"","trial_number","genome","merit","accuracy","genome_length","door_rooms","exit_rooms","correct_doors","incorrect_doors","correct_exits","incorrect_exits","doors_taken_0","doors_correct_0","doors_taken_1","doors_correct_1","doors_taken_2","doors_correct_2","seed"
"1",0,"[33]GJHglqIHcdKpcJvcGHqxdCBfeeirHtzIq",172,0.99422,33,173,1,172,1,1,0,1,1,96,95,77,77,1
"2",1,"[33]GJHglqIHcdKpcJvcGHqxdCBfeeirHtzIq",169,0.994118,33,170,1,169,1,1,0,1,1,90,89,80,80,1
"3",2,"[33]GJHglqIHcdKpcJvcGHqxdCBfeeirHtzIq",166,0.994012,33,167,1,166,1,1,0,1,1,81,80,86,86,1
"4",3,"[33]GJHglqIHcdKpcJvcGHqxdCBfeeirHtzIq",168,0.994083,33,169,1,168,1,1,0,1,1,87,86,82,82,1
"5",4,"[33]GJHglqIHcdKpcJvcGHqxdCBfeeirHtzIq",166,0.994012,33,167,1,166,1,1,0,1,1,82,81,85,85,1
"6",5,"[33]GJHglqIHcdKpcJvcGHqxdCBfeeirHtzIq",172,0.99422,33,173,1,172,1,1,0,1,1,95,94,78,78,1
"7",6,"[33]GJHglqIHcdKpcJvcGHqxdCBfeeirHtzIq",173,0.994253,33,174,1,173,1,1,0,1,1,102,101,72,72,1
"8",7,"[33]GJHglqIHcdKpcJvcGHqxdCBfeeirHtzIq",164,0.993939,33,165,1,164,1,1,0,1,1,77,76,88,88,1
"9",8,"[33]GJHglqIHcdKpcJvcGHqxdCBfeeirHtzIq",172,0.99422,33,173,1,172,1,1,0,1,1,98,97,75,75,1
"10",9,"[33]GJHglqIHcdKpcJvcGHqxdCBfeeirHtzIq",169,0.994118,33,170,1,169,1,1,0,1,1,90,89,80,80,1
"11",10,"[33]GJHglqIHcdKpcJvcGHqxdCBfeeirHtzIq",165,0.993976,33,166,1,165,1,1,0,1,1,80,79,86,86,1
"12",11,"[33]GJHglqIHcdKpcJvcGHqxdCBfeeirHtzIq",167,0.994048,33,168,1,167,1,1,0,1,1,85,84,83,83,1
"13",12,"[33]GJHglqIHcdKpcJvcGHqxdCBfeeirHtzIq",161,0.993827,33,162,1,161,1,1,0,1,1,67,66,95,95,1
"14",13,"[33]GJHglqIHcdKpcJvcGHqxdCBfeeirHtzIq",168,0.994083,33,169,1,168,1,1,0,1,1,87,86,82,82,1
"15",14,"[33]GJHglqIHcdKpcJvcGHqxdCBfeeirHtzIq",172,0.99422,33,173,1,172,1,1,0,1,1,98,97,75,75,1
"16",15,"[33]GJHglqIHcdKpcJvcGHqxdCBfeeirHtzIq",167,0.994048,33,168,1,167,1,1,0,1,1,83,82,85,85,1
"17",16,"[33]GJHglqIHcdKpcJvcGHqxdCBfeeirHtzIq",166,0.994012,33,167,1,166,1,1,0,1,1,81,80,86,86,1
"18",17,"[33]GJHglqIHcdKpcJvcGHqxdCBfeeirHtzIq",164,0.993939,33,165,1,164,1,1,0,1,1,76,75,89,89,1
"19",18,"[33]GJHglqIHcdKpcJvcGHqxdCBfeeirHtzIq",165,0.993976,33,166,1,165,1,1,0,1,1,79,78,87,87,1
"20",19,"[33]GJHglqIHcdKpcJvcGHqxdCBfeeirHtzIq",170,0.994152,33,171,1,170,1,1,0,1,1,93,92,78,78,1
"21",20,"[33]GJHglqIHcdKpcJvcGHqxdCBfeeirHtzIq",168,0.994083,33,169,1,168,1,1,0,1,1,88,87,81,81,1
"22",21,"[33]GJHglqIHcdKpcJvcGHqxdCBfeeirHtzIq",169,0.994118,33,170,1,169,1,1,0,1,1,91,90,79,79,1
"23",22,"[33]GJHglqIHcdKpcJvcGHqxdCBfeeirHtzIq",169,0.994118,33,170,1,169,1,1,0,1,1,89,88,81,81,1
"24",23,"[33]GJHglqIHcdKpcJvcGHqxdCBfeeirHtzIq",166,0.994012,33,167,1,166,1,1,0,1,1,83,82,84,84,1
"25",24,"[33]GJHglqIHcdKpcJvcGHqxdCBfeeirHtzIq",168,0.994083,33,169,1,168,1,1,0,1,1,86,85,83,83,1
"26",25,"[33]GJHglqIHcdKpcJvcGHqxdCBfeeirHtzIq",164,0.993939,33,165,1,164,1,1,0,1,1,76,75,89,89,1
"27",26,"[33]GJHglqIHcdKpcJvcGHqxdCBfeeirHtzIq",165,0.993976,33,166,1,165,1,1,0,1,1,80,79,86,86,1
"28",27,"[33]GJHglqIHcdKpcJvcGHqxdCBfeeirHtzIq",169,0.994118,33,170,1,169,1,1,0,1,1,90,89,80,80,1
"29",28,"[33]GJHglqIHcdKpcJvcGHqxdCBfeeirHtzIq",167,0.994048,33,168,1,167,1,1,0,1,1,83,82,85,85,1
"30",29,"[33]GJHglqIHcdKpcJvcGHqxdCBfeeirHtzIq",163,0.993902,33,164,1,163,1,1,0,1,1,73,72,91,91,1
"31",30,"[33]GJHglqIHcdKpcJvcGHqxdCBfeeirHtzIq",169,0.994118,33,170,1,169,1,1,0,1,1,90,89,80,80,1
"32",31,"[33]GJHglqIHcdKpcJvcGHqxdCBfeeirHtzIq",169,0.994118,33,170,1,169,1,1,0,1,1,89,88,81,81,1
"33",32,"[33]GJHglqIHcdKpcJvcGHqxdCBfeeirHtzIq",161,0.993827,33,162,1,161,1,1,0,1,1,67,66,95,95,1
"34",33,"[33]GJHglqIHcdKpcJvcGHqxdCBfeeirHtzIq",164,0.993939,33,165,1,164,1,1,0,1,1,75,74,90,90,1
"35",34,"[33]GJHglqIHcdKpcJvcGHqxdCBfeeirHtzIq",170,0.994152,33,171,1,170,1,1,0,1,1,92,91,79,79,1
"36",35,"[33]GJHglqIHcdKpcJvcGHqxdCBfeeirHtzIq",169,0.994118,33,170,1,169,1,1,0,1,1,90,89,80,80,1
"37",36,"[33]GJHglqIHcdKpcJvcGHqxdCBfeeirHtzIq",161,0.993827,33,162,1,161,1,1,0,1,1,69,68,93,93,1
"38",37,"[33]GJHglqIHcdKpcJvcGHqxdCBfeeirHtzIq",170,0.994152,33,171,1,170,1,1,0,1,1,92,91,79,79,1
"39",38,"[33]GJHglqIHcdKpcJvcGHqxdCBfeeirHtzIq",169,0.994118,33,170,1,169,1,1,0,1,1,90,89,80,80,1
"40",39,"[33]GJHglqIHcdKpcJvcGHqxdCBfeeirHtzIq",166,0.994012,33,167,1,166,1,1,0,1,1,82,81,85,85,1
"41",40,"[33]GJHglqIHcdKpcJvcGHqxdCBfeeirHtzIq",166,0.994012,33,167,1,166,1,1,0,1,1,82,81,85,85,1
"42",41,"[33]GJHglqIHcdKpcJvcGHqxdCBfeeirHtzIq",167,0.994048,33,168,1,167,1,1,0,1,1,84,83,84,84,1
"43",42,"[33]GJHglqIHcdKpcJvcGHqxdCBfeeirHtzIq",165,0.993976,33,166,1,165,1,1,0,1,1,78,77,88,88,1
"44",43,"[33]GJHglqIHcdKpcJvcGHqxdCBfeeirHtzIq",168,0.994083,33,169,1,168,1,1,0,1,1,86,85,83,83,1
"45",44,"[33]GJHglqIHcdKpcJvcGHqxdCBfeeirHtzIq",171,0.994186,33,172,1,171,1,1,0,1,1,94,93,78,78,1
"46",45,"[33]GJHglqIHcdKpcJvcGHqxdCBfeeirHtzIq",165,0.993976,33,166,1,165,1,1,0,1,1,79,78,87,87,1
"47",46,"[33]GJHglqIHcdKpcJvcGHqxdCBfeeirHtzIq",163,0.993902,33,164,1,163,1,1,0,1,1,75,74,89,89,1
"48",47,"[33]GJHglqIHcdKpcJvcGHqxdCBfeeirHtzIq",167,0.994048,33,168,1,167,1,1,0,1,1,84,83,84,84,1
"49",48,"[33]GJHglqIHcdKpcJvcGHqxdCBfeeirHtzIq",164,0.993939,33,165,1,164,1,1,0,1,1,77,76,88,88,1
"50",49,"[33]GJHglqIHcdKpcJvcGHqxdCBfeeirHtzIq",169,0.994118,33,170,1,169,1,1,0,1,1,90,89,80,80,1
"51",50,"[33]GJHglqIHcdKpcJvcGHqxdCBfeeirHtzIq",161,0.993827,33,162,1,161,1,1,0,1,1,68,67,94,94,1
"52",51,"[33]GJHglqIHcdKpcJvcGHqxdCBfeeirHtzIq",166,0.994012,33,167,1,166,1,1,0,1,1,83,82,84,84,1
"53",52,"[33]GJHglqIHcdKpcJvcGHqxdCBfeeirHtzIq",164,0.993939,33,165,1,164,1,1,0,1,1,77,76,88,88,1
"54",53,"[33]GJHglqIHcdKpcJvcGHqxdCBfeeirHtzIq",171,0.994186,33,172,1,171,1,1,0,1,1,95,94,77,77,1
"55",54,"[33]GJHglqIHcdKpcJvcGHqxdCBfeeirHtzIq",166,0.994012,33,167,1,166,1,1,0,1,1,83,82,84,84,1
"56",55,"[33]GJHglqIHcdKpcJvcGHqxdCBfeeirHtzIq",168,0.994083,33,169,1,168,1,1,0,1,1,88,87,81,81,1
"57",56,"[33]GJHglqIHcdKpcJvcGHqxdCBfeeirHtzIq",168,0.994083,33,169,1,168,1,1,0,1,1,87,86,82,82,1
"58",57,"[33]GJHglqIHcdKpcJvcGHqxdCBfeeirHtzIq",165,0.993976,33,166,1,165,1,1,0,1,1,79,78,87,87,1
"59",58,"[33]GJHglqIHcdKpcJvcGHqxdCBfeeirHtzIq",169,0.994118,33,170,1,169,1,1,0,1,1,91,90,79,79,1
"60",59,"[33]GJHglqIHcdKpcJvcGHqxdCBfeeirHtzIq",165,0.993976,33,166,1,165,1,1,0,1,1,78,77,88,88,1
"61",60,"[33]GJHglqIHcdKpcJvcGHqxdCBfeeirHtzIq",166,0.994012,33,167,1,166,1,1,0,1,1,81,80,86,86,1
"62",61,"[33]GJHglqIHcdKpcJvcGHqxdCBfeeirHtzIq",171,0.994186,33,172,1,171,1,1,0,1,1,96,95,76,76,1
"63",62,"[33]GJHglqIHcdKpcJvcGHqxdCBfeeirHtzIq",166,0.994012,33,167,1,166,1,1,0,1,1,82,81,85,85,1
"64",63,"[33]GJHglqIHcdKpcJvcGHqxdCBfeeirHtzIq",168,0.994083,33,169,1,168,1,1,0,1,1,88,87,81,81,1
"65",64,"[33]GJHglqIHcdKpcJvcGHqxdCBfeeirHtzIq",169,0.994118,33,170,1,169,1,1,0,1,1,90,89,80,80,1
"66",65,"[33]GJHglqIHcdKpcJvcGHqxdCBfeeirHtzIq",165,0.993976,33,166,1,165,1,1,0,1,1,78,77,88,88,1
"67",66,"[33]GJHglqIHcdKpcJvcGHqxdCBfeeirHtzIq",167,0.994048,33,168,1,167,1,1,0,1,1,85,84,83,83,1
"68",67,"[33]GJHglqIHcdKpcJvcGHqxdCBfeeirHtzIq",169,0.994118,33,170,1,169,1,1,0,1,1,89,88,81,81,1
"69",68,"[33]GJHglqIHcdKpcJvcGHqxdCBfeeirHtzIq",164,0.993939,33,165,1,164,1,1,0,1,1,75,74,90,90,1
"70",69,"[33]GJHglqIHcdKpcJvcGHqxdCBfeeirHtzIq",167,0.994048,33,168,1,167,1,1,0,1,1,85,84,83,83,1
"71",70,"[33]GJHglqIHcdKpcJvcGHqxdCBfeeirHtzIq",168,0.994083,33,169,1,168,1,1,0,1,1,88,87,81,81,1
"72",71,"[33]GJHglqIHcdKpcJvcGHqxdCBfeeirHtzIq",166,0.994012,33,167,1,166,1,1,0,1,1,83,82,84,84,1
"73",72,"[33]GJHglqIHcdKpcJvcGHqxdCBfeeirHtzIq",171,0.994186,33,172,1,171,1,1,0,1,1,95,94,77,77,1
"74",73,"[33]GJHglqIHcdKpcJvcGHqxdCBfeeirHtzIq",169,0.994118,33,170,1,169,1,1,0,1,1,91,90,79,79,1
"75",74,"[33]GJHglqIHcdKpcJvcGHqxdCBfeeirHtzIq",168,0.994083,33,169,1,168,1,1,0,1,1,86,85,83,83,1
"76",75,"[33]GJHglqIHcdKpcJvcGHqxdCBfeeirHtzIq",171,0.994186,33,172,1,171,1,1,0,1,1,94,93,78,78,1
"77",76,"[33]GJHglqIHcdKpcJvcGHqxdCBfeeirHtzIq",165,0.993976,33,166,1,165,1,1,0,1,1,79,78,87,87,1
"78",77,"[33]GJHglqIHcdKpcJvcGHqxdCBfeeirHtzIq",162,0.993865,33,163,1,162,1,1,0,1,1,71,70,92,92,1
"79",78,"[33]GJHglqIHcdKpcJvcGHqxdCBfeeirHtzIq",167,0.994048,33,168,1,167,1,1,0,1,1,86,85,82,82,1
"80",79,"[33]GJHglqIHcdKpcJvcGHqxdCBfeeirHtzIq",168,0.994083,33,169,1,168,1,1,0,1,1,87,86,82,82,1
"81",80,"[33]GJHglqIHcdKpcJvcGHqxdCBfeeirHtzIq",169,0.994118,33,170,1,169,1,1,0,1,1,90,89,80,80,1
"82",81,"[33]GJHglqIHcdKpcJvcGHqxdCBfeeirHtzIq",170,0.994152,33,171,1,170,1,1,0,1,1,92,91,79,79,1
"83",82,"[33]GJHglqIHcdKpcJvcGHqxdCBfeeirHtzIq",166,0.994012,33,167,1,166,1,1,0,1,1,80,79,87,87,1
"84",83,"[33]GJHglqIHcdKpcJvcGHqxdCBfeeirHtzIq",169,0.994118,33,170,1,169,1,1,0,1,1,90,89,80,80,1
"85",84,"[33]GJHglqIHcdKpcJvcGHqxdCBfeeirHtzIq",165,0.993976,33,166,1,165,1,1,0,1,1,78,77,88,88,1
"86",85,"[33]GJHglqIHcdKpcJvcGHqxdCBfeeirHtzIq",166,0.994012,33,167,1,166,1,1,0,1,1,80,79,87,87,1
"87",86,"[33]GJHglqIHcdKpcJvcGHqxdCBfeeirHtzIq",172,0.99422,33,173,1,172,1,1,0,1,1,99,98,74,74,1
"88",87,"[33]GJHglqIHcdKpcJvcGHqxdCBfeeirHtzIq",165,0.993976,33,166,1,165,1,1,0,1,1,80,79,86,86,1
"89",88,"[33]GJHglqIHcdKpcJvcGHqxdCBfeeirHtzIq",173,0.994253,33,174,1,173,1,1,0,1,1,100,99,74,74,1
"90",89,"[33]GJHglqIHcdKpcJvcGHqxdCBfeeirHtzIq",171,0.994186,33,172,1,171,1,1,0,1,1,96,95,76,76,1
"91",90,"[33]GJHglqIHcdKpcJvcGHqxdCBfeeirHtzIq",170,0.994152,33,171,1,170,1,1,0,1,1,93,92,78,78,1
"92",91,"[33]GJHglqIHcdKpcJvcGHqxdCBfeeirHtzIq",162,0.993865,33,163,1,162,1,1,0,1,1,71,70,92,92,1
"93",92,"[33]GJHglqIHcdKpcJvcGHqxdCBfeeirHtzIq",164,0.993939,33,165,1,164,1,1,0,1,1,76,75,89,89,1
"94",93,"[33]GJHglqIHcdKpcJvcGHqxdCBfeeirHtzIq",169,0.994118,33,170,1,169,1,1,0,1,1,90,89,80,80,1
"95",94,"[33]GJHglqIHcdKpcJvcGHqxdCBfeeirHtzIq",171,0.994186,33,172,1,171,1,1,0,1,1,95,94,77,77,1
"96",95,"[33]GJHglqIHcdKpcJvcGHqxdCBfeeirHtzIq",167,0.994048,33,168,1,167,1,1,0,1,1,85,84,83,83,1
"97",96,"[33]GJHglqIHcdKpcJvcGHqxdCBfeeirHtzIq",166,0.994012,33,167,1,166,1,1,0,1,1,82,81,85,85,1
"98",97,"[33]GJHglqIHcdKpcJvcGHqxdCBfeeirHtzIq",169,0.994118,33,170,1,169,1,1,0,1,1,90,89,80,80,1
"99",98,"[33]GJHglqIHcdKpcJvcGHqxdCBfeeirHtzIq",167,0.994048,33,168,1,167,1,1,0,1,1,85,84,83,83,1
"100",99,"[33]GJHglqIHcdKpcJvcGHqxdCBfeeirHtzIq",164,0.993939,33,165,1,164,1,1,0,1,1,77,76,88,88,1
"101",0,"[31]lJHglqIHcdKpcJvcGHqvdCCsnvBHBmI",166,0.994012,31,167,1,166,1,1,0,1,1,80,79,87,87,2
"102",1,"[31]lJHglqIHcdKpcJvcGHqvdCCsnvBHBmI",169,0.994118,31,170,1,169,1,1,0,1,1,89,88,81,81,2
"103",2,"[31]lJHglqIHcdKpcJvcGHqvdCCsnvBHBmI",171,0.994186,31,172,1,171,1,1,0,1,1,93,92,79,79,2
"104",3,"[31]lJHglqIHcdKpcJvcGHqvdCCsnvBHBmI",168,0.994083,31,169,1,168,1,1,0,1,1,85,84,84,84,2
"105",4,"[31]lJHglqIHcdKpcJvcGHqvdCCsnvBHBmI",168,0.994083,31,169,1,168,1,1,0,1,1,88,87,81,81,2
"106",5,"[31]lJHglqIHcdKpcJvcGHqvdCCsnvBHBmI",166,0.994012,31,167,1,166,1,1,0,1,1,81,80,86,86,2
"107",6,"[31]lJHglqIHcdKpcJvcGHqvdCCsnvBHBmI",164,0.993939,31,165,1,164,1,1,0,1,1,76,75,89,89,2
"108",7,"[31]lJHglqIHcdKpcJvcGHqvdCCsnvBHBmI",167,0.994048,31,168,1,167,1,1,0,1,1,85,84,83,83,2
"109",8,"[31]lJHglqIHcdKpcJvcGHqvdCCsnvBHBmI",168,0.994083,31,169,1,168,1,1,0,1,1,85,84,84,84,2
"110",9,"[31]lJHglqIHcdKpcJvcGHqvdCCsnvBHBmI",165,0.993976,31,166,1,165,1,1,0,1,1,78,77,88,88,2
"111",10,"[31]lJHglqIHcdKpcJvcGHqvdCCsnvBHBmI",171,0.994186,31,172,1,171,1,1,0,1,1,93,92,79,79,2
"112",11,"[31]lJHglqIHcdKpcJvcGHqvdCCsnvBHBmI",163,0.993902,31,164,1,163,1,1,0,1,1,75,74,89,89,2
"113",12,"[31]lJHglqIHcdKpcJvcGHqvdCCsnvBHBmI",165,0.993976,31,166,1,165,1,1,0,1,1,80,79,86,86,2
"114",13,"[31]lJHglqIHcdKpcJvcGHqvdCCsnvBHBmI",170,0.994152,31,171,1,170,1,1,0,1,1,92,91,79,79,2
"115",14,"[31]lJHglqIHcdKpcJvcGHqvdCCsnvBHBmI",164,0.993939,31,165,1,164,1,1,0,1,1,77,76,88,88,2
"116",15,"[31]lJHglqIHcdKpcJvcGHqvdCCsnvBHBmI",170,0.994152,31,171,1,170,1,1,0,1,1,92,91,79,79,2
"117",16,"[31]lJHglqIHcdKpcJvcGHqvdCCsnvBHBmI",169,0.994118,31,170,1,169,1,1,0,1,1,90,89,80,80,2
"118",17,"[31]lJHglqIHcdKpcJvcGHqvdCCsnvBHBmI",168,0.994083,31,169,1,168,1,1,0,1,1,88,87,81,81,2
"119",18,"[31]lJHglqIHcdKpcJvcGHqvdCCsnvBHBmI",166,0.994012,31,167,1,166,1,1,0,1,1,82,81,85,85,2
"120",19,"[31]lJHglqIHcdKpcJvcGHqvdCCsnvBHBmI",174,0.994286,31,175,1,174,1,1,0,1,1,103,102,72,72,2
"121",20,"[31]lJHglqIHcdKpcJvcGHqvdCCsnvBHBmI",167,0.994048,31,168,1,167,1,1,0,1,1,86,85,82,82,2
"122",21,"[31]lJHglqIHcdKpcJvcGHqvdCCsnvBHBmI",169,0.994118,31,170,1,169,1,1,0,1,1,91,90,79,79,2
"123",22,"[31]lJHglqIHcdKpcJvcGHqvdCCsnvBHBmI",168,0.994083,31,169,1,168,1,1,0,1,1,88,87,81,81,2
"124",23,"[31]lJHglqIHcdKpcJvcGHqvdCCsnvBHBmI",169,0.994118,31,170,1,169,1,1,0,1,1,90,89,80,80,2
"125",24,"[31]lJHglqIHcdKpcJvcGHqvdCCsnvBHBmI",175,0.994318,31,176,1,175,1,1,0,1,1,106,105,70,70,2
"126",25,"[31]lJHglqIHcdKpcJvcGHqvdCCsnvBHBmI",161,0.993827,31,162,1,161,1,1,0,1,1,68,67,94,94,2
"127",26,"[31]lJHglqIHcdKpcJvcGHqvdCCsnvBHBmI",166,0.994012,31,167,1,166,1,1,0,1,1,82,81,85,85,2
"128",27,"[31]lJHglqIHcdKpcJvcGHqvdCCsnvBHBmI",166,0.994012,31,167,1,166,1,1,0,1,1,83,82,84,84,2
"129",28,"[31]lJHglqIHcdKpcJvcGHqvdCCsnvBHBmI",168,0.994083,31,169,1,168,1,1,0,1,1,88,87,81,81,2
"130",29,"[31]lJHglqIHcdKpcJvcGHqvdCCsnvBHBmI",171,0.994186,31,172,1,171,1,1,0,1,1,96,95,76,76,2
"131",30,"[31]lJHglqIHcdKpcJvcGHqvdCCsnvBHBmI",170,0.994152,31,171,1,170,1,1,0,1,1,94,93,77,77,2
"132",31,"[31]lJHglqIHcdKpcJvcGHqvdCCsnvBHBmI",168,0.994083,31,169,1,168,1,1,0,1,1,87,86,82,82,2
"133",32,"[31]lJHglqIHcdKpcJvcGHqvdCCsnvBHBmI",170,0.994152,31,171,1,170,1,1,0,1,1,90,89,81,81,2
"134",33,"[31]lJHglqIHcdKpcJvcGHqvdCCsnvBHBmI",171,0.994186,31,172,1,171,1,1,0,1,1,95,94,77,77,2
"135",34,"[31]lJHglqIHcdKpcJvcGHqvdCCsnvBHBmI",166,0.994012,31,167,1,166,1,1,0,1,1,81,80,86,86,2
"136",35,"[31]lJHglqIHcdKpcJvcGHqvdCCsnvBHBmI",171,0.994186,31,172,1,171,1,1,0,1,1,95,94,77,77,2
"137",36,"[31]lJHglqIHcdKpcJvcGHqvdCCsnvBHBmI",166,0.994012,31,167,1,166,1,1,0,1,1,82,81,85,85,2
"138",37,"[31]lJHglqIHcdKpcJvcGHqvdCCsnvBHBmI",165,0.993976,31,166,1,165,1,1,0,1,1,80,79,86,86,2
"139",38,"[31]lJHglqIHcdKpcJvcGHqvdCCsnvBHBmI",167,0.994048,31,168,1,167,1,1,0,1,1,85,84,83,83,2
"140",39,"[31]lJHglqIHcdKpcJvcGHqvdCCsnvBHBmI",164,0.993939,31,165,1,164,1,1,0,1,1,76,75,89,89,2
"141",40,"[31]lJHglqIHcdKpcJvcGHqvdCCsnvBHBmI",165,0.993976,31,166,1,165,1,1,0,1,1,79,78,87,87,2
"142",41,"[31]lJHglqIHcdKpcJvcGHqvdCCsnvBHBmI",167,0.994048,31,168,1,167,1,1,0,1,1,86,85,82,82,2
"143",42,"[31]lJHglqIHcdKpcJvcGHqvdCCsnvBHBmI",172,0.99422,31,173,1,172,1,1,0,1,1,97,96,76,76,2
"144",43,"[31]lJHglqIHcdKpcJvcGHqvdCCsnvBHBmI",159,0.99375,31,160,1,159,1,1,0,1,1,63,62,97,97,2
"145",44,"[31]lJHglqIHcdKpcJvcGHqvdCCsnvBHBmI",163,0.993902,31,164,1,163,1,1,0,1,1,75,74,89,89,2
"146",45,"[31]lJHglqIHcdKpcJvcGHqvdCCsnvBHBmI",169,0.994118,31,170,1,169,1,1,0,1,1,90,89,80,80,2
"147",46,"[31]lJHglqIHcdKpcJvcGHqvdCCsnvBHBmI",160,0.993789,31,161,1,160,1,1,0,1,1,65,64,96,96,2
"148",47,"[31]lJHglqIHcdKpcJvcGHqvdCCsnvBHBmI",170,0.994152,31,171,1,170,1,1,0,1,1,94,93,77,77,2
"149",48,"[31]lJHglqIHcdKpcJvcGHqvdCCsnvBHBmI",167,0.994048,31,168,1,167,1,1,0,1,1,85,84,83,83,2
"150",49,"[31]lJHglqIHcdKpcJvcGHqvdCCsnvBHBmI",166,0.994012,31,167,1,166,1,1,0,1,1,80,79,87,87,2
"151",50,"[31]lJHglqIHcdKpcJvcGHqvdCCsnvBHBmI",170,0.994152,31,171,1,170,1,1,0,1,1,92,91,79,79,2
"152",51,"[31]lJHglqIHcdKpcJvcGHqvdCCsnvBHBmI",165,0.993976,31,166,1,165,1,1,0,1,1,79,78,87,87,2
"153",52,"[31]lJHglqIHcdKpcJvcGHqvdCCsnvBHBmI",167,0.994048,31,168,1,167,1,1,0,1,1,83,82,85,85,2
"154",53,"[31]lJHglqIHcdKpcJvcGHqvdCCsnvBHBmI",168,0.994083,31,169,1,168,1,1,0,1,1,87,86,82,82,2
"155",54,"[31]lJHglqIHcdKpcJvcGHqvdCCsnvBHBmI",165,0.993976,31,166,1,165,1,1,0,1,1,80,79,86,86,2
"156",55,"[31]lJHglqIHcdKpcJvcGHqvdCCsnvBHBmI",162,0.993865,31,163,1,162,1,1,0,1,1,72,71,91,91,2
"157",56,"[31]lJHglqIHcdKpcJvcGHqvdCCsnvBHBmI",164,0.993939,31,165,1,164,1,1,0,1,1,77,76,88,88,2
"158",57,"[31]lJHglqIHcdKpcJvcGHqvdCCsnvBHBmI",171,0.994186,31,172,1,171,1,1,0,1,1,97,96,75,75,2
"159",58,"[31]lJHglqIHcdKpcJvcGHqvdCCsnvBHBmI",168,0.994083,31,169,1,168,1,1,0,1,1,87,86,82,82,2
"160",59,"[31]lJHglqIHcdKpcJvcGHqvdCCsnvBHBmI",161,0.993827,31,162,1,161,1,1,0,1,1,68,67,94,94,2
"161",60,"[31]lJHglqIHcdKpcJvcGHqvdCCsnvBHBmI",168,0.994083,31,169,1,168,1,1,0,1,1,85,84,84,84,2
"162",61,"[31]lJHglqIHcdKpcJvcGHqvdCCsnvBHBmI",165,0.993976,31,166,1,165,1,1,0,1,1,79,78,87,87,2
"163",62,"[31]lJHglqIHcdKpcJvcGHqvdCCsnvBHBmI",161,0.993827,31,162,1,161,1,1,0,1,1,69,68,93,93,2
"164",63,"[31]lJHglqIHcdKpcJvcGHqvdCCsnvBHBmI",173,0.994253,31,174,1,173,1,1,0,1,1,102,101,72,72,2
"165",64,"[31]lJHglqIHcdKpcJvcGHqvdCCsnvBHBmI",161,0.993827,31,162,1,161,1,1,0,1,1,69,68,93,93,2
"166",65,"[31]lJHglqIHcdKpcJvcGHqvdCCsnvBHBmI",169,0.994118,31,170,1,169,1,1,0,1,1,90,89,80,80,2
"167",66,"[31]lJHglqIHcdKpcJvcGHqvdCCsnvBHBmI",169,0.994118,31,170,1,169,1,1,0,1,1,89,88,81,81,2
"168",67,"[31]lJHglqIHcdKpcJvcGHqvdCCsnvBHBmI",168,0.994083,31,169,1,168,1,1,0,1,1,87,86,82,82,2
"169",68,"[31]lJHglqIHcdKpcJvcGHqvdCCsnvBHBmI",166,0.994012,31,167,1,166,1,1,0,1,1,82,81,85,85,2
"170",69,"[31]lJHglqIHcdKpcJvcGHqvdCCsnvBHBmI",166,0.994012,31,167,1,166,1,1,0,1,1,82,81,85,85,2
"171",70,"[31]lJHglqIHcdKpcJvcGHqvdCCsnvBHBmI",167,0.994048,31,168,1,167,1,1,0,1,1,85,84,83,83,2
"172",71,"[31]lJHglqIHcdKpcJvcGHqvdCCsnvBHBmI",167,0.994048,31,168,1,167,1,1,0,1,1,84,83,84,84,2
"173",72,"[31]lJHglqIHcdKpcJvcGHqvdCCsnvBHBmI",166,0.994012,31,167,1,166,1,1,0,1,1,83,82,84,84,2
"174",73,"[31]lJHglqIHcdKpcJvcGHqvdCCsnvBHBmI",167,0.994048,31,168,1,167,1,1,0,1,1,85,84,83,83,2
"175",74,"[31]lJHglqIHcdKpcJvcGHqvdCCsnvBHBmI",172,0.99422,31,173,1,172,1,1,0,1,1,98,97,75,75,2
"176",75,"[31]lJHglqIHcdKpcJvcGHqvdCCsnvBHBmI",170,0.994152,31,171,1,170,1,1,0,1,1,93,92,78,78,2
"177",76,"[31]lJHglqIHcdKpcJvcGHqvdCCsnvBHBmI",160,0.993789,31,161,1,160,1,1,0,1,1,66,65,95,95,2
"178",77,"[31]lJHglqIHcdKpcJvcGHqvdCCsnvBHBmI",170,0.994152,31,171,1,170,1,1,0,1,1,94,93,77,77,2
"179",78,"[31]lJHglqIHcdKpcJvcGHqvdCCsnvBHBmI",166,0.994012,31,167,1,166,1,1,0,1,1,81,80,86,86,2
"180",79,"[31]lJHglqIHcdKpcJvcGHqvdCCsnvBHBmI",163,0.993902,31,164,1,163,1,1,0,1,1,74,73,90,90,2
"181",80,"[31]lJHglqIHcdKpcJvcGHqvdCCsnvBHBmI",162,0.993865,31,163,1,162,1,1,0,1,1,71,70,92,92,2
"182",81,"[31]lJHglqIHcdKpcJvcGHqvdCCsnvBHBmI",166,0.994012,31,167,1,166,1,1,0,1,1,83,82,84,84,2
"183",82,"[31]lJHglqIHcdKpcJvcGHqvdCCsnvBHBmI",165,0.993976,31,166,1,165,1,1,0,1,1,76,75,90,90,2
"184",83,"[31]lJHglqIHcdKpcJvcGHqvdCCsnvBHBmI",167,0.994048,31,168,1,167,1,1,0,1,1,85,84,83,83,2
"185",84,"[31]lJHglqIHcdKpcJvcGHqvdCCsnvBHBmI",165,0.993976,31,166,1,165,1,1,0,1,1,80,79,86,86,2
"186",85,"[31]lJHglqIHcdKpcJvcGHqvdCCsnvBHBmI",162,0.993865,31,163,1,162,1,1,0,1,1,72,71,91,91,2
"187",86,"[31]lJHglqIHcdKpcJvcGHqvdCCsnvBHBmI",169,0.994118,31,170,1,169,1,1,0,1,1,90,89,80,80,2
"188",87,"[31]lJHglqIHcdKpcJvcGHqvdCCsnvBHBmI",170,0.994152,31,171,1,170,1,1,0,1,1,93,92,78,78,2
"189",88,"[31]lJHglqIHcdKpcJvcGHqvdCCsnvBHBmI",166,0.994012,31,167,1,166,1,1,0,1,1,82,81,85,85,2
"190",89,"[31]lJHglqIHcdKpcJvcGHqvdCCsnvBHBmI",168,0.994083,31,169,1,168,1,1,0,1,1,86,85,83,83,2
"191",90,"[31]lJHglqIHcdKpcJvcGHqvdCCsnvBHBmI",163,0.993902,31,164,1,163,1,1,0,1,1,74,73,90,90,2
"192",91,"[31]lJHglqIHcdKpcJvcGHqvdCCsnvBHBmI",170,0.994152,31,171,1,170,1,1,0,1,1,93,92,78,78,2
"193",92,"[31]lJHglqIHcdKpcJvcGHqvdCCsnvBHBmI",164,0.993939,31,165,1,164,1,1,0,1,1,76,75,89,89,2
"194",93,"[31]lJHglqIHcdKpcJvcGHqvdCCsnvBHBmI",167,0.994048,31,168,1,167,1,1,0,1,1,85,84,83,83,2
"195",94,"[31]lJHglqIHcdKpcJvcGHqvdCCsnvBHBmI",174,0.994286,31,175,1,174,1,1,0,1,1,104,103,71,71,2
"196",95,"[31]lJHglqIHcdKpcJvcGHqvdCCsnvBHBmI",167,0.994048,31,168,1,167,1,1,0,1,1,85,84,83,83,2
"197",96,"[31]lJHglqIHcdKpcJvcGHqvdCCsnvBHBmI",165,0.993976,31,166,1,165,1,1,0,1,1,79,78,87,87,2
"198",97,"[31]lJHglqIHcdKpcJvcGHqvdCCsnvBHBmI",163,0.993902,31,164,1,163,1,1,0,1,1,73,72,91,91,2
"199",98,"[31]lJHglqIHcdKpcJvcGHqvdCCsnvBHBmI",166,0.994012,31,167,1,166,1,1,0,1,1,82,81,85,85,2
"200",99,"[31]lJHglqIHcdKpcJvcGHqvdCCsnvBHBmI",164,0.993939,31,165,1,164,1,1,0,1,1,76,75,89,89,2
"201",0,"[29]dJHglqIrHctdKpcJvcGHqvdCpAaaj",172,0.99422,29,173,1,172,1,1,0,1,1,99,98,74,74,3
"202",1,"[29]dJHglqIrHctdKpcJvcGHqvdCpAaaj",167,0.994048,29,168,1,167,1,1,0,1,1,85,84,83,83,3
"203",2,"[29]dJHglqIrHctdKpcJvcGHqvdCpAaaj",167,0.994048,29,168,1,167,1,1,0,1,1,85,84,83,83,3
"204",3,"[29]dJHglqIrHctdKpcJvcGHqvdCpAaaj",165,0.993976,29,166,1,165,1,1,0,1,1,79,78,87,87,3
"205",4,"[29]dJHglqIrHctdKpcJvcGHqvdCpAaaj",164,0.993939,29,165,1,164,1,1,0,1,1,76,75,89,89,3
"206",5,"[29]dJHglqIrHctdKpcJvcGHqvdCpAaaj",162,0.993865,29,163,1,162,1,1,0,1,1,72,71,91,91,3
"207",6,"[29]dJHglqIrHctdKpcJvcGHqvdCpAaaj",166,0.994012,29,167,1,166,1,1,0,1,1,83,82,84,84,3
"208",7,"[29]dJHglqIrHctdKpcJvcGHqvdCpAaaj",167,0.994048,29,168,1,167,1,1,0,1,1,84,83,84,84,3
"209",8,"[29]dJHglqIrHctdKpcJvcGHqvdCpAaaj",168,0.994083,29,169,1,168,1,1,0,1,1,87,86,82,82,3
"210",9,"[29]dJHglqIrHctdKpcJvcGHqvdCpAaaj",170,0.994152,29,171,1,170,1,1,0,1,1,92,91,79,79,3
"211",10,"[29]dJHglqIrHctdKpcJvcGHqvdCpAaaj",168,0.994083,29,169,1,168,1,1,0,1,1,88,87,81,81,3
"212",11,"[29]dJHglqIrHctdKpcJvcGHqvdCpAaaj",168,0.994083,29,169,1,168,1,1,0,1,1,88,87,81,81,3
"213",12,"[29]dJHglqIrHctdKpcJvcGHqvdCpAaaj",165,0.993976,29,166,1,165,1,1,0,1,1,80,79,86,86,3
"214",13,"[29]dJHglqIrHctdKpcJvcGHqvdCpAaaj",168,0.994083,29,169,1,168,1,1,0,1,1,87,86,82,82,3
"215",14,"[29]dJHglqIrHctdKpcJvcGHqvdCpAaaj",166,0.994012,29,167,1,166,1,1,0,1,1,82,81,85,85,3
"216",15,"[29]dJHglqIrHctdKpcJvcGHqvdCpAaaj",164,0.993939,29,165,1,164,1,1,0,1,1,78,77,87,87,3
"217",16,"[29]dJHglqIrHctdKpcJvcGHqvdCpAaaj",164,0.993939,29,165,1,164,1,1,0,1,1,78,77,87,87,3
"218",17,"[29]dJHglqIrHctdKpcJvcGHqvdCpAaaj",165,0.993976,29,166,1,165,1,1,0,1,1,80,79,86,86,3
"219",18,"[29]dJHglqIrHctdKpcJvcGHqvdCpAaaj",165,0.993976,29,166,1,165,1,1,0,1,1,79,78,87,87,3
"220",19,"[29]dJHglqIrHctdKpcJvcGHqvdCpAaaj",168,0.994083,29,169,1,168,1,1,0,1,1,86,85,83,83,3
"221",20,"[29]dJHglqIrHctdKpcJvcGHqvdCpAaaj",169,0.994118,29,170,1,169,1,1,0,1,1,92,91,78,78,3
"222",21,"[29]dJHglqIrHctdKpcJvcGHqvdCpAaaj",164,0.993939,29,165,1,164,1,1,0,1,1,76,75,89,89,3
"223",22,"[29]dJHglqIrHctdKpcJvcGHqvdCpAaaj",169,0.994118,29,170,1,169,1,1,0,1,1,91,90,79,79,3
"224",23,"[29]dJHglqIrHctdKpcJvcGHqvdCpAaaj",164,0.993939,29,165,1,164,1,1,0,1,1,77,76,88,88,3
"225",24,"[29]dJHglqIrHctdKpcJvcGHqvdCpAaaj",168,0.994083,29,169,1,168,1,1,0,1,1,88,87,81,81,3
"226",25,"[29]dJHglqIrHctdKpcJvcGHqvdCpAaaj",164,0.993939,29,165,1,164,1,1,0,1,1,77,76,88,88,3
"227",26,"[29]dJHglqIrHctdKpcJvcGHqvdCpAaaj",169,0.994118,29,170,1,169,1,1,0,1,1,91,90,79,79,3
"228",27,"[29]dJHglqIrHctdKpcJvcGHqvdCpAaaj",168,0.994083,29,169,1,168,1,1,0,1,1,88,87,81,81,3
"229",28,"[29]dJHglqIrHctdKpcJvcGHqvdCpAaaj",166,0.994012,29,167,1,166,1,1,0,1,1,83,82,84,84,3
"230",29,"[29]dJHglqIrHctdKpcJvcGHqvdCpAaaj",167,0.994048,29,168,1,167,1,1,0,1,1,85,84,83,83,3
"231",30,"[29]dJHglqIrHctdKpcJvcGHqvdCpAaaj",168,0.994083,29,169,1,168,1,1,0,1,1,88,87,81,81,3
"232",31,"[29]dJHglqIrHctdKpcJvcGHqvdCpAaaj",171,0.994186,29,172,1,171,1,1,0,1,1,96,95,76,76,3
"233",32,"[29]dJHglqIrHctdKpcJvcGHqvdCpAaaj",161,0.993827,29,162,1,161,1,1,0,1,1,69,68,93,93,3
"234",33,"[29]dJHglqIrHctdKpcJvcGHqvdCpAaaj",167,0.994048,29,168,1,167,1,1,0,1,1,84,83,84,84,3
"235",34,"[29]dJHglqIrHctdKpcJvcGHqvdCpAaaj",170,0.994152,29,171,1,170,1,1,0,1,1,92,91,79,79,3
"236",35,"[29]dJHglqIrHctdKpcJvcGHqvdCpAaaj",166,0.994012,29,167,1,166,1,1,0,1,1,83,82,84,84,3
"237",36,"[29]dJHglqIrHctdKpcJvcGHqvdCpAaaj",169,0.994118,29,170,1,169,1,1,0,1,1,90,89,80,80,3
"238",37,"[29]dJHglqIrHctdKpcJvcGHqvdCpAaaj",166,0.994012,29,167,1,166,1,1,0,1,1,81,80,86,86,3
"239",38,"[29]dJHglqIrHctdKpcJvcGHqvdCpAaaj",163,0.993902,29,164,1,163,1,1,0,1,1,74,73,90,90,3
"240",39,"[29]dJHglqIrHctdKpcJvcGHqvdCpAaaj",165,0.993976,29,166,1,165,1,1,0,1,1,81,80,85,85,3
"241",40,"[29]dJHglqIrHctdKpcJvcGHqvdCpAaaj",168,0.994083,29,169,1,168,1,1,0,1,1,88,87,81,81,3
"242",41,"[29]dJHglqIrHctdKpcJvcGHqvdCpAaaj",167,0.994048,29,168,1,167,1,1,0,1,1,85,84,83,83,3
"243",42,"[29]dJHglqIrHctdKpcJvcGHqvdCpAaaj",167,0.994048,29,168,1,167,1,1,0,1,1,86,85,82,82,3
"244",43,"[29]dJHglqIrHctdKpcJvcGHqvdCpAaaj",169,0.994118,29,170,1,169,1,1,0,1,1,88,87,82,82,3
"245",44,"[29]dJHglqIrHctdKpcJvcGHqvdCpAaaj",169,0.994118,29,170,1,169,1,1,0,1,1,89,88,81,81,3
"246",45,"[29]dJHglqIrHctdKpcJvcGHqvdCpAaaj",164,0.993939,29,165,1,164,1,1,0,1,1,74,73,91,91,3
"247",46,"[29]dJHglqIrHctdKpcJvcGHqvdCpAaaj",171,0.994186,29,172,1,171,1,1,0,1,1,95,94,77,77,3
"248",47,"[29]dJHglqIrHctdKpcJvcGHqvdCpAaaj",168,0.994083,29,169,1,168,1,1,0,1,1,88,87,81,81,3
"249",48,"[29]dJHglqIrHctdKpcJvcGHqvdCpAaaj",168,0.994083,29,169,1,168,1,1,0,1,1,87,86,82,82,3
"250",49,"[29]dJHglqIrHctdKpcJvcGHqvdCpAaaj",172,0.99422,29,173,1,172,1,1,0,1,1,99,98,74,74,3
"251",50,"[29]dJHglqIrHctdKpcJvcGHqvdCpAaaj",167,0.994048,29,168,1,167,1,1,0,1,1,85,84,83,83,3
"252",51,"[29]dJHglqIrHctdKpcJvcGHqvdCpAaaj",165,0.993976,29,166,1,165,1,1,0,1,1,79,78,87,87,3
"253",52,"[29]dJHglqIrHctdKpcJvcGHqvdCpAaaj",165,0.993976,29,166,1,165,1,1,0,1,1,80,79,86,86,3
"254",53,"[29]dJHglqIrHctdKpcJvcGHqvdCpAaaj",167,0.994048,29,168,1,167,1,1,0,1,1,84,83,84,84,3
"255",54,"[29]dJHglqIrHctdKpcJvcGHqvdCpAaaj",169,0.994118,29,170,1,169,1,1,0,1,1,90,89,80,80,3
"256",55,"[29]dJHglqIrHctdKpcJvcGHqvdCpAaaj",167,0.994048,29,168,1,167,1,1,0,1,1,84,83,84,84,3
"257",56,"[29]dJHglqIrHctdKpcJvcGHqvdCpAaaj",164,0.993939,29,165,1,164,1,1,0,1,1,78,77,87,87,3
"258",57,"[29]dJHglqIrHctdKpcJvcGHqvdCpAaaj",169,0.994118,29,170,1,169,1,1,0,1,1,92,91,78,78,3
"259",58,"[29]dJHglqIrHctdKpcJvcGHqvdCpAaaj",170,0.994152,29,171,1,170,1,1,0,1,1,93,92,78,78,3
"260",59,"[29]dJHglqIrHctdKpcJvcGHqvdCpAaaj",163,0.993902,29,164,1,163,1,1,0,1,1,75,74,89,89,3
"261",60,"[29]dJHglqIrHctdKpcJvcGHqvdCpAaaj",173,0.994253,29,174,1,173,1,1,0,1,1,102,101,72,72,3
"262",61,"[29]dJHglqIrHctdKpcJvcGHqvdCpAaaj",163,0.993902,29,164,1,163,1,1,0,1,1,74,73,90,90,3
"263",62,"[29]dJHglqIrHctdKpcJvcGHqvdCpAaaj",166,0.994012,29,167,1,166,1,1,0,1,1,83,82,84,84,3
"264",63,"[29]dJHglqIrHctdKpcJvcGHqvdCpAaaj",173,0.994253,29,174,1,173,1,1,0,1,1,99,98,75,75,3
"265",64,"[29]dJHglqIrHctdKpcJvcGHqvdCpAaaj",167,0.994048,29,168,1,167,1,1,0,1,1,84,83,84,84,3
"266",65,"[29]dJHglqIrHctdKpcJvcGHqvdCpAaaj",167,0.994048,29,168,1,167,1,1,0,1,1,86,85,82,82,3
"267",66,"[29]dJHglqIrHctdKpcJvcGHqvdCpAaaj",165,0.993976,29,166,1,165,1,1,0,1,1,81,80,85,85,3
"268",67,"[29]dJHglqIrHctdKpcJvcGHqvdCpAaaj",170,0.994152,29,171,1,170,1,1,0,1,1,94,93,77,77,3
"269",68,"[29]dJHglqIrHctdKpcJvcGHqvdCpAaaj",168,0.994083,29,169,1,168,1,1,0,1,1,88,87,81,81,3
"270",69,"[29]dJHglqIrHctdKpcJvcGHqvdCpAaaj",169,0.994118,29,170,1,169,1,1,0,1,1,92,91,78,78,3
"271",70,"[29]dJHglqIrHctdKpcJvcGHqvdCpAaaj",165,0.993976,29,166,1,165,1,1,0,1,1,77,76,89,89,3
"272",71,"[29]dJHglqIrHctdKpcJvcGHqvdCpAaaj",170,0.994152,29,171,1,170,1,1,0,1,1,94,93,77,77,3
"273",72,"[29]dJHglqIrHctdKpcJvcGHqvdCpAaaj",169,0.994118,29,170,1,169,1,1,0,1,1,90,89,80,80,3
"274",73,"[29]dJHglqIrHctdKpcJvcGHqvdCpAaaj",169,0.994118,29,170,1,169,1,1,0,1,1,90,89,80,80,3
"275",74,"[29]dJHglqIrHctdKpcJvcGHqvdCpAaaj",165,0.993976,29,166,1,165,1,1,0,1,1,81,80,85,85,3
"276",75,"[29]dJHglqIrHctdKpcJvcGHqvdCpAaaj",165,0.993976,29,166,1,165,1,1,0,1,1,79,78,87,87,3
"277",76,"[29]dJHglqIrHctdKpcJvcGHqvdCpAaaj",168,0.994083,29,169,1,168,1,1,0,1,1,89,88,80,80,3
"278",77,"[29]dJHglqIrHctdKpcJvcGHqvdCpAaaj",167,0.994048,29,168,1,167,1,1,0,1,1,86,85,82,82,3
"279",78,"[29]dJHglqIrHctdKpcJvcGHqvdCpAaaj",166,0.994012,29,167,1,166,1,1,0,1,1,83,82,84,84,3
"280",79,"[29]dJHglqIrHctdKpcJvcGHqvdCpAaaj",166,0.994012,29,167,1,166,1,1,0,1,1,83,82,84,84,3
"281",80,"[29]dJHglqIrHctdKpcJvcGHqvdCpAaaj",173,0.994253,29,174,1,173,1,1,0,1,1,99,98,75,75,3
"282",81,"[29]dJHglqIrHctdKpcJvcGHqvdCpAaaj",166,0.994012,29,167,1,166,1,1,0,1,1,82,81,85,85,3
"283",82,"[29]dJHglqIrHctdKpcJvcGHqvdCpAaaj",163,0.993902,29,164,1,163,1,1,0,1,1,74,73,90,90,3
"284",83,"[29]dJHglqIrHctdKpcJvcGHqvdCpAaaj",164,0.993939,29,165,1,164,1,1,0,1,1,77,76,88,88,3
"285",84,"[29]dJHglqIrHctdKpcJvcGHqvdCpAaaj",161,0.993827,29,162,1,161,1,1,0,1,1,68,67,94,94,3
"286",85,"[29]dJHglqIrHctdKpcJvcGHqvdCpAaaj",167,0.994048,29,168,1,167,1,1,0,1,1,86,85,82,82,3
"287",86,"[29]dJHglqIrHctdKpcJvcGHqvdCpAaaj",169,0.994118,29,170,1,169,1,1,0,1,1,91,90,79,79,3
"288",87,"[29]dJHglqIrHctdKpcJvcGHqvdCpAaaj",172,0.99422,29,173,1,172,1,1,0,1,1,99,98,74,74,3
"289",88,"[29]dJHglqIrHctdKpcJvcGHqvdCpAaaj",166,0.994012,29,167,1,166,1,1,0,1,1,81,80,86,86,3
"290",89,"[29]dJHglqIrHctdKpcJvcGHqvdCpAaaj",164,0.993939,29,165,1,164,1,1,0,1,1,76,75,89,89,3
"291",90,"[29]dJHglqIrHctdKpcJvcGHqvdCpAaaj",170,0.994152,29,171,1,170,1,1,0,1,1,94,93,77,77,3
"292",91,"[29]dJHglqIrHctdKpcJvcGHqvdCpAaaj",165,0.993976,29,166,1,165,1,1,0,1,1,80,79,86,86,3
"293",92,"[29]dJHglqIrHctdKpcJvcGHqvdCpAaaj",169,0.994118,29,170,1,169,1,1,0,1,1,91,90,79,79,3
"294",93,"[29]dJHglqIrHctdKpcJvcGHqvdCpAaaj",163,0.993902,29,164,1,163,1,1,0,1,1,73,72,91,91,3
"295",94,"[29]dJHglqIrHctdKpcJvcGHqvdCpAaaj",163,0.993902,29,164,1,163,1,1,0,1,1,74,73,90,90,3
"296",95,"[29]dJHglqIrHctdKpcJvcGHqvdCpAaaj",168,0.994083,29,169,1,168,1,1,0,1,1,89,88,80,80,3
"297",96,"[29]dJHglqIrHctdKpcJvcGHqvdCpAaaj",165,0.993976,29,166,1,165,1,1,0,1,1,81,80,85,85,3
"298",97,"[29]dJHglqIrHctdKpcJvcGHqvdCpAaaj",164,0.993939,29,165,1,164,1,1,0,1,1,77,76,88,88,3
"299",98,"[29]dJHglqIrHctdKpcJvcGHqvdCpAaaj",169,0.994118,29,170,1,169,1,1,0,1,1,91,90,79,79,3
"300",99,"[29]dJHglqIrHctdKpcJvcGHqvdCpAaaj",167,0.994048,29,168,1,167,1,1,0,1,1,84,83,84,84,3
"301",0,"[27]dJHggqIHcdKocJvcGHqxdCagCgA",167,0.994048,27,168,1,167,1,1,0,1,1,86,85,82,82,4
"302",1,"[27]dJHggqIHcdKocJvcGHqxdCagCgA",165,0.993976,27,166,1,165,1,1,0,1,1,80,79,86,86,4
"303",2,"[27]dJHggqIHcdKocJvcGHqxdCagCgA",169,0.994118,27,170,1,169,1,1,0,1,1,90,89,80,80,4
"304",3,"[27]dJHggqIHcdKocJvcGHqxdCagCgA",168,0.994083,27,169,1,168,1,1,0,1,1,88,87,81,81,4
"305",4,"[27]dJHggqIHcdKocJvcGHqxdCagCgA",166,0.994012,27,167,1,166,1,1,0,1,1,82,81,85,85,4
"306",5,"[27]dJHggqIHcdKocJvcGHqxdCagCgA",170,0.994152,27,171,1,170,1,1,0,1,1,93,92,78,78,4
"307",6,"[27]dJHggqIHcdKocJvcGHqxdCagCgA",164,0.993939,27,165,1,164,1,1,0,1,1,76,75,89,89,4
"308",7,"[27]dJHggqIHcdKocJvcGHqxdCagCgA",164,0.993939,27,165,1,164,1,1,0,1,1,76,75,89,89,4
"309",8,"[27]dJHggqIHcdKocJvcGHqxdCagCgA",163,0.993902,27,164,1,163,1,1,0,1,1,73,72,91,91,4
"310",9,"[27]dJHggqIHcdKocJvcGHqxdCagCgA",163,0.993902,27,164,1,163,1,1,0,1,1,75,74,89,89,4
"311",10,"[27]dJHggqIHcdKocJvcGHqxdCagCgA",164,0.993939,27,165,1,164,1,1,0,1,1,76,75,89,89,4
"312",11,"[27]dJHggqIHcdKocJvcGHqxdCagCgA",169,0.994118,27,170,1,169,1,1,0,1,1,91,90,79,79,4
"313",12,"[27]dJHggqIHcdKocJvcGHqxdCagCgA",169,0.994118,27,170,1,169,1,1,0,1,1,90,89,80,80,4
"314",13,"[27]dJHggqIHcdKocJvcGHqxdCagCgA",168,0.994083,27,169,1,168,1,1,0,1,1,87,86,82,82,4
"315",14,"[27]dJHggqIHcdKocJvcGHqxdCagCgA",163,0.993902,27,164,1,163,1,1,0,1,1,74,73,90,90,4
"316",15,"[27]dJHggqIHcdKocJvcGHqxdCagCgA",166,0.994012,27,167,1,166,1,1,0,1,1,81,80,86,86,4
"317",16,"[27]dJHggqIHcdKocJvcGHqxdCagCgA",168,0.994083,27,169,1,168,1,1,0,1,1,87,86,82,82,4
"318",17,"[27]dJHggqIHcdKocJvcGHqxdCagCgA",166,0.994012,27,167,1,166,1,1,0,1,1,81,80,86,86,4
"319",18,"[27]dJHggqIHcdKocJvcGHqxdCagCgA",169,0.994118,27,170,1,169,1,1,0,1,1,90,89,80,80,4
"320",19,"[27]dJHggqIHcdKocJvcGHqxdCagCgA",167,0.994048,27,168,1,167,1,1,0,1,1,85,84,83,83,4
"321",20,"[27]dJHggqIHcdKocJvcGHqxdCagCgA",174,0.994286,27,175,1,174,1,1,0,1,1,103,102,72,72,4
"322",21,"[27]dJHggqIHcdKocJvcGHqxdCagCgA",165,0.993976,27,166,1,165,1,1,0,1,1,80,79,86,86,4
"323",22,"[27]dJHggqIHcdKocJvcGHqxdCagCgA",165,0.993976,27,166,1,165,1,1,0,1,1,80,79,86,86,4
"324",23,"[27]dJHggqIHcdKocJvcGHqxdCagCgA",168,0.994083,27,169,1,168,1,1,0,1,1,88,87,81,81,4
"325",24,"[27]dJHggqIHcdKocJvcGHqxdCagCgA",167,0.994048,27,168,1,167,1,1,0,1,1,84,83,84,84,4
"326",25,"[27]dJHggqIHcdKocJvcGHqxdCagCgA",169,0.994118,27,170,1,169,1,1,0,1,1,91,90,79,79,4
"327",26,"[27]dJHggqIHcdKocJvcGHqxdCagCgA",167,0.994048,27,168,1,167,1,1,0,1,1,86,85,82,82,4
"328",27,"[27]dJHggqIHcdKocJvcGHqxdCagCgA",168,0.994083,27,169,1,168,1,1,0,1,1,87,86,82,82,4
"329",28,"[27]dJHggqIHcdKocJvcGHqxdCagCgA",169,0.994118,27,170,1,169,1,1,0,1,1,88,87,82,82,4
"330",29,"[27]dJHggqIHcdKocJvcGHqxdCagCgA",165,0.993976,27,166,1,165,1,1,0,1,1,80,79,86,86,4
"331",30,"[27]dJHggqIHcdKocJvcGHqxdCagCgA",164,0.993939,27,165,1,164,1,1,0,1,1,77,76,88,88,4
"332",31,"[27]dJHggqIHcdKocJvcGHqxdCagCgA",163,0.993902,27,164,1,163,1,1,0,1,1,75,74,89,89,4
"333",32,"[27]dJHggqIHcdKocJvcGHqxdCagCgA",166,0.994012,27,167,1,166,1,1,0,1,1,81,80,86,86,4
"334",33,"[27]dJHggqIHcdKocJvcGHqxdCagCgA",170,0.994152,27,171,1,170,1,1,0,1,1,89,88,82,82,4
"335",34,"[27]dJHggqIHcdKocJvcGHqxdCagCgA",163,0.993902,27,164,1,163,1,1,0,1,1,75,74,89,89,4
"336",35,"[27]dJHggqIHcdKocJvcGHqxdCagCgA",164,0.993939,27,165,1,164,1,1,0,1,1,76,75,89,89,4
"337",36,"[27]dJHggqIHcdKocJvcGHqxdCagCgA",170,0.994152,27,171,1,170,1,1,0,1,1,94,93,77,77,4
"338",37,"[27]dJHggqIHcdKocJvcGHqxdCagCgA",168,0.994083,27,169,1,168,1,1,0,1,1,88,87,81,81,4
"339",38,"[27]dJHggqIHcdKocJvcGHqxdCagCgA",164,0.993939,27,165,1,164,1,1,0,1,1,77,76,88,88,4
"340",39,"[27]dJHggqIHcdKocJvcGHqxdCagCgA",165,0.993976,27,166,1,165,1,1,0,1,1,80,79,86,86,4
"341",40,"[27]dJHggqIHcdKocJvcGHqxdCagCgA",166,0.994012,27,167,1,166,1,1,0,1,1,82,81,85,85,4
"342",41,"[27]dJHggqIHcdKocJvcGHqxdCagCgA",165,0.993976,27,166,1,165,1,1,0,1,1,79,78,87,87,4
"343",42,"[27]dJHggqIHcdKocJvcGHqxdCagCgA",169,0.994118,27,170,1,169,1,1,0,1,1,91,90,79,79,4
"344",43,"[27]dJHggqIHcdKocJvcGHqxdCagCgA",167,0.994048,27,168,1,167,1,1,0,1,1,82,81,86,86,4
"345",44,"[27]dJHggqIHcdKocJvcGHqxdCagCgA",166,0.994012,27,167,1,166,1,1,0,1,1,81,80,86,86,4
"346",45,"[27]dJHggqIHcdKocJvcGHqxdCagCgA",166,0.994012,27,167,1,166,1,1,0,1,1,83,82,84,84,4
"347",46,"[27]dJHggqIHcdKocJvcGHqxdCagCgA",168,0.994083,27,169,1,168,1,1,0,1,1,87,86,82,82,4
"348",47,"[27]dJHggqIHcdKocJvcGHqxdCagCgA",166,0.994012,27,167,1,166,1,1,0,1,1,82,81,85,85,4
"349",48,"[27]dJHggqIHcdKocJvcGHqxdCagCgA",167,0.994048,27,168,1,167,1,1,0,1,1,85,84,83,83,4
"350",49,"[27]dJHggqIHcdKocJvcGHqxdCagCgA",167,0.994048,27,168,1,167,1,1,0,1,1,84,83,84,84,4
"351",50,"[27]dJHggqIHcdKocJvcGHqxdCagCgA",163,0.993902,27,164,1,163,1,1,0,1,1,74,73,90,90,4
"352",51,"[27]dJHggqIHcdKocJvcGHqxdCagCgA",166,0.994012,27,167,1,166,1,1,0,1,1,82,81,85,85,4
"353",52,"[27]dJHggqIHcdKocJvcGHqxdCagCgA",164,0.993939,27,165,1,164,1,1,0,1,1,77,76,88,88,4
"354",53,"[27]dJHggqIHcdKocJvcGHqxdCagCgA",168,0.994083,27,169,1,168,1,1,0,1,1,88,87,81,81,4
"355",54,"[27]dJHggqIHcdKocJvcGHqxdCagCgA",173,0.994253,27,174,1,173,1,1,0,1,1,100,99,74,74,4
"356",55,"[27]dJHggqIHcdKocJvcGHqxdCagCgA",167,0.994048,27,168,1,167,1,1,0,1,1,86,85,82,82,4
"357",56,"[27]dJHggqIHcdKocJvcGHqxdCagCgA",168,0.994083,27,169,1,168,1,1,0,1,1,88,87,81,81,4
"358",57,"[27]dJHggqIHcdKocJvcGHqxdCagCgA",162,0.993865,27,163,1,162,1,1,0,1,1,71,70,92,92,4
"359",58,"[27]dJHggqIHcdKocJvcGHqxdCagCgA",166,0.994012,27,167,1,166,1,1,0,1,1,82,81,85,85,4
"360",59,"[27]dJHggqIHcdKocJvcGHqxdCagCgA",166,0.994012,27,167,1,166,1,1,0,1,1,82,81,85,85,4
"361",60,"[27]dJHggqIHcdKocJvcGHqxdCagCgA",166,0.994012,27,167,1,166,1,1,0,1,1,82,81,85,85,4
"362",61,"[27]dJHggqIHcdKocJvcGHqxdCagCgA",165,0.993976,27,166,1,165,1,1,0,1,1,79,78,87,87,4
"363",62,"[27]dJHggqIHcdKocJvcGHqxdCagCgA",165,0.993976,27,166,1,165,1,1,0,1,1,80,79,86,86,4
"364",63,"[27]dJHggqIHcdKocJvcGHqxdCagCgA",167,0.994048,27,168,1,167,1,1,0,1,1,84,83,84,84,4
"365",64,"[27]dJHggqIHcdKocJvcGHqxdCagCgA",170,0.994152,27,171,1,170,1,1,0,1,1,92,91,79,79,4
"366",65,"[27]dJHggqIHcdKocJvcGHqxdCagCgA",166,0.994012,27,167,1,166,1,1,0,1,1,82,81,85,85,4
"367",66,"[27]dJHggqIHcdKocJvcGHqxdCagCgA",175,0.994318,27,176,1,175,1,1,0,1,1,105,104,71,71,4
"368",67,"[27]dJHggqIHcdKocJvcGHqxdCagCgA",168,0.994083,27,169,1,168,1,1,0,1,1,87,86,82,82,4
"369",68,"[27]dJHggqIHcdKocJvcGHqxdCagCgA",166,0.994012,27,167,1,166,1,1,0,1,1,80,79,87,87,4
"370",69,"[27]dJHggqIHcdKocJvcGHqxdCagCgA",166,0.994012,27,167,1,166,1,1,0,1,1,82,81,85,85,4
"371",70,"[27]dJHggqIHcdKocJvcGHqxdCagCgA",166,0.994012,27,167,1,166,1,1,0,1,1,81,80,86,86,4
"372",71,"[27]dJHggqIHcdKocJvcGHqxdCagCgA",167,0.994048,27,168,1,167,1,1,0,1,1,83,82,85,85,4
"373",72,"[27]dJHggqIHcdKocJvcGHqxdCagCgA",165,0.993976,27,166,1,165,1,1,0,1,1,79,78,87,87,4
"374",73,"[27]dJHggqIHcdKocJvcGHqxdCagCgA",169,0.994118,27,170,1,169,1,1,0,1,1,90,89,80,80,4
"375",74,"[27]dJHggqIHcdKocJvcGHqxdCagCgA",167,0.994048,27,168,1,167,1,1,0,1,1,84,83,84,84,4
"376",75,"[27]dJHggqIHcdKocJvcGHqxdCagCgA",170,0.994152,27,171,1,170,1,1,0,1,1,93,92,78,78,4
"377",76,"[27]dJHggqIHcdKocJvcGHqxdCagCgA",164,0.993939,27,165,1,164,1,1,0,1,1,76,75,89,89,4
"378",77,"[27]dJHggqIHcdKocJvcGHqxdCagCgA",165,0.993976,27,166,1,165,1,1,0,1,1,80,79,86,86,4
"379",78,"[27]dJHggqIHcdKocJvcGHqxdCagCgA",172,0.99422,27,173,1,172,1,1,0,1,1,96,95,77,77,4
"380",79,"[27]dJHggqIHcdKocJvcGHqxdCagCgA",167,0.994048,27,168,1,167,1,1,0,1,1,83,82,85,85,4
"381",80,"[27]dJHggqIHcdKocJvcGHqxdCagCgA",171,0.994186,27,172,1,171,1,1,0,1,1,95,94,77,77,4
"382",81,"[27]dJHggqIHcdKocJvcGHqxdCagCgA",167,0.994048,27,168,1,167,1,1,0,1,1,85,84,83,83,4
"383",82,"[27]dJHggqIHcdKocJvcGHqxdCagCgA",171,0.994186,27,172,1,171,1,1,0,1,1,95,94,77,77,4
"384",83,"[27]dJHggqIHcdKocJvcGHqxdCagCgA",166,0.994012,27,167,1,166,1,1,0,1,1,83,82,84,84,4
"385",84,"[27]dJHggqIHcdKocJvcGHqxdCagCgA",167,0.994048,27,168,1,167,1,1,0,1,1,83,82,85,85,4
"386",85,"[27]dJHggqIHcdKocJvcGHqxdCagCgA",166,0.994012,27,167,1,166,1,1,0,1,1,81,80,86,86,4
"387",86,"[27]dJHggqIHcdKocJvcGHqxdCagCgA",171,0.994186,27,172,1,171,1,1,0,1,1,94,93,78,78,4
"388",87,"[27]dJHggqIHcdKocJvcGHqxdCagCgA",171,0.994186,27,172,1,171,1,1,0,1,1,96,95,76,76,4
"389",88,"[27]dJHggqIHcdKocJvcGHqxdCagCgA",164,0.993939,27,165,1,164,1,1,0,1,1,77,76,88,88,4
"390",89,"[27]dJHggqIHcdKocJvcGHqxdCagCgA",169,0.994118,27,170,1,169,1,1,0,1,1,89,88,81,81,4
"391",90,"[27]dJHggqIHcdKocJvcGHqxdCagCgA",169,0.994118,27,170,1,169,1,1,0,1,1,90,89,80,80,4
"392",91,"[27]dJHggqIHcdKocJvcGHqxdCagCgA",163,0.993902,27,164,1,163,1,1,0,1,1,72,71,92,92,4
"393",92,"[27]dJHggqIHcdKocJvcGHqxdCagCgA",168,0.994083,27,169,1,168,1,1,0,1,1,88,87,81,81,4
"394",93,"[27]dJHggqIHcdKocJvcGHqxdCagCgA",166,0.994012,27,167,1,166,1,1,0,1,1,81,80,86,86,4
"395",94,"[27]dJHggqIHcdKocJvcGHqxdCagCgA",164,0.993939,27,165,1,164,1,1,0,1,1,76,75,89,89,4
"396",95,"[27]dJHggqIHcdKocJvcGHqxdCagCgA",165,0.993976,27,166,1,165,1,1,0,1,1,78,77,88,88,4
"397",96,"[27]dJHggqIHcdKocJvcGHqxdCagCgA",169,0.994118,27,170,1,169,1,1,0,1,1,91,90,79,79,4
"398",97,"[27]dJHggqIHcdKocJvcGHqxdCagCgA",169,0.994118,27,170,1,169,1,1,0,1,1,89,88,81,81,4
"399",98,"[27]dJHggqIHcdKocJvcGHqxdCagCgA",169,0.994118,27,170,1,169,1,1,0,1,1,91,90,79,79,4
"400",99,"[27]dJHggqIHcdKocJvcGHqxdCagCgA",167,0.994048,27,168,1,167,1,1,0,1,1,86,85,82,82,4
"401",0,"[27]kJHggqIqHcidKpcJvcGHqFdCioa",179,0.994444,27,180,1,179,1,1,0,1,1,101,100,79,79,5
"402",1,"[27]kJHggqIqHcidKpcJvcGHqFdCioa",182,0.994536,27,183,1,182,1,1,0,1,1,110,109,73,73,5
"403",2,"[27]kJHggqIqHcidKpcJvcGHqFdCioa",171,0.994186,27,172,1,171,1,1,0,1,1,73,72,99,99,5
"404",3,"[27]kJHggqIqHcidKpcJvcGHqFdCioa",178,0.994413,27,179,1,178,1,1,0,1,1,93,92,86,86,5
"405",4,"[27]kJHggqIqHcidKpcJvcGHqFdCioa",177,0.994382,27,178,1,177,1,1,0,1,1,92,91,86,86,5
"406",5,"[27]kJHggqIqHcidKpcJvcGHqFdCioa",178,0.994413,27,179,1,178,1,1,0,1,1,96,95,83,83,5
"407",6,"[27]kJHggqIqHcidKpcJvcGHqFdCioa",178,0.994413,27,179,1,178,1,1,0,1,1,95,94,84,84,5
"408",7,"[27]kJHggqIqHcidKpcJvcGHqFdCioa",176,0.99435,27,177,1,176,1,1,0,1,1,88,87,89,89,5
"409",8,"[27]kJHggqIqHcidKpcJvcGHqFdCioa",179,0.994444,27,180,1,179,1,1,0,1,1,99,98,81,81,5
"410",9,"[27]kJHggqIqHcidKpcJvcGHqFdCioa",174,0.994286,27,175,1,174,1,1,0,1,1,84,83,91,91,5
"411",10,"[27]kJHggqIqHcidKpcJvcGHqFdCioa",177,0.994382,27,178,1,177,1,1,0,1,1,91,90,87,87,5
"412",11,"[27]kJHggqIqHcidKpcJvcGHqFdCioa",175,0.994318,27,176,1,175,1,1,0,1,1,84,83,92,92,5
"413",12,"[27]kJHggqIqHcidKpcJvcGHqFdCioa",178,0.994413,27,179,1,178,1,1,0,1,1,97,96,82,82,5
"414",13,"[27]kJHggqIqHcidKpcJvcGHqFdCioa",177,0.994382,27,178,1,177,1,1,0,1,1,92,91,86,86,5
"415",14,"[27]kJHggqIqHcidKpcJvcGHqFdCioa",179,0.994444,27,180,1,179,1,1,0,1,1,98,97,82,82,5
"416",15,"[27]kJHggqIqHcidKpcJvcGHqFdCioa",175,0.994318,27,176,1,175,1,1,0,1,1,87,86,89,89,5
"417",16,"[27]kJHggqIqHcidKpcJvcGHqFdCioa",177,0.994382,27,178,1,177,1,1,0,1,1,93,92,85,85,5
"418",17,"[27]kJHggqIqHcidKpcJvcGHqFdCioa",176,0.99435,27,177,1,176,1,1,0,1,1,88,87,89,89,5
"419",18,"[27]kJHggqIqHcidKpcJvcGHqFdCioa",171,0.994186,27,172,1,171,1,1,0,1,1,73,72,99,99,5
"420",19,"[27]kJHggqIqHcidKpcJvcGHqFdCioa",178,0.994413,27,179,1,178,1,1,0,1,1,95,94,84,84,5
"421",20,"[27]kJHggqIqHcidKpcJvcGHqFdCioa",174,0.994286,27,175,1,174,1,1,0,1,1,82,81,93,93,5
"422",21,"[27]kJHggqIqHcidKpcJvcGHqFdCioa",178,0.994413,27,179,1,178,1,1,0,1,1,97,96,82,82,5
"423",22,"[27]kJHggqIqHcidKpcJvcGHqFdCioa",180,0.994475,27,181,1,180,1,1,0,1,1,103,102,78,78,5
"424",23,"[27]kJHggqIqHcidKpcJvcGHqFdCioa",178,0.994413,27,179,1,178,1,1,0,1,1,97,96,82,82,5
"425",24,"[27]kJHggqIqHcidKpcJvcGHqFdCioa",179,0.994444,27,180,1,179,1,1,0,1,1,99,98,81,81,5
"426",25,"[27]kJHggqIqHcidKpcJvcGHqFdCioa",174,0.994286,27,175,1,174,1,1,0,1,1,82,81,93,93,5
"427",26,"[27]kJHggqIqHcidKpcJvcGHqFdCioa",175,0.994318,27,176,1,175,1,1,0,1,1,86,85,90,90,5
"428",27,"[27]kJHggqIqHcidKpcJvcGHqFdCioa",178,0.994413,27,179,1,178,1,1,0,1,1,95,94,84,84,5
"429",28,"[27]kJHggqIqHcidKpcJvcGHqFdCioa",176,0.99435,27,177,1,176,1,1,0,1,1,90,89,87,87,5
"430",29,"[27]kJHggqIqHcidKpcJvcGHqFdCioa",175,0.994318,27,176,1,175,1,1,0,1,1,87,86,89,89,5
"431",30,"[27]kJHggqIqHcidKpcJvcGHqFdCioa",178,0.994413,27,179,1,178,1,1,0,1,1,96,95,83,83,5
"432",31,"[27]kJHggqIqHcidKpcJvcGHqFdCioa",172,0.99422,27,173,1,172,1,1,0,1,1,76,75,97,97,5
"433",32,"[27]kJHggqIqHcidKpcJvcGHqFdCioa",171,0.994186,27,172,1,171,1,1,0,1,1,72,71,100,100,5
"434",33,"[27]kJHggqIqHcidKpcJvcGHqFdCioa",177,0.994382,27,178,1,177,1,1,0,1,1,93,92,85,85,5
"435",34,"[27]kJHggqIqHcidKpcJvcGHqFdCioa",174,0.994286,27,175,1,174,1,1,0,1,1,80,79,95,95,5
"436",35,"[27]kJHggqIqHcidKpcJvcGHqFdCioa",178,0.994413,27,179,1,178,1,1,0,1,1,96,95,83,83,5
"437",36,"[27]kJHggqIqHcidKpcJvcGHqFdCioa",177,0.994382,27,178,1,177,1,1,0,1,1,92,91,86,86,5
"438",37,"[27]kJHggqIqHcidKpcJvcGHqFdCioa",180,0.994475,27,181,1,180,1,1,0,1,1,102,101,79,79,5
"439",38,"[27]kJHggqIqHcidKpcJvcGHqFdCioa",177,0.994382,27,178,1,177,1,1,0,1,1,93,92,85,85,5
"440",39,"[27]kJHggqIqHcidKpcJvcGHqFdCioa",172,0.99422,27,173,1,172,1,1,0,1,1,75,74,98,98,5
"441",40,"[27]kJHggqIqHcidKpcJvcGHqFdCioa",178,0.994413,27,179,1,178,1,1,0,1,1,97,96,82,82,5
"442",41,"[27]kJHggqIqHcidKpcJvcGHqFdCioa",175,0.994318,27,176,1,175,1,1,0,1,1,87,86,89,89,5
"443",42,"[27]kJHggqIqHcidKpcJvcGHqFdCioa",177,0.994382,27,178,1,177,1,1,0,1,1,91,90,87,87,5
"444",43,"[27]kJHggqIqHcidKpcJvcGHqFdCioa",175,0.994318,27,176,1,175,1,1,0,1,1,86,85,90,90,5
"445",44,"[27]kJHggqIqHcidKpcJvcGHqFdCioa",173,0.994253,27,174,1,173,1,1,0,1,1,79,78,95,95,5
"446",45,"[27]kJHggqIqHcidKpcJvcGHqFdCioa",172,0.99422,27,173,1,172,1,1,0,1,1,77,76,96,96,5
"447",46,"[27]kJHggqIqHcidKpcJvcGHqFdCioa",173,0.994253,27,174,1,173,1,1,0,1,1,80,79,94,94,5
"448",47,"[27]kJHggqIqHcidKpcJvcGHqFdCioa",175,0.994318,27,176,1,175,1,1,0,1,1,84,83,92,92,5
"449",48,"[27]kJHggqIqHcidKpcJvcGHqFdCioa",179,0.994444,27,180,1,179,1,1,0,1,1,98,97,82,82,5
"450",49,"[27]kJHggqIqHcidKpcJvcGHqFdCioa",178,0.994413,27,179,1,178,1,1,0,1,1,94,93,85,85,5
"451",50,"[27]kJHggqIqHcidKpcJvcGHqFdCioa",175,0.994318,27,176,1,175,1,1,0,1,1,87,86,89,89,5
"452",51,"[27]kJHggqIqHcidKpcJvcGHqFdCioa",177,0.994382,27,178,1,177,1,1,0,1,1,92,91,86,86,5
"453",52,"[27]kJHggqIqHcidKpcJvcGHqFdCioa",178,0.994413,27,179,1,178,1,1,0,1,1,94,93,85,85,5
"454",53,"[27]kJHggqIqHcidKpcJvcGHqFdCioa",176,0.99435,27,177,1,176,1,1,0,1,1,90,89,87,87,5
"455",54,"[27]kJHggqIqHcidKpcJvcGHqFdCioa",174,0.994286,27,175,1,174,1,1,0,1,1,83,82,92,92,5
"456",55,"[27]kJHggqIqHcidKpcJvcGHqFdCioa",176,0.99435,27,177,1,176,1,1,0,1,1,90,89,87,87,5
"457",56,"[27]kJHggqIqHcidKpcJvcGHqFdCioa",175,0.994318,27,176,1,175,1,1,0,1,1,87,86,89,89,5
"458",57,"[27]kJHggqIqHcidKpcJvcGHqFdCioa",177,0.994382,27,178,1,177,1,1,0,1,1,91,90,87,87,5
"459",58,"[27]kJHggqIqHcidKpcJvcGHqFdCioa",181,0.994505,27,182,1,181,1,1,0,1,1,107,106,75,75,5
"460",59,"[27]kJHggqIqHcidKpcJvcGHqFdCioa",176,0.99435,27,177,1,176,1,1,0,1,1,89,88,88,88,5
"461",60,"[27]kJHggqIqHcidKpcJvcGHqFdCioa",176,0.99435,27,177,1,176,1,1,0,1,1,90,89,87,87,5
"462",61,"[27]kJHggqIqHcidKpcJvcGHqFdCioa",175,0.994318,27,176,1,175,1,1,0,1,1,85,84,91,91,5
"463",62,"[27]kJHggqIqHcidKpcJvcGHqFdCioa",176,0.99435,27,177,1,176,1,1,0,1,1,90,89,87,87,5
"464",63,"[27]kJHggqIqHcidKpcJvcGHqFdCioa",177,0.994382,27,178,1,177,1,1,0,1,1,93,92,85,85,5
"465",64,"[27]kJHggqIqHcidKpcJvcGHqFdCioa",175,0.994318,27,176,1,175,1,1,0,1,1,86,85,90,90,5
"466",65,"[27]kJHggqIqHcidKpcJvcGHqFdCioa",179,0.994444,27,180,1,179,1,1,0,1,1,99,98,81,81,5
"467",66,"[27]kJHggqIqHcidKpcJvcGHqFdCioa",174,0.994286,27,175,1,174,1,1,0,1,1,84,83,91,91,5
"468",67,"[27]kJHggqIqHcidKpcJvcGHqFdCioa",176,0.99435,27,177,1,176,1,1,0,1,1,90,89,87,87,5
"469",68,"[27]kJHggqIqHcidKpcJvcGHqFdCioa",176,0.99435,27,177,1,176,1,1,0,1,1,90,89,87,87,5
"470",69,"[27]kJHggqIqHcidKpcJvcGHqFdCioa",174,0.994286,27,175,1,174,1,1,0,1,1,81,80,94,94,5
"471",70,"[27]kJHggqIqHcidKpcJvcGHqFdCioa",174,0.994286,27,175,1,174,1,1,0,1,1,83,82,92,92,5
"472",71,"[27]kJHggqIqHcidKpcJvcGHqFdCioa",175,0.994318,27,176,1,175,1,1,0,1,1,86,85,90,90,5
"473",72,"[27]kJHggqIqHcidKpcJvcGHqFdCioa",174,0.994286,27,175,1,174,1,1,0,1,1,84,83,91,91,5
"474",73,"[27]kJHggqIqHcidKpcJvcGHqFdCioa",175,0.994318,27,176,1,175,1,1,0,1,1,84,83,92,92,5
"475",74,"[27]kJHggqIqHcidKpcJvcGHqFdCioa",177,0.994382,27,178,1,177,1,1,0,1,1,93,92,85,85,5
"476",75,"[27]kJHggqIqHcidKpcJvcGHqFdCioa",175,0.994318,27,176,1,175,1,1,0,1,1,85,84,91,91,5
"477",76,"[27]kJHggqIqHcidKpcJvcGHqFdCioa",175,0.994318,27,176,1,175,1,1,0,1,1,86,85,90,90,5
"478",77,"[27]kJHggqIqHcidKpcJvcGHqFdCioa",174,0.994286,27,175,1,174,1,1,0,1,1,83,82,92,92,5
"479",78,"[27]kJHggqIqHcidKpcJvcGHqFdCioa",174,0.994286,27,175,1,174,1,1,0,1,1,82,81,93,93,5
"480",79,"[27]kJHggqIqHcidKpcJvcGHqFdCioa",172,0.99422,27,173,1,172,1,1,0,1,1,76,75,97,97,5
"481",80,"[27]kJHggqIqHcidKpcJvcGHqFdCioa",174,0.994286,27,175,1,174,1,1,0,1,1,84,83,91,91,5
"482",81,"[27]kJHggqIqHcidKpcJvcGHqFdCioa",172,0.99422,27,173,1,172,1,1,0,1,1,76,75,97,97,5
"483",82,"[27]kJHggqIqHcidKpcJvcGHqFdCioa",175,0.994318,27,176,1,175,1,1,0,1,1,85,84,91,91,5
"484",83,"[27]kJHggqIqHcidKpcJvcGHqFdCioa",179,0.994444,27,180,1,179,1,1,0,1,1,95,94,85,85,5
"485",84,"[27]kJHggqIqHcidKpcJvcGHqFdCioa",175,0.994318,27,176,1,175,1,1,0,1,1,86,85,90,90,5
"486",85,"[27]kJHggqIqHcidKpcJvcGHqFdCioa",174,0.994286,27,175,1,174,1,1,0,1,1,83,82,92,92,5
"487",86,"[27]kJHggqIqHcidKpcJvcGHqFdCioa",176,0.99435,27,177,1,176,1,1,0,1,1,91,90,86,86,5
"488",87,"[27]kJHggqIqHcidKpcJvcGHqFdCioa",178,0.994413,27,179,1,178,1,1,0,1,1,97,96,82,82,5
"489",88,"[27]kJHggqIqHcidKpcJvcGHqFdCioa",176,0.99435,27,177,1,176,1,1,0,1,1,91,90,86,86,5
"490",89,"[27]kJHggqIqHcidKpcJvcGHqFdCioa",172,0.99422,27,173,1,172,1,1,0,1,1,76,75,97,97,5
"491",90,"[27]kJHggqIqHcidKpcJvcGHqFdCioa",174,0.994286,27,175,1,174,1,1,0,1,1,81,80,94,94,5
"492",91,"[27]kJHggqIqHcidKpcJvcGHqFdCioa",175,0.994318,27,176,1,175,1,1,0,1,1,85,84,91,91,5
"493",92,"[27]kJHggqIqHcidKpcJvcGHqFdCioa",176,0.99435,27,177,1,176,1,1,0,1,1,89,88,88,88,5
"494",93,"[27]kJHggqIqHcidKpcJvcGHqFdCioa",175,0.994318,27,176,1,175,1,1,0,1,1,85,84,91,91,5
"495",94,"[27]kJHggqIqHcidKpcJvcGHqFdCioa",174,0.994286,27,175,1,174,1,1,0,1,1,82,81,93,93,5
"496",95,"[27]kJHggqIqHcidKpcJvcGHqFdCioa",176,0.99435,27,177,1,176,1,1,0,1,1,88,87,89,89,5
"497",96,"[27]kJHggqIqHcidKpcJvcGHqFdCioa",178,0.994413,27,179,1,178,1,1,0,1,1,95,94,84,84,5
"498",97,"[27]kJHggqIqHcidKpcJvcGHqFdCioa",177,0.994382,27,178,1,177,1,1,0,1,1,92,91,86,86,5
"499",98,"[27]kJHggqIqHcidKpcJvcGHqFdCioa",178,0.994413,27,179,1,178,1,1,0,1,1,95,94,84,84,5
"500",99,"[27]kJHggqIqHcidKpcJvcGHqFdCioa",176,0.99435,27,177,1,176,1,1,0,1,1,89,88,88,88,5
"501",0,"[34]fJHiqwIHBvuldKocJvcGHqFdClwGlexuep",176,0.99435,34,177,1,176,1,1,0,1,1,92,91,85,85,6
"502",1,"[34]fJHiqwIHBvuldKocJvcGHqFdClwGlexuep",171,0.994186,34,172,1,171,1,1,0,1,1,72,71,100,100,6
"503",2,"[34]fJHiqwIHBvuldKocJvcGHqFdClwGlexuep",175,0.994318,34,176,1,175,1,1,0,1,1,85,84,91,91,6
"504",3,"[34]fJHiqwIHBvuldKocJvcGHqFdClwGlexuep",176,0.99435,34,177,1,176,1,1,0,1,1,91,90,86,86,6
"505",4,"[34]fJHiqwIHBvuldKocJvcGHqFdClwGlexuep",176,0.99435,34,177,1,176,1,1,0,1,1,91,90,86,86,6
"506",5,"[34]fJHiqwIHBvuldKocJvcGHqFdClwGlexuep",176,0.99435,34,177,1,176,1,1,0,1,1,88,87,89,89,6
"507",6,"[34]fJHiqwIHBvuldKocJvcGHqFdClwGlexuep",174,0.994286,34,175,1,174,1,1,0,1,1,80,79,95,95,6
"508",7,"[34]fJHiqwIHBvuldKocJvcGHqFdClwGlexuep",178,0.994413,34,179,1,178,1,1,0,1,1,98,97,81,81,6
"509",8,"[34]fJHiqwIHBvuldKocJvcGHqFdClwGlexuep",174,0.994286,34,175,1,174,1,1,0,1,1,83,82,92,92,6
"510",9,"[34]fJHiqwIHBvuldKocJvcGHqFdClwGlexuep",172,0.99422,34,173,1,172,1,1,0,1,1,77,76,96,96,6
"511",10,"[34]fJHiqwIHBvuldKocJvcGHqFdClwGlexuep",175,0.994318,34,176,1,175,1,1,0,1,1,88,87,88,88,6
"512",11,"[34]fJHiqwIHBvuldKocJvcGHqFdClwGlexuep",177,0.994382,34,178,1,177,1,1,0,1,1,94,93,84,84,6
"513",12,"[34]fJHiqwIHBvuldKocJvcGHqFdClwGlexuep",175,0.994318,34,176,1,175,1,1,0,1,1,88,87,88,88,6
"514",13,"[34]fJHiqwIHBvuldKocJvcGHqFdClwGlexuep",173,0.994253,34,174,1,173,1,1,0,1,1,80,79,94,94,6
"515",14,"[34]fJHiqwIHBvuldKocJvcGHqFdClwGlexuep",176,0.99435,34,177,1,176,1,1,0,1,1,91,90,86,86,6
"516",15,"[34]fJHiqwIHBvuldKocJvcGHqFdClwGlexuep",175,0.994318,34,176,1,175,1,1,0,1,1,85,84,91,91,6
"517",16,"[34]fJHiqwIHBvuldKocJvcGHqFdClwGlexuep",176,0.99435,34,177,1,176,1,1,0,1,1,90,89,87,87,6
"518",17,"[34]fJHiqwIHBvuldKocJvcGHqFdClwGlexuep",176,0.99435,34,177,1,176,1,1,0,1,1,92,91,85,85,6
"519",18,"[34]fJHiqwIHBvuldKocJvcGHqFdClwGlexuep",174,0.994286,34,175,1,174,1,1,0,1,1,83,82,92,92,6
"520",19,"[34]fJHiqwIHBvuldKocJvcGHqFdClwGlexuep",176,0.99435,34,177,1,176,1,1,0,1,1,90,89,87,87,6
"521",20,"[34]fJHiqwIHBvuldKocJvcGHqFdClwGlexuep",172,0.99422,34,173,1,172,1,1,0,1,1,78,77,95,95,6
"522",21,"[34]fJHiqwIHBvuldKocJvcGHqFdClwGlexuep",175,0.994318,34,176,1,175,1,1,0,1,1,87,86,89,89,6
"523",22,"[34]fJHiqwIHBvuldKocJvcGHqFdClwGlexuep",175,0.994318,34,176,1,175,1,1,0,1,1,87,86,89,89,6
"524",23,"[34]fJHiqwIHBvuldKocJvcGHqFdClwGlexuep",176,0.99435,34,177,1,176,1,1,0,1,1,91,90,86,86,6
"525",24,"[34]fJHiqwIHBvuldKocJvcGHqFdClwGlexuep",174,0.994286,34,175,1,174,1,1,0,1,1,84,83,91,91,6
"526",25,"[34]fJHiqwIHBvuldKocJvcGHqFdClwGlexuep",174,0.994286,34,175,1,174,1,1,0,1,1,83,82,92,92,6
"527",26,"[34]fJHiqwIHBvuldKocJvcGHqFdClwGlexuep",178,0.994413,34,179,1,178,1,1,0,1,1,98,97,81,81,6
"528",27,"[34]fJHiqwIHBvuldKocJvcGHqFdClwGlexuep",178,0.994413,34,179,1,178,1,1,0,1,1,95,94,84,84,6
"529",28,"[34]fJHiqwIHBvuldKocJvcGHqFdClwGlexuep",177,0.994382,34,178,1,177,1,1,0,1,1,93,92,85,85,6
"530",29,"[34]fJHiqwIHBvuldKocJvcGHqFdClwGlexuep",178,0.994413,34,179,1,178,1,1,0,1,1,96,95,83,83,6
"531",30,"[34]fJHiqwIHBvuldKocJvcGHqFdClwGlexuep",175,0.994318,34,176,1,175,1,1,0,1,1,87,86,89,89,6
"532",31,"[34]fJHiqwIHBvuldKocJvcGHqFdClwGlexuep",178,0.994413,34,179,1,178,1,1,0,1,1,96,95,83,83,6
"533",32,"[34]fJHiqwIHBvuldKocJvcGHqFdClwGlexuep",173,0.994253,34,174,1,173,1,1,0,1,1,81,80,93,93,6
"534",33,"[34]fJHiqwIHBvuldKocJvcGHqFdClwGlexuep",179,0.994444,34,180,1,179,1,1,0,1,1,102,101,78,78,6
"535",34,"[34]fJHiqwIHBvuldKocJvcGHqFdClwGlexuep",174,0.994286,34,175,1,174,1,1,0,1,1,85,84,90,90,6
"536",35,"[34]fJHiqwIHBvuldKocJvcGHqFdClwGlexuep",175,0.994318,34,176,1,175,1,1,0,1,1,86,85,90,90,6
"537",36,"[34]fJHiqwIHBvuldKocJvcGHqFdClwGlexuep",173,0.994253,34,174,1,173,1,1,0,1,1,81,80,93,93,6
"538",37,"[34]fJHiqwIHBvuldKocJvcGHqFdClwGlexuep",176,0.99435,34,177,1,176,1,1,0,1,1,91,90,86,86,6
"539",38,"[34]fJHiqwIHBvuldKocJvcGHqFdClwGlexuep",173,0.994253,34,174,1,173,1,1,0,1,1,80,79,94,94,6
"540",39,"[34]fJHiqwIHBvuldKocJvcGHqFdClwGlexuep",175,0.994318,34,176,1,175,1,1,0,1,1,87,86,89,89,6
"541",40,"[34]fJHiqwIHBvuldKocJvcGHqFdClwGlexuep",178,0.994413,34,179,1,178,1,1,0,1,1,95,94,84,84,6
"542",41,"[34]fJHiqwIHBvuldKocJvcGHqFdClwGlexuep",174,0.994286,34,175,1,174,1,1,0,1,1,84,83,91,91,6
"543",42,"[34]fJHiqwIHBvuldKocJvcGHqFdClwGlexuep",173,0.994253,34,174,1,173,1,1,0,1,1,82,81,92,92,6
"544",43,"[34]fJHiqwIHBvuldKocJvcGHqFdClwGlexuep",173,0.994253,34,174,1,173,1,1,0,1,1,81,80,93,93,6
"545",44,"[34]fJHiqwIHBvuldKocJvcGHqFdClwGlexuep",172,0.99422,34,173,1,172,1,1,0,1,1,78,77,95,95,6
"546",45,"[34]fJHiqwIHBvuldKocJvcGHqFdClwGlexuep",176,0.99435,34,177,1,176,1,1,0,1,1,91,90,86,86,6
"547",46,"[34]fJHiqwIHBvuldKocJvcGHqFdClwGlexuep",179,0.994444,34,180,1,179,1,1,0,1,1,101,100,79,79,6
"548",47,"[34]fJHiqwIHBvuldKocJvcGHqFdClwGlexuep",176,0.99435,34,177,1,176,1,1,0,1,1,90,89,87,87,6
"549",48,"[34]fJHiqwIHBvuldKocJvcGHqFdClwGlexuep",176,0.99435,34,177,1,176,1,1,0,1,1,89,88,88,88,6
"550",49,"[34]fJHiqwIHBvuldKocJvcGHqFdClwGlexuep",178,0.994413,34,179,1,178,1,1,0,1,1,96,95,83,83,6
"551",50,"[34]fJHiqwIHBvuldKocJvcGHqFdClwGlexuep",170,0.994152,34,171,1,170,1,1,0,1,1,71,70,100,100,6
"552",51,"[34]fJHiqwIHBvuldKocJvcGHqFdClwGlexuep",177,0.994382,34,178,1,177,1,1,0,1,1,92,91,86,86,6
"553",52,"[34]fJHiqwIHBvuldKocJvcGHqFdClwGlexuep",172,0.99422,34,173,1,172,1,1,0,1,1,77,76,96,96,6
"554",53,"[34]fJHiqwIHBvuldKocJvcGHqFdClwGlexuep",177,0.994382,34,178,1,177,1,1,0,1,1,94,93,84,84,6
"555",54,"[34]fJHiqwIHBvuldKocJvcGHqFdClwGlexuep",176,0.99435,34,177,1,176,1,1,0,1,1,92,91,85,85,6
"556",55,"[34]fJHiqwIHBvuldKocJvcGHqFdClwGlexuep",174,0.994286,34,175,1,174,1,1,0,1,1,83,82,92,92,6
"557",56,"[34]fJHiqwIHBvuldKocJvcGHqFdClwGlexuep",174,0.994286,34,175,1,174,1,1,0,1,1,82,81,93,93,6
"558",57,"[34]fJHiqwIHBvuldKocJvcGHqFdClwGlexuep",174,0.994286,34,175,1,174,1,1,0,1,1,81,80,94,94,6
"559",58,"[34]fJHiqwIHBvuldKocJvcGHqFdClwGlexuep",170,0.994152,34,171,1,170,1,1,0,1,1,69,68,102,102,6
"560",59,"[34]fJHiqwIHBvuldKocJvcGHqFdClwGlexuep",174,0.994286,34,175,1,174,1,1,0,1,1,85,84,90,90,6
"561",60,"[34]fJHiqwIHBvuldKocJvcGHqFdClwGlexuep",178,0.994413,34,179,1,178,1,1,0,1,1,96,95,83,83,6
"562",61,"[34]fJHiqwIHBvuldKocJvcGHqFdClwGlexuep",179,0.994444,34,180,1,179,1,1,0,1,1,101,100,79,79,6
"563",62,"[34]fJHiqwIHBvuldKocJvcGHqFdClwGlexuep",175,0.994318,34,176,1,175,1,1,0,1,1,88,87,88,88,6
"564",63,"[34]fJHiqwIHBvuldKocJvcGHqFdClwGlexuep",172,0.99422,34,173,1,172,1,1,0,1,1,78,77,95,95,6
"565",64,"[34]fJHiqwIHBvuldKocJvcGHqFdClwGlexuep",180,0.994475,34,181,1,180,1,1,0,1,1,102,101,79,79,6
"566",65,"[34]fJHiqwIHBvuldKocJvcGHqFdClwGlexuep",176,0.99435,34,177,1,176,1,1,0,1,1,90,89,87,87,6
"567",66,"[34]fJHiqwIHBvuldKocJvcGHqFdClwGlexuep",177,0.994382,34,178,1,177,1,1,0,1,1,95,94,83,83,6
"568",67,"[34]fJHiqwIHBvuldKocJvcGHqFdClwGlexuep",176,0.99435,34,177,1,176,1,1,0,1,1,89,88,88,88,6
"569",68,"[34]fJHiqwIHBvuldKocJvcGHqFdClwGlexuep",176,0.99435,34,177,1,176,1,1,0,1,1,91,90,86,86,6
"570",69,"[34]fJHiqwIHBvuldKocJvcGHqFdClwGlexuep",175,0.994318,34,176,1,175,1,1,0,1,1,87,86,89,89,6
"571",70,"[34]fJHiqwIHBvuldKocJvcGHqFdClwGlexuep",176,0.99435,34,177,1,176,1,1,0,1,1,91,90,86,86,6
"572",71,"[34]fJHiqwIHBvuldKocJvcGHqFdClwGlexuep",177,0.994382,34,178,1,177,1,1,0,1,1,95,94,83,83,6
"573",72,"[34]fJHiqwIHBvuldKocJvcGHqFdClwGlexuep",179,0.994444,34,180,1,179,1,1,0,1,1,102,101,78,78,6
"574",73,"[34]fJHiqwIHBvuldKocJvcGHqFdClwGlexuep",174,0.994286,34,175,1,174,1,1,0,1,1,84,83,91,91,6
"575",74,"[34]fJHiqwIHBvuldKocJvcGHqFdClwGlexuep",177,0.994382,34,178,1,177,1,1,0,1,1,92,91,86,86,6
"576",75,"[34]fJHiqwIHBvuldKocJvcGHqFdClwGlexuep",177,0.994382,34,178,1,177,1,1,0,1,1,93,92,85,85,6
"577",76,"[34]fJHiqwIHBvuldKocJvcGHqFdClwGlexuep",176,0.99435,34,177,1,176,1,1,0,1,1,89,88,88,88,6
"578",77,"[34]fJHiqwIHBvuldKocJvcGHqFdClwGlexuep",178,0.994413,34,179,1,178,1,1,0,1,1,96,95,83,83,6
"579",78,"[34]fJHiqwIHBvuldKocJvcGHqFdClwGlexuep",177,0.994382,34,178,1,177,1,1,0,1,1,92,91,86,86,6
"580",79,"[34]fJHiqwIHBvuldKocJvcGHqFdClwGlexuep",175,0.994318,34,176,1,175,1,1,0,1,1,86,85,90,90,6
"581",80,"[34]fJHiqwIHBvuldKocJvcGHqFdClwGlexuep",173,0.994253,34,174,1,173,1,1,0,1,1,79,78,95,95,6
"582",81,"[34]fJHiqwIHBvuldKocJvcGHqFdClwGlexuep",178,0.994413,34,179,1,178,1,1,0,1,1,97,96,82,82,6
"583",82,"[34]fJHiqwIHBvuldKocJvcGHqFdClwGlexuep",179,0.994444,34,180,1,179,1,1,0,1,1,97,96,83,83,6
"584",83,"[34]fJHiqwIHBvuldKocJvcGHqFdClwGlexuep",177,0.994382,34,178,1,177,1,1,0,1,1,94,93,84,84,6
"585",84,"[34]fJHiqwIHBvuldKocJvcGHqFdClwGlexuep",180,0.994475,34,181,1,180,1,1,0,1,1,102,101,79,79,6
"586",85,"[34]fJHiqwIHBvuldKocJvcGHqFdClwGlexuep",176,0.99435,34,177,1,176,1,1,0,1,1,89,88,88,88,6
"587",86,"[34]fJHiqwIHBvuldKocJvcGHqFdClwGlexuep",179,0.994444,34,180,1,179,1,1,0,1,1,100,99,80,80,6
"588",87,"[34]fJHiqwIHBvuldKocJvcGHqFdClwGlexuep",173,0.994253,34,174,1,173,1,1,0,1,1,81,80,93,93,6
"589",88,"[34]fJHiqwIHBvuldKocJvcGHqFdClwGlexuep",176,0.99435,34,177,1,176,1,1,0,1,1,88,87,89,89,6
"590",89,"[34]fJHiqwIHBvuldKocJvcGHqFdClwGlexuep",174,0.994286,34,175,1,174,1,1,0,1,1,85,84,90,90,6
"591",90,"[34]fJHiqwIHBvuldKocJvcGHqFdClwGlexuep",173,0.994253,34,174,1,173,1,1,0,1,1,80,79,94,94,6
"592",91,"[34]fJHiqwIHBvuldKocJvcGHqFdClwGlexuep",175,0.994318,34,176,1,175,1,1,0,1,1,86,85,90,90,6
"593",92,"[34]fJHiqwIHBvuldKocJvcGHqFdClwGlexuep",178,0.994413,34,179,1,178,1,1,0,1,1,96,95,83,83,6
"594",93,"[34]fJHiqwIHBvuldKocJvcGHqFdClwGlexuep",177,0.994382,34,178,1,177,1,1,0,1,1,91,90,87,87,6
"595",94,"[34]fJHiqwIHBvuldKocJvcGHqFdClwGlexuep",176,0.99435,34,177,1,176,1,1,0,1,1,90,89,87,87,6
"596",95,"[34]fJHiqwIHBvuldKocJvcGHqFdClwGlexuep",174,0.994286,34,175,1,174,1,1,0,1,1,83,82,92,92,6
"597",96,"[34]fJHiqwIHBvuldKocJvcGHqFdClwGlexuep",175,0.994318,34,176,1,175,1,1,0,1,1,87,86,89,89,6
"598",97,"[34]fJHiqwIHBvuldKocJvcGHqFdClwGlexuep",178,0.994413,34,179,1,178,1,1,0,1,1,97,96,82,82,6
"599",98,"[34]fJHiqwIHBvuldKocJvcGHqFdClwGlexuep",175,0.994318,34,176,1,175,1,1,0,1,1,87,86,89,89,6
"600",99,"[34]fJHiqwIHBvuldKocJvcGHqFdClwGlexuep",178,0.994413,34,179,1,178,1,1,0,1,1,95,94,84,84,6
"601",0,"[27]AJHggqqIHcidKocJvcGHqFdCtwz",177,0.994382,27,178,1,177,1,1,0,1,1,92,91,86,86,7
"602",1,"[27]AJHggqqIHcidKocJvcGHqFdCtwz",175,0.994318,27,176,1,175,1,1,0,1,1,85,84,91,91,7
"603",2,"[27]AJHggqqIHcidKocJvcGHqFdCtwz",177,0.994382,27,178,1,177,1,1,0,1,1,92,91,86,86,7
"604",3,"[27]AJHggqqIHcidKocJvcGHqFdCtwz",179,0.994444,27,180,1,179,1,1,0,1,1,100,99,80,80,7
"605",4,"[27]AJHggqqIHcidKocJvcGHqFdCtwz",179,0.994444,27,180,1,179,1,1,0,1,1,99,98,81,81,7
"606",5,"[27]AJHggqqIHcidKocJvcGHqFdCtwz",176,0.99435,27,177,1,176,1,1,0,1,1,89,88,88,88,7
"607",6,"[27]AJHggqqIHcidKocJvcGHqFdCtwz",178,0.994413,27,179,1,178,1,1,0,1,1,94,93,85,85,7
"608",7,"[27]AJHggqqIHcidKocJvcGHqFdCtwz",179,0.994444,27,180,1,179,1,1,0,1,1,99,98,81,81,7
"609",8,"[27]AJHggqqIHcidKocJvcGHqFdCtwz",176,0.99435,27,177,1,176,1,1,0,1,1,89,88,88,88,7
"610",9,"[27]AJHggqqIHcidKocJvcGHqFdCtwz",174,0.994286,27,175,1,174,1,1,0,1,1,81,80,94,94,7
"611",10,"[27]AJHggqqIHcidKocJvcGHqFdCtwz",174,0.994286,27,175,1,174,1,1,0,1,1,82,81,93,93,7
"612",11,"[27]AJHggqqIHcidKocJvcGHqFdCtwz",173,0.994253,27,174,1,173,1,1,0,1,1,80,79,94,94,7
"613",12,"[27]AJHggqqIHcidKocJvcGHqFdCtwz",175,0.994318,27,176,1,175,1,1,0,1,1,86,85,90,90,7
"614",13,"[27]AJHggqqIHcidKocJvcGHqFdCtwz",176,0.99435,27,177,1,176,1,1,0,1,1,89,88,88,88,7
"615",14,"[27]AJHggqqIHcidKocJvcGHqFdCtwz",183,0.994565,27,184,1,183,1,1,0,1,1,110,109,74,74,7
"616",15,"[27]AJHggqqIHcidKocJvcGHqFdCtwz",177,0.994382,27,178,1,177,1,1,0,1,1,91,90,87,87,7
"617",16,"[27]AJHggqqIHcidKocJvcGHqFdCtwz",174,0.994286,27,175,1,174,1,1,0,1,1,82,81,93,93,7
"618",17,"[27]AJHggqqIHcidKocJvcGHqFdCtwz",180,0.994475,27,181,1,180,1,1,0,1,1,103,102,78,78,7
"619",18,"[27]AJHggqqIHcidKocJvcGHqFdCtwz",174,0.994286,27,175,1,174,1,1,0,1,1,80,79,95,95,7
"620",19,"[27]AJHggqqIHcidKocJvcGHqFdCtwz",178,0.994413,27,179,1,178,1,1,0,1,1,96,95,83,83,7
"621",20,"[27]AJHggqqIHcidKocJvcGHqFdCtwz",180,0.994475,27,181,1,180,1,1,0,1,1,100,99,81,81,7
"622",21,"[27]AJHggqqIHcidKocJvcGHqFdCtwz",178,0.994413,27,179,1,178,1,1,0,1,1,95,94,84,84,7
"623",22,"[27]AJHggqqIHcidKocJvcGHqFdCtwz",177,0.994382,27,178,1,177,1,1,0,1,1,93,92,85,85,7
"624",23,"[27]AJHggqqIHcidKocJvcGHqFdCtwz",177,0.994382,27,178,1,177,1,1,0,1,1,93,92,85,85,7
"625",24,"[27]AJHggqqIHcidKocJvcGHqFdCtwz",175,0.994318,27,176,1,175,1,1,0,1,1,85,84,91,91,7
"626",25,"[27]AJHggqqIHcidKocJvcGHqFdCtwz",175,0.994318,27,176,1,175,1,1,0,1,1,85,84,91,91,7
"627",26,"[27]AJHggqqIHcidKocJvcGHqFdCtwz",178,0.994413,27,179,1,178,1,1,0,1,1,95,94,84,84,7
"628",27,"[27]AJHggqqIHcidKocJvcGHqFdCtwz",178,0.994413,27,179,1,178,1,1,0,1,1,96,95,83,83,7
"629",28,"[27]AJHggqqIHcidKocJvcGHqFdCtwz",173,0.994253,27,174,1,173,1,1,0,1,1,79,78,95,95,7
"630",29,"[27]AJHggqqIHcidKocJvcGHqFdCtwz",179,0.994444,27,180,1,179,1,1,0,1,1,99,98,81,81,7
"631",30,"[27]AJHggqqIHcidKocJvcGHqFdCtwz",172,0.99422,27,173,1,172,1,1,0,1,1,77,76,96,96,7
"632",31,"[27]AJHggqqIHcidKocJvcGHqFdCtwz",178,0.994413,27,179,1,178,1,1,0,1,1,97,96,82,82,7
"633",32,"[27]AJHggqqIHcidKocJvcGHqFdCtwz",181,0.994505,27,182,1,181,1,1,0,1,1,104,103,78,78,7
"634",33,"[27]AJHggqqIHcidKocJvcGHqFdCtwz",174,0.994286,27,175,1,174,1,1,0,1,1,84,83,91,91,7
"635",34,"[27]AJHggqqIHcidKocJvcGHqFdCtwz",177,0.994382,27,178,1,177,1,1,0,1,1,94,93,84,84,7
"636",35,"[27]AJHggqqIHcidKocJvcGHqFdCtwz",177,0.994382,27,178,1,177,1,1,0,1,1,94,93,84,84,7
"637",36,"[27]AJHggqqIHcidKocJvcGHqFdCtwz",176,0.99435,27,177,1,176,1,1,0,1,1,90,89,87,87,7
"638",37,"[27]AJHggqqIHcidKocJvcGHqFdCtwz",176,0.99435,27,177,1,176,1,1,0,1,1,88,87,89,89,7
"639",38,"[27]AJHggqqIHcidKocJvcGHqFdCtwz",177,0.994382,27,178,1,177,1,1,0,1,1,93,92,85,85,7
"640",39,"[27]AJHggqqIHcidKocJvcGHqFdCtwz",173,0.994253,27,174,1,173,1,1,0,1,1,80,79,94,94,7
"641",40,"[27]AJHggqqIHcidKocJvcGHqFdCtwz",176,0.99435,27,177,1,176,1,1,0,1,1,86,85,91,91,7
"642",41,"[27]AJHggqqIHcidKocJvcGHqFdCtwz",174,0.994286,27,175,1,174,1,1,0,1,1,81,80,94,94,7
"643",42,"[27]AJHggqqIHcidKocJvcGHqFdCtwz",179,0.994444,27,180,1,179,1,1,0,1,1,100,99,80,80,7
"644",43,"[27]AJHggqqIHcidKocJvcGHqFdCtwz",172,0.99422,27,173,1,172,1,1,0,1,1,74,73,99,99,7
"645",44,"[27]AJHggqqIHcidKocJvcGHqFdCtwz",173,0.994253,27,174,1,173,1,1,0,1,1,81,80,93,93,7
"646",45,"[27]AJHggqqIHcidKocJvcGHqFdCtwz",179,0.994444,27,180,1,179,1,1,0,1,1,99,98,81,81,7
"647",46,"[27]AJHggqqIHcidKocJvcGHqFdCtwz",177,0.994382,27,178,1,177,1,1,0,1,1,92,91,86,86,7
"648",47,"[27]AJHggqqIHcidKocJvcGHqFdCtwz",177,0.994382,27,178,1,177,1,1,0,1,1,93,92,85,85,7
"649",48,"[27]AJHggqqIHcidKocJvcGHqFdCtwz",169,0.994118,27,170,1,169,1,1,0,1,1,67,66,103,103,7
"650",49,"[27]AJHggqqIHcidKocJvcGHqFdCtwz",176,0.99435,27,177,1,176,1,1,0,1,1,90,89,87,87,7
"651",50,"[27]AJHggqqIHcidKocJvcGHqFdCtwz",175,0.994318,27,176,1,175,1,1,0,1,1,86,85,90,90,7
"652",51,"[27]AJHggqqIHcidKocJvcGHqFdCtwz",174,0.994286,27,175,1,174,1,1,0,1,1,83,82,92,92,7
"653",52,"[27]AJHggqqIHcidKocJvcGHqFdCtwz",177,0.994382,27,178,1,177,1,1,0,1,1,94,93,84,84,7
"654",53,"[27]AJHggqqIHcidKocJvcGHqFdCtwz",176,0.99435,27,177,1,176,1,1,0,1,1,91,90,86,86,7
"655",54,"[27]AJHggqqIHcidKocJvcGHqFdCtwz",175,0.994318,27,176,1,175,1,1,0,1,1,85,84,91,91,7
"656",55,"[27]AJHggqqIHcidKocJvcGHqFdCtwz",178,0.994413,27,179,1,178,1,1,0,1,1,96,95,83,83,7
"657",56,"[27]AJHggqqIHcidKocJvcGHqFdCtwz",174,0.994286,27,175,1,174,1,1,0,1,1,82,81,93,93,7
"658",57,"[27]AJHggqqIHcidKocJvcGHqFdCtwz",176,0.99435,27,177,1,176,1,1,0,1,1,91,90,86,86,7
"659",58,"[27]AJHggqqIHcidKocJvcGHqFdCtwz",172,0.99422,27,173,1,172,1,1,0,1,1,76,75,97,97,7
"660",59,"[27]AJHggqqIHcidKocJvcGHqFdCtwz",177,0.994382,27,178,1,177,1,1,0,1,1,92,91,86,86,7
"661",60,"[27]AJHggqqIHcidKocJvcGHqFdCtwz",177,0.994382,27,178,1,177,1,1,0,1,1,92,91,86,86,7
"662",61,"[27]AJHggqqIHcidKocJvcGHqFdCtwz",175,0.994318,27,176,1,175,1,1,0,1,1,86,85,90,90,7
"663",62,"[27]AJHggqqIHcidKocJvcGHqFdCtwz",178,0.994413,27,179,1,178,1,1,0,1,1,94,93,85,85,7
"664",63,"[27]AJHggqqIHcidKocJvcGHqFdCtwz",178,0.994413,27,179,1,178,1,1,0,1,1,96,95,83,83,7
"665",64,"[27]AJHggqqIHcidKocJvcGHqFdCtwz",174,0.994286,27,175,1,174,1,1,0,1,1,83,82,92,92,7
"666",65,"[27]AJHggqqIHcidKocJvcGHqFdCtwz",174,0.994286,27,175,1,174,1,1,0,1,1,83,82,92,92,7
"667",66,"[27]AJHggqqIHcidKocJvcGHqFdCtwz",176,0.99435,27,177,1,176,1,1,0,1,1,89,88,88,88,7
"668",67,"[27]AJHggqqIHcidKocJvcGHqFdCtwz",176,0.99435,27,177,1,176,1,1,0,1,1,90,89,87,87,7
"669",68,"[27]AJHggqqIHcidKocJvcGHqFdCtwz",178,0.994413,27,179,1,178,1,1,0,1,1,94,93,85,85,7
"670",69,"[27]AJHggqqIHcidKocJvcGHqFdCtwz",179,0.994444,27,180,1,179,1,1,0,1,1,99,98,81,81,7
"671",70,"[27]AJHggqqIHcidKocJvcGHqFdCtwz",177,0.994382,27,178,1,177,1,1,0,1,1,93,92,85,85,7
"672",71,"[27]AJHggqqIHcidKocJvcGHqFdCtwz",177,0.994382,27,178,1,177,1,1,0,1,1,92,91,86,86,7
"673",72,"[27]AJHggqqIHcidKocJvcGHqFdCtwz",175,0.994318,27,176,1,175,1,1,0,1,1,83,82,93,93,7
"674",73,"[27]AJHggqqIHcidKocJvcGHqFdCtwz",175,0.994318,27,176,1,175,1,1,0,1,1,85,84,91,91,7
"675",74,"[27]AJHggqqIHcidKocJvcGHqFdCtwz",177,0.994382,27,178,1,177,1,1,0,1,1,92,91,86,86,7
"676",75,"[27]AJHggqqIHcidKocJvcGHqFdCtwz",175,0.994318,27,176,1,175,1,1,0,1,1,87,86,89,89,7
"677",76,"[27]AJHggqqIHcidKocJvcGHqFdCtwz",176,0.99435,27,177,1,176,1,1,0,1,1,90,89,87,87,7
"678",77,"[27]AJHggqqIHcidKocJvcGHqFdCtwz",178,0.994413,27,179,1,178,1,1,0,1,1,95,94,84,84,7
"679",78,"[27]AJHggqqIHcidKocJvcGHqFdCtwz",176,0.99435,27,177,1,176,1,1,0,1,1,90,89,87,87,7
"680",79,"[27]AJHggqqIHcidKocJvcGHqFdCtwz",176,0.99435,27,177,1,176,1,1,0,1,1,91,90,86,86,7
"681",80,"[27]AJHggqqIHcidKocJvcGHqFdCtwz",173,0.994253,27,174,1,173,1,1,0,1,1,80,79,94,94,7
"682",81,"[27]AJHggqqIHcidKocJvcGHqFdCtwz",171,0.994186,27,172,1,171,1,1,0,1,1,73,72,99,99,7
"683",82,"[27]AJHggqqIHcidKocJvcGHqFdCtwz",175,0.994318,27,176,1,175,1,1,0,1,1,84,83,92,92,7
"684",83,"[27]AJHggqqIHcidKocJvcGHqFdCtwz",177,0.994382,27,178,1,177,1,1,0,1,1,94,93,84,84,7
"685",84,"[27]AJHggqqIHcidKocJvcGHqFdCtwz",182,0.994536,27,183,1,182,1,1,0,1,1,109,108,74,74,7
"686",85,"[27]AJHggqqIHcidKocJvcGHqFdCtwz",173,0.994253,27,174,1,173,1,1,0,1,1,78,77,96,96,7
"687",86,"[27]AJHggqqIHcidKocJvcGHqFdCtwz",179,0.994444,27,180,1,179,1,1,0,1,1,99,98,81,81,7
"688",87,"[27]AJHggqqIHcidKocJvcGHqFdCtwz",179,0.994444,27,180,1,179,1,1,0,1,1,98,97,82,82,7
"689",88,"[27]AJHggqqIHcidKocJvcGHqFdCtwz",179,0.994444,27,180,1,179,1,1,0,1,1,95,94,85,85,7
"690",89,"[27]AJHggqqIHcidKocJvcGHqFdCtwz",173,0.994253,27,174,1,173,1,1,0,1,1,79,78,95,95,7
"691",90,"[27]AJHggqqIHcidKocJvcGHqFdCtwz",176,0.99435,27,177,1,176,1,1,0,1,1,91,90,86,86,7
"692",91,"[27]AJHggqqIHcidKocJvcGHqFdCtwz",178,0.994413,27,179,1,178,1,1,0,1,1,97,96,82,82,7
"693",92,"[27]AJHggqqIHcidKocJvcGHqFdCtwz",173,0.994253,27,174,1,173,1,1,0,1,1,80,79,94,94,7
"694",93,"[27]AJHggqqIHcidKocJvcGHqFdCtwz",176,0.99435,27,177,1,176,1,1,0,1,1,89,88,88,88,7
"695",94,"[27]AJHggqqIHcidKocJvcGHqFdCtwz",172,0.99422,27,173,1,172,1,1,0,1,1,75,74,98,98,7
"696",95,"[27]AJHggqqIHcidKocJvcGHqFdCtwz",177,0.994382,27,178,1,177,1,1,0,1,1,93,92,85,85,7
"697",96,"[27]AJHggqqIHcidKocJvcGHqFdCtwz",174,0.994286,27,175,1,174,1,1,0,1,1,83,82,92,92,7
"698",97,"[27]AJHggqqIHcidKocJvcGHqFdCtwz",175,0.994318,27,176,1,175,1,1,0,1,1,85,84,91,91,7
"699",98,"[27]AJHggqqIHcidKocJvcGHqFdCtwz",176,0.99435,27,177,1,176,1,1,0,1,1,90,89,87,87,7
"700",99,"[27]AJHggqqIHcidKocJvcGHqFdCtwz",178,0.994413,27,179,1,178,1,1,0,1,1,96,95,83,83,7
"701",0,"[28]nJHglqIHckidKocJvcGHqFdCFcep",173,0.994253,28,174,1,173,1,1,0,1,1,81,80,93,93,8
"702",1,"[28]nJHglqIHckidKocJvcGHqFdCFcep",175,0.994318,28,176,1,175,1,1,0,1,1,85,84,91,91,8
"703",2,"[28]nJHglqIHckidKocJvcGHqFdCFcep",177,0.994382,28,178,1,177,1,1,0,1,1,92,91,86,86,8
"704",3,"[28]nJHglqIHckidKocJvcGHqFdCFcep",177,0.994382,28,178,1,177,1,1,0,1,1,92,91,86,86,8
"705",4,"[28]nJHglqIHckidKocJvcGHqFdCFcep",175,0.994318,28,176,1,175,1,1,0,1,1,86,85,90,90,8
"706",5,"[28]nJHglqIHckidKocJvcGHqFdCFcep",175,0.994318,28,176,1,175,1,1,0,1,1,86,85,90,90,8
"707",6,"[28]nJHglqIHckidKocJvcGHqFdCFcep",175,0.994318,28,176,1,175,1,1,0,1,1,87,86,89,89,8
"708",7,"[28]nJHglqIHckidKocJvcGHqFdCFcep",177,0.994382,28,178,1,177,1,1,0,1,1,88,87,90,90,8
"709",8,"[28]nJHglqIHckidKocJvcGHqFdCFcep",178,0.994413,28,179,1,178,1,1,0,1,1,95,94,84,84,8
"710",9,"[28]nJHglqIHckidKocJvcGHqFdCFcep",171,0.994186,28,172,1,171,1,1,0,1,1,74,73,98,98,8
"711",10,"[28]nJHglqIHckidKocJvcGHqFdCFcep",173,0.994253,28,174,1,173,1,1,0,1,1,81,80,93,93,8
"712",11,"[28]nJHglqIHckidKocJvcGHqFdCFcep",179,0.994444,28,180,1,179,1,1,0,1,1,99,98,81,81,8
"713",12,"[28]nJHglqIHckidKocJvcGHqFdCFcep",178,0.994413,28,179,1,178,1,1,0,1,1,96,95,83,83,8
"714",13,"[28]nJHglqIHckidKocJvcGHqFdCFcep",178,0.994413,28,179,1,178,1,1,0,1,1,96,95,83,83,8
"715",14,"[28]nJHglqIHckidKocJvcGHqFdCFcep",175,0.994318,28,176,1,175,1,1,0,1,1,86,85,90,90,8
"716",15,"[28]nJHglqIHckidKocJvcGHqFdCFcep",176,0.99435,28,177,1,176,1,1,0,1,1,89,88,88,88,8
"717",16,"[28]nJHglqIHckidKocJvcGHqFdCFcep",178,0.994413,28,179,1,178,1,1,0,1,1,97,96,82,82,8
"718",17,"[28]nJHglqIHckidKocJvcGHqFdCFcep",172,0.99422,28,173,1,172,1,1,0,1,1,76,75,97,97,8
"719",18,"[28]nJHglqIHckidKocJvcGHqFdCFcep",178,0.994413,28,179,1,178,1,1,0,1,1,97,96,82,82,8
"720",19,"[28]nJHglqIHckidKocJvcGHqFdCFcep",176,0.99435,28,177,1,176,1,1,0,1,1,88,87,89,89,8
"721",20,"[28]nJHglqIHckidKocJvcGHqFdCFcep",177,0.994382,28,178,1,177,1,1,0,1,1,91,90,87,87,8
"722",21,"[28]nJHglqIHckidKocJvcGHqFdCFcep",178,0.994413,28,179,1,178,1,1,0,1,1,97,96,82,82,8
"723",22,"[28]nJHglqIHckidKocJvcGHqFdCFcep",180,0.994475,28,181,1,180,1,1,0,1,1,103,102,78,78,8
"724",23,"[28]nJHglqIHckidKocJvcGHqFdCFcep",177,0.994382,28,178,1,177,1,1,0,1,1,94,93,84,84,8
"725",24,"[28]nJHglqIHckidKocJvcGHqFdCFcep",176,0.99435,28,177,1,176,1,1,0,1,1,90,89,87,87,8
"726",25,"[28]nJHglqIHckidKocJvcGHqFdCFcep",175,0.994318,28,176,1,175,1,1,0,1,1,85,84,91,91,8
"727",26,"[28]nJHglqIHckidKocJvcGHqFdCFcep",175,0.994318,28,176,1,175,1,1,0,1,1,86,85,90,90,8
"728",27,"[28]nJHglqIHckidKocJvcGHqFdCFcep",177,0.994382,28,178,1,177,1,1,0,1,1,93,92,85,85,8
"729",28,"[28]nJHglqIHckidKocJvcGHqFdCFcep",178,0.994413,28,179,1,178,1,1,0,1,1,95,94,84,84,8
"730",29,"[28]nJHglqIHckidKocJvcGHqFdCFcep",179,0.994444,28,180,1,179,1,1,0,1,1,98,97,82,82,8
"731",30,"[28]nJHglqIHckidKocJvcGHqFdCFcep",178,0.994413,28,179,1,178,1,1,0,1,1,94,93,85,85,8
"732",31,"[28]nJHglqIHckidKocJvcGHqFdCFcep",172,0.99422,28,173,1,172,1,1,0,1,1,77,76,96,96,8
"733",32,"[28]nJHglqIHckidKocJvcGHqFdCFcep",175,0.994318,28,176,1,175,1,1,0,1,1,86,85,90,90,8
"734",33,"[28]nJHglqIHckidKocJvcGHqFdCFcep",177,0.994382,28,178,1,177,1,1,0,1,1,94,93,84,84,8
"735",34,"[28]nJHglqIHckidKocJvcGHqFdCFcep",176,0.99435,28,177,1,176,1,1,0,1,1,89,88,88,88,8
"736",35,"[28]nJHglqIHckidKocJvcGHqFdCFcep",179,0.994444,28,180,1,179,1,1,0,1,1,98,97,82,82,8
"737",36,"[28]nJHglqIHckidKocJvcGHqFdCFcep",177,0.994382,28,178,1,177,1,1,0,1,1,91,90,87,87,8
"738",37,"[28]nJHglqIHckidKocJvcGHqFdCFcep",177,0.994382,28,178,1,177,1,1,0,1,1,93,92,85,85,8
"739",38,"[28]nJHglqIHckidKocJvcGHqFdCFcep",177,0.994382,28,178,1,177,1,1,0,1,1,92,91,86,86,8
"740",39,"[28]nJHglqIHckidKocJvcGHqFdCFcep",177,0.994382,28,178,1,177,1,1,0,1,1,93,92,85,85,8
"741",40,"[28]nJHglqIHckidKocJvcGHqFdCFcep",172,0.99422,28,173,1,172,1,1,0,1,1,77,76,96,96,8
"742",41,"[28]nJHglqIHckidKocJvcGHqFdCFcep",176,0.99435,28,177,1,176,1,1,0,1,1,88,87,89,89,8
"743",42,"[28]nJHglqIHckidKocJvcGHqFdCFcep",178,0.994413,28,179,1,178,1,1,0,1,1,96,95,83,83,8
"744",43,"[28]nJHglqIHckidKocJvcGHqFdCFcep",176,0.99435,28,177,1,176,1,1,0,1,1,88,87,89,89,8
"745",44,"[28]nJHglqIHckidKocJvcGHqFdCFcep",173,0.994253,28,174,1,173,1,1,0,1,1,79,78,95,95,8
"746",45,"[28]nJHglqIHckidKocJvcGHqFdCFcep",175,0.994318,28,176,1,175,1,1,0,1,1,84,83,92,92,8
"747",46,"[28]nJHglqIHckidKocJvcGHqFdCFcep",177,0.994382,28,178,1,177,1,1,0,1,1,94,93,84,84,8
"748",47,"[28]nJHglqIHckidKocJvcGHqFdCFcep",174,0.994286,28,175,1,174,1,1,0,1,1,84,83,91,91,8
"749",48,"[28]nJHglqIHckidKocJvcGHqFdCFcep",175,0.994318,28,176,1,175,1,1,0,1,1,84,83,92,92,8
"750",49,"[28]nJHglqIHckidKocJvcGHqFdCFcep",178,0.994413,28,179,1,178,1,1,0,1,1,96,95,83,83,8
"751",50,"[28]nJHglqIHckidKocJvcGHqFdCFcep",176,0.99435,28,177,1,176,1,1,0,1,1,90,89,87,87,8
"752",51,"[28]nJHglqIHckidKocJvcGHqFdCFcep",177,0.994382,28,178,1,177,1,1,0,1,1,91,90,87,87,8
"753",52,"[28]nJHglqIHckidKocJvcGHqFdCFcep",177,0.994382,28,178,1,177,1,1,0,1,1,93,92,85,85,8
"754",53,"[28]nJHglqIHckidKocJvcGHqFdCFcep",177,0.994382,28,178,1,177,1,1,0,1,1,91,90,87,87,8
"755",54,"[28]nJHglqIHckidKocJvcGHqFdCFcep",174,0.994286,28,175,1,174,1,1,0,1,1,83,82,92,92,8
"756",55,"[28]nJHglqIHckidKocJvcGHqFdCFcep",180,0.994475,28,181,1,180,1,1,0,1,1,103,102,78,78,8
"757",56,"[28]nJHglqIHckidKocJvcGHqFdCFcep",177,0.994382,28,178,1,177,1,1,0,1,1,92,91,86,86,8
"758",57,"[28]nJHglqIHckidKocJvcGHqFdCFcep",175,0.994318,28,176,1,175,1,1,0,1,1,86,85,90,90,8
"759",58,"[28]nJHglqIHckidKocJvcGHqFdCFcep",177,0.994382,28,178,1,177,1,1,0,1,1,92,91,86,86,8
"760",59,"[28]nJHglqIHckidKocJvcGHqFdCFcep",178,0.994413,28,179,1,178,1,1,0,1,1,96,95,83,83,8
"761",60,"[28]nJHglqIHckidKocJvcGHqFdCFcep",176,0.99435,28,177,1,176,1,1,0,1,1,90,89,87,87,8
"762",61,"[28]nJHglqIHckidKocJvcGHqFdCFcep",177,0.994382,28,178,1,177,1,1,0,1,1,92,91,86,86,8
"763",62,"[28]nJHglqIHckidKocJvcGHqFdCFcep",180,0.994475,28,181,1,180,1,1,0,1,1,101,100,80,80,8
"764",63,"[28]nJHglqIHckidKocJvcGHqFdCFcep",175,0.994318,28,176,1,175,1,1,0,1,1,85,84,91,91,8
"765",64,"[28]nJHglqIHckidKocJvcGHqFdCFcep",175,0.994318,28,176,1,175,1,1,0,1,1,87,86,89,89,8
"766",65,"[28]nJHglqIHckidKocJvcGHqFdCFcep",182,0.994536,28,183,1,182,1,1,0,1,1,109,108,74,74,8
"767",66,"[28]nJHglqIHckidKocJvcGHqFdCFcep",178,0.994413,28,179,1,178,1,1,0,1,1,95,94,84,84,8
"768",67,"[28]nJHglqIHckidKocJvcGHqFdCFcep",173,0.994253,28,174,1,173,1,1,0,1,1,79,78,95,95,8
"769",68,"[28]nJHglqIHckidKocJvcGHqFdCFcep",181,0.994505,28,182,1,181,1,1,0,1,1,104,103,78,78,8
"770",69,"[28]nJHglqIHckidKocJvcGHqFdCFcep",180,0.994475,28,181,1,180,1,1,0,1,1,101,100,80,80,8
"771",70,"[28]nJHglqIHckidKocJvcGHqFdCFcep",177,0.994382,28,178,1,177,1,1,0,1,1,92,91,86,86,8
"772",71,"[28]nJHglqIHckidKocJvcGHqFdCFcep",178,0.994413,28,179,1,178,1,1,0,1,1,96,95,83,83,8
"773",72,"[28]nJHglqIHckidKocJvcGHqFdCFcep",177,0.994382,28,178,1,177,1,1,0,1,1,91,90,87,87,8
"774",73,"[28]nJHglqIHckidKocJvcGHqFdCFcep",171,0.994186,28,172,1,171,1,1,0,1,1,70,69,102,102,8
"775",74,"[28]nJHglqIHckidKocJvcGHqFdCFcep",179,0.994444,28,180,1,179,1,1,0,1,1,100,99,80,80,8
"776",75,"[28]nJHglqIHckidKocJvcGHqFdCFcep",178,0.994413,28,179,1,178,1,1,0,1,1,97,96,82,82,8
"777",76,"[28]nJHglqIHckidKocJvcGHqFdCFcep",172,0.99422,28,173,1,172,1,1,0,1,1,77,76,96,96,8
"778",77,"[28]nJHglqIHckidKocJvcGHqFdCFcep",177,0.994382,28,178,1,177,1,1,0,1,1,91,90,87,87,8
"779",78,"[28]nJHglqIHckidKocJvcGHqFdCFcep",178,0.994413,28,179,1,178,1,1,0,1,1,96,95,83,83,8
"780",79,"[28]nJHglqIHckidKocJvcGHqFdCFcep",176,0.99435,28,177,1,176,1,1,0,1,1,89,88,88,88,8
"781",80,"[28]nJHglqIHckidKocJvcGHqFdCFcep",173,0.994253,28,174,1,173,1,1,0,1,1,81,80,93,93,8
"782",81,"[28]nJHglqIHckidKocJvcGHqFdCFcep",177,0.994382,28,178,1,177,1,1,0,1,1,93,92,85,85,8
"783",82,"[28]nJHglqIHckidKocJvcGHqFdCFcep",175,0.994318,28,176,1,175,1,1,0,1,1,87,86,89,89,8
"784",83,"[28]nJHglqIHckidKocJvcGHqFdCFcep",176,0.99435,28,177,1,176,1,1,0,1,1,86,85,91,91,8
"785",84,"[28]nJHglqIHckidKocJvcGHqFdCFcep",177,0.994382,28,178,1,177,1,1,0,1,1,93,92,85,85,8
"786",85,"[28]nJHglqIHckidKocJvcGHqFdCFcep",176,0.99435,28,177,1,176,1,1,0,1,1,91,90,86,86,8
"787",86,"[28]nJHglqIHckidKocJvcGHqFdCFcep",172,0.99422,28,173,1,172,1,1,0,1,1,74,73,99,99,8
"788",87,"[28]nJHglqIHckidKocJvcGHqFdCFcep",174,0.994286,28,175,1,174,1,1,0,1,1,82,81,93,93,8
"789",88,"[28]nJHglqIHckidKocJvcGHqFdCFcep",179,0.994444,28,180,1,179,1,1,0,1,1,96,95,84,84,8
"790",89,"[28]nJHglqIHckidKocJvcGHqFdCFcep",173,0.994253,28,174,1,173,1,1,0,1,1,79,78,95,95,8
"791",90,"[28]nJHglqIHckidKocJvcGHqFdCFcep",179,0.994444,28,180,1,179,1,1,0,1,1,97,96,83,83,8
"792",91,"[28]nJHglqIHckidKocJvcGHqFdCFcep",175,0.994318,28,176,1,175,1,1,0,1,1,86,85,90,90,8
"793",92,"[28]nJHglqIHckidKocJvcGHqFdCFcep",175,0.994318,28,176,1,175,1,1,0,1,1,87,86,89,89,8
"794",93,"[28]nJHglqIHckidKocJvcGHqFdCFcep",173,0.994253,28,174,1,173,1,1,0,1,1,80,79,94,94,8
"795",94,"[28]nJHglqIHckidKocJvcGHqFdCFcep",176,0.99435,28,177,1,176,1,1,0,1,1,91,90,86,86,8
"796",95,"[28]nJHglqIHckidKocJvcGHqFdCFcep",176,0.99435,28,177,1,176,1,1,0,1,1,89,88,88,88,8
"797",96,"[28]nJHglqIHckidKocJvcGHqFdCFcep",174,0.994286,28,175,1,174,1,1,0,1,1,84,83,91,91,8
"798",97,"[28]nJHglqIHckidKocJvcGHqFdCFcep",177,0.994382,28,178,1,177,1,1,0,1,1,94,93,84,84,8
"799",98,"[28]nJHglqIHckidKocJvcGHqFdCFcep",177,0.994382,28,178,1,177,1,1,0,1,1,92,91,86,86,8
"800",99,"[28]nJHglqIHckidKocJvcGHqFdCFcep",174,0.994286,28,175,1,174,1,1,0,1,1,81,80,94,94,8
"801",0,"[28]aJHggqIcHcidKocJvcGHqFdCmfGJ",175,0.994318,28,176,1,175,1,1,0,1,1,84,83,92,92,10
"802",1,"[28]aJHggqIcHcidKocJvcGHqFdCmfGJ",177,0.994382,28,178,1,177,1,1,0,1,1,92,91,86,86,10
"803",2,"[28]aJHggqIcHcidKocJvcGHqFdCmfGJ",177,0.994382,28,178,1,177,1,1,0,1,1,91,90,87,87,10
"804",3,"[28]aJHggqIcHcidKocJvcGHqFdCmfGJ",178,0.994413,28,179,1,178,1,1,0,1,1,95,94,84,84,10
"805",4,"[28]aJHggqIcHcidKocJvcGHqFdCmfGJ",177,0.994382,28,178,1,177,1,1,0,1,1,93,92,85,85,10
"806",5,"[28]aJHggqIcHcidKocJvcGHqFdCmfGJ",176,0.99435,28,177,1,176,1,1,0,1,1,89,88,88,88,10
"807",6,"[28]aJHggqIcHcidKocJvcGHqFdCmfGJ",181,0.994505,28,182,1,181,1,1,0,1,1,104,103,78,78,10
"808",7,"[28]aJHggqIcHcidKocJvcGHqFdCmfGJ",171,0.994186,28,172,1,171,1,1,0,1,1,74,73,98,98,10
"809",8,"[28]aJHggqIcHcidKocJvcGHqFdCmfGJ",173,0.994253,28,174,1,173,1,1,0,1,1,81,80,93,93,10
"810",9,"[28]aJHggqIcHcidKocJvcGHqFdCmfGJ",179,0.994444,28,180,1,179,1,1,0,1,1,99,98,81,81,10
"811",10,"[28]aJHggqIcHcidKocJvcGHqFdCmfGJ",178,0.994413,28,179,1,178,1,1,0,1,1,94,93,85,85,10
"812",11,"[28]aJHggqIcHcidKocJvcGHqFdCmfGJ",176,0.99435,28,177,1,176,1,1,0,1,1,88,87,89,89,10
"813",12,"[28]aJHggqIcHcidKocJvcGHqFdCmfGJ",178,0.994413,28,179,1,178,1,1,0,1,1,96,95,83,83,10
"814",13,"[28]aJHggqIcHcidKocJvcGHqFdCmfGJ",173,0.994253,28,174,1,173,1,1,0,1,1,77,76,97,97,10
"815",14,"[28]aJHggqIcHcidKocJvcGHqFdCmfGJ",178,0.994413,28,179,1,178,1,1,0,1,1,92,91,87,87,10
"816",15,"[28]aJHggqIcHcidKocJvcGHqFdCmfGJ",176,0.99435,28,177,1,176,1,1,0,1,1,87,86,90,90,10
"817",16,"[28]aJHggqIcHcidKocJvcGHqFdCmfGJ",175,0.994318,28,176,1,175,1,1,0,1,1,87,86,89,89,10
"818",17,"[28]aJHggqIcHcidKocJvcGHqFdCmfGJ",175,0.994318,28,176,1,175,1,1,0,1,1,85,84,91,91,10
"819",18,"[28]aJHggqIcHcidKocJvcGHqFdCmfGJ",175,0.994318,28,176,1,175,1,1,0,1,1,86,85,90,90,10
"820",19,"[28]aJHggqIcHcidKocJvcGHqFdCmfGJ",178,0.994413,28,179,1,178,1,1,0,1,1,95,94,84,84,10
"821",20,"[28]aJHggqIcHcidKocJvcGHqFdCmfGJ",178,0.994413,28,179,1,178,1,1,0,1,1,96,95,83,83,10
"822",21,"[28]aJHggqIcHcidKocJvcGHqFdCmfGJ",176,0.99435,28,177,1,176,1,1,0,1,1,87,86,90,90,10
"823",22,"[28]aJHggqIcHcidKocJvcGHqFdCmfGJ",180,0.994475,28,181,1,180,1,1,0,1,1,99,98,82,82,10
"824",23,"[28]aJHggqIcHcidKocJvcGHqFdCmfGJ",174,0.994286,28,175,1,174,1,1,0,1,1,82,81,93,93,10
"825",24,"[28]aJHggqIcHcidKocJvcGHqFdCmfGJ",172,0.99422,28,173,1,172,1,1,0,1,1,76,75,97,97,10
"826",25,"[28]aJHggqIcHcidKocJvcGHqFdCmfGJ",177,0.994382,28,178,1,177,1,1,0,1,1,91,90,87,87,10
"827",26,"[28]aJHggqIcHcidKocJvcGHqFdCmfGJ",174,0.994286,28,175,1,174,1,1,0,1,1,83,82,92,92,10
"828",27,"[28]aJHggqIcHcidKocJvcGHqFdCmfGJ",176,0.99435,28,177,1,176,1,1,0,1,1,87,86,90,90,10
"829",28,"[28]aJHggqIcHcidKocJvcGHqFdCmfGJ",170,0.994152,28,171,1,170,1,1,0,1,1,70,69,101,101,10
"830",29,"[28]aJHggqIcHcidKocJvcGHqFdCmfGJ",174,0.994286,28,175,1,174,1,1,0,1,1,83,82,92,92,10
"831",30,"[28]aJHggqIcHcidKocJvcGHqFdCmfGJ",177,0.994382,28,178,1,177,1,1,0,1,1,92,91,86,86,10
"832",31,"[28]aJHggqIcHcidKocJvcGHqFdCmfGJ",176,0.99435,28,177,1,176,1,1,0,1,1,88,87,89,89,10
"833",32,"[28]aJHggqIcHcidKocJvcGHqFdCmfGJ",176,0.99435,28,177,1,176,1,1,0,1,1,91,90,86,86,10
"834",33,"[28]aJHggqIcHcidKocJvcGHqFdCmfGJ",176,0.99435,28,177,1,176,1,1,0,1,1,90,89,87,87,10
"835",34,"[28]aJHggqIcHcidKocJvcGHqFdCmfGJ",179,0.994444,28,180,1,179,1,1,0,1,1,98,97,82,82,10
"836",35,"[28]aJHggqIcHcidKocJvcGHqFdCmfGJ",175,0.994318,28,176,1,175,1,1,0,1,1,85,84,91,91,10
"837",36,"[28]aJHggqIcHcidKocJvcGHqFdCmfGJ",173,0.994253,28,174,1,173,1,1,0,1,1,81,80,93,93,10
"838",37,"[28]aJHggqIcHcidKocJvcGHqFdCmfGJ",177,0.994382,28,178,1,177,1,1,0,1,1,93,92,85,85,10
"839",38,"[28]aJHggqIcHcidKocJvcGHqFdCmfGJ",175,0.994318,28,176,1,175,1,1,0,1,1,84,83,92,92,10
"840",39,"[28]aJHggqIcHcidKocJvcGHqFdCmfGJ",177,0.994382,28,178,1,177,1,1,0,1,1,92,91,86,86,10
"841",40,"[28]aJHggqIcHcidKocJvcGHqFdCmfGJ",176,0.99435,28,177,1,176,1,1,0,1,1,90,89,87,87,10
"842",41,"[28]aJHggqIcHcidKocJvcGHqFdCmfGJ",177,0.994382,28,178,1,177,1,1,0,1,1,91,90,87,87,10
"843",42,"[28]aJHggqIcHcidKocJvcGHqFdCmfGJ",181,0.994505,28,182,1,181,1,1,0,1,1,102,101,80,80,10
"844",43,"[28]aJHggqIcHcidKocJvcGHqFdCmfGJ",176,0.99435,28,177,1,176,1,1,0,1,1,89,88,88,88,10
"845",44,"[28]aJHggqIcHcidKocJvcGHqFdCmfGJ",178,0.994413,28,179,1,178,1,1,0,1,1,96,95,83,83,10
"846",45,"[28]aJHggqIcHcidKocJvcGHqFdCmfGJ",178,0.994413,28,179,1,178,1,1,0,1,1,96,95,83,83,10
"847",46,"[28]aJHggqIcHcidKocJvcGHqFdCmfGJ",171,0.994186,28,172,1,171,1,1,0,1,1,74,73,98,98,10
"848",47,"[28]aJHggqIcHcidKocJvcGHqFdCmfGJ",177,0.994382,28,178,1,177,1,1,0,1,1,92,91,86,86,10
"849",48,"[28]aJHggqIcHcidKocJvcGHqFdCmfGJ",175,0.994318,28,176,1,175,1,1,0,1,1,84,83,92,92,10
"850",49,"[28]aJHggqIcHcidKocJvcGHqFdCmfGJ",176,0.99435,28,177,1,176,1,1,0,1,1,89,88,88,88,10
"851",50,"[28]aJHggqIcHcidKocJvcGHqFdCmfGJ",177,0.994382,28,178,1,177,1,1,0,1,1,94,93,84,84,10
"852",51,"[28]aJHggqIcHcidKocJvcGHqFdCmfGJ",176,0.99435,28,177,1,176,1,1,0,1,1,90,89,87,87,10
"853",52,"[28]aJHggqIcHcidKocJvcGHqFdCmfGJ",177,0.994382,28,178,1,177,1,1,0,1,1,93,92,85,85,10
"854",53,"[28]aJHggqIcHcidKocJvcGHqFdCmfGJ",178,0.994413,28,179,1,178,1,1,0,1,1,94,93,85,85,10
"855",54,"[28]aJHggqIcHcidKocJvcGHqFdCmfGJ",176,0.99435,28,177,1,176,1,1,0,1,1,91,90,86,86,10
"856",55,"[28]aJHggqIcHcidKocJvcGHqFdCmfGJ",178,0.994413,28,179,1,178,1,1,0,1,1,95,94,84,84,10
"857",56,"[28]aJHggqIcHcidKocJvcGHqFdCmfGJ",180,0.994475,28,181,1,180,1,1,0,1,1,101,100,80,80,10
"858",57,"[28]aJHggqIcHcidKocJvcGHqFdCmfGJ",175,0.994318,28,176,1,175,1,1,0,1,1,84,83,92,92,10
"859",58,"[28]aJHggqIcHcidKocJvcGHqFdCmfGJ",172,0.99422,28,173,1,172,1,1,0,1,1,75,74,98,98,10
"860",59,"[28]aJHggqIcHcidKocJvcGHqFdCmfGJ",178,0.994413,28,179,1,178,1,1,0,1,1,93,92,86,86,10
"861",60,"[28]aJHggqIcHcidKocJvcGHqFdCmfGJ",176,0.99435,28,177,1,176,1,1,0,1,1,89,88,88,88,10
"862",61,"[28]aJHggqIcHcidKocJvcGHqFdCmfGJ",173,0.994253,28,174,1,173,1,1,0,1,1,81,80,93,93,10
"863",62,"[28]aJHggqIcHcidKocJvcGHqFdCmfGJ",179,0.994444,28,180,1,179,1,1,0,1,1,99,98,81,81,10
"864",63,"[28]aJHggqIcHcidKocJvcGHqFdCmfGJ",179,0.994444,28,180,1,179,1,1,0,1,1,99,98,81,81,10
"865",64,"[28]aJHggqIcHcidKocJvcGHqFdCmfGJ",174,0.994286,28,175,1,174,1,1,0,1,1,84,83,91,91,10
"866",65,"[28]aJHggqIcHcidKocJvcGHqFdCmfGJ",179,0.994444,28,180,1,179,1,1,0,1,1,98,97,82,82,10
"867",66,"[28]aJHggqIcHcidKocJvcGHqFdCmfGJ",177,0.994382,28,178,1,177,1,1,0,1,1,93,92,85,85,10
"868",67,"[28]aJHggqIcHcidKocJvcGHqFdCmfGJ",181,0.994505,28,182,1,181,1,1,0,1,1,104,103,78,78,10
"869",68,"[28]aJHggqIcHcidKocJvcGHqFdCmfGJ",175,0.994318,28,176,1,175,1,1,0,1,1,86,85,90,90,10
"870",69,"[28]aJHggqIcHcidKocJvcGHqFdCmfGJ",178,0.994413,28,179,1,178,1,1,0,1,1,96,95,83,83,10
"871",70,"[28]aJHggqIcHcidKocJvcGHqFdCmfGJ",175,0.994318,28,176,1,175,1,1,0,1,1,87,86,89,89,10
"872",71,"[28]aJHggqIcHcidKocJvcGHqFdCmfGJ",175,0.994318,28,176,1,175,1,1,0,1,1,87,86,89,89,10
"873",72,"[28]aJHggqIcHcidKocJvcGHqFdCmfGJ",176,0.99435,28,177,1,176,1,1,0,1,1,89,88,88,88,10
"874",73,"[28]aJHggqIcHcidKocJvcGHqFdCmfGJ",175,0.994318,28,176,1,175,1,1,0,1,1,86,85,90,90,10
"875",74,"[28]aJHggqIcHcidKocJvcGHqFdCmfGJ",173,0.994253,28,174,1,173,1,1,0,1,1,80,79,94,94,10
"876",75,"[28]aJHggqIcHcidKocJvcGHqFdCmfGJ",176,0.99435,28,177,1,176,1,1,0,1,1,89,88,88,88,10
"877",76,"[28]aJHggqIcHcidKocJvcGHqFdCmfGJ",179,0.994444,28,180,1,179,1,1,0,1,1,101,100,79,79,10
"878",77,"[28]aJHggqIcHcidKocJvcGHqFdCmfGJ",178,0.994413,28,179,1,178,1,1,0,1,1,93,92,86,86,10
"879",78,"[28]aJHggqIcHcidKocJvcGHqFdCmfGJ",174,0.994286,28,175,1,174,1,1,0,1,1,83,82,92,92,10
"880",79,"[28]aJHggqIcHcidKocJvcGHqFdCmfGJ",179,0.994444,28,180,1,179,1,1,0,1,1,98,97,82,82,10
"881",80,"[28]aJHggqIcHcidKocJvcGHqFdCmfGJ",173,0.994253,28,174,1,173,1,1,0,1,1,81,80,93,93,10
"882",81,"[28]aJHggqIcHcidKocJvcGHqFdCmfGJ",173,0.994253,28,174,1,173,1,1,0,1,1,81,80,93,93,10
"883",82,"[28]aJHggqIcHcidKocJvcGHqFdCmfGJ",176,0.99435,28,177,1,176,1,1,0,1,1,89,88,88,88,10
"884",83,"[28]aJHggqIcHcidKocJvcGHqFdCmfGJ",179,0.994444,28,180,1,179,1,1,0,1,1,99,98,81,81,10
"885",84,"[28]aJHggqIcHcidKocJvcGHqFdCmfGJ",173,0.994253,28,174,1,173,1,1,0,1,1,80,79,94,94,10
"886",85,"[28]aJHggqIcHcidKocJvcGHqFdCmfGJ",175,0.994318,28,176,1,175,1,1,0,1,1,86,85,90,90,10
"887",86,"[28]aJHggqIcHcidKocJvcGHqFdCmfGJ",176,0.99435,28,177,1,176,1,1,0,1,1,89,88,88,88,10
"888",87,"[28]aJHggqIcHcidKocJvcGHqFdCmfGJ",179,0.994444,28,180,1,179,1,1,0,1,1,98,97,82,82,10
"889",88,"[28]aJHggqIcHcidKocJvcGHqFdCmfGJ",176,0.99435,28,177,1,176,1,1,0,1,1,88,87,89,89,10
"890",89,"[28]aJHggqIcHcidKocJvcGHqFdCmfGJ",178,0.994413,28,179,1,178,1,1,0,1,1,97,96,82,82,10
"891",90,"[28]aJHggqIcHcidKocJvcGHqFdCmfGJ",180,0.994475,28,181,1,180,1,1,0,1,1,99,98,82,82,10
"892",91,"[28]aJHggqIcHcidKocJvcGHqFdCmfGJ",176,0.99435,28,177,1,176,1,1,0,1,1,90,89,87,87,10
"893",92,"[28]aJHggqIcHcidKocJvcGHqFdCmfGJ",178,0.994413,28,179,1,178,1,1,0,1,1,93,92,86,86,10
"894",93,"[28]aJHggqIcHcidKocJvcGHqFdCmfGJ",180,0.994475,28,181,1,180,1,1,0,1,1,102,101,79,79,10
"895",94,"[28]aJHggqIcHcidKocJvcGHqFdCmfGJ",179,0.994444,28,180,1,179,1,1,0,1,1,98,97,82,82,10
"896",95,"[28]aJHggqIcHcidKocJvcGHqFdCmfGJ",172,0.99422,28,173,1,172,1,1,0,1,1,77,76,96,96,10
"897",96,"[28]aJHggqIcHcidKocJvcGHqFdCmfGJ",175,0.994318,28,176,1,175,1,1,0,1,1,86,85,90,90,10
"898",97,"[28]aJHggqIcHcidKocJvcGHqFdCmfGJ",175,0.994318,28,176,1,175,1,1,0,1,1,87,86,89,89,10
"899",98,"[28]aJHggqIcHcidKocJvcGHqFdCmfGJ",179,0.994444,28,180,1,179,1,1,0,1,1,97,96,83,83,10
"900",99,"[28]aJHggqIcHcidKocJvcGHqFdCmfGJ",178,0.994413,28,179,1,178,1,1,0,1,1,96,95,83,83,10
"901",0,"[26]CJHggqIHcdKpcJvcGHqvdCjHdb",166,0.994012,26,167,1,166,1,1,0,1,1,81,80,86,86,11
"902",1,"[26]CJHggqIHcdKpcJvcGHqvdCjHdb",169,0.994118,26,170,1,169,1,1,0,1,1,90,89,80,80,11
"903",2,"[26]CJHggqIHcdKpcJvcGHqvdCjHdb",171,0.994186,26,172,1,171,1,1,0,1,1,95,94,77,77,11
"904",3,"[26]CJHggqIHcdKpcJvcGHqvdCjHdb",166,0.994012,26,167,1,166,1,1,0,1,1,82,81,85,85,11
"905",4,"[26]CJHggqIHcdKpcJvcGHqvdCjHdb",165,0.993976,26,166,1,165,1,1,0,1,1,79,78,87,87,11
"906",5,"[26]CJHggqIHcdKpcJvcGHqvdCjHdb",167,0.994048,26,168,1,167,1,1,0,1,1,85,84,83,83,11
"907",6,"[26]CJHggqIHcdKpcJvcGHqvdCjHdb",171,0.994186,26,172,1,171,1,1,0,1,1,96,95,76,76,11
"908",7,"[26]CJHggqIHcdKpcJvcGHqvdCjHdb",170,0.994152,26,171,1,170,1,1,0,1,1,93,92,78,78,11
"909",8,"[26]CJHggqIHcdKpcJvcGHqvdCjHdb",165,0.993976,26,166,1,165,1,1,0,1,1,79,78,87,87,11
"910",9,"[26]CJHggqIHcdKpcJvcGHqvdCjHdb",167,0.994048,26,168,1,167,1,1,0,1,1,85,84,83,83,11
"911",10,"[26]CJHggqIHcdKpcJvcGHqvdCjHdb",162,0.993865,26,163,1,162,1,1,0,1,1,72,71,91,91,11
"912",11,"[26]CJHggqIHcdKpcJvcGHqvdCjHdb",166,0.994012,26,167,1,166,1,1,0,1,1,82,81,85,85,11
"913",12,"[26]CJHggqIHcdKpcJvcGHqvdCjHdb",168,0.994083,26,169,1,168,1,1,0,1,1,88,87,81,81,11
"914",13,"[26]CJHggqIHcdKpcJvcGHqvdCjHdb",164,0.993939,26,165,1,164,1,1,0,1,1,76,75,89,89,11
"915",14,"[26]CJHggqIHcdKpcJvcGHqvdCjHdb",168,0.994083,26,169,1,168,1,1,0,1,1,88,87,81,81,11
"916",15,"[26]CJHggqIHcdKpcJvcGHqvdCjHdb",174,0.994286,26,175,1,174,1,1,0,1,1,102,101,73,73,11
"917",16,"[26]CJHggqIHcdKpcJvcGHqvdCjHdb",170,0.994152,26,171,1,170,1,1,0,1,1,93,92,78,78,11
"918",17,"[26]CJHggqIHcdKpcJvcGHqvdCjHdb",169,0.994118,26,170,1,169,1,1,0,1,1,89,88,81,81,11
"919",18,"[26]CJHggqIHcdKpcJvcGHqvdCjHdb",170,0.994152,26,171,1,170,1,1,0,1,1,92,91,79,79,11
"920",19,"[26]CJHggqIHcdKpcJvcGHqvdCjHdb",164,0.993939,26,165,1,164,1,1,0,1,1,76,75,89,89,11
"921",20,"[26]CJHggqIHcdKpcJvcGHqvdCjHdb",164,0.993939,26,165,1,164,1,1,0,1,1,77,76,88,88,11
"922",21,"[26]CJHggqIHcdKpcJvcGHqvdCjHdb",170,0.994152,26,171,1,170,1,1,0,1,1,92,91,79,79,11
"923",22,"[26]CJHggqIHcdKpcJvcGHqvdCjHdb",168,0.994083,26,169,1,168,1,1,0,1,1,87,86,82,82,11
"924",23,"[26]CJHggqIHcdKpcJvcGHqvdCjHdb",164,0.993939,26,165,1,164,1,1,0,1,1,76,75,89,89,11
"925",24,"[26]CJHggqIHcdKpcJvcGHqvdCjHdb",170,0.994152,26,171,1,170,1,1,0,1,1,92,91,79,79,11
"926",25,"[26]CJHggqIHcdKpcJvcGHqvdCjHdb",165,0.993976,26,166,1,165,1,1,0,1,1,80,79,86,86,11
"927",26,"[26]CJHggqIHcdKpcJvcGHqvdCjHdb",167,0.994048,26,168,1,167,1,1,0,1,1,85,84,83,83,11
"928",27,"[26]CJHggqIHcdKpcJvcGHqvdCjHdb",162,0.993865,26,163,1,162,1,1,0,1,1,70,69,93,93,11
"929",28,"[26]CJHggqIHcdKpcJvcGHqvdCjHdb",169,0.994118,26,170,1,169,1,1,0,1,1,90,89,80,80,11
"930",29,"[26]CJHggqIHcdKpcJvcGHqvdCjHdb",169,0.994118,26,170,1,169,1,1,0,1,1,91,90,79,79,11
"931",30,"[26]CJHggqIHcdKpcJvcGHqvdCjHdb",170,0.994152,26,171,1,170,1,1,0,1,1,91,90,80,80,11
"932",31,"[26]CJHggqIHcdKpcJvcGHqvdCjHdb",168,0.994083,26,169,1,168,1,1,0,1,1,87,86,82,82,11
"933",32,"[26]CJHggqIHcdKpcJvcGHqvdCjHdb",167,0.994048,26,168,1,167,1,1,0,1,1,85,84,83,83,11
"934",33,"[26]CJHggqIHcdKpcJvcGHqvdCjHdb",169,0.994118,26,170,1,169,1,1,0,1,1,89,88,81,81,11
"935",34,"[26]CJHggqIHcdKpcJvcGHqvdCjHdb",163,0.993902,26,164,1,163,1,1,0,1,1,74,73,90,90,11
"936",35,"[26]CJHggqIHcdKpcJvcGHqvdCjHdb",168,0.994083,26,169,1,168,1,1,0,1,1,86,85,83,83,11
"937",36,"[26]CJHggqIHcdKpcJvcGHqvdCjHdb",170,0.994152,26,171,1,170,1,1,0,1,1,94,93,77,77,11
"938",37,"[26]CJHggqIHcdKpcJvcGHqvdCjHdb",167,0.994048,26,168,1,167,1,1,0,1,1,85,84,83,83,11
"939",38,"[26]CJHggqIHcdKpcJvcGHqvdCjHdb",167,0.994048,26,168,1,167,1,1,0,1,1,85,84,83,83,11
"940",39,"[26]CJHggqIHcdKpcJvcGHqvdCjHdb",164,0.993939,26,165,1,164,1,1,0,1,1,76,75,89,89,11
"941",40,"[26]CJHggqIHcdKpcJvcGHqvdCjHdb",167,0.994048,26,168,1,167,1,1,0,1,1,85,84,83,83,11
"942",41,"[26]CJHggqIHcdKpcJvcGHqvdCjHdb",167,0.994048,26,168,1,167,1,1,0,1,1,84,83,84,84,11
"943",42,"[26]CJHggqIHcdKpcJvcGHqvdCjHdb",164,0.993939,26,165,1,164,1,1,0,1,1,76,75,89,89,11
"944",43,"[26]CJHggqIHcdKpcJvcGHqvdCjHdb",167,0.994048,26,168,1,167,1,1,0,1,1,83,82,85,85,11
"945",44,"[26]CJHggqIHcdKpcJvcGHqvdCjHdb",167,0.994048,26,168,1,167,1,1,0,1,1,85,84,83,83,11
"946",45,"[26]CJHggqIHcdKpcJvcGHqvdCjHdb",171,0.994186,26,172,1,171,1,1,0,1,1,96,95,76,76,11
"947",46,"[26]CJHggqIHcdKpcJvcGHqvdCjHdb",168,0.994083,26,169,1,168,1,1,0,1,1,88,87,81,81,11
"948",47,"[26]CJHggqIHcdKpcJvcGHqvdCjHdb",175,0.994318,26,176,1,175,1,1,0,1,1,107,106,69,69,11
"949",48,"[26]CJHggqIHcdKpcJvcGHqvdCjHdb",170,0.994152,26,171,1,170,1,1,0,1,1,93,92,78,78,11
"950",49,"[26]CJHggqIHcdKpcJvcGHqvdCjHdb",168,0.994083,26,169,1,168,1,1,0,1,1,88,87,81,81,11
"951",50,"[26]CJHggqIHcdKpcJvcGHqvdCjHdb",167,0.994048,26,168,1,167,1,1,0,1,1,85,84,83,83,11
"952",51,"[26]CJHggqIHcdKpcJvcGHqvdCjHdb",171,0.994186,26,172,1,171,1,1,0,1,1,92,91,80,80,11
"953",52,"[26]CJHggqIHcdKpcJvcGHqvdCjHdb",169,0.994118,26,170,1,169,1,1,0,1,1,88,87,82,82,11
"954",53,"[26]CJHggqIHcdKpcJvcGHqvdCjHdb",170,0.994152,26,171,1,170,1,1,0,1,1,93,92,78,78,11
"955",54,"[26]CJHggqIHcdKpcJvcGHqvdCjHdb",169,0.994118,26,170,1,169,1,1,0,1,1,90,89,80,80,11
"956",55,"[26]CJHggqIHcdKpcJvcGHqvdCjHdb",168,0.994083,26,169,1,168,1,1,0,1,1,87,86,82,82,11
"957",56,"[26]CJHggqIHcdKpcJvcGHqvdCjHdb",166,0.994012,26,167,1,166,1,1,0,1,1,82,81,85,85,11
"958",57,"[26]CJHggqIHcdKpcJvcGHqvdCjHdb",171,0.994186,26,172,1,171,1,1,0,1,1,94,93,78,78,11
"959",58,"[26]CJHggqIHcdKpcJvcGHqvdCjHdb",168,0.994083,26,169,1,168,1,1,0,1,1,87,86,82,82,11
"960",59,"[26]CJHggqIHcdKpcJvcGHqvdCjHdb",164,0.993939,26,165,1,164,1,1,0,1,1,76,75,89,89,11
"961",60,"[26]CJHggqIHcdKpcJvcGHqvdCjHdb",172,0.99422,26,173,1,172,1,1,0,1,1,98,97,75,75,11
"962",61,"[26]CJHggqIHcdKpcJvcGHqvdCjHdb",172,0.99422,26,173,1,172,1,1,0,1,1,99,98,74,74,11
"963",62,"[26]CJHggqIHcdKpcJvcGHqvdCjHdb",164,0.993939,26,165,1,164,1,1,0,1,1,77,76,88,88,11
"964",63,"[26]CJHggqIHcdKpcJvcGHqvdCjHdb",165,0.993976,26,166,1,165,1,1,0,1,1,80,79,86,86,11
"965",64,"[26]CJHggqIHcdKpcJvcGHqvdCjHdb",170,0.994152,26,171,1,170,1,1,0,1,1,92,91,79,79,11
"966",65,"[26]CJHggqIHcdKpcJvcGHqvdCjHdb",168,0.994083,26,169,1,168,1,1,0,1,1,87,86,82,82,11
"967",66,"[26]CJHggqIHcdKpcJvcGHqvdCjHdb",167,0.994048,26,168,1,167,1,1,0,1,1,85,84,83,83,11
"968",67,"[26]CJHggqIHcdKpcJvcGHqvdCjHdb",177,0.994382,26,178,1,177,1,1,0,1,1,111,110,67,67,11
"969",68,"[26]CJHggqIHcdKpcJvcGHqvdCjHdb",169,0.994118,26,170,1,169,1,1,0,1,1,89,88,81,81,11
"970",69,"[26]CJHggqIHcdKpcJvcGHqvdCjHdb",171,0.994186,26,172,1,171,1,1,0,1,1,95,94,77,77,11
"971",70,"[26]CJHggqIHcdKpcJvcGHqvdCjHdb",164,0.993939,26,165,1,164,1,1,0,1,1,77,76,88,88,11
"972",71,"[26]CJHggqIHcdKpcJvcGHqvdCjHdb",169,0.994118,26,170,1,169,1,1,0,1,1,91,90,79,79,11
"973",72,"[26]CJHggqIHcdKpcJvcGHqvdCjHdb",172,0.99422,26,173,1,172,1,1,0,1,1,98,97,75,75,11
"974",73,"[26]CJHggqIHcdKpcJvcGHqvdCjHdb",168,0.994083,26,169,1,168,1,1,0,1,1,88,87,81,81,11
"975",74,"[26]CJHggqIHcdKpcJvcGHqvdCjHdb",169,0.994118,26,170,1,169,1,1,0,1,1,90,89,80,80,11
"976",75,"[26]CJHggqIHcdKpcJvcGHqvdCjHdb",167,0.994048,26,168,1,167,1,1,0,1,1,83,82,85,85,11
"977",76,"[26]CJHggqIHcdKpcJvcGHqvdCjHdb",167,0.994048,26,168,1,167,1,1,0,1,1,85,84,83,83,11
"978",77,"[26]CJHggqIHcdKpcJvcGHqvdCjHdb",167,0.994048,26,168,1,167,1,1,0,1,1,86,85,82,82,11
"979",78,"[26]CJHggqIHcdKpcJvcGHqvdCjHdb",165,0.993976,26,166,1,165,1,1,0,1,1,79,78,87,87,11
"980",79,"[26]CJHggqIHcdKpcJvcGHqvdCjHdb",169,0.994118,26,170,1,169,1,1,0,1,1,89,88,81,81,11
"981",80,"[26]CJHggqIHcdKpcJvcGHqvdCjHdb",165,0.993976,26,166,1,165,1,1,0,1,1,79,78,87,87,11
"982",81,"[26]CJHggqIHcdKpcJvcGHqvdCjHdb",174,0.994286,26,175,1,174,1,1,0,1,1,104,103,71,71,11
"983",82,"[26]CJHggqIHcdKpcJvcGHqvdCjHdb",171,0.994186,26,172,1,171,1,1,0,1,1,97,96,75,75,11
"984",83,"[26]CJHggqIHcdKpcJvcGHqvdCjHdb",171,0.994186,26,172,1,171,1,1,0,1,1,95,94,77,77,11
"985",84,"[26]CJHggqIHcdKpcJvcGHqvdCjHdb",164,0.993939,26,165,1,164,1,1,0,1,1,75,74,90,90,11
"986",85,"[26]CJHggqIHcdKpcJvcGHqvdCjHdb",167,0.994048,26,168,1,167,1,1,0,1,1,86,85,82,82,11
"987",86,"[26]CJHggqIHcdKpcJvcGHqvdCjHdb",167,0.994048,26,168,1,167,1,1,0,1,1,84,83,84,84,11
"988",87,"[26]CJHggqIHcdKpcJvcGHqvdCjHdb",166,0.994012,26,167,1,166,1,1,0,1,1,83,82,84,84,11
"989",88,"[26]CJHggqIHcdKpcJvcGHqvdCjHdb",167,0.994048,26,168,1,167,1,1,0,1,1,84,83,84,84,11
"990",89,"[26]CJHggqIHcdKpcJvcGHqvdCjHdb",168,0.994083,26,169,1,168,1,1,0,1,1,87,86,82,82,11
"991",90,"[26]CJHggqIHcdKpcJvcGHqvdCjHdb",166,0.994012,26,167,1,166,1,1,0,1,1,82,81,85,85,11
"992",91,"[26]CJHggqIHcdKpcJvcGHqvdCjHdb",163,0.993902,26,164,1,163,1,1,0,1,1,73,72,91,91,11
"993",92,"[26]CJHggqIHcdKpcJvcGHqvdCjHdb",166,0.994012,26,167,1,166,1,1,0,1,1,83,82,84,84,11
"994",93,"[26]CJHggqIHcdKpcJvcGHqvdCjHdb",162,0.993865,26,163,1,162,1,1,0,1,1,71,70,92,92,11
"995",94,"[26]CJHggqIHcdKpcJvcGHqvdCjHdb",171,0.994186,26,172,1,171,1,1,0,1,1,95,94,77,77,11
"996",95,"[26]CJHggqIHcdKpcJvcGHqvdCjHdb",167,0.994048,26,168,1,167,1,1,0,1,1,85,84,83,83,11
"997",96,"[26]CJHggqIHcdKpcJvcGHqvdCjHdb",168,0.994083,26,169,1,168,1,1,0,1,1,87,86,82,82,11
"998",97,"[26]CJHggqIHcdKpcJvcGHqvdCjHdb",166,0.994012,26,167,1,166,1,1,0,1,1,82,81,85,85,11
"999",98,"[26]CJHggqIHcdKpcJvcGHqvdCjHdb",171,0.994186,26,172,1,171,1,1,0,1,1,92,91,80,80,11
"1000",99,"[26]CJHggqIHcdKpcJvcGHqvdCjHdb",165,0.993976,26,166,1,165,1,1,0,1,1,78,77,88,88,11
"1001",0,"[25]pJHggqIHcedKocJvcGHqxdCJn",168,0.994083,25,169,1,168,1,1,0,1,1,88,87,81,81,13
"1002",1,"[25]pJHggqIHcedKocJvcGHqxdCJn",164,0.993939,25,165,1,164,1,1,0,1,1,78,77,87,87,13
"1003",2,"[25]pJHggqIHcedKocJvcGHqxdCJn",168,0.994083,25,169,1,168,1,1,0,1,1,89,88,80,80,13
"1004",3,"[25]pJHggqIHcedKocJvcGHqxdCJn",166,0.994012,25,167,1,166,1,1,0,1,1,82,81,85,85,13
"1005",4,"[25]pJHggqIHcedKocJvcGHqxdCJn",170,0.994152,25,171,1,170,1,1,0,1,1,94,93,77,77,13
"1006",5,"[25]pJHggqIHcedKocJvcGHqxdCJn",168,0.994083,25,169,1,168,1,1,0,1,1,89,88,80,80,13
"1007",6,"[25]pJHggqIHcedKocJvcGHqxdCJn",171,0.994186,25,172,1,171,1,1,0,1,1,98,97,74,74,13
"1008",7,"[25]pJHggqIHcedKocJvcGHqxdCJn",159,0.99375,25,160,1,159,1,1,0,1,1,64,63,96,96,13
"1009",8,"[25]pJHggqIHcedKocJvcGHqxdCJn",166,0.994012,25,167,1,166,1,1,0,1,1,83,82,84,84,13
"1010",9,"[25]pJHggqIHcedKocJvcGHqxdCJn",164,0.993939,25,165,1,164,1,1,0,1,1,79,78,86,86,13
"1011",10,"[25]pJHggqIHcedKocJvcGHqxdCJn",163,0.993902,25,164,1,163,1,1,0,1,1,76,75,88,88,13
"1012",11,"[25]pJHggqIHcedKocJvcGHqxdCJn",166,0.994012,25,167,1,166,1,1,0,1,1,84,83,83,83,13
"1013",12,"[25]pJHggqIHcedKocJvcGHqxdCJn",166,0.994012,25,167,1,166,1,1,0,1,1,82,81,85,85,13
"1014",13,"[25]pJHggqIHcedKocJvcGHqxdCJn",170,0.994152,25,171,1,170,1,1,0,1,1,94,93,77,77,13
"1015",14,"[25]pJHggqIHcedKocJvcGHqxdCJn",164,0.993939,25,165,1,164,1,1,0,1,1,78,77,87,87,13
"1016",15,"[25]pJHggqIHcedKocJvcGHqxdCJn",160,0.993789,25,161,1,160,1,1,0,1,1,66,65,95,95,13
"1017",16,"[25]pJHggqIHcedKocJvcGHqxdCJn",167,0.994048,25,168,1,167,1,1,0,1,1,84,83,84,84,13
"1018",17,"[25]pJHggqIHcedKocJvcGHqxdCJn",168,0.994083,25,169,1,168,1,1,0,1,1,88,87,81,81,13
"1019",18,"[25]pJHggqIHcedKocJvcGHqxdCJn",160,0.993789,25,161,1,160,1,1,0,1,1,68,67,93,93,13
"1020",19,"[25]pJHggqIHcedKocJvcGHqxdCJn",168,0.994083,25,169,1,168,1,1,0,1,1,88,87,81,81,13
"1021",20,"[25]pJHggqIHcedKocJvcGHqxdCJn",163,0.993902,25,164,1,163,1,1,0,1,1,75,74,89,89,13
"1022",21,"[25]pJHggqIHcedKocJvcGHqxdCJn",168,0.994083,25,169,1,168,1,1,0,1,1,90,89,79,79,13
"1023",22,"[25]pJHggqIHcedKocJvcGHqxdCJn",170,0.994152,25,171,1,170,1,1,0,1,1,95,94,76,76,13
"1024",23,"[25]pJHggqIHcedKocJvcGHqxdCJn",168,0.994083,25,169,1,168,1,1,0,1,1,88,87,81,81,13
"1025",24,"[25]pJHggqIHcedKocJvcGHqxdCJn",168,0.994083,25,169,1,168,1,1,0,1,1,89,88,80,80,13
"1026",25,"[25]pJHggqIHcedKocJvcGHqxdCJn",161,0.993827,25,162,1,161,1,1,0,1,1,69,68,93,93,13
"1027",26,"[25]pJHggqIHcedKocJvcGHqxdCJn",166,0.994012,25,167,1,166,1,1,0,1,1,83,82,84,84,13
"1028",27,"[25]pJHggqIHcedKocJvcGHqxdCJn",164,0.993939,25,165,1,164,1,1,0,1,1,79,78,86,86,13
"1029",28,"[25]pJHggqIHcedKocJvcGHqxdCJn",168,0.994083,25,169,1,168,1,1,0,1,1,87,86,82,82,13
"1030",29,"[25]pJHggqIHcedKocJvcGHqxdCJn",163,0.993902,25,164,1,163,1,1,0,1,1,76,75,88,88,13
"1031",30,"[25]pJHggqIHcedKocJvcGHqxdCJn",163,0.993902,25,164,1,163,1,1,0,1,1,75,74,89,89,13
"1032",31,"[25]pJHggqIHcedKocJvcGHqxdCJn",165,0.993976,25,166,1,165,1,1,0,1,1,79,78,87,87,13
"1033",32,"[25]pJHggqIHcedKocJvcGHqxdCJn",172,0.99422,25,173,1,172,1,1,0,1,1,99,98,74,74,13
"1034",33,"[25]pJHggqIHcedKocJvcGHqxdCJn",165,0.993976,25,166,1,165,1,1,0,1,1,81,80,85,85,13
"1035",34,"[25]pJHggqIHcedKocJvcGHqxdCJn",166,0.994012,25,167,1,166,1,1,0,1,1,84,83,83,83,13
"1036",35,"[25]pJHggqIHcedKocJvcGHqxdCJn",163,0.993902,25,164,1,163,1,1,0,1,1,74,73,90,90,13
"1037",36,"[25]pJHggqIHcedKocJvcGHqxdCJn",166,0.994012,25,167,1,166,1,1,0,1,1,82,81,85,85,13
"1038",37,"[25]pJHggqIHcedKocJvcGHqxdCJn",166,0.994012,25,167,1,166,1,1,0,1,1,83,82,84,84,13
"1039",38,"[25]pJHggqIHcedKocJvcGHqxdCJn",166,0.994012,25,167,1,166,1,1,0,1,1,84,83,83,83,13
"1040",39,"[25]pJHggqIHcedKocJvcGHqxdCJn",163,0.993902,25,164,1,163,1,1,0,1,1,76,75,88,88,13
"1041",40,"[25]pJHggqIHcedKocJvcGHqxdCJn",165,0.993976,25,166,1,165,1,1,0,1,1,80,79,86,86,13
"1042",41,"[25]pJHggqIHcedKocJvcGHqxdCJn",166,0.994012,25,167,1,166,1,1,0,1,1,82,81,85,85,13
"1043",42,"[25]pJHggqIHcedKocJvcGHqxdCJn",168,0.994083,25,169,1,168,1,1,0,1,1,88,87,81,81,13
"1044",43,"[25]pJHggqIHcedKocJvcGHqxdCJn",161,0.993827,25,162,1,161,1,1,0,1,1,70,69,92,92,13
"1045",44,"[25]pJHggqIHcedKocJvcGHqxdCJn",164,0.993939,25,165,1,164,1,1,0,1,1,78,77,87,87,13
"1046",45,"[25]pJHggqIHcedKocJvcGHqxdCJn",164,0.993939,25,165,1,164,1,1,0,1,1,79,78,86,86,13
"1047",46,"[25]pJHggqIHcedKocJvcGHqxdCJn",164,0.993939,25,165,1,164,1,1,0,1,1,77,76,88,88,13
"1048",47,"[25]pJHggqIHcedKocJvcGHqxdCJn",164,0.993939,25,165,1,164,1,1,0,1,1,77,76,88,88,13
"1049",48,"[25]pJHggqIHcedKocJvcGHqxdCJn",166,0.994012,25,167,1,166,1,1,0,1,1,84,83,83,83,13
"1050",49,"[25]pJHggqIHcedKocJvcGHqxdCJn",170,0.994152,25,171,1,170,1,1,0,1,1,91,90,80,80,13
"1051",50,"[25]pJHggqIHcedKocJvcGHqxdCJn",170,0.994152,25,171,1,170,1,1,0,1,1,95,94,76,76,13
"1052",51,"[25]pJHggqIHcedKocJvcGHqxdCJn",164,0.993939,25,165,1,164,1,1,0,1,1,78,77,87,87,13
"1053",52,"[25]pJHggqIHcedKocJvcGHqxdCJn",164,0.993939,25,165,1,164,1,1,0,1,1,78,77,87,87,13
"1054",53,"[25]pJHggqIHcedKocJvcGHqxdCJn",167,0.994048,25,168,1,167,1,1,0,1,1,87,86,81,81,13
"1055",54,"[25]pJHggqIHcedKocJvcGHqxdCJn",169,0.994118,25,170,1,169,1,1,0,1,1,92,91,78,78,13
"1056",55,"[25]pJHggqIHcedKocJvcGHqxdCJn",170,0.994152,25,171,1,170,1,1,0,1,1,95,94,76,76,13
"1057",56,"[25]pJHggqIHcedKocJvcGHqxdCJn",165,0.993976,25,166,1,165,1,1,0,1,1,81,80,85,85,13
"1058",57,"[25]pJHggqIHcedKocJvcGHqxdCJn",167,0.994048,25,168,1,167,1,1,0,1,1,86,85,82,82,13
"1059",58,"[25]pJHggqIHcedKocJvcGHqxdCJn",165,0.993976,25,166,1,165,1,1,0,1,1,81,80,85,85,13
"1060",59,"[25]pJHggqIHcedKocJvcGHqxdCJn",165,0.993976,25,166,1,165,1,1,0,1,1,79,78,87,87,13
"1061",60,"[25]pJHggqIHcedKocJvcGHqxdCJn",168,0.994083,25,169,1,168,1,1,0,1,1,90,89,79,79,13
"1062",61,"[25]pJHggqIHcedKocJvcGHqxdCJn",170,0.994152,25,171,1,170,1,1,0,1,1,93,92,78,78,13
"1063",62,"[25]pJHggqIHcedKocJvcGHqxdCJn",165,0.993976,25,166,1,165,1,1,0,1,1,81,80,85,85,13
"1064",63,"[25]pJHggqIHcedKocJvcGHqxdCJn",164,0.993939,25,165,1,164,1,1,0,1,1,75,74,90,90,13
"1065",64,"[25]pJHggqIHcedKocJvcGHqxdCJn",169,0.994118,25,170,1,169,1,1,0,1,1,92,91,78,78,13
"1066",65,"[25]pJHggqIHcedKocJvcGHqxdCJn",169,0.994118,25,170,1,169,1,1,0,1,1,91,90,79,79,13
"1067",66,"[25]pJHggqIHcedKocJvcGHqxdCJn",168,0.994083,25,169,1,168,1,1,0,1,1,88,87,81,81,13
"1068",67,"[25]pJHggqIHcedKocJvcGHqxdCJn",168,0.994083,25,169,1,168,1,1,0,1,1,90,89,79,79,13
"1069",68,"[25]pJHggqIHcedKocJvcGHqxdCJn",167,0.994048,25,168,1,167,1,1,0,1,1,86,85,82,82,13
"1070",69,"[25]pJHggqIHcedKocJvcGHqxdCJn",164,0.993939,25,165,1,164,1,1,0,1,1,78,77,87,87,13
"1071",70,"[25]pJHggqIHcedKocJvcGHqxdCJn",162,0.993865,25,163,1,162,1,1,0,1,1,72,71,91,91,13
"1072",71,"[25]pJHggqIHcedKocJvcGHqxdCJn",165,0.993976,25,166,1,165,1,1,0,1,1,81,80,85,85,13
"1073",72,"[25]pJHggqIHcedKocJvcGHqxdCJn",169,0.994118,25,170,1,169,1,1,0,1,1,91,90,79,79,13
"1074",73,"[25]pJHggqIHcedKocJvcGHqxdCJn",167,0.994048,25,168,1,167,1,1,0,1,1,85,84,83,83,13
"1075",74,"[25]pJHggqIHcedKocJvcGHqxdCJn",174,0.994286,25,175,1,174,1,1,0,1,1,103,102,72,72,13
"1076",75,"[25]pJHggqIHcedKocJvcGHqxdCJn",168,0.994083,25,169,1,168,1,1,0,1,1,88,87,81,81,13
"1077",76,"[25]pJHggqIHcedKocJvcGHqxdCJn",164,0.993939,25,165,1,164,1,1,0,1,1,77,76,88,88,13
"1078",77,"[25]pJHggqIHcedKocJvcGHqxdCJn",164,0.993939,25,165,1,164,1,1,0,1,1,79,78,86,86,13
"1079",78,"[25]pJHggqIHcedKocJvcGHqxdCJn",164,0.993939,25,165,1,164,1,1,0,1,1,78,77,87,87,13
"1080",79,"[25]pJHggqIHcedKocJvcGHqxdCJn",170,0.994152,25,171,1,170,1,1,0,1,1,93,92,78,78,13
"1081",80,"[25]pJHggqIHcedKocJvcGHqxdCJn",166,0.994012,25,167,1,166,1,1,0,1,1,84,83,83,83,13
"1082",81,"[25]pJHggqIHcedKocJvcGHqxdCJn",167,0.994048,25,168,1,167,1,1,0,1,1,85,84,83,83,13
"1083",82,"[25]pJHggqIHcedKocJvcGHqxdCJn",172,0.99422,25,173,1,172,1,1,0,1,1,96,95,77,77,13
"1084",83,"[25]pJHggqIHcedKocJvcGHqxdCJn",162,0.993865,25,163,1,162,1,1,0,1,1,72,71,91,91,13
"1085",84,"[25]pJHggqIHcedKocJvcGHqxdCJn",163,0.993902,25,164,1,163,1,1,0,1,1,75,74,89,89,13
"1086",85,"[25]pJHggqIHcedKocJvcGHqxdCJn",164,0.993939,25,165,1,164,1,1,0,1,1,77,76,88,88,13
"1087",86,"[25]pJHggqIHcedKocJvcGHqxdCJn",163,0.993902,25,164,1,163,1,1,0,1,1,74,73,90,90,13
"1088",87,"[25]pJHggqIHcedKocJvcGHqxdCJn",164,0.993939,25,165,1,164,1,1,0,1,1,77,76,88,88,13
"1089",88,"[25]pJHggqIHcedKocJvcGHqxdCJn",166,0.994012,25,167,1,166,1,1,0,1,1,84,83,83,83,13
"1090",89,"[25]pJHggqIHcedKocJvcGHqxdCJn",163,0.993902,25,164,1,163,1,1,0,1,1,76,75,88,88,13
"1091",90,"[25]pJHggqIHcedKocJvcGHqxdCJn",166,0.994012,25,167,1,166,1,1,0,1,1,82,81,85,85,13
"1092",91,"[25]pJHggqIHcedKocJvcGHqxdCJn",164,0.993939,25,165,1,164,1,1,0,1,1,79,78,86,86,13
"1093",92,"[25]pJHggqIHcedKocJvcGHqxdCJn",168,0.994083,25,169,1,168,1,1,0,1,1,89,88,80,80,13
"1094",93,"[25]pJHggqIHcedKocJvcGHqxdCJn",168,0.994083,25,169,1,168,1,1,0,1,1,87,86,82,82,13
"1095",94,"[25]pJHggqIHcedKocJvcGHqxdCJn",166,0.994012,25,167,1,166,1,1,0,1,1,82,81,85,85,13
"1096",95,"[25]pJHggqIHcedKocJvcGHqxdCJn",172,0.99422,25,173,1,172,1,1,0,1,1,101,100,72,72,13
"1097",96,"[25]pJHggqIHcedKocJvcGHqxdCJn",167,0.994048,25,168,1,167,1,1,0,1,1,85,84,83,83,13
"1098",97,"[25]pJHggqIHcedKocJvcGHqxdCJn",168,0.994083,25,169,1,168,1,1,0,1,1,89,88,80,80,13
"1099",98,"[25]pJHggqIHcedKocJvcGHqxdCJn",164,0.993939,25,165,1,164,1,1,0,1,1,76,75,89,89,13
"1100",99,"[25]pJHggqIHcedKocJvcGHqxdCJn",164,0.993939,25,165,1,164,1,1,0,1,1,78,77,87,87,13
"1101",0,"[32]yJHglqIuHBidKocJwcGHqFdClIqaAdnq",173,0.994253,32,174,1,173,1,1,0,1,1,79,78,95,95,14
"1102",1,"[32]yJHglqIuHBidKocJwcGHqFdClIqaAdnq",174,0.994286,32,175,1,174,1,1,0,1,1,82,81,93,93,14
"1103",2,"[32]yJHglqIuHBidKocJwcGHqFdClIqaAdnq",180,0.994475,32,181,1,180,1,1,0,1,1,102,101,79,79,14
"1104",3,"[32]yJHglqIuHBidKocJwcGHqFdClIqaAdnq",173,0.994253,32,174,1,173,1,1,0,1,1,81,80,93,93,14
"1105",4,"[32]yJHglqIuHBidKocJwcGHqFdClIqaAdnq",178,0.994413,32,179,1,178,1,1,0,1,1,94,93,85,85,14
"1106",5,"[32]yJHglqIuHBidKocJwcGHqFdClIqaAdnq",178,0.994413,32,179,1,178,1,1,0,1,1,97,96,82,82,14
"1107",6,"[32]yJHglqIuHBidKocJwcGHqFdClIqaAdnq",175,0.994318,32,176,1,175,1,1,0,1,1,85,84,91,91,14
"1108",7,"[32]yJHglqIuHBidKocJwcGHqFdClIqaAdnq",178,0.994413,32,179,1,178,1,1,0,1,1,92,91,87,87,14
"1109",8,"[32]yJHglqIuHBidKocJwcGHqFdClIqaAdnq",173,0.994253,32,174,1,173,1,1,0,1,1,79,78,95,95,14
"1110",9,"[32]yJHglqIuHBidKocJwcGHqFdClIqaAdnq",179,0.994444,32,180,1,179,1,1,0,1,1,101,100,79,79,14
"1111",10,"[32]yJHglqIuHBidKocJwcGHqFdClIqaAdnq",185,0.994624,32,186,1,185,1,1,0,1,1,117,116,69,69,14
"1112",11,"[32]yJHglqIuHBidKocJwcGHqFdClIqaAdnq",174,0.994286,32,175,1,174,1,1,0,1,1,82,81,93,93,14
"1113",12,"[32]yJHglqIuHBidKocJwcGHqFdClIqaAdnq",176,0.99435,32,177,1,176,1,1,0,1,1,88,87,89,89,14
"1114",13,"[32]yJHglqIuHBidKocJwcGHqFdClIqaAdnq",173,0.994253,32,174,1,173,1,1,0,1,1,80,79,94,94,14
"1115",14,"[32]yJHglqIuHBidKocJwcGHqFdClIqaAdnq",175,0.994318,32,176,1,175,1,1,0,1,1,87,86,89,89,14
"1116",15,"[32]yJHglqIuHBidKocJwcGHqFdClIqaAdnq",179,0.994444,32,180,1,179,1,1,0,1,1,98,97,82,82,14
"1117",16,"[32]yJHglqIuHBidKocJwcGHqFdClIqaAdnq",178,0.994413,32,179,1,178,1,1,0,1,1,94,93,85,85,14
"1118",17,"[32]yJHglqIuHBidKocJwcGHqFdClIqaAdnq",173,0.994253,32,174,1,173,1,1,0,1,1,81,80,93,93,14
"1119",18,"[32]yJHglqIuHBidKocJwcGHqFdClIqaAdnq",173,0.994253,32,174,1,173,1,1,0,1,1,78,77,96,96,14
"1120",19,"[32]yJHglqIuHBidKocJwcGHqFdClIqaAdnq",176,0.99435,32,177,1,176,1,1,0,1,1,90,89,87,87,14
"1121",20,"[32]yJHglqIuHBidKocJwcGHqFdClIqaAdnq",179,0.994444,32,180,1,179,1,1,0,1,1,98,97,82,82,14
"1122",21,"[32]yJHglqIuHBidKocJwcGHqFdClIqaAdnq",178,0.994413,32,179,1,178,1,1,0,1,1,94,93,85,85,14
"1123",22,"[32]yJHglqIuHBidKocJwcGHqFdClIqaAdnq",176,0.99435,32,177,1,176,1,1,0,1,1,90,89,87,87,14
"1124",23,"[32]yJHglqIuHBidKocJwcGHqFdClIqaAdnq",175,0.994318,32,176,1,175,1,1,0,1,1,87,86,89,89,14
"1125",24,"[32]yJHglqIuHBidKocJwcGHqFdClIqaAdnq",176,0.99435,32,177,1,176,1,1,0,1,1,88,87,89,89,14
"1126",25,"[32]yJHglqIuHBidKocJwcGHqFdClIqaAdnq",176,0.99435,32,177,1,176,1,1,0,1,1,91,90,86,86,14
"1127",26,"[32]yJHglqIuHBidKocJwcGHqFdClIqaAdnq",173,0.994253,32,174,1,173,1,1,0,1,1,80,79,94,94,14
"1128",27,"[32]yJHglqIuHBidKocJwcGHqFdClIqaAdnq",176,0.99435,32,177,1,176,1,1,0,1,1,88,87,89,89,14
"1129",28,"[32]yJHglqIuHBidKocJwcGHqFdClIqaAdnq",171,0.994186,32,172,1,171,1,1,0,1,1,73,72,99,99,14
"1130",29,"[32]yJHglqIuHBidKocJwcGHqFdClIqaAdnq",177,0.994382,32,178,1,177,1,1,0,1,1,93,92,85,85,14
"1131",30,"[32]yJHglqIuHBidKocJwcGHqFdClIqaAdnq",176,0.99435,32,177,1,176,1,1,0,1,1,91,90,86,86,14
"1132",31,"[32]yJHglqIuHBidKocJwcGHqFdClIqaAdnq",177,0.994382,32,178,1,177,1,1,0,1,1,92,91,86,86,14
"1133",32,"[32]yJHglqIuHBidKocJwcGHqFdClIqaAdnq",176,0.99435,32,177,1,176,1,1,0,1,1,88,87,89,89,14
"1134",33,"[32]yJHglqIuHBidKocJwcGHqFdClIqaAdnq",175,0.994318,32,176,1,175,1,1,0,1,1,84,83,92,92,14
"1135",34,"[32]yJHglqIuHBidKocJwcGHqFdClIqaAdnq",176,0.99435,32,177,1,176,1,1,0,1,1,90,89,87,87,14
"1136",35,"[32]yJHglqIuHBidKocJwcGHqFdClIqaAdnq",170,0.994152,32,171,1,170,1,1,0,1,1,70,69,101,101,14
"1137",36,"[32]yJHglqIuHBidKocJwcGHqFdClIqaAdnq",171,0.994186,32,172,1,171,1,1,0,1,1,73,72,99,99,14
"1138",37,"[32]yJHglqIuHBidKocJwcGHqFdClIqaAdnq",177,0.994382,32,178,1,177,1,1,0,1,1,90,89,88,88,14
"1139",38,"[32]yJHglqIuHBidKocJwcGHqFdClIqaAdnq",175,0.994318,32,176,1,175,1,1,0,1,1,87,86,89,89,14
"1140",39,"[32]yJHglqIuHBidKocJwcGHqFdClIqaAdnq",175,0.994318,32,176,1,175,1,1,0,1,1,82,81,94,94,14
"1141",40,"[32]yJHglqIuHBidKocJwcGHqFdClIqaAdnq",182,0.994536,32,183,1,182,1,1,0,1,1,108,107,75,75,14
"1142",41,"[32]yJHglqIuHBidKocJwcGHqFdClIqaAdnq",177,0.994382,32,178,1,177,1,1,0,1,1,92,91,86,86,14
"1143",42,"[32]yJHglqIuHBidKocJwcGHqFdClIqaAdnq",177,0.994382,32,178,1,177,1,1,0,1,1,90,89,88,88,14
"1144",43,"[32]yJHglqIuHBidKocJwcGHqFdClIqaAdnq",171,0.994186,32,172,1,171,1,1,0,1,1,73,72,99,99,14
"1145",44,"[32]yJHglqIuHBidKocJwcGHqFdClIqaAdnq",175,0.994318,32,176,1,175,1,1,0,1,1,87,86,89,89,14
"1146",45,"[32]yJHglqIuHBidKocJwcGHqFdClIqaAdnq",176,0.99435,32,177,1,176,1,1,0,1,1,88,87,89,89,14
"1147",46,"[32]yJHglqIuHBidKocJwcGHqFdClIqaAdnq",181,0.994505,32,182,1,181,1,1,0,1,1,103,102,79,79,14
"1148",47,"[32]yJHglqIuHBidKocJwcGHqFdClIqaAdnq",176,0.99435,32,177,1,176,1,1,0,1,1,89,88,88,88,14
"1149",48,"[32]yJHglqIuHBidKocJwcGHqFdClIqaAdnq",176,0.99435,32,177,1,176,1,1,0,1,1,91,90,86,86,14
"1150",49,"[32]yJHglqIuHBidKocJwcGHqFdClIqaAdnq",178,0.994413,32,179,1,178,1,1,0,1,1,93,92,86,86,14
"1151",50,"[32]yJHglqIuHBidKocJwcGHqFdClIqaAdnq",175,0.994318,32,176,1,175,1,1,0,1,1,85,84,91,91,14
"1152",51,"[32]yJHglqIuHBidKocJwcGHqFdClIqaAdnq",176,0.99435,32,177,1,176,1,1,0,1,1,91,90,86,86,14
"1153",52,"[32]yJHglqIuHBidKocJwcGHqFdClIqaAdnq",178,0.994413,32,179,1,178,1,1,0,1,1,96,95,83,83,14
"1154",53,"[32]yJHglqIuHBidKocJwcGHqFdClIqaAdnq",178,0.994413,32,179,1,178,1,1,0,1,1,95,94,84,84,14
"1155",54,"[32]yJHglqIuHBidKocJwcGHqFdClIqaAdnq",177,0.994382,32,178,1,177,1,1,0,1,1,90,89,88,88,14
"1156",55,"[32]yJHglqIuHBidKocJwcGHqFdClIqaAdnq",174,0.994286,32,175,1,174,1,1,0,1,1,84,83,91,91,14
"1157",56,"[32]yJHglqIuHBidKocJwcGHqFdClIqaAdnq",179,0.994444,32,180,1,179,1,1,0,1,1,98,97,82,82,14
"1158",57,"[32]yJHglqIuHBidKocJwcGHqFdClIqaAdnq",177,0.994382,32,178,1,177,1,1,0,1,1,91,90,87,87,14
"1159",58,"[32]yJHglqIuHBidKocJwcGHqFdClIqaAdnq",175,0.994318,32,176,1,175,1,1,0,1,1,87,86,89,89,14
"1160",59,"[32]yJHglqIuHBidKocJwcGHqFdClIqaAdnq",174,0.994286,32,175,1,174,1,1,0,1,1,83,82,92,92,14
"1161",60,"[32]yJHglqIuHBidKocJwcGHqFdClIqaAdnq",181,0.994505,32,182,1,181,1,1,0,1,1,101,100,81,81,14
"1162",61,"[32]yJHglqIuHBidKocJwcGHqFdClIqaAdnq",180,0.994475,32,181,1,180,1,1,0,1,1,104,103,77,77,14
"1163",62,"[32]yJHglqIuHBidKocJwcGHqFdClIqaAdnq",175,0.994318,32,176,1,175,1,1,0,1,1,85,84,91,91,14
"1164",63,"[32]yJHglqIuHBidKocJwcGHqFdClIqaAdnq",176,0.99435,32,177,1,176,1,1,0,1,1,90,89,87,87,14
"1165",64,"[32]yJHglqIuHBidKocJwcGHqFdClIqaAdnq",175,0.994318,32,176,1,175,1,1,0,1,1,84,83,92,92,14
"1166",65,"[32]yJHglqIuHBidKocJwcGHqFdClIqaAdnq",176,0.99435,32,177,1,176,1,1,0,1,1,86,85,91,91,14
"1167",66,"[32]yJHglqIuHBidKocJwcGHqFdClIqaAdnq",172,0.99422,32,173,1,172,1,1,0,1,1,75,74,98,98,14
"1168",67,"[32]yJHglqIuHBidKocJwcGHqFdClIqaAdnq",179,0.994444,32,180,1,179,1,1,0,1,1,100,99,80,80,14
"1169",68,"[32]yJHglqIuHBidKocJwcGHqFdClIqaAdnq",176,0.99435,32,177,1,176,1,1,0,1,1,89,88,88,88,14
"1170",69,"[32]yJHglqIuHBidKocJwcGHqFdClIqaAdnq",176,0.99435,32,177,1,176,1,1,0,1,1,89,88,88,88,14
"1171",70,"[32]yJHglqIuHBidKocJwcGHqFdClIqaAdnq",176,0.99435,32,177,1,176,1,1,0,1,1,90,89,87,87,14
"1172",71,"[32]yJHglqIuHBidKocJwcGHqFdClIqaAdnq",173,0.994253,32,174,1,173,1,1,0,1,1,79,78,95,95,14
"1173",72,"[32]yJHglqIuHBidKocJwcGHqFdClIqaAdnq",176,0.99435,32,177,1,176,1,1,0,1,1,90,89,87,87,14
"1174",73,"[32]yJHglqIuHBidKocJwcGHqFdClIqaAdnq",173,0.994253,32,174,1,173,1,1,0,1,1,79,78,95,95,14
"1175",74,"[32]yJHglqIuHBidKocJwcGHqFdClIqaAdnq",176,0.99435,32,177,1,176,1,1,0,1,1,90,89,87,87,14
"1176",75,"[32]yJHglqIuHBidKocJwcGHqFdClIqaAdnq",171,0.994186,32,172,1,171,1,1,0,1,1,74,73,98,98,14
"1177",76,"[32]yJHglqIuHBidKocJwcGHqFdClIqaAdnq",174,0.994286,32,175,1,174,1,1,0,1,1,82,81,93,93,14
"1178",77,"[32]yJHglqIuHBidKocJwcGHqFdClIqaAdnq",177,0.994382,32,178,1,177,1,1,0,1,1,93,92,85,85,14
"1179",78,"[32]yJHglqIuHBidKocJwcGHqFdClIqaAdnq",178,0.994413,32,179,1,178,1,1,0,1,1,95,94,84,84,14
"1180",79,"[32]yJHglqIuHBidKocJwcGHqFdClIqaAdnq",176,0.99435,32,177,1,176,1,1,0,1,1,89,88,88,88,14
"1181",80,"[32]yJHglqIuHBidKocJwcGHqFdClIqaAdnq",176,0.99435,32,177,1,176,1,1,0,1,1,85,84,92,92,14
"1182",81,"[32]yJHglqIuHBidKocJwcGHqFdClIqaAdnq",174,0.994286,32,175,1,174,1,1,0,1,1,82,81,93,93,14
"1183",82,"[32]yJHglqIuHBidKocJwcGHqFdClIqaAdnq",175,0.994318,32,176,1,175,1,1,0,1,1,87,86,89,89,14
"1184",83,"[32]yJHglqIuHBidKocJwcGHqFdClIqaAdnq",177,0.994382,32,178,1,177,1,1,0,1,1,92,91,86,86,14
"1185",84,"[32]yJHglqIuHBidKocJwcGHqFdClIqaAdnq",172,0.99422,32,173,1,172,1,1,0,1,1,77,76,96,96,14
"1186",85,"[32]yJHglqIuHBidKocJwcGHqFdClIqaAdnq",179,0.994444,32,180,1,179,1,1,0,1,1,99,98,81,81,14
"1187",86,"[32]yJHglqIuHBidKocJwcGHqFdClIqaAdnq",174,0.994286,32,175,1,174,1,1,0,1,1,84,83,91,91,14
"1188",87,"[32]yJHglqIuHBidKocJwcGHqFdClIqaAdnq",175,0.994318,32,176,1,175,1,1,0,1,1,84,83,92,92,14
"1189",88,"[32]yJHglqIuHBidKocJwcGHqFdClIqaAdnq",180,0.994475,32,181,1,180,1,1,0,1,1,100,99,81,81,14
"1190",89,"[32]yJHglqIuHBidKocJwcGHqFdClIqaAdnq",176,0.99435,32,177,1,176,1,1,0,1,1,91,90,86,86,14
"1191",90,"[32]yJHglqIuHBidKocJwcGHqFdClIqaAdnq",174,0.994286,32,175,1,174,1,1,0,1,1,80,79,95,95,14
"1192",91,"[32]yJHglqIuHBidKocJwcGHqFdClIqaAdnq",172,0.99422,32,173,1,172,1,1,0,1,1,76,75,97,97,14
"1193",92,"[32]yJHglqIuHBidKocJwcGHqFdClIqaAdnq",176,0.99435,32,177,1,176,1,1,0,1,1,90,89,87,87,14
"1194",93,"[32]yJHglqIuHBidKocJwcGHqFdClIqaAdnq",177,0.994382,32,178,1,177,1,1,0,1,1,92,91,86,86,14
"1195",94,"[32]yJHglqIuHBidKocJwcGHqFdClIqaAdnq",171,0.994186,32,172,1,171,1,1,0,1,1,72,71,100,100,14
"1196",95,"[32]yJHglqIuHBidKocJwcGHqFdClIqaAdnq",179,0.994444,32,180,1,179,1,1,0,1,1,98,97,82,82,14
"1197",96,"[32]yJHglqIuHBidKocJwcGHqFdClIqaAdnq",173,0.994253,32,174,1,173,1,1,0,1,1,78,77,96,96,14
"1198",97,"[32]yJHglqIuHBidKocJwcGHqFdClIqaAdnq",173,0.994253,32,174,1,173,1,1,0,1,1,81,80,93,93,14
"1199",98,"[32]yJHglqIuHBidKocJwcGHqFdClIqaAdnq",175,0.994318,32,176,1,175,1,1,0,1,1,85,84,91,91,14
"1200",99,"[32]yJHglqIuHBidKocJwcGHqFdClIqaAdnq",173,0.994253,32,174,1,173,1,1,0,1,1,78,77,96,96,14
"1201",0,"[30]hJHiqIcHcdKocJvcGHqvdCupemJxys",167,0.994048,30,168,1,167,1,1,0,1,1,84,83,84,84,15
"1202",1,"[30]hJHiqIcHcdKocJvcGHqvdCupemJxys",170,0.994152,30,171,1,170,1,1,0,1,1,91,90,80,80,15
"1203",2,"[30]hJHiqIcHcdKocJvcGHqvdCupemJxys",172,0.99422,30,173,1,172,1,1,0,1,1,99,98,74,74,15
"1204",3,"[30]hJHiqIcHcdKocJvcGHqvdCupemJxys",168,0.994083,30,169,1,168,1,1,0,1,1,87,86,82,82,15
"1205",4,"[30]hJHiqIcHcdKocJvcGHqvdCupemJxys",164,0.993939,30,165,1,164,1,1,0,1,1,77,76,88,88,15
"1206",5,"[30]hJHiqIcHcdKocJvcGHqvdCupemJxys",167,0.994048,30,168,1,167,1,1,0,1,1,85,84,83,83,15
"1207",6,"[30]hJHiqIcHcdKocJvcGHqvdCupemJxys",168,0.994083,30,169,1,168,1,1,0,1,1,85,84,84,84,15
"1208",7,"[30]hJHiqIcHcdKocJvcGHqvdCupemJxys",168,0.994083,30,169,1,168,1,1,0,1,1,87,86,82,82,15
"1209",8,"[30]hJHiqIcHcdKocJvcGHqvdCupemJxys",167,0.994048,30,168,1,167,1,1,0,1,1,84,83,84,84,15
"1210",9,"[30]hJHiqIcHcdKocJvcGHqvdCupemJxys",171,0.994186,30,172,1,171,1,1,0,1,1,94,93,78,78,15
"1211",10,"[30]hJHiqIcHcdKocJvcGHqvdCupemJxys",163,0.993902,30,164,1,163,1,1,0,1,1,75,74,89,89,15
"1212",11,"[30]hJHiqIcHcdKocJvcGHqvdCupemJxys",171,0.994186,30,172,1,171,1,1,0,1,1,93,92,79,79,15
"1213",12,"[30]hJHiqIcHcdKocJvcGHqvdCupemJxys",163,0.993902,30,164,1,163,1,1,0,1,1,75,74,89,89,15
"1214",13,"[30]hJHiqIcHcdKocJvcGHqvdCupemJxys",167,0.994048,30,168,1,167,1,1,0,1,1,83,82,85,85,15
"1215",14,"[30]hJHiqIcHcdKocJvcGHqvdCupemJxys",161,0.993827,30,162,1,161,1,1,0,1,1,68,67,94,94,15
"1216",15,"[30]hJHiqIcHcdKocJvcGHqvdCupemJxys",168,0.994083,30,169,1,168,1,1,0,1,1,87,86,82,82,15
"1217",16,"[30]hJHiqIcHcdKocJvcGHqvdCupemJxys",167,0.994048,30,168,1,167,1,1,0,1,1,86,85,82,82,15
"1218",17,"[30]hJHiqIcHcdKocJvcGHqvdCupemJxys",166,0.994012,30,167,1,166,1,1,0,1,1,83,82,84,84,15
"1219",18,"[30]hJHiqIcHcdKocJvcGHqvdCupemJxys",166,0.994012,30,167,1,166,1,1,0,1,1,82,81,85,85,15
"1220",19,"[30]hJHiqIcHcdKocJvcGHqvdCupemJxys",168,0.994083,30,169,1,168,1,1,0,1,1,86,85,83,83,15
"1221",20,"[30]hJHiqIcHcdKocJvcGHqvdCupemJxys",163,0.993902,30,164,1,163,1,1,0,1,1,73,72,91,91,15
"1222",21,"[30]hJHiqIcHcdKocJvcGHqvdCupemJxys",169,0.994118,30,170,1,169,1,1,0,1,1,89,88,81,81,15
"1223",22,"[30]hJHiqIcHcdKocJvcGHqvdCupemJxys",171,0.994186,30,172,1,171,1,1,0,1,1,94,93,78,78,15
"1224",23,"[30]hJHiqIcHcdKocJvcGHqvdCupemJxys",168,0.994083,30,169,1,168,1,1,0,1,1,88,87,81,81,15
"1225",24,"[30]hJHiqIcHcdKocJvcGHqvdCupemJxys",166,0.994012,30,167,1,166,1,1,0,1,1,83,82,84,84,15
"1226",25,"[30]hJHiqIcHcdKocJvcGHqvdCupemJxys",166,0.994012,30,167,1,166,1,1,0,1,1,82,81,85,85,15
"1227",26,"[30]hJHiqIcHcdKocJvcGHqvdCupemJxys",168,0.994083,30,169,1,168,1,1,0,1,1,87,86,82,82,15
"1228",27,"[30]hJHiqIcHcdKocJvcGHqvdCupemJxys",168,0.994083,30,169,1,168,1,1,0,1,1,84,83,85,85,15
"1229",28,"[30]hJHiqIcHcdKocJvcGHqvdCupemJxys",170,0.994152,30,171,1,170,1,1,0,1,1,92,91,79,79,15
"1230",29,"[30]hJHiqIcHcdKocJvcGHqvdCupemJxys",170,0.994152,30,171,1,170,1,1,0,1,1,92,91,79,79,15
"1231",30,"[30]hJHiqIcHcdKocJvcGHqvdCupemJxys",173,0.994253,30,174,1,173,1,1,0,1,1,100,99,74,74,15
"1232",31,"[30]hJHiqIcHcdKocJvcGHqvdCupemJxys",163,0.993902,30,164,1,163,1,1,0,1,1,73,72,91,91,15
"1233",32,"[30]hJHiqIcHcdKocJvcGHqvdCupemJxys",168,0.994083,30,169,1,168,1,1,0,1,1,88,87,81,81,15
"1234",33,"[30]hJHiqIcHcdKocJvcGHqvdCupemJxys",166,0.994012,30,167,1,166,1,1,0,1,1,82,81,85,85,15
"1235",34,"[30]hJHiqIcHcdKocJvcGHqvdCupemJxys",167,0.994048,30,168,1,167,1,1,0,1,1,84,83,84,84,15
"1236",35,"[30]hJHiqIcHcdKocJvcGHqvdCupemJxys",163,0.993902,30,164,1,163,1,1,0,1,1,75,74,89,89,15
"1237",36,"[30]hJHiqIcHcdKocJvcGHqvdCupemJxys",170,0.994152,30,171,1,170,1,1,0,1,1,91,90,80,80,15
"1238",37,"[30]hJHiqIcHcdKocJvcGHqvdCupemJxys",165,0.993976,30,166,1,165,1,1,0,1,1,79,78,87,87,15
"1239",38,"[30]hJHiqIcHcdKocJvcGHqvdCupemJxys",163,0.993902,30,164,1,163,1,1,0,1,1,73,72,91,91,15
"1240",39,"[30]hJHiqIcHcdKocJvcGHqvdCupemJxys",163,0.993902,30,164,1,163,1,1,0,1,1,74,73,90,90,15
"1241",40,"[30]hJHiqIcHcdKocJvcGHqvdCupemJxys",166,0.994012,30,167,1,166,1,1,0,1,1,80,79,87,87,15
"1242",41,"[30]hJHiqIcHcdKocJvcGHqvdCupemJxys",169,0.994118,30,170,1,169,1,1,0,1,1,89,88,81,81,15
"1243",42,"[30]hJHiqIcHcdKocJvcGHqvdCupemJxys",168,0.994083,30,169,1,168,1,1,0,1,1,87,86,82,82,15
"1244",43,"[30]hJHiqIcHcdKocJvcGHqvdCupemJxys",169,0.994118,30,170,1,169,1,1,0,1,1,91,90,79,79,15
"1245",44,"[30]hJHiqIcHcdKocJvcGHqvdCupemJxys",165,0.993976,30,166,1,165,1,1,0,1,1,78,77,88,88,15
"1246",45,"[30]hJHiqIcHcdKocJvcGHqvdCupemJxys",167,0.994048,30,168,1,167,1,1,0,1,1,86,85,82,82,15
"1247",46,"[30]hJHiqIcHcdKocJvcGHqvdCupemJxys",171,0.994186,30,172,1,171,1,1,0,1,1,95,94,77,77,15
"1248",47,"[30]hJHiqIcHcdKocJvcGHqvdCupemJxys",167,0.994048,30,168,1,167,1,1,0,1,1,83,82,85,85,15
"1249",48,"[30]hJHiqIcHcdKocJvcGHqvdCupemJxys",172,0.99422,30,173,1,172,1,1,0,1,1,97,96,76,76,15
"1250",49,"[30]hJHiqIcHcdKocJvcGHqvdCupemJxys",171,0.994186,30,172,1,171,1,1,0,1,1,94,93,78,78,15
"1251",50,"[30]hJHiqIcHcdKocJvcGHqvdCupemJxys",163,0.993902,30,164,1,163,1,1,0,1,1,74,73,90,90,15
"1252",51,"[30]hJHiqIcHcdKocJvcGHqvdCupemJxys",167,0.994048,30,168,1,167,1,1,0,1,1,84,83,84,84,15
"1253",52,"[30]hJHiqIcHcdKocJvcGHqvdCupemJxys",168,0.994083,30,169,1,168,1,1,0,1,1,88,87,81,81,15
"1254",53,"[30]hJHiqIcHcdKocJvcGHqvdCupemJxys",162,0.993865,30,163,1,162,1,1,0,1,1,70,69,93,93,15
"1255",54,"[30]hJHiqIcHcdKocJvcGHqvdCupemJxys",170,0.994152,30,171,1,170,1,1,0,1,1,93,92,78,78,15
"1256",55,"[30]hJHiqIcHcdKocJvcGHqvdCupemJxys",166,0.994012,30,167,1,166,1,1,0,1,1,82,81,85,85,15
"1257",56,"[30]hJHiqIcHcdKocJvcGHqvdCupemJxys",168,0.994083,30,169,1,168,1,1,0,1,1,87,86,82,82,15
"1258",57,"[30]hJHiqIcHcdKocJvcGHqvdCupemJxys",170,0.994152,30,171,1,170,1,1,0,1,1,94,93,77,77,15
"1259",58,"[30]hJHiqIcHcdKocJvcGHqvdCupemJxys",162,0.993865,30,163,1,162,1,1,0,1,1,72,71,91,91,15
"1260",59,"[30]hJHiqIcHcdKocJvcGHqvdCupemJxys",170,0.994152,30,171,1,170,1,1,0,1,1,93,92,78,78,15
"1261",60,"[30]hJHiqIcHcdKocJvcGHqvdCupemJxys",167,0.994048,30,168,1,167,1,1,0,1,1,85,84,83,83,15
"1262",61,"[30]hJHiqIcHcdKocJvcGHqvdCupemJxys",168,0.994083,30,169,1,168,1,1,0,1,1,85,84,84,84,15
"1263",62,"[30]hJHiqIcHcdKocJvcGHqvdCupemJxys",169,0.994118,30,170,1,169,1,1,0,1,1,85,84,85,85,15
"1264",63,"[30]hJHiqIcHcdKocJvcGHqvdCupemJxys",168,0.994083,30,169,1,168,1,1,0,1,1,88,87,81,81,15
"1265",64,"[30]hJHiqIcHcdKocJvcGHqvdCupemJxys",162,0.993865,30,163,1,162,1,1,0,1,1,71,70,92,92,15
"1266",65,"[30]hJHiqIcHcdKocJvcGHqvdCupemJxys",166,0.994012,30,167,1,166,1,1,0,1,1,82,81,85,85,15
"1267",66,"[30]hJHiqIcHcdKocJvcGHqvdCupemJxys",167,0.994048,30,168,1,167,1,1,0,1,1,85,84,83,83,15
"1268",67,"[30]hJHiqIcHcdKocJvcGHqvdCupemJxys",169,0.994118,30,170,1,169,1,1,0,1,1,90,89,80,80,15
"1269",68,"[30]hJHiqIcHcdKocJvcGHqvdCupemJxys",163,0.993902,30,164,1,163,1,1,0,1,1,74,73,90,90,15
"1270",69,"[30]hJHiqIcHcdKocJvcGHqvdCupemJxys",171,0.994186,30,172,1,171,1,1,0,1,1,96,95,76,76,15
"1271",70,"[30]hJHiqIcHcdKocJvcGHqvdCupemJxys",165,0.993976,30,166,1,165,1,1,0,1,1,78,77,88,88,15
"1272",71,"[30]hJHiqIcHcdKocJvcGHqvdCupemJxys",172,0.99422,30,173,1,172,1,1,0,1,1,94,93,79,79,15
"1273",72,"[30]hJHiqIcHcdKocJvcGHqvdCupemJxys",169,0.994118,30,170,1,169,1,1,0,1,1,91,90,79,79,15
"1274",73,"[30]hJHiqIcHcdKocJvcGHqvdCupemJxys",171,0.994186,30,172,1,171,1,1,0,1,1,95,94,77,77,15
"1275",74,"[30]hJHiqIcHcdKocJvcGHqvdCupemJxys",167,0.994048,30,168,1,167,1,1,0,1,1,81,80,87,87,15
"1276",75,"[30]hJHiqIcHcdKocJvcGHqvdCupemJxys",170,0.994152,30,171,1,170,1,1,0,1,1,92,91,79,79,15
"1277",76,"[30]hJHiqIcHcdKocJvcGHqvdCupemJxys",169,0.994118,30,170,1,169,1,1,0,1,1,89,88,81,81,15
"1278",77,"[30]hJHiqIcHcdKocJvcGHqvdCupemJxys",162,0.993865,30,163,1,162,1,1,0,1,1,71,70,92,92,15
"1279",78,"[30]hJHiqIcHcdKocJvcGHqvdCupemJxys",166,0.994012,30,167,1,166,1,1,0,1,1,82,81,85,85,15
"1280",79,"[30]hJHiqIcHcdKocJvcGHqvdCupemJxys",168,0.994083,30,169,1,168,1,1,0,1,1,86,85,83,83,15
"1281",80,"[30]hJHiqIcHcdKocJvcGHqvdCupemJxys",170,0.994152,30,171,1,170,1,1,0,1,1,90,89,81,81,15
"1282",81,"[30]hJHiqIcHcdKocJvcGHqvdCupemJxys",163,0.993902,30,164,1,163,1,1,0,1,1,73,72,91,91,15
"1283",82,"[30]hJHiqIcHcdKocJvcGHqvdCupemJxys",168,0.994083,30,169,1,168,1,1,0,1,1,88,87,81,81,15
"1284",83,"[30]hJHiqIcHcdKocJvcGHqvdCupemJxys",165,0.993976,30,166,1,165,1,1,0,1,1,79,78,87,87,15
"1285",84,"[30]hJHiqIcHcdKocJvcGHqvdCupemJxys",171,0.994186,30,172,1,171,1,1,0,1,1,94,93,78,78,15
"1286",85,"[30]hJHiqIcHcdKocJvcGHqvdCupemJxys",164,0.993939,30,165,1,164,1,1,0,1,1,77,76,88,88,15
"1287",86,"[30]hJHiqIcHcdKocJvcGHqvdCupemJxys",164,0.993939,30,165,1,164,1,1,0,1,1,76,75,89,89,15
"1288",87,"[30]hJHiqIcHcdKocJvcGHqvdCupemJxys",168,0.994083,30,169,1,168,1,1,0,1,1,86,85,83,83,15
"1289",88,"[30]hJHiqIcHcdKocJvcGHqvdCupemJxys",169,0.994118,30,170,1,169,1,1,0,1,1,90,89,80,80,15
"1290",89,"[30]hJHiqIcHcdKocJvcGHqvdCupemJxys",163,0.993902,30,164,1,163,1,1,0,1,1,74,73,90,90,15
"1291",90,"[30]hJHiqIcHcdKocJvcGHqvdCupemJxys",169,0.994118,30,170,1,169,1,1,0,1,1,90,89,80,80,15
"1292",91,"[30]hJHiqIcHcdKocJvcGHqvdCupemJxys",163,0.993902,30,164,1,163,1,1,0,1,1,75,74,89,89,15
"1293",92,"[30]hJHiqIcHcdKocJvcGHqvdCupemJxys",171,0.994186,30,172,1,171,1,1,0,1,1,96,95,76,76,15
"1294",93,"[30]hJHiqIcHcdKocJvcGHqvdCupemJxys",164,0.993939,30,165,1,164,1,1,0,1,1,77,76,88,88,15
"1295",94,"[30]hJHiqIcHcdKocJvcGHqvdCupemJxys",168,0.994083,30,169,1,168,1,1,0,1,1,88,87,81,81,15
"1296",95,"[30]hJHiqIcHcdKocJvcGHqvdCupemJxys",164,0.993939,30,165,1,164,1,1,0,1,1,77,76,88,88,15
"1297",96,"[30]hJHiqIcHcdKocJvcGHqvdCupemJxys",169,0.994118,30,170,1,169,1,1,0,1,1,89,88,81,81,15
"1298",97,"[30]hJHiqIcHcdKocJvcGHqvdCupemJxys",164,0.993939,30,165,1,164,1,1,0,1,1,77,76,88,88,15
"1299",98,"[30]hJHiqIcHcdKocJvcGHqvdCupemJxys",161,0.993827,30,162,1,161,1,1,0,1,1,69,68,93,93,15
"1300",99,"[30]hJHiqIcHcdKocJvcGHqvdCupemJxys",164,0.993939,30,165,1,164,1,1,0,1,1,77,76,88,88,15
"1301",0,"[31]tJHgnlqIHcdKocJvcGHqvdCKmwldfgb",166,0.994012,31,167,1,166,1,1,0,1,1,81,80,86,86,16
"1302",1,"[31]tJHgnlqIHcdKocJvcGHqvdCKmwldfgb",164,0.993939,31,165,1,164,1,1,0,1,1,76,75,89,89,16
"1303",2,"[31]tJHgnlqIHcdKocJvcGHqvdCKmwldfgb",165,0.993976,31,166,1,165,1,1,0,1,1,80,79,86,86,16
"1304",3,"[31]tJHgnlqIHcdKocJvcGHqvdCKmwldfgb",170,0.994152,31,171,1,170,1,1,0,1,1,94,93,77,77,16
"1305",4,"[31]tJHgnlqIHcdKocJvcGHqvdCKmwldfgb",167,0.994048,31,168,1,167,1,1,0,1,1,84,83,84,84,16
"1306",5,"[31]tJHgnlqIHcdKocJvcGHqvdCKmwldfgb",170,0.994152,31,171,1,170,1,1,0,1,1,92,91,79,79,16
"1307",6,"[31]tJHgnlqIHcdKocJvcGHqvdCKmwldfgb",163,0.993902,31,164,1,163,1,1,0,1,1,75,74,89,89,16
"1308",7,"[31]tJHgnlqIHcdKocJvcGHqvdCKmwldfgb",162,0.993865,31,163,1,162,1,1,0,1,1,71,70,92,92,16
"1309",8,"[31]tJHgnlqIHcdKocJvcGHqvdCKmwldfgb",166,0.994012,31,167,1,166,1,1,0,1,1,83,82,84,84,16
"1310",9,"[31]tJHgnlqIHcdKocJvcGHqvdCKmwldfgb",171,0.994186,31,172,1,171,1,1,0,1,1,97,96,75,75,16
"1311",10,"[31]tJHgnlqIHcdKocJvcGHqvdCKmwldfgb",168,0.994083,31,169,1,168,1,1,0,1,1,88,87,81,81,16
"1312",11,"[31]tJHgnlqIHcdKocJvcGHqvdCKmwldfgb",167,0.994048,31,168,1,167,1,1,0,1,1,85,84,83,83,16
"1313",12,"[31]tJHgnlqIHcdKocJvcGHqvdCKmwldfgb",167,0.994048,31,168,1,167,1,1,0,1,1,85,84,83,83,16
"1314",13,"[31]tJHgnlqIHcdKocJvcGHqvdCKmwldfgb",170,0.994152,31,171,1,170,1,1,0,1,1,93,92,78,78,16
"1315",14,"[31]tJHgnlqIHcdKocJvcGHqvdCKmwldfgb",167,0.994048,31,168,1,167,1,1,0,1,1,86,85,82,82,16
"1316",15,"[31]tJHgnlqIHcdKocJvcGHqvdCKmwldfgb",166,0.994012,31,167,1,166,1,1,0,1,1,82,81,85,85,16
"1317",16,"[31]tJHgnlqIHcdKocJvcGHqvdCKmwldfgb",166,0.994012,31,167,1,166,1,1,0,1,1,81,80,86,86,16
"1318",17,"[31]tJHgnlqIHcdKocJvcGHqvdCKmwldfgb",166,0.994012,31,167,1,166,1,1,0,1,1,82,81,85,85,16
"1319",18,"[31]tJHgnlqIHcdKocJvcGHqvdCKmwldfgb",167,0.994048,31,168,1,167,1,1,0,1,1,85,84,83,83,16
"1320",19,"[31]tJHgnlqIHcdKocJvcGHqvdCKmwldfgb",167,0.994048,31,168,1,167,1,1,0,1,1,86,85,82,82,16
"1321",20,"[31]tJHgnlqIHcdKocJvcGHqvdCKmwldfgb",167,0.994048,31,168,1,167,1,1,0,1,1,84,83,84,84,16
"1322",21,"[31]tJHgnlqIHcdKocJvcGHqvdCKmwldfgb",167,0.994048,31,168,1,167,1,1,0,1,1,85,84,83,83,16
"1323",22,"[31]tJHgnlqIHcdKocJvcGHqvdCKmwldfgb",167,0.994048,31,168,1,167,1,1,0,1,1,84,83,84,84,16
"1324",23,"[31]tJHgnlqIHcdKocJvcGHqvdCKmwldfgb",165,0.993976,31,166,1,165,1,1,0,1,1,78,77,88,88,16
"1325",24,"[31]tJHgnlqIHcdKocJvcGHqvdCKmwldfgb",165,0.993976,31,166,1,165,1,1,0,1,1,80,79,86,86,16
"1326",25,"[31]tJHgnlqIHcdKocJvcGHqvdCKmwldfgb",164,0.993939,31,165,1,164,1,1,0,1,1,77,76,88,88,16
"1327",26,"[31]tJHgnlqIHcdKocJvcGHqvdCKmwldfgb",168,0.994083,31,169,1,168,1,1,0,1,1,88,87,81,81,16
"1328",27,"[31]tJHgnlqIHcdKocJvcGHqvdCKmwldfgb",161,0.993827,31,162,1,161,1,1,0,1,1,69,68,93,93,16
"1329",28,"[31]tJHgnlqIHcdKocJvcGHqvdCKmwldfgb",173,0.994253,31,174,1,173,1,1,0,1,1,101,100,73,73,16
"1330",29,"[31]tJHgnlqIHcdKocJvcGHqvdCKmwldfgb",167,0.994048,31,168,1,167,1,1,0,1,1,84,83,84,84,16
"1331",30,"[31]tJHgnlqIHcdKocJvcGHqvdCKmwldfgb",166,0.994012,31,167,1,166,1,1,0,1,1,82,81,85,85,16
"1332",31,"[31]tJHgnlqIHcdKocJvcGHqvdCKmwldfgb",169,0.994118,31,170,1,169,1,1,0,1,1,91,90,79,79,16
"1333",32,"[31]tJHgnlqIHcdKocJvcGHqvdCKmwldfgb",168,0.994083,31,169,1,168,1,1,0,1,1,89,88,80,80,16
"1334",33,"[31]tJHgnlqIHcdKocJvcGHqvdCKmwldfgb",168,0.994083,31,169,1,168,1,1,0,1,1,89,88,80,80,16
"1335",34,"[31]tJHgnlqIHcdKocJvcGHqvdCKmwldfgb",168,0.994083,31,169,1,168,1,1,0,1,1,88,87,81,81,16
"1336",35,"[31]tJHgnlqIHcdKocJvcGHqvdCKmwldfgb",164,0.993939,31,165,1,164,1,1,0,1,1,77,76,88,88,16
"1337",36,"[31]tJHgnlqIHcdKocJvcGHqvdCKmwldfgb",165,0.993976,31,166,1,165,1,1,0,1,1,80,79,86,86,16
"1338",37,"[31]tJHgnlqIHcdKocJvcGHqvdCKmwldfgb",165,0.993976,31,166,1,165,1,1,0,1,1,80,79,86,86,16
"1339",38,"[31]tJHgnlqIHcdKocJvcGHqvdCKmwldfgb",171,0.994186,31,172,1,171,1,1,0,1,1,97,96,75,75,16
"1340",39,"[31]tJHgnlqIHcdKocJvcGHqvdCKmwldfgb",163,0.993902,31,164,1,163,1,1,0,1,1,73,72,91,91,16
"1341",40,"[31]tJHgnlqIHcdKocJvcGHqvdCKmwldfgb",169,0.994118,31,170,1,169,1,1,0,1,1,90,89,80,80,16
"1342",41,"[31]tJHgnlqIHcdKocJvcGHqvdCKmwldfgb",167,0.994048,31,168,1,167,1,1,0,1,1,85,84,83,83,16
"1343",42,"[31]tJHgnlqIHcdKocJvcGHqvdCKmwldfgb",168,0.994083,31,169,1,168,1,1,0,1,1,88,87,81,81,16
"1344",43,"[31]tJHgnlqIHcdKocJvcGHqvdCKmwldfgb",169,0.994118,31,170,1,169,1,1,0,1,1,90,89,80,80,16
"1345",44,"[31]tJHgnlqIHcdKocJvcGHqvdCKmwldfgb",164,0.993939,31,165,1,164,1,1,0,1,1,77,76,88,88,16
"1346",45,"[31]tJHgnlqIHcdKocJvcGHqvdCKmwldfgb",168,0.994083,31,169,1,168,1,1,0,1,1,87,86,82,82,16
"1347",46,"[31]tJHgnlqIHcdKocJvcGHqvdCKmwldfgb",173,0.994253,31,174,1,173,1,1,0,1,1,102,101,72,72,16
"1348",47,"[31]tJHgnlqIHcdKocJvcGHqvdCKmwldfgb",164,0.993939,31,165,1,164,1,1,0,1,1,77,76,88,88,16
"1349",48,"[31]tJHgnlqIHcdKocJvcGHqvdCKmwldfgb",168,0.994083,31,169,1,168,1,1,0,1,1,87,86,82,82,16
"1350",49,"[31]tJHgnlqIHcdKocJvcGHqvdCKmwldfgb",170,0.994152,31,171,1,170,1,1,0,1,1,92,91,79,79,16
"1351",50,"[31]tJHgnlqIHcdKocJvcGHqvdCKmwldfgb",162,0.993865,31,163,1,162,1,1,0,1,1,71,70,92,92,16
"1352",51,"[31]tJHgnlqIHcdKocJvcGHqvdCKmwldfgb",161,0.993827,31,162,1,161,1,1,0,1,1,68,67,94,94,16
"1353",52,"[31]tJHgnlqIHcdKocJvcGHqvdCKmwldfgb",168,0.994083,31,169,1,168,1,1,0,1,1,88,87,81,81,16
"1354",53,"[31]tJHgnlqIHcdKocJvcGHqvdCKmwldfgb",167,0.994048,31,168,1,167,1,1,0,1,1,84,83,84,84,16
"1355",54,"[31]tJHgnlqIHcdKocJvcGHqvdCKmwldfgb",172,0.99422,31,173,1,172,1,1,0,1,1,99,98,74,74,16
"1356",55,"[31]tJHgnlqIHcdKocJvcGHqvdCKmwldfgb",171,0.994186,31,172,1,171,1,1,0,1,1,96,95,76,76,16
"1357",56,"[31]tJHgnlqIHcdKocJvcGHqvdCKmwldfgb",168,0.994083,31,169,1,168,1,1,0,1,1,88,87,81,81,16
"1358",57,"[31]tJHgnlqIHcdKocJvcGHqvdCKmwldfgb",162,0.993865,31,163,1,162,1,1,0,1,1,71,70,92,92,16
"1359",58,"[31]tJHgnlqIHcdKocJvcGHqvdCKmwldfgb",164,0.993939,31,165,1,164,1,1,0,1,1,77,76,88,88,16
"1360",59,"[31]tJHgnlqIHcdKocJvcGHqvdCKmwldfgb",167,0.994048,31,168,1,167,1,1,0,1,1,85,84,83,83,16
"1361",60,"[31]tJHgnlqIHcdKocJvcGHqvdCKmwldfgb",169,0.994118,31,170,1,169,1,1,0,1,1,90,89,80,80,16
"1362",61,"[31]tJHgnlqIHcdKocJvcGHqvdCKmwldfgb",163,0.993902,31,164,1,163,1,1,0,1,1,73,72,91,91,16
"1363",62,"[31]tJHgnlqIHcdKocJvcGHqvdCKmwldfgb",163,0.993902,31,164,1,163,1,1,0,1,1,74,73,90,90,16
"1364",63,"[31]tJHgnlqIHcdKocJvcGHqvdCKmwldfgb",165,0.993976,31,166,1,165,1,1,0,1,1,79,78,87,87,16
"1365",64,"[31]tJHgnlqIHcdKocJvcGHqvdCKmwldfgb",170,0.994152,31,171,1,170,1,1,0,1,1,93,92,78,78,16
"1366",65,"[31]tJHgnlqIHcdKocJvcGHqvdCKmwldfgb",167,0.994048,31,168,1,167,1,1,0,1,1,86,85,82,82,16
"1367",66,"[31]tJHgnlqIHcdKocJvcGHqvdCKmwldfgb",172,0.99422,31,173,1,172,1,1,0,1,1,99,98,74,74,16
"1368",67,"[31]tJHgnlqIHcdKocJvcGHqvdCKmwldfgb",174,0.994286,31,175,1,174,1,1,0,1,1,104,103,71,71,16
"1369",68,"[31]tJHgnlqIHcdKocJvcGHqvdCKmwldfgb",166,0.994012,31,167,1,166,1,1,0,1,1,83,82,84,84,16
"1370",69,"[31]tJHgnlqIHcdKocJvcGHqvdCKmwldfgb",167,0.994048,31,168,1,167,1,1,0,1,1,85,84,83,83,16
"1371",70,"[31]tJHgnlqIHcdKocJvcGHqvdCKmwldfgb",171,0.994186,31,172,1,171,1,1,0,1,1,94,93,78,78,16
"1372",71,"[31]tJHgnlqIHcdKocJvcGHqvdCKmwldfgb",166,0.994012,31,167,1,166,1,1,0,1,1,82,81,85,85,16
"1373",72,"[31]tJHgnlqIHcdKocJvcGHqvdCKmwldfgb",167,0.994048,31,168,1,167,1,1,0,1,1,84,83,84,84,16
"1374",73,"[31]tJHgnlqIHcdKocJvcGHqvdCKmwldfgb",165,0.993976,31,166,1,165,1,1,0,1,1,78,77,88,88,16
"1375",74,"[31]tJHgnlqIHcdKocJvcGHqvdCKmwldfgb",167,0.994048,31,168,1,167,1,1,0,1,1,84,83,84,84,16
"1376",75,"[31]tJHgnlqIHcdKocJvcGHqvdCKmwldfgb",165,0.993976,31,166,1,165,1,1,0,1,1,80,79,86,86,16
"1377",76,"[31]tJHgnlqIHcdKocJvcGHqvdCKmwldfgb",164,0.993939,31,165,1,164,1,1,0,1,1,76,75,89,89,16
"1378",77,"[31]tJHgnlqIHcdKocJvcGHqvdCKmwldfgb",167,0.994048,31,168,1,167,1,1,0,1,1,86,85,82,82,16
"1379",78,"[31]tJHgnlqIHcdKocJvcGHqvdCKmwldfgb",163,0.993902,31,164,1,163,1,1,0,1,1,75,74,89,89,16
"1380",79,"[31]tJHgnlqIHcdKocJvcGHqvdCKmwldfgb",166,0.994012,31,167,1,166,1,1,0,1,1,83,82,84,84,16
"1381",80,"[31]tJHgnlqIHcdKocJvcGHqvdCKmwldfgb",166,0.994012,31,167,1,166,1,1,0,1,1,83,82,84,84,16
"1382",81,"[31]tJHgnlqIHcdKocJvcGHqvdCKmwldfgb",165,0.993976,31,166,1,165,1,1,0,1,1,79,78,87,87,16
"1383",82,"[31]tJHgnlqIHcdKocJvcGHqvdCKmwldfgb",168,0.994083,31,169,1,168,1,1,0,1,1,88,87,81,81,16
"1384",83,"[31]tJHgnlqIHcdKocJvcGHqvdCKmwldfgb",170,0.994152,31,171,1,170,1,1,0,1,1,94,93,77,77,16
"1385",84,"[31]tJHgnlqIHcdKocJvcGHqvdCKmwldfgb",165,0.993976,31,166,1,165,1,1,0,1,1,78,77,88,88,16
"1386",85,"[31]tJHgnlqIHcdKocJvcGHqvdCKmwldfgb",171,0.994186,31,172,1,171,1,1,0,1,1,97,96,75,75,16
"1387",86,"[31]tJHgnlqIHcdKocJvcGHqvdCKmwldfgb",168,0.994083,31,169,1,168,1,1,0,1,1,89,88,80,80,16
"1388",87,"[31]tJHgnlqIHcdKocJvcGHqvdCKmwldfgb",171,0.994186,31,172,1,171,1,1,0,1,1,95,94,77,77,16
"1389",88,"[31]tJHgnlqIHcdKocJvcGHqvdCKmwldfgb",166,0.994012,31,167,1,166,1,1,0,1,1,81,80,86,86,16
"1390",89,"[31]tJHgnlqIHcdKocJvcGHqvdCKmwldfgb",165,0.993976,31,166,1,165,1,1,0,1,1,78,77,88,88,16
"1391",90,"[31]tJHgnlqIHcdKocJvcGHqvdCKmwldfgb",166,0.994012,31,167,1,166,1,1,0,1,1,82,81,85,85,16
"1392",91,"[31]tJHgnlqIHcdKocJvcGHqvdCKmwldfgb",165,0.993976,31,166,1,165,1,1,0,1,1,78,77,88,88,16
"1393",92,"[31]tJHgnlqIHcdKocJvcGHqvdCKmwldfgb",165,0.993976,31,166,1,165,1,1,0,1,1,78,77,88,88,16
"1394",93,"[31]tJHgnlqIHcdKocJvcGHqvdCKmwldfgb",168,0.994083,31,169,1,168,1,1,0,1,1,89,88,80,80,16
"1395",94,"[31]tJHgnlqIHcdKocJvcGHqvdCKmwldfgb",168,0.994083,31,169,1,168,1,1,0,1,1,89,88,80,80,16
"1396",95,"[31]tJHgnlqIHcdKocJvcGHqvdCKmwldfgb",171,0.994186,31,172,1,171,1,1,0,1,1,96,95,76,76,16
"1397",96,"[31]tJHgnlqIHcdKocJvcGHqvdCKmwldfgb",171,0.994186,31,172,1,171,1,1,0,1,1,95,94,77,77,16
"1398",97,"[31]tJHgnlqIHcdKocJvcGHqvdCKmwldfgb",171,0.994186,31,172,1,171,1,1,0,1,1,96,95,76,76,16
"1399",98,"[31]tJHgnlqIHcdKocJvcGHqvdCKmwldfgb",167,0.994048,31,168,1,167,1,1,0,1,1,85,84,83,83,16
"1400",99,"[31]tJHgnlqIHcdKocJvcGHqvdCKmwldfgb",161,0.993827,31,162,1,161,1,1,0,1,1,68,67,94,94,16
"1401",0,"[31]jJHggqIHBrodKpcJvcHqvdGCklgdkls",176,0.99435,31,177,1,176,1,1,0,1,1,89,88,88,88,17
"1402",1,"[31]jJHggqIHBrodKpcJvcHqvdGCklgdkls",178,0.994413,31,179,1,178,1,1,0,1,1,94,93,85,85,17
"1403",2,"[31]jJHggqIHBrodKpcJvcHqvdGCklgdkls",180,0.994475,31,181,1,180,1,1,0,1,1,98,97,83,83,17
"1404",3,"[31]jJHggqIHBrodKpcJvcHqvdGCklgdkls",191,0.994792,31,192,1,191,1,1,0,1,1,119,118,73,73,17
"1405",4,"[31]jJHggqIHBrodKpcJvcHqvdGCklgdkls",174,0.994286,31,175,1,174,1,1,0,1,1,85,84,90,90,17
"1406",5,"[31]jJHggqIHBrodKpcJvcHqvdGCklgdkls",174,0.994286,31,175,1,174,1,1,0,1,1,85,84,90,90,17
"1407",6,"[31]jJHggqIHBrodKpcJvcHqvdGCklgdkls",178,0.994413,31,179,1,178,1,1,0,1,1,91,90,88,88,17
"1408",7,"[31]jJHggqIHBrodKpcJvcHqvdGCklgdkls",171,0.994186,31,172,1,171,1,1,0,1,1,77,76,95,95,17
"1409",8,"[31]jJHggqIHBrodKpcJvcHqvdGCklgdkls",173,0.994253,31,174,1,173,1,1,0,1,1,82,81,92,92,17
"1410",9,"[31]jJHggqIHBrodKpcJvcHqvdGCklgdkls",178,0.994413,31,179,1,178,1,1,0,1,1,93,92,86,86,17
"1411",10,"[31]jJHggqIHBrodKpcJvcHqvdGCklgdkls",182,0.994536,31,183,1,182,1,1,0,1,1,101,100,82,82,17
"1412",11,"[31]jJHggqIHBrodKpcJvcHqvdGCklgdkls",184,0.994595,31,185,1,184,1,1,0,1,1,106,105,79,79,17
"1413",12,"[31]jJHggqIHBrodKpcJvcHqvdGCklgdkls",180,0.994475,31,181,1,180,1,1,0,1,1,98,97,83,83,17
"1414",13,"[31]jJHggqIHBrodKpcJvcHqvdGCklgdkls",172,0.99422,31,173,1,172,1,1,0,1,1,79,78,94,94,17
"1415",14,"[31]jJHggqIHBrodKpcJvcHqvdGCklgdkls",167,0.994048,31,168,1,167,1,1,0,1,1,68,67,100,100,17
"1416",15,"[31]jJHggqIHBrodKpcJvcHqvdGCklgdkls",180,0.994475,31,181,1,180,1,1,0,1,1,96,95,85,85,17
"1417",16,"[31]jJHggqIHBrodKpcJvcHqvdGCklgdkls",185,0.994624,31,186,1,185,1,1,0,1,1,108,107,78,78,17
"1418",17,"[31]jJHggqIHBrodKpcJvcHqvdGCklgdkls",178,0.994413,31,179,1,178,1,1,0,1,1,91,90,88,88,17
"1419",18,"[31]jJHggqIHBrodKpcJvcHqvdGCklgdkls",173,0.994253,31,174,1,173,1,1,0,1,1,83,82,91,91,17
"1420",19,"[31]jJHggqIHBrodKpcJvcHqvdGCklgdkls",177,0.994382,31,178,1,177,1,1,0,1,1,92,91,86,86,17
"1421",20,"[31]jJHggqIHBrodKpcJvcHqvdGCklgdkls",187,0.994681,31,188,1,187,1,1,0,1,1,107,106,81,81,17
"1422",21,"[31]jJHggqIHBrodKpcJvcHqvdGCklgdkls",179,0.994444,31,180,1,179,1,1,0,1,1,96,95,84,84,17
"1423",22,"[31]jJHggqIHBrodKpcJvcHqvdGCklgdkls",170,0.994152,31,171,1,170,1,1,0,1,1,74,73,97,97,17
"1424",23,"[31]jJHggqIHBrodKpcJvcHqvdGCklgdkls",175,0.994318,31,176,1,175,1,1,0,1,1,87,86,89,89,17
"1425",24,"[31]jJHggqIHBrodKpcJvcHqvdGCklgdkls",176,0.99435,31,177,1,176,1,1,0,1,1,86,85,91,91,17
"1426",25,"[31]jJHggqIHBrodKpcJvcHqvdGCklgdkls",175,0.994318,31,176,1,175,1,1,0,1,1,87,86,89,89,17
"1427",26,"[31]jJHggqIHBrodKpcJvcHqvdGCklgdkls",179,0.994444,31,180,1,179,1,1,0,1,1,95,94,85,85,17
"1428",27,"[31]jJHggqIHBrodKpcJvcHqvdGCklgdkls",181,0.994505,31,182,1,181,1,1,0,1,1,99,98,83,83,17
"1429",28,"[31]jJHggqIHBrodKpcJvcHqvdGCklgdkls",179,0.994444,31,180,1,179,1,1,0,1,1,96,95,84,84,17
"1430",29,"[31]jJHggqIHBrodKpcJvcHqvdGCklgdkls",178,0.994413,31,179,1,178,1,1,0,1,1,93,92,86,86,17
"1431",30,"[31]jJHggqIHBrodKpcJvcHqvdGCklgdkls",171,0.994186,31,172,1,171,1,1,0,1,1,75,74,97,97,17
"1432",31,"[31]jJHggqIHBrodKpcJvcHqvdGCklgdkls",174,0.994286,31,175,1,174,1,1,0,1,1,83,82,92,92,17
"1433",32,"[31]jJHggqIHBrodKpcJvcHqvdGCklgdkls",177,0.994382,31,178,1,177,1,1,0,1,1,91,90,87,87,17
"1434",33,"[31]jJHggqIHBrodKpcJvcHqvdGCklgdkls",182,0.994536,31,183,1,182,1,1,0,1,1,100,99,83,83,17
"1435",34,"[31]jJHggqIHBrodKpcJvcHqvdGCklgdkls",176,0.99435,31,177,1,176,1,1,0,1,1,87,86,90,90,17
"1436",35,"[31]jJHggqIHBrodKpcJvcHqvdGCklgdkls",181,0.994505,31,182,1,181,1,1,0,1,1,100,99,82,82,17
"1437",36,"[31]jJHggqIHBrodKpcJvcHqvdGCklgdkls",173,0.994253,31,174,1,173,1,1,0,1,1,82,81,92,92,17
"1438",37,"[31]jJHggqIHBrodKpcJvcHqvdGCklgdkls",183,0.994565,31,184,1,183,1,1,0,1,1,104,103,80,80,17
"1439",38,"[31]jJHggqIHBrodKpcJvcHqvdGCklgdkls",183,0.994565,31,184,1,183,1,1,0,1,1,103,102,81,81,17
"1440",39,"[31]jJHggqIHBrodKpcJvcHqvdGCklgdkls",176,0.99435,31,177,1,176,1,1,0,1,1,89,88,88,88,17
"1441",40,"[31]jJHggqIHBrodKpcJvcHqvdGCklgdkls",179,0.994444,31,180,1,179,1,1,0,1,1,96,95,84,84,17
"1442",41,"[31]jJHggqIHBrodKpcJvcHqvdGCklgdkls",185,0.994624,31,186,1,185,1,1,0,1,1,107,106,79,79,17
"1443",42,"[31]jJHggqIHBrodKpcJvcHqvdGCklgdkls",183,0.994565,31,184,1,183,1,1,0,1,1,103,102,81,81,17
"1444",43,"[31]jJHggqIHBrodKpcJvcHqvdGCklgdkls",174,0.994286,31,175,1,174,1,1,0,1,1,85,84,90,90,17
"1445",44,"[31]jJHggqIHBrodKpcJvcHqvdGCklgdkls",176,0.99435,31,177,1,176,1,1,0,1,1,88,87,89,89,17
"1446",45,"[31]jJHggqIHBrodKpcJvcHqvdGCklgdkls",180,0.994475,31,181,1,180,1,1,0,1,1,98,97,83,83,17
"1447",46,"[31]jJHggqIHBrodKpcJvcHqvdGCklgdkls",181,0.994505,31,182,1,181,1,1,0,1,1,93,92,89,89,17
"1448",47,"[31]jJHggqIHBrodKpcJvcHqvdGCklgdkls",180,0.994475,31,181,1,180,1,1,0,1,1,96,95,85,85,17
"1449",48,"[31]jJHggqIHBrodKpcJvcHqvdGCklgdkls",177,0.994382,31,178,1,177,1,1,0,1,1,88,87,90,90,17
"1450",49,"[31]jJHggqIHBrodKpcJvcHqvdGCklgdkls",174,0.994286,31,175,1,174,1,1,0,1,1,85,84,90,90,17
"1451",50,"[31]jJHggqIHBrodKpcJvcHqvdGCklgdkls",181,0.994505,31,182,1,181,1,1,0,1,1,99,98,83,83,17
"1452",51,"[31]jJHggqIHBrodKpcJvcHqvdGCklgdkls",177,0.994382,31,178,1,177,1,1,0,1,1,85,84,93,93,17
"1453",52,"[31]jJHggqIHBrodKpcJvcHqvdGCklgdkls",178,0.994413,31,179,1,178,1,1,0,1,1,92,91,87,87,17
"1454",53,"[31]jJHggqIHBrodKpcJvcHqvdGCklgdkls",175,0.994318,31,176,1,175,1,1,0,1,1,87,86,89,89,17
"1455",54,"[31]jJHggqIHBrodKpcJvcHqvdGCklgdkls",176,0.99435,31,177,1,176,1,1,0,1,1,88,87,89,89,17
"1456",55,"[31]jJHggqIHBrodKpcJvcHqvdGCklgdkls",183,0.994565,31,184,1,183,1,1,0,1,1,102,101,82,82,17
"1457",56,"[31]jJHggqIHBrodKpcJvcHqvdGCklgdkls",176,0.99435,31,177,1,176,1,1,0,1,1,88,87,89,89,17
"1458",57,"[31]jJHggqIHBrodKpcJvcHqvdGCklgdkls",180,0.994475,31,181,1,180,1,1,0,1,1,98,97,83,83,17
"1459",58,"[31]jJHggqIHBrodKpcJvcHqvdGCklgdkls",182,0.994536,31,183,1,182,1,1,0,1,1,100,99,83,83,17
"1460",59,"[31]jJHggqIHBrodKpcJvcHqvdGCklgdkls",174,0.994286,31,175,1,174,1,1,0,1,1,85,84,90,90,17
"1461",60,"[31]jJHggqIHBrodKpcJvcHqvdGCklgdkls",183,0.994565,31,184,1,183,1,1,0,1,1,103,102,81,81,17
"1462",61,"[31]jJHggqIHBrodKpcJvcHqvdGCklgdkls",181,0.994505,31,182,1,181,1,1,0,1,1,96,95,86,86,17
"1463",62,"[31]jJHggqIHBrodKpcJvcHqvdGCklgdkls",179,0.994444,31,180,1,179,1,1,0,1,1,95,94,85,85,17
"1464",63,"[31]jJHggqIHBrodKpcJvcHqvdGCklgdkls",174,0.994286,31,175,1,174,1,1,0,1,1,84,83,91,91,17
"1465",64,"[31]jJHggqIHBrodKpcJvcHqvdGCklgdkls",175,0.994318,31,176,1,175,1,1,0,1,1,85,84,91,91,17
"1466",65,"[31]jJHggqIHBrodKpcJvcHqvdGCklgdkls",180,0.994475,31,181,1,180,1,1,0,1,1,93,92,88,88,17
"1467",66,"[31]jJHggqIHBrodKpcJvcHqvdGCklgdkls",173,0.994253,31,174,1,173,1,1,0,1,1,78,77,96,96,17
"1468",67,"[31]jJHggqIHBrodKpcJvcHqvdGCklgdkls",180,0.994475,31,181,1,180,1,1,0,1,1,98,97,83,83,17
"1469",68,"[31]jJHggqIHBrodKpcJvcHqvdGCklgdkls",172,0.99422,31,173,1,172,1,1,0,1,1,78,77,95,95,17
"1470",69,"[31]jJHggqIHBrodKpcJvcHqvdGCklgdkls",174,0.994286,31,175,1,174,1,1,0,1,1,85,84,90,90,17
"1471",70,"[31]jJHggqIHBrodKpcJvcHqvdGCklgdkls",180,0.994475,31,181,1,180,1,1,0,1,1,97,96,84,84,17
"1472",71,"[31]jJHggqIHBrodKpcJvcHqvdGCklgdkls",180,0.994475,31,181,1,180,1,1,0,1,1,92,91,89,89,17
"1473",72,"[31]jJHggqIHBrodKpcJvcHqvdGCklgdkls",176,0.99435,31,177,1,176,1,1,0,1,1,87,86,90,90,17
"1474",73,"[31]jJHggqIHBrodKpcJvcHqvdGCklgdkls",176,0.99435,31,177,1,176,1,1,0,1,1,86,85,91,91,17
"1475",74,"[31]jJHggqIHBrodKpcJvcHqvdGCklgdkls",178,0.994413,31,179,1,178,1,1,0,1,1,94,93,85,85,17
"1476",75,"[31]jJHggqIHBrodKpcJvcHqvdGCklgdkls",175,0.994318,31,176,1,175,1,1,0,1,1,87,86,89,89,17
"1477",76,"[31]jJHggqIHBrodKpcJvcHqvdGCklgdkls",180,0.994475,31,181,1,180,1,1,0,1,1,98,97,83,83,17
"1478",77,"[31]jJHggqIHBrodKpcJvcHqvdGCklgdkls",177,0.994382,31,178,1,177,1,1,0,1,1,88,87,90,90,17
"1479",78,"[31]jJHggqIHBrodKpcJvcHqvdGCklgdkls",179,0.994444,31,180,1,179,1,1,0,1,1,94,93,86,86,17
"1480",79,"[31]jJHggqIHBrodKpcJvcHqvdGCklgdkls",167,0.994048,31,168,1,167,1,1,0,1,1,69,68,99,99,17
"1481",80,"[31]jJHggqIHBrodKpcJvcHqvdGCklgdkls",177,0.994382,31,178,1,177,1,1,0,1,1,88,87,90,90,17
"1482",81,"[31]jJHggqIHBrodKpcJvcHqvdGCklgdkls",178,0.994413,31,179,1,178,1,1,0,1,1,92,91,87,87,17
"1483",82,"[31]jJHggqIHBrodKpcJvcHqvdGCklgdkls",180,0.994475,31,181,1,180,1,1,0,1,1,96,95,85,85,17
"1484",83,"[31]jJHggqIHBrodKpcJvcHqvdGCklgdkls",181,0.994505,31,182,1,181,1,1,0,1,1,97,96,85,85,17
"1485",84,"[31]jJHggqIHBrodKpcJvcHqvdGCklgdkls",179,0.994444,31,180,1,179,1,1,0,1,1,96,95,84,84,17
"1486",85,"[31]jJHggqIHBrodKpcJvcHqvdGCklgdkls",175,0.994318,31,176,1,175,1,1,0,1,1,86,85,90,90,17
"1487",86,"[31]jJHggqIHBrodKpcJvcHqvdGCklgdkls",177,0.994382,31,178,1,177,1,1,0,1,1,91,90,87,87,17
"1488",87,"[31]jJHggqIHBrodKpcJvcHqvdGCklgdkls",176,0.99435,31,177,1,176,1,1,0,1,1,89,88,88,88,17
"1489",88,"[31]jJHggqIHBrodKpcJvcHqvdGCklgdkls",180,0.994475,31,181,1,180,1,1,0,1,1,98,97,83,83,17
"1490",89,"[31]jJHggqIHBrodKpcJvcHqvdGCklgdkls",176,0.99435,31,177,1,176,1,1,0,1,1,89,88,88,88,17
"1491",90,"[31]jJHggqIHBrodKpcJvcHqvdGCklgdkls",174,0.994286,31,175,1,174,1,1,0,1,1,83,82,92,92,17
"1492",91,"[31]jJHggqIHBrodKpcJvcHqvdGCklgdkls",175,0.994318,31,176,1,175,1,1,0,1,1,87,86,89,89,17
"1493",92,"[31]jJHggqIHBrodKpcJvcHqvdGCklgdkls",181,0.994505,31,182,1,181,1,1,0,1,1,99,98,83,83,17
"1494",93,"[31]jJHggqIHBrodKpcJvcHqvdGCklgdkls",178,0.994413,31,179,1,178,1,1,0,1,1,92,91,87,87,17
"1495",94,"[31]jJHggqIHBrodKpcJvcHqvdGCklgdkls",173,0.994253,31,174,1,173,1,1,0,1,1,82,81,92,92,17
"1496",95,"[31]jJHggqIHBrodKpcJvcHqvdGCklgdkls",184,0.994595,31,185,1,184,1,1,0,1,1,99,98,86,86,17
"1497",96,"[31]jJHggqIHBrodKpcJvcHqvdGCklgdkls",175,0.994318,31,176,1,175,1,1,0,1,1,87,86,89,89,17
"1498",97,"[31]jJHggqIHBrodKpcJvcHqvdGCklgdkls",176,0.99435,31,177,1,176,1,1,0,1,1,88,87,89,89,17
"1499",98,"[31]jJHggqIHBrodKpcJvcHqvdGCklgdkls",184,0.994595,31,185,1,184,1,1,0,1,1,104,103,81,81,17
"1500",99,"[31]jJHggqIHBrodKpcJvcHqvdGCklgdkls",173,0.994253,31,174,1,173,1,1,0,1,1,80,79,94,94,17
"1501",0,"[33]bJHglqIHcdKpcJvcGHqxdCgrqBmxJcBIF",166,0.994012,33,167,1,166,1,1,0,1,1,83,82,84,84,18
"1502",1,"[33]bJHglqIHcdKpcJvcGHqxdCgrqBmxJcBIF",167,0.994048,33,168,1,167,1,1,0,1,1,83,82,85,85,18
"1503",2,"[33]bJHglqIHcdKpcJvcGHqxdCgrqBmxJcBIF",163,0.993902,33,164,1,163,1,1,0,1,1,75,74,89,89,18
"1504",3,"[33]bJHglqIHcdKpcJvcGHqxdCgrqBmxJcBIF",163,0.993902,33,164,1,163,1,1,0,1,1,73,72,91,91,18
"1505",4,"[33]bJHglqIHcdKpcJvcGHqxdCgrqBmxJcBIF",166,0.994012,33,167,1,166,1,1,0,1,1,81,80,86,86,18
"1506",5,"[33]bJHglqIHcdKpcJvcGHqxdCgrqBmxJcBIF",170,0.994152,33,171,1,170,1,1,0,1,1,92,91,79,79,18
"1507",6,"[33]bJHglqIHcdKpcJvcGHqxdCgrqBmxJcBIF",170,0.994152,33,171,1,170,1,1,0,1,1,92,91,79,79,18
"1508",7,"[33]bJHglqIHcdKpcJvcGHqxdCgrqBmxJcBIF",163,0.993902,33,164,1,163,1,1,0,1,1,74,73,90,90,18
"1509",8,"[33]bJHglqIHcdKpcJvcGHqxdCgrqBmxJcBIF",166,0.994012,33,167,1,166,1,1,0,1,1,81,80,86,86,18
"1510",9,"[33]bJHglqIHcdKpcJvcGHqxdCgrqBmxJcBIF",167,0.994048,33,168,1,167,1,1,0,1,1,84,83,84,84,18
"1511",10,"[33]bJHglqIHcdKpcJvcGHqxdCgrqBmxJcBIF",165,0.993976,33,166,1,165,1,1,0,1,1,80,79,86,86,18
"1512",11,"[33]bJHglqIHcdKpcJvcGHqxdCgrqBmxJcBIF",164,0.993939,33,165,1,164,1,1,0,1,1,77,76,88,88,18
"1513",12,"[33]bJHglqIHcdKpcJvcGHqxdCgrqBmxJcBIF",161,0.993827,33,162,1,161,1,1,0,1,1,68,67,94,94,18
"1514",13,"[33]bJHglqIHcdKpcJvcGHqxdCgrqBmxJcBIF",163,0.993902,33,164,1,163,1,1,0,1,1,75,74,89,89,18
"1515",14,"[33]bJHglqIHcdKpcJvcGHqxdCgrqBmxJcBIF",168,0.994083,33,169,1,168,1,1,0,1,1,87,86,82,82,18
"1516",15,"[33]bJHglqIHcdKpcJvcGHqxdCgrqBmxJcBIF",161,0.993827,33,162,1,161,1,1,0,1,1,68,67,94,94,18
"1517",16,"[33]bJHglqIHcdKpcJvcGHqxdCgrqBmxJcBIF",166,0.994012,33,167,1,166,1,1,0,1,1,81,80,86,86,18
"1518",17,"[33]bJHglqIHcdKpcJvcGHqxdCgrqBmxJcBIF",167,0.994048,33,168,1,167,1,1,0,1,1,84,83,84,84,18
"1519",18,"[33]bJHglqIHcdKpcJvcGHqxdCgrqBmxJcBIF",166,0.994012,33,167,1,166,1,1,0,1,1,82,81,85,85,18
"1520",19,"[33]bJHglqIHcdKpcJvcGHqxdCgrqBmxJcBIF",170,0.994152,33,171,1,170,1,1,0,1,1,92,91,79,79,18
"1521",20,"[33]bJHglqIHcdKpcJvcGHqxdCgrqBmxJcBIF",165,0.993976,33,166,1,165,1,1,0,1,1,79,78,87,87,18
"1522",21,"[33]bJHglqIHcdKpcJvcGHqxdCgrqBmxJcBIF",167,0.994048,33,168,1,167,1,1,0,1,1,86,85,82,82,18
"1523",22,"[33]bJHglqIHcdKpcJvcGHqxdCgrqBmxJcBIF",169,0.994118,33,170,1,169,1,1,0,1,1,90,89,80,80,18
"1524",23,"[33]bJHglqIHcdKpcJvcGHqxdCgrqBmxJcBIF",173,0.994253,33,174,1,173,1,1,0,1,1,101,100,73,73,18
"1525",24,"[33]bJHglqIHcdKpcJvcGHqxdCgrqBmxJcBIF",171,0.994186,33,172,1,171,1,1,0,1,1,94,93,78,78,18
"1526",25,"[33]bJHglqIHcdKpcJvcGHqxdCgrqBmxJcBIF",165,0.993976,33,166,1,165,1,1,0,1,1,80,79,86,86,18
"1527",26,"[33]bJHglqIHcdKpcJvcGHqxdCgrqBmxJcBIF",167,0.994048,33,168,1,167,1,1,0,1,1,84,83,84,84,18
"1528",27,"[33]bJHglqIHcdKpcJvcGHqxdCgrqBmxJcBIF",170,0.994152,33,171,1,170,1,1,0,1,1,93,92,78,78,18
"1529",28,"[33]bJHglqIHcdKpcJvcGHqxdCgrqBmxJcBIF",172,0.99422,33,173,1,172,1,1,0,1,1,98,97,75,75,18
"1530",29,"[33]bJHglqIHcdKpcJvcGHqxdCgrqBmxJcBIF",169,0.994118,33,170,1,169,1,1,0,1,1,90,89,80,80,18
"1531",30,"[33]bJHglqIHcdKpcJvcGHqxdCgrqBmxJcBIF",163,0.993902,33,164,1,163,1,1,0,1,1,74,73,90,90,18
"1532",31,"[33]bJHglqIHcdKpcJvcGHqxdCgrqBmxJcBIF",169,0.994118,33,170,1,169,1,1,0,1,1,91,90,79,79,18
"1533",32,"[33]bJHglqIHcdKpcJvcGHqxdCgrqBmxJcBIF",168,0.994083,33,169,1,168,1,1,0,1,1,87,86,82,82,18
"1534",33,"[33]bJHglqIHcdKpcJvcGHqxdCgrqBmxJcBIF",169,0.994118,33,170,1,169,1,1,0,1,1,91,90,79,79,18
"1535",34,"[33]bJHglqIHcdKpcJvcGHqxdCgrqBmxJcBIF",164,0.993939,33,165,1,164,1,1,0,1,1,77,76,88,88,18
"1536",35,"[33]bJHglqIHcdKpcJvcGHqxdCgrqBmxJcBIF",169,0.994118,33,170,1,169,1,1,0,1,1,88,87,82,82,18
"1537",36,"[33]bJHglqIHcdKpcJvcGHqxdCgrqBmxJcBIF",173,0.994253,33,174,1,173,1,1,0,1,1,99,98,75,75,18
"1538",37,"[33]bJHglqIHcdKpcJvcGHqxdCgrqBmxJcBIF",164,0.993939,33,165,1,164,1,1,0,1,1,77,76,88,88,18
"1539",38,"[33]bJHglqIHcdKpcJvcGHqxdCgrqBmxJcBIF",168,0.994083,33,169,1,168,1,1,0,1,1,88,87,81,81,18
"1540",39,"[33]bJHglqIHcdKpcJvcGHqxdCgrqBmxJcBIF",166,0.994012,33,167,1,166,1,1,0,1,1,81,80,86,86,18
"1541",40,"[33]bJHglqIHcdKpcJvcGHqxdCgrqBmxJcBIF",168,0.994083,33,169,1,168,1,1,0,1,1,88,87,81,81,18
"1542",41,"[33]bJHglqIHcdKpcJvcGHqxdCgrqBmxJcBIF",167,0.994048,33,168,1,167,1,1,0,1,1,84,83,84,84,18
"1543",42,"[33]bJHglqIHcdKpcJvcGHqxdCgrqBmxJcBIF",167,0.994048,33,168,1,167,1,1,0,1,1,86,85,82,82,18
"1544",43,"[33]bJHglqIHcdKpcJvcGHqxdCgrqBmxJcBIF",170,0.994152,33,171,1,170,1,1,0,1,1,91,90,80,80,18
"1545",44,"[33]bJHglqIHcdKpcJvcGHqxdCgrqBmxJcBIF",169,0.994118,33,170,1,169,1,1,0,1,1,89,88,81,81,18
"1546",45,"[33]bJHglqIHcdKpcJvcGHqxdCgrqBmxJcBIF",166,0.994012,33,167,1,166,1,1,0,1,1,82,81,85,85,18
"1547",46,"[33]bJHglqIHcdKpcJvcGHqxdCgrqBmxJcBIF",165,0.993976,33,166,1,165,1,1,0,1,1,77,76,89,89,18
"1548",47,"[33]bJHglqIHcdKpcJvcGHqxdCgrqBmxJcBIF",173,0.994253,33,174,1,173,1,1,0,1,1,97,96,77,77,18
"1549",48,"[33]bJHglqIHcdKpcJvcGHqxdCgrqBmxJcBIF",167,0.994048,33,168,1,167,1,1,0,1,1,86,85,82,82,18
"1550",49,"[33]bJHglqIHcdKpcJvcGHqxdCgrqBmxJcBIF",166,0.994012,33,167,1,166,1,1,0,1,1,83,82,84,84,18
"1551",50,"[33]bJHglqIHcdKpcJvcGHqxdCgrqBmxJcBIF",165,0.993976,33,166,1,165,1,1,0,1,1,80,79,86,86,18
"1552",51,"[33]bJHglqIHcdKpcJvcGHqxdCgrqBmxJcBIF",170,0.994152,33,171,1,170,1,1,0,1,1,93,92,78,78,18
"1553",52,"[33]bJHglqIHcdKpcJvcGHqxdCgrqBmxJcBIF",168,0.994083,33,169,1,168,1,1,0,1,1,85,84,84,84,18
"1554",53,"[33]bJHglqIHcdKpcJvcGHqxdCgrqBmxJcBIF",170,0.994152,33,171,1,170,1,1,0,1,1,92,91,79,79,18
"1555",54,"[33]bJHglqIHcdKpcJvcGHqxdCgrqBmxJcBIF",172,0.99422,33,173,1,172,1,1,0,1,1,98,97,75,75,18
"1556",55,"[33]bJHglqIHcdKpcJvcGHqxdCgrqBmxJcBIF",171,0.994186,33,172,1,171,1,1,0,1,1,95,94,77,77,18
"1557",56,"[33]bJHglqIHcdKpcJvcGHqxdCgrqBmxJcBIF",165,0.993976,33,166,1,165,1,1,0,1,1,78,77,88,88,18
"1558",57,"[33]bJHglqIHcdKpcJvcGHqxdCgrqBmxJcBIF",168,0.994083,33,169,1,168,1,1,0,1,1,87,86,82,82,18
"1559",58,"[33]bJHglqIHcdKpcJvcGHqxdCgrqBmxJcBIF",173,0.994253,33,174,1,173,1,1,0,1,1,98,97,76,76,18
"1560",59,"[33]bJHglqIHcdKpcJvcGHqxdCgrqBmxJcBIF",172,0.99422,33,173,1,172,1,1,0,1,1,98,97,75,75,18
"1561",60,"[33]bJHglqIHcdKpcJvcGHqxdCgrqBmxJcBIF",163,0.993902,33,164,1,163,1,1,0,1,1,72,71,92,92,18
"1562",61,"[33]bJHglqIHcdKpcJvcGHqxdCgrqBmxJcBIF",170,0.994152,33,171,1,170,1,1,0,1,1,93,92,78,78,18
"1563",62,"[33]bJHglqIHcdKpcJvcGHqxdCgrqBmxJcBIF",168,0.994083,33,169,1,168,1,1,0,1,1,88,87,81,81,18
"1564",63,"[33]bJHglqIHcdKpcJvcGHqxdCgrqBmxJcBIF",164,0.993939,33,165,1,164,1,1,0,1,1,75,74,90,90,18
"1565",64,"[33]bJHglqIHcdKpcJvcGHqxdCgrqBmxJcBIF",164,0.993939,33,165,1,164,1,1,0,1,1,76,75,89,89,18
"1566",65,"[33]bJHglqIHcdKpcJvcGHqxdCgrqBmxJcBIF",169,0.994118,33,170,1,169,1,1,0,1,1,90,89,80,80,18
"1567",66,"[33]bJHglqIHcdKpcJvcGHqxdCgrqBmxJcBIF",165,0.993976,33,166,1,165,1,1,0,1,1,79,78,87,87,18
"1568",67,"[33]bJHglqIHcdKpcJvcGHqxdCgrqBmxJcBIF",167,0.994048,33,168,1,167,1,1,0,1,1,86,85,82,82,18
"1569",68,"[33]bJHglqIHcdKpcJvcGHqxdCgrqBmxJcBIF",170,0.994152,33,171,1,170,1,1,0,1,1,93,92,78,78,18
"1570",69,"[33]bJHglqIHcdKpcJvcGHqxdCgrqBmxJcBIF",170,0.994152,33,171,1,170,1,1,0,1,1,91,90,80,80,18
"1571",70,"[33]bJHglqIHcdKpcJvcGHqxdCgrqBmxJcBIF",169,0.994118,33,170,1,169,1,1,0,1,1,91,90,79,79,18
"1572",71,"[33]bJHglqIHcdKpcJvcGHqxdCgrqBmxJcBIF",163,0.993902,33,164,1,163,1,1,0,1,1,74,73,90,90,18
"1573",72,"[33]bJHglqIHcdKpcJvcGHqxdCgrqBmxJcBIF",166,0.994012,33,167,1,166,1,1,0,1,1,80,79,87,87,18
"1574",73,"[33]bJHglqIHcdKpcJvcGHqxdCgrqBmxJcBIF",166,0.994012,33,167,1,166,1,1,0,1,1,82,81,85,85,18
"1575",74,"[33]bJHglqIHcdKpcJvcGHqxdCgrqBmxJcBIF",168,0.994083,33,169,1,168,1,1,0,1,1,86,85,83,83,18
"1576",75,"[33]bJHglqIHcdKpcJvcGHqxdCgrqBmxJcBIF",165,0.993976,33,166,1,165,1,1,0,1,1,78,77,88,88,18
"1577",76,"[33]bJHglqIHcdKpcJvcGHqxdCgrqBmxJcBIF",165,0.993976,33,166,1,165,1,1,0,1,1,78,77,88,88,18
"1578",77,"[33]bJHglqIHcdKpcJvcGHqxdCgrqBmxJcBIF",169,0.994118,33,170,1,169,1,1,0,1,1,90,89,80,80,18
"1579",78,"[33]bJHglqIHcdKpcJvcGHqxdCgrqBmxJcBIF",169,0.994118,33,170,1,169,1,1,0,1,1,89,88,81,81,18
"1580",79,"[33]bJHglqIHcdKpcJvcGHqxdCgrqBmxJcBIF",169,0.994118,33,170,1,169,1,1,0,1,1,90,89,80,80,18
"1581",80,"[33]bJHglqIHcdKpcJvcGHqxdCgrqBmxJcBIF",163,0.993902,33,164,1,163,1,1,0,1,1,75,74,89,89,18
"1582",81,"[33]bJHglqIHcdKpcJvcGHqxdCgrqBmxJcBIF",165,0.993976,33,166,1,165,1,1,0,1,1,79,78,87,87,18
"1583",82,"[33]bJHglqIHcdKpcJvcGHqxdCgrqBmxJcBIF",167,0.994048,33,168,1,167,1,1,0,1,1,84,83,84,84,18
"1584",83,"[33]bJHglqIHcdKpcJvcGHqxdCgrqBmxJcBIF",170,0.994152,33,171,1,170,1,1,0,1,1,94,93,77,77,18
"1585",84,"[33]bJHglqIHcdKpcJvcGHqxdCgrqBmxJcBIF",169,0.994118,33,170,1,169,1,1,0,1,1,89,88,81,81,18
"1586",85,"[33]bJHglqIHcdKpcJvcGHqxdCgrqBmxJcBIF",162,0.993865,33,163,1,162,1,1,0,1,1,72,71,91,91,18
"1587",86,"[33]bJHglqIHcdKpcJvcGHqxdCgrqBmxJcBIF",168,0.994083,33,169,1,168,1,1,0,1,1,88,87,81,81,18
"1588",87,"[33]bJHglqIHcdKpcJvcGHqxdCgrqBmxJcBIF",166,0.994012,33,167,1,166,1,1,0,1,1,83,82,84,84,18
"1589",88,"[33]bJHglqIHcdKpcJvcGHqxdCgrqBmxJcBIF",163,0.993902,33,164,1,163,1,1,0,1,1,75,74,89,89,18
"1590",89,"[33]bJHglqIHcdKpcJvcGHqxdCgrqBmxJcBIF",162,0.993865,33,163,1,162,1,1,0,1,1,69,68,94,94,18
"1591",90,"[33]bJHglqIHcdKpcJvcGHqxdCgrqBmxJcBIF",166,0.994012,33,167,1,166,1,1,0,1,1,81,80,86,86,18
"1592",91,"[33]bJHglqIHcdKpcJvcGHqxdCgrqBmxJcBIF",165,0.993976,33,166,1,165,1,1,0,1,1,80,79,86,86,18
"1593",92,"[33]bJHglqIHcdKpcJvcGHqxdCgrqBmxJcBIF",167,0.994048,33,168,1,167,1,1,0,1,1,86,85,82,82,18
"1594",93,"[33]bJHglqIHcdKpcJvcGHqxdCgrqBmxJcBIF",170,0.994152,33,171,1,170,1,1,0,1,1,93,92,78,78,18
"1595",94,"[33]bJHglqIHcdKpcJvcGHqxdCgrqBmxJcBIF",165,0.993976,33,166,1,165,1,1,0,1,1,79,78,87,87,18
"1596",95,"[33]bJHglqIHcdKpcJvcGHqxdCgrqBmxJcBIF",169,0.994118,33,170,1,169,1,1,0,1,1,91,90,79,79,18
"1597",96,"[33]bJHglqIHcdKpcJvcGHqxdCgrqBmxJcBIF",168,0.994083,33,169,1,168,1,1,0,1,1,88,87,81,81,18
"1598",97,"[33]bJHglqIHcdKpcJvcGHqxdCgrqBmxJcBIF",169,0.994118,33,170,1,169,1,1,0,1,1,88,87,82,82,18
"1599",98,"[33]bJHglqIHcdKpcJvcGHqxdCgrqBmxJcBIF",166,0.994012,33,167,1,166,1,1,0,1,1,82,81,85,85,18
"1600",99,"[33]bJHglqIHcdKpcJvcGHqxdCgrqBmxJcBIF",174,0.994286,33,175,1,174,1,1,0,1,1,100,99,75,75,18
"1601",0,"[29]nJHglqIHcKpcJvcGHqxcCCAoccDBy",167,0.994048,29,168,1,167,1,1,0,1,1,85,84,83,83,19
"1602",1,"[29]nJHglqIHcKpcJvcGHqxcCCAoccDBy",168,0.994083,29,169,1,168,1,1,0,1,1,88,87,81,81,19
"1603",2,"[29]nJHglqIHcKpcJvcGHqxcCCAoccDBy",169,0.994118,29,170,1,169,1,1,0,1,1,88,87,82,82,19
"1604",3,"[29]nJHglqIHcKpcJvcGHqxcCCAoccDBy",169,0.994118,29,170,1,169,1,1,0,1,1,90,89,80,80,19
"1605",4,"[29]nJHglqIHcKpcJvcGHqxcCCAoccDBy",162,0.993865,29,163,1,162,1,1,0,1,1,70,69,93,93,19
"1606",5,"[29]nJHglqIHcKpcJvcGHqxcCCAoccDBy",163,0.993902,29,164,1,163,1,1,0,1,1,73,72,91,91,19
"1607",6,"[29]nJHglqIHcKpcJvcGHqxcCCAoccDBy",170,0.994152,29,171,1,170,1,1,0,1,1,91,90,80,80,19
"1608",7,"[29]nJHglqIHcKpcJvcGHqxcCCAoccDBy",172,0.99422,29,173,1,172,1,1,0,1,1,96,95,77,77,19
"1609",8,"[29]nJHglqIHcKpcJvcGHqxcCCAoccDBy",164,0.993939,29,165,1,164,1,1,0,1,1,76,75,89,89,19
"1610",9,"[29]nJHglqIHcKpcJvcGHqxcCCAoccDBy",167,0.994048,29,168,1,167,1,1,0,1,1,84,83,84,84,19
"1611",10,"[29]nJHglqIHcKpcJvcGHqxcCCAoccDBy",171,0.994186,29,172,1,171,1,1,0,1,1,95,94,77,77,19
"1612",11,"[29]nJHglqIHcKpcJvcGHqxcCCAoccDBy",170,0.994152,29,171,1,170,1,1,0,1,1,92,91,79,79,19
"1613",12,"[29]nJHglqIHcKpcJvcGHqxcCCAoccDBy",166,0.994012,29,167,1,166,1,1,0,1,1,82,81,85,85,19
"1614",13,"[29]nJHglqIHcKpcJvcGHqxcCCAoccDBy",166,0.994012,29,167,1,166,1,1,0,1,1,82,81,85,85,19
"1615",14,"[29]nJHglqIHcKpcJvcGHqxcCCAoccDBy",169,0.994118,29,170,1,169,1,1,0,1,1,89,88,81,81,19
"1616",15,"[29]nJHglqIHcKpcJvcGHqxcCCAoccDBy",170,0.994152,29,171,1,170,1,1,0,1,1,93,92,78,78,19
"1617",16,"[29]nJHglqIHcKpcJvcGHqxcCCAoccDBy",166,0.994012,29,167,1,166,1,1,0,1,1,81,80,86,86,19
"1618",17,"[29]nJHglqIHcKpcJvcGHqxcCCAoccDBy",165,0.993976,29,166,1,165,1,1,0,1,1,79,78,87,87,19
"1619",18,"[29]nJHglqIHcKpcJvcGHqxcCCAoccDBy",161,0.993827,29,162,1,161,1,1,0,1,1,68,67,94,94,19
"1620",19,"[29]nJHglqIHcKpcJvcGHqxcCCAoccDBy",169,0.994118,29,170,1,169,1,1,0,1,1,90,89,80,80,19
"1621",20,"[29]nJHglqIHcKpcJvcGHqxcCCAoccDBy",172,0.99422,29,173,1,172,1,1,0,1,1,98,97,75,75,19
"1622",21,"[29]nJHglqIHcKpcJvcGHqxcCCAoccDBy",167,0.994048,29,168,1,167,1,1,0,1,1,83,82,85,85,19
"1623",22,"[29]nJHglqIHcKpcJvcGHqxcCCAoccDBy",162,0.993865,29,163,1,162,1,1,0,1,1,70,69,93,93,19
"1624",23,"[29]nJHglqIHcKpcJvcGHqxcCCAoccDBy",166,0.994012,29,167,1,166,1,1,0,1,1,82,81,85,85,19
"1625",24,"[29]nJHglqIHcKpcJvcGHqxcCCAoccDBy",169,0.994118,29,170,1,169,1,1,0,1,1,90,89,80,80,19
"1626",25,"[29]nJHglqIHcKpcJvcGHqxcCCAoccDBy",172,0.99422,29,173,1,172,1,1,0,1,1,98,97,75,75,19
"1627",26,"[29]nJHglqIHcKpcJvcGHqxcCCAoccDBy",164,0.993939,29,165,1,164,1,1,0,1,1,77,76,88,88,19
"1628",27,"[29]nJHglqIHcKpcJvcGHqxcCCAoccDBy",170,0.994152,29,171,1,170,1,1,0,1,1,94,93,77,77,19
"1629",28,"[29]nJHglqIHcKpcJvcGHqxcCCAoccDBy",167,0.994048,29,168,1,167,1,1,0,1,1,83,82,85,85,19
"1630",29,"[29]nJHglqIHcKpcJvcGHqxcCCAoccDBy",163,0.993902,29,164,1,163,1,1,0,1,1,74,73,90,90,19
"1631",30,"[29]nJHglqIHcKpcJvcGHqxcCCAoccDBy",168,0.994083,29,169,1,168,1,1,0,1,1,85,84,84,84,19
"1632",31,"[29]nJHglqIHcKpcJvcGHqxcCCAoccDBy",160,0.993789,29,161,1,160,1,1,0,1,1,64,63,97,97,19
"1633",32,"[29]nJHglqIHcKpcJvcGHqxcCCAoccDBy",168,0.994083,29,169,1,168,1,1,0,1,1,87,86,82,82,19
"1634",33,"[29]nJHglqIHcKpcJvcGHqxcCCAoccDBy",165,0.993976,29,166,1,165,1,1,0,1,1,80,79,86,86,19
"1635",34,"[29]nJHglqIHcKpcJvcGHqxcCCAoccDBy",165,0.993976,29,166,1,165,1,1,0,1,1,79,78,87,87,19
"1636",35,"[29]nJHglqIHcKpcJvcGHqxcCCAoccDBy",169,0.994118,29,170,1,169,1,1,0,1,1,89,88,81,81,19
"1637",36,"[29]nJHglqIHcKpcJvcGHqxcCCAoccDBy",165,0.993976,29,166,1,165,1,1,0,1,1,79,78,87,87,19
"1638",37,"[29]nJHglqIHcKpcJvcGHqxcCCAoccDBy",170,0.994152,29,171,1,170,1,1,0,1,1,93,92,78,78,19
"1639",38,"[29]nJHglqIHcKpcJvcGHqxcCCAoccDBy",166,0.994012,29,167,1,166,1,1,0,1,1,83,82,84,84,19
"1640",39,"[29]nJHglqIHcKpcJvcGHqxcCCAoccDBy",169,0.994118,29,170,1,169,1,1,0,1,1,89,88,81,81,19
"1641",40,"[29]nJHglqIHcKpcJvcGHqxcCCAoccDBy",170,0.994152,29,171,1,170,1,1,0,1,1,93,92,78,78,19
"1642",41,"[29]nJHglqIHcKpcJvcGHqxcCCAoccDBy",168,0.994083,29,169,1,168,1,1,0,1,1,86,85,83,83,19
"1643",42,"[29]nJHglqIHcKpcJvcGHqxcCCAoccDBy",170,0.994152,29,171,1,170,1,1,0,1,1,93,92,78,78,19
"1644",43,"[29]nJHglqIHcKpcJvcGHqxcCCAoccDBy",164,0.993939,29,165,1,164,1,1,0,1,1,75,74,90,90,19
"1645",44,"[29]nJHglqIHcKpcJvcGHqxcCCAoccDBy",168,0.994083,29,169,1,168,1,1,0,1,1,86,85,83,83,19
"1646",45,"[29]nJHglqIHcKpcJvcGHqxcCCAoccDBy",165,0.993976,29,166,1,165,1,1,0,1,1,80,79,86,86,19
"1647",46,"[29]nJHglqIHcKpcJvcGHqxcCCAoccDBy",168,0.994083,29,169,1,168,1,1,0,1,1,88,87,81,81,19
"1648",47,"[29]nJHglqIHcKpcJvcGHqxcCCAoccDBy",166,0.994012,29,167,1,166,1,1,0,1,1,81,80,86,86,19
"1649",48,"[29]nJHglqIHcKpcJvcGHqxcCCAoccDBy",169,0.994118,29,170,1,169,1,1,0,1,1,90,89,80,80,19
"1650",49,"[29]nJHglqIHcKpcJvcGHqxcCCAoccDBy",169,0.994118,29,170,1,169,1,1,0,1,1,88,87,82,82,19
"1651",50,"[29]nJHglqIHcKpcJvcGHqxcCCAoccDBy",165,0.993976,29,166,1,165,1,1,0,1,1,78,77,88,88,19
"1652",51,"[29]nJHglqIHcKpcJvcGHqxcCCAoccDBy",164,0.993939,29,165,1,164,1,1,0,1,1,76,75,89,89,19
"1653",52,"[29]nJHglqIHcKpcJvcGHqxcCCAoccDBy",169,0.994118,29,170,1,169,1,1,0,1,1,89,88,81,81,19
"1654",53,"[29]nJHglqIHcKpcJvcGHqxcCCAoccDBy",165,0.993976,29,166,1,165,1,1,0,1,1,79,78,87,87,19
"1655",54,"[29]nJHglqIHcKpcJvcGHqxcCCAoccDBy",166,0.994012,29,167,1,166,1,1,0,1,1,83,82,84,84,19
"1656",55,"[29]nJHglqIHcKpcJvcGHqxcCCAoccDBy",167,0.994048,29,168,1,167,1,1,0,1,1,85,84,83,83,19
"1657",56,"[29]nJHglqIHcKpcJvcGHqxcCCAoccDBy",169,0.994118,29,170,1,169,1,1,0,1,1,90,89,80,80,19
"1658",57,"[29]nJHglqIHcKpcJvcGHqxcCCAoccDBy",169,0.994118,29,170,1,169,1,1,0,1,1,91,90,79,79,19
"1659",58,"[29]nJHglqIHcKpcJvcGHqxcCCAoccDBy",169,0.994118,29,170,1,169,1,1,0,1,1,90,89,80,80,19
"1660",59,"[29]nJHglqIHcKpcJvcGHqxcCCAoccDBy",172,0.99422,29,173,1,172,1,1,0,1,1,98,97,75,75,19
"1661",60,"[29]nJHglqIHcKpcJvcGHqxcCCAoccDBy",170,0.994152,29,171,1,170,1,1,0,1,1,94,93,77,77,19
"1662",61,"[29]nJHglqIHcKpcJvcGHqxcCCAoccDBy",169,0.994118,29,170,1,169,1,1,0,1,1,90,89,80,80,19
"1663",62,"[29]nJHglqIHcKpcJvcGHqxcCCAoccDBy",170,0.994152,29,171,1,170,1,1,0,1,1,93,92,78,78,19
"1664",63,"[29]nJHglqIHcKpcJvcGHqxcCCAoccDBy",170,0.994152,29,171,1,170,1,1,0,1,1,91,90,80,80,19
"1665",64,"[29]nJHglqIHcKpcJvcGHqxcCCAoccDBy",165,0.993976,29,166,1,165,1,1,0,1,1,80,79,86,86,19
"1666",65,"[29]nJHglqIHcKpcJvcGHqxcCCAoccDBy",158,0.993711,29,159,1,158,1,1,0,1,1,60,59,99,99,19
"1667",66,"[29]nJHglqIHcKpcJvcGHqxcCCAoccDBy",168,0.994083,29,169,1,168,1,1,0,1,1,87,86,82,82,19
"1668",67,"[29]nJHglqIHcKpcJvcGHqxcCCAoccDBy",164,0.993939,29,165,1,164,1,1,0,1,1,76,75,89,89,19
"1669",68,"[29]nJHglqIHcKpcJvcGHqxcCCAoccDBy",166,0.994012,29,167,1,166,1,1,0,1,1,83,82,84,84,19
"1670",69,"[29]nJHglqIHcKpcJvcGHqxcCCAoccDBy",163,0.993902,29,164,1,163,1,1,0,1,1,72,71,92,92,19
"1671",70,"[29]nJHglqIHcKpcJvcGHqxcCCAoccDBy",166,0.994012,29,167,1,166,1,1,0,1,1,81,80,86,86,19
"1672",71,"[29]nJHglqIHcKpcJvcGHqxcCCAoccDBy",166,0.994012,29,167,1,166,1,1,0,1,1,81,80,86,86,19
"1673",72,"[29]nJHglqIHcKpcJvcGHqxcCCAoccDBy",173,0.994253,29,174,1,173,1,1,0,1,1,101,100,73,73,19
"1674",73,"[29]nJHglqIHcKpcJvcGHqxcCCAoccDBy",165,0.993976,29,166,1,165,1,1,0,1,1,78,77,88,88,19
"1675",74,"[29]nJHglqIHcKpcJvcGHqxcCCAoccDBy",166,0.994012,29,167,1,166,1,1,0,1,1,81,80,86,86,19
"1676",75,"[29]nJHglqIHcKpcJvcGHqxcCCAoccDBy",169,0.994118,29,170,1,169,1,1,0,1,1,89,88,81,81,19
"1677",76,"[29]nJHglqIHcKpcJvcGHqxcCCAoccDBy",165,0.993976,29,166,1,165,1,1,0,1,1,80,79,86,86,19
"1678",77,"[29]nJHglqIHcKpcJvcGHqxcCCAoccDBy",168,0.994083,29,169,1,168,1,1,0,1,1,85,84,84,84,19
"1679",78,"[29]nJHglqIHcKpcJvcGHqxcCCAoccDBy",161,0.993827,29,162,1,161,1,1,0,1,1,67,66,95,95,19
"1680",79,"[29]nJHglqIHcKpcJvcGHqxcCCAoccDBy",169,0.994118,29,170,1,169,1,1,0,1,1,90,89,80,80,19
"1681",80,"[29]nJHglqIHcKpcJvcGHqxcCCAoccDBy",161,0.993827,29,162,1,161,1,1,0,1,1,67,66,95,95,19
"1682",81,"[29]nJHglqIHcKpcJvcGHqxcCCAoccDBy",166,0.994012,29,167,1,166,1,1,0,1,1,82,81,85,85,19
"1683",82,"[29]nJHglqIHcKpcJvcGHqxcCCAoccDBy",167,0.994048,29,168,1,167,1,1,0,1,1,85,84,83,83,19
"1684",83,"[29]nJHglqIHcKpcJvcGHqxcCCAoccDBy",166,0.994012,29,167,1,166,1,1,0,1,1,81,80,86,86,19
"1685",84,"[29]nJHglqIHcKpcJvcGHqxcCCAoccDBy",169,0.994118,29,170,1,169,1,1,0,1,1,90,89,80,80,19
"1686",85,"[29]nJHglqIHcKpcJvcGHqxcCCAoccDBy",165,0.993976,29,166,1,165,1,1,0,1,1,79,78,87,87,19
"1687",86,"[29]nJHglqIHcKpcJvcGHqxcCCAoccDBy",166,0.994012,29,167,1,166,1,1,0,1,1,82,81,85,85,19
"1688",87,"[29]nJHglqIHcKpcJvcGHqxcCCAoccDBy",165,0.993976,29,166,1,165,1,1,0,1,1,79,78,87,87,19
"1689",88,"[29]nJHglqIHcKpcJvcGHqxcCCAoccDBy",167,0.994048,29,168,1,167,1,1,0,1,1,84,83,84,84,19
"1690",89,"[29]nJHglqIHcKpcJvcGHqxcCCAoccDBy",171,0.994186,29,172,1,171,1,1,0,1,1,94,93,78,78,19
"1691",90,"[29]nJHglqIHcKpcJvcGHqxcCCAoccDBy",170,0.994152,29,171,1,170,1,1,0,1,1,91,90,80,80,19
"1692",91,"[29]nJHglqIHcKpcJvcGHqxcCCAoccDBy",165,0.993976,29,166,1,165,1,1,0,1,1,78,77,88,88,19
"1693",92,"[29]nJHglqIHcKpcJvcGHqxcCCAoccDBy",169,0.994118,29,170,1,169,1,1,0,1,1,90,89,80,80,19
"1694",93,"[29]nJHglqIHcKpcJvcGHqxcCCAoccDBy",166,0.994012,29,167,1,166,1,1,0,1,1,82,81,85,85,19
"1695",94,"[29]nJHglqIHcKpcJvcGHqxcCCAoccDBy",165,0.993976,29,166,1,165,1,1,0,1,1,77,76,89,89,19
"1696",95,"[29]nJHglqIHcKpcJvcGHqxcCCAoccDBy",166,0.994012,29,167,1,166,1,1,0,1,1,82,81,85,85,19
"1697",96,"[29]nJHglqIHcKpcJvcGHqxcCCAoccDBy",171,0.994186,29,172,1,171,1,1,0,1,1,96,95,76,76,19
"1698",97,"[29]nJHglqIHcKpcJvcGHqxcCCAoccDBy",171,0.994186,29,172,1,171,1,1,0,1,1,95,94,77,77,19
"1699",98,"[29]nJHglqIHcKpcJvcGHqxcCCAoccDBy",170,0.994152,29,171,1,170,1,1,0,1,1,90,89,81,81,19
"1700",99,"[29]nJHglqIHcKpcJvcGHqxcCCAoccDBy",169,0.994118,29,170,1,169,1,1,0,1,1,90,89,80,80,19
"1701",0,"[28]zJHglqIHBGdKocJvcGHqvdCCelhz",168,0.994083,28,169,1,168,1,1,0,1,1,86,85,83,83,20
"1702",1,"[28]zJHglqIHBGdKocJvcGHqvdCCelhz",167,0.994048,28,168,1,167,1,1,0,1,1,84,83,84,84,20
"1703",2,"[28]zJHglqIHBGdKocJvcGHqvdCCelhz",166,0.994012,28,167,1,166,1,1,0,1,1,82,81,85,85,20
"1704",3,"[28]zJHglqIHBGdKocJvcGHqvdCCelhz",167,0.994048,28,168,1,167,1,1,0,1,1,85,84,83,83,20
"1705",4,"[28]zJHglqIHBGdKocJvcGHqvdCCelhz",166,0.994012,28,167,1,166,1,1,0,1,1,83,82,84,84,20
"1706",5,"[28]zJHglqIHBGdKocJvcGHqvdCCelhz",167,0.994048,28,168,1,167,1,1,0,1,1,85,84,83,83,20
"1707",6,"[28]zJHglqIHBGdKocJvcGHqvdCCelhz",170,0.994152,28,171,1,170,1,1,0,1,1,94,93,77,77,20
"1708",7,"[28]zJHglqIHBGdKocJvcGHqvdCCelhz",167,0.994048,28,168,1,167,1,1,0,1,1,84,83,84,84,20
"1709",8,"[28]zJHglqIHBGdKocJvcGHqvdCCelhz",171,0.994186,28,172,1,171,1,1,0,1,1,95,94,77,77,20
"1710",9,"[28]zJHglqIHBGdKocJvcGHqvdCCelhz",166,0.994012,28,167,1,166,1,1,0,1,1,82,81,85,85,20
"1711",10,"[28]zJHglqIHBGdKocJvcGHqvdCCelhz",167,0.994048,28,168,1,167,1,1,0,1,1,85,84,83,83,20
"1712",11,"[28]zJHglqIHBGdKocJvcGHqvdCCelhz",164,0.993939,28,165,1,164,1,1,0,1,1,75,74,90,90,20
"1713",12,"[28]zJHglqIHBGdKocJvcGHqvdCCelhz",170,0.994152,28,171,1,170,1,1,0,1,1,92,91,79,79,20
"1714",13,"[28]zJHglqIHBGdKocJvcGHqvdCCelhz",167,0.994048,28,168,1,167,1,1,0,1,1,85,84,83,83,20
"1715",14,"[28]zJHglqIHBGdKocJvcGHqvdCCelhz",175,0.994318,28,176,1,175,1,1,0,1,1,108,107,68,68,20
"1716",15,"[28]zJHglqIHBGdKocJvcGHqvdCCelhz",165,0.993976,28,166,1,165,1,1,0,1,1,80,79,86,86,20
"1717",16,"[28]zJHglqIHBGdKocJvcGHqvdCCelhz",167,0.994048,28,168,1,167,1,1,0,1,1,83,82,85,85,20
"1718",17,"[28]zJHglqIHBGdKocJvcGHqvdCCelhz",167,0.994048,28,168,1,167,1,1,0,1,1,83,82,85,85,20
"1719",18,"[28]zJHglqIHBGdKocJvcGHqvdCCelhz",170,0.994152,28,171,1,170,1,1,0,1,1,94,93,77,77,20
"1720",19,"[28]zJHglqIHBGdKocJvcGHqvdCCelhz",164,0.993939,28,165,1,164,1,1,0,1,1,76,75,89,89,20
"1721",20,"[28]zJHglqIHBGdKocJvcGHqvdCCelhz",164,0.993939,28,165,1,164,1,1,0,1,1,78,77,87,87,20
"1722",21,"[28]zJHglqIHBGdKocJvcGHqvdCCelhz",166,0.994012,28,167,1,166,1,1,0,1,1,81,80,86,86,20
"1723",22,"[28]zJHglqIHBGdKocJvcGHqvdCCelhz",163,0.993902,28,164,1,163,1,1,0,1,1,74,73,90,90,20
"1724",23,"[28]zJHglqIHBGdKocJvcGHqvdCCelhz",165,0.993976,28,166,1,165,1,1,0,1,1,78,77,88,88,20
"1725",24,"[28]zJHglqIHBGdKocJvcGHqvdCCelhz",166,0.994012,28,167,1,166,1,1,0,1,1,83,82,84,84,20
"1726",25,"[28]zJHglqIHBGdKocJvcGHqvdCCelhz",170,0.994152,28,171,1,170,1,1,0,1,1,93,92,78,78,20
"1727",26,"[28]zJHglqIHBGdKocJvcGHqvdCCelhz",164,0.993939,28,165,1,164,1,1,0,1,1,76,75,89,89,20
"1728",27,"[28]zJHglqIHBGdKocJvcGHqvdCCelhz",166,0.994012,28,167,1,166,1,1,0,1,1,82,81,85,85,20
"1729",28,"[28]zJHglqIHBGdKocJvcGHqvdCCelhz",165,0.993976,28,166,1,165,1,1,0,1,1,80,79,86,86,20
"1730",29,"[28]zJHglqIHBGdKocJvcGHqvdCCelhz",164,0.993939,28,165,1,164,1,1,0,1,1,78,77,87,87,20
"1731",30,"[28]zJHglqIHBGdKocJvcGHqvdCCelhz",166,0.994012,28,167,1,166,1,1,0,1,1,83,82,84,84,20
"1732",31,"[28]zJHglqIHBGdKocJvcGHqvdCCelhz",170,0.994152,28,171,1,170,1,1,0,1,1,94,93,77,77,20
"1733",32,"[28]zJHglqIHBGdKocJvcGHqvdCCelhz",165,0.993976,28,166,1,165,1,1,0,1,1,79,78,87,87,20
"1734",33,"[28]zJHglqIHBGdKocJvcGHqvdCCelhz",170,0.994152,28,171,1,170,1,1,0,1,1,93,92,78,78,20
"1735",34,"[28]zJHglqIHBGdKocJvcGHqvdCCelhz",164,0.993939,28,165,1,164,1,1,0,1,1,77,76,88,88,20
"1736",35,"[28]zJHglqIHBGdKocJvcGHqvdCCelhz",165,0.993976,28,166,1,165,1,1,0,1,1,79,78,87,87,20
"1737",36,"[28]zJHglqIHBGdKocJvcGHqvdCCelhz",169,0.994118,28,170,1,169,1,1,0,1,1,91,90,79,79,20
"1738",37,"[28]zJHglqIHBGdKocJvcGHqvdCCelhz",168,0.994083,28,169,1,168,1,1,0,1,1,86,85,83,83,20
"1739",38,"[28]zJHglqIHBGdKocJvcGHqvdCCelhz",164,0.993939,28,165,1,164,1,1,0,1,1,76,75,89,89,20
"1740",39,"[28]zJHglqIHBGdKocJvcGHqvdCCelhz",169,0.994118,28,170,1,169,1,1,0,1,1,90,89,80,80,20
"1741",40,"[28]zJHglqIHBGdKocJvcGHqvdCCelhz",171,0.994186,28,172,1,171,1,1,0,1,1,97,96,75,75,20
"1742",41,"[28]zJHglqIHBGdKocJvcGHqvdCCelhz",162,0.993865,28,163,1,162,1,1,0,1,1,71,70,92,92,20
"1743",42,"[28]zJHglqIHBGdKocJvcGHqvdCCelhz",169,0.994118,28,170,1,169,1,1,0,1,1,91,90,79,79,20
"1744",43,"[28]zJHglqIHBGdKocJvcGHqvdCCelhz",166,0.994012,28,167,1,166,1,1,0,1,1,82,81,85,85,20
"1745",44,"[28]zJHglqIHBGdKocJvcGHqvdCCelhz",168,0.994083,28,169,1,168,1,1,0,1,1,86,85,83,83,20
"1746",45,"[28]zJHglqIHBGdKocJvcGHqvdCCelhz",168,0.994083,28,169,1,168,1,1,0,1,1,87,86,82,82,20
"1747",46,"[28]zJHglqIHBGdKocJvcGHqvdCCelhz",167,0.994048,28,168,1,167,1,1,0,1,1,85,84,83,83,20
"1748",47,"[28]zJHglqIHBGdKocJvcGHqvdCCelhz",165,0.993976,28,166,1,165,1,1,0,1,1,79,78,87,87,20
"1749",48,"[28]zJHglqIHBGdKocJvcGHqvdCCelhz",170,0.994152,28,171,1,170,1,1,0,1,1,93,92,78,78,20
"1750",49,"[28]zJHglqIHBGdKocJvcGHqvdCCelhz",166,0.994012,28,167,1,166,1,1,0,1,1,81,80,86,86,20
"1751",50,"[28]zJHglqIHBGdKocJvcGHqvdCCelhz",165,0.993976,28,166,1,165,1,1,0,1,1,80,79,86,86,20
"1752",51,"[28]zJHglqIHBGdKocJvcGHqvdCCelhz",169,0.994118,28,170,1,169,1,1,0,1,1,91,90,79,79,20
"1753",52,"[28]zJHglqIHBGdKocJvcGHqvdCCelhz",170,0.994152,28,171,1,170,1,1,0,1,1,94,93,77,77,20
"1754",53,"[28]zJHglqIHBGdKocJvcGHqvdCCelhz",164,0.993939,28,165,1,164,1,1,0,1,1,78,77,87,87,20
"1755",54,"[28]zJHglqIHBGdKocJvcGHqvdCCelhz",167,0.994048,28,168,1,167,1,1,0,1,1,84,83,84,84,20
"1756",55,"[28]zJHglqIHBGdKocJvcGHqvdCCelhz",164,0.993939,28,165,1,164,1,1,0,1,1,77,76,88,88,20
"1757",56,"[28]zJHglqIHBGdKocJvcGHqvdCCelhz",167,0.994048,28,168,1,167,1,1,0,1,1,84,83,84,84,20
"1758",57,"[28]zJHglqIHBGdKocJvcGHqvdCCelhz",168,0.994083,28,169,1,168,1,1,0,1,1,87,86,82,82,20
"1759",58,"[28]zJHglqIHBGdKocJvcGHqvdCCelhz",167,0.994048,28,168,1,167,1,1,0,1,1,85,84,83,83,20
"1760",59,"[28]zJHglqIHBGdKocJvcGHqvdCCelhz",168,0.994083,28,169,1,168,1,1,0,1,1,88,87,81,81,20
"1761",60,"[28]zJHglqIHBGdKocJvcGHqvdCCelhz",165,0.993976,28,166,1,165,1,1,0,1,1,79,78,87,87,20
"1762",61,"[28]zJHglqIHBGdKocJvcGHqvdCCelhz",161,0.993827,28,162,1,161,1,1,0,1,1,69,68,93,93,20
"1763",62,"[28]zJHglqIHBGdKocJvcGHqvdCCelhz",168,0.994083,28,169,1,168,1,1,0,1,1,87,86,82,82,20
"1764",63,"[28]zJHglqIHBGdKocJvcGHqvdCCelhz",166,0.994012,28,167,1,166,1,1,0,1,1,83,82,84,84,20
"1765",64,"[28]zJHglqIHBGdKocJvcGHqvdCCelhz",167,0.994048,28,168,1,167,1,1,0,1,1,82,81,86,86,20
"1766",65,"[28]zJHglqIHBGdKocJvcGHqvdCCelhz",166,0.994012,28,167,1,166,1,1,0,1,1,82,81,85,85,20
"1767",66,"[28]zJHglqIHBGdKocJvcGHqvdCCelhz",162,0.993865,28,163,1,162,1,1,0,1,1,72,71,91,91,20
"1768",67,"[28]zJHglqIHBGdKocJvcGHqvdCCelhz",164,0.993939,28,165,1,164,1,1,0,1,1,75,74,90,90,20
"1769",68,"[28]zJHglqIHBGdKocJvcGHqvdCCelhz",166,0.994012,28,167,1,166,1,1,0,1,1,79,78,88,88,20
"1770",69,"[28]zJHglqIHBGdKocJvcGHqvdCCelhz",165,0.993976,28,166,1,165,1,1,0,1,1,78,77,88,88,20
"1771",70,"[28]zJHglqIHBGdKocJvcGHqvdCCelhz",168,0.994083,28,169,1,168,1,1,0,1,1,86,85,83,83,20
"1772",71,"[28]zJHglqIHBGdKocJvcGHqvdCCelhz",170,0.994152,28,171,1,170,1,1,0,1,1,92,91,79,79,20
"1773",72,"[28]zJHglqIHBGdKocJvcGHqvdCCelhz",168,0.994083,28,169,1,168,1,1,0,1,1,87,86,82,82,20
"1774",73,"[28]zJHglqIHBGdKocJvcGHqvdCCelhz",174,0.994286,28,175,1,174,1,1,0,1,1,105,104,70,70,20
"1775",74,"[28]zJHglqIHBGdKocJvcGHqvdCCelhz",168,0.994083,28,169,1,168,1,1,0,1,1,88,87,81,81,20
"1776",75,"[28]zJHglqIHBGdKocJvcGHqvdCCelhz",167,0.994048,28,168,1,167,1,1,0,1,1,85,84,83,83,20
"1777",76,"[28]zJHglqIHBGdKocJvcGHqvdCCelhz",163,0.993902,28,164,1,163,1,1,0,1,1,74,73,90,90,20
"1778",77,"[28]zJHglqIHBGdKocJvcGHqvdCCelhz",169,0.994118,28,170,1,169,1,1,0,1,1,89,88,81,81,20
"1779",78,"[28]zJHglqIHBGdKocJvcGHqvdCCelhz",169,0.994118,28,170,1,169,1,1,0,1,1,91,90,79,79,20
"1780",79,"[28]zJHglqIHBGdKocJvcGHqvdCCelhz",165,0.993976,28,166,1,165,1,1,0,1,1,79,78,87,87,20
"1781",80,"[28]zJHglqIHBGdKocJvcGHqvdCCelhz",170,0.994152,28,171,1,170,1,1,0,1,1,94,93,77,77,20
"1782",81,"[28]zJHglqIHBGdKocJvcGHqvdCCelhz",169,0.994118,28,170,1,169,1,1,0,1,1,90,89,80,80,20
"1783",82,"[28]zJHglqIHBGdKocJvcGHqvdCCelhz",171,0.994186,28,172,1,171,1,1,0,1,1,95,94,77,77,20
"1784",83,"[28]zJHglqIHBGdKocJvcGHqvdCCelhz",163,0.993902,28,164,1,163,1,1,0,1,1,74,73,90,90,20
"1785",84,"[28]zJHglqIHBGdKocJvcGHqvdCCelhz",170,0.994152,28,171,1,170,1,1,0,1,1,92,91,79,79,20
"1786",85,"[28]zJHglqIHBGdKocJvcGHqvdCCelhz",170,0.994152,28,171,1,170,1,1,0,1,1,94,93,77,77,20
"1787",86,"[28]zJHglqIHBGdKocJvcGHqvdCCelhz",167,0.994048,28,168,1,167,1,1,0,1,1,86,85,82,82,20
"1788",87,"[28]zJHglqIHBGdKocJvcGHqvdCCelhz",168,0.994083,28,169,1,168,1,1,0,1,1,88,87,81,81,20
"1789",88,"[28]zJHglqIHBGdKocJvcGHqvdCCelhz",163,0.993902,28,164,1,163,1,1,0,1,1,72,71,92,92,20
"1790",89,"[28]zJHglqIHBGdKocJvcGHqvdCCelhz",170,0.994152,28,171,1,170,1,1,0,1,1,93,92,78,78,20
"1791",90,"[28]zJHglqIHBGdKocJvcGHqvdCCelhz",169,0.994118,28,170,1,169,1,1,0,1,1,90,89,80,80,20
"1792",91,"[28]zJHglqIHBGdKocJvcGHqvdCCelhz",164,0.993939,28,165,1,164,1,1,0,1,1,78,77,87,87,20
"1793",92,"[28]zJHglqIHBGdKocJvcGHqvdCCelhz",166,0.994012,28,167,1,166,1,1,0,1,1,82,81,85,85,20
"1794",93,"[28]zJHglqIHBGdKocJvcGHqvdCCelhz",166,0.994012,28,167,1,166,1,1,0,1,1,83,82,84,84,20
"1795",94,"[28]zJHglqIHBGdKocJvcGHqvdCCelhz",169,0.994118,28,170,1,169,1,1,0,1,1,91,90,79,79,20
"1796",95,"[28]zJHglqIHBGdKocJvcGHqvdCCelhz",170,0.994152,28,171,1,170,1,1,0,1,1,93,92,78,78,20
"1797",96,"[28]zJHglqIHBGdKocJvcGHqvdCCelhz",165,0.993976,28,166,1,165,1,1,0,1,1,80,79,86,86,20
"1798",97,"[28]zJHglqIHBGdKocJvcGHqvdCCelhz",163,0.993902,28,164,1,163,1,1,0,1,1,74,73,90,90,20
"1799",98,"[28]zJHglqIHBGdKocJvcGHqvdCCelhz",167,0.994048,28,168,1,167,1,1,0,1,1,83,82,85,85,20
"1800",99,"[28]zJHglqIHBGdKocJvcGHqvdCCelhz",167,0.994048,28,168,1,167,1,1,0,1,1,84,83,84,84,20
"1801",0,"[29]ykJHglqIrHcbdKocJvcGHqvdCrhhc",166,0.994012,29,167,1,166,1,1,0,1,1,84,83,83,83,21
"1802",1,"[29]ykJHglqIrHcbdKocJvcGHqvdCrhhc",171,0.994186,29,172,1,171,1,1,0,1,1,97,96,75,75,21
"1803",2,"[29]ykJHglqIrHcbdKocJvcGHqvdCrhhc",162,0.993865,29,163,1,162,1,1,0,1,1,73,72,90,90,21
"1804",3,"[29]ykJHglqIrHcbdKocJvcGHqvdCrhhc",162,0.993865,29,163,1,162,1,1,0,1,1,71,70,92,92,21
"1805",4,"[29]ykJHglqIrHcbdKocJvcGHqvdCrhhc",171,0.994186,29,172,1,171,1,1,0,1,1,97,96,75,75,21
"1806",5,"[29]ykJHglqIrHcbdKocJvcGHqvdCrhhc",168,0.994083,29,169,1,168,1,1,0,1,1,88,87,81,81,21
"1807",6,"[29]ykJHglqIrHcbdKocJvcGHqvdCrhhc",167,0.994048,29,168,1,167,1,1,0,1,1,86,85,82,82,21
"1808",7,"[29]ykJHglqIrHcbdKocJvcGHqvdCrhhc",166,0.994012,29,167,1,166,1,1,0,1,1,84,83,83,83,21
"1809",8,"[29]ykJHglqIrHcbdKocJvcGHqvdCrhhc",173,0.994253,29,174,1,173,1,1,0,1,1,101,100,73,73,21
"1810",9,"[29]ykJHglqIrHcbdKocJvcGHqvdCrhhc",169,0.994118,29,170,1,169,1,1,0,1,1,91,90,79,79,21
"1811",10,"[29]ykJHglqIrHcbdKocJvcGHqvdCrhhc",162,0.993865,29,163,1,162,1,1,0,1,1,73,72,90,90,21
"1812",11,"[29]ykJHglqIrHcbdKocJvcGHqvdCrhhc",165,0.993976,29,166,1,165,1,1,0,1,1,80,79,86,86,21
"1813",12,"[29]ykJHglqIrHcbdKocJvcGHqvdCrhhc",169,0.994118,29,170,1,169,1,1,0,1,1,90,89,80,80,21
"1814",13,"[29]ykJHglqIrHcbdKocJvcGHqvdCrhhc",165,0.993976,29,166,1,165,1,1,0,1,1,80,79,86,86,21
"1815",14,"[29]ykJHglqIrHcbdKocJvcGHqvdCrhhc",170,0.994152,29,171,1,170,1,1,0,1,1,93,92,78,78,21
"1816",15,"[29]ykJHglqIrHcbdKocJvcGHqvdCrhhc",164,0.993939,29,165,1,164,1,1,0,1,1,77,76,88,88,21
"1817",16,"[29]ykJHglqIrHcbdKocJvcGHqvdCrhhc",167,0.994048,29,168,1,167,1,1,0,1,1,86,85,82,82,21
"1818",17,"[29]ykJHglqIrHcbdKocJvcGHqvdCrhhc",162,0.993865,29,163,1,162,1,1,0,1,1,72,71,91,91,21
"1819",18,"[29]ykJHglqIrHcbdKocJvcGHqvdCrhhc",170,0.994152,29,171,1,170,1,1,0,1,1,93,92,78,78,21
"1820",19,"[29]ykJHglqIrHcbdKocJvcGHqvdCrhhc",169,0.994118,29,170,1,169,1,1,0,1,1,90,89,80,80,21
"1821",20,"[29]ykJHglqIrHcbdKocJvcGHqvdCrhhc",165,0.993976,29,166,1,165,1,1,0,1,1,79,78,87,87,21
"1822",21,"[29]ykJHglqIrHcbdKocJvcGHqvdCrhhc",166,0.994012,29,167,1,166,1,1,0,1,1,83,82,84,84,21
"1823",22,"[29]ykJHglqIrHcbdKocJvcGHqvdCrhhc",164,0.993939,29,165,1,164,1,1,0,1,1,78,77,87,87,21
"1824",23,"[29]ykJHglqIrHcbdKocJvcGHqvdCrhhc",168,0.994083,29,169,1,168,1,1,0,1,1,87,86,82,82,21
"1825",24,"[29]ykJHglqIrHcbdKocJvcGHqvdCrhhc",166,0.994012,29,167,1,166,1,1,0,1,1,82,81,85,85,21
"1826",25,"[29]ykJHglqIrHcbdKocJvcGHqvdCrhhc",166,0.994012,29,167,1,166,1,1,0,1,1,84,83,83,83,21
"1827",26,"[29]ykJHglqIrHcbdKocJvcGHqvdCrhhc",165,0.993976,29,166,1,165,1,1,0,1,1,80,79,86,86,21
"1828",27,"[29]ykJHglqIrHcbdKocJvcGHqvdCrhhc",164,0.993939,29,165,1,164,1,1,0,1,1,78,77,87,87,21
"1829",28,"[29]ykJHglqIrHcbdKocJvcGHqvdCrhhc",164,0.993939,29,165,1,164,1,1,0,1,1,78,77,87,87,21
"1830",29,"[29]ykJHglqIrHcbdKocJvcGHqvdCrhhc",166,0.994012,29,167,1,166,1,1,0,1,1,83,82,84,84,21
"1831",30,"[29]ykJHglqIrHcbdKocJvcGHqvdCrhhc",168,0.994083,29,169,1,168,1,1,0,1,1,87,86,82,82,21
"1832",31,"[29]ykJHglqIrHcbdKocJvcGHqvdCrhhc",164,0.993939,29,165,1,164,1,1,0,1,1,77,76,88,88,21
"1833",32,"[29]ykJHglqIrHcbdKocJvcGHqvdCrhhc",168,0.994083,29,169,1,168,1,1,0,1,1,87,86,82,82,21
"1834",33,"[29]ykJHglqIrHcbdKocJvcGHqvdCrhhc",168,0.994083,29,169,1,168,1,1,0,1,1,87,86,82,82,21
"1835",34,"[29]ykJHglqIrHcbdKocJvcGHqvdCrhhc",168,0.994083,29,169,1,168,1,1,0,1,1,88,87,81,81,21
"1836",35,"[29]ykJHglqIrHcbdKocJvcGHqvdCrhhc",166,0.994012,29,167,1,166,1,1,0,1,1,83,82,84,84,21
"1837",36,"[29]ykJHglqIrHcbdKocJvcGHqvdCrhhc",165,0.993976,29,166,1,165,1,1,0,1,1,81,80,85,85,21
"1838",37,"[29]ykJHglqIrHcbdKocJvcGHqvdCrhhc",167,0.994048,29,168,1,167,1,1,0,1,1,85,84,83,83,21
"1839",38,"[29]ykJHglqIrHcbdKocJvcGHqvdCrhhc",171,0.994186,29,172,1,171,1,1,0,1,1,96,95,76,76,21
"1840",39,"[29]ykJHglqIrHcbdKocJvcGHqvdCrhhc",168,0.994083,29,169,1,168,1,1,0,1,1,89,88,80,80,21
"1841",40,"[29]ykJHglqIrHcbdKocJvcGHqvdCrhhc",166,0.994012,29,167,1,166,1,1,0,1,1,84,83,83,83,21
"1842",41,"[29]ykJHglqIrHcbdKocJvcGHqvdCrhhc",165,0.993976,29,166,1,165,1,1,0,1,1,79,78,87,87,21
"1843",42,"[29]ykJHglqIrHcbdKocJvcGHqvdCrhhc",164,0.993939,29,165,1,164,1,1,0,1,1,77,76,88,88,21
"1844",43,"[29]ykJHglqIrHcbdKocJvcGHqvdCrhhc",166,0.994012,29,167,1,166,1,1,0,1,1,83,82,84,84,21
"1845",44,"[29]ykJHglqIrHcbdKocJvcGHqvdCrhhc",163,0.993902,29,164,1,163,1,1,0,1,1,74,73,90,90,21
"1846",45,"[29]ykJHglqIrHcbdKocJvcGHqvdCrhhc",159,0.99375,29,160,1,159,1,1,0,1,1,64,63,96,96,21
"1847",46,"[29]ykJHglqIrHcbdKocJvcGHqvdCrhhc",164,0.993939,29,165,1,164,1,1,0,1,1,78,77,87,87,21
"1848",47,"[29]ykJHglqIrHcbdKocJvcGHqvdCrhhc",163,0.993902,29,164,1,163,1,1,0,1,1,75,74,89,89,21
"1849",48,"[29]ykJHglqIrHcbdKocJvcGHqvdCrhhc",167,0.994048,29,168,1,167,1,1,0,1,1,85,84,83,83,21
"1850",49,"[29]ykJHglqIrHcbdKocJvcGHqvdCrhhc",166,0.994012,29,167,1,166,1,1,0,1,1,81,80,86,86,21
"1851",50,"[29]ykJHglqIrHcbdKocJvcGHqvdCrhhc",168,0.994083,29,169,1,168,1,1,0,1,1,88,87,81,81,21
"1852",51,"[29]ykJHglqIrHcbdKocJvcGHqvdCrhhc",168,0.994083,29,169,1,168,1,1,0,1,1,89,88,80,80,21
"1853",52,"[29]ykJHglqIrHcbdKocJvcGHqvdCrhhc",166,0.994012,29,167,1,166,1,1,0,1,1,83,82,84,84,21
"1854",53,"[29]ykJHglqIrHcbdKocJvcGHqvdCrhhc",163,0.993902,29,164,1,163,1,1,0,1,1,75,74,89,89,21
"1855",54,"[29]ykJHglqIrHcbdKocJvcGHqvdCrhhc",169,0.994118,29,170,1,169,1,1,0,1,1,89,88,81,81,21
"1856",55,"[29]ykJHglqIrHcbdKocJvcGHqvdCrhhc",165,0.993976,29,166,1,165,1,1,0,1,1,81,80,85,85,21
"1857",56,"[29]ykJHglqIrHcbdKocJvcGHqvdCrhhc",162,0.993865,29,163,1,162,1,1,0,1,1,73,72,90,90,21
"1858",57,"[29]ykJHglqIrHcbdKocJvcGHqvdCrhhc",164,0.993939,29,165,1,164,1,1,0,1,1,77,76,88,88,21
"1859",58,"[29]ykJHglqIrHcbdKocJvcGHqvdCrhhc",164,0.993939,29,165,1,164,1,1,0,1,1,78,77,87,87,21
"1860",59,"[29]ykJHglqIrHcbdKocJvcGHqvdCrhhc",167,0.994048,29,168,1,167,1,1,0,1,1,86,85,82,82,21
"1861",60,"[29]ykJHglqIrHcbdKocJvcGHqvdCrhhc",171,0.994186,29,172,1,171,1,1,0,1,1,96,95,76,76,21
"1862",61,"[29]ykJHglqIrHcbdKocJvcGHqvdCrhhc",164,0.993939,29,165,1,164,1,1,0,1,1,76,75,89,89,21
"1863",62,"[29]ykJHglqIrHcbdKocJvcGHqvdCrhhc",168,0.994083,29,169,1,168,1,1,0,1,1,88,87,81,81,21
"1864",63,"[29]ykJHglqIrHcbdKocJvcGHqvdCrhhc",168,0.994083,29,169,1,168,1,1,0,1,1,88,87,81,81,21
"1865",64,"[29]ykJHglqIrHcbdKocJvcGHqvdCrhhc",169,0.994118,29,170,1,169,1,1,0,1,1,92,91,78,78,21
"1866",65,"[29]ykJHglqIrHcbdKocJvcGHqvdCrhhc",169,0.994118,29,170,1,169,1,1,0,1,1,91,90,79,79,21
"1867",66,"[29]ykJHglqIrHcbdKocJvcGHqvdCrhhc",170,0.994152,29,171,1,170,1,1,0,1,1,92,91,79,79,21
"1868",67,"[29]ykJHglqIrHcbdKocJvcGHqvdCrhhc",168,0.994083,29,169,1,168,1,1,0,1,1,89,88,80,80,21
"1869",68,"[29]ykJHglqIrHcbdKocJvcGHqvdCrhhc",165,0.993976,29,166,1,165,1,1,0,1,1,78,77,88,88,21
"1870",69,"[29]ykJHglqIrHcbdKocJvcGHqvdCrhhc",171,0.994186,29,172,1,171,1,1,0,1,1,96,95,76,76,21
"1871",70,"[29]ykJHglqIrHcbdKocJvcGHqvdCrhhc",160,0.993789,29,161,1,160,1,1,0,1,1,67,66,94,94,21
"1872",71,"[29]ykJHglqIrHcbdKocJvcGHqvdCrhhc",171,0.994186,29,172,1,171,1,1,0,1,1,96,95,76,76,21
"1873",72,"[29]ykJHglqIrHcbdKocJvcGHqvdCrhhc",161,0.993827,29,162,1,161,1,1,0,1,1,69,68,93,93,21
"1874",73,"[29]ykJHglqIrHcbdKocJvcGHqvdCrhhc",163,0.993902,29,164,1,163,1,1,0,1,1,75,74,89,89,21
"1875",74,"[29]ykJHglqIrHcbdKocJvcGHqvdCrhhc",169,0.994118,29,170,1,169,1,1,0,1,1,90,89,80,80,21
"1876",75,"[29]ykJHglqIrHcbdKocJvcGHqvdCrhhc",165,0.993976,29,166,1,165,1,1,0,1,1,80,79,86,86,21
"1877",76,"[29]ykJHglqIrHcbdKocJvcGHqvdCrhhc",166,0.994012,29,167,1,166,1,1,0,1,1,83,82,84,84,21
"1878",77,"[29]ykJHglqIrHcbdKocJvcGHqvdCrhhc",164,0.993939,29,165,1,164,1,1,0,1,1,77,76,88,88,21
"1879",78,"[29]ykJHglqIrHcbdKocJvcGHqvdCrhhc",168,0.994083,29,169,1,168,1,1,0,1,1,87,86,82,82,21
"1880",79,"[29]ykJHglqIrHcbdKocJvcGHqvdCrhhc",162,0.993865,29,163,1,162,1,1,0,1,1,73,72,90,90,21
"1881",80,"[29]ykJHglqIrHcbdKocJvcGHqvdCrhhc",163,0.993902,29,164,1,163,1,1,0,1,1,75,74,89,89,21
"1882",81,"[29]ykJHglqIrHcbdKocJvcGHqvdCrhhc",164,0.993939,29,165,1,164,1,1,0,1,1,76,75,89,89,21
"1883",82,"[29]ykJHglqIrHcbdKocJvcGHqvdCrhhc",164,0.993939,29,165,1,164,1,1,0,1,1,78,77,87,87,21
"1884",83,"[29]ykJHglqIrHcbdKocJvcGHqvdCrhhc",161,0.993827,29,162,1,161,1,1,0,1,1,69,68,93,93,21
"1885",84,"[29]ykJHglqIrHcbdKocJvcGHqvdCrhhc",164,0.993939,29,165,1,164,1,1,0,1,1,78,77,87,87,21
"1886",85,"[29]ykJHglqIrHcbdKocJvcGHqvdCrhhc",162,0.993865,29,163,1,162,1,1,0,1,1,73,72,90,90,21
"1887",86,"[29]ykJHglqIrHcbdKocJvcGHqvdCrhhc",165,0.993976,29,166,1,165,1,1,0,1,1,80,79,86,86,21
"1888",87,"[29]ykJHglqIrHcbdKocJvcGHqvdCrhhc",169,0.994118,29,170,1,169,1,1,0,1,1,91,90,79,79,21
"1889",88,"[29]ykJHglqIrHcbdKocJvcGHqvdCrhhc",166,0.994012,29,167,1,166,1,1,0,1,1,84,83,83,83,21
"1890",89,"[29]ykJHglqIrHcbdKocJvcGHqvdCrhhc",166,0.994012,29,167,1,166,1,1,0,1,1,82,81,85,85,21
"1891",90,"[29]ykJHglqIrHcbdKocJvcGHqvdCrhhc",165,0.993976,29,166,1,165,1,1,0,1,1,81,80,85,85,21
"1892",91,"[29]ykJHglqIrHcbdKocJvcGHqvdCrhhc",168,0.994083,29,169,1,168,1,1,0,1,1,88,87,81,81,21
"1893",92,"[29]ykJHglqIrHcbdKocJvcGHqvdCrhhc",168,0.994083,29,169,1,168,1,1,0,1,1,88,87,81,81,21
"1894",93,"[29]ykJHglqIrHcbdKocJvcGHqvdCrhhc",167,0.994048,29,168,1,167,1,1,0,1,1,86,85,82,82,21
"1895",94,"[29]ykJHglqIrHcbdKocJvcGHqvdCrhhc",163,0.993902,29,164,1,163,1,1,0,1,1,75,74,89,89,21
"1896",95,"[29]ykJHglqIrHcbdKocJvcGHqvdCrhhc",166,0.994012,29,167,1,166,1,1,0,1,1,83,82,84,84,21
"1897",96,"[29]ykJHglqIrHcbdKocJvcGHqvdCrhhc",164,0.993939,29,165,1,164,1,1,0,1,1,76,75,89,89,21
"1898",97,"[29]ykJHglqIrHcbdKocJvcGHqvdCrhhc",166,0.994012,29,167,1,166,1,1,0,1,1,83,82,84,84,21
"1899",98,"[29]ykJHglqIrHcbdKocJvcGHqvdCrhhc",165,0.993976,29,166,1,165,1,1,0,1,1,79,78,87,87,21
"1900",99,"[29]ykJHglqIrHcbdKocJvcGHqvdCrhhc",167,0.994048,29,168,1,167,1,1,0,1,1,85,84,83,83,21
"1901",0,"[32]wJHggqIHBidrKocJvcGHqFdCwfHJgwmx",179,0.994444,32,180,1,179,1,1,0,1,1,98,97,82,82,22
"1902",1,"[32]wJHggqIHBidrKocJvcGHqFdCwfHJgwmx",174,0.994286,32,175,1,174,1,1,0,1,1,83,82,92,92,22
"1903",2,"[32]wJHggqIHBidrKocJvcGHqFdCwfHJgwmx",173,0.994253,32,174,1,173,1,1,0,1,1,79,78,95,95,22
"1904",3,"[32]wJHggqIHBidrKocJvcGHqFdCwfHJgwmx",176,0.99435,32,177,1,176,1,1,0,1,1,88,87,89,89,22
"1905",4,"[32]wJHggqIHBidrKocJvcGHqFdCwfHJgwmx",176,0.99435,32,177,1,176,1,1,0,1,1,91,90,86,86,22
"1906",5,"[32]wJHggqIHBidrKocJvcGHqFdCwfHJgwmx",180,0.994475,32,181,1,180,1,1,0,1,1,102,101,79,79,22
"1907",6,"[32]wJHggqIHBidrKocJvcGHqFdCwfHJgwmx",178,0.994413,32,179,1,178,1,1,0,1,1,95,94,84,84,22
"1908",7,"[32]wJHggqIHBidrKocJvcGHqFdCwfHJgwmx",181,0.994505,32,182,1,181,1,1,0,1,1,104,103,78,78,22
"1909",8,"[32]wJHggqIHBidrKocJvcGHqFdCwfHJgwmx",177,0.994382,32,178,1,177,1,1,0,1,1,91,90,87,87,22
"1910",9,"[32]wJHggqIHBidrKocJvcGHqFdCwfHJgwmx",178,0.994413,32,179,1,178,1,1,0,1,1,94,93,85,85,22
"1911",10,"[32]wJHggqIHBidrKocJvcGHqFdCwfHJgwmx",178,0.994413,32,179,1,178,1,1,0,1,1,97,96,82,82,22
"1912",11,"[32]wJHggqIHBidrKocJvcGHqFdCwfHJgwmx",179,0.994444,32,180,1,179,1,1,0,1,1,99,98,81,81,22
"1913",12,"[32]wJHggqIHBidrKocJvcGHqFdCwfHJgwmx",179,0.994444,32,180,1,179,1,1,0,1,1,98,97,82,82,22
"1914",13,"[32]wJHggqIHBidrKocJvcGHqFdCwfHJgwmx",173,0.994253,32,174,1,173,1,1,0,1,1,80,79,94,94,22
"1915",14,"[32]wJHggqIHBidrKocJvcGHqFdCwfHJgwmx",179,0.994444,32,180,1,179,1,1,0,1,1,100,99,80,80,22
"1916",15,"[32]wJHggqIHBidrKocJvcGHqFdCwfHJgwmx",175,0.994318,32,176,1,175,1,1,0,1,1,84,83,92,92,22
"1917",16,"[32]wJHggqIHBidrKocJvcGHqFdCwfHJgwmx",178,0.994413,32,179,1,178,1,1,0,1,1,95,94,84,84,22
"1918",17,"[32]wJHggqIHBidrKocJvcGHqFdCwfHJgwmx",180,0.994475,32,181,1,180,1,1,0,1,1,103,102,78,78,22
"1919",18,"[32]wJHggqIHBidrKocJvcGHqFdCwfHJgwmx",177,0.994382,32,178,1,177,1,1,0,1,1,92,91,86,86,22
"1920",19,"[32]wJHggqIHBidrKocJvcGHqFdCwfHJgwmx",179,0.994444,32,180,1,179,1,1,0,1,1,99,98,81,81,22
"1921",20,"[32]wJHggqIHBidrKocJvcGHqFdCwfHJgwmx",180,0.994475,32,181,1,180,1,1,0,1,1,99,98,82,82,22
"1922",21,"[32]wJHggqIHBidrKocJvcGHqFdCwfHJgwmx",175,0.994318,32,176,1,175,1,1,0,1,1,85,84,91,91,22
"1923",22,"[32]wJHggqIHBidrKocJvcGHqFdCwfHJgwmx",180,0.994475,32,181,1,180,1,1,0,1,1,102,101,79,79,22
"1924",23,"[32]wJHggqIHBidrKocJvcGHqFdCwfHJgwmx",173,0.994253,32,174,1,173,1,1,0,1,1,81,80,93,93,22
"1925",24,"[32]wJHggqIHBidrKocJvcGHqFdCwfHJgwmx",172,0.99422,32,173,1,172,1,1,0,1,1,76,75,97,97,22
"1926",25,"[32]wJHggqIHBidrKocJvcGHqFdCwfHJgwmx",174,0.994286,32,175,1,174,1,1,0,1,1,83,82,92,92,22
"1927",26,"[32]wJHggqIHBidrKocJvcGHqFdCwfHJgwmx",179,0.994444,32,180,1,179,1,1,0,1,1,99,98,81,81,22
"1928",27,"[32]wJHggqIHBidrKocJvcGHqFdCwfHJgwmx",175,0.994318,32,176,1,175,1,1,0,1,1,84,83,92,92,22
"1929",28,"[32]wJHggqIHBidrKocJvcGHqFdCwfHJgwmx",178,0.994413,32,179,1,178,1,1,0,1,1,95,94,84,84,22
"1930",29,"[32]wJHggqIHBidrKocJvcGHqFdCwfHJgwmx",172,0.99422,32,173,1,172,1,1,0,1,1,75,74,98,98,22
"1931",30,"[32]wJHggqIHBidrKocJvcGHqFdCwfHJgwmx",178,0.994413,32,179,1,178,1,1,0,1,1,96,95,83,83,22
"1932",31,"[32]wJHggqIHBidrKocJvcGHqFdCwfHJgwmx",178,0.994413,32,179,1,178,1,1,0,1,1,95,94,84,84,22
"1933",32,"[32]wJHggqIHBidrKocJvcGHqFdCwfHJgwmx",177,0.994382,32,178,1,177,1,1,0,1,1,91,90,87,87,22
"1934",33,"[32]wJHggqIHBidrKocJvcGHqFdCwfHJgwmx",175,0.994318,32,176,1,175,1,1,0,1,1,86,85,90,90,22
"1935",34,"[32]wJHggqIHBidrKocJvcGHqFdCwfHJgwmx",177,0.994382,32,178,1,177,1,1,0,1,1,94,93,84,84,22
"1936",35,"[32]wJHggqIHBidrKocJvcGHqFdCwfHJgwmx",175,0.994318,32,176,1,175,1,1,0,1,1,85,84,91,91,22
"1937",36,"[32]wJHggqIHBidrKocJvcGHqFdCwfHJgwmx",174,0.994286,32,175,1,174,1,1,0,1,1,81,80,94,94,22
"1938",37,"[32]wJHggqIHBidrKocJvcGHqFdCwfHJgwmx",178,0.994413,32,179,1,178,1,1,0,1,1,94,93,85,85,22
"1939",38,"[32]wJHggqIHBidrKocJvcGHqFdCwfHJgwmx",179,0.994444,32,180,1,179,1,1,0,1,1,99,98,81,81,22
"1940",39,"[32]wJHggqIHBidrKocJvcGHqFdCwfHJgwmx",175,0.994318,32,176,1,175,1,1,0,1,1,87,86,89,89,22
"1941",40,"[32]wJHggqIHBidrKocJvcGHqFdCwfHJgwmx",177,0.994382,32,178,1,177,1,1,0,1,1,94,93,84,84,22
"1942",41,"[32]wJHggqIHBidrKocJvcGHqFdCwfHJgwmx",177,0.994382,32,178,1,177,1,1,0,1,1,92,91,86,86,22
"1943",42,"[32]wJHggqIHBidrKocJvcGHqFdCwfHJgwmx",173,0.994253,32,174,1,173,1,1,0,1,1,78,77,96,96,22
"1944",43,"[32]wJHggqIHBidrKocJvcGHqFdCwfHJgwmx",171,0.994186,32,172,1,171,1,1,0,1,1,74,73,98,98,22
"1945",44,"[32]wJHggqIHBidrKocJvcGHqFdCwfHJgwmx",175,0.994318,32,176,1,175,1,1,0,1,1,86,85,90,90,22
"1946",45,"[32]wJHggqIHBidrKocJvcGHqFdCwfHJgwmx",176,0.99435,32,177,1,176,1,1,0,1,1,89,88,88,88,22
"1947",46,"[32]wJHggqIHBidrKocJvcGHqFdCwfHJgwmx",174,0.994286,32,175,1,174,1,1,0,1,1,84,83,91,91,22
"1948",47,"[32]wJHggqIHBidrKocJvcGHqFdCwfHJgwmx",176,0.99435,32,177,1,176,1,1,0,1,1,89,88,88,88,22
"1949",48,"[32]wJHggqIHBidrKocJvcGHqFdCwfHJgwmx",177,0.994382,32,178,1,177,1,1,0,1,1,92,91,86,86,22
"1950",49,"[32]wJHggqIHBidrKocJvcGHqFdCwfHJgwmx",173,0.994253,32,174,1,173,1,1,0,1,1,78,77,96,96,22
"1951",50,"[32]wJHggqIHBidrKocJvcGHqFdCwfHJgwmx",177,0.994382,32,178,1,177,1,1,0,1,1,91,90,87,87,22
"1952",51,"[32]wJHggqIHBidrKocJvcGHqFdCwfHJgwmx",174,0.994286,32,175,1,174,1,1,0,1,1,83,82,92,92,22
"1953",52,"[32]wJHggqIHBidrKocJvcGHqFdCwfHJgwmx",179,0.994444,32,180,1,179,1,1,0,1,1,99,98,81,81,22
"1954",53,"[32]wJHggqIHBidrKocJvcGHqFdCwfHJgwmx",177,0.994382,32,178,1,177,1,1,0,1,1,91,90,87,87,22
"1955",54,"[32]wJHggqIHBidrKocJvcGHqFdCwfHJgwmx",176,0.99435,32,177,1,176,1,1,0,1,1,90,89,87,87,22
"1956",55,"[32]wJHggqIHBidrKocJvcGHqFdCwfHJgwmx",178,0.994413,32,179,1,178,1,1,0,1,1,96,95,83,83,22
"1957",56,"[32]wJHggqIHBidrKocJvcGHqFdCwfHJgwmx",172,0.99422,32,173,1,172,1,1,0,1,1,77,76,96,96,22
"1958",57,"[32]wJHggqIHBidrKocJvcGHqFdCwfHJgwmx",177,0.994382,32,178,1,177,1,1,0,1,1,92,91,86,86,22
"1959",58,"[32]wJHggqIHBidrKocJvcGHqFdCwfHJgwmx",176,0.99435,32,177,1,176,1,1,0,1,1,87,86,90,90,22
"1960",59,"[32]wJHggqIHBidrKocJvcGHqFdCwfHJgwmx",177,0.994382,32,178,1,177,1,1,0,1,1,93,92,85,85,22
"1961",60,"[32]wJHggqIHBidrKocJvcGHqFdCwfHJgwmx",178,0.994413,32,179,1,178,1,1,0,1,1,95,94,84,84,22
"1962",61,"[32]wJHggqIHBidrKocJvcGHqFdCwfHJgwmx",178,0.994413,32,179,1,178,1,1,0,1,1,96,95,83,83,22
"1963",62,"[32]wJHggqIHBidrKocJvcGHqFdCwfHJgwmx",177,0.994382,32,178,1,177,1,1,0,1,1,92,91,86,86,22
"1964",63,"[32]wJHggqIHBidrKocJvcGHqFdCwfHJgwmx",178,0.994413,32,179,1,178,1,1,0,1,1,96,95,83,83,22
"1965",64,"[32]wJHggqIHBidrKocJvcGHqFdCwfHJgwmx",177,0.994382,32,178,1,177,1,1,0,1,1,94,93,84,84,22
"1966",65,"[32]wJHggqIHBidrKocJvcGHqFdCwfHJgwmx",177,0.994382,32,178,1,177,1,1,0,1,1,93,92,85,85,22
"1967",66,"[32]wJHggqIHBidrKocJvcGHqFdCwfHJgwmx",178,0.994413,32,179,1,178,1,1,0,1,1,95,94,84,84,22
"1968",67,"[32]wJHggqIHBidrKocJvcGHqFdCwfHJgwmx",176,0.99435,32,177,1,176,1,1,0,1,1,89,88,88,88,22
"1969",68,"[32]wJHggqIHBidrKocJvcGHqFdCwfHJgwmx",174,0.994286,32,175,1,174,1,1,0,1,1,83,82,92,92,22
"1970",69,"[32]wJHggqIHBidrKocJvcGHqFdCwfHJgwmx",178,0.994413,32,179,1,178,1,1,0,1,1,94,93,85,85,22
"1971",70,"[32]wJHggqIHBidrKocJvcGHqFdCwfHJgwmx",174,0.994286,32,175,1,174,1,1,0,1,1,84,83,91,91,22
"1972",71,"[32]wJHggqIHBidrKocJvcGHqFdCwfHJgwmx",176,0.99435,32,177,1,176,1,1,0,1,1,90,89,87,87,22
"1973",72,"[32]wJHggqIHBidrKocJvcGHqFdCwfHJgwmx",175,0.994318,32,176,1,175,1,1,0,1,1,87,86,89,89,22
"1974",73,"[32]wJHggqIHBidrKocJvcGHqFdCwfHJgwmx",175,0.994318,32,176,1,175,1,1,0,1,1,86,85,90,90,22
"1975",74,"[32]wJHggqIHBidrKocJvcGHqFdCwfHJgwmx",177,0.994382,32,178,1,177,1,1,0,1,1,94,93,84,84,22
"1976",75,"[32]wJHggqIHBidrKocJvcGHqFdCwfHJgwmx",178,0.994413,32,179,1,178,1,1,0,1,1,93,92,86,86,22
"1977",76,"[32]wJHggqIHBidrKocJvcGHqFdCwfHJgwmx",174,0.994286,32,175,1,174,1,1,0,1,1,80,79,95,95,22
"1978",77,"[32]wJHggqIHBidrKocJvcGHqFdCwfHJgwmx",173,0.994253,32,174,1,173,1,1,0,1,1,78,77,96,96,22
"1979",78,"[32]wJHggqIHBidrKocJvcGHqFdCwfHJgwmx",176,0.99435,32,177,1,176,1,1,0,1,1,88,87,89,89,22
"1980",79,"[32]wJHggqIHBidrKocJvcGHqFdCwfHJgwmx",176,0.99435,32,177,1,176,1,1,0,1,1,85,84,92,92,22
"1981",80,"[32]wJHggqIHBidrKocJvcGHqFdCwfHJgwmx",174,0.994286,32,175,1,174,1,1,0,1,1,82,81,93,93,22
"1982",81,"[32]wJHggqIHBidrKocJvcGHqFdCwfHJgwmx",178,0.994413,32,179,1,178,1,1,0,1,1,95,94,84,84,22
"1983",82,"[32]wJHggqIHBidrKocJvcGHqFdCwfHJgwmx",177,0.994382,32,178,1,177,1,1,0,1,1,94,93,84,84,22
"1984",83,"[32]wJHggqIHBidrKocJvcGHqFdCwfHJgwmx",176,0.99435,32,177,1,176,1,1,0,1,1,91,90,86,86,22
"1985",84,"[32]wJHggqIHBidrKocJvcGHqFdCwfHJgwmx",175,0.994318,32,176,1,175,1,1,0,1,1,86,85,90,90,22
"1986",85,"[32]wJHggqIHBidrKocJvcGHqFdCwfHJgwmx",179,0.994444,32,180,1,179,1,1,0,1,1,99,98,81,81,22
"1987",86,"[32]wJHggqIHBidrKocJvcGHqFdCwfHJgwmx",176,0.99435,32,177,1,176,1,1,0,1,1,89,88,88,88,22
"1988",87,"[32]wJHggqIHBidrKocJvcGHqFdCwfHJgwmx",178,0.994413,32,179,1,178,1,1,0,1,1,94,93,85,85,22
"1989",88,"[32]wJHggqIHBidrKocJvcGHqFdCwfHJgwmx",177,0.994382,32,178,1,177,1,1,0,1,1,91,90,87,87,22
"1990",89,"[32]wJHggqIHBidrKocJvcGHqFdCwfHJgwmx",173,0.994253,32,174,1,173,1,1,0,1,1,79,78,95,95,22
"1991",90,"[32]wJHggqIHBidrKocJvcGHqFdCwfHJgwmx",174,0.994286,32,175,1,174,1,1,0,1,1,83,82,92,92,22
"1992",91,"[32]wJHggqIHBidrKocJvcGHqFdCwfHJgwmx",177,0.994382,32,178,1,177,1,1,0,1,1,92,91,86,86,22
"1993",92,"[32]wJHggqIHBidrKocJvcGHqFdCwfHJgwmx",176,0.99435,32,177,1,176,1,1,0,1,1,86,85,91,91,22
"1994",93,"[32]wJHggqIHBidrKocJvcGHqFdCwfHJgwmx",173,0.994253,32,174,1,173,1,1,0,1,1,79,78,95,95,22
"1995",94,"[32]wJHggqIHBidrKocJvcGHqFdCwfHJgwmx",175,0.994318,32,176,1,175,1,1,0,1,1,87,86,89,89,22
"1996",95,"[32]wJHggqIHBidrKocJvcGHqFdCwfHJgwmx",173,0.994253,32,174,1,173,1,1,0,1,1,78,77,96,96,22
"1997",96,"[32]wJHggqIHBidrKocJvcGHqFdCwfHJgwmx",175,0.994318,32,176,1,175,1,1,0,1,1,85,84,91,91,22
"1998",97,"[32]wJHggqIHBidrKocJvcGHqFdCwfHJgwmx",176,0.99435,32,177,1,176,1,1,0,1,1,87,86,90,90,22
"1999",98,"[32]wJHggqIHBidrKocJvcGHqFdCwfHJgwmx",172,0.99422,32,173,1,172,1,1,0,1,1,76,75,97,97,22
"2000",99,"[32]wJHggqIHBidrKocJvcGHqFdCwfHJgwmx",180,0.994475,32,181,1,180,1,1,0,1,1,101,100,80,80,22
"2001",0,"[29]jhJHglqIFHcdKocJvcGHqxdCyJscc",162,0.993865,29,163,1,162,1,1,0,1,1,71,70,92,92,23
"2002",1,"[29]jhJHglqIFHcdKocJvcGHqxdCyJscc",171,0.994186,29,172,1,171,1,1,0,1,1,97,96,75,75,23
"2003",2,"[29]jhJHglqIFHcdKocJvcGHqxdCyJscc",161,0.993827,29,162,1,161,1,1,0,1,1,69,68,93,93,23
"2004",3,"[29]jhJHglqIFHcdKocJvcGHqxdCyJscc",166,0.994012,29,167,1,166,1,1,0,1,1,82,81,85,85,23
"2005",4,"[29]jhJHglqIFHcdKocJvcGHqxdCyJscc",170,0.994152,29,171,1,170,1,1,0,1,1,92,91,79,79,23
"2006",5,"[29]jhJHglqIFHcdKocJvcGHqxdCyJscc",163,0.993902,29,164,1,163,1,1,0,1,1,73,72,91,91,23
"2007",6,"[29]jhJHglqIFHcdKocJvcGHqxdCyJscc",164,0.993939,29,165,1,164,1,1,0,1,1,77,76,88,88,23
"2008",7,"[29]jhJHglqIFHcdKocJvcGHqxdCyJscc",167,0.994048,29,168,1,167,1,1,0,1,1,83,82,85,85,23
"2009",8,"[29]jhJHglqIFHcdKocJvcGHqxdCyJscc",164,0.993939,29,165,1,164,1,1,0,1,1,76,75,89,89,23
"2010",9,"[29]jhJHglqIFHcdKocJvcGHqxdCyJscc",169,0.994118,29,170,1,169,1,1,0,1,1,91,90,79,79,23
"2011",10,"[29]jhJHglqIFHcdKocJvcGHqxdCyJscc",167,0.994048,29,168,1,167,1,1,0,1,1,84,83,84,84,23
"2012",11,"[29]jhJHglqIFHcdKocJvcGHqxdCyJscc",168,0.994083,29,169,1,168,1,1,0,1,1,88,87,81,81,23
"2013",12,"[29]jhJHglqIFHcdKocJvcGHqxdCyJscc",163,0.993902,29,164,1,163,1,1,0,1,1,73,72,91,91,23
"2014",13,"[29]jhJHglqIFHcdKocJvcGHqxdCyJscc",167,0.994048,29,168,1,167,1,1,0,1,1,85,84,83,83,23
"2015",14,"[29]jhJHglqIFHcdKocJvcGHqxdCyJscc",168,0.994083,29,169,1,168,1,1,0,1,1,89,88,80,80,23
"2016",15,"[29]jhJHglqIFHcdKocJvcGHqxdCyJscc",166,0.994012,29,167,1,166,1,1,0,1,1,82,81,85,85,23
"2017",16,"[29]jhJHglqIFHcdKocJvcGHqxdCyJscc",167,0.994048,29,168,1,167,1,1,0,1,1,86,85,82,82,23
"2018",17,"[29]jhJHglqIFHcdKocJvcGHqxdCyJscc",169,0.994118,29,170,1,169,1,1,0,1,1,91,90,79,79,23
"2019",18,"[29]jhJHglqIFHcdKocJvcGHqxdCyJscc",168,0.994083,29,169,1,168,1,1,0,1,1,89,88,80,80,23
"2020",19,"[29]jhJHglqIFHcdKocJvcGHqxdCyJscc",167,0.994048,29,168,1,167,1,1,0,1,1,84,83,84,84,23
"2021",20,"[29]jhJHglqIFHcdKocJvcGHqxdCyJscc",162,0.993865,29,163,1,162,1,1,0,1,1,72,71,91,91,23
"2022",21,"[29]jhJHglqIFHcdKocJvcGHqxdCyJscc",164,0.993939,29,165,1,164,1,1,0,1,1,78,77,87,87,23
"2023",22,"[29]jhJHglqIFHcdKocJvcGHqxdCyJscc",174,0.994286,29,175,1,174,1,1,0,1,1,105,104,70,70,23
"2024",23,"[29]jhJHglqIFHcdKocJvcGHqxdCyJscc",162,0.993865,29,163,1,162,1,1,0,1,1,71,70,92,92,23
"2025",24,"[29]jhJHglqIFHcdKocJvcGHqxdCyJscc",172,0.99422,29,173,1,172,1,1,0,1,1,99,98,74,74,23
"2026",25,"[29]jhJHglqIFHcdKocJvcGHqxdCyJscc",169,0.994118,29,170,1,169,1,1,0,1,1,91,90,79,79,23
"2027",26,"[29]jhJHglqIFHcdKocJvcGHqxdCyJscc",171,0.994186,29,172,1,171,1,1,0,1,1,97,96,75,75,23
"2028",27,"[29]jhJHglqIFHcdKocJvcGHqxdCyJscc",167,0.994048,29,168,1,167,1,1,0,1,1,86,85,82,82,23
"2029",28,"[29]jhJHglqIFHcdKocJvcGHqxdCyJscc",167,0.994048,29,168,1,167,1,1,0,1,1,85,84,83,83,23
"2030",29,"[29]jhJHglqIFHcdKocJvcGHqxdCyJscc",164,0.993939,29,165,1,164,1,1,0,1,1,77,76,88,88,23
"2031",30,"[29]jhJHglqIFHcdKocJvcGHqxdCyJscc",168,0.994083,29,169,1,168,1,1,0,1,1,88,87,81,81,23
"2032",31,"[29]jhJHglqIFHcdKocJvcGHqxdCyJscc",161,0.993827,29,162,1,161,1,1,0,1,1,70,69,92,92,23
"2033",32,"[29]jhJHglqIFHcdKocJvcGHqxdCyJscc",167,0.994048,29,168,1,167,1,1,0,1,1,84,83,84,84,23
"2034",33,"[29]jhJHglqIFHcdKocJvcGHqxdCyJscc",170,0.994152,29,171,1,170,1,1,0,1,1,93,92,78,78,23
"2035",34,"[29]jhJHglqIFHcdKocJvcGHqxdCyJscc",167,0.994048,29,168,1,167,1,1,0,1,1,86,85,82,82,23
"2036",35,"[29]jhJHglqIFHcdKocJvcGHqxdCyJscc",165,0.993976,29,166,1,165,1,1,0,1,1,78,77,88,88,23
"2037",36,"[29]jhJHglqIFHcdKocJvcGHqxdCyJscc",165,0.993976,29,166,1,165,1,1,0,1,1,80,79,86,86,23
"2038",37,"[29]jhJHglqIFHcdKocJvcGHqxdCyJscc",164,0.993939,29,165,1,164,1,1,0,1,1,76,75,89,89,23
"2039",38,"[29]jhJHglqIFHcdKocJvcGHqxdCyJscc",164,0.993939,29,165,1,164,1,1,0,1,1,78,77,87,87,23
"2040",39,"[29]jhJHglqIFHcdKocJvcGHqxdCyJscc",168,0.994083,29,169,1,168,1,1,0,1,1,88,87,81,81,23
"2041",40,"[29]jhJHglqIFHcdKocJvcGHqxdCyJscc",173,0.994253,29,174,1,173,1,1,0,1,1,102,101,72,72,23
"2042",41,"[29]jhJHglqIFHcdKocJvcGHqxdCyJscc",169,0.994118,29,170,1,169,1,1,0,1,1,91,90,79,79,23
"2043",42,"[29]jhJHglqIFHcdKocJvcGHqxdCyJscc",166,0.994012,29,167,1,166,1,1,0,1,1,82,81,85,85,23
"2044",43,"[29]jhJHglqIFHcdKocJvcGHqxdCyJscc",170,0.994152,29,171,1,170,1,1,0,1,1,94,93,77,77,23
"2045",44,"[29]jhJHglqIFHcdKocJvcGHqxdCyJscc",166,0.994012,29,167,1,166,1,1,0,1,1,83,82,84,84,23
"2046",45,"[29]jhJHglqIFHcdKocJvcGHqxdCyJscc",163,0.993902,29,164,1,163,1,1,0,1,1,75,74,89,89,23
"2047",46,"[29]jhJHglqIFHcdKocJvcGHqxdCyJscc",167,0.994048,29,168,1,167,1,1,0,1,1,84,83,84,84,23
"2048",47,"[29]jhJHglqIFHcdKocJvcGHqxdCyJscc",164,0.993939,29,165,1,164,1,1,0,1,1,78,77,87,87,23
"2049",48,"[29]jhJHglqIFHcdKocJvcGHqxdCyJscc",163,0.993902,29,164,1,163,1,1,0,1,1,74,73,90,90,23
"2050",49,"[29]jhJHglqIFHcdKocJvcGHqxdCyJscc",165,0.993976,29,166,1,165,1,1,0,1,1,80,79,86,86,23
"2051",50,"[29]jhJHglqIFHcdKocJvcGHqxdCyJscc",167,0.994048,29,168,1,167,1,1,0,1,1,86,85,82,82,23
"2052",51,"[29]jhJHglqIFHcdKocJvcGHqxdCyJscc",161,0.993827,29,162,1,161,1,1,0,1,1,70,69,92,92,23
"2053",52,"[29]jhJHglqIFHcdKocJvcGHqxdCyJscc",165,0.993976,29,166,1,165,1,1,0,1,1,80,79,86,86,23
"2054",53,"[29]jhJHglqIFHcdKocJvcGHqxdCyJscc",168,0.994083,29,169,1,168,1,1,0,1,1,89,88,80,80,23
"2055",54,"[29]jhJHglqIFHcdKocJvcGHqxdCyJscc",165,0.993976,29,166,1,165,1,1,0,1,1,80,79,86,86,23
"2056",55,"[29]jhJHglqIFHcdKocJvcGHqxdCyJscc",166,0.994012,29,167,1,166,1,1,0,1,1,83,82,84,84,23
"2057",56,"[29]jhJHglqIFHcdKocJvcGHqxdCyJscc",172,0.99422,29,173,1,172,1,1,0,1,1,99,98,74,74,23
"2058",57,"[29]jhJHglqIFHcdKocJvcGHqxdCyJscc",168,0.994083,29,169,1,168,1,1,0,1,1,88,87,81,81,23
"2059",58,"[29]jhJHglqIFHcdKocJvcGHqxdCyJscc",169,0.994118,29,170,1,169,1,1,0,1,1,91,90,79,79,23
"2060",59,"[29]jhJHglqIFHcdKocJvcGHqxdCyJscc",167,0.994048,29,168,1,167,1,1,0,1,1,86,85,82,82,23
"2061",60,"[29]jhJHglqIFHcdKocJvcGHqxdCyJscc",165,0.993976,29,166,1,165,1,1,0,1,1,79,78,87,87,23
"2062",61,"[29]jhJHglqIFHcdKocJvcGHqxdCyJscc",166,0.994012,29,167,1,166,1,1,0,1,1,83,82,84,84,23
"2063",62,"[29]jhJHglqIFHcdKocJvcGHqxdCyJscc",164,0.993939,29,165,1,164,1,1,0,1,1,77,76,88,88,23
"2064",63,"[29]jhJHglqIFHcdKocJvcGHqxdCyJscc",168,0.994083,29,169,1,168,1,1,0,1,1,89,88,80,80,23
"2065",64,"[29]jhJHglqIFHcdKocJvcGHqxdCyJscc",168,0.994083,29,169,1,168,1,1,0,1,1,89,88,80,80,23
"2066",65,"[29]jhJHglqIFHcdKocJvcGHqxdCyJscc",166,0.994012,29,167,1,166,1,1,0,1,1,82,81,85,85,23
"2067",66,"[29]jhJHglqIFHcdKocJvcGHqxdCyJscc",169,0.994118,29,170,1,169,1,1,0,1,1,90,89,80,80,23
"2068",67,"[29]jhJHglqIFHcdKocJvcGHqxdCyJscc",171,0.994186,29,172,1,171,1,1,0,1,1,97,96,75,75,23
"2069",68,"[29]jhJHglqIFHcdKocJvcGHqxdCyJscc",170,0.994152,29,171,1,170,1,1,0,1,1,93,92,78,78,23
"2070",69,"[29]jhJHglqIFHcdKocJvcGHqxdCyJscc",168,0.994083,29,169,1,168,1,1,0,1,1,88,87,81,81,23
"2071",70,"[29]jhJHglqIFHcdKocJvcGHqxdCyJscc",168,0.994083,29,169,1,168,1,1,0,1,1,89,88,80,80,23
"2072",71,"[29]jhJHglqIFHcdKocJvcGHqxdCyJscc",164,0.993939,29,165,1,164,1,1,0,1,1,77,76,88,88,23
"2073",72,"[29]jhJHglqIFHcdKocJvcGHqxdCyJscc",165,0.993976,29,166,1,165,1,1,0,1,1,80,79,86,86,23
"2074",73,"[29]jhJHglqIFHcdKocJvcGHqxdCyJscc",167,0.994048,29,168,1,167,1,1,0,1,1,85,84,83,83,23
"2075",74,"[29]jhJHglqIFHcdKocJvcGHqxdCyJscc",164,0.993939,29,165,1,164,1,1,0,1,1,76,75,89,89,23
"2076",75,"[29]jhJHglqIFHcdKocJvcGHqxdCyJscc",168,0.994083,29,169,1,168,1,1,0,1,1,87,86,82,82,23
"2077",76,"[29]jhJHglqIFHcdKocJvcGHqxdCyJscc",168,0.994083,29,169,1,168,1,1,0,1,1,89,88,80,80,23
"2078",77,"[29]jhJHglqIFHcdKocJvcGHqxdCyJscc",168,0.994083,29,169,1,168,1,1,0,1,1,88,87,81,81,23
"2079",78,"[29]jhJHglqIFHcdKocJvcGHqxdCyJscc",166,0.994012,29,167,1,166,1,1,0,1,1,83,82,84,84,23
"2080",79,"[29]jhJHglqIFHcdKocJvcGHqxdCyJscc",173,0.994253,29,174,1,173,1,1,0,1,1,102,101,72,72,23
"2081",80,"[29]jhJHglqIFHcdKocJvcGHqxdCyJscc",168,0.994083,29,169,1,168,1,1,0,1,1,89,88,80,80,23
"2082",81,"[29]jhJHglqIFHcdKocJvcGHqxdCyJscc",161,0.993827,29,162,1,161,1,1,0,1,1,69,68,93,93,23
"2083",82,"[29]jhJHglqIFHcdKocJvcGHqxdCyJscc",169,0.994118,29,170,1,169,1,1,0,1,1,90,89,80,80,23
"2084",83,"[29]jhJHglqIFHcdKocJvcGHqxdCyJscc",168,0.994083,29,169,1,168,1,1,0,1,1,89,88,80,80,23
"2085",84,"[29]jhJHglqIFHcdKocJvcGHqxdCyJscc",172,0.99422,29,173,1,172,1,1,0,1,1,99,98,74,74,23
"2086",85,"[29]jhJHglqIFHcdKocJvcGHqxdCyJscc",172,0.99422,29,173,1,172,1,1,0,1,1,98,97,75,75,23
"2087",86,"[29]jhJHglqIFHcdKocJvcGHqxdCyJscc",172,0.99422,29,173,1,172,1,1,0,1,1,98,97,75,75,23
"2088",87,"[29]jhJHglqIFHcdKocJvcGHqxdCyJscc",163,0.993902,29,164,1,163,1,1,0,1,1,74,73,90,90,23
"2089",88,"[29]jhJHglqIFHcdKocJvcGHqxdCyJscc",166,0.994012,29,167,1,166,1,1,0,1,1,83,82,84,84,23
"2090",89,"[29]jhJHglqIFHcdKocJvcGHqxdCyJscc",169,0.994118,29,170,1,169,1,1,0,1,1,91,90,79,79,23
"2091",90,"[29]jhJHglqIFHcdKocJvcGHqxdCyJscc",168,0.994083,29,169,1,168,1,1,0,1,1,88,87,81,81,23
"2092",91,"[29]jhJHglqIFHcdKocJvcGHqxdCyJscc",167,0.994048,29,168,1,167,1,1,0,1,1,86,85,82,82,23
"2093",92,"[29]jhJHglqIFHcdKocJvcGHqxdCyJscc",166,0.994012,29,167,1,166,1,1,0,1,1,81,80,86,86,23
"2094",93,"[29]jhJHglqIFHcdKocJvcGHqxdCyJscc",169,0.994118,29,170,1,169,1,1,0,1,1,90,89,80,80,23
"2095",94,"[29]jhJHglqIFHcdKocJvcGHqxdCyJscc",164,0.993939,29,165,1,164,1,1,0,1,1,76,75,89,89,23
"2096",95,"[29]jhJHglqIFHcdKocJvcGHqxdCyJscc",167,0.994048,29,168,1,167,1,1,0,1,1,84,83,84,84,23
"2097",96,"[29]jhJHglqIFHcdKocJvcGHqxdCyJscc",167,0.994048,29,168,1,167,1,1,0,1,1,85,84,83,83,23
"2098",97,"[29]jhJHglqIFHcdKocJvcGHqxdCyJscc",167,0.994048,29,168,1,167,1,1,0,1,1,86,85,82,82,23
"2099",98,"[29]jhJHglqIFHcdKocJvcGHqxdCyJscc",163,0.993902,29,164,1,163,1,1,0,1,1,74,73,90,90,23
"2100",99,"[29]jhJHglqIFHcdKocJvcGHqxdCyJscc",169,0.994118,29,170,1,169,1,1,0,1,1,91,90,79,79,23
"2101",0,"[28]bJHiqIHcgudKocJvcGHqxdCivfzd",168,0.994083,28,169,1,168,1,1,0,1,1,86,85,83,83,24
"2102",1,"[28]bJHiqIHcgudKocJvcGHqxdCivfzd",164,0.993939,28,165,1,164,1,1,0,1,1,76,75,89,89,24
"2103",2,"[28]bJHiqIHcgudKocJvcGHqxdCivfzd",164,0.993939,28,165,1,164,1,1,0,1,1,78,77,87,87,24
"2104",3,"[28]bJHiqIHcgudKocJvcGHqxdCivfzd",167,0.994048,28,168,1,167,1,1,0,1,1,86,85,82,82,24
"2105",4,"[28]bJHiqIHcgudKocJvcGHqxdCivfzd",167,0.994048,28,168,1,167,1,1,0,1,1,86,85,82,82,24
"2106",5,"[28]bJHiqIHcgudKocJvcGHqxdCivfzd",166,0.994012,28,167,1,166,1,1,0,1,1,79,78,88,88,24
"2107",6,"[28]bJHiqIHcgudKocJvcGHqxdCivfzd",170,0.994152,28,171,1,170,1,1,0,1,1,92,91,79,79,24
"2108",7,"[28]bJHiqIHcgudKocJvcGHqxdCivfzd",168,0.994083,28,169,1,168,1,1,0,1,1,86,85,83,83,24
"2109",8,"[28]bJHiqIHcgudKocJvcGHqxdCivfzd",163,0.993902,28,164,1,163,1,1,0,1,1,73,72,91,91,24
"2110",9,"[28]bJHiqIHcgudKocJvcGHqxdCivfzd",164,0.993939,28,165,1,164,1,1,0,1,1,76,75,89,89,24
"2111",10,"[28]bJHiqIHcgudKocJvcGHqxdCivfzd",168,0.994083,28,169,1,168,1,1,0,1,1,87,86,82,82,24
"2112",11,"[28]bJHiqIHcgudKocJvcGHqxdCivfzd",164,0.993939,28,165,1,164,1,1,0,1,1,78,77,87,87,24
"2113",12,"[28]bJHiqIHcgudKocJvcGHqxdCivfzd",160,0.993789,28,161,1,160,1,1,0,1,1,63,62,98,98,24
"2114",13,"[28]bJHiqIHcgudKocJvcGHqxdCivfzd",168,0.994083,28,169,1,168,1,1,0,1,1,88,87,81,81,24
"2115",14,"[28]bJHiqIHcgudKocJvcGHqxdCivfzd",163,0.993902,28,164,1,163,1,1,0,1,1,74,73,90,90,24
"2116",15,"[28]bJHiqIHcgudKocJvcGHqxdCivfzd",166,0.994012,28,167,1,166,1,1,0,1,1,80,79,87,87,24
"2117",16,"[28]bJHiqIHcgudKocJvcGHqxdCivfzd",174,0.994286,28,175,1,174,1,1,0,1,1,105,104,70,70,24
"2118",17,"[28]bJHiqIHcgudKocJvcGHqxdCivfzd",162,0.993865,28,163,1,162,1,1,0,1,1,72,71,91,91,24
"2119",18,"[28]bJHiqIHcgudKocJvcGHqxdCivfzd",169,0.994118,28,170,1,169,1,1,0,1,1,88,87,82,82,24
"2120",19,"[28]bJHiqIHcgudKocJvcGHqxdCivfzd",169,0.994118,28,170,1,169,1,1,0,1,1,91,90,79,79,24
"2121",20,"[28]bJHiqIHcgudKocJvcGHqxdCivfzd",170,0.994152,28,171,1,170,1,1,0,1,1,90,89,81,81,24
"2122",21,"[28]bJHiqIHcgudKocJvcGHqxdCivfzd",172,0.99422,28,173,1,172,1,1,0,1,1,98,97,75,75,24
"2123",22,"[28]bJHiqIHcgudKocJvcGHqxdCivfzd",166,0.994012,28,167,1,166,1,1,0,1,1,83,82,84,84,24
"2124",23,"[28]bJHiqIHcgudKocJvcGHqxdCivfzd",168,0.994083,28,169,1,168,1,1,0,1,1,86,85,83,83,24
"2125",24,"[28]bJHiqIHcgudKocJvcGHqxdCivfzd",167,0.994048,28,168,1,167,1,1,0,1,1,84,83,84,84,24
"2126",25,"[28]bJHiqIHcgudKocJvcGHqxdCivfzd",164,0.993939,28,165,1,164,1,1,0,1,1,78,77,87,87,24
"2127",26,"[28]bJHiqIHcgudKocJvcGHqxdCivfzd",159,0.99375,28,160,1,159,1,1,0,1,1,63,62,97,97,24
"2128",27,"[28]bJHiqIHcgudKocJvcGHqxdCivfzd",166,0.994012,28,167,1,166,1,1,0,1,1,82,81,85,85,24
"2129",28,"[28]bJHiqIHcgudKocJvcGHqxdCivfzd",164,0.993939,28,165,1,164,1,1,0,1,1,76,75,89,89,24
"2130",29,"[28]bJHiqIHcgudKocJvcGHqxdCivfzd",167,0.994048,28,168,1,167,1,1,0,1,1,84,83,84,84,24
"2131",30,"[28]bJHiqIHcgudKocJvcGHqxdCivfzd",169,0.994118,28,170,1,169,1,1,0,1,1,90,89,80,80,24
"2132",31,"[28]bJHiqIHcgudKocJvcGHqxdCivfzd",168,0.994083,28,169,1,168,1,1,0,1,1,87,86,82,82,24
"2133",32,"[28]bJHiqIHcgudKocJvcGHqxdCivfzd",168,0.994083,28,169,1,168,1,1,0,1,1,89,88,80,80,24
"2134",33,"[28]bJHiqIHcgudKocJvcGHqxdCivfzd",168,0.994083,28,169,1,168,1,1,0,1,1,89,88,80,80,24
"2135",34,"[28]bJHiqIHcgudKocJvcGHqxdCivfzd",168,0.994083,28,169,1,168,1,1,0,1,1,87,86,82,82,24
"2136",35,"[28]bJHiqIHcgudKocJvcGHqxdCivfzd",168,0.994083,28,169,1,168,1,1,0,1,1,87,86,82,82,24
"2137",36,"[28]bJHiqIHcgudKocJvcGHqxdCivfzd",174,0.994286,28,175,1,174,1,1,0,1,1,104,103,71,71,24
"2138",37,"[28]bJHiqIHcgudKocJvcGHqxdCivfzd",167,0.994048,28,168,1,167,1,1,0,1,1,85,84,83,83,24
"2139",38,"[28]bJHiqIHcgudKocJvcGHqxdCivfzd",164,0.993939,28,165,1,164,1,1,0,1,1,77,76,88,88,24
"2140",39,"[28]bJHiqIHcgudKocJvcGHqxdCivfzd",164,0.993939,28,165,1,164,1,1,0,1,1,76,75,89,89,24
"2141",40,"[28]bJHiqIHcgudKocJvcGHqxdCivfzd",165,0.993976,28,166,1,165,1,1,0,1,1,80,79,86,86,24
"2142",41,"[28]bJHiqIHcgudKocJvcGHqxdCivfzd",169,0.994118,28,170,1,169,1,1,0,1,1,91,90,79,79,24
"2143",42,"[28]bJHiqIHcgudKocJvcGHqxdCivfzd",163,0.993902,28,164,1,163,1,1,0,1,1,75,74,89,89,24
"2144",43,"[28]bJHiqIHcgudKocJvcGHqxdCivfzd",171,0.994186,28,172,1,171,1,1,0,1,1,95,94,77,77,24
"2145",44,"[28]bJHiqIHcgudKocJvcGHqxdCivfzd",169,0.994118,28,170,1,169,1,1,0,1,1,91,90,79,79,24
"2146",45,"[28]bJHiqIHcgudKocJvcGHqxdCivfzd",165,0.993976,28,166,1,165,1,1,0,1,1,79,78,87,87,24
"2147",46,"[28]bJHiqIHcgudKocJvcGHqxdCivfzd",164,0.993939,28,165,1,164,1,1,0,1,1,76,75,89,89,24
"2148",47,"[28]bJHiqIHcgudKocJvcGHqxdCivfzd",165,0.993976,28,166,1,165,1,1,0,1,1,78,77,88,88,24
"2149",48,"[28]bJHiqIHcgudKocJvcGHqxdCivfzd",168,0.994083,28,169,1,168,1,1,0,1,1,88,87,81,81,24
"2150",49,"[28]bJHiqIHcgudKocJvcGHqxdCivfzd",162,0.993865,28,163,1,162,1,1,0,1,1,70,69,93,93,24
"2151",50,"[28]bJHiqIHcgudKocJvcGHqxdCivfzd",166,0.994012,28,167,1,166,1,1,0,1,1,82,81,85,85,24
"2152",51,"[28]bJHiqIHcgudKocJvcGHqxdCivfzd",168,0.994083,28,169,1,168,1,1,0,1,1,86,85,83,83,24
"2153",52,"[28]bJHiqIHcgudKocJvcGHqxdCivfzd",166,0.994012,28,167,1,166,1,1,0,1,1,82,81,85,85,24
"2154",53,"[28]bJHiqIHcgudKocJvcGHqxdCivfzd",166,0.994012,28,167,1,166,1,1,0,1,1,81,80,86,86,24
"2155",54,"[28]bJHiqIHcgudKocJvcGHqxdCivfzd",168,0.994083,28,169,1,168,1,1,0,1,1,89,88,80,80,24
"2156",55,"[28]bJHiqIHcgudKocJvcGHqxdCivfzd",169,0.994118,28,170,1,169,1,1,0,1,1,90,89,80,80,24
"2157",56,"[28]bJHiqIHcgudKocJvcGHqxdCivfzd",163,0.993902,28,164,1,163,1,1,0,1,1,74,73,90,90,24
"2158",57,"[28]bJHiqIHcgudKocJvcGHqxdCivfzd",171,0.994186,28,172,1,171,1,1,0,1,1,96,95,76,76,24
"2159",58,"[28]bJHiqIHcgudKocJvcGHqxdCivfzd",169,0.994118,28,170,1,169,1,1,0,1,1,86,85,84,84,24
"2160",59,"[28]bJHiqIHcgudKocJvcGHqxdCivfzd",173,0.994253,28,174,1,173,1,1,0,1,1,99,98,75,75,24
"2161",60,"[28]bJHiqIHcgudKocJvcGHqxdCivfzd",170,0.994152,28,171,1,170,1,1,0,1,1,91,90,80,80,24
"2162",61,"[28]bJHiqIHcgudKocJvcGHqxdCivfzd",168,0.994083,28,169,1,168,1,1,0,1,1,88,87,81,81,24
"2163",62,"[28]bJHiqIHcgudKocJvcGHqxdCivfzd",165,0.993976,28,166,1,165,1,1,0,1,1,80,79,86,86,24
"2164",63,"[28]bJHiqIHcgudKocJvcGHqxdCivfzd",170,0.994152,28,171,1,170,1,1,0,1,1,92,91,79,79,24
"2165",64,"[28]bJHiqIHcgudKocJvcGHqxdCivfzd",169,0.994118,28,170,1,169,1,1,0,1,1,91,90,79,79,24
"2166",65,"[28]bJHiqIHcgudKocJvcGHqxdCivfzd",166,0.994012,28,167,1,166,1,1,0,1,1,80,79,87,87,24
"2167",66,"[28]bJHiqIHcgudKocJvcGHqxdCivfzd",164,0.993939,28,165,1,164,1,1,0,1,1,77,76,88,88,24
"2168",67,"[28]bJHiqIHcgudKocJvcGHqxdCivfzd",167,0.994048,28,168,1,167,1,1,0,1,1,83,82,85,85,24
"2169",68,"[28]bJHiqIHcgudKocJvcGHqxdCivfzd",167,0.994048,28,168,1,167,1,1,0,1,1,86,85,82,82,24
"2170",69,"[28]bJHiqIHcgudKocJvcGHqxdCivfzd",168,0.994083,28,169,1,168,1,1,0,1,1,86,85,83,83,24
"2171",70,"[28]bJHiqIHcgudKocJvcGHqxdCivfzd",168,0.994083,28,169,1,168,1,1,0,1,1,89,88,80,80,24
"2172",71,"[28]bJHiqIHcgudKocJvcGHqxdCivfzd",173,0.994253,28,174,1,173,1,1,0,1,1,102,101,72,72,24
"2173",72,"[28]bJHiqIHcgudKocJvcGHqxdCivfzd",168,0.994083,28,169,1,168,1,1,0,1,1,89,88,80,80,24
"2174",73,"[28]bJHiqIHcgudKocJvcGHqxdCivfzd",166,0.994012,28,167,1,166,1,1,0,1,1,82,81,85,85,24
"2175",74,"[28]bJHiqIHcgudKocJvcGHqxdCivfzd",167,0.994048,28,168,1,167,1,1,0,1,1,84,83,84,84,24
"2176",75,"[28]bJHiqIHcgudKocJvcGHqxdCivfzd",168,0.994083,28,169,1,168,1,1,0,1,1,88,87,81,81,24
"2177",76,"[28]bJHiqIHcgudKocJvcGHqxdCivfzd",166,0.994012,28,167,1,166,1,1,0,1,1,83,82,84,84,24
"2178",77,"[28]bJHiqIHcgudKocJvcGHqxdCivfzd",167,0.994048,28,168,1,167,1,1,0,1,1,84,83,84,84,24
"2179",78,"[28]bJHiqIHcgudKocJvcGHqxdCivfzd",169,0.994118,28,170,1,169,1,1,0,1,1,90,89,80,80,24
"2180",79,"[28]bJHiqIHcgudKocJvcGHqxdCivfzd",170,0.994152,28,171,1,170,1,1,0,1,1,90,89,81,81,24
"2181",80,"[28]bJHiqIHcgudKocJvcGHqxdCivfzd",170,0.994152,28,171,1,170,1,1,0,1,1,92,91,79,79,24
"2182",81,"[28]bJHiqIHcgudKocJvcGHqxdCivfzd",172,0.99422,28,173,1,172,1,1,0,1,1,99,98,74,74,24
"2183",82,"[28]bJHiqIHcgudKocJvcGHqxdCivfzd",166,0.994012,28,167,1,166,1,1,0,1,1,82,81,85,85,24
"2184",83,"[28]bJHiqIHcgudKocJvcGHqxdCivfzd",172,0.99422,28,173,1,172,1,1,0,1,1,100,99,73,73,24
"2185",84,"[28]bJHiqIHcgudKocJvcGHqxdCivfzd",164,0.993939,28,165,1,164,1,1,0,1,1,77,76,88,88,24
"2186",85,"[28]bJHiqIHcgudKocJvcGHqxdCivfzd",171,0.994186,28,172,1,171,1,1,0,1,1,96,95,76,76,24
"2187",86,"[28]bJHiqIHcgudKocJvcGHqxdCivfzd",166,0.994012,28,167,1,166,1,1,0,1,1,80,79,87,87,24
"2188",87,"[28]bJHiqIHcgudKocJvcGHqxdCivfzd",160,0.993789,28,161,1,160,1,1,0,1,1,67,66,94,94,24
"2189",88,"[28]bJHiqIHcgudKocJvcGHqxdCivfzd",165,0.993976,28,166,1,165,1,1,0,1,1,80,79,86,86,24
"2190",89,"[28]bJHiqIHcgudKocJvcGHqxdCivfzd",168,0.994083,28,169,1,168,1,1,0,1,1,88,87,81,81,24
"2191",90,"[28]bJHiqIHcgudKocJvcGHqxdCivfzd",165,0.993976,28,166,1,165,1,1,0,1,1,79,78,87,87,24
"2192",91,"[28]bJHiqIHcgudKocJvcGHqxdCivfzd",164,0.993939,28,165,1,164,1,1,0,1,1,77,76,88,88,24
"2193",92,"[28]bJHiqIHcgudKocJvcGHqxdCivfzd",168,0.994083,28,169,1,168,1,1,0,1,1,86,85,83,83,24
"2194",93,"[28]bJHiqIHcgudKocJvcGHqxdCivfzd",164,0.993939,28,165,1,164,1,1,0,1,1,78,77,87,87,24
"2195",94,"[28]bJHiqIHcgudKocJvcGHqxdCivfzd",172,0.99422,28,173,1,172,1,1,0,1,1,98,97,75,75,24
"2196",95,"[28]bJHiqIHcgudKocJvcGHqxdCivfzd",163,0.993902,28,164,1,163,1,1,0,1,1,73,72,91,91,24
"2197",96,"[28]bJHiqIHcgudKocJvcGHqxdCivfzd",167,0.994048,28,168,1,167,1,1,0,1,1,83,82,85,85,24
"2198",97,"[28]bJHiqIHcgudKocJvcGHqxdCivfzd",171,0.994186,28,172,1,171,1,1,0,1,1,97,96,75,75,24
"2199",98,"[28]bJHiqIHcgudKocJvcGHqxdCivfzd",170,0.994152,28,171,1,170,1,1,0,1,1,94,93,77,77,24
"2200",99,"[28]bJHiqIHcgudKocJvcGHqxdCivfzd",163,0.993902,28,164,1,163,1,1,0,1,1,74,73,90,90,24
"2201",0,"[28]lJHglqzIHcidKpcJvcGHqFdCsmDA",176,0.99435,28,177,1,176,1,1,0,1,1,89,88,88,88,25
"2202",1,"[28]lJHglqzIHcidKpcJvcGHqFdCsmDA",178,0.994413,28,179,1,178,1,1,0,1,1,96,95,83,83,25
"2203",2,"[28]lJHglqzIHcidKpcJvcGHqFdCsmDA",170,0.994152,28,171,1,170,1,1,0,1,1,71,70,100,100,25
"2204",3,"[28]lJHglqzIHcidKpcJvcGHqFdCsmDA",176,0.99435,28,177,1,176,1,1,0,1,1,87,86,90,90,25
"2205",4,"[28]lJHglqzIHcidKpcJvcGHqFdCsmDA",174,0.994286,28,175,1,174,1,1,0,1,1,82,81,93,93,25
"2206",5,"[28]lJHglqzIHcidKpcJvcGHqFdCsmDA",172,0.99422,28,173,1,172,1,1,0,1,1,76,75,97,97,25
"2207",6,"[28]lJHglqzIHcidKpcJvcGHqFdCsmDA",178,0.994413,28,179,1,178,1,1,0,1,1,95,94,84,84,25
"2208",7,"[28]lJHglqzIHcidKpcJvcGHqFdCsmDA",173,0.994253,28,174,1,173,1,1,0,1,1,79,78,95,95,25
"2209",8,"[28]lJHglqzIHcidKpcJvcGHqFdCsmDA",176,0.99435,28,177,1,176,1,1,0,1,1,87,86,90,90,25
"2210",9,"[28]lJHglqzIHcidKpcJvcGHqFdCsmDA",174,0.994286,28,175,1,174,1,1,0,1,1,81,80,94,94,25
"2211",10,"[28]lJHglqzIHcidKpcJvcGHqFdCsmDA",176,0.99435,28,177,1,176,1,1,0,1,1,90,89,87,87,25
"2212",11,"[28]lJHglqzIHcidKpcJvcGHqFdCsmDA",172,0.99422,28,173,1,172,1,1,0,1,1,77,76,96,96,25
"2213",12,"[28]lJHglqzIHcidKpcJvcGHqFdCsmDA",170,0.994152,28,171,1,170,1,1,0,1,1,70,69,101,101,25
"2214",13,"[28]lJHglqzIHcidKpcJvcGHqFdCsmDA",176,0.99435,28,177,1,176,1,1,0,1,1,89,88,88,88,25
"2215",14,"[28]lJHglqzIHcidKpcJvcGHqFdCsmDA",176,0.99435,28,177,1,176,1,1,0,1,1,91,90,86,86,25
"2216",15,"[28]lJHglqzIHcidKpcJvcGHqFdCsmDA",172,0.99422,28,173,1,172,1,1,0,1,1,76,75,97,97,25
"2217",16,"[28]lJHglqzIHcidKpcJvcGHqFdCsmDA",174,0.994286,28,175,1,174,1,1,0,1,1,84,83,91,91,25
"2218",17,"[28]lJHglqzIHcidKpcJvcGHqFdCsmDA",174,0.994286,28,175,1,174,1,1,0,1,1,84,83,91,91,25
"2219",18,"[28]lJHglqzIHcidKpcJvcGHqFdCsmDA",173,0.994253,28,174,1,173,1,1,0,1,1,79,78,95,95,25
"2220",19,"[28]lJHglqzIHcidKpcJvcGHqFdCsmDA",173,0.994253,28,174,1,173,1,1,0,1,1,80,79,94,94,25
"2221",20,"[28]lJHglqzIHcidKpcJvcGHqFdCsmDA",177,0.994382,28,178,1,177,1,1,0,1,1,92,91,86,86,25
"2222",21,"[28]lJHglqzIHcidKpcJvcGHqFdCsmDA",178,0.994413,28,179,1,178,1,1,0,1,1,96,95,83,83,25
"2223",22,"[28]lJHglqzIHcidKpcJvcGHqFdCsmDA",174,0.994286,28,175,1,174,1,1,0,1,1,82,81,93,93,25
"2224",23,"[28]lJHglqzIHcidKpcJvcGHqFdCsmDA",179,0.994444,28,180,1,179,1,1,0,1,1,99,98,81,81,25
"2225",24,"[28]lJHglqzIHcidKpcJvcGHqFdCsmDA",178,0.994413,28,179,1,178,1,1,0,1,1,97,96,82,82,25
"2226",25,"[28]lJHglqzIHcidKpcJvcGHqFdCsmDA",179,0.994444,28,180,1,179,1,1,0,1,1,98,97,82,82,25
"2227",26,"[28]lJHglqzIHcidKpcJvcGHqFdCsmDA",173,0.994253,28,174,1,173,1,1,0,1,1,79,78,95,95,25
"2228",27,"[28]lJHglqzIHcidKpcJvcGHqFdCsmDA",174,0.994286,28,175,1,174,1,1,0,1,1,84,83,91,91,25
"2229",28,"[28]lJHglqzIHcidKpcJvcGHqFdCsmDA",176,0.99435,28,177,1,176,1,1,0,1,1,91,90,86,86,25
"2230",29,"[28]lJHglqzIHcidKpcJvcGHqFdCsmDA",177,0.994382,28,178,1,177,1,1,0,1,1,93,92,85,85,25
"2231",30,"[28]lJHglqzIHcidKpcJvcGHqFdCsmDA",173,0.994253,28,174,1,173,1,1,0,1,1,81,80,93,93,25
"2232",31,"[28]lJHglqzIHcidKpcJvcGHqFdCsmDA",178,0.994413,28,179,1,178,1,1,0,1,1,97,96,82,82,25
"2233",32,"[28]lJHglqzIHcidKpcJvcGHqFdCsmDA",173,0.994253,28,174,1,173,1,1,0,1,1,81,80,93,93,25
"2234",33,"[28]lJHglqzIHcidKpcJvcGHqFdCsmDA",179,0.994444,28,180,1,179,1,1,0,1,1,99,98,81,81,25
"2235",34,"[28]lJHglqzIHcidKpcJvcGHqFdCsmDA",178,0.994413,28,179,1,178,1,1,0,1,1,94,93,85,85,25
"2236",35,"[28]lJHglqzIHcidKpcJvcGHqFdCsmDA",178,0.994413,28,179,1,178,1,1,0,1,1,97,96,82,82,25
"2237",36,"[28]lJHglqzIHcidKpcJvcGHqFdCsmDA",174,0.994286,28,175,1,174,1,1,0,1,1,82,81,93,93,25
"2238",37,"[28]lJHglqzIHcidKpcJvcGHqFdCsmDA",178,0.994413,28,179,1,178,1,1,0,1,1,94,93,85,85,25
"2239",38,"[28]lJHglqzIHcidKpcJvcGHqFdCsmDA",176,0.99435,28,177,1,176,1,1,0,1,1,88,87,89,89,25
"2240",39,"[28]lJHglqzIHcidKpcJvcGHqFdCsmDA",179,0.994444,28,180,1,179,1,1,0,1,1,99,98,81,81,25
"2241",40,"[28]lJHglqzIHcidKpcJvcGHqFdCsmDA",175,0.994318,28,176,1,175,1,1,0,1,1,87,86,89,89,25
"2242",41,"[28]lJHglqzIHcidKpcJvcGHqFdCsmDA",175,0.994318,28,176,1,175,1,1,0,1,1,87,86,89,89,25
"2243",42,"[28]lJHglqzIHcidKpcJvcGHqFdCsmDA",181,0.994505,28,182,1,181,1,1,0,1,1,106,105,76,76,25
"2244",43,"[28]lJHglqzIHcidKpcJvcGHqFdCsmDA",178,0.994413,28,179,1,178,1,1,0,1,1,96,95,83,83,25
"2245",44,"[28]lJHglqzIHcidKpcJvcGHqFdCsmDA",175,0.994318,28,176,1,175,1,1,0,1,1,85,84,91,91,25
"2246",45,"[28]lJHglqzIHcidKpcJvcGHqFdCsmDA",175,0.994318,28,176,1,175,1,1,0,1,1,87,86,89,89,25
"2247",46,"[28]lJHglqzIHcidKpcJvcGHqFdCsmDA",175,0.994318,28,176,1,175,1,1,0,1,1,86,85,90,90,25
"2248",47,"[28]lJHglqzIHcidKpcJvcGHqFdCsmDA",179,0.994444,28,180,1,179,1,1,0,1,1,97,96,83,83,25
"2249",48,"[28]lJHglqzIHcidKpcJvcGHqFdCsmDA",174,0.994286,28,175,1,174,1,1,0,1,1,81,80,94,94,25
"2250",49,"[28]lJHglqzIHcidKpcJvcGHqFdCsmDA",173,0.994253,28,174,1,173,1,1,0,1,1,80,79,94,94,25
"2251",50,"[28]lJHglqzIHcidKpcJvcGHqFdCsmDA",171,0.994186,28,172,1,171,1,1,0,1,1,74,73,98,98,25
"2252",51,"[28]lJHglqzIHcidKpcJvcGHqFdCsmDA",176,0.99435,28,177,1,176,1,1,0,1,1,87,86,90,90,25
"2253",52,"[28]lJHglqzIHcidKpcJvcGHqFdCsmDA",176,0.99435,28,177,1,176,1,1,0,1,1,88,87,89,89,25
"2254",53,"[28]lJHglqzIHcidKpcJvcGHqFdCsmDA",177,0.994382,28,178,1,177,1,1,0,1,1,93,92,85,85,25
"2255",54,"[28]lJHglqzIHcidKpcJvcGHqFdCsmDA",176,0.99435,28,177,1,176,1,1,0,1,1,88,87,89,89,25
"2256",55,"[28]lJHglqzIHcidKpcJvcGHqFdCsmDA",173,0.994253,28,174,1,173,1,1,0,1,1,79,78,95,95,25
"2257",56,"[28]lJHglqzIHcidKpcJvcGHqFdCsmDA",175,0.994318,28,176,1,175,1,1,0,1,1,85,84,91,91,25
"2258",57,"[28]lJHglqzIHcidKpcJvcGHqFdCsmDA",176,0.99435,28,177,1,176,1,1,0,1,1,89,88,88,88,25
"2259",58,"[28]lJHglqzIHcidKpcJvcGHqFdCsmDA",177,0.994382,28,178,1,177,1,1,0,1,1,94,93,84,84,25
"2260",59,"[28]lJHglqzIHcidKpcJvcGHqFdCsmDA",178,0.994413,28,179,1,178,1,1,0,1,1,97,96,82,82,25
"2261",60,"[28]lJHglqzIHcidKpcJvcGHqFdCsmDA",171,0.994186,28,172,1,171,1,1,0,1,1,73,72,99,99,25
"2262",61,"[28]lJHglqzIHcidKpcJvcGHqFdCsmDA",176,0.99435,28,177,1,176,1,1,0,1,1,89,88,88,88,25
"2263",62,"[28]lJHglqzIHcidKpcJvcGHqFdCsmDA",176,0.99435,28,177,1,176,1,1,0,1,1,88,87,89,89,25
"2264",63,"[28]lJHglqzIHcidKpcJvcGHqFdCsmDA",180,0.994475,28,181,1,180,1,1,0,1,1,101,100,80,80,25
"2265",64,"[28]lJHglqzIHcidKpcJvcGHqFdCsmDA",176,0.99435,28,177,1,176,1,1,0,1,1,87,86,90,90,25
"2266",65,"[28]lJHglqzIHcidKpcJvcGHqFdCsmDA",175,0.994318,28,176,1,175,1,1,0,1,1,85,84,91,91,25
"2267",66,"[28]lJHglqzIHcidKpcJvcGHqFdCsmDA",175,0.994318,28,176,1,175,1,1,0,1,1,86,85,90,90,25
"2268",67,"[28]lJHglqzIHcidKpcJvcGHqFdCsmDA",175,0.994318,28,176,1,175,1,1,0,1,1,86,85,90,90,25
"2269",68,"[28]lJHglqzIHcidKpcJvcGHqFdCsmDA",174,0.994286,28,175,1,174,1,1,0,1,1,83,82,92,92,25
"2270",69,"[28]lJHglqzIHcidKpcJvcGHqFdCsmDA",176,0.99435,28,177,1,176,1,1,0,1,1,88,87,89,89,25
"2271",70,"[28]lJHglqzIHcidKpcJvcGHqFdCsmDA",177,0.994382,28,178,1,177,1,1,0,1,1,94,93,84,84,25
"2272",71,"[28]lJHglqzIHcidKpcJvcGHqFdCsmDA",175,0.994318,28,176,1,175,1,1,0,1,1,86,85,90,90,25
"2273",72,"[28]lJHglqzIHcidKpcJvcGHqFdCsmDA",173,0.994253,28,174,1,173,1,1,0,1,1,80,79,94,94,25
"2274",73,"[28]lJHglqzIHcidKpcJvcGHqFdCsmDA",174,0.994286,28,175,1,174,1,1,0,1,1,83,82,92,92,25
"2275",74,"[28]lJHglqzIHcidKpcJvcGHqFdCsmDA",175,0.994318,28,176,1,175,1,1,0,1,1,86,85,90,90,25
"2276",75,"[28]lJHglqzIHcidKpcJvcGHqFdCsmDA",178,0.994413,28,179,1,178,1,1,0,1,1,95,94,84,84,25
"2277",76,"[28]lJHglqzIHcidKpcJvcGHqFdCsmDA",178,0.994413,28,179,1,178,1,1,0,1,1,96,95,83,83,25
"2278",77,"[28]lJHglqzIHcidKpcJvcGHqFdCsmDA",174,0.994286,28,175,1,174,1,1,0,1,1,82,81,93,93,25
"2279",78,"[28]lJHglqzIHcidKpcJvcGHqFdCsmDA",178,0.994413,28,179,1,178,1,1,0,1,1,97,96,82,82,25
"2280",79,"[28]lJHglqzIHcidKpcJvcGHqFdCsmDA",173,0.994253,28,174,1,173,1,1,0,1,1,81,80,93,93,25
"2281",80,"[28]lJHglqzIHcidKpcJvcGHqFdCsmDA",178,0.994413,28,179,1,178,1,1,0,1,1,95,94,84,84,25
"2282",81,"[28]lJHglqzIHcidKpcJvcGHqFdCsmDA",177,0.994382,28,178,1,177,1,1,0,1,1,93,92,85,85,25
"2283",82,"[28]lJHglqzIHcidKpcJvcGHqFdCsmDA",177,0.994382,28,178,1,177,1,1,0,1,1,94,93,84,84,25
"2284",83,"[28]lJHglqzIHcidKpcJvcGHqFdCsmDA",178,0.994413,28,179,1,178,1,1,0,1,1,93,92,86,86,25
"2285",84,"[28]lJHglqzIHcidKpcJvcGHqFdCsmDA",177,0.994382,28,178,1,177,1,1,0,1,1,94,93,84,84,25
"2286",85,"[28]lJHglqzIHcidKpcJvcGHqFdCsmDA",177,0.994382,28,178,1,177,1,1,0,1,1,90,89,88,88,25
"2287",86,"[28]lJHglqzIHcidKpcJvcGHqFdCsmDA",173,0.994253,28,174,1,173,1,1,0,1,1,81,80,93,93,25
"2288",87,"[28]lJHglqzIHcidKpcJvcGHqFdCsmDA",178,0.994413,28,179,1,178,1,1,0,1,1,94,93,85,85,25
"2289",88,"[28]lJHglqzIHcidKpcJvcGHqFdCsmDA",174,0.994286,28,175,1,174,1,1,0,1,1,82,81,93,93,25
"2290",89,"[28]lJHglqzIHcidKpcJvcGHqFdCsmDA",176,0.99435,28,177,1,176,1,1,0,1,1,90,89,87,87,25
"2291",90,"[28]lJHglqzIHcidKpcJvcGHqFdCsmDA",176,0.99435,28,177,1,176,1,1,0,1,1,88,87,89,89,25
"2292",91,"[28]lJHglqzIHcidKpcJvcGHqFdCsmDA",176,0.99435,28,177,1,176,1,1,0,1,1,88,87,89,89,25
"2293",92,"[28]lJHglqzIHcidKpcJvcGHqFdCsmDA",175,0.994318,28,176,1,175,1,1,0,1,1,87,86,89,89,25
"2294",93,"[28]lJHglqzIHcidKpcJvcGHqFdCsmDA",180,0.994475,28,181,1,180,1,1,0,1,1,102,101,79,79,25
"2295",94,"[28]lJHglqzIHcidKpcJvcGHqFdCsmDA",172,0.99422,28,173,1,172,1,1,0,1,1,77,76,96,96,25
"2296",95,"[28]lJHglqzIHcidKpcJvcGHqFdCsmDA",176,0.99435,28,177,1,176,1,1,0,1,1,91,90,86,86,25
"2297",96,"[28]lJHglqzIHcidKpcJvcGHqFdCsmDA",175,0.994318,28,176,1,175,1,1,0,1,1,86,85,90,90,25
"2298",97,"[28]lJHglqzIHcidKpcJvcGHqFdCsmDA",176,0.99435,28,177,1,176,1,1,0,1,1,89,88,88,88,25
"2299",98,"[28]lJHglqzIHcidKpcJvcGHqFdCsmDA",177,0.994382,28,178,1,177,1,1,0,1,1,94,93,84,84,25
"2300",99,"[28]lJHglqzIHcidKpcJvcGHqFdCsmDA",177,0.994382,28,178,1,177,1,1,0,1,1,92,91,86,86,25
"2301",0,"[31]eJHnaqIjHcgldKocJvcGHqFdCqtpbcw",173,0.994253,31,174,1,173,1,1,0,1,1,78,77,96,96,26
"2302",1,"[31]eJHnaqIjHcgldKocJvcGHqFdCqtpbcw",178,0.994413,31,179,1,178,1,1,0,1,1,96,95,83,83,26
"2303",2,"[31]eJHnaqIjHcgldKocJvcGHqFdCqtpbcw",174,0.994286,31,175,1,174,1,1,0,1,1,84,83,91,91,26
"2304",3,"[31]eJHnaqIjHcgldKocJvcGHqFdCqtpbcw",177,0.994382,31,178,1,177,1,1,0,1,1,93,92,85,85,26
"2305",4,"[31]eJHnaqIjHcgldKocJvcGHqFdCqtpbcw",175,0.994318,31,176,1,175,1,1,0,1,1,85,84,91,91,26
"2306",5,"[31]eJHnaqIjHcgldKocJvcGHqFdCqtpbcw",179,0.994444,31,180,1,179,1,1,0,1,1,100,99,80,80,26
"2307",6,"[31]eJHnaqIjHcgldKocJvcGHqFdCqtpbcw",176,0.99435,31,177,1,176,1,1,0,1,1,91,90,86,86,26
"2308",7,"[31]eJHnaqIjHcgldKocJvcGHqFdCqtpbcw",178,0.994413,31,179,1,178,1,1,0,1,1,98,97,81,81,26
"2309",8,"[31]eJHnaqIjHcgldKocJvcGHqFdCqtpbcw",178,0.994413,31,179,1,178,1,1,0,1,1,93,92,86,86,26
"2310",9,"[31]eJHnaqIjHcgldKocJvcGHqFdCqtpbcw",176,0.99435,31,177,1,176,1,1,0,1,1,91,90,86,86,26
"2311",10,"[31]eJHnaqIjHcgldKocJvcGHqFdCqtpbcw",178,0.994413,31,179,1,178,1,1,0,1,1,97,96,82,82,26
"2312",11,"[31]eJHnaqIjHcgldKocJvcGHqFdCqtpbcw",174,0.994286,31,175,1,174,1,1,0,1,1,81,80,94,94,26
"2313",12,"[31]eJHnaqIjHcgldKocJvcGHqFdCqtpbcw",174,0.994286,31,175,1,174,1,1,0,1,1,81,80,94,94,26
"2314",13,"[31]eJHnaqIjHcgldKocJvcGHqFdCqtpbcw",177,0.994382,31,178,1,177,1,1,0,1,1,94,93,84,84,26
"2315",14,"[31]eJHnaqIjHcgldKocJvcGHqFdCqtpbcw",177,0.994382,31,178,1,177,1,1,0,1,1,92,91,86,86,26
"2316",15,"[31]eJHnaqIjHcgldKocJvcGHqFdCqtpbcw",175,0.994318,31,176,1,175,1,1,0,1,1,84,83,92,92,26
"2317",16,"[31]eJHnaqIjHcgldKocJvcGHqFdCqtpbcw",173,0.994253,31,174,1,173,1,1,0,1,1,81,80,93,93,26
"2318",17,"[31]eJHnaqIjHcgldKocJvcGHqFdCqtpbcw",174,0.994286,31,175,1,174,1,1,0,1,1,80,79,95,95,26
"2319",18,"[31]eJHnaqIjHcgldKocJvcGHqFdCqtpbcw",173,0.994253,31,174,1,173,1,1,0,1,1,81,80,93,93,26
"2320",19,"[31]eJHnaqIjHcgldKocJvcGHqFdCqtpbcw",172,0.99422,31,173,1,172,1,1,0,1,1,75,74,98,98,26
"2321",20,"[31]eJHnaqIjHcgldKocJvcGHqFdCqtpbcw",175,0.994318,31,176,1,175,1,1,0,1,1,86,85,90,90,26
"2322",21,"[31]eJHnaqIjHcgldKocJvcGHqFdCqtpbcw",178,0.994413,31,179,1,178,1,1,0,1,1,97,96,82,82,26
"2323",22,"[31]eJHnaqIjHcgldKocJvcGHqFdCqtpbcw",174,0.994286,31,175,1,174,1,1,0,1,1,84,83,91,91,26
"2324",23,"[31]eJHnaqIjHcgldKocJvcGHqFdCqtpbcw",181,0.994505,31,182,1,181,1,1,0,1,1,103,102,79,79,26
"2325",24,"[31]eJHnaqIjHcgldKocJvcGHqFdCqtpbcw",177,0.994382,31,178,1,177,1,1,0,1,1,90,89,88,88,26
"2326",25,"[31]eJHnaqIjHcgldKocJvcGHqFdCqtpbcw",175,0.994318,31,176,1,175,1,1,0,1,1,86,85,90,90,26
"2327",26,"[31]eJHnaqIjHcgldKocJvcGHqFdCqtpbcw",178,0.994413,31,179,1,178,1,1,0,1,1,94,93,85,85,26
"2328",27,"[31]eJHnaqIjHcgldKocJvcGHqFdCqtpbcw",177,0.994382,31,178,1,177,1,1,0,1,1,93,92,85,85,26
"2329",28,"[31]eJHnaqIjHcgldKocJvcGHqFdCqtpbcw",178,0.994413,31,179,1,178,1,1,0,1,1,98,97,81,81,26
"2330",29,"[31]eJHnaqIjHcgldKocJvcGHqFdCqtpbcw",175,0.994318,31,176,1,175,1,1,0,1,1,85,84,91,91,26
"2331",30,"[31]eJHnaqIjHcgldKocJvcGHqFdCqtpbcw",178,0.994413,31,179,1,178,1,1,0,1,1,92,91,87,87,26
"2332",31,"[31]eJHnaqIjHcgldKocJvcGHqFdCqtpbcw",176,0.99435,31,177,1,176,1,1,0,1,1,89,88,88,88,26
"2333",32,"[31]eJHnaqIjHcgldKocJvcGHqFdCqtpbcw",180,0.994475,31,181,1,180,1,1,0,1,1,95,94,86,86,26
"2334",33,"[31]eJHnaqIjHcgldKocJvcGHqFdCqtpbcw",177,0.994382,31,178,1,177,1,1,0,1,1,91,90,87,87,26
"2335",34,"[31]eJHnaqIjHcgldKocJvcGHqFdCqtpbcw",175,0.994318,31,176,1,175,1,1,0,1,1,86,85,90,90,26
"2336",35,"[31]eJHnaqIjHcgldKocJvcGHqFdCqtpbcw",177,0.994382,31,178,1,177,1,1,0,1,1,92,91,86,86,26
"2337",36,"[31]eJHnaqIjHcgldKocJvcGHqFdCqtpbcw",179,0.994444,31,180,1,179,1,1,0,1,1,99,98,81,81,26
"2338",37,"[31]eJHnaqIjHcgldKocJvcGHqFdCqtpbcw",176,0.99435,31,177,1,176,1,1,0,1,1,91,90,86,86,26
"2339",38,"[31]eJHnaqIjHcgldKocJvcGHqFdCqtpbcw",176,0.99435,31,177,1,176,1,1,0,1,1,88,87,89,89,26
"2340",39,"[31]eJHnaqIjHcgldKocJvcGHqFdCqtpbcw",178,0.994413,31,179,1,178,1,1,0,1,1,94,93,85,85,26
"2341",40,"[31]eJHnaqIjHcgldKocJvcGHqFdCqtpbcw",177,0.994382,31,178,1,177,1,1,0,1,1,92,91,86,86,26
"2342",41,"[31]eJHnaqIjHcgldKocJvcGHqFdCqtpbcw",178,0.994413,31,179,1,178,1,1,0,1,1,96,95,83,83,26
"2343",42,"[31]eJHnaqIjHcgldKocJvcGHqFdCqtpbcw",176,0.99435,31,177,1,176,1,1,0,1,1,90,89,87,87,26
"2344",43,"[31]eJHnaqIjHcgldKocJvcGHqFdCqtpbcw",175,0.994318,31,176,1,175,1,1,0,1,1,85,84,91,91,26
"2345",44,"[31]eJHnaqIjHcgldKocJvcGHqFdCqtpbcw",175,0.994318,31,176,1,175,1,1,0,1,1,86,85,90,90,26
"2346",45,"[31]eJHnaqIjHcgldKocJvcGHqFdCqtpbcw",178,0.994413,31,179,1,178,1,1,0,1,1,96,95,83,83,26
"2347",46,"[31]eJHnaqIjHcgldKocJvcGHqFdCqtpbcw",178,0.994413,31,179,1,178,1,1,0,1,1,96,95,83,83,26
"2348",47,"[31]eJHnaqIjHcgldKocJvcGHqFdCqtpbcw",180,0.994475,31,181,1,180,1,1,0,1,1,104,103,77,77,26
"2349",48,"[31]eJHnaqIjHcgldKocJvcGHqFdCqtpbcw",178,0.994413,31,179,1,178,1,1,0,1,1,98,97,81,81,26
"2350",49,"[31]eJHnaqIjHcgldKocJvcGHqFdCqtpbcw",174,0.994286,31,175,1,174,1,1,0,1,1,83,82,92,92,26
"2351",50,"[31]eJHnaqIjHcgldKocJvcGHqFdCqtpbcw",175,0.994318,31,176,1,175,1,1,0,1,1,86,85,90,90,26
"2352",51,"[31]eJHnaqIjHcgldKocJvcGHqFdCqtpbcw",174,0.994286,31,175,1,174,1,1,0,1,1,83,82,92,92,26
"2353",52,"[31]eJHnaqIjHcgldKocJvcGHqFdCqtpbcw",175,0.994318,31,176,1,175,1,1,0,1,1,85,84,91,91,26
"2354",53,"[31]eJHnaqIjHcgldKocJvcGHqFdCqtpbcw",174,0.994286,31,175,1,174,1,1,0,1,1,79,78,96,96,26
"2355",54,"[31]eJHnaqIjHcgldKocJvcGHqFdCqtpbcw",177,0.994382,31,178,1,177,1,1,0,1,1,92,91,86,86,26
"2356",55,"[31]eJHnaqIjHcgldKocJvcGHqFdCqtpbcw",176,0.99435,31,177,1,176,1,1,0,1,1,90,89,87,87,26
"2357",56,"[31]eJHnaqIjHcgldKocJvcGHqFdCqtpbcw",174,0.994286,31,175,1,174,1,1,0,1,1,84,83,91,91,26
"2358",57,"[31]eJHnaqIjHcgldKocJvcGHqFdCqtpbcw",181,0.994505,31,182,1,181,1,1,0,1,1,102,101,80,80,26
"2359",58,"[31]eJHnaqIjHcgldKocJvcGHqFdCqtpbcw",173,0.994253,31,174,1,173,1,1,0,1,1,77,76,97,97,26
"2360",59,"[31]eJHnaqIjHcgldKocJvcGHqFdCqtpbcw",178,0.994413,31,179,1,178,1,1,0,1,1,92,91,87,87,26
"2361",60,"[31]eJHnaqIjHcgldKocJvcGHqFdCqtpbcw",175,0.994318,31,176,1,175,1,1,0,1,1,83,82,93,93,26
"2362",61,"[31]eJHnaqIjHcgldKocJvcGHqFdCqtpbcw",177,0.994382,31,178,1,177,1,1,0,1,1,90,89,88,88,26
"2363",62,"[31]eJHnaqIjHcgldKocJvcGHqFdCqtpbcw",174,0.994286,31,175,1,174,1,1,0,1,1,84,83,91,91,26
"2364",63,"[31]eJHnaqIjHcgldKocJvcGHqFdCqtpbcw",178,0.994413,31,179,1,178,1,1,0,1,1,97,96,82,82,26
"2365",64,"[31]eJHnaqIjHcgldKocJvcGHqFdCqtpbcw",178,0.994413,31,179,1,178,1,1,0,1,1,95,94,84,84,26
"2366",65,"[31]eJHnaqIjHcgldKocJvcGHqFdCqtpbcw",177,0.994382,31,178,1,177,1,1,0,1,1,90,89,88,88,26
"2367",66,"[31]eJHnaqIjHcgldKocJvcGHqFdCqtpbcw",177,0.994382,31,178,1,177,1,1,0,1,1,93,92,85,85,26
"2368",67,"[31]eJHnaqIjHcgldKocJvcGHqFdCqtpbcw",175,0.994318,31,176,1,175,1,1,0,1,1,86,85,90,90,26
"2369",68,"[31]eJHnaqIjHcgldKocJvcGHqFdCqtpbcw",175,0.994318,31,176,1,175,1,1,0,1,1,86,85,90,90,26
"2370",69,"[31]eJHnaqIjHcgldKocJvcGHqFdCqtpbcw",172,0.99422,31,173,1,172,1,1,0,1,1,75,74,98,98,26
"2371",70,"[31]eJHnaqIjHcgldKocJvcGHqFdCqtpbcw",181,0.994505,31,182,1,181,1,1,0,1,1,105,104,77,77,26
"2372",71,"[31]eJHnaqIjHcgldKocJvcGHqFdCqtpbcw",179,0.994444,31,180,1,179,1,1,0,1,1,99,98,81,81,26
"2373",72,"[31]eJHnaqIjHcgldKocJvcGHqFdCqtpbcw",179,0.994444,31,180,1,179,1,1,0,1,1,99,98,81,81,26
"2374",73,"[31]eJHnaqIjHcgldKocJvcGHqFdCqtpbcw",172,0.99422,31,173,1,172,1,1,0,1,1,76,75,97,97,26
"2375",74,"[31]eJHnaqIjHcgldKocJvcGHqFdCqtpbcw",177,0.994382,31,178,1,177,1,1,0,1,1,92,91,86,86,26
"2376",75,"[31]eJHnaqIjHcgldKocJvcGHqFdCqtpbcw",182,0.994536,31,183,1,182,1,1,0,1,1,108,107,75,75,26
"2377",76,"[31]eJHnaqIjHcgldKocJvcGHqFdCqtpbcw",174,0.994286,31,175,1,174,1,1,0,1,1,81,80,94,94,26
"2378",77,"[31]eJHnaqIjHcgldKocJvcGHqFdCqtpbcw",174,0.994286,31,175,1,174,1,1,0,1,1,82,81,93,93,26
"2379",78,"[31]eJHnaqIjHcgldKocJvcGHqFdCqtpbcw",173,0.994253,31,174,1,173,1,1,0,1,1,79,78,95,95,26
"2380",79,"[31]eJHnaqIjHcgldKocJvcGHqFdCqtpbcw",180,0.994475,31,181,1,180,1,1,0,1,1,103,102,78,78,26
"2381",80,"[31]eJHnaqIjHcgldKocJvcGHqFdCqtpbcw",174,0.994286,31,175,1,174,1,1,0,1,1,83,82,92,92,26
"2382",81,"[31]eJHnaqIjHcgldKocJvcGHqFdCqtpbcw",175,0.994318,31,176,1,175,1,1,0,1,1,81,80,95,95,26
"2383",82,"[31]eJHnaqIjHcgldKocJvcGHqFdCqtpbcw",175,0.994318,31,176,1,175,1,1,0,1,1,87,86,89,89,26
"2384",83,"[31]eJHnaqIjHcgldKocJvcGHqFdCqtpbcw",178,0.994413,31,179,1,178,1,1,0,1,1,92,91,87,87,26
"2385",84,"[31]eJHnaqIjHcgldKocJvcGHqFdCqtpbcw",181,0.994505,31,182,1,181,1,1,0,1,1,104,103,78,78,26
"2386",85,"[31]eJHnaqIjHcgldKocJvcGHqFdCqtpbcw",178,0.994413,31,179,1,178,1,1,0,1,1,96,95,83,83,26
"2387",86,"[31]eJHnaqIjHcgldKocJvcGHqFdCqtpbcw",176,0.99435,31,177,1,176,1,1,0,1,1,89,88,88,88,26
"2388",87,"[31]eJHnaqIjHcgldKocJvcGHqFdCqtpbcw",175,0.994318,31,176,1,175,1,1,0,1,1,87,86,89,89,26
"2389",88,"[31]eJHnaqIjHcgldKocJvcGHqFdCqtpbcw",177,0.994382,31,178,1,177,1,1,0,1,1,92,91,86,86,26
"2390",89,"[31]eJHnaqIjHcgldKocJvcGHqFdCqtpbcw",178,0.994413,31,179,1,178,1,1,0,1,1,94,93,85,85,26
"2391",90,"[31]eJHnaqIjHcgldKocJvcGHqFdCqtpbcw",175,0.994318,31,176,1,175,1,1,0,1,1,88,87,88,88,26
"2392",91,"[31]eJHnaqIjHcgldKocJvcGHqFdCqtpbcw",180,0.994475,31,181,1,180,1,1,0,1,1,100,99,81,81,26
"2393",92,"[31]eJHnaqIjHcgldKocJvcGHqFdCqtpbcw",175,0.994318,31,176,1,175,1,1,0,1,1,87,86,89,89,26
"2394",93,"[31]eJHnaqIjHcgldKocJvcGHqFdCqtpbcw",175,0.994318,31,176,1,175,1,1,0,1,1,87,86,89,89,26
"2395",94,"[31]eJHnaqIjHcgldKocJvcGHqFdCqtpbcw",177,0.994382,31,178,1,177,1,1,0,1,1,93,92,85,85,26
"2396",95,"[31]eJHnaqIjHcgldKocJvcGHqFdCqtpbcw",174,0.994286,31,175,1,174,1,1,0,1,1,84,83,91,91,26
"2397",96,"[31]eJHnaqIjHcgldKocJvcGHqFdCqtpbcw",175,0.994318,31,176,1,175,1,1,0,1,1,86,85,90,90,26
"2398",97,"[31]eJHnaqIjHcgldKocJvcGHqFdCqtpbcw",178,0.994413,31,179,1,178,1,1,0,1,1,94,93,85,85,26
"2399",98,"[31]eJHnaqIjHcgldKocJvcGHqFdCqtpbcw",176,0.99435,31,177,1,176,1,1,0,1,1,89,88,88,88,26
"2400",99,"[31]eJHnaqIjHcgldKocJvcGHqFdCqtpbcw",175,0.994318,31,176,1,175,1,1,0,1,1,86,85,90,90,26
"2401",0,"[27]aJHggqIHcdKocJvcGHqwdCgEGnD",163,0.993902,27,164,1,163,1,1,0,1,1,74,73,90,90,27
"2402",1,"[27]aJHggqIHcdKocJvcGHqwdCgEGnD",166,0.994012,27,167,1,166,1,1,0,1,1,83,82,84,84,27
"2403",2,"[27]aJHggqIHcdKocJvcGHqwdCgEGnD",168,0.994083,27,169,1,168,1,1,0,1,1,86,85,83,83,27
"2404",3,"[27]aJHggqIHcdKocJvcGHqwdCgEGnD",168,0.994083,27,169,1,168,1,1,0,1,1,85,84,84,84,27
"2405",4,"[27]aJHggqIHcdKocJvcGHqwdCgEGnD",167,0.994048,27,168,1,167,1,1,0,1,1,84,83,84,84,27
"2406",5,"[27]aJHggqIHcdKocJvcGHqwdCgEGnD",162,0.993865,27,163,1,162,1,1,0,1,1,70,69,93,93,27
"2407",6,"[27]aJHggqIHcdKocJvcGHqwdCgEGnD",167,0.994048,27,168,1,167,1,1,0,1,1,84,83,84,84,27
"2408",7,"[27]aJHggqIHcdKocJvcGHqwdCgEGnD",165,0.993976,27,166,1,165,1,1,0,1,1,79,78,87,87,27
"2409",8,"[27]aJHggqIHcdKocJvcGHqwdCgEGnD",166,0.994012,27,167,1,166,1,1,0,1,1,80,79,87,87,27
"2410",9,"[27]aJHggqIHcdKocJvcGHqwdCgEGnD",174,0.994286,27,175,1,174,1,1,0,1,1,104,103,71,71,27
"2411",10,"[27]aJHggqIHcdKocJvcGHqwdCgEGnD",171,0.994186,27,172,1,171,1,1,0,1,1,94,93,78,78,27
"2412",11,"[27]aJHggqIHcdKocJvcGHqwdCgEGnD",169,0.994118,27,170,1,169,1,1,0,1,1,89,88,81,81,27
"2413",12,"[27]aJHggqIHcdKocJvcGHqwdCgEGnD",170,0.994152,27,171,1,170,1,1,0,1,1,93,92,78,78,27
"2414",13,"[27]aJHggqIHcdKocJvcGHqwdCgEGnD",167,0.994048,27,168,1,167,1,1,0,1,1,86,85,82,82,27
"2415",14,"[27]aJHggqIHcdKocJvcGHqwdCgEGnD",169,0.994118,27,170,1,169,1,1,0,1,1,90,89,80,80,27
"2416",15,"[27]aJHggqIHcdKocJvcGHqwdCgEGnD",169,0.994118,27,170,1,169,1,1,0,1,1,89,88,81,81,27
"2417",16,"[27]aJHggqIHcdKocJvcGHqwdCgEGnD",166,0.994012,27,167,1,166,1,1,0,1,1,81,80,86,86,27
"2418",17,"[27]aJHggqIHcdKocJvcGHqwdCgEGnD",170,0.994152,27,171,1,170,1,1,0,1,1,92,91,79,79,27
"2419",18,"[27]aJHggqIHcdKocJvcGHqwdCgEGnD",171,0.994186,27,172,1,171,1,1,0,1,1,95,94,77,77,27
"2420",19,"[27]aJHggqIHcdKocJvcGHqwdCgEGnD",165,0.993976,27,166,1,165,1,1,0,1,1,78,77,88,88,27
"2421",20,"[27]aJHggqIHcdKocJvcGHqwdCgEGnD",162,0.993865,27,163,1,162,1,1,0,1,1,72,71,91,91,27
"2422",21,"[27]aJHggqIHcdKocJvcGHqwdCgEGnD",166,0.994012,27,167,1,166,1,1,0,1,1,81,80,86,86,27
"2423",22,"[27]aJHggqIHcdKocJvcGHqwdCgEGnD",164,0.993939,27,165,1,164,1,1,0,1,1,76,75,89,89,27
"2424",23,"[27]aJHggqIHcdKocJvcGHqwdCgEGnD",167,0.994048,27,168,1,167,1,1,0,1,1,84,83,84,84,27
"2425",24,"[27]aJHggqIHcdKocJvcGHqwdCgEGnD",168,0.994083,27,169,1,168,1,1,0,1,1,87,86,82,82,27
"2426",25,"[27]aJHggqIHcdKocJvcGHqwdCgEGnD",167,0.994048,27,168,1,167,1,1,0,1,1,83,82,85,85,27
"2427",26,"[27]aJHggqIHcdKocJvcGHqwdCgEGnD",172,0.99422,27,173,1,172,1,1,0,1,1,97,96,76,76,27
"2428",27,"[27]aJHggqIHcdKocJvcGHqwdCgEGnD",172,0.99422,27,173,1,172,1,1,0,1,1,99,98,74,74,27
"2429",28,"[27]aJHggqIHcdKocJvcGHqwdCgEGnD",165,0.993976,27,166,1,165,1,1,0,1,1,80,79,86,86,27
"2430",29,"[27]aJHggqIHcdKocJvcGHqwdCgEGnD",169,0.994118,27,170,1,169,1,1,0,1,1,89,88,81,81,27
"2431",30,"[27]aJHggqIHcdKocJvcGHqwdCgEGnD",170,0.994152,27,171,1,170,1,1,0,1,1,91,90,80,80,27
"2432",31,"[27]aJHggqIHcdKocJvcGHqwdCgEGnD",168,0.994083,27,169,1,168,1,1,0,1,1,86,85,83,83,27
"2433",32,"[27]aJHggqIHcdKocJvcGHqwdCgEGnD",169,0.994118,27,170,1,169,1,1,0,1,1,90,89,80,80,27
"2434",33,"[27]aJHggqIHcdKocJvcGHqwdCgEGnD",164,0.993939,27,165,1,164,1,1,0,1,1,77,76,88,88,27
"2435",34,"[27]aJHggqIHcdKocJvcGHqwdCgEGnD",166,0.994012,27,167,1,166,1,1,0,1,1,82,81,85,85,27
"2436",35,"[27]aJHggqIHcdKocJvcGHqwdCgEGnD",163,0.993902,27,164,1,163,1,1,0,1,1,74,73,90,90,27
"2437",36,"[27]aJHggqIHcdKocJvcGHqwdCgEGnD",167,0.994048,27,168,1,167,1,1,0,1,1,86,85,82,82,27
"2438",37,"[27]aJHggqIHcdKocJvcGHqwdCgEGnD",165,0.993976,27,166,1,165,1,1,0,1,1,78,77,88,88,27
"2439",38,"[27]aJHggqIHcdKocJvcGHqwdCgEGnD",164,0.993939,27,165,1,164,1,1,0,1,1,77,76,88,88,27
"2440",39,"[27]aJHggqIHcdKocJvcGHqwdCgEGnD",166,0.994012,27,167,1,166,1,1,0,1,1,81,80,86,86,27
"2441",40,"[27]aJHggqIHcdKocJvcGHqwdCgEGnD",166,0.994012,27,167,1,166,1,1,0,1,1,82,81,85,85,27
"2442",41,"[27]aJHggqIHcdKocJvcGHqwdCgEGnD",171,0.994186,27,172,1,171,1,1,0,1,1,96,95,76,76,27
"2443",42,"[27]aJHggqIHcdKocJvcGHqwdCgEGnD",167,0.994048,27,168,1,167,1,1,0,1,1,85,84,83,83,27
"2444",43,"[27]aJHggqIHcdKocJvcGHqwdCgEGnD",169,0.994118,27,170,1,169,1,1,0,1,1,89,88,81,81,27
"2445",44,"[27]aJHggqIHcdKocJvcGHqwdCgEGnD",163,0.993902,27,164,1,163,1,1,0,1,1,74,73,90,90,27
"2446",45,"[27]aJHggqIHcdKocJvcGHqwdCgEGnD",168,0.994083,27,169,1,168,1,1,0,1,1,88,87,81,81,27
"2447",46,"[27]aJHggqIHcdKocJvcGHqwdCgEGnD",164,0.993939,27,165,1,164,1,1,0,1,1,77,76,88,88,27
"2448",47,"[27]aJHggqIHcdKocJvcGHqwdCgEGnD",168,0.994083,27,169,1,168,1,1,0,1,1,88,87,81,81,27
"2449",48,"[27]aJHggqIHcdKocJvcGHqwdCgEGnD",162,0.993865,27,163,1,162,1,1,0,1,1,71,70,92,92,27
"2450",49,"[27]aJHggqIHcdKocJvcGHqwdCgEGnD",168,0.994083,27,169,1,168,1,1,0,1,1,88,87,81,81,27
"2451",50,"[27]aJHggqIHcdKocJvcGHqwdCgEGnD",170,0.994152,27,171,1,170,1,1,0,1,1,92,91,79,79,27
"2452",51,"[27]aJHggqIHcdKocJvcGHqwdCgEGnD",170,0.994152,27,171,1,170,1,1,0,1,1,92,91,79,79,27
"2453",52,"[27]aJHggqIHcdKocJvcGHqwdCgEGnD",164,0.993939,27,165,1,164,1,1,0,1,1,77,76,88,88,27
"2454",53,"[27]aJHggqIHcdKocJvcGHqwdCgEGnD",172,0.99422,27,173,1,172,1,1,0,1,1,98,97,75,75,27
"2455",54,"[27]aJHggqIHcdKocJvcGHqwdCgEGnD",169,0.994118,27,170,1,169,1,1,0,1,1,88,87,82,82,27
"2456",55,"[27]aJHggqIHcdKocJvcGHqwdCgEGnD",171,0.994186,27,172,1,171,1,1,0,1,1,96,95,76,76,27
"2457",56,"[27]aJHggqIHcdKocJvcGHqwdCgEGnD",171,0.994186,27,172,1,171,1,1,0,1,1,94,93,78,78,27
"2458",57,"[27]aJHggqIHcdKocJvcGHqwdCgEGnD",167,0.994048,27,168,1,167,1,1,0,1,1,83,82,85,85,27
"2459",58,"[27]aJHggqIHcdKocJvcGHqwdCgEGnD",167,0.994048,27,168,1,167,1,1,0,1,1,84,83,84,84,27
"2460",59,"[27]aJHggqIHcdKocJvcGHqwdCgEGnD",165,0.993976,27,166,1,165,1,1,0,1,1,78,77,88,88,27
"2461",60,"[27]aJHggqIHcdKocJvcGHqwdCgEGnD",163,0.993902,27,164,1,163,1,1,0,1,1,74,73,90,90,27
"2462",61,"[27]aJHggqIHcdKocJvcGHqwdCgEGnD",166,0.994012,27,167,1,166,1,1,0,1,1,83,82,84,84,27
"2463",62,"[27]aJHggqIHcdKocJvcGHqwdCgEGnD",161,0.993827,27,162,1,161,1,1,0,1,1,69,68,93,93,27
"2464",63,"[27]aJHggqIHcdKocJvcGHqwdCgEGnD",166,0.994012,27,167,1,166,1,1,0,1,1,82,81,85,85,27
"2465",64,"[27]aJHggqIHcdKocJvcGHqwdCgEGnD",164,0.993939,27,165,1,164,1,1,0,1,1,76,75,89,89,27
"2466",65,"[27]aJHggqIHcdKocJvcGHqwdCgEGnD",167,0.994048,27,168,1,167,1,1,0,1,1,85,84,83,83,27
"2467",66,"[27]aJHggqIHcdKocJvcGHqwdCgEGnD",167,0.994048,27,168,1,167,1,1,0,1,1,85,84,83,83,27
"2468",67,"[27]aJHggqIHcdKocJvcGHqwdCgEGnD",166,0.994012,27,167,1,166,1,1,0,1,1,81,80,86,86,27
"2469",68,"[27]aJHggqIHcdKocJvcGHqwdCgEGnD",167,0.994048,27,168,1,167,1,1,0,1,1,85,84,83,83,27
"2470",69,"[27]aJHggqIHcdKocJvcGHqwdCgEGnD",170,0.994152,27,171,1,170,1,1,0,1,1,94,93,77,77,27
"2471",70,"[27]aJHggqIHcdKocJvcGHqwdCgEGnD",170,0.994152,27,171,1,170,1,1,0,1,1,92,91,79,79,27
"2472",71,"[27]aJHggqIHcdKocJvcGHqwdCgEGnD",164,0.993939,27,165,1,164,1,1,0,1,1,77,76,88,88,27
"2473",72,"[27]aJHggqIHcdKocJvcGHqwdCgEGnD",165,0.993976,27,166,1,165,1,1,0,1,1,79,78,87,87,27
"2474",73,"[27]aJHggqIHcdKocJvcGHqwdCgEGnD",172,0.99422,27,173,1,172,1,1,0,1,1,99,98,74,74,27
"2475",74,"[27]aJHggqIHcdKocJvcGHqwdCgEGnD",173,0.994253,27,174,1,173,1,1,0,1,1,102,101,72,72,27
"2476",75,"[27]aJHggqIHcdKocJvcGHqwdCgEGnD",169,0.994118,27,170,1,169,1,1,0,1,1,90,89,80,80,27
"2477",76,"[27]aJHggqIHcdKocJvcGHqwdCgEGnD",167,0.994048,27,168,1,167,1,1,0,1,1,84,83,84,84,27
"2478",77,"[27]aJHggqIHcdKocJvcGHqwdCgEGnD",172,0.99422,27,173,1,172,1,1,0,1,1,98,97,75,75,27
"2479",78,"[27]aJHggqIHcdKocJvcGHqwdCgEGnD",164,0.993939,27,165,1,164,1,1,0,1,1,76,75,89,89,27
"2480",79,"[27]aJHggqIHcdKocJvcGHqwdCgEGnD",166,0.994012,27,167,1,166,1,1,0,1,1,83,82,84,84,27
"2481",80,"[27]aJHggqIHcdKocJvcGHqwdCgEGnD",165,0.993976,27,166,1,165,1,1,0,1,1,78,77,88,88,27
"2482",81,"[27]aJHggqIHcdKocJvcGHqwdCgEGnD",163,0.993902,27,164,1,163,1,1,0,1,1,75,74,89,89,27
"2483",82,"[27]aJHggqIHcdKocJvcGHqwdCgEGnD",164,0.993939,27,165,1,164,1,1,0,1,1,77,76,88,88,27
"2484",83,"[27]aJHggqIHcdKocJvcGHqwdCgEGnD",169,0.994118,27,170,1,169,1,1,0,1,1,89,88,81,81,27
"2485",84,"[27]aJHggqIHcdKocJvcGHqwdCgEGnD",165,0.993976,27,166,1,165,1,1,0,1,1,78,77,88,88,27
"2486",85,"[27]aJHggqIHcdKocJvcGHqwdCgEGnD",165,0.993976,27,166,1,165,1,1,0,1,1,78,77,88,88,27
"2487",86,"[27]aJHggqIHcdKocJvcGHqwdCgEGnD",165,0.993976,27,166,1,165,1,1,0,1,1,80,79,86,86,27
"2488",87,"[27]aJHggqIHcdKocJvcGHqwdCgEGnD",161,0.993827,27,162,1,161,1,1,0,1,1,67,66,95,95,27
"2489",88,"[27]aJHggqIHcdKocJvcGHqwdCgEGnD",170,0.994152,27,171,1,170,1,1,0,1,1,94,93,77,77,27
"2490",89,"[27]aJHggqIHcdKocJvcGHqwdCgEGnD",164,0.993939,27,165,1,164,1,1,0,1,1,77,76,88,88,27
"2491",90,"[27]aJHggqIHcdKocJvcGHqwdCgEGnD",169,0.994118,27,170,1,169,1,1,0,1,1,90,89,80,80,27
"2492",91,"[27]aJHggqIHcdKocJvcGHqwdCgEGnD",164,0.993939,27,165,1,164,1,1,0,1,1,77,76,88,88,27
"2493",92,"[27]aJHggqIHcdKocJvcGHqwdCgEGnD",163,0.993902,27,164,1,163,1,1,0,1,1,74,73,90,90,27
"2494",93,"[27]aJHggqIHcdKocJvcGHqwdCgEGnD",167,0.994048,27,168,1,167,1,1,0,1,1,84,83,84,84,27
"2495",94,"[27]aJHggqIHcdKocJvcGHqwdCgEGnD",168,0.994083,27,169,1,168,1,1,0,1,1,87,86,82,82,27
"2496",95,"[27]aJHggqIHcdKocJvcGHqwdCgEGnD",168,0.994083,27,169,1,168,1,1,0,1,1,88,87,81,81,27
"2497",96,"[27]aJHggqIHcdKocJvcGHqwdCgEGnD",166,0.994012,27,167,1,166,1,1,0,1,1,83,82,84,84,27
"2498",97,"[27]aJHggqIHcdKocJvcGHqwdCgEGnD",172,0.99422,27,173,1,172,1,1,0,1,1,98,97,75,75,27
"2499",98,"[27]aJHggqIHcdKocJvcGHqwdCgEGnD",165,0.993976,27,166,1,165,1,1,0,1,1,79,78,87,87,27
"2500",99,"[27]aJHggqIHcdKocJvcGHqwdCgEGnD",167,0.994048,27,168,1,167,1,1,0,1,1,85,84,83,83,27
"2501",0,"[27]jJHggqIAHBidKpcJvcGHqFdCCzz",181,0.994505,27,182,1,181,1,1,0,1,1,107,106,75,75,28
"2502",1,"[27]jJHggqIAHBidKpcJvcGHqFdCCzz",175,0.994318,27,176,1,175,1,1,0,1,1,87,86,89,89,28
"2503",2,"[27]jJHggqIAHBidKpcJvcGHqFdCCzz",176,0.99435,27,177,1,176,1,1,0,1,1,91,90,86,86,28
"2504",3,"[27]jJHggqIAHBidKpcJvcGHqFdCCzz",175,0.994318,27,176,1,175,1,1,0,1,1,85,84,91,91,28
"2505",4,"[27]jJHggqIAHBidKpcJvcGHqFdCCzz",179,0.994444,27,180,1,179,1,1,0,1,1,96,95,84,84,28
"2506",5,"[27]jJHggqIAHBidKpcJvcGHqFdCCzz",173,0.994253,27,174,1,173,1,1,0,1,1,80,79,94,94,28
"2507",6,"[27]jJHggqIAHBidKpcJvcGHqFdCCzz",179,0.994444,27,180,1,179,1,1,0,1,1,101,100,79,79,28
"2508",7,"[27]jJHggqIAHBidKpcJvcGHqFdCCzz",176,0.99435,27,177,1,176,1,1,0,1,1,87,86,90,90,28
"2509",8,"[27]jJHggqIAHBidKpcJvcGHqFdCCzz",180,0.994475,27,181,1,180,1,1,0,1,1,103,102,78,78,28
"2510",9,"[27]jJHggqIAHBidKpcJvcGHqFdCCzz",175,0.994318,27,176,1,175,1,1,0,1,1,85,84,91,91,28
"2511",10,"[27]jJHggqIAHBidKpcJvcGHqFdCCzz",174,0.994286,27,175,1,174,1,1,0,1,1,81,80,94,94,28
"2512",11,"[27]jJHggqIAHBidKpcJvcGHqFdCCzz",174,0.994286,27,175,1,174,1,1,0,1,1,84,83,91,91,28
"2513",12,"[27]jJHggqIAHBidKpcJvcGHqFdCCzz",177,0.994382,27,178,1,177,1,1,0,1,1,93,92,85,85,28
"2514",13,"[27]jJHggqIAHBidKpcJvcGHqFdCCzz",174,0.994286,27,175,1,174,1,1,0,1,1,84,83,91,91,28
"2515",14,"[27]jJHggqIAHBidKpcJvcGHqFdCCzz",176,0.99435,27,177,1,176,1,1,0,1,1,89,88,88,88,28
"2516",15,"[27]jJHggqIAHBidKpcJvcGHqFdCCzz",181,0.994505,27,182,1,181,1,1,0,1,1,105,104,77,77,28
"2517",16,"[27]jJHggqIAHBidKpcJvcGHqFdCCzz",178,0.994413,27,179,1,178,1,1,0,1,1,97,96,82,82,28
"2518",17,"[27]jJHggqIAHBidKpcJvcGHqFdCCzz",179,0.994444,27,180,1,179,1,1,0,1,1,99,98,81,81,28
"2519",18,"[27]jJHggqIAHBidKpcJvcGHqFdCCzz",174,0.994286,27,175,1,174,1,1,0,1,1,84,83,91,91,28
"2520",19,"[27]jJHggqIAHBidKpcJvcGHqFdCCzz",181,0.994505,27,182,1,181,1,1,0,1,1,105,104,77,77,28
"2521",20,"[27]jJHggqIAHBidKpcJvcGHqFdCCzz",178,0.994413,27,179,1,178,1,1,0,1,1,95,94,84,84,28
"2522",21,"[27]jJHggqIAHBidKpcJvcGHqFdCCzz",179,0.994444,27,180,1,179,1,1,0,1,1,99,98,81,81,28
"2523",22,"[27]jJHggqIAHBidKpcJvcGHqFdCCzz",178,0.994413,27,179,1,178,1,1,0,1,1,93,92,86,86,28
"2524",23,"[27]jJHggqIAHBidKpcJvcGHqFdCCzz",178,0.994413,27,179,1,178,1,1,0,1,1,97,96,82,82,28
"2525",24,"[27]jJHggqIAHBidKpcJvcGHqFdCCzz",175,0.994318,27,176,1,175,1,1,0,1,1,84,83,92,92,28
"2526",25,"[27]jJHggqIAHBidKpcJvcGHqFdCCzz",177,0.994382,27,178,1,177,1,1,0,1,1,92,91,86,86,28
"2527",26,"[27]jJHggqIAHBidKpcJvcGHqFdCCzz",177,0.994382,27,178,1,177,1,1,0,1,1,93,92,85,85,28
"2528",27,"[27]jJHggqIAHBidKpcJvcGHqFdCCzz",178,0.994413,27,179,1,178,1,1,0,1,1,97,96,82,82,28
"2529",28,"[27]jJHggqIAHBidKpcJvcGHqFdCCzz",174,0.994286,27,175,1,174,1,1,0,1,1,83,82,92,92,28
"2530",29,"[27]jJHggqIAHBidKpcJvcGHqFdCCzz",177,0.994382,27,178,1,177,1,1,0,1,1,91,90,87,87,28
"2531",30,"[27]jJHggqIAHBidKpcJvcGHqFdCCzz",173,0.994253,27,174,1,173,1,1,0,1,1,80,79,94,94,28
"2532",31,"[27]jJHggqIAHBidKpcJvcGHqFdCCzz",172,0.99422,27,173,1,172,1,1,0,1,1,76,75,97,97,28
"2533",32,"[27]jJHggqIAHBidKpcJvcGHqFdCCzz",176,0.99435,27,177,1,176,1,1,0,1,1,89,88,88,88,28
"2534",33,"[27]jJHggqIAHBidKpcJvcGHqFdCCzz",176,0.99435,27,177,1,176,1,1,0,1,1,86,85,91,91,28
"2535",34,"[27]jJHggqIAHBidKpcJvcGHqFdCCzz",174,0.994286,27,175,1,174,1,1,0,1,1,83,82,92,92,28
"2536",35,"[27]jJHggqIAHBidKpcJvcGHqFdCCzz",176,0.99435,27,177,1,176,1,1,0,1,1,89,88,88,88,28
"2537",36,"[27]jJHggqIAHBidKpcJvcGHqFdCCzz",177,0.994382,27,178,1,177,1,1,0,1,1,93,92,85,85,28
"2538",37,"[27]jJHggqIAHBidKpcJvcGHqFdCCzz",174,0.994286,27,175,1,174,1,1,0,1,1,82,81,93,93,28
"2539",38,"[27]jJHggqIAHBidKpcJvcGHqFdCCzz",176,0.99435,27,177,1,176,1,1,0,1,1,91,90,86,86,28
"2540",39,"[27]jJHggqIAHBidKpcJvcGHqFdCCzz",174,0.994286,27,175,1,174,1,1,0,1,1,84,83,91,91,28
"2541",40,"[27]jJHggqIAHBidKpcJvcGHqFdCCzz",176,0.99435,27,177,1,176,1,1,0,1,1,90,89,87,87,28
"2542",41,"[27]jJHggqIAHBidKpcJvcGHqFdCCzz",175,0.994318,27,176,1,175,1,1,0,1,1,86,85,90,90,28
"2543",42,"[27]jJHggqIAHBidKpcJvcGHqFdCCzz",177,0.994382,27,178,1,177,1,1,0,1,1,93,92,85,85,28
"2544",43,"[27]jJHggqIAHBidKpcJvcGHqFdCCzz",179,0.994444,27,180,1,179,1,1,0,1,1,99,98,81,81,28
"2545",44,"[27]jJHggqIAHBidKpcJvcGHqFdCCzz",177,0.994382,27,178,1,177,1,1,0,1,1,93,92,85,85,28
"2546",45,"[27]jJHggqIAHBidKpcJvcGHqFdCCzz",177,0.994382,27,178,1,177,1,1,0,1,1,94,93,84,84,28
"2547",46,"[27]jJHggqIAHBidKpcJvcGHqFdCCzz",175,0.994318,27,176,1,175,1,1,0,1,1,86,85,90,90,28
"2548",47,"[27]jJHggqIAHBidKpcJvcGHqFdCCzz",174,0.994286,27,175,1,174,1,1,0,1,1,81,80,94,94,28
"2549",48,"[27]jJHggqIAHBidKpcJvcGHqFdCCzz",177,0.994382,27,178,1,177,1,1,0,1,1,94,93,84,84,28
"2550",49,"[27]jJHggqIAHBidKpcJvcGHqFdCCzz",176,0.99435,27,177,1,176,1,1,0,1,1,87,86,90,90,28
"2551",50,"[27]jJHggqIAHBidKpcJvcGHqFdCCzz",171,0.994186,27,172,1,171,1,1,0,1,1,73,72,99,99,28
"2552",51,"[27]jJHggqIAHBidKpcJvcGHqFdCCzz",178,0.994413,27,179,1,178,1,1,0,1,1,97,96,82,82,28
"2553",52,"[27]jJHggqIAHBidKpcJvcGHqFdCCzz",175,0.994318,27,176,1,175,1,1,0,1,1,85,84,91,91,28
"2554",53,"[27]jJHggqIAHBidKpcJvcGHqFdCCzz",175,0.994318,27,176,1,175,1,1,0,1,1,85,84,91,91,28
"2555",54,"[27]jJHggqIAHBidKpcJvcGHqFdCCzz",172,0.99422,27,173,1,172,1,1,0,1,1,75,74,98,98,28
"2556",55,"[27]jJHggqIAHBidKpcJvcGHqFdCCzz",174,0.994286,27,175,1,174,1,1,0,1,1,82,81,93,93,28
"2557",56,"[27]jJHggqIAHBidKpcJvcGHqFdCCzz",172,0.99422,27,173,1,172,1,1,0,1,1,77,76,96,96,28
"2558",57,"[27]jJHggqIAHBidKpcJvcGHqFdCCzz",180,0.994475,27,181,1,180,1,1,0,1,1,100,99,81,81,28
"2559",58,"[27]jJHggqIAHBidKpcJvcGHqFdCCzz",179,0.994444,27,180,1,179,1,1,0,1,1,97,96,83,83,28
"2560",59,"[27]jJHggqIAHBidKpcJvcGHqFdCCzz",176,0.99435,27,177,1,176,1,1,0,1,1,90,89,87,87,28
"2561",60,"[27]jJHggqIAHBidKpcJvcGHqFdCCzz",176,0.99435,27,177,1,176,1,1,0,1,1,89,88,88,88,28
"2562",61,"[27]jJHggqIAHBidKpcJvcGHqFdCCzz",173,0.994253,27,174,1,173,1,1,0,1,1,80,79,94,94,28
"2563",62,"[27]jJHggqIAHBidKpcJvcGHqFdCCzz",172,0.99422,27,173,1,172,1,1,0,1,1,75,74,98,98,28
"2564",63,"[27]jJHggqIAHBidKpcJvcGHqFdCCzz",173,0.994253,27,174,1,173,1,1,0,1,1,79,78,95,95,28
"2565",64,"[27]jJHggqIAHBidKpcJvcGHqFdCCzz",176,0.99435,27,177,1,176,1,1,0,1,1,88,87,89,89,28
"2566",65,"[27]jJHggqIAHBidKpcJvcGHqFdCCzz",177,0.994382,27,178,1,177,1,1,0,1,1,92,91,86,86,28
"2567",66,"[27]jJHggqIAHBidKpcJvcGHqFdCCzz",179,0.994444,27,180,1,179,1,1,0,1,1,99,98,81,81,28
"2568",67,"[27]jJHggqIAHBidKpcJvcGHqFdCCzz",174,0.994286,27,175,1,174,1,1,0,1,1,84,83,91,91,28
"2569",68,"[27]jJHggqIAHBidKpcJvcGHqFdCCzz",172,0.99422,27,173,1,172,1,1,0,1,1,77,76,96,96,28
"2570",69,"[27]jJHggqIAHBidKpcJvcGHqFdCCzz",177,0.994382,27,178,1,177,1,1,0,1,1,92,91,86,86,28
"2571",70,"[27]jJHggqIAHBidKpcJvcGHqFdCCzz",177,0.994382,27,178,1,177,1,1,0,1,1,92,91,86,86,28
"2572",71,"[27]jJHggqIAHBidKpcJvcGHqFdCCzz",174,0.994286,27,175,1,174,1,1,0,1,1,84,83,91,91,28
"2573",72,"[27]jJHggqIAHBidKpcJvcGHqFdCCzz",180,0.994475,27,181,1,180,1,1,0,1,1,101,100,80,80,28
"2574",73,"[27]jJHggqIAHBidKpcJvcGHqFdCCzz",174,0.994286,27,175,1,174,1,1,0,1,1,84,83,91,91,28
"2575",74,"[27]jJHggqIAHBidKpcJvcGHqFdCCzz",173,0.994253,27,174,1,173,1,1,0,1,1,78,77,96,96,28
"2576",75,"[27]jJHggqIAHBidKpcJvcGHqFdCCzz",176,0.99435,27,177,1,176,1,1,0,1,1,89,88,88,88,28
"2577",76,"[27]jJHggqIAHBidKpcJvcGHqFdCCzz",176,0.99435,27,177,1,176,1,1,0,1,1,88,87,89,89,28
"2578",77,"[27]jJHggqIAHBidKpcJvcGHqFdCCzz",178,0.994413,27,179,1,178,1,1,0,1,1,95,94,84,84,28
"2579",78,"[27]jJHggqIAHBidKpcJvcGHqFdCCzz",173,0.994253,27,174,1,173,1,1,0,1,1,78,77,96,96,28
"2580",79,"[27]jJHggqIAHBidKpcJvcGHqFdCCzz",177,0.994382,27,178,1,177,1,1,0,1,1,91,90,87,87,28
"2581",80,"[27]jJHggqIAHBidKpcJvcGHqFdCCzz",177,0.994382,27,178,1,177,1,1,0,1,1,89,88,89,89,28
"2582",81,"[27]jJHggqIAHBidKpcJvcGHqFdCCzz",174,0.994286,27,175,1,174,1,1,0,1,1,82,81,93,93,28
"2583",82,"[27]jJHggqIAHBidKpcJvcGHqFdCCzz",173,0.994253,27,174,1,173,1,1,0,1,1,81,80,93,93,28
"2584",83,"[27]jJHggqIAHBidKpcJvcGHqFdCCzz",175,0.994318,27,176,1,175,1,1,0,1,1,86,85,90,90,28
"2585",84,"[27]jJHggqIAHBidKpcJvcGHqFdCCzz",178,0.994413,27,179,1,178,1,1,0,1,1,96,95,83,83,28
"2586",85,"[27]jJHggqIAHBidKpcJvcGHqFdCCzz",174,0.994286,27,175,1,174,1,1,0,1,1,83,82,92,92,28
"2587",86,"[27]jJHggqIAHBidKpcJvcGHqFdCCzz",175,0.994318,27,176,1,175,1,1,0,1,1,85,84,91,91,28
"2588",87,"[27]jJHggqIAHBidKpcJvcGHqFdCCzz",172,0.99422,27,173,1,172,1,1,0,1,1,77,76,96,96,28
"2589",88,"[27]jJHggqIAHBidKpcJvcGHqFdCCzz",178,0.994413,27,179,1,178,1,1,0,1,1,95,94,84,84,28
"2590",89,"[27]jJHggqIAHBidKpcJvcGHqFdCCzz",178,0.994413,27,179,1,178,1,1,0,1,1,96,95,83,83,28
"2591",90,"[27]jJHggqIAHBidKpcJvcGHqFdCCzz",175,0.994318,27,176,1,175,1,1,0,1,1,85,84,91,91,28
"2592",91,"[27]jJHggqIAHBidKpcJvcGHqFdCCzz",178,0.994413,27,179,1,178,1,1,0,1,1,95,94,84,84,28
"2593",92,"[27]jJHggqIAHBidKpcJvcGHqFdCCzz",174,0.994286,27,175,1,174,1,1,0,1,1,82,81,93,93,28
"2594",93,"[27]jJHggqIAHBidKpcJvcGHqFdCCzz",174,0.994286,27,175,1,174,1,1,0,1,1,81,80,94,94,28
"2595",94,"[27]jJHggqIAHBidKpcJvcGHqFdCCzz",176,0.99435,27,177,1,176,1,1,0,1,1,89,88,88,88,28
"2596",95,"[27]jJHggqIAHBidKpcJvcGHqFdCCzz",177,0.994382,27,178,1,177,1,1,0,1,1,94,93,84,84,28
"2597",96,"[27]jJHggqIAHBidKpcJvcGHqFdCCzz",179,0.994444,27,180,1,179,1,1,0,1,1,99,98,81,81,28
"2598",97,"[27]jJHggqIAHBidKpcJvcGHqFdCCzz",174,0.994286,27,175,1,174,1,1,0,1,1,82,81,93,93,28
"2599",98,"[27]jJHggqIAHBidKpcJvcGHqFdCCzz",177,0.994382,27,178,1,177,1,1,0,1,1,92,91,86,86,28
"2600",99,"[27]jJHggqIAHBidKpcJvcGHqFdCCzz",172,0.99422,27,173,1,172,1,1,0,1,1,77,76,96,96,28
"2601",0,"[27]hJHglqIHcdKocJvcGHqxdCAmkEw",163,0.993902,27,164,1,163,1,1,0,1,1,74,73,90,90,29
"2602",1,"[27]hJHglqIHcdKocJvcGHqxdCAmkEw",164,0.993939,27,165,1,164,1,1,0,1,1,76,75,89,89,29
"2603",2,"[27]hJHglqIHcdKocJvcGHqxdCAmkEw",171,0.994186,27,172,1,171,1,1,0,1,1,94,93,78,78,29
"2604",3,"[27]hJHglqIHcdKocJvcGHqxdCAmkEw",163,0.993902,27,164,1,163,1,1,0,1,1,73,72,91,91,29
"2605",4,"[27]hJHglqIHcdKocJvcGHqxdCAmkEw",169,0.994118,27,170,1,169,1,1,0,1,1,90,89,80,80,29
"2606",5,"[27]hJHglqIHcdKocJvcGHqxdCAmkEw",171,0.994186,27,172,1,171,1,1,0,1,1,94,93,78,78,29
"2607",6,"[27]hJHglqIHcdKocJvcGHqxdCAmkEw",166,0.994012,27,167,1,166,1,1,0,1,1,83,82,84,84,29
"2608",7,"[27]hJHglqIHcdKocJvcGHqxdCAmkEw",165,0.993976,27,166,1,165,1,1,0,1,1,80,79,86,86,29
"2609",8,"[27]hJHglqIHcdKocJvcGHqxdCAmkEw",163,0.993902,27,164,1,163,1,1,0,1,1,74,73,90,90,29
"2610",9,"[27]hJHglqIHcdKocJvcGHqxdCAmkEw",162,0.993865,27,163,1,162,1,1,0,1,1,71,70,92,92,29
"2611",10,"[27]hJHglqIHcdKocJvcGHqxdCAmkEw",170,0.994152,27,171,1,170,1,1,0,1,1,94,93,77,77,29
"2612",11,"[27]hJHglqIHcdKocJvcGHqxdCAmkEw",167,0.994048,27,168,1,167,1,1,0,1,1,84,83,84,84,29
"2613",12,"[27]hJHglqIHcdKocJvcGHqxdCAmkEw",171,0.994186,27,172,1,171,1,1,0,1,1,96,95,76,76,29
"2614",13,"[27]hJHglqIHcdKocJvcGHqxdCAmkEw",169,0.994118,27,170,1,169,1,1,0,1,1,90,89,80,80,29
"2615",14,"[27]hJHglqIHcdKocJvcGHqxdCAmkEw",165,0.993976,27,166,1,165,1,1,0,1,1,78,77,88,88,29
"2616",15,"[27]hJHglqIHcdKocJvcGHqxdCAmkEw",168,0.994083,27,169,1,168,1,1,0,1,1,87,86,82,82,29
"2617",16,"[27]hJHglqIHcdKocJvcGHqxdCAmkEw",171,0.994186,27,172,1,171,1,1,0,1,1,93,92,79,79,29
"2618",17,"[27]hJHglqIHcdKocJvcGHqxdCAmkEw",173,0.994253,27,174,1,173,1,1,0,1,1,100,99,74,74,29
"2619",18,"[27]hJHglqIHcdKocJvcGHqxdCAmkEw",172,0.99422,27,173,1,172,1,1,0,1,1,98,97,75,75,29
"2620",19,"[27]hJHglqIHcdKocJvcGHqxdCAmkEw",169,0.994118,27,170,1,169,1,1,0,1,1,91,90,79,79,29
"2621",20,"[27]hJHglqIHcdKocJvcGHqxdCAmkEw",172,0.99422,27,173,1,172,1,1,0,1,1,99,98,74,74,29
"2622",21,"[27]hJHglqIHcdKocJvcGHqxdCAmkEw",169,0.994118,27,170,1,169,1,1,0,1,1,90,89,80,80,29
"2623",22,"[27]hJHglqIHcdKocJvcGHqxdCAmkEw",172,0.99422,27,173,1,172,1,1,0,1,1,95,94,78,78,29
"2624",23,"[27]hJHglqIHcdKocJvcGHqxdCAmkEw",161,0.993827,27,162,1,161,1,1,0,1,1,68,67,94,94,29
"2625",24,"[27]hJHglqIHcdKocJvcGHqxdCAmkEw",168,0.994083,27,169,1,168,1,1,0,1,1,87,86,82,82,29
"2626",25,"[27]hJHglqIHcdKocJvcGHqxdCAmkEw",172,0.99422,27,173,1,172,1,1,0,1,1,98,97,75,75,29
"2627",26,"[27]hJHglqIHcdKocJvcGHqxdCAmkEw",166,0.994012,27,167,1,166,1,1,0,1,1,83,82,84,84,29
"2628",27,"[27]hJHglqIHcdKocJvcGHqxdCAmkEw",172,0.99422,27,173,1,172,1,1,0,1,1,99,98,74,74,29
"2629",28,"[27]hJHglqIHcdKocJvcGHqxdCAmkEw",171,0.994186,27,172,1,171,1,1,0,1,1,95,94,77,77,29
"2630",29,"[27]hJHglqIHcdKocJvcGHqxdCAmkEw",169,0.994118,27,170,1,169,1,1,0,1,1,90,89,80,80,29
"2631",30,"[27]hJHglqIHcdKocJvcGHqxdCAmkEw",167,0.994048,27,168,1,167,1,1,0,1,1,85,84,83,83,29
"2632",31,"[27]hJHglqIHcdKocJvcGHqxdCAmkEw",166,0.994012,27,167,1,166,1,1,0,1,1,81,80,86,86,29
"2633",32,"[27]hJHglqIHcdKocJvcGHqxdCAmkEw",168,0.994083,27,169,1,168,1,1,0,1,1,86,85,83,83,29
"2634",33,"[27]hJHglqIHcdKocJvcGHqxdCAmkEw",165,0.993976,27,166,1,165,1,1,0,1,1,79,78,87,87,29
"2635",34,"[27]hJHglqIHcdKocJvcGHqxdCAmkEw",170,0.994152,27,171,1,170,1,1,0,1,1,89,88,82,82,29
"2636",35,"[27]hJHglqIHcdKocJvcGHqxdCAmkEw",170,0.994152,27,171,1,170,1,1,0,1,1,93,92,78,78,29
"2637",36,"[27]hJHglqIHcdKocJvcGHqxdCAmkEw",165,0.993976,27,166,1,165,1,1,0,1,1,80,79,86,86,29
"2638",37,"[27]hJHglqIHcdKocJvcGHqxdCAmkEw",163,0.993902,27,164,1,163,1,1,0,1,1,74,73,90,90,29
"2639",38,"[27]hJHglqIHcdKocJvcGHqxdCAmkEw",169,0.994118,27,170,1,169,1,1,0,1,1,91,90,79,79,29
"2640",39,"[27]hJHglqIHcdKocJvcGHqxdCAmkEw",168,0.994083,27,169,1,168,1,1,0,1,1,88,87,81,81,29
"2641",40,"[27]hJHglqIHcdKocJvcGHqxdCAmkEw",165,0.993976,27,166,1,165,1,1,0,1,1,77,76,89,89,29
"2642",41,"[27]hJHglqIHcdKocJvcGHqxdCAmkEw",166,0.994012,27,167,1,166,1,1,0,1,1,81,80,86,86,29
"2643",42,"[27]hJHglqIHcdKocJvcGHqxdCAmkEw",167,0.994048,27,168,1,167,1,1,0,1,1,85,84,83,83,29
"2644",43,"[27]hJHglqIHcdKocJvcGHqxdCAmkEw",163,0.993902,27,164,1,163,1,1,0,1,1,73,72,91,91,29
"2645",44,"[27]hJHglqIHcdKocJvcGHqxdCAmkEw",168,0.994083,27,169,1,168,1,1,0,1,1,87,86,82,82,29
"2646",45,"[27]hJHglqIHcdKocJvcGHqxdCAmkEw",168,0.994083,27,169,1,168,1,1,0,1,1,88,87,81,81,29
"2647",46,"[27]hJHglqIHcdKocJvcGHqxdCAmkEw",165,0.993976,27,166,1,165,1,1,0,1,1,79,78,87,87,29
"2648",47,"[27]hJHglqIHcdKocJvcGHqxdCAmkEw",169,0.994118,27,170,1,169,1,1,0,1,1,89,88,81,81,29
"2649",48,"[27]hJHglqIHcdKocJvcGHqxdCAmkEw",167,0.994048,27,168,1,167,1,1,0,1,1,84,83,84,84,29
"2650",49,"[27]hJHglqIHcdKocJvcGHqxdCAmkEw",165,0.993976,27,166,1,165,1,1,0,1,1,78,77,88,88,29
"2651",50,"[27]hJHglqIHcdKocJvcGHqxdCAmkEw",169,0.994118,27,170,1,169,1,1,0,1,1,89,88,81,81,29
"2652",51,"[27]hJHglqIHcdKocJvcGHqxdCAmkEw",167,0.994048,27,168,1,167,1,1,0,1,1,84,83,84,84,29
"2653",52,"[27]hJHglqIHcdKocJvcGHqxdCAmkEw",160,0.993789,27,161,1,160,1,1,0,1,1,64,63,97,97,29
"2654",53,"[27]hJHglqIHcdKocJvcGHqxdCAmkEw",167,0.994048,27,168,1,167,1,1,0,1,1,84,83,84,84,29
"2655",54,"[27]hJHglqIHcdKocJvcGHqxdCAmkEw",163,0.993902,27,164,1,163,1,1,0,1,1,74,73,90,90,29
"2656",55,"[27]hJHglqIHcdKocJvcGHqxdCAmkEw",170,0.994152,27,171,1,170,1,1,0,1,1,90,89,81,81,29
"2657",56,"[27]hJHglqIHcdKocJvcGHqxdCAmkEw",165,0.993976,27,166,1,165,1,1,0,1,1,78,77,88,88,29
"2658",57,"[27]hJHglqIHcdKocJvcGHqxdCAmkEw",172,0.99422,27,173,1,172,1,1,0,1,1,98,97,75,75,29
"2659",58,"[27]hJHglqIHcdKocJvcGHqxdCAmkEw",166,0.994012,27,167,1,166,1,1,0,1,1,83,82,84,84,29
"2660",59,"[27]hJHglqIHcdKocJvcGHqxdCAmkEw",165,0.993976,27,166,1,165,1,1,0,1,1,79,78,87,87,29
"2661",60,"[27]hJHglqIHcdKocJvcGHqxdCAmkEw",166,0.994012,27,167,1,166,1,1,0,1,1,82,81,85,85,29
"2662",61,"[27]hJHglqIHcdKocJvcGHqxdCAmkEw",171,0.994186,27,172,1,171,1,1,0,1,1,94,93,78,78,29
"2663",62,"[27]hJHglqIHcdKocJvcGHqxdCAmkEw",169,0.994118,27,170,1,169,1,1,0,1,1,90,89,80,80,29
"2664",63,"[27]hJHglqIHcdKocJvcGHqxdCAmkEw",166,0.994012,27,167,1,166,1,1,0,1,1,83,82,84,84,29
"2665",64,"[27]hJHglqIHcdKocJvcGHqxdCAmkEw",165,0.993976,27,166,1,165,1,1,0,1,1,78,77,88,88,29
"2666",65,"[27]hJHglqIHcdKocJvcGHqxdCAmkEw",163,0.993902,27,164,1,163,1,1,0,1,1,73,72,91,91,29
"2667",66,"[27]hJHglqIHcdKocJvcGHqxdCAmkEw",169,0.994118,27,170,1,169,1,1,0,1,1,89,88,81,81,29
"2668",67,"[27]hJHglqIHcdKocJvcGHqxdCAmkEw",164,0.993939,27,165,1,164,1,1,0,1,1,76,75,89,89,29
"2669",68,"[27]hJHglqIHcdKocJvcGHqxdCAmkEw",168,0.994083,27,169,1,168,1,1,0,1,1,88,87,81,81,29
"2670",69,"[27]hJHglqIHcdKocJvcGHqxdCAmkEw",164,0.993939,27,165,1,164,1,1,0,1,1,76,75,89,89,29
"2671",70,"[27]hJHglqIHcdKocJvcGHqxdCAmkEw",166,0.994012,27,167,1,166,1,1,0,1,1,81,80,86,86,29
"2672",71,"[27]hJHglqIHcdKocJvcGHqxdCAmkEw",172,0.99422,27,173,1,172,1,1,0,1,1,98,97,75,75,29
"2673",72,"[27]hJHglqIHcdKocJvcGHqxdCAmkEw",165,0.993976,27,166,1,165,1,1,0,1,1,79,78,87,87,29
"2674",73,"[27]hJHglqIHcdKocJvcGHqxdCAmkEw",168,0.994083,27,169,1,168,1,1,0,1,1,87,86,82,82,29
"2675",74,"[27]hJHglqIHcdKocJvcGHqxdCAmkEw",169,0.994118,27,170,1,169,1,1,0,1,1,90,89,80,80,29
"2676",75,"[27]hJHglqIHcdKocJvcGHqxdCAmkEw",166,0.994012,27,167,1,166,1,1,0,1,1,81,80,86,86,29
"2677",76,"[27]hJHglqIHcdKocJvcGHqxdCAmkEw",162,0.993865,27,163,1,162,1,1,0,1,1,71,70,92,92,29
"2678",77,"[27]hJHglqIHcdKocJvcGHqxdCAmkEw",164,0.993939,27,165,1,164,1,1,0,1,1,77,76,88,88,29
"2679",78,"[27]hJHglqIHcdKocJvcGHqxdCAmkEw",167,0.994048,27,168,1,167,1,1,0,1,1,86,85,82,82,29
"2680",79,"[27]hJHglqIHcdKocJvcGHqxdCAmkEw",170,0.994152,27,171,1,170,1,1,0,1,1,93,92,78,78,29
"2681",80,"[27]hJHglqIHcdKocJvcGHqxdCAmkEw",167,0.994048,27,168,1,167,1,1,0,1,1,86,85,82,82,29
"2682",81,"[27]hJHglqIHcdKocJvcGHqxdCAmkEw",160,0.993789,27,161,1,160,1,1,0,1,1,66,65,95,95,29
"2683",82,"[27]hJHglqIHcdKocJvcGHqxdCAmkEw",164,0.993939,27,165,1,164,1,1,0,1,1,77,76,88,88,29
"2684",83,"[27]hJHglqIHcdKocJvcGHqxdCAmkEw",161,0.993827,27,162,1,161,1,1,0,1,1,68,67,94,94,29
"2685",84,"[27]hJHglqIHcdKocJvcGHqxdCAmkEw",168,0.994083,27,169,1,168,1,1,0,1,1,88,87,81,81,29
"2686",85,"[27]hJHglqIHcdKocJvcGHqxdCAmkEw",165,0.993976,27,166,1,165,1,1,0,1,1,78,77,88,88,29
"2687",86,"[27]hJHglqIHcdKocJvcGHqxdCAmkEw",170,0.994152,27,171,1,170,1,1,0,1,1,93,92,78,78,29
"2688",87,"[27]hJHglqIHcdKocJvcGHqxdCAmkEw",167,0.994048,27,168,1,167,1,1,0,1,1,84,83,84,84,29
"2689",88,"[27]hJHglqIHcdKocJvcGHqxdCAmkEw",163,0.993902,27,164,1,163,1,1,0,1,1,74,73,90,90,29
"2690",89,"[27]hJHglqIHcdKocJvcGHqxdCAmkEw",167,0.994048,27,168,1,167,1,1,0,1,1,85,84,83,83,29
"2691",90,"[27]hJHglqIHcdKocJvcGHqxdCAmkEw",170,0.994152,27,171,1,170,1,1,0,1,1,91,90,80,80,29
"2692",91,"[27]hJHglqIHcdKocJvcGHqxdCAmkEw",163,0.993902,27,164,1,163,1,1,0,1,1,74,73,90,90,29
"2693",92,"[27]hJHglqIHcdKocJvcGHqxdCAmkEw",166,0.994012,27,167,1,166,1,1,0,1,1,83,82,84,84,29
"2694",93,"[27]hJHglqIHcdKocJvcGHqxdCAmkEw",167,0.994048,27,168,1,167,1,1,0,1,1,84,83,84,84,29
"2695",94,"[27]hJHglqIHcdKocJvcGHqxdCAmkEw",163,0.993902,27,164,1,163,1,1,0,1,1,75,74,89,89,29
"2696",95,"[27]hJHglqIHcdKocJvcGHqxdCAmkEw",166,0.994012,27,167,1,166,1,1,0,1,1,81,80,86,86,29
"2697",96,"[27]hJHglqIHcdKocJvcGHqxdCAmkEw",164,0.993939,27,165,1,164,1,1,0,1,1,75,74,90,90,29
"2698",97,"[27]hJHglqIHcdKocJvcGHqxdCAmkEw",171,0.994186,27,172,1,171,1,1,0,1,1,96,95,76,76,29
"2699",98,"[27]hJHglqIHcdKocJvcGHqxdCAmkEw",164,0.993939,27,165,1,164,1,1,0,1,1,77,76,88,88,29
"2700",99,"[27]hJHglqIHcdKocJvcGHqxdCAmkEw",171,0.994186,27,172,1,171,1,1,0,1,1,96,95,76,76,29
"2701",0,"[30]zJHglqIqHcidKocJvcGHqFdCKhwbtC",178,0.994413,30,179,1,178,1,1,0,1,1,97,96,82,82,30
"2702",1,"[30]zJHglqIqHcidKocJvcGHqFdCKhwbtC",175,0.994318,30,176,1,175,1,1,0,1,1,86,85,90,90,30
"2703",2,"[30]zJHglqIqHcidKocJvcGHqFdCKhwbtC",171,0.994186,30,172,1,171,1,1,0,1,1,74,73,98,98,30
"2704",3,"[30]zJHglqIqHcidKocJvcGHqFdCKhwbtC",176,0.99435,30,177,1,176,1,1,0,1,1,91,90,86,86,30
"2705",4,"[30]zJHglqIqHcidKocJvcGHqFdCKhwbtC",181,0.994505,30,182,1,181,1,1,0,1,1,107,106,75,75,30
"2706",5,"[30]zJHglqIqHcidKocJvcGHqFdCKhwbtC",177,0.994382,30,178,1,177,1,1,0,1,1,94,93,84,84,30
"2707",6,"[30]zJHglqIqHcidKocJvcGHqFdCKhwbtC",178,0.994413,30,179,1,178,1,1,0,1,1,94,93,85,85,30
"2708",7,"[30]zJHglqIqHcidKocJvcGHqFdCKhwbtC",175,0.994318,30,176,1,175,1,1,0,1,1,86,85,90,90,30
"2709",8,"[30]zJHglqIqHcidKocJvcGHqFdCKhwbtC",174,0.994286,30,175,1,174,1,1,0,1,1,83,82,92,92,30
"2710",9,"[30]zJHglqIqHcidKocJvcGHqFdCKhwbtC",175,0.994318,30,176,1,175,1,1,0,1,1,85,84,91,91,30
"2711",10,"[30]zJHglqIqHcidKocJvcGHqFdCKhwbtC",179,0.994444,30,180,1,179,1,1,0,1,1,101,100,79,79,30
"2712",11,"[30]zJHglqIqHcidKocJvcGHqFdCKhwbtC",173,0.994253,30,174,1,173,1,1,0,1,1,77,76,97,97,30
"2713",12,"[30]zJHglqIqHcidKocJvcGHqFdCKhwbtC",176,0.99435,30,177,1,176,1,1,0,1,1,88,87,89,89,30
"2714",13,"[30]zJHglqIqHcidKocJvcGHqFdCKhwbtC",176,0.99435,30,177,1,176,1,1,0,1,1,89,88,88,88,30
"2715",14,"[30]zJHglqIqHcidKocJvcGHqFdCKhwbtC",175,0.994318,30,176,1,175,1,1,0,1,1,84,83,92,92,30
"2716",15,"[30]zJHglqIqHcidKocJvcGHqFdCKhwbtC",177,0.994382,30,178,1,177,1,1,0,1,1,93,92,85,85,30
"2717",16,"[30]zJHglqIqHcidKocJvcGHqFdCKhwbtC",174,0.994286,30,175,1,174,1,1,0,1,1,84,83,91,91,30
"2718",17,"[30]zJHglqIqHcidKocJvcGHqFdCKhwbtC",176,0.99435,30,177,1,176,1,1,0,1,1,91,90,86,86,30
"2719",18,"[30]zJHglqIqHcidKocJvcGHqFdCKhwbtC",177,0.994382,30,178,1,177,1,1,0,1,1,92,91,86,86,30
"2720",19,"[30]zJHglqIqHcidKocJvcGHqFdCKhwbtC",171,0.994186,30,172,1,171,1,1,0,1,1,74,73,98,98,30
"2721",20,"[30]zJHglqIqHcidKocJvcGHqFdCKhwbtC",173,0.994253,30,174,1,173,1,1,0,1,1,81,80,93,93,30
"2722",21,"[30]zJHglqIqHcidKocJvcGHqFdCKhwbtC",177,0.994382,30,178,1,177,1,1,0,1,1,94,93,84,84,30
"2723",22,"[30]zJHglqIqHcidKocJvcGHqFdCKhwbtC",178,0.994413,30,179,1,178,1,1,0,1,1,96,95,83,83,30
"2724",23,"[30]zJHglqIqHcidKocJvcGHqFdCKhwbtC",178,0.994413,30,179,1,178,1,1,0,1,1,95,94,84,84,30
"2725",24,"[30]zJHglqIqHcidKocJvcGHqFdCKhwbtC",180,0.994475,30,181,1,180,1,1,0,1,1,101,100,80,80,30
"2726",25,"[30]zJHglqIqHcidKocJvcGHqFdCKhwbtC",177,0.994382,30,178,1,177,1,1,0,1,1,92,91,86,86,30
"2727",26,"[30]zJHglqIqHcidKocJvcGHqFdCKhwbtC",174,0.994286,30,175,1,174,1,1,0,1,1,84,83,91,91,30
"2728",27,"[30]zJHglqIqHcidKocJvcGHqFdCKhwbtC",178,0.994413,30,179,1,178,1,1,0,1,1,96,95,83,83,30
"2729",28,"[30]zJHglqIqHcidKocJvcGHqFdCKhwbtC",174,0.994286,30,175,1,174,1,1,0,1,1,84,83,91,91,30
"2730",29,"[30]zJHglqIqHcidKocJvcGHqFdCKhwbtC",176,0.99435,30,177,1,176,1,1,0,1,1,86,85,91,91,30
"2731",30,"[30]zJHglqIqHcidKocJvcGHqFdCKhwbtC",176,0.99435,30,177,1,176,1,1,0,1,1,89,88,88,88,30
"2732",31,"[30]zJHglqIqHcidKocJvcGHqFdCKhwbtC",178,0.994413,30,179,1,178,1,1,0,1,1,97,96,82,82,30
"2733",32,"[30]zJHglqIqHcidKocJvcGHqFdCKhwbtC",181,0.994505,30,182,1,181,1,1,0,1,1,105,104,77,77,30
"2734",33,"[30]zJHglqIqHcidKocJvcGHqFdCKhwbtC",178,0.994413,30,179,1,178,1,1,0,1,1,96,95,83,83,30
"2735",34,"[30]zJHglqIqHcidKocJvcGHqFdCKhwbtC",177,0.994382,30,178,1,177,1,1,0,1,1,92,91,86,86,30
"2736",35,"[30]zJHglqIqHcidKocJvcGHqFdCKhwbtC",173,0.994253,30,174,1,173,1,1,0,1,1,81,80,93,93,30
"2737",36,"[30]zJHglqIqHcidKocJvcGHqFdCKhwbtC",181,0.994505,30,182,1,181,1,1,0,1,1,106,105,76,76,30
"2738",37,"[30]zJHglqIqHcidKocJvcGHqFdCKhwbtC",179,0.994444,30,180,1,179,1,1,0,1,1,96,95,84,84,30
"2739",38,"[30]zJHglqIqHcidKocJvcGHqFdCKhwbtC",174,0.994286,30,175,1,174,1,1,0,1,1,82,81,93,93,30
"2740",39,"[30]zJHglqIqHcidKocJvcGHqFdCKhwbtC",180,0.994475,30,181,1,180,1,1,0,1,1,102,101,79,79,30
"2741",40,"[30]zJHglqIqHcidKocJvcGHqFdCKhwbtC",174,0.994286,30,175,1,174,1,1,0,1,1,82,81,93,93,30
"2742",41,"[30]zJHglqIqHcidKocJvcGHqFdCKhwbtC",173,0.994253,30,174,1,173,1,1,0,1,1,78,77,96,96,30
"2743",42,"[30]zJHglqIqHcidKocJvcGHqFdCKhwbtC",177,0.994382,30,178,1,177,1,1,0,1,1,92,91,86,86,30
"2744",43,"[30]zJHglqIqHcidKocJvcGHqFdCKhwbtC",174,0.994286,30,175,1,174,1,1,0,1,1,80,79,95,95,30
"2745",44,"[30]zJHglqIqHcidKocJvcGHqFdCKhwbtC",177,0.994382,30,178,1,177,1,1,0,1,1,93,92,85,85,30
"2746",45,"[30]zJHglqIqHcidKocJvcGHqFdCKhwbtC",177,0.994382,30,178,1,177,1,1,0,1,1,91,90,87,87,30
"2747",46,"[30]zJHglqIqHcidKocJvcGHqFdCKhwbtC",174,0.994286,30,175,1,174,1,1,0,1,1,82,81,93,93,30
"2748",47,"[30]zJHglqIqHcidKocJvcGHqFdCKhwbtC",176,0.99435,30,177,1,176,1,1,0,1,1,89,88,88,88,30
"2749",48,"[30]zJHglqIqHcidKocJvcGHqFdCKhwbtC",179,0.994444,30,180,1,179,1,1,0,1,1,97,96,83,83,30
"2750",49,"[30]zJHglqIqHcidKocJvcGHqFdCKhwbtC",177,0.994382,30,178,1,177,1,1,0,1,1,92,91,86,86,30
"2751",50,"[30]zJHglqIqHcidKocJvcGHqFdCKhwbtC",178,0.994413,30,179,1,178,1,1,0,1,1,97,96,82,82,30
"2752",51,"[30]zJHglqIqHcidKocJvcGHqFdCKhwbtC",175,0.994318,30,176,1,175,1,1,0,1,1,85,84,91,91,30
"2753",52,"[30]zJHglqIqHcidKocJvcGHqFdCKhwbtC",177,0.994382,30,178,1,177,1,1,0,1,1,91,90,87,87,30
"2754",53,"[30]zJHglqIqHcidKocJvcGHqFdCKhwbtC",179,0.994444,30,180,1,179,1,1,0,1,1,100,99,80,80,30
"2755",54,"[30]zJHglqIqHcidKocJvcGHqFdCKhwbtC",179,0.994444,30,180,1,179,1,1,0,1,1,98,97,82,82,30
"2756",55,"[30]zJHglqIqHcidKocJvcGHqFdCKhwbtC",173,0.994253,30,174,1,173,1,1,0,1,1,79,78,95,95,30
"2757",56,"[30]zJHglqIqHcidKocJvcGHqFdCKhwbtC",174,0.994286,30,175,1,174,1,1,0,1,1,83,82,92,92,30
"2758",57,"[30]zJHglqIqHcidKocJvcGHqFdCKhwbtC",175,0.994318,30,176,1,175,1,1,0,1,1,86,85,90,90,30
"2759",58,"[30]zJHglqIqHcidKocJvcGHqFdCKhwbtC",177,0.994382,30,178,1,177,1,1,0,1,1,91,90,87,87,30
"2760",59,"[30]zJHglqIqHcidKocJvcGHqFdCKhwbtC",176,0.99435,30,177,1,176,1,1,0,1,1,88,87,89,89,30
"2761",60,"[30]zJHglqIqHcidKocJvcGHqFdCKhwbtC",171,0.994186,30,172,1,171,1,1,0,1,1,73,72,99,99,30
"2762",61,"[30]zJHglqIqHcidKocJvcGHqFdCKhwbtC",177,0.994382,30,178,1,177,1,1,0,1,1,92,91,86,86,30
"2763",62,"[30]zJHglqIqHcidKocJvcGHqFdCKhwbtC",177,0.994382,30,178,1,177,1,1,0,1,1,93,92,85,85,30
"2764",63,"[30]zJHglqIqHcidKocJvcGHqFdCKhwbtC",176,0.99435,30,177,1,176,1,1,0,1,1,91,90,86,86,30
"2765",64,"[30]zJHglqIqHcidKocJvcGHqFdCKhwbtC",172,0.99422,30,173,1,172,1,1,0,1,1,75,74,98,98,30
"2766",65,"[30]zJHglqIqHcidKocJvcGHqFdCKhwbtC",175,0.994318,30,176,1,175,1,1,0,1,1,86,85,90,90,30
"2767",66,"[30]zJHglqIqHcidKocJvcGHqFdCKhwbtC",173,0.994253,30,174,1,173,1,1,0,1,1,79,78,95,95,30
"2768",67,"[30]zJHglqIqHcidKocJvcGHqFdCKhwbtC",173,0.994253,30,174,1,173,1,1,0,1,1,81,80,93,93,30
"2769",68,"[30]zJHglqIqHcidKocJvcGHqFdCKhwbtC",172,0.99422,30,173,1,172,1,1,0,1,1,77,76,96,96,30
"2770",69,"[30]zJHglqIqHcidKocJvcGHqFdCKhwbtC",177,0.994382,30,178,1,177,1,1,0,1,1,92,91,86,86,30
"2771",70,"[30]zJHglqIqHcidKocJvcGHqFdCKhwbtC",175,0.994318,30,176,1,175,1,1,0,1,1,85,84,91,91,30
"2772",71,"[30]zJHglqIqHcidKocJvcGHqFdCKhwbtC",181,0.994505,30,182,1,181,1,1,0,1,1,104,103,78,78,30
"2773",72,"[30]zJHglqIqHcidKocJvcGHqFdCKhwbtC",176,0.99435,30,177,1,176,1,1,0,1,1,90,89,87,87,30
"2774",73,"[30]zJHglqIqHcidKocJvcGHqFdCKhwbtC",179,0.994444,30,180,1,179,1,1,0,1,1,99,98,81,81,30
"2775",74,"[30]zJHglqIqHcidKocJvcGHqFdCKhwbtC",176,0.99435,30,177,1,176,1,1,0,1,1,89,88,88,88,30
"2776",75,"[30]zJHglqIqHcidKocJvcGHqFdCKhwbtC",173,0.994253,30,174,1,173,1,1,0,1,1,81,80,93,93,30
"2777",76,"[30]zJHglqIqHcidKocJvcGHqFdCKhwbtC",174,0.994286,30,175,1,174,1,1,0,1,1,84,83,91,91,30
"2778",77,"[30]zJHglqIqHcidKocJvcGHqFdCKhwbtC",177,0.994382,30,178,1,177,1,1,0,1,1,91,90,87,87,30
"2779",78,"[30]zJHglqIqHcidKocJvcGHqFdCKhwbtC",178,0.994413,30,179,1,178,1,1,0,1,1,96,95,83,83,30
"2780",79,"[30]zJHglqIqHcidKocJvcGHqFdCKhwbtC",174,0.994286,30,175,1,174,1,1,0,1,1,83,82,92,92,30
"2781",80,"[30]zJHglqIqHcidKocJvcGHqFdCKhwbtC",172,0.99422,30,173,1,172,1,1,0,1,1,77,76,96,96,30
"2782",81,"[30]zJHglqIqHcidKocJvcGHqFdCKhwbtC",176,0.99435,30,177,1,176,1,1,0,1,1,89,88,88,88,30
"2783",82,"[30]zJHglqIqHcidKocJvcGHqFdCKhwbtC",178,0.994413,30,179,1,178,1,1,0,1,1,97,96,82,82,30
"2784",83,"[30]zJHglqIqHcidKocJvcGHqFdCKhwbtC",175,0.994318,30,176,1,175,1,1,0,1,1,84,83,92,92,30
"2785",84,"[30]zJHglqIqHcidKocJvcGHqFdCKhwbtC",176,0.99435,30,177,1,176,1,1,0,1,1,89,88,88,88,30
"2786",85,"[30]zJHglqIqHcidKocJvcGHqFdCKhwbtC",177,0.994382,30,178,1,177,1,1,0,1,1,93,92,85,85,30
"2787",86,"[30]zJHglqIqHcidKocJvcGHqFdCKhwbtC",179,0.994444,30,180,1,179,1,1,0,1,1,100,99,80,80,30
"2788",87,"[30]zJHglqIqHcidKocJvcGHqFdCKhwbtC",172,0.99422,30,173,1,172,1,1,0,1,1,76,75,97,97,30
"2789",88,"[30]zJHglqIqHcidKocJvcGHqFdCKhwbtC",178,0.994413,30,179,1,178,1,1,0,1,1,97,96,82,82,30
"2790",89,"[30]zJHglqIqHcidKocJvcGHqFdCKhwbtC",176,0.99435,30,177,1,176,1,1,0,1,1,89,88,88,88,30
"2791",90,"[30]zJHglqIqHcidKocJvcGHqFdCKhwbtC",179,0.994444,30,180,1,179,1,1,0,1,1,99,98,81,81,30
"2792",91,"[30]zJHglqIqHcidKocJvcGHqFdCKhwbtC",170,0.994152,30,171,1,170,1,1,0,1,1,68,67,103,103,30
"2793",92,"[30]zJHglqIqHcidKocJvcGHqFdCKhwbtC",173,0.994253,30,174,1,173,1,1,0,1,1,80,79,94,94,30
"2794",93,"[30]zJHglqIqHcidKocJvcGHqFdCKhwbtC",176,0.99435,30,177,1,176,1,1,0,1,1,91,90,86,86,30
"2795",94,"[30]zJHglqIqHcidKocJvcGHqFdCKhwbtC",173,0.994253,30,174,1,173,1,1,0,1,1,81,80,93,93,30
"2796",95,"[30]zJHglqIqHcidKocJvcGHqFdCKhwbtC",174,0.994286,30,175,1,174,1,1,0,1,1,84,83,91,91,30
"2797",96,"[30]zJHglqIqHcidKocJvcGHqFdCKhwbtC",176,0.99435,30,177,1,176,1,1,0,1,1,90,89,87,87,30
"2798",97,"[30]zJHglqIqHcidKocJvcGHqFdCKhwbtC",176,0.99435,30,177,1,176,1,1,0,1,1,89,88,88,88,30
"2799",98,"[30]zJHglqIqHcidKocJvcGHqFdCKhwbtC",179,0.994444,30,180,1,179,1,1,0,1,1,98,97,82,82,30
"2800",99,"[30]zJHglqIqHcidKocJvcGHqFdCKhwbtC",174,0.994286,30,175,1,174,1,1,0,1,1,83,82,92,92,30
"2801",0,"[28]AJHggqBIHcidKpcJvcGHqFdCygdd",175,0.994318,28,176,1,175,1,1,0,1,1,86,85,90,90,31
"2802",1,"[28]AJHggqBIHcidKpcJvcGHqFdCygdd",176,0.99435,28,177,1,176,1,1,0,1,1,89,88,88,88,31
"2803",2,"[28]AJHggqBIHcidKpcJvcGHqFdCygdd",177,0.994382,28,178,1,177,1,1,0,1,1,94,93,84,84,31
"2804",3,"[28]AJHggqBIHcidKpcJvcGHqFdCygdd",178,0.994413,28,179,1,178,1,1,0,1,1,94,93,85,85,31
"2805",4,"[28]AJHggqBIHcidKpcJvcGHqFdCygdd",173,0.994253,28,174,1,173,1,1,0,1,1,81,80,93,93,31
"2806",5,"[28]AJHggqBIHcidKpcJvcGHqFdCygdd",173,0.994253,28,174,1,173,1,1,0,1,1,81,80,93,93,31
"2807",6,"[28]AJHggqBIHcidKpcJvcGHqFdCygdd",177,0.994382,28,178,1,177,1,1,0,1,1,93,92,85,85,31
"2808",7,"[28]AJHggqBIHcidKpcJvcGHqFdCygdd",172,0.99422,28,173,1,172,1,1,0,1,1,77,76,96,96,31
"2809",8,"[28]AJHggqBIHcidKpcJvcGHqFdCygdd",174,0.994286,28,175,1,174,1,1,0,1,1,83,82,92,92,31
"2810",9,"[28]AJHggqBIHcidKpcJvcGHqFdCygdd",175,0.994318,28,176,1,175,1,1,0,1,1,83,82,93,93,31
"2811",10,"[28]AJHggqBIHcidKpcJvcGHqFdCygdd",177,0.994382,28,178,1,177,1,1,0,1,1,93,92,85,85,31
"2812",11,"[28]AJHggqBIHcidKpcJvcGHqFdCygdd",180,0.994475,28,181,1,180,1,1,0,1,1,103,102,78,78,31
"2813",12,"[28]AJHggqBIHcidKpcJvcGHqFdCygdd",174,0.994286,28,175,1,174,1,1,0,1,1,84,83,91,91,31
"2814",13,"[28]AJHggqBIHcidKpcJvcGHqFdCygdd",178,0.994413,28,179,1,178,1,1,0,1,1,96,95,83,83,31
"2815",14,"[28]AJHggqBIHcidKpcJvcGHqFdCygdd",179,0.994444,28,180,1,179,1,1,0,1,1,101,100,79,79,31
"2816",15,"[28]AJHggqBIHcidKpcJvcGHqFdCygdd",178,0.994413,28,179,1,178,1,1,0,1,1,94,93,85,85,31
"2817",16,"[28]AJHggqBIHcidKpcJvcGHqFdCygdd",173,0.994253,28,174,1,173,1,1,0,1,1,79,78,95,95,31
"2818",17,"[28]AJHggqBIHcidKpcJvcGHqFdCygdd",177,0.994382,28,178,1,177,1,1,0,1,1,93,92,85,85,31
"2819",18,"[28]AJHggqBIHcidKpcJvcGHqFdCygdd",175,0.994318,28,176,1,175,1,1,0,1,1,85,84,91,91,31
"2820",19,"[28]AJHggqBIHcidKpcJvcGHqFdCygdd",175,0.994318,28,176,1,175,1,1,0,1,1,84,83,92,92,31
"2821",20,"[28]AJHggqBIHcidKpcJvcGHqFdCygdd",175,0.994318,28,176,1,175,1,1,0,1,1,87,86,89,89,31
"2822",21,"[28]AJHggqBIHcidKpcJvcGHqFdCygdd",176,0.99435,28,177,1,176,1,1,0,1,1,88,87,89,89,31
"2823",22,"[28]AJHggqBIHcidKpcJvcGHqFdCygdd",175,0.994318,28,176,1,175,1,1,0,1,1,87,86,89,89,31
"2824",23,"[28]AJHggqBIHcidKpcJvcGHqFdCygdd",177,0.994382,28,178,1,177,1,1,0,1,1,92,91,86,86,31
"2825",24,"[28]AJHggqBIHcidKpcJvcGHqFdCygdd",180,0.994475,28,181,1,180,1,1,0,1,1,102,101,79,79,31
"2826",25,"[28]AJHggqBIHcidKpcJvcGHqFdCygdd",171,0.994186,28,172,1,171,1,1,0,1,1,74,73,98,98,31
"2827",26,"[28]AJHggqBIHcidKpcJvcGHqFdCygdd",181,0.994505,28,182,1,181,1,1,0,1,1,103,102,79,79,31
"2828",27,"[28]AJHggqBIHcidKpcJvcGHqFdCygdd",176,0.99435,28,177,1,176,1,1,0,1,1,89,88,88,88,31
"2829",28,"[28]AJHggqBIHcidKpcJvcGHqFdCygdd",174,0.994286,28,175,1,174,1,1,0,1,1,84,83,91,91,31
"2830",29,"[28]AJHggqBIHcidKpcJvcGHqFdCygdd",175,0.994318,28,176,1,175,1,1,0,1,1,87,86,89,89,31
"2831",30,"[28]AJHggqBIHcidKpcJvcGHqFdCygdd",173,0.994253,28,174,1,173,1,1,0,1,1,79,78,95,95,31
"2832",31,"[28]AJHggqBIHcidKpcJvcGHqFdCygdd",181,0.994505,28,182,1,181,1,1,0,1,1,104,103,78,78,31
"2833",32,"[28]AJHggqBIHcidKpcJvcGHqFdCygdd",177,0.994382,28,178,1,177,1,1,0,1,1,93,92,85,85,31
"2834",33,"[28]AJHggqBIHcidKpcJvcGHqFdCygdd",179,0.994444,28,180,1,179,1,1,0,1,1,99,98,81,81,31
"2835",34,"[28]AJHggqBIHcidKpcJvcGHqFdCygdd",178,0.994413,28,179,1,178,1,1,0,1,1,95,94,84,84,31
"2836",35,"[28]AJHggqBIHcidKpcJvcGHqFdCygdd",173,0.994253,28,174,1,173,1,1,0,1,1,78,77,96,96,31
"2837",36,"[28]AJHggqBIHcidKpcJvcGHqFdCygdd",174,0.994286,28,175,1,174,1,1,0,1,1,82,81,93,93,31
"2838",37,"[28]AJHggqBIHcidKpcJvcGHqFdCygdd",172,0.99422,28,173,1,172,1,1,0,1,1,76,75,97,97,31
"2839",38,"[28]AJHggqBIHcidKpcJvcGHqFdCygdd",175,0.994318,28,176,1,175,1,1,0,1,1,86,85,90,90,31
"2840",39,"[28]AJHggqBIHcidKpcJvcGHqFdCygdd",176,0.99435,28,177,1,176,1,1,0,1,1,88,87,89,89,31
"2841",40,"[28]AJHggqBIHcidKpcJvcGHqFdCygdd",176,0.99435,28,177,1,176,1,1,0,1,1,91,90,86,86,31
"2842",41,"[28]AJHggqBIHcidKpcJvcGHqFdCygdd",175,0.994318,28,176,1,175,1,1,0,1,1,86,85,90,90,31
"2843",42,"[28]AJHggqBIHcidKpcJvcGHqFdCygdd",179,0.994444,28,180,1,179,1,1,0,1,1,101,100,79,79,31
"2844",43,"[28]AJHggqBIHcidKpcJvcGHqFdCygdd",180,0.994475,28,181,1,180,1,1,0,1,1,101,100,80,80,31
"2845",44,"[28]AJHggqBIHcidKpcJvcGHqFdCygdd",179,0.994444,28,180,1,179,1,1,0,1,1,99,98,81,81,31
"2846",45,"[28]AJHggqBIHcidKpcJvcGHqFdCygdd",174,0.994286,28,175,1,174,1,1,0,1,1,84,83,91,91,31
"2847",46,"[28]AJHggqBIHcidKpcJvcGHqFdCygdd",175,0.994318,28,176,1,175,1,1,0,1,1,87,86,89,89,31
"2848",47,"[28]AJHggqBIHcidKpcJvcGHqFdCygdd",175,0.994318,28,176,1,175,1,1,0,1,1,85,84,91,91,31
"2849",48,"[28]AJHggqBIHcidKpcJvcGHqFdCygdd",179,0.994444,28,180,1,179,1,1,0,1,1,99,98,81,81,31
"2850",49,"[28]AJHggqBIHcidKpcJvcGHqFdCygdd",175,0.994318,28,176,1,175,1,1,0,1,1,86,85,90,90,31
"2851",50,"[28]AJHggqBIHcidKpcJvcGHqFdCygdd",174,0.994286,28,175,1,174,1,1,0,1,1,83,82,92,92,31
"2852",51,"[28]AJHggqBIHcidKpcJvcGHqFdCygdd",177,0.994382,28,178,1,177,1,1,0,1,1,92,91,86,86,31
"2853",52,"[28]AJHggqBIHcidKpcJvcGHqFdCygdd",175,0.994318,28,176,1,175,1,1,0,1,1,86,85,90,90,31
"2854",53,"[28]AJHggqBIHcidKpcJvcGHqFdCygdd",170,0.994152,28,171,1,170,1,1,0,1,1,71,70,100,100,31
"2855",54,"[28]AJHggqBIHcidKpcJvcGHqFdCygdd",177,0.994382,28,178,1,177,1,1,0,1,1,92,91,86,86,31
"2856",55,"[28]AJHggqBIHcidKpcJvcGHqFdCygdd",174,0.994286,28,175,1,174,1,1,0,1,1,83,82,92,92,31
"2857",56,"[28]AJHggqBIHcidKpcJvcGHqFdCygdd",174,0.994286,28,175,1,174,1,1,0,1,1,82,81,93,93,31
"2858",57,"[28]AJHggqBIHcidKpcJvcGHqFdCygdd",175,0.994318,28,176,1,175,1,1,0,1,1,84,83,92,92,31
"2859",58,"[28]AJHggqBIHcidKpcJvcGHqFdCygdd",171,0.994186,28,172,1,171,1,1,0,1,1,73,72,99,99,31
"2860",59,"[28]AJHggqBIHcidKpcJvcGHqFdCygdd",176,0.99435,28,177,1,176,1,1,0,1,1,89,88,88,88,31
"2861",60,"[28]AJHggqBIHcidKpcJvcGHqFdCygdd",179,0.994444,28,180,1,179,1,1,0,1,1,99,98,81,81,31
"2862",61,"[28]AJHggqBIHcidKpcJvcGHqFdCygdd",176,0.99435,28,177,1,176,1,1,0,1,1,89,88,88,88,31
"2863",62,"[28]AJHggqBIHcidKpcJvcGHqFdCygdd",177,0.994382,28,178,1,177,1,1,0,1,1,92,91,86,86,31
"2864",63,"[28]AJHggqBIHcidKpcJvcGHqFdCygdd",178,0.994413,28,179,1,178,1,1,0,1,1,97,96,82,82,31
"2865",64,"[28]AJHggqBIHcidKpcJvcGHqFdCygdd",174,0.994286,28,175,1,174,1,1,0,1,1,84,83,91,91,31
"2866",65,"[28]AJHggqBIHcidKpcJvcGHqFdCygdd",175,0.994318,28,176,1,175,1,1,0,1,1,86,85,90,90,31
"2867",66,"[28]AJHggqBIHcidKpcJvcGHqFdCygdd",177,0.994382,28,178,1,177,1,1,0,1,1,90,89,88,88,31
"2868",67,"[28]AJHggqBIHcidKpcJvcGHqFdCygdd",177,0.994382,28,178,1,177,1,1,0,1,1,93,92,85,85,31
"2869",68,"[28]AJHggqBIHcidKpcJvcGHqFdCygdd",177,0.994382,28,178,1,177,1,1,0,1,1,93,92,85,85,31
"2870",69,"[28]AJHggqBIHcidKpcJvcGHqFdCygdd",175,0.994318,28,176,1,175,1,1,0,1,1,87,86,89,89,31
"2871",70,"[28]AJHggqBIHcidKpcJvcGHqFdCygdd",174,0.994286,28,175,1,174,1,1,0,1,1,83,82,92,92,31
"2872",71,"[28]AJHggqBIHcidKpcJvcGHqFdCygdd",175,0.994318,28,176,1,175,1,1,0,1,1,87,86,89,89,31
"2873",72,"[28]AJHggqBIHcidKpcJvcGHqFdCygdd",173,0.994253,28,174,1,173,1,1,0,1,1,81,80,93,93,31
"2874",73,"[28]AJHggqBIHcidKpcJvcGHqFdCygdd",179,0.994444,28,180,1,179,1,1,0,1,1,98,97,82,82,31
"2875",74,"[28]AJHggqBIHcidKpcJvcGHqFdCygdd",179,0.994444,28,180,1,179,1,1,0,1,1,98,97,82,82,31
"2876",75,"[28]AJHggqBIHcidKpcJvcGHqFdCygdd",175,0.994318,28,176,1,175,1,1,0,1,1,85,84,91,91,31
"2877",76,"[28]AJHggqBIHcidKpcJvcGHqFdCygdd",177,0.994382,28,178,1,177,1,1,0,1,1,92,91,86,86,31
"2878",77,"[28]AJHggqBIHcidKpcJvcGHqFdCygdd",177,0.994382,28,178,1,177,1,1,0,1,1,94,93,84,84,31
"2879",78,"[28]AJHggqBIHcidKpcJvcGHqFdCygdd",178,0.994413,28,179,1,178,1,1,0,1,1,95,94,84,84,31
"2880",79,"[28]AJHggqBIHcidKpcJvcGHqFdCygdd",173,0.994253,28,174,1,173,1,1,0,1,1,79,78,95,95,31
"2881",80,"[28]AJHggqBIHcidKpcJvcGHqFdCygdd",174,0.994286,28,175,1,174,1,1,0,1,1,81,80,94,94,31
"2882",81,"[28]AJHggqBIHcidKpcJvcGHqFdCygdd",174,0.994286,28,175,1,174,1,1,0,1,1,83,82,92,92,31
"2883",82,"[28]AJHggqBIHcidKpcJvcGHqFdCygdd",178,0.994413,28,179,1,178,1,1,0,1,1,94,93,85,85,31
"2884",83,"[28]AJHggqBIHcidKpcJvcGHqFdCygdd",178,0.994413,28,179,1,178,1,1,0,1,1,96,95,83,83,31
"2885",84,"[28]AJHggqBIHcidKpcJvcGHqFdCygdd",176,0.99435,28,177,1,176,1,1,0,1,1,88,87,89,89,31
"2886",85,"[28]AJHggqBIHcidKpcJvcGHqFdCygdd",174,0.994286,28,175,1,174,1,1,0,1,1,84,83,91,91,31
"2887",86,"[28]AJHggqBIHcidKpcJvcGHqFdCygdd",175,0.994318,28,176,1,175,1,1,0,1,1,86,85,90,90,31
"2888",87,"[28]AJHggqBIHcidKpcJvcGHqFdCygdd",176,0.99435,28,177,1,176,1,1,0,1,1,90,89,87,87,31
"2889",88,"[28]AJHggqBIHcidKpcJvcGHqFdCygdd",180,0.994475,28,181,1,180,1,1,0,1,1,102,101,79,79,31
"2890",89,"[28]AJHggqBIHcidKpcJvcGHqFdCygdd",177,0.994382,28,178,1,177,1,1,0,1,1,93,92,85,85,31
"2891",90,"[28]AJHggqBIHcidKpcJvcGHqFdCygdd",178,0.994413,28,179,1,178,1,1,0,1,1,97,96,82,82,31
"2892",91,"[28]AJHggqBIHcidKpcJvcGHqFdCygdd",173,0.994253,28,174,1,173,1,1,0,1,1,81,80,93,93,31
"2893",92,"[28]AJHggqBIHcidKpcJvcGHqFdCygdd",173,0.994253,28,174,1,173,1,1,0,1,1,79,78,95,95,31
"2894",93,"[28]AJHggqBIHcidKpcJvcGHqFdCygdd",172,0.99422,28,173,1,172,1,1,0,1,1,75,74,98,98,31
"2895",94,"[28]AJHggqBIHcidKpcJvcGHqFdCygdd",179,0.994444,28,180,1,179,1,1,0,1,1,100,99,80,80,31
"2896",95,"[28]AJHggqBIHcidKpcJvcGHqFdCygdd",172,0.99422,28,173,1,172,1,1,0,1,1,77,76,96,96,31
"2897",96,"[28]AJHggqBIHcidKpcJvcGHqFdCygdd",183,0.994565,28,184,1,183,1,1,0,1,1,112,111,72,72,31
"2898",97,"[28]AJHggqBIHcidKpcJvcGHqFdCygdd",174,0.994286,28,175,1,174,1,1,0,1,1,84,83,91,91,31
"2899",98,"[28]AJHggqBIHcidKpcJvcGHqFdCygdd",174,0.994286,28,175,1,174,1,1,0,1,1,83,82,92,92,31
"2900",99,"[28]AJHggqBIHcidKpcJvcGHqFdCygdd",175,0.994318,28,176,1,175,1,1,0,1,1,87,86,89,89,31
"2901",0,"[33]fJHiqEIeHcdldKocJvcGHqFdCltqwrCdf",179,0.994444,33,180,1,179,1,1,0,1,1,102,101,78,78,32
"2902",1,"[33]fJHiqEIeHcdldKocJvcGHqFdCltqwrCdf",176,0.99435,33,177,1,176,1,1,0,1,1,86,85,91,91,32
"2903",2,"[33]fJHiqEIeHcdldKocJvcGHqFdCltqwrCdf",174,0.994286,33,175,1,174,1,1,0,1,1,83,82,92,92,32
"2904",3,"[33]fJHiqEIeHcdldKocJvcGHqFdCltqwrCdf",180,0.994475,33,181,1,180,1,1,0,1,1,104,103,77,77,32
"2905",4,"[33]fJHiqEIeHcdldKocJvcGHqFdCltqwrCdf",173,0.994253,33,174,1,173,1,1,0,1,1,80,79,94,94,32
"2906",5,"[33]fJHiqEIeHcdldKocJvcGHqFdCltqwrCdf",173,0.994253,33,174,1,173,1,1,0,1,1,80,79,94,94,32
"2907",6,"[33]fJHiqEIeHcdldKocJvcGHqFdCltqwrCdf",179,0.994444,33,180,1,179,1,1,0,1,1,98,97,82,82,32
"2908",7,"[33]fJHiqEIeHcdldKocJvcGHqFdCltqwrCdf",172,0.99422,33,173,1,172,1,1,0,1,1,77,76,96,96,32
"2909",8,"[33]fJHiqEIeHcdldKocJvcGHqFdCltqwrCdf",176,0.99435,33,177,1,176,1,1,0,1,1,91,90,86,86,32
"2910",9,"[33]fJHiqEIeHcdldKocJvcGHqFdCltqwrCdf",178,0.994413,33,179,1,178,1,1,0,1,1,97,96,82,82,32
"2911",10,"[33]fJHiqEIeHcdldKocJvcGHqFdCltqwrCdf",183,0.994565,33,184,1,183,1,1,0,1,1,113,112,71,71,32
"2912",11,"[33]fJHiqEIeHcdldKocJvcGHqFdCltqwrCdf",178,0.994413,33,179,1,178,1,1,0,1,1,97,96,82,82,32
"2913",12,"[33]fJHiqEIeHcdldKocJvcGHqFdCltqwrCdf",175,0.994318,33,176,1,175,1,1,0,1,1,86,85,90,90,32
"2914",13,"[33]fJHiqEIeHcdldKocJvcGHqFdCltqwrCdf",175,0.994318,33,176,1,175,1,1,0,1,1,86,85,90,90,32
"2915",14,"[33]fJHiqEIeHcdldKocJvcGHqFdCltqwrCdf",175,0.994318,33,176,1,175,1,1,0,1,1,87,86,89,89,32
"2916",15,"[33]fJHiqEIeHcdldKocJvcGHqFdCltqwrCdf",175,0.994318,33,176,1,175,1,1,0,1,1,86,85,90,90,32
"2917",16,"[33]fJHiqEIeHcdldKocJvcGHqFdCltqwrCdf",179,0.994444,33,180,1,179,1,1,0,1,1,99,98,81,81,32
"2918",17,"[33]fJHiqEIeHcdldKocJvcGHqFdCltqwrCdf",171,0.994186,33,172,1,171,1,1,0,1,1,74,73,98,98,32
"2919",18,"[33]fJHiqEIeHcdldKocJvcGHqFdCltqwrCdf",180,0.994475,33,181,1,180,1,1,0,1,1,104,103,77,77,32
"2920",19,"[33]fJHiqEIeHcdldKocJvcGHqFdCltqwrCdf",177,0.994382,33,178,1,177,1,1,0,1,1,88,87,90,90,32
"2921",20,"[33]fJHiqEIeHcdldKocJvcGHqFdCltqwrCdf",176,0.99435,33,177,1,176,1,1,0,1,1,92,91,85,85,32
"2922",21,"[33]fJHiqEIeHcdldKocJvcGHqFdCltqwrCdf",175,0.994318,33,176,1,175,1,1,0,1,1,87,86,89,89,32
"2923",22,"[33]fJHiqEIeHcdldKocJvcGHqFdCltqwrCdf",179,0.994444,33,180,1,179,1,1,0,1,1,100,99,80,80,32
"2924",23,"[33]fJHiqEIeHcdldKocJvcGHqFdCltqwrCdf",176,0.99435,33,177,1,176,1,1,0,1,1,92,91,85,85,32
"2925",24,"[33]fJHiqEIeHcdldKocJvcGHqFdCltqwrCdf",175,0.994318,33,176,1,175,1,1,0,1,1,87,86,89,89,32
"2926",25,"[33]fJHiqEIeHcdldKocJvcGHqFdCltqwrCdf",172,0.99422,33,173,1,172,1,1,0,1,1,75,74,98,98,32
"2927",26,"[33]fJHiqEIeHcdldKocJvcGHqFdCltqwrCdf",177,0.994382,33,178,1,177,1,1,0,1,1,94,93,84,84,32
"2928",27,"[33]fJHiqEIeHcdldKocJvcGHqFdCltqwrCdf",173,0.994253,33,174,1,173,1,1,0,1,1,80,79,94,94,32
"2929",28,"[33]fJHiqEIeHcdldKocJvcGHqFdCltqwrCdf",176,0.99435,33,177,1,176,1,1,0,1,1,92,91,85,85,32
"2930",29,"[33]fJHiqEIeHcdldKocJvcGHqFdCltqwrCdf",172,0.99422,33,173,1,172,1,1,0,1,1,77,76,96,96,32
"2931",30,"[33]fJHiqEIeHcdldKocJvcGHqFdCltqwrCdf",180,0.994475,33,181,1,180,1,1,0,1,1,105,104,76,76,32
"2932",31,"[33]fJHiqEIeHcdldKocJvcGHqFdCltqwrCdf",173,0.994253,33,174,1,173,1,1,0,1,1,81,80,93,93,32
"2933",32,"[33]fJHiqEIeHcdldKocJvcGHqFdCltqwrCdf",178,0.994413,33,179,1,178,1,1,0,1,1,97,96,82,82,32
"2934",33,"[33]fJHiqEIeHcdldKocJvcGHqFdCltqwrCdf",173,0.994253,33,174,1,173,1,1,0,1,1,82,81,92,92,32
"2935",34,"[33]fJHiqEIeHcdldKocJvcGHqFdCltqwrCdf",181,0.994505,33,182,1,181,1,1,0,1,1,103,102,79,79,32
"2936",35,"[33]fJHiqEIeHcdldKocJvcGHqFdCltqwrCdf",178,0.994413,33,179,1,178,1,1,0,1,1,96,95,83,83,32
"2937",36,"[33]fJHiqEIeHcdldKocJvcGHqFdCltqwrCdf",180,0.994475,33,181,1,180,1,1,0,1,1,100,99,81,81,32
"2938",37,"[33]fJHiqEIeHcdldKocJvcGHqFdCltqwrCdf",178,0.994413,33,179,1,178,1,1,0,1,1,95,94,84,84,32
"2939",38,"[33]fJHiqEIeHcdldKocJvcGHqFdCltqwrCdf",173,0.994253,33,174,1,173,1,1,0,1,1,79,78,95,95,32
"2940",39,"[33]fJHiqEIeHcdldKocJvcGHqFdCltqwrCdf",179,0.994444,33,180,1,179,1,1,0,1,1,100,99,80,80,32
"2941",40,"[33]fJHiqEIeHcdldKocJvcGHqFdCltqwrCdf",177,0.994382,33,178,1,177,1,1,0,1,1,95,94,83,83,32
"2942",41,"[33]fJHiqEIeHcdldKocJvcGHqFdCltqwrCdf",176,0.99435,33,177,1,176,1,1,0,1,1,87,86,90,90,32
"2943",42,"[33]fJHiqEIeHcdldKocJvcGHqFdCltqwrCdf",179,0.994444,33,180,1,179,1,1,0,1,1,101,100,79,79,32
"2944",43,"[33]fJHiqEIeHcdldKocJvcGHqFdCltqwrCdf",173,0.994253,33,174,1,173,1,1,0,1,1,77,76,97,97,32
"2945",44,"[33]fJHiqEIeHcdldKocJvcGHqFdCltqwrCdf",178,0.994413,33,179,1,178,1,1,0,1,1,97,96,82,82,32
"2946",45,"[33]fJHiqEIeHcdldKocJvcGHqFdCltqwrCdf",179,0.994444,33,180,1,179,1,1,0,1,1,100,99,80,80,32
"2947",46,"[33]fJHiqEIeHcdldKocJvcGHqFdCltqwrCdf",176,0.99435,33,177,1,176,1,1,0,1,1,88,87,89,89,32
"2948",47,"[33]fJHiqEIeHcdldKocJvcGHqFdCltqwrCdf",176,0.99435,33,177,1,176,1,1,0,1,1,90,89,87,87,32
"2949",48,"[33]fJHiqEIeHcdldKocJvcGHqFdCltqwrCdf",179,0.994444,33,180,1,179,1,1,0,1,1,100,99,80,80,32
"2950",49,"[33]fJHiqEIeHcdldKocJvcGHqFdCltqwrCdf",181,0.994505,33,182,1,181,1,1,0,1,1,105,104,77,77,32
"2951",50,"[33]fJHiqEIeHcdldKocJvcGHqFdCltqwrCdf",176,0.99435,33,177,1,176,1,1,0,1,1,90,89,87,87,32
"2952",51,"[33]fJHiqEIeHcdldKocJvcGHqFdCltqwrCdf",176,0.99435,33,177,1,176,1,1,0,1,1,91,90,86,86,32
"2953",52,"[33]fJHiqEIeHcdldKocJvcGHqFdCltqwrCdf",170,0.994152,33,171,1,170,1,1,0,1,1,72,71,99,99,32
"2954",53,"[33]fJHiqEIeHcdldKocJvcGHqFdCltqwrCdf",173,0.994253,33,174,1,173,1,1,0,1,1,81,80,93,93,32
"2955",54,"[33]fJHiqEIeHcdldKocJvcGHqFdCltqwrCdf",174,0.994286,33,175,1,174,1,1,0,1,1,85,84,90,90,32
"2956",55,"[33]fJHiqEIeHcdldKocJvcGHqFdCltqwrCdf",174,0.994286,33,175,1,174,1,1,0,1,1,84,83,91,91,32
"2957",56,"[33]fJHiqEIeHcdldKocJvcGHqFdCltqwrCdf",181,0.994505,33,182,1,181,1,1,0,1,1,108,107,74,74,32
"2958",57,"[33]fJHiqEIeHcdldKocJvcGHqFdCltqwrCdf",177,0.994382,33,178,1,177,1,1,0,1,1,91,90,87,87,32
"2959",58,"[33]fJHiqEIeHcdldKocJvcGHqFdCltqwrCdf",175,0.994318,33,176,1,175,1,1,0,1,1,86,85,90,90,32
"2960",59,"[33]fJHiqEIeHcdldKocJvcGHqFdCltqwrCdf",176,0.99435,33,177,1,176,1,1,0,1,1,89,88,88,88,32
"2961",60,"[33]fJHiqEIeHcdldKocJvcGHqFdCltqwrCdf",173,0.994253,33,174,1,173,1,1,0,1,1,80,79,94,94,32
"2962",61,"[33]fJHiqEIeHcdldKocJvcGHqFdCltqwrCdf",176,0.99435,33,177,1,176,1,1,0,1,1,86,85,91,91,32
"2963",62,"[33]fJHiqEIeHcdldKocJvcGHqFdCltqwrCdf",175,0.994318,33,176,1,175,1,1,0,1,1,88,87,88,88,32
"2964",63,"[33]fJHiqEIeHcdldKocJvcGHqFdCltqwrCdf",174,0.994286,33,175,1,174,1,1,0,1,1,84,83,91,91,32
"2965",64,"[33]fJHiqEIeHcdldKocJvcGHqFdCltqwrCdf",176,0.99435,33,177,1,176,1,1,0,1,1,90,89,87,87,32
"2966",65,"[33]fJHiqEIeHcdldKocJvcGHqFdCltqwrCdf",178,0.994413,33,179,1,178,1,1,0,1,1,96,95,83,83,32
"2967",66,"[33]fJHiqEIeHcdldKocJvcGHqFdCltqwrCdf",175,0.994318,33,176,1,175,1,1,0,1,1,87,86,89,89,32
"2968",67,"[33]fJHiqEIeHcdldKocJvcGHqFdCltqwrCdf",180,0.994475,33,181,1,180,1,1,0,1,1,103,102,78,78,32
"2969",68,"[33]fJHiqEIeHcdldKocJvcGHqFdCltqwrCdf",175,0.994318,33,176,1,175,1,1,0,1,1,87,86,89,89,32
"2970",69,"[33]fJHiqEIeHcdldKocJvcGHqFdCltqwrCdf",172,0.99422,33,173,1,172,1,1,0,1,1,76,75,97,97,32
"2971",70,"[33]fJHiqEIeHcdldKocJvcGHqFdCltqwrCdf",176,0.99435,33,177,1,176,1,1,0,1,1,88,87,89,89,32
"2972",71,"[33]fJHiqEIeHcdldKocJvcGHqFdCltqwrCdf",175,0.994318,33,176,1,175,1,1,0,1,1,88,87,88,88,32
"2973",72,"[33]fJHiqEIeHcdldKocJvcGHqFdCltqwrCdf",177,0.994382,33,178,1,177,1,1,0,1,1,94,93,84,84,32
"2974",73,"[33]fJHiqEIeHcdldKocJvcGHqFdCltqwrCdf",173,0.994253,33,174,1,173,1,1,0,1,1,82,81,92,92,32
"2975",74,"[33]fJHiqEIeHcdldKocJvcGHqFdCltqwrCdf",179,0.994444,33,180,1,179,1,1,0,1,1,99,98,81,81,32
"2976",75,"[33]fJHiqEIeHcdldKocJvcGHqFdCltqwrCdf",178,0.994413,33,179,1,178,1,1,0,1,1,96,95,83,83,32
"2977",76,"[33]fJHiqEIeHcdldKocJvcGHqFdCltqwrCdf",176,0.99435,33,177,1,176,1,1,0,1,1,91,90,86,86,32
"2978",77,"[33]fJHiqEIeHcdldKocJvcGHqFdCltqwrCdf",176,0.99435,33,177,1,176,1,1,0,1,1,91,90,86,86,32
"2979",78,"[33]fJHiqEIeHcdldKocJvcGHqFdCltqwrCdf",173,0.994253,33,174,1,173,1,1,0,1,1,79,78,95,95,32
"2980",79,"[33]fJHiqEIeHcdldKocJvcGHqFdCltqwrCdf",178,0.994413,33,179,1,178,1,1,0,1,1,97,96,82,82,32
"2981",80,"[33]fJHiqEIeHcdldKocJvcGHqFdCltqwrCdf",173,0.994253,33,174,1,173,1,1,0,1,1,80,79,94,94,32
"2982",81,"[33]fJHiqEIeHcdldKocJvcGHqFdCltqwrCdf",172,0.99422,33,173,1,172,1,1,0,1,1,76,75,97,97,32
"2983",82,"[33]fJHiqEIeHcdldKocJvcGHqFdCltqwrCdf",173,0.994253,33,174,1,173,1,1,0,1,1,78,77,96,96,32
"2984",83,"[33]fJHiqEIeHcdldKocJvcGHqFdCltqwrCdf",174,0.994286,33,175,1,174,1,1,0,1,1,84,83,91,91,32
"2985",84,"[33]fJHiqEIeHcdldKocJvcGHqFdCltqwrCdf",178,0.994413,33,179,1,178,1,1,0,1,1,98,97,81,81,32
"2986",85,"[33]fJHiqEIeHcdldKocJvcGHqFdCltqwrCdf",178,0.994413,33,179,1,178,1,1,0,1,1,94,93,85,85,32
"2987",86,"[33]fJHiqEIeHcdldKocJvcGHqFdCltqwrCdf",179,0.994444,33,180,1,179,1,1,0,1,1,100,99,80,80,32
"2988",87,"[33]fJHiqEIeHcdldKocJvcGHqFdCltqwrCdf",177,0.994382,33,178,1,177,1,1,0,1,1,93,92,85,85,32
"2989",88,"[33]fJHiqEIeHcdldKocJvcGHqFdCltqwrCdf",177,0.994382,33,178,1,177,1,1,0,1,1,92,91,86,86,32
"2990",89,"[33]fJHiqEIeHcdldKocJvcGHqFdCltqwrCdf",175,0.994318,33,176,1,175,1,1,0,1,1,87,86,89,89,32
"2991",90,"[33]fJHiqEIeHcdldKocJvcGHqFdCltqwrCdf",177,0.994382,33,178,1,177,1,1,0,1,1,94,93,84,84,32
"2992",91,"[33]fJHiqEIeHcdldKocJvcGHqFdCltqwrCdf",168,0.994083,33,169,1,168,1,1,0,1,1,62,61,107,107,32
"2993",92,"[33]fJHiqEIeHcdldKocJvcGHqFdCltqwrCdf",176,0.99435,33,177,1,176,1,1,0,1,1,92,91,85,85,32
"2994",93,"[33]fJHiqEIeHcdldKocJvcGHqFdCltqwrCdf",170,0.994152,33,171,1,170,1,1,0,1,1,70,69,101,101,32
"2995",94,"[33]fJHiqEIeHcdldKocJvcGHqFdCltqwrCdf",179,0.994444,33,180,1,179,1,1,0,1,1,99,98,81,81,32
"2996",95,"[33]fJHiqEIeHcdldKocJvcGHqFdCltqwrCdf",174,0.994286,33,175,1,174,1,1,0,1,1,85,84,90,90,32
"2997",96,"[33]fJHiqEIeHcdldKocJvcGHqFdCltqwrCdf",180,0.994475,33,181,1,180,1,1,0,1,1,99,98,82,82,32
"2998",97,"[33]fJHiqEIeHcdldKocJvcGHqFdCltqwrCdf",176,0.99435,33,177,1,176,1,1,0,1,1,89,88,88,88,32
"2999",98,"[33]fJHiqEIeHcdldKocJvcGHqFdCltqwrCdf",178,0.994413,33,179,1,178,1,1,0,1,1,94,93,85,85,32
"3000",99,"[33]fJHiqEIeHcdldKocJvcGHqFdCltqwrCdf",175,0.994318,33,176,1,175,1,1,0,1,1,88,87,88,88,32
"3001",0,"[33]hJHggqIGHBidKocJxcGHqFdCIIIjtvGgi",173,0.994253,33,174,1,173,1,1,0,1,1,80,79,94,94,34
"3002",1,"[33]hJHggqIGHBidKocJxcGHqFdCIIIjtvGgi",175,0.994318,33,176,1,175,1,1,0,1,1,85,84,91,91,34
"3003",2,"[33]hJHggqIGHBidKocJxcGHqFdCIIIjtvGgi",174,0.994286,33,175,1,174,1,1,0,1,1,82,81,93,93,34
"3004",3,"[33]hJHggqIGHBidKocJxcGHqFdCIIIjtvGgi",177,0.994382,33,178,1,177,1,1,0,1,1,94,93,84,84,34
"3005",4,"[33]hJHggqIGHBidKocJxcGHqFdCIIIjtvGgi",177,0.994382,33,178,1,177,1,1,0,1,1,93,92,85,85,34
"3006",5,"[33]hJHggqIGHBidKocJxcGHqFdCIIIjtvGgi",176,0.99435,33,177,1,176,1,1,0,1,1,88,87,89,89,34
"3007",6,"[33]hJHggqIGHBidKocJxcGHqFdCIIIjtvGgi",176,0.99435,33,177,1,176,1,1,0,1,1,89,88,88,88,34
"3008",7,"[33]hJHggqIGHBidKocJxcGHqFdCIIIjtvGgi",175,0.994318,33,176,1,175,1,1,0,1,1,86,85,90,90,34
"3009",8,"[33]hJHggqIGHBidKocJxcGHqFdCIIIjtvGgi",174,0.994286,33,175,1,174,1,1,0,1,1,81,80,94,94,34
"3010",9,"[33]hJHggqIGHBidKocJxcGHqFdCIIIjtvGgi",176,0.99435,33,177,1,176,1,1,0,1,1,90,89,87,87,34
"3011",10,"[33]hJHggqIGHBidKocJxcGHqFdCIIIjtvGgi",175,0.994318,33,176,1,175,1,1,0,1,1,85,84,91,91,34
"3012",11,"[33]hJHggqIGHBidKocJxcGHqFdCIIIjtvGgi",178,0.994413,33,179,1,178,1,1,0,1,1,96,95,83,83,34
"3013",12,"[33]hJHggqIGHBidKocJxcGHqFdCIIIjtvGgi",177,0.994382,33,178,1,177,1,1,0,1,1,91,90,87,87,34
"3014",13,"[33]hJHggqIGHBidKocJxcGHqFdCIIIjtvGgi",174,0.994286,33,175,1,174,1,1,0,1,1,81,80,94,94,34
"3015",14,"[33]hJHggqIGHBidKocJxcGHqFdCIIIjtvGgi",176,0.99435,33,177,1,176,1,1,0,1,1,91,90,86,86,34
"3016",15,"[33]hJHggqIGHBidKocJxcGHqFdCIIIjtvGgi",175,0.994318,33,176,1,175,1,1,0,1,1,86,85,90,90,34
"3017",16,"[33]hJHggqIGHBidKocJxcGHqFdCIIIjtvGgi",179,0.994444,33,180,1,179,1,1,0,1,1,99,98,81,81,34
"3018",17,"[33]hJHggqIGHBidKocJxcGHqFdCIIIjtvGgi",177,0.994382,33,178,1,177,1,1,0,1,1,92,91,86,86,34
"3019",18,"[33]hJHggqIGHBidKocJxcGHqFdCIIIjtvGgi",178,0.994413,33,179,1,178,1,1,0,1,1,96,95,83,83,34
"3020",19,"[33]hJHggqIGHBidKocJxcGHqFdCIIIjtvGgi",174,0.994286,33,175,1,174,1,1,0,1,1,82,81,93,93,34
"3021",20,"[33]hJHggqIGHBidKocJxcGHqFdCIIIjtvGgi",179,0.994444,33,180,1,179,1,1,0,1,1,100,99,80,80,34
"3022",21,"[33]hJHggqIGHBidKocJxcGHqFdCIIIjtvGgi",177,0.994382,33,178,1,177,1,1,0,1,1,90,89,88,88,34
"3023",22,"[33]hJHggqIGHBidKocJxcGHqFdCIIIjtvGgi",176,0.99435,33,177,1,176,1,1,0,1,1,90,89,87,87,34
"3024",23,"[33]hJHggqIGHBidKocJxcGHqFdCIIIjtvGgi",180,0.994475,33,181,1,180,1,1,0,1,1,101,100,80,80,34
"3025",24,"[33]hJHggqIGHBidKocJxcGHqFdCIIIjtvGgi",175,0.994318,33,176,1,175,1,1,0,1,1,86,85,90,90,34
"3026",25,"[33]hJHggqIGHBidKocJxcGHqFdCIIIjtvGgi",174,0.994286,33,175,1,174,1,1,0,1,1,83,82,92,92,34
"3027",26,"[33]hJHggqIGHBidKocJxcGHqFdCIIIjtvGgi",174,0.994286,33,175,1,174,1,1,0,1,1,80,79,95,95,34
"3028",27,"[33]hJHggqIGHBidKocJxcGHqFdCIIIjtvGgi",176,0.99435,33,177,1,176,1,1,0,1,1,88,87,89,89,34
"3029",28,"[33]hJHggqIGHBidKocJxcGHqFdCIIIjtvGgi",173,0.994253,33,174,1,173,1,1,0,1,1,80,79,94,94,34
"3030",29,"[33]hJHggqIGHBidKocJxcGHqFdCIIIjtvGgi",174,0.994286,33,175,1,174,1,1,0,1,1,83,82,92,92,34
"3031",30,"[33]hJHggqIGHBidKocJxcGHqFdCIIIjtvGgi",176,0.99435,33,177,1,176,1,1,0,1,1,91,90,86,86,34
"3032",31,"[33]hJHggqIGHBidKocJxcGHqFdCIIIjtvGgi",175,0.994318,33,176,1,175,1,1,0,1,1,85,84,91,91,34
"3033",32,"[33]hJHggqIGHBidKocJxcGHqFdCIIIjtvGgi",178,0.994413,33,179,1,178,1,1,0,1,1,97,96,82,82,34
"3034",33,"[33]hJHggqIGHBidKocJxcGHqFdCIIIjtvGgi",177,0.994382,33,178,1,177,1,1,0,1,1,94,93,84,84,34
"3035",34,"[33]hJHggqIGHBidKocJxcGHqFdCIIIjtvGgi",176,0.99435,33,177,1,176,1,1,0,1,1,89,88,88,88,34
"3036",35,"[33]hJHggqIGHBidKocJxcGHqFdCIIIjtvGgi",175,0.994318,33,176,1,175,1,1,0,1,1,87,86,89,89,34
"3037",36,"[33]hJHggqIGHBidKocJxcGHqFdCIIIjtvGgi",178,0.994413,33,179,1,178,1,1,0,1,1,97,96,82,82,34
"3038",37,"[33]hJHggqIGHBidKocJxcGHqFdCIIIjtvGgi",173,0.994253,33,174,1,173,1,1,0,1,1,79,78,95,95,34
"3039",38,"[33]hJHggqIGHBidKocJxcGHqFdCIIIjtvGgi",175,0.994318,33,176,1,175,1,1,0,1,1,87,86,89,89,34
"3040",39,"[33]hJHggqIGHBidKocJxcGHqFdCIIIjtvGgi",173,0.994253,33,174,1,173,1,1,0,1,1,80,79,94,94,34
"3041",40,"[33]hJHggqIGHBidKocJxcGHqFdCIIIjtvGgi",176,0.99435,33,177,1,176,1,1,0,1,1,91,90,86,86,34
"3042",41,"[33]hJHggqIGHBidKocJxcGHqFdCIIIjtvGgi",174,0.994286,33,175,1,174,1,1,0,1,1,81,80,94,94,34
"3043",42,"[33]hJHggqIGHBidKocJxcGHqFdCIIIjtvGgi",181,0.994505,33,182,1,181,1,1,0,1,1,106,105,76,76,34
"3044",43,"[33]hJHggqIGHBidKocJxcGHqFdCIIIjtvGgi",178,0.994413,33,179,1,178,1,1,0,1,1,92,91,87,87,34
"3045",44,"[33]hJHggqIGHBidKocJxcGHqFdCIIIjtvGgi",177,0.994382,33,178,1,177,1,1,0,1,1,94,93,84,84,34
"3046",45,"[33]hJHggqIGHBidKocJxcGHqFdCIIIjtvGgi",178,0.994413,33,179,1,178,1,1,0,1,1,96,95,83,83,34
"3047",46,"[33]hJHggqIGHBidKocJxcGHqFdCIIIjtvGgi",178,0.994413,33,179,1,178,1,1,0,1,1,96,95,83,83,34
"3048",47,"[33]hJHggqIGHBidKocJxcGHqFdCIIIjtvGgi",176,0.99435,33,177,1,176,1,1,0,1,1,89,88,88,88,34
"3049",48,"[33]hJHggqIGHBidKocJxcGHqFdCIIIjtvGgi",177,0.994382,33,178,1,177,1,1,0,1,1,88,87,90,90,34
"3050",49,"[33]hJHggqIGHBidKocJxcGHqFdCIIIjtvGgi",177,0.994382,33,178,1,177,1,1,0,1,1,91,90,87,87,34
"3051",50,"[33]hJHggqIGHBidKocJxcGHqFdCIIIjtvGgi",176,0.99435,33,177,1,176,1,1,0,1,1,88,87,89,89,34
"3052",51,"[33]hJHggqIGHBidKocJxcGHqFdCIIIjtvGgi",174,0.994286,33,175,1,174,1,1,0,1,1,84,83,91,91,34
"3053",52,"[33]hJHggqIGHBidKocJxcGHqFdCIIIjtvGgi",176,0.99435,33,177,1,176,1,1,0,1,1,89,88,88,88,34
"3054",53,"[33]hJHggqIGHBidKocJxcGHqFdCIIIjtvGgi",177,0.994382,33,178,1,177,1,1,0,1,1,91,90,87,87,34
"3055",54,"[33]hJHggqIGHBidKocJxcGHqFdCIIIjtvGgi",173,0.994253,33,174,1,173,1,1,0,1,1,80,79,94,94,34
"3056",55,"[33]hJHggqIGHBidKocJxcGHqFdCIIIjtvGgi",174,0.994286,33,175,1,174,1,1,0,1,1,83,82,92,92,34
"3057",56,"[33]hJHggqIGHBidKocJxcGHqFdCIIIjtvGgi",177,0.994382,33,178,1,177,1,1,0,1,1,94,93,84,84,34
"3058",57,"[33]hJHggqIGHBidKocJxcGHqFdCIIIjtvGgi",176,0.99435,33,177,1,176,1,1,0,1,1,89,88,88,88,34
"3059",58,"[33]hJHggqIGHBidKocJxcGHqFdCIIIjtvGgi",175,0.994318,33,176,1,175,1,1,0,1,1,84,83,92,92,34
"3060",59,"[33]hJHggqIGHBidKocJxcGHqFdCIIIjtvGgi",176,0.99435,33,177,1,176,1,1,0,1,1,89,88,88,88,34
"3061",60,"[33]hJHggqIGHBidKocJxcGHqFdCIIIjtvGgi",173,0.994253,33,174,1,173,1,1,0,1,1,79,78,95,95,34
"3062",61,"[33]hJHggqIGHBidKocJxcGHqFdCIIIjtvGgi",176,0.99435,33,177,1,176,1,1,0,1,1,89,88,88,88,34
"3063",62,"[33]hJHggqIGHBidKocJxcGHqFdCIIIjtvGgi",174,0.994286,33,175,1,174,1,1,0,1,1,84,83,91,91,34
"3064",63,"[33]hJHggqIGHBidKocJxcGHqFdCIIIjtvGgi",175,0.994318,33,176,1,175,1,1,0,1,1,86,85,90,90,34
"3065",64,"[33]hJHggqIGHBidKocJxcGHqFdCIIIjtvGgi",177,0.994382,33,178,1,177,1,1,0,1,1,92,91,86,86,34
"3066",65,"[33]hJHggqIGHBidKocJxcGHqFdCIIIjtvGgi",178,0.994413,33,179,1,178,1,1,0,1,1,96,95,83,83,34
"3067",66,"[33]hJHggqIGHBidKocJxcGHqFdCIIIjtvGgi",178,0.994413,33,179,1,178,1,1,0,1,1,97,96,82,82,34
"3068",67,"[33]hJHggqIGHBidKocJxcGHqFdCIIIjtvGgi",178,0.994413,33,179,1,178,1,1,0,1,1,96,95,83,83,34
"3069",68,"[33]hJHggqIGHBidKocJxcGHqFdCIIIjtvGgi",172,0.99422,33,173,1,172,1,1,0,1,1,74,73,99,99,34
"3070",69,"[33]hJHggqIGHBidKocJxcGHqFdCIIIjtvGgi",177,0.994382,33,178,1,177,1,1,0,1,1,91,90,87,87,34
"3071",70,"[33]hJHggqIGHBidKocJxcGHqFdCIIIjtvGgi",174,0.994286,33,175,1,174,1,1,0,1,1,83,82,92,92,34
"3072",71,"[33]hJHggqIGHBidKocJxcGHqFdCIIIjtvGgi",177,0.994382,33,178,1,177,1,1,0,1,1,93,92,85,85,34
"3073",72,"[33]hJHggqIGHBidKocJxcGHqFdCIIIjtvGgi",178,0.994413,33,179,1,178,1,1,0,1,1,95,94,84,84,34
"3074",73,"[33]hJHggqIGHBidKocJxcGHqFdCIIIjtvGgi",179,0.994444,33,180,1,179,1,1,0,1,1,100,99,80,80,34
"3075",74,"[33]hJHggqIGHBidKocJxcGHqFdCIIIjtvGgi",172,0.99422,33,173,1,172,1,1,0,1,1,75,74,98,98,34
"3076",75,"[33]hJHggqIGHBidKocJxcGHqFdCIIIjtvGgi",176,0.99435,33,177,1,176,1,1,0,1,1,91,90,86,86,34
"3077",76,"[33]hJHggqIGHBidKocJxcGHqFdCIIIjtvGgi",174,0.994286,33,175,1,174,1,1,0,1,1,82,81,93,93,34
"3078",77,"[33]hJHggqIGHBidKocJxcGHqFdCIIIjtvGgi",179,0.994444,33,180,1,179,1,1,0,1,1,97,96,83,83,34
"3079",78,"[33]hJHggqIGHBidKocJxcGHqFdCIIIjtvGgi",174,0.994286,33,175,1,174,1,1,0,1,1,82,81,93,93,34
"3080",79,"[33]hJHggqIGHBidKocJxcGHqFdCIIIjtvGgi",176,0.99435,33,177,1,176,1,1,0,1,1,89,88,88,88,34
"3081",80,"[33]hJHggqIGHBidKocJxcGHqFdCIIIjtvGgi",178,0.994413,33,179,1,178,1,1,0,1,1,95,94,84,84,34
"3082",81,"[33]hJHggqIGHBidKocJxcGHqFdCIIIjtvGgi",175,0.994318,33,176,1,175,1,1,0,1,1,86,85,90,90,34
"3083",82,"[33]hJHggqIGHBidKocJxcGHqFdCIIIjtvGgi",169,0.994118,33,170,1,169,1,1,0,1,1,67,66,103,103,34
"3084",83,"[33]hJHggqIGHBidKocJxcGHqFdCIIIjtvGgi",177,0.994382,33,178,1,177,1,1,0,1,1,93,92,85,85,34
"3085",84,"[33]hJHggqIGHBidKocJxcGHqFdCIIIjtvGgi",176,0.99435,33,177,1,176,1,1,0,1,1,89,88,88,88,34
"3086",85,"[33]hJHggqIGHBidKocJxcGHqFdCIIIjtvGgi",176,0.99435,33,177,1,176,1,1,0,1,1,88,87,89,89,34
"3087",86,"[33]hJHggqIGHBidKocJxcGHqFdCIIIjtvGgi",177,0.994382,33,178,1,177,1,1,0,1,1,93,92,85,85,34
"3088",87,"[33]hJHggqIGHBidKocJxcGHqFdCIIIjtvGgi",175,0.994318,33,176,1,175,1,1,0,1,1,85,84,91,91,34
"3089",88,"[33]hJHggqIGHBidKocJxcGHqFdCIIIjtvGgi",176,0.99435,33,177,1,176,1,1,0,1,1,88,87,89,89,34
"3090",89,"[33]hJHggqIGHBidKocJxcGHqFdCIIIjtvGgi",176,0.99435,33,177,1,176,1,1,0,1,1,90,89,87,87,34
"3091",90,"[33]hJHggqIGHBidKocJxcGHqFdCIIIjtvGgi",177,0.994382,33,178,1,177,1,1,0,1,1,93,92,85,85,34
"3092",91,"[33]hJHggqIGHBidKocJxcGHqFdCIIIjtvGgi",175,0.994318,33,176,1,175,1,1,0,1,1,86,85,90,90,34
"3093",92,"[33]hJHggqIGHBidKocJxcGHqFdCIIIjtvGgi",176,0.99435,33,177,1,176,1,1,0,1,1,88,87,89,89,34
"3094",93,"[33]hJHggqIGHBidKocJxcGHqFdCIIIjtvGgi",172,0.99422,33,173,1,172,1,1,0,1,1,76,75,97,97,34
"3095",94,"[33]hJHggqIGHBidKocJxcGHqFdCIIIjtvGgi",175,0.994318,33,176,1,175,1,1,0,1,1,85,84,91,91,34
"3096",95,"[33]hJHggqIGHBidKocJxcGHqFdCIIIjtvGgi",178,0.994413,33,179,1,178,1,1,0,1,1,94,93,85,85,34
"3097",96,"[33]hJHggqIGHBidKocJxcGHqFdCIIIjtvGgi",175,0.994318,33,176,1,175,1,1,0,1,1,87,86,89,89,34
"3098",97,"[33]hJHggqIGHBidKocJxcGHqFdCIIIjtvGgi",173,0.994253,33,174,1,173,1,1,0,1,1,79,78,95,95,34
"3099",98,"[33]hJHggqIGHBidKocJxcGHqFdCIIIjtvGgi",175,0.994318,33,176,1,175,1,1,0,1,1,86,85,90,90,34
"3100",99,"[33]hJHggqIGHBidKocJxcGHqFdCIIIjtvGgi",179,0.994444,33,180,1,179,1,1,0,1,1,100,99,80,80,34
"3101",0,"[28]BJHiqIHBCdKocJvcGHqvdCrwulDa",166,0.994012,28,167,1,166,1,1,0,1,1,83,82,84,84,35
"3102",1,"[28]BJHiqIHBCdKocJvcGHqvdCrwulDa",170,0.994152,28,171,1,170,1,1,0,1,1,92,91,79,79,35
"3103",2,"[28]BJHiqIHBCdKocJvcGHqvdCrwulDa",161,0.993827,28,162,1,161,1,1,0,1,1,67,66,95,95,35
"3104",3,"[28]BJHiqIHBCdKocJvcGHqvdCrwulDa",165,0.993976,28,166,1,165,1,1,0,1,1,78,77,88,88,35
"3105",4,"[28]BJHiqIHBCdKocJvcGHqvdCrwulDa",172,0.99422,28,173,1,172,1,1,0,1,1,96,95,77,77,35
"3106",5,"[28]BJHiqIHBCdKocJvcGHqvdCrwulDa",164,0.993939,28,165,1,164,1,1,0,1,1,75,74,90,90,35
"3107",6,"[28]BJHiqIHBCdKocJvcGHqvdCrwulDa",167,0.994048,28,168,1,167,1,1,0,1,1,83,82,85,85,35
"3108",7,"[28]BJHiqIHBCdKocJvcGHqvdCrwulDa",167,0.994048,28,168,1,167,1,1,0,1,1,86,85,82,82,35
"3109",8,"[28]BJHiqIHBCdKocJvcGHqvdCrwulDa",175,0.994318,28,176,1,175,1,1,0,1,1,105,104,71,71,35
"3110",9,"[28]BJHiqIHBCdKocJvcGHqvdCrwulDa",166,0.994012,28,167,1,166,1,1,0,1,1,83,82,84,84,35
"3111",10,"[28]BJHiqIHBCdKocJvcGHqvdCrwulDa",164,0.993939,28,165,1,164,1,1,0,1,1,77,76,88,88,35
"3112",11,"[28]BJHiqIHBCdKocJvcGHqvdCrwulDa",163,0.993902,28,164,1,163,1,1,0,1,1,73,72,91,91,35
"3113",12,"[28]BJHiqIHBCdKocJvcGHqvdCrwulDa",169,0.994118,28,170,1,169,1,1,0,1,1,89,88,81,81,35
"3114",13,"[28]BJHiqIHBCdKocJvcGHqvdCrwulDa",166,0.994012,28,167,1,166,1,1,0,1,1,81,80,86,86,35
"3115",14,"[28]BJHiqIHBCdKocJvcGHqvdCrwulDa",166,0.994012,28,167,1,166,1,1,0,1,1,81,80,86,86,35
"3116",15,"[28]BJHiqIHBCdKocJvcGHqvdCrwulDa",164,0.993939,28,165,1,164,1,1,0,1,1,76,75,89,89,35
"3117",16,"[28]BJHiqIHBCdKocJvcGHqvdCrwulDa",166,0.994012,28,167,1,166,1,1,0,1,1,81,80,86,86,35
"3118",17,"[28]BJHiqIHBCdKocJvcGHqvdCrwulDa",169,0.994118,28,170,1,169,1,1,0,1,1,89,88,81,81,35
"3119",18,"[28]BJHiqIHBCdKocJvcGHqvdCrwulDa",169,0.994118,28,170,1,169,1,1,0,1,1,90,89,80,80,35
"3120",19,"[28]BJHiqIHBCdKocJvcGHqvdCrwulDa",164,0.993939,28,165,1,164,1,1,0,1,1,77,76,88,88,35
"3121",20,"[28]BJHiqIHBCdKocJvcGHqvdCrwulDa",173,0.994253,28,174,1,173,1,1,0,1,1,100,99,74,74,35
"3122",21,"[28]BJHiqIHBCdKocJvcGHqvdCrwulDa",166,0.994012,28,167,1,166,1,1,0,1,1,82,81,85,85,35
"3123",22,"[28]BJHiqIHBCdKocJvcGHqvdCrwulDa",167,0.994048,28,168,1,167,1,1,0,1,1,85,84,83,83,35
"3124",23,"[28]BJHiqIHBCdKocJvcGHqvdCrwulDa",171,0.994186,28,172,1,171,1,1,0,1,1,94,93,78,78,35
"3125",24,"[28]BJHiqIHBCdKocJvcGHqvdCrwulDa",169,0.994118,28,170,1,169,1,1,0,1,1,90,89,80,80,35
"3126",25,"[28]BJHiqIHBCdKocJvcGHqvdCrwulDa",168,0.994083,28,169,1,168,1,1,0,1,1,88,87,81,81,35
"3127",26,"[28]BJHiqIHBCdKocJvcGHqvdCrwulDa",165,0.993976,28,166,1,165,1,1,0,1,1,79,78,87,87,35
"3128",27,"[28]BJHiqIHBCdKocJvcGHqvdCrwulDa",164,0.993939,28,165,1,164,1,1,0,1,1,77,76,88,88,35
"3129",28,"[28]BJHiqIHBCdKocJvcGHqvdCrwulDa",171,0.994186,28,172,1,171,1,1,0,1,1,93,92,79,79,35
"3130",29,"[28]BJHiqIHBCdKocJvcGHqvdCrwulDa",163,0.993902,28,164,1,163,1,1,0,1,1,72,71,92,92,35
"3131",30,"[28]BJHiqIHBCdKocJvcGHqvdCrwulDa",163,0.993902,28,164,1,163,1,1,0,1,1,74,73,90,90,35
"3132",31,"[28]BJHiqIHBCdKocJvcGHqvdCrwulDa",171,0.994186,28,172,1,171,1,1,0,1,1,95,94,77,77,35
"3133",32,"[28]BJHiqIHBCdKocJvcGHqvdCrwulDa",170,0.994152,28,171,1,170,1,1,0,1,1,93,92,78,78,35
"3134",33,"[28]BJHiqIHBCdKocJvcGHqvdCrwulDa",162,0.993865,28,163,1,162,1,1,0,1,1,70,69,93,93,35
"3135",34,"[28]BJHiqIHBCdKocJvcGHqvdCrwulDa",165,0.993976,28,166,1,165,1,1,0,1,1,78,77,88,88,35
"3136",35,"[28]BJHiqIHBCdKocJvcGHqvdCrwulDa",166,0.994012,28,167,1,166,1,1,0,1,1,79,78,88,88,35
"3137",36,"[28]BJHiqIHBCdKocJvcGHqvdCrwulDa",168,0.994083,28,169,1,168,1,1,0,1,1,85,84,84,84,35
"3138",37,"[28]BJHiqIHBCdKocJvcGHqvdCrwulDa",169,0.994118,28,170,1,169,1,1,0,1,1,89,88,81,81,35
"3139",38,"[28]BJHiqIHBCdKocJvcGHqvdCrwulDa",167,0.994048,28,168,1,167,1,1,0,1,1,85,84,83,83,35
"3140",39,"[28]BJHiqIHBCdKocJvcGHqvdCrwulDa",167,0.994048,28,168,1,167,1,1,0,1,1,83,82,85,85,35
"3141",40,"[28]BJHiqIHBCdKocJvcGHqvdCrwulDa",168,0.994083,28,169,1,168,1,1,0,1,1,88,87,81,81,35
"3142",41,"[28]BJHiqIHBCdKocJvcGHqvdCrwulDa",167,0.994048,28,168,1,167,1,1,0,1,1,85,84,83,83,35
"3143",42,"[28]BJHiqIHBCdKocJvcGHqvdCrwulDa",167,0.994048,28,168,1,167,1,1,0,1,1,85,84,83,83,35
"3144",43,"[28]BJHiqIHBCdKocJvcGHqvdCrwulDa",165,0.993976,28,166,1,165,1,1,0,1,1,79,78,87,87,35
"3145",44,"[28]BJHiqIHBCdKocJvcGHqvdCrwulDa",164,0.993939,28,165,1,164,1,1,0,1,1,76,75,89,89,35
"3146",45,"[28]BJHiqIHBCdKocJvcGHqvdCrwulDa",164,0.993939,28,165,1,164,1,1,0,1,1,76,75,89,89,35
"3147",46,"[28]BJHiqIHBCdKocJvcGHqvdCrwulDa",170,0.994152,28,171,1,170,1,1,0,1,1,94,93,77,77,35
"3148",47,"[28]BJHiqIHBCdKocJvcGHqvdCrwulDa",169,0.994118,28,170,1,169,1,1,0,1,1,88,87,82,82,35
"3149",48,"[28]BJHiqIHBCdKocJvcGHqvdCrwulDa",170,0.994152,28,171,1,170,1,1,0,1,1,94,93,77,77,35
"3150",49,"[28]BJHiqIHBCdKocJvcGHqvdCrwulDa",169,0.994118,28,170,1,169,1,1,0,1,1,90,89,80,80,35
"3151",50,"[28]BJHiqIHBCdKocJvcGHqvdCrwulDa",167,0.994048,28,168,1,167,1,1,0,1,1,85,84,83,83,35
"3152",51,"[28]BJHiqIHBCdKocJvcGHqvdCrwulDa",168,0.994083,28,169,1,168,1,1,0,1,1,87,86,82,82,35
"3153",52,"[28]BJHiqIHBCdKocJvcGHqvdCrwulDa",172,0.99422,28,173,1,172,1,1,0,1,1,99,98,74,74,35
"3154",53,"[28]BJHiqIHBCdKocJvcGHqvdCrwulDa",165,0.993976,28,166,1,165,1,1,0,1,1,78,77,88,88,35
"3155",54,"[28]BJHiqIHBCdKocJvcGHqvdCrwulDa",171,0.994186,28,172,1,171,1,1,0,1,1,96,95,76,76,35
"3156",55,"[28]BJHiqIHBCdKocJvcGHqvdCrwulDa",167,0.994048,28,168,1,167,1,1,0,1,1,86,85,82,82,35
"3157",56,"[28]BJHiqIHBCdKocJvcGHqvdCrwulDa",168,0.994083,28,169,1,168,1,1,0,1,1,88,87,81,81,35
"3158",57,"[28]BJHiqIHBCdKocJvcGHqvdCrwulDa",166,0.994012,28,167,1,166,1,1,0,1,1,83,82,84,84,35
"3159",58,"[28]BJHiqIHBCdKocJvcGHqvdCrwulDa",167,0.994048,28,168,1,167,1,1,0,1,1,85,84,83,83,35
"3160",59,"[28]BJHiqIHBCdKocJvcGHqvdCrwulDa",169,0.994118,28,170,1,169,1,1,0,1,1,90,89,80,80,35
"3161",60,"[28]BJHiqIHBCdKocJvcGHqvdCrwulDa",173,0.994253,28,174,1,173,1,1,0,1,1,99,98,75,75,35
"3162",61,"[28]BJHiqIHBCdKocJvcGHqvdCrwulDa",169,0.994118,28,170,1,169,1,1,0,1,1,90,89,80,80,35
"3163",62,"[28]BJHiqIHBCdKocJvcGHqvdCrwulDa",163,0.993902,28,164,1,163,1,1,0,1,1,75,74,89,89,35
"3164",63,"[28]BJHiqIHBCdKocJvcGHqvdCrwulDa",173,0.994253,28,174,1,173,1,1,0,1,1,100,99,74,74,35
"3165",64,"[28]BJHiqIHBCdKocJvcGHqvdCrwulDa",168,0.994083,28,169,1,168,1,1,0,1,1,87,86,82,82,35
"3166",65,"[28]BJHiqIHBCdKocJvcGHqvdCrwulDa",171,0.994186,28,172,1,171,1,1,0,1,1,95,94,77,77,35
"3167",66,"[28]BJHiqIHBCdKocJvcGHqvdCrwulDa",162,0.993865,28,163,1,162,1,1,0,1,1,69,68,94,94,35
"3168",67,"[28]BJHiqIHBCdKocJvcGHqvdCrwulDa",164,0.993939,28,165,1,164,1,1,0,1,1,77,76,88,88,35
"3169",68,"[28]BJHiqIHBCdKocJvcGHqvdCrwulDa",168,0.994083,28,169,1,168,1,1,0,1,1,88,87,81,81,35
"3170",69,"[28]BJHiqIHBCdKocJvcGHqvdCrwulDa",163,0.993902,28,164,1,163,1,1,0,1,1,75,74,89,89,35
"3171",70,"[28]BJHiqIHBCdKocJvcGHqvdCrwulDa",171,0.994186,28,172,1,171,1,1,0,1,1,95,94,77,77,35
"3172",71,"[28]BJHiqIHBCdKocJvcGHqvdCrwulDa",165,0.993976,28,166,1,165,1,1,0,1,1,79,78,87,87,35
"3173",72,"[28]BJHiqIHBCdKocJvcGHqvdCrwulDa",167,0.994048,28,168,1,167,1,1,0,1,1,85,84,83,83,35
"3174",73,"[28]BJHiqIHBCdKocJvcGHqvdCrwulDa",170,0.994152,28,171,1,170,1,1,0,1,1,89,88,82,82,35
"3175",74,"[28]BJHiqIHBCdKocJvcGHqvdCrwulDa",168,0.994083,28,169,1,168,1,1,0,1,1,87,86,82,82,35
"3176",75,"[28]BJHiqIHBCdKocJvcGHqvdCrwulDa",168,0.994083,28,169,1,168,1,1,0,1,1,88,87,81,81,35
"3177",76,"[28]BJHiqIHBCdKocJvcGHqvdCrwulDa",165,0.993976,28,166,1,165,1,1,0,1,1,79,78,87,87,35
"3178",77,"[28]BJHiqIHBCdKocJvcGHqvdCrwulDa",175,0.994318,28,176,1,175,1,1,0,1,1,104,103,72,72,35
"3179",78,"[28]BJHiqIHBCdKocJvcGHqvdCrwulDa",161,0.993827,28,162,1,161,1,1,0,1,1,69,68,93,93,35
"3180",79,"[28]BJHiqIHBCdKocJvcGHqvdCrwulDa",166,0.994012,28,167,1,166,1,1,0,1,1,83,82,84,84,35
"3181",80,"[28]BJHiqIHBCdKocJvcGHqvdCrwulDa",161,0.993827,28,162,1,161,1,1,0,1,1,69,68,93,93,35
"3182",81,"[28]BJHiqIHBCdKocJvcGHqvdCrwulDa",164,0.993939,28,165,1,164,1,1,0,1,1,76,75,89,89,35
"3183",82,"[28]BJHiqIHBCdKocJvcGHqvdCrwulDa",166,0.994012,28,167,1,166,1,1,0,1,1,83,82,84,84,35
"3184",83,"[28]BJHiqIHBCdKocJvcGHqvdCrwulDa",163,0.993902,28,164,1,163,1,1,0,1,1,74,73,90,90,35
"3185",84,"[28]BJHiqIHBCdKocJvcGHqvdCrwulDa",168,0.994083,28,169,1,168,1,1,0,1,1,87,86,82,82,35
"3186",85,"[28]BJHiqIHBCdKocJvcGHqvdCrwulDa",171,0.994186,28,172,1,171,1,1,0,1,1,91,90,81,81,35
"3187",86,"[28]BJHiqIHBCdKocJvcGHqvdCrwulDa",165,0.993976,28,166,1,165,1,1,0,1,1,78,77,88,88,35
"3188",87,"[28]BJHiqIHBCdKocJvcGHqvdCrwulDa",171,0.994186,28,172,1,171,1,1,0,1,1,96,95,76,76,35
"3189",88,"[28]BJHiqIHBCdKocJvcGHqvdCrwulDa",168,0.994083,28,169,1,168,1,1,0,1,1,83,82,86,86,35
"3190",89,"[28]BJHiqIHBCdKocJvcGHqvdCrwulDa",167,0.994048,28,168,1,167,1,1,0,1,1,85,84,83,83,35
"3191",90,"[28]BJHiqIHBCdKocJvcGHqvdCrwulDa",171,0.994186,28,172,1,171,1,1,0,1,1,94,93,78,78,35
"3192",91,"[28]BJHiqIHBCdKocJvcGHqvdCrwulDa",171,0.994186,28,172,1,171,1,1,0,1,1,96,95,76,76,35
"3193",92,"[28]BJHiqIHBCdKocJvcGHqvdCrwulDa",171,0.994186,28,172,1,171,1,1,0,1,1,95,94,77,77,35
"3194",93,"[28]BJHiqIHBCdKocJvcGHqvdCrwulDa",167,0.994048,28,168,1,167,1,1,0,1,1,82,81,86,86,35
"3195",94,"[28]BJHiqIHBCdKocJvcGHqvdCrwulDa",170,0.994152,28,171,1,170,1,1,0,1,1,92,91,79,79,35
"3196",95,"[28]BJHiqIHBCdKocJvcGHqvdCrwulDa",163,0.993902,28,164,1,163,1,1,0,1,1,73,72,91,91,35
"3197",96,"[28]BJHiqIHBCdKocJvcGHqvdCrwulDa",164,0.993939,28,165,1,164,1,1,0,1,1,76,75,89,89,35
"3198",97,"[28]BJHiqIHBCdKocJvcGHqvdCrwulDa",171,0.994186,28,172,1,171,1,1,0,1,1,95,94,77,77,35
"3199",98,"[28]BJHiqIHBCdKocJvcGHqvdCrwulDa",168,0.994083,28,169,1,168,1,1,0,1,1,87,86,82,82,35
"3200",99,"[28]BJHiqIHBCdKocJvcGHqvdCrwulDa",166,0.994012,28,167,1,166,1,1,0,1,1,79,78,88,88,35
"3201",0,"[28]vJHggqIHcdKocJvcGHqvdCxEGFxh",171,0.994186,28,172,1,171,1,1,0,1,1,96,95,76,76,36
"3202",1,"[28]vJHggqIHcdKocJvcGHqvdCxEGFxh",165,0.993976,28,166,1,165,1,1,0,1,1,80,79,86,86,36
"3203",2,"[28]vJHggqIHcdKocJvcGHqvdCxEGFxh",161,0.993827,28,162,1,161,1,1,0,1,1,69,68,93,93,36
"3204",3,"[28]vJHggqIHcdKocJvcGHqvdCxEGFxh",164,0.993939,28,165,1,164,1,1,0,1,1,77,76,88,88,36
"3205",4,"[28]vJHggqIHcdKocJvcGHqvdCxEGFxh",167,0.994048,28,168,1,167,1,1,0,1,1,85,84,83,83,36
"3206",5,"[28]vJHggqIHcdKocJvcGHqvdCxEGFxh",165,0.993976,28,166,1,165,1,1,0,1,1,79,78,87,87,36
"3207",6,"[28]vJHggqIHcdKocJvcGHqvdCxEGFxh",169,0.994118,28,170,1,169,1,1,0,1,1,88,87,82,82,36
"3208",7,"[28]vJHggqIHcdKocJvcGHqvdCxEGFxh",164,0.993939,28,165,1,164,1,1,0,1,1,77,76,88,88,36
"3209",8,"[28]vJHggqIHcdKocJvcGHqvdCxEGFxh",165,0.993976,28,166,1,165,1,1,0,1,1,79,78,87,87,36
"3210",9,"[28]vJHggqIHcdKocJvcGHqvdCxEGFxh",167,0.994048,28,168,1,167,1,1,0,1,1,85,84,83,83,36
"3211",10,"[28]vJHggqIHcdKocJvcGHqvdCxEGFxh",163,0.993902,28,164,1,163,1,1,0,1,1,73,72,91,91,36
"3212",11,"[28]vJHggqIHcdKocJvcGHqvdCxEGFxh",166,0.994012,28,167,1,166,1,1,0,1,1,83,82,84,84,36
"3213",12,"[28]vJHggqIHcdKocJvcGHqvdCxEGFxh",169,0.994118,28,170,1,169,1,1,0,1,1,89,88,81,81,36
"3214",13,"[28]vJHggqIHcdKocJvcGHqvdCxEGFxh",166,0.994012,28,167,1,166,1,1,0,1,1,83,82,84,84,36
"3215",14,"[28]vJHggqIHcdKocJvcGHqvdCxEGFxh",167,0.994048,28,168,1,167,1,1,0,1,1,85,84,83,83,36
"3216",15,"[28]vJHggqIHcdKocJvcGHqvdCxEGFxh",161,0.993827,28,162,1,161,1,1,0,1,1,68,67,94,94,36
"3217",16,"[28]vJHggqIHcdKocJvcGHqvdCxEGFxh",160,0.993789,28,161,1,160,1,1,0,1,1,65,64,96,96,36
"3218",17,"[28]vJHggqIHcdKocJvcGHqvdCxEGFxh",165,0.993976,28,166,1,165,1,1,0,1,1,80,79,86,86,36
"3219",18,"[28]vJHggqIHcdKocJvcGHqvdCxEGFxh",170,0.994152,28,171,1,170,1,1,0,1,1,91,90,80,80,36
"3220",19,"[28]vJHggqIHcdKocJvcGHqvdCxEGFxh",169,0.994118,28,170,1,169,1,1,0,1,1,91,90,79,79,36
"3221",20,"[28]vJHggqIHcdKocJvcGHqvdCxEGFxh",171,0.994186,28,172,1,171,1,1,0,1,1,95,94,77,77,36
"3222",21,"[28]vJHggqIHcdKocJvcGHqvdCxEGFxh",164,0.993939,28,165,1,164,1,1,0,1,1,77,76,88,88,36
"3223",22,"[28]vJHggqIHcdKocJvcGHqvdCxEGFxh",163,0.993902,28,164,1,163,1,1,0,1,1,75,74,89,89,36
"3224",23,"[28]vJHggqIHcdKocJvcGHqvdCxEGFxh",164,0.993939,28,165,1,164,1,1,0,1,1,76,75,89,89,36
"3225",24,"[28]vJHggqIHcdKocJvcGHqvdCxEGFxh",168,0.994083,28,169,1,168,1,1,0,1,1,87,86,82,82,36
"3226",25,"[28]vJHggqIHcdKocJvcGHqvdCxEGFxh",165,0.993976,28,166,1,165,1,1,0,1,1,78,77,88,88,36
"3227",26,"[28]vJHggqIHcdKocJvcGHqvdCxEGFxh",170,0.994152,28,171,1,170,1,1,0,1,1,92,91,79,79,36
"3228",27,"[28]vJHggqIHcdKocJvcGHqvdCxEGFxh",167,0.994048,28,168,1,167,1,1,0,1,1,84,83,84,84,36
"3229",28,"[28]vJHggqIHcdKocJvcGHqvdCxEGFxh",167,0.994048,28,168,1,167,1,1,0,1,1,85,84,83,83,36
"3230",29,"[28]vJHggqIHcdKocJvcGHqvdCxEGFxh",171,0.994186,28,172,1,171,1,1,0,1,1,95,94,77,77,36
"3231",30,"[28]vJHggqIHcdKocJvcGHqvdCxEGFxh",164,0.993939,28,165,1,164,1,1,0,1,1,74,73,91,91,36
"3232",31,"[28]vJHggqIHcdKocJvcGHqvdCxEGFxh",170,0.994152,28,171,1,170,1,1,0,1,1,93,92,78,78,36
"3233",32,"[28]vJHggqIHcdKocJvcGHqvdCxEGFxh",163,0.993902,28,164,1,163,1,1,0,1,1,75,74,89,89,36
"3234",33,"[28]vJHggqIHcdKocJvcGHqvdCxEGFxh",165,0.993976,28,166,1,165,1,1,0,1,1,78,77,88,88,36
"3235",34,"[28]vJHggqIHcdKocJvcGHqvdCxEGFxh",168,0.994083,28,169,1,168,1,1,0,1,1,88,87,81,81,36
"3236",35,"[28]vJHggqIHcdKocJvcGHqvdCxEGFxh",167,0.994048,28,168,1,167,1,1,0,1,1,85,84,83,83,36
"3237",36,"[28]vJHggqIHcdKocJvcGHqvdCxEGFxh",168,0.994083,28,169,1,168,1,1,0,1,1,88,87,81,81,36
"3238",37,"[28]vJHggqIHcdKocJvcGHqvdCxEGFxh",170,0.994152,28,171,1,170,1,1,0,1,1,92,91,79,79,36
"3239",38,"[28]vJHggqIHcdKocJvcGHqvdCxEGFxh",175,0.994318,28,176,1,175,1,1,0,1,1,105,104,71,71,36
"3240",39,"[28]vJHggqIHcdKocJvcGHqvdCxEGFxh",165,0.993976,28,166,1,165,1,1,0,1,1,78,77,88,88,36
"3241",40,"[28]vJHggqIHcdKocJvcGHqvdCxEGFxh",165,0.993976,28,166,1,165,1,1,0,1,1,79,78,87,87,36
"3242",41,"[28]vJHggqIHcdKocJvcGHqvdCxEGFxh",167,0.994048,28,168,1,167,1,1,0,1,1,86,85,82,82,36
"3243",42,"[28]vJHggqIHcdKocJvcGHqvdCxEGFxh",169,0.994118,28,170,1,169,1,1,0,1,1,89,88,81,81,36
"3244",43,"[28]vJHggqIHcdKocJvcGHqvdCxEGFxh",165,0.993976,28,166,1,165,1,1,0,1,1,79,78,87,87,36
"3245",44,"[28]vJHggqIHcdKocJvcGHqvdCxEGFxh",169,0.994118,28,170,1,169,1,1,0,1,1,89,88,81,81,36
"3246",45,"[28]vJHggqIHcdKocJvcGHqvdCxEGFxh",165,0.993976,28,166,1,165,1,1,0,1,1,80,79,86,86,36
"3247",46,"[28]vJHggqIHcdKocJvcGHqvdCxEGFxh",169,0.994118,28,170,1,169,1,1,0,1,1,91,90,79,79,36
"3248",47,"[28]vJHggqIHcdKocJvcGHqvdCxEGFxh",168,0.994083,28,169,1,168,1,1,0,1,1,86,85,83,83,36
"3249",48,"[28]vJHggqIHcdKocJvcGHqvdCxEGFxh",165,0.993976,28,166,1,165,1,1,0,1,1,79,78,87,87,36
"3250",49,"[28]vJHggqIHcdKocJvcGHqvdCxEGFxh",169,0.994118,28,170,1,169,1,1,0,1,1,89,88,81,81,36
"3251",50,"[28]vJHggqIHcdKocJvcGHqvdCxEGFxh",164,0.993939,28,165,1,164,1,1,0,1,1,77,76,88,88,36
"3252",51,"[28]vJHggqIHcdKocJvcGHqvdCxEGFxh",166,0.994012,28,167,1,166,1,1,0,1,1,81,80,86,86,36
"3253",52,"[28]vJHggqIHcdKocJvcGHqvdCxEGFxh",167,0.994048,28,168,1,167,1,1,0,1,1,84,83,84,84,36
"3254",53,"[28]vJHggqIHcdKocJvcGHqvdCxEGFxh",162,0.993865,28,163,1,162,1,1,0,1,1,72,71,91,91,36
"3255",54,"[28]vJHggqIHcdKocJvcGHqvdCxEGFxh",171,0.994186,28,172,1,171,1,1,0,1,1,97,96,75,75,36
"3256",55,"[28]vJHggqIHcdKocJvcGHqvdCxEGFxh",165,0.993976,28,166,1,165,1,1,0,1,1,80,79,86,86,36
"3257",56,"[28]vJHggqIHcdKocJvcGHqvdCxEGFxh",168,0.994083,28,169,1,168,1,1,0,1,1,86,85,83,83,36
"3258",57,"[28]vJHggqIHcdKocJvcGHqvdCxEGFxh",167,0.994048,28,168,1,167,1,1,0,1,1,86,85,82,82,36
"3259",58,"[28]vJHggqIHcdKocJvcGHqvdCxEGFxh",167,0.994048,28,168,1,167,1,1,0,1,1,86,85,82,82,36
"3260",59,"[28]vJHggqIHcdKocJvcGHqvdCxEGFxh",169,0.994118,28,170,1,169,1,1,0,1,1,90,89,80,80,36
"3261",60,"[28]vJHggqIHcdKocJvcGHqvdCxEGFxh",170,0.994152,28,171,1,170,1,1,0,1,1,94,93,77,77,36
"3262",61,"[28]vJHggqIHcdKocJvcGHqvdCxEGFxh",166,0.994012,28,167,1,166,1,1,0,1,1,82,81,85,85,36
"3263",62,"[28]vJHggqIHcdKocJvcGHqvdCxEGFxh",165,0.993976,28,166,1,165,1,1,0,1,1,80,79,86,86,36
"3264",63,"[28]vJHggqIHcdKocJvcGHqvdCxEGFxh",170,0.994152,28,171,1,170,1,1,0,1,1,93,92,78,78,36
"3265",64,"[28]vJHggqIHcdKocJvcGHqvdCxEGFxh",162,0.993865,28,163,1,162,1,1,0,1,1,70,69,93,93,36
"3266",65,"[28]vJHggqIHcdKocJvcGHqvdCxEGFxh",169,0.994118,28,170,1,169,1,1,0,1,1,90,89,80,80,36
"3267",66,"[28]vJHggqIHcdKocJvcGHqvdCxEGFxh",166,0.994012,28,167,1,166,1,1,0,1,1,82,81,85,85,36
"3268",67,"[28]vJHggqIHcdKocJvcGHqvdCxEGFxh",164,0.993939,28,165,1,164,1,1,0,1,1,77,76,88,88,36
"3269",68,"[28]vJHggqIHcdKocJvcGHqvdCxEGFxh",166,0.994012,28,167,1,166,1,1,0,1,1,82,81,85,85,36
"3270",69,"[28]vJHggqIHcdKocJvcGHqvdCxEGFxh",166,0.994012,28,167,1,166,1,1,0,1,1,82,81,85,85,36
"3271",70,"[28]vJHggqIHcdKocJvcGHqvdCxEGFxh",167,0.994048,28,168,1,167,1,1,0,1,1,84,83,84,84,36
"3272",71,"[28]vJHggqIHcdKocJvcGHqvdCxEGFxh",163,0.993902,28,164,1,163,1,1,0,1,1,74,73,90,90,36
"3273",72,"[28]vJHggqIHcdKocJvcGHqvdCxEGFxh",162,0.993865,28,163,1,162,1,1,0,1,1,72,71,91,91,36
"3274",73,"[28]vJHggqIHcdKocJvcGHqvdCxEGFxh",165,0.993976,28,166,1,165,1,1,0,1,1,79,78,87,87,36
"3275",74,"[28]vJHggqIHcdKocJvcGHqvdCxEGFxh",164,0.993939,28,165,1,164,1,1,0,1,1,75,74,90,90,36
"3276",75,"[28]vJHggqIHcdKocJvcGHqvdCxEGFxh",171,0.994186,28,172,1,171,1,1,0,1,1,96,95,76,76,36
"3277",76,"[28]vJHggqIHcdKocJvcGHqvdCxEGFxh",165,0.993976,28,166,1,165,1,1,0,1,1,77,76,89,89,36
"3278",77,"[28]vJHggqIHcdKocJvcGHqvdCxEGFxh",166,0.994012,28,167,1,166,1,1,0,1,1,83,82,84,84,36
"3279",78,"[28]vJHggqIHcdKocJvcGHqvdCxEGFxh",165,0.993976,28,166,1,165,1,1,0,1,1,79,78,87,87,36
"3280",79,"[28]vJHggqIHcdKocJvcGHqvdCxEGFxh",167,0.994048,28,168,1,167,1,1,0,1,1,85,84,83,83,36
"3281",80,"[28]vJHggqIHcdKocJvcGHqvdCxEGFxh",166,0.994012,28,167,1,166,1,1,0,1,1,82,81,85,85,36
"3282",81,"[28]vJHggqIHcdKocJvcGHqvdCxEGFxh",169,0.994118,28,170,1,169,1,1,0,1,1,88,87,82,82,36
"3283",82,"[28]vJHggqIHcdKocJvcGHqvdCxEGFxh",165,0.993976,28,166,1,165,1,1,0,1,1,77,76,89,89,36
"3284",83,"[28]vJHggqIHcdKocJvcGHqvdCxEGFxh",164,0.993939,28,165,1,164,1,1,0,1,1,76,75,89,89,36
"3285",84,"[28]vJHggqIHcdKocJvcGHqvdCxEGFxh",167,0.994048,28,168,1,167,1,1,0,1,1,84,83,84,84,36
"3286",85,"[28]vJHggqIHcdKocJvcGHqvdCxEGFxh",168,0.994083,28,169,1,168,1,1,0,1,1,85,84,84,84,36
"3287",86,"[28]vJHggqIHcdKocJvcGHqvdCxEGFxh",169,0.994118,28,170,1,169,1,1,0,1,1,89,88,81,81,36
"3288",87,"[28]vJHggqIHcdKocJvcGHqvdCxEGFxh",172,0.99422,28,173,1,172,1,1,0,1,1,99,98,74,74,36
"3289",88,"[28]vJHggqIHcdKocJvcGHqvdCxEGFxh",171,0.994186,28,172,1,171,1,1,0,1,1,95,94,77,77,36
"3290",89,"[28]vJHggqIHcdKocJvcGHqvdCxEGFxh",166,0.994012,28,167,1,166,1,1,0,1,1,80,79,87,87,36
"3291",90,"[28]vJHggqIHcdKocJvcGHqvdCxEGFxh",167,0.994048,28,168,1,167,1,1,0,1,1,86,85,82,82,36
"3292",91,"[28]vJHggqIHcdKocJvcGHqvdCxEGFxh",170,0.994152,28,171,1,170,1,1,0,1,1,93,92,78,78,36
"3293",92,"[28]vJHggqIHcdKocJvcGHqvdCxEGFxh",164,0.993939,28,165,1,164,1,1,0,1,1,75,74,90,90,36
"3294",93,"[28]vJHggqIHcdKocJvcGHqvdCxEGFxh",170,0.994152,28,171,1,170,1,1,0,1,1,90,89,81,81,36
"3295",94,"[28]vJHggqIHcdKocJvcGHqvdCxEGFxh",167,0.994048,28,168,1,167,1,1,0,1,1,85,84,83,83,36
"3296",95,"[28]vJHggqIHcdKocJvcGHqvdCxEGFxh",166,0.994012,28,167,1,166,1,1,0,1,1,82,81,85,85,36
"3297",96,"[28]vJHggqIHcdKocJvcGHqvdCxEGFxh",169,0.994118,28,170,1,169,1,1,0,1,1,89,88,81,81,36
"3298",97,"[28]vJHggqIHcdKocJvcGHqvdCxEGFxh",174,0.994286,28,175,1,174,1,1,0,1,1,102,101,73,73,36
"3299",98,"[28]vJHggqIHcdKocJvcGHqvdCxEGFxh",166,0.994012,28,167,1,166,1,1,0,1,1,82,81,85,85,36
"3300",99,"[28]vJHggqIHcdKocJvcGHqvdCxEGFxh",162,0.993865,28,163,1,162,1,1,0,1,1,71,70,92,92,36
"3301",0,"[34]wJHglqIHcnvdKpcJvcGHqvdCszBltyegbD",170,0.994152,34,171,1,170,1,1,0,1,1,92,91,79,79,37
"3302",1,"[34]wJHglqIHcnvdKpcJvcGHqvdCszBltyegbD",166,0.994012,34,167,1,166,1,1,0,1,1,83,82,84,84,37
"3303",2,"[34]wJHglqIHcnvdKpcJvcGHqvdCszBltyegbD",161,0.993827,34,162,1,161,1,1,0,1,1,69,68,93,93,37
"3304",3,"[34]wJHglqIHcnvdKpcJvcGHqvdCszBltyegbD",169,0.994118,34,170,1,169,1,1,0,1,1,87,86,83,83,37
"3305",4,"[34]wJHglqIHcnvdKpcJvcGHqvdCszBltyegbD",161,0.993827,34,162,1,161,1,1,0,1,1,66,65,96,96,37
"3306",5,"[34]wJHglqIHcnvdKpcJvcGHqvdCszBltyegbD",166,0.994012,34,167,1,166,1,1,0,1,1,82,81,85,85,37
"3307",6,"[34]wJHglqIHcnvdKpcJvcGHqvdCszBltyegbD",165,0.993976,34,166,1,165,1,1,0,1,1,79,78,87,87,37
"3308",7,"[34]wJHglqIHcnvdKpcJvcGHqvdCszBltyegbD",168,0.994083,34,169,1,168,1,1,0,1,1,89,88,80,80,37
"3309",8,"[34]wJHglqIHcnvdKpcJvcGHqvdCszBltyegbD",165,0.993976,34,166,1,165,1,1,0,1,1,79,78,87,87,37
"3310",9,"[34]wJHglqIHcnvdKpcJvcGHqvdCszBltyegbD",171,0.994186,34,172,1,171,1,1,0,1,1,96,95,76,76,37
"3311",10,"[34]wJHglqIHcnvdKpcJvcGHqvdCszBltyegbD",168,0.994083,34,169,1,168,1,1,0,1,1,87,86,82,82,37
"3312",11,"[34]wJHglqIHcnvdKpcJvcGHqvdCszBltyegbD",162,0.993865,34,163,1,162,1,1,0,1,1,71,70,92,92,37
"3313",12,"[34]wJHglqIHcnvdKpcJvcGHqvdCszBltyegbD",171,0.994186,34,172,1,171,1,1,0,1,1,96,95,76,76,37
"3314",13,"[34]wJHglqIHcnvdKpcJvcGHqvdCszBltyegbD",172,0.99422,34,173,1,172,1,1,0,1,1,98,97,75,75,37
"3315",14,"[34]wJHglqIHcnvdKpcJvcGHqvdCszBltyegbD",163,0.993902,34,164,1,163,1,1,0,1,1,73,72,91,91,37
"3316",15,"[34]wJHglqIHcnvdKpcJvcGHqvdCszBltyegbD",166,0.994012,34,167,1,166,1,1,0,1,1,83,82,84,84,37
"3317",16,"[34]wJHglqIHcnvdKpcJvcGHqvdCszBltyegbD",165,0.993976,34,166,1,165,1,1,0,1,1,79,78,87,87,37
"3318",17,"[34]wJHglqIHcnvdKpcJvcGHqvdCszBltyegbD",170,0.994152,34,171,1,170,1,1,0,1,1,92,91,79,79,37
"3319",18,"[34]wJHglqIHcnvdKpcJvcGHqvdCszBltyegbD",167,0.994048,34,168,1,167,1,1,0,1,1,86,85,82,82,37
"3320",19,"[34]wJHglqIHcnvdKpcJvcGHqvdCszBltyegbD",173,0.994253,34,174,1,173,1,1,0,1,1,101,100,73,73,37
"3321",20,"[34]wJHglqIHcnvdKpcJvcGHqvdCszBltyegbD",166,0.994012,34,167,1,166,1,1,0,1,1,82,81,85,85,37
"3322",21,"[34]wJHglqIHcnvdKpcJvcGHqvdCszBltyegbD",169,0.994118,34,170,1,169,1,1,0,1,1,90,89,80,80,37
"3323",22,"[34]wJHglqIHcnvdKpcJvcGHqvdCszBltyegbD",167,0.994048,34,168,1,167,1,1,0,1,1,84,83,84,84,37
"3324",23,"[34]wJHglqIHcnvdKpcJvcGHqvdCszBltyegbD",165,0.993976,34,166,1,165,1,1,0,1,1,79,78,87,87,37
"3325",24,"[34]wJHglqIHcnvdKpcJvcGHqvdCszBltyegbD",165,0.993976,34,166,1,165,1,1,0,1,1,80,79,86,86,37
"3326",25,"[34]wJHglqIHcnvdKpcJvcGHqvdCszBltyegbD",164,0.993939,34,165,1,164,1,1,0,1,1,77,76,88,88,37
"3327",26,"[34]wJHglqIHcnvdKpcJvcGHqvdCszBltyegbD",163,0.993902,34,164,1,163,1,1,0,1,1,74,73,90,90,37
"3328",27,"[34]wJHglqIHcnvdKpcJvcGHqvdCszBltyegbD",167,0.994048,34,168,1,167,1,1,0,1,1,85,84,83,83,37
"3329",28,"[34]wJHglqIHcnvdKpcJvcGHqvdCszBltyegbD",168,0.994083,34,169,1,168,1,1,0,1,1,87,86,82,82,37
"3330",29,"[34]wJHglqIHcnvdKpcJvcGHqvdCszBltyegbD",171,0.994186,34,172,1,171,1,1,0,1,1,97,96,75,75,37
"3331",30,"[34]wJHglqIHcnvdKpcJvcGHqvdCszBltyegbD",168,0.994083,34,169,1,168,1,1,0,1,1,89,88,80,80,37
"3332",31,"[34]wJHglqIHcnvdKpcJvcGHqvdCszBltyegbD",167,0.994048,34,168,1,167,1,1,0,1,1,84,83,84,84,37
"3333",32,"[34]wJHglqIHcnvdKpcJvcGHqvdCszBltyegbD",165,0.993976,34,166,1,165,1,1,0,1,1,81,80,85,85,37
"3334",33,"[34]wJHglqIHcnvdKpcJvcGHqvdCszBltyegbD",167,0.994048,34,168,1,167,1,1,0,1,1,85,84,83,83,37
"3335",34,"[34]wJHglqIHcnvdKpcJvcGHqvdCszBltyegbD",167,0.994048,34,168,1,167,1,1,0,1,1,85,84,83,83,37
"3336",35,"[34]wJHglqIHcnvdKpcJvcGHqvdCszBltyegbD",167,0.994048,34,168,1,167,1,1,0,1,1,86,85,82,82,37
"3337",36,"[34]wJHglqIHcnvdKpcJvcGHqvdCszBltyegbD",165,0.993976,34,166,1,165,1,1,0,1,1,80,79,86,86,37
"3338",37,"[34]wJHglqIHcnvdKpcJvcGHqvdCszBltyegbD",167,0.994048,34,168,1,167,1,1,0,1,1,85,84,83,83,37
"3339",38,"[34]wJHglqIHcnvdKpcJvcGHqvdCszBltyegbD",161,0.993827,34,162,1,161,1,1,0,1,1,69,68,93,93,37
"3340",39,"[34]wJHglqIHcnvdKpcJvcGHqvdCszBltyegbD",165,0.993976,34,166,1,165,1,1,0,1,1,78,77,88,88,37
"3341",40,"[34]wJHglqIHcnvdKpcJvcGHqvdCszBltyegbD",169,0.994118,34,170,1,169,1,1,0,1,1,92,91,78,78,37
"3342",41,"[34]wJHglqIHcnvdKpcJvcGHqvdCszBltyegbD",165,0.993976,34,166,1,165,1,1,0,1,1,80,79,86,86,37
"3343",42,"[34]wJHglqIHcnvdKpcJvcGHqvdCszBltyegbD",168,0.994083,34,169,1,168,1,1,0,1,1,89,88,80,80,37
"3344",43,"[34]wJHglqIHcnvdKpcJvcGHqvdCszBltyegbD",167,0.994048,34,168,1,167,1,1,0,1,1,86,85,82,82,37
"3345",44,"[34]wJHglqIHcnvdKpcJvcGHqvdCszBltyegbD",165,0.993976,34,166,1,165,1,1,0,1,1,80,79,86,86,37
"3346",45,"[34]wJHglqIHcnvdKpcJvcGHqvdCszBltyegbD",163,0.993902,34,164,1,163,1,1,0,1,1,75,74,89,89,37
"3347",46,"[34]wJHglqIHcnvdKpcJvcGHqvdCszBltyegbD",166,0.994012,34,167,1,166,1,1,0,1,1,82,81,85,85,37
"3348",47,"[34]wJHglqIHcnvdKpcJvcGHqvdCszBltyegbD",164,0.993939,34,165,1,164,1,1,0,1,1,78,77,87,87,37
"3349",48,"[34]wJHglqIHcnvdKpcJvcGHqvdCszBltyegbD",167,0.994048,34,168,1,167,1,1,0,1,1,82,81,86,86,37
"3350",49,"[34]wJHglqIHcnvdKpcJvcGHqvdCszBltyegbD",165,0.993976,34,166,1,165,1,1,0,1,1,81,80,85,85,37
"3351",50,"[34]wJHglqIHcnvdKpcJvcGHqvdCszBltyegbD",164,0.993939,34,165,1,164,1,1,0,1,1,77,76,88,88,37
"3352",51,"[34]wJHglqIHcnvdKpcJvcGHqvdCszBltyegbD",165,0.993976,34,166,1,165,1,1,0,1,1,80,79,86,86,37
"3353",52,"[34]wJHglqIHcnvdKpcJvcGHqvdCszBltyegbD",162,0.993865,34,163,1,162,1,1,0,1,1,72,71,91,91,37
"3354",53,"[34]wJHglqIHcnvdKpcJvcGHqvdCszBltyegbD",171,0.994186,34,172,1,171,1,1,0,1,1,96,95,76,76,37
"3355",54,"[34]wJHglqIHcnvdKpcJvcGHqvdCszBltyegbD",169,0.994118,34,170,1,169,1,1,0,1,1,91,90,79,79,37
"3356",55,"[34]wJHglqIHcnvdKpcJvcGHqvdCszBltyegbD",163,0.993902,34,164,1,163,1,1,0,1,1,73,72,91,91,37
"3357",56,"[34]wJHglqIHcnvdKpcJvcGHqvdCszBltyegbD",166,0.994012,34,167,1,166,1,1,0,1,1,83,82,84,84,37
"3358",57,"[34]wJHglqIHcnvdKpcJvcGHqvdCszBltyegbD",167,0.994048,34,168,1,167,1,1,0,1,1,84,83,84,84,37
"3359",58,"[34]wJHglqIHcnvdKpcJvcGHqvdCszBltyegbD",167,0.994048,34,168,1,167,1,1,0,1,1,85,84,83,83,37
"3360",59,"[34]wJHglqIHcnvdKpcJvcGHqvdCszBltyegbD",167,0.994048,34,168,1,167,1,1,0,1,1,84,83,84,84,37
"3361",60,"[34]wJHglqIHcnvdKpcJvcGHqvdCszBltyegbD",174,0.994286,34,175,1,174,1,1,0,1,1,105,104,70,70,37
"3362",61,"[34]wJHglqIHcnvdKpcJvcGHqvdCszBltyegbD",167,0.994048,34,168,1,167,1,1,0,1,1,84,83,84,84,37
"3363",62,"[34]wJHglqIHcnvdKpcJvcGHqvdCszBltyegbD",168,0.994083,34,169,1,168,1,1,0,1,1,88,87,81,81,37
"3364",63,"[34]wJHglqIHcnvdKpcJvcGHqvdCszBltyegbD",166,0.994012,34,167,1,166,1,1,0,1,1,82,81,85,85,37
"3365",64,"[34]wJHglqIHcnvdKpcJvcGHqvdCszBltyegbD",167,0.994048,34,168,1,167,1,1,0,1,1,84,83,84,84,37
"3366",65,"[34]wJHglqIHcnvdKpcJvcGHqvdCszBltyegbD",165,0.993976,34,166,1,165,1,1,0,1,1,80,79,86,86,37
"3367",66,"[34]wJHglqIHcnvdKpcJvcGHqvdCszBltyegbD",173,0.994253,34,174,1,173,1,1,0,1,1,102,101,72,72,37
"3368",67,"[34]wJHglqIHcnvdKpcJvcGHqvdCszBltyegbD",168,0.994083,34,169,1,168,1,1,0,1,1,89,88,80,80,37
"3369",68,"[34]wJHglqIHcnvdKpcJvcGHqvdCszBltyegbD",169,0.994118,34,170,1,169,1,1,0,1,1,88,87,82,82,37
"3370",69,"[34]wJHglqIHcnvdKpcJvcGHqvdCszBltyegbD",168,0.994083,34,169,1,168,1,1,0,1,1,88,87,81,81,37
"3371",70,"[34]wJHglqIHcnvdKpcJvcGHqvdCszBltyegbD",164,0.993939,34,165,1,164,1,1,0,1,1,76,75,89,89,37
"3372",71,"[34]wJHglqIHcnvdKpcJvcGHqvdCszBltyegbD",165,0.993976,34,166,1,165,1,1,0,1,1,78,77,88,88,37
"3373",72,"[34]wJHglqIHcnvdKpcJvcGHqvdCszBltyegbD",161,0.993827,34,162,1,161,1,1,0,1,1,68,67,94,94,37
"3374",73,"[34]wJHglqIHcnvdKpcJvcGHqvdCszBltyegbD",164,0.993939,34,165,1,164,1,1,0,1,1,78,77,87,87,37
"3375",74,"[34]wJHglqIHcnvdKpcJvcGHqvdCszBltyegbD",170,0.994152,34,171,1,170,1,1,0,1,1,94,93,77,77,37
"3376",75,"[34]wJHglqIHcnvdKpcJvcGHqvdCszBltyegbD",170,0.994152,34,171,1,170,1,1,0,1,1,94,93,77,77,37
"3377",76,"[34]wJHglqIHcnvdKpcJvcGHqvdCszBltyegbD",167,0.994048,34,168,1,167,1,1,0,1,1,86,85,82,82,37
"3378",77,"[34]wJHglqIHcnvdKpcJvcGHqvdCszBltyegbD",166,0.994012,34,167,1,166,1,1,0,1,1,82,81,85,85,37
"3379",78,"[34]wJHglqIHcnvdKpcJvcGHqvdCszBltyegbD",168,0.994083,34,169,1,168,1,1,0,1,1,87,86,82,82,37
"3380",79,"[34]wJHglqIHcnvdKpcJvcGHqvdCszBltyegbD",162,0.993865,34,163,1,162,1,1,0,1,1,72,71,91,91,37
"3381",80,"[34]wJHglqIHcnvdKpcJvcGHqvdCszBltyegbD",168,0.994083,34,169,1,168,1,1,0,1,1,88,87,81,81,37
"3382",81,"[34]wJHglqIHcnvdKpcJvcGHqvdCszBltyegbD",165,0.993976,34,166,1,165,1,1,0,1,1,80,79,86,86,37
"3383",82,"[34]wJHglqIHcnvdKpcJvcGHqvdCszBltyegbD",169,0.994118,34,170,1,169,1,1,0,1,1,89,88,81,81,37
"3384",83,"[34]wJHglqIHcnvdKpcJvcGHqvdCszBltyegbD",164,0.993939,34,165,1,164,1,1,0,1,1,78,77,87,87,37
"3385",84,"[34]wJHglqIHcnvdKpcJvcGHqvdCszBltyegbD",169,0.994118,34,170,1,169,1,1,0,1,1,91,90,79,79,37
"3386",85,"[34]wJHglqIHcnvdKpcJvcGHqvdCszBltyegbD",164,0.993939,34,165,1,164,1,1,0,1,1,77,76,88,88,37
"3387",86,"[34]wJHglqIHcnvdKpcJvcGHqvdCszBltyegbD",165,0.993976,34,166,1,165,1,1,0,1,1,80,79,86,86,37
"3388",87,"[34]wJHglqIHcnvdKpcJvcGHqvdCszBltyegbD",167,0.994048,34,168,1,167,1,1,0,1,1,85,84,83,83,37
"3389",88,"[34]wJHglqIHcnvdKpcJvcGHqvdCszBltyegbD",170,0.994152,34,171,1,170,1,1,0,1,1,93,92,78,78,37
"3390",89,"[34]wJHglqIHcnvdKpcJvcGHqvdCszBltyegbD",170,0.994152,34,171,1,170,1,1,0,1,1,92,91,79,79,37
"3391",90,"[34]wJHglqIHcnvdKpcJvcGHqvdCszBltyegbD",162,0.993865,34,163,1,162,1,1,0,1,1,71,70,92,92,37
"3392",91,"[34]wJHglqIHcnvdKpcJvcGHqvdCszBltyegbD",169,0.994118,34,170,1,169,1,1,0,1,1,91,90,79,79,37
"3393",92,"[34]wJHglqIHcnvdKpcJvcGHqvdCszBltyegbD",167,0.994048,34,168,1,167,1,1,0,1,1,85,84,83,83,37
"3394",93,"[34]wJHglqIHcnvdKpcJvcGHqvdCszBltyegbD",166,0.994012,34,167,1,166,1,1,0,1,1,83,82,84,84,37
"3395",94,"[34]wJHglqIHcnvdKpcJvcGHqvdCszBltyegbD",166,0.994012,34,167,1,166,1,1,0,1,1,82,81,85,85,37
"3396",95,"[34]wJHglqIHcnvdKpcJvcGHqvdCszBltyegbD",161,0.993827,34,162,1,161,1,1,0,1,1,70,69,92,92,37
"3397",96,"[34]wJHglqIHcnvdKpcJvcGHqvdCszBltyegbD",165,0.993976,34,166,1,165,1,1,0,1,1,79,78,87,87,37
"3398",97,"[34]wJHglqIHcnvdKpcJvcGHqvdCszBltyegbD",165,0.993976,34,166,1,165,1,1,0,1,1,79,78,87,87,37
"3399",98,"[34]wJHglqIHcnvdKpcJvcGHqvdCszBltyegbD",165,0.993976,34,166,1,165,1,1,0,1,1,80,79,86,86,37
"3400",99,"[34]wJHglqIHcnvdKpcJvcGHqvdCszBltyegbD",167,0.994048,34,168,1,167,1,1,0,1,1,86,85,82,82,37
"3401",0,"[28]cJHggqIjHcidKocJvcGHqFdCpHqz",178,0.994413,28,179,1,178,1,1,0,1,1,94,93,85,85,38
"3402",1,"[28]cJHggqIjHcidKocJvcGHqFdCpHqz",174,0.994286,28,175,1,174,1,1,0,1,1,80,79,95,95,38
"3403",2,"[28]cJHggqIjHcidKocJvcGHqFdCpHqz",173,0.994253,28,174,1,173,1,1,0,1,1,79,78,95,95,38
"3404",3,"[28]cJHggqIjHcidKocJvcGHqFdCpHqz",173,0.994253,28,174,1,173,1,1,0,1,1,79,78,95,95,38
"3405",4,"[28]cJHggqIjHcidKocJvcGHqFdCpHqz",171,0.994186,28,172,1,171,1,1,0,1,1,74,73,98,98,38
"3406",5,"[28]cJHggqIjHcidKocJvcGHqFdCpHqz",177,0.994382,28,178,1,177,1,1,0,1,1,90,89,88,88,38
"3407",6,"[28]cJHggqIjHcidKocJvcGHqFdCpHqz",179,0.994444,28,180,1,179,1,1,0,1,1,101,100,79,79,38
"3408",7,"[28]cJHggqIjHcidKocJvcGHqFdCpHqz",179,0.994444,28,180,1,179,1,1,0,1,1,98,97,82,82,38
"3409",8,"[28]cJHggqIjHcidKocJvcGHqFdCpHqz",177,0.994382,28,178,1,177,1,1,0,1,1,90,89,88,88,38
"3410",9,"[28]cJHggqIjHcidKocJvcGHqFdCpHqz",176,0.99435,28,177,1,176,1,1,0,1,1,89,88,88,88,38
"3411",10,"[28]cJHggqIjHcidKocJvcGHqFdCpHqz",180,0.994475,28,181,1,180,1,1,0,1,1,99,98,82,82,38
"3412",11,"[28]cJHggqIjHcidKocJvcGHqFdCpHqz",178,0.994413,28,179,1,178,1,1,0,1,1,96,95,83,83,38
"3413",12,"[28]cJHggqIjHcidKocJvcGHqFdCpHqz",178,0.994413,28,179,1,178,1,1,0,1,1,97,96,82,82,38
"3414",13,"[28]cJHggqIjHcidKocJvcGHqFdCpHqz",176,0.99435,28,177,1,176,1,1,0,1,1,88,87,89,89,38
"3415",14,"[28]cJHggqIjHcidKocJvcGHqFdCpHqz",174,0.994286,28,175,1,174,1,1,0,1,1,81,80,94,94,38
"3416",15,"[28]cJHggqIjHcidKocJvcGHqFdCpHqz",173,0.994253,28,174,1,173,1,1,0,1,1,80,79,94,94,38
"3417",16,"[28]cJHggqIjHcidKocJvcGHqFdCpHqz",174,0.994286,28,175,1,174,1,1,0,1,1,82,81,93,93,38
"3418",17,"[28]cJHggqIjHcidKocJvcGHqFdCpHqz",181,0.994505,28,182,1,181,1,1,0,1,1,104,103,78,78,38
"3419",18,"[28]cJHggqIjHcidKocJvcGHqFdCpHqz",175,0.994318,28,176,1,175,1,1,0,1,1,85,84,91,91,38
"3420",19,"[28]cJHggqIjHcidKocJvcGHqFdCpHqz",177,0.994382,28,178,1,177,1,1,0,1,1,91,90,87,87,38
"3421",20,"[28]cJHggqIjHcidKocJvcGHqFdCpHqz",177,0.994382,28,178,1,177,1,1,0,1,1,92,91,86,86,38
"3422",21,"[28]cJHggqIjHcidKocJvcGHqFdCpHqz",177,0.994382,28,178,1,177,1,1,0,1,1,92,91,86,86,38
"3423",22,"[28]cJHggqIjHcidKocJvcGHqFdCpHqz",176,0.99435,28,177,1,176,1,1,0,1,1,90,89,87,87,38
"3424",23,"[28]cJHggqIjHcidKocJvcGHqFdCpHqz",173,0.994253,28,174,1,173,1,1,0,1,1,79,78,95,95,38
"3425",24,"[28]cJHggqIjHcidKocJvcGHqFdCpHqz",177,0.994382,28,178,1,177,1,1,0,1,1,92,91,86,86,38
"3426",25,"[28]cJHggqIjHcidKocJvcGHqFdCpHqz",175,0.994318,28,176,1,175,1,1,0,1,1,85,84,91,91,38
"3427",26,"[28]cJHggqIjHcidKocJvcGHqFdCpHqz",171,0.994186,28,172,1,171,1,1,0,1,1,73,72,99,99,38
"3428",27,"[28]cJHggqIjHcidKocJvcGHqFdCpHqz",177,0.994382,28,178,1,177,1,1,0,1,1,91,90,87,87,38
"3429",28,"[28]cJHggqIjHcidKocJvcGHqFdCpHqz",179,0.994444,28,180,1,179,1,1,0,1,1,98,97,82,82,38
"3430",29,"[28]cJHggqIjHcidKocJvcGHqFdCpHqz",179,0.994444,28,180,1,179,1,1,0,1,1,99,98,81,81,38
"3431",30,"[28]cJHggqIjHcidKocJvcGHqFdCpHqz",171,0.994186,28,172,1,171,1,1,0,1,1,72,71,100,100,38
"3432",31,"[28]cJHggqIjHcidKocJvcGHqFdCpHqz",178,0.994413,28,179,1,178,1,1,0,1,1,95,94,84,84,38
"3433",32,"[28]cJHggqIjHcidKocJvcGHqFdCpHqz",173,0.994253,28,174,1,173,1,1,0,1,1,81,80,93,93,38
"3434",33,"[28]cJHggqIjHcidKocJvcGHqFdCpHqz",174,0.994286,28,175,1,174,1,1,0,1,1,82,81,93,93,38
"3435",34,"[28]cJHggqIjHcidKocJvcGHqFdCpHqz",177,0.994382,28,178,1,177,1,1,0,1,1,92,91,86,86,38
"3436",35,"[28]cJHggqIjHcidKocJvcGHqFdCpHqz",172,0.99422,28,173,1,172,1,1,0,1,1,76,75,97,97,38
"3437",36,"[28]cJHggqIjHcidKocJvcGHqFdCpHqz",180,0.994475,28,181,1,180,1,1,0,1,1,103,102,78,78,38
"3438",37,"[28]cJHggqIjHcidKocJvcGHqFdCpHqz",178,0.994413,28,179,1,178,1,1,0,1,1,94,93,85,85,38
"3439",38,"[28]cJHggqIjHcidKocJvcGHqFdCpHqz",174,0.994286,28,175,1,174,1,1,0,1,1,83,82,92,92,38
"3440",39,"[28]cJHggqIjHcidKocJvcGHqFdCpHqz",176,0.99435,28,177,1,176,1,1,0,1,1,90,89,87,87,38
"3441",40,"[28]cJHggqIjHcidKocJvcGHqFdCpHqz",172,0.99422,28,173,1,172,1,1,0,1,1,76,75,97,97,38
"3442",41,"[28]cJHggqIjHcidKocJvcGHqFdCpHqz",174,0.994286,28,175,1,174,1,1,0,1,1,84,83,91,91,38
"3443",42,"[28]cJHggqIjHcidKocJvcGHqFdCpHqz",174,0.994286,28,175,1,174,1,1,0,1,1,84,83,91,91,38
"3444",43,"[28]cJHggqIjHcidKocJvcGHqFdCpHqz",178,0.994413,28,179,1,178,1,1,0,1,1,96,95,83,83,38
"3445",44,"[28]cJHggqIjHcidKocJvcGHqFdCpHqz",176,0.99435,28,177,1,176,1,1,0,1,1,89,88,88,88,38
"3446",45,"[28]cJHggqIjHcidKocJvcGHqFdCpHqz",178,0.994413,28,179,1,178,1,1,0,1,1,95,94,84,84,38
"3447",46,"[28]cJHggqIjHcidKocJvcGHqFdCpHqz",175,0.994318,28,176,1,175,1,1,0,1,1,87,86,89,89,38
"3448",47,"[28]cJHggqIjHcidKocJvcGHqFdCpHqz",173,0.994253,28,174,1,173,1,1,0,1,1,81,80,93,93,38
"3449",48,"[28]cJHggqIjHcidKocJvcGHqFdCpHqz",178,0.994413,28,179,1,178,1,1,0,1,1,95,94,84,84,38
"3450",49,"[28]cJHggqIjHcidKocJvcGHqFdCpHqz",179,0.994444,28,180,1,179,1,1,0,1,1,99,98,81,81,38
"3451",50,"[28]cJHggqIjHcidKocJvcGHqFdCpHqz",181,0.994505,28,182,1,181,1,1,0,1,1,105,104,77,77,38
"3452",51,"[28]cJHggqIjHcidKocJvcGHqFdCpHqz",178,0.994413,28,179,1,178,1,1,0,1,1,97,96,82,82,38
"3453",52,"[28]cJHggqIjHcidKocJvcGHqFdCpHqz",173,0.994253,28,174,1,173,1,1,0,1,1,79,78,95,95,38
"3454",53,"[28]cJHggqIjHcidKocJvcGHqFdCpHqz",171,0.994186,28,172,1,171,1,1,0,1,1,73,72,99,99,38
"3455",54,"[28]cJHggqIjHcidKocJvcGHqFdCpHqz",179,0.994444,28,180,1,179,1,1,0,1,1,99,98,81,81,38
"3456",55,"[28]cJHggqIjHcidKocJvcGHqFdCpHqz",179,0.994444,28,180,1,179,1,1,0,1,1,99,98,81,81,38
"3457",56,"[28]cJHggqIjHcidKocJvcGHqFdCpHqz",177,0.994382,28,178,1,177,1,1,0,1,1,94,93,84,84,38
"3458",57,"[28]cJHggqIjHcidKocJvcGHqFdCpHqz",177,0.994382,28,178,1,177,1,1,0,1,1,91,90,87,87,38
"3459",58,"[28]cJHggqIjHcidKocJvcGHqFdCpHqz",178,0.994413,28,179,1,178,1,1,0,1,1,97,96,82,82,38
"3460",59,"[28]cJHggqIjHcidKocJvcGHqFdCpHqz",174,0.994286,28,175,1,174,1,1,0,1,1,84,83,91,91,38
"3461",60,"[28]cJHggqIjHcidKocJvcGHqFdCpHqz",172,0.99422,28,173,1,172,1,1,0,1,1,76,75,97,97,38
"3462",61,"[28]cJHggqIjHcidKocJvcGHqFdCpHqz",174,0.994286,28,175,1,174,1,1,0,1,1,84,83,91,91,38
"3463",62,"[28]cJHggqIjHcidKocJvcGHqFdCpHqz",176,0.99435,28,177,1,176,1,1,0,1,1,90,89,87,87,38
"3464",63,"[28]cJHggqIjHcidKocJvcGHqFdCpHqz",178,0.994413,28,179,1,178,1,1,0,1,1,95,94,84,84,38
"3465",64,"[28]cJHggqIjHcidKocJvcGHqFdCpHqz",174,0.994286,28,175,1,174,1,1,0,1,1,81,80,94,94,38
"3466",65,"[28]cJHggqIjHcidKocJvcGHqFdCpHqz",172,0.99422,28,173,1,172,1,1,0,1,1,77,76,96,96,38
"3467",66,"[28]cJHggqIjHcidKocJvcGHqFdCpHqz",175,0.994318,28,176,1,175,1,1,0,1,1,86,85,90,90,38
"3468",67,"[28]cJHggqIjHcidKocJvcGHqFdCpHqz",180,0.994475,28,181,1,180,1,1,0,1,1,104,103,77,77,38
"3469",68,"[28]cJHggqIjHcidKocJvcGHqFdCpHqz",175,0.994318,28,176,1,175,1,1,0,1,1,87,86,89,89,38
"3470",69,"[28]cJHggqIjHcidKocJvcGHqFdCpHqz",176,0.99435,28,177,1,176,1,1,0,1,1,89,88,88,88,38
"3471",70,"[28]cJHggqIjHcidKocJvcGHqFdCpHqz",177,0.994382,28,178,1,177,1,1,0,1,1,91,90,87,87,38
"3472",71,"[28]cJHggqIjHcidKocJvcGHqFdCpHqz",177,0.994382,28,178,1,177,1,1,0,1,1,92,91,86,86,38
"3473",72,"[28]cJHggqIjHcidKocJvcGHqFdCpHqz",177,0.994382,28,178,1,177,1,1,0,1,1,91,90,87,87,38
"3474",73,"[28]cJHggqIjHcidKocJvcGHqFdCpHqz",178,0.994413,28,179,1,178,1,1,0,1,1,95,94,84,84,38
"3475",74,"[28]cJHggqIjHcidKocJvcGHqFdCpHqz",180,0.994475,28,181,1,180,1,1,0,1,1,101,100,80,80,38
"3476",75,"[28]cJHggqIjHcidKocJvcGHqFdCpHqz",175,0.994318,28,176,1,175,1,1,0,1,1,85,84,91,91,38
"3477",76,"[28]cJHggqIjHcidKocJvcGHqFdCpHqz",180,0.994475,28,181,1,180,1,1,0,1,1,103,102,78,78,38
"3478",77,"[28]cJHggqIjHcidKocJvcGHqFdCpHqz",177,0.994382,28,178,1,177,1,1,0,1,1,90,89,88,88,38
"3479",78,"[28]cJHggqIjHcidKocJvcGHqFdCpHqz",178,0.994413,28,179,1,178,1,1,0,1,1,94,93,85,85,38
"3480",79,"[28]cJHggqIjHcidKocJvcGHqFdCpHqz",175,0.994318,28,176,1,175,1,1,0,1,1,87,86,89,89,38
"3481",80,"[28]cJHggqIjHcidKocJvcGHqFdCpHqz",177,0.994382,28,178,1,177,1,1,0,1,1,93,92,85,85,38
"3482",81,"[28]cJHggqIjHcidKocJvcGHqFdCpHqz",175,0.994318,28,176,1,175,1,1,0,1,1,86,85,90,90,38
"3483",82,"[28]cJHggqIjHcidKocJvcGHqFdCpHqz",179,0.994444,28,180,1,179,1,1,0,1,1,100,99,80,80,38
"3484",83,"[28]cJHggqIjHcidKocJvcGHqFdCpHqz",176,0.99435,28,177,1,176,1,1,0,1,1,90,89,87,87,38
"3485",84,"[28]cJHggqIjHcidKocJvcGHqFdCpHqz",169,0.994118,28,170,1,169,1,1,0,1,1,67,66,103,103,38
"3486",85,"[28]cJHggqIjHcidKocJvcGHqFdCpHqz",178,0.994413,28,179,1,178,1,1,0,1,1,95,94,84,84,38
"3487",86,"[28]cJHggqIjHcidKocJvcGHqFdCpHqz",175,0.994318,28,176,1,175,1,1,0,1,1,87,86,89,89,38
"3488",87,"[28]cJHggqIjHcidKocJvcGHqFdCpHqz",175,0.994318,28,176,1,175,1,1,0,1,1,87,86,89,89,38
"3489",88,"[28]cJHggqIjHcidKocJvcGHqFdCpHqz",176,0.99435,28,177,1,176,1,1,0,1,1,89,88,88,88,38
"3490",89,"[28]cJHggqIjHcidKocJvcGHqFdCpHqz",176,0.99435,28,177,1,176,1,1,0,1,1,90,89,87,87,38
"3491",90,"[28]cJHggqIjHcidKocJvcGHqFdCpHqz",175,0.994318,28,176,1,175,1,1,0,1,1,85,84,91,91,38
"3492",91,"[28]cJHggqIjHcidKocJvcGHqFdCpHqz",173,0.994253,28,174,1,173,1,1,0,1,1,79,78,95,95,38
"3493",92,"[28]cJHggqIjHcidKocJvcGHqFdCpHqz",175,0.994318,28,176,1,175,1,1,0,1,1,87,86,89,89,38
"3494",93,"[28]cJHggqIjHcidKocJvcGHqFdCpHqz",178,0.994413,28,179,1,178,1,1,0,1,1,96,95,83,83,38
"3495",94,"[28]cJHggqIjHcidKocJvcGHqFdCpHqz",176,0.99435,28,177,1,176,1,1,0,1,1,89,88,88,88,38
"3496",95,"[28]cJHggqIjHcidKocJvcGHqFdCpHqz",179,0.994444,28,180,1,179,1,1,0,1,1,101,100,79,79,38
"3497",96,"[28]cJHggqIjHcidKocJvcGHqFdCpHqz",178,0.994413,28,179,1,178,1,1,0,1,1,95,94,84,84,38
"3498",97,"[28]cJHggqIjHcidKocJvcGHqFdCpHqz",175,0.994318,28,176,1,175,1,1,0,1,1,86,85,90,90,38
"3499",98,"[28]cJHggqIjHcidKocJvcGHqFdCpHqz",174,0.994286,28,175,1,174,1,1,0,1,1,82,81,93,93,38
"3500",99,"[28]cJHggqIjHcidKocJvcGHqFdCpHqz",175,0.994318,28,176,1,175,1,1,0,1,1,86,85,90,90,38
"3501",0,"[25]GJHggqIHBodKpcJvcGHqxdCrr",171,0.994186,25,172,1,171,1,1,0,1,1,97,96,75,75,39
"3502",1,"[25]GJHggqIHBodKpcJvcGHqxdCrr",162,0.993865,25,163,1,162,1,1,0,1,1,72,71,91,91,39
"3503",2,"[25]GJHggqIHBodKpcJvcGHqxdCrr",164,0.993939,25,165,1,164,1,1,0,1,1,75,74,90,90,39
"3504",3,"[25]GJHggqIHBodKpcJvcGHqxdCrr",168,0.994083,25,169,1,168,1,1,0,1,1,87,86,82,82,39
"3505",4,"[25]GJHggqIHBodKpcJvcGHqxdCrr",166,0.994012,25,167,1,166,1,1,0,1,1,80,79,87,87,39
"3506",5,"[25]GJHggqIHBodKpcJvcGHqxdCrr",169,0.994118,25,170,1,169,1,1,0,1,1,89,88,81,81,39
"3507",6,"[25]GJHggqIHBodKpcJvcGHqxdCrr",165,0.993976,25,166,1,165,1,1,0,1,1,80,79,86,86,39
"3508",7,"[25]GJHggqIHBodKpcJvcGHqxdCrr",172,0.99422,25,173,1,172,1,1,0,1,1,98,97,75,75,39
"3509",8,"[25]GJHggqIHBodKpcJvcGHqxdCrr",165,0.993976,25,166,1,165,1,1,0,1,1,80,79,86,86,39
"3510",9,"[25]GJHggqIHBodKpcJvcGHqxdCrr",167,0.994048,25,168,1,167,1,1,0,1,1,86,85,82,82,39
"3511",10,"[25]GJHggqIHBodKpcJvcGHqxdCrr",166,0.994012,25,167,1,166,1,1,0,1,1,81,80,86,86,39
"3512",11,"[25]GJHggqIHBodKpcJvcGHqxdCrr",167,0.994048,25,168,1,167,1,1,0,1,1,85,84,83,83,39
"3513",12,"[25]GJHggqIHBodKpcJvcGHqxdCrr",167,0.994048,25,168,1,167,1,1,0,1,1,84,83,84,84,39
"3514",13,"[25]GJHggqIHBodKpcJvcGHqxdCrr",172,0.99422,25,173,1,172,1,1,0,1,1,96,95,77,77,39
"3515",14,"[25]GJHggqIHBodKpcJvcGHqxdCrr",169,0.994118,25,170,1,169,1,1,0,1,1,89,88,81,81,39
"3516",15,"[25]GJHggqIHBodKpcJvcGHqxdCrr",166,0.994012,25,167,1,166,1,1,0,1,1,82,81,85,85,39
"3517",16,"[25]GJHggqIHBodKpcJvcGHqxdCrr",171,0.994186,25,172,1,171,1,1,0,1,1,96,95,76,76,39
"3518",17,"[25]GJHggqIHBodKpcJvcGHqxdCrr",166,0.994012,25,167,1,166,1,1,0,1,1,82,81,85,85,39
"3519",18,"[25]GJHggqIHBodKpcJvcGHqxdCrr",163,0.993902,25,164,1,163,1,1,0,1,1,75,74,89,89,39
"3520",19,"[25]GJHggqIHBodKpcJvcGHqxdCrr",165,0.993976,25,166,1,165,1,1,0,1,1,78,77,88,88,39
"3521",20,"[25]GJHggqIHBodKpcJvcGHqxdCrr",167,0.994048,25,168,1,167,1,1,0,1,1,84,83,84,84,39
"3522",21,"[25]GJHggqIHBodKpcJvcGHqxdCrr",165,0.993976,25,166,1,165,1,1,0,1,1,78,77,88,88,39
"3523",22,"[25]GJHggqIHBodKpcJvcGHqxdCrr",164,0.993939,25,165,1,164,1,1,0,1,1,77,76,88,88,39
"3524",23,"[25]GJHggqIHBodKpcJvcGHqxdCrr",166,0.994012,25,167,1,166,1,1,0,1,1,82,81,85,85,39
"3525",24,"[25]GJHggqIHBodKpcJvcGHqxdCrr",166,0.994012,25,167,1,166,1,1,0,1,1,82,81,85,85,39
"3526",25,"[25]GJHggqIHBodKpcJvcGHqxdCrr",169,0.994118,25,170,1,169,1,1,0,1,1,90,89,80,80,39
"3527",26,"[25]GJHggqIHBodKpcJvcGHqxdCrr",168,0.994083,25,169,1,168,1,1,0,1,1,87,86,82,82,39
"3528",27,"[25]GJHggqIHBodKpcJvcGHqxdCrr",171,0.994186,25,172,1,171,1,1,0,1,1,94,93,78,78,39
"3529",28,"[25]GJHggqIHBodKpcJvcGHqxdCrr",165,0.993976,25,166,1,165,1,1,0,1,1,78,77,88,88,39
"3530",29,"[25]GJHggqIHBodKpcJvcGHqxdCrr",167,0.994048,25,168,1,167,1,1,0,1,1,85,84,83,83,39
"3531",30,"[25]GJHggqIHBodKpcJvcGHqxdCrr",162,0.993865,25,163,1,162,1,1,0,1,1,72,71,91,91,39
"3532",31,"[25]GJHggqIHBodKpcJvcGHqxdCrr",164,0.993939,25,165,1,164,1,1,0,1,1,75,74,90,90,39
"3533",32,"[25]GJHggqIHBodKpcJvcGHqxdCrr",167,0.994048,25,168,1,167,1,1,0,1,1,86,85,82,82,39
"3534",33,"[25]GJHggqIHBodKpcJvcGHqxdCrr",167,0.994048,25,168,1,167,1,1,0,1,1,85,84,83,83,39
"3535",34,"[25]GJHggqIHBodKpcJvcGHqxdCrr",171,0.994186,25,172,1,171,1,1,0,1,1,95,94,77,77,39
"3536",35,"[25]GJHggqIHBodKpcJvcGHqxdCrr",162,0.993865,25,163,1,162,1,1,0,1,1,72,71,91,91,39
"3537",36,"[25]GJHggqIHBodKpcJvcGHqxdCrr",163,0.993902,25,164,1,163,1,1,0,1,1,72,71,92,92,39
"3538",37,"[25]GJHggqIHBodKpcJvcGHqxdCrr",168,0.994083,25,169,1,168,1,1,0,1,1,88,87,81,81,39
"3539",38,"[25]GJHggqIHBodKpcJvcGHqxdCrr",164,0.993939,25,165,1,164,1,1,0,1,1,75,74,90,90,39
"3540",39,"[25]GJHggqIHBodKpcJvcGHqxdCrr",167,0.994048,25,168,1,167,1,1,0,1,1,85,84,83,83,39
"3541",40,"[25]GJHggqIHBodKpcJvcGHqxdCrr",167,0.994048,25,168,1,167,1,1,0,1,1,85,84,83,83,39
"3542",41,"[25]GJHggqIHBodKpcJvcGHqxdCrr",168,0.994083,25,169,1,168,1,1,0,1,1,86,85,83,83,39
"3543",42,"[25]GJHggqIHBodKpcJvcGHqxdCrr",167,0.994048,25,168,1,167,1,1,0,1,1,84,83,84,84,39
"3544",43,"[25]GJHggqIHBodKpcJvcGHqxdCrr",167,0.994048,25,168,1,167,1,1,0,1,1,85,84,83,83,39
"3545",44,"[25]GJHggqIHBodKpcJvcGHqxdCrr",164,0.993939,25,165,1,164,1,1,0,1,1,76,75,89,89,39
"3546",45,"[25]GJHggqIHBodKpcJvcGHqxdCrr",166,0.994012,25,167,1,166,1,1,0,1,1,83,82,84,84,39
"3547",46,"[25]GJHggqIHBodKpcJvcGHqxdCrr",169,0.994118,25,170,1,169,1,1,0,1,1,90,89,80,80,39
"3548",47,"[25]GJHggqIHBodKpcJvcGHqxdCrr",164,0.993939,25,165,1,164,1,1,0,1,1,76,75,89,89,39
"3549",48,"[25]GJHggqIHBodKpcJvcGHqxdCrr",165,0.993976,25,166,1,165,1,1,0,1,1,80,79,86,86,39
"3550",49,"[25]GJHggqIHBodKpcJvcGHqxdCrr",167,0.994048,25,168,1,167,1,1,0,1,1,85,84,83,83,39
"3551",50,"[25]GJHggqIHBodKpcJvcGHqxdCrr",164,0.993939,25,165,1,164,1,1,0,1,1,77,76,88,88,39
"3552",51,"[25]GJHggqIHBodKpcJvcGHqxdCrr",166,0.994012,25,167,1,166,1,1,0,1,1,81,80,86,86,39
"3553",52,"[25]GJHggqIHBodKpcJvcGHqxdCrr",169,0.994118,25,170,1,169,1,1,0,1,1,89,88,81,81,39
"3554",53,"[25]GJHggqIHBodKpcJvcGHqxdCrr",166,0.994012,25,167,1,166,1,1,0,1,1,81,80,86,86,39
"3555",54,"[25]GJHggqIHBodKpcJvcGHqxdCrr",168,0.994083,25,169,1,168,1,1,0,1,1,87,86,82,82,39
"3556",55,"[25]GJHggqIHBodKpcJvcGHqxdCrr",164,0.993939,25,165,1,164,1,1,0,1,1,77,76,88,88,39
"3557",56,"[25]GJHggqIHBodKpcJvcGHqxdCrr",170,0.994152,25,171,1,170,1,1,0,1,1,92,91,79,79,39
"3558",57,"[25]GJHggqIHBodKpcJvcGHqxdCrr",167,0.994048,25,168,1,167,1,1,0,1,1,86,85,82,82,39
"3559",58,"[25]GJHggqIHBodKpcJvcGHqxdCrr",167,0.994048,25,168,1,167,1,1,0,1,1,85,84,83,83,39
"3560",59,"[25]GJHggqIHBodKpcJvcGHqxdCrr",169,0.994118,25,170,1,169,1,1,0,1,1,90,89,80,80,39
"3561",60,"[25]GJHggqIHBodKpcJvcGHqxdCrr",164,0.993939,25,165,1,164,1,1,0,1,1,77,76,88,88,39
"3562",61,"[25]GJHggqIHBodKpcJvcGHqxdCrr",168,0.994083,25,169,1,168,1,1,0,1,1,88,87,81,81,39
"3563",62,"[25]GJHggqIHBodKpcJvcGHqxdCrr",167,0.994048,25,168,1,167,1,1,0,1,1,83,82,85,85,39
"3564",63,"[25]GJHggqIHBodKpcJvcGHqxdCrr",171,0.994186,25,172,1,171,1,1,0,1,1,95,94,77,77,39
"3565",64,"[25]GJHggqIHBodKpcJvcGHqxdCrr",165,0.993976,25,166,1,165,1,1,0,1,1,79,78,87,87,39
"3566",65,"[25]GJHggqIHBodKpcJvcGHqxdCrr",171,0.994186,25,172,1,171,1,1,0,1,1,96,95,76,76,39
"3567",66,"[25]GJHggqIHBodKpcJvcGHqxdCrr",167,0.994048,25,168,1,167,1,1,0,1,1,85,84,83,83,39
"3568",67,"[25]GJHggqIHBodKpcJvcGHqxdCrr",174,0.994286,25,175,1,174,1,1,0,1,1,105,104,70,70,39
"3569",68,"[25]GJHggqIHBodKpcJvcGHqxdCrr",169,0.994118,25,170,1,169,1,1,0,1,1,90,89,80,80,39
"3570",69,"[25]GJHggqIHBodKpcJvcGHqxdCrr",163,0.993902,25,164,1,163,1,1,0,1,1,74,73,90,90,39
"3571",70,"[25]GJHggqIHBodKpcJvcGHqxdCrr",169,0.994118,25,170,1,169,1,1,0,1,1,91,90,79,79,39
"3572",71,"[25]GJHggqIHBodKpcJvcGHqxdCrr",168,0.994083,25,169,1,168,1,1,0,1,1,88,87,81,81,39
"3573",72,"[25]GJHggqIHBodKpcJvcGHqxdCrr",169,0.994118,25,170,1,169,1,1,0,1,1,90,89,80,80,39
"3574",73,"[25]GJHggqIHBodKpcJvcGHqxdCrr",168,0.994083,25,169,1,168,1,1,0,1,1,85,84,84,84,39
"3575",74,"[25]GJHggqIHBodKpcJvcGHqxdCrr",170,0.994152,25,171,1,170,1,1,0,1,1,92,91,79,79,39
"3576",75,"[25]GJHggqIHBodKpcJvcGHqxdCrr",166,0.994012,25,167,1,166,1,1,0,1,1,82,81,85,85,39
"3577",76,"[25]GJHggqIHBodKpcJvcGHqxdCrr",162,0.993865,25,163,1,162,1,1,0,1,1,70,69,93,93,39
"3578",77,"[25]GJHggqIHBodKpcJvcGHqxdCrr",170,0.994152,25,171,1,170,1,1,0,1,1,93,92,78,78,39
"3579",78,"[25]GJHggqIHBodKpcJvcGHqxdCrr",162,0.993865,25,163,1,162,1,1,0,1,1,71,70,92,92,39
"3580",79,"[25]GJHggqIHBodKpcJvcGHqxdCrr",165,0.993976,25,166,1,165,1,1,0,1,1,79,78,87,87,39
"3581",80,"[25]GJHggqIHBodKpcJvcGHqxdCrr",171,0.994186,25,172,1,171,1,1,0,1,1,94,93,78,78,39
"3582",81,"[25]GJHggqIHBodKpcJvcGHqxdCrr",165,0.993976,25,166,1,165,1,1,0,1,1,80,79,86,86,39
"3583",82,"[25]GJHggqIHBodKpcJvcGHqxdCrr",164,0.993939,25,165,1,164,1,1,0,1,1,75,74,90,90,39
"3584",83,"[25]GJHggqIHBodKpcJvcGHqxdCrr",166,0.994012,25,167,1,166,1,1,0,1,1,81,80,86,86,39
"3585",84,"[25]GJHggqIHBodKpcJvcGHqxdCrr",170,0.994152,25,171,1,170,1,1,0,1,1,93,92,78,78,39
"3586",85,"[25]GJHggqIHBodKpcJvcGHqxdCrr",161,0.993827,25,162,1,161,1,1,0,1,1,69,68,93,93,39
"3587",86,"[25]GJHggqIHBodKpcJvcGHqxdCrr",169,0.994118,25,170,1,169,1,1,0,1,1,91,90,79,79,39
"3588",87,"[25]GJHggqIHBodKpcJvcGHqxdCrr",169,0.994118,25,170,1,169,1,1,0,1,1,90,89,80,80,39
"3589",88,"[25]GJHggqIHBodKpcJvcGHqxdCrr",169,0.994118,25,170,1,169,1,1,0,1,1,89,88,81,81,39
"3590",89,"[25]GJHggqIHBodKpcJvcGHqxdCrr",166,0.994012,25,167,1,166,1,1,0,1,1,80,79,87,87,39
"3591",90,"[25]GJHggqIHBodKpcJvcGHqxdCrr",170,0.994152,25,171,1,170,1,1,0,1,1,92,91,79,79,39
"3592",91,"[25]GJHggqIHBodKpcJvcGHqxdCrr",171,0.994186,25,172,1,171,1,1,0,1,1,94,93,78,78,39
"3593",92,"[25]GJHggqIHBodKpcJvcGHqxdCrr",172,0.99422,25,173,1,172,1,1,0,1,1,98,97,75,75,39
"3594",93,"[25]GJHggqIHBodKpcJvcGHqxdCrr",171,0.994186,25,172,1,171,1,1,0,1,1,96,95,76,76,39
"3595",94,"[25]GJHggqIHBodKpcJvcGHqxdCrr",163,0.993902,25,164,1,163,1,1,0,1,1,75,74,89,89,39
"3596",95,"[25]GJHggqIHBodKpcJvcGHqxdCrr",163,0.993902,25,164,1,163,1,1,0,1,1,72,71,92,92,39
"3597",96,"[25]GJHggqIHBodKpcJvcGHqxdCrr",167,0.994048,25,168,1,167,1,1,0,1,1,84,83,84,84,39
"3598",97,"[25]GJHggqIHBodKpcJvcGHqxdCrr",163,0.993902,25,164,1,163,1,1,0,1,1,75,74,89,89,39
"3599",98,"[25]GJHggqIHBodKpcJvcGHqxdCrr",164,0.993939,25,165,1,164,1,1,0,1,1,76,75,89,89,39
"3600",99,"[25]GJHggqIHBodKpcJvcGHqxdCrr",169,0.994118,25,170,1,169,1,1,0,1,1,90,89,80,80,39
"3601",0,"[26]HJHglqIHcdKpcJvcGHqwdCDrmH",166,0.994012,26,167,1,166,1,1,0,1,1,81,80,86,86,40
"3602",1,"[26]HJHglqIHcdKpcJvcGHqwdCDrmH",173,0.994253,26,174,1,173,1,1,0,1,1,100,99,74,74,40
"3603",2,"[26]HJHglqIHcdKpcJvcGHqwdCDrmH",169,0.994118,26,170,1,169,1,1,0,1,1,91,90,79,79,40
"3604",3,"[26]HJHglqIHcdKpcJvcGHqwdCDrmH",167,0.994048,26,168,1,167,1,1,0,1,1,83,82,85,85,40
"3605",4,"[26]HJHglqIHcdKpcJvcGHqwdCDrmH",168,0.994083,26,169,1,168,1,1,0,1,1,88,87,81,81,40
"3606",5,"[26]HJHglqIHcdKpcJvcGHqwdCDrmH",165,0.993976,26,166,1,165,1,1,0,1,1,77,76,89,89,40
"3607",6,"[26]HJHglqIHcdKpcJvcGHqwdCDrmH",163,0.993902,26,164,1,163,1,1,0,1,1,74,73,90,90,40
"3608",7,"[26]HJHglqIHcdKpcJvcGHqwdCDrmH",163,0.993902,26,164,1,163,1,1,0,1,1,75,74,89,89,40
"3609",8,"[26]HJHglqIHcdKpcJvcGHqwdCDrmH",163,0.993902,26,164,1,163,1,1,0,1,1,75,74,89,89,40
"3610",9,"[26]HJHglqIHcdKpcJvcGHqwdCDrmH",171,0.994186,26,172,1,171,1,1,0,1,1,94,93,78,78,40
"3611",10,"[26]HJHglqIHcdKpcJvcGHqwdCDrmH",170,0.994152,26,171,1,170,1,1,0,1,1,94,93,77,77,40
"3612",11,"[26]HJHglqIHcdKpcJvcGHqwdCDrmH",169,0.994118,26,170,1,169,1,1,0,1,1,91,90,79,79,40
"3613",12,"[26]HJHglqIHcdKpcJvcGHqwdCDrmH",171,0.994186,26,172,1,171,1,1,0,1,1,96,95,76,76,40
"3614",13,"[26]HJHglqIHcdKpcJvcGHqwdCDrmH",166,0.994012,26,167,1,166,1,1,0,1,1,81,80,86,86,40
"3615",14,"[26]HJHglqIHcdKpcJvcGHqwdCDrmH",164,0.993939,26,165,1,164,1,1,0,1,1,76,75,89,89,40
"3616",15,"[26]HJHglqIHcdKpcJvcGHqwdCDrmH",168,0.994083,26,169,1,168,1,1,0,1,1,86,85,83,83,40
"3617",16,"[26]HJHglqIHcdKpcJvcGHqwdCDrmH",166,0.994012,26,167,1,166,1,1,0,1,1,82,81,85,85,40
"3618",17,"[26]HJHglqIHcdKpcJvcGHqwdCDrmH",168,0.994083,26,169,1,168,1,1,0,1,1,87,86,82,82,40
"3619",18,"[26]HJHglqIHcdKpcJvcGHqwdCDrmH",165,0.993976,26,166,1,165,1,1,0,1,1,79,78,87,87,40
"3620",19,"[26]HJHglqIHcdKpcJvcGHqwdCDrmH",170,0.994152,26,171,1,170,1,1,0,1,1,92,91,79,79,40
"3621",20,"[26]HJHglqIHcdKpcJvcGHqwdCDrmH",166,0.994012,26,167,1,166,1,1,0,1,1,81,80,86,86,40
"3622",21,"[26]HJHglqIHcdKpcJvcGHqwdCDrmH",170,0.994152,26,171,1,170,1,1,0,1,1,94,93,77,77,40
"3623",22,"[26]HJHglqIHcdKpcJvcGHqwdCDrmH",163,0.993902,26,164,1,163,1,1,0,1,1,73,72,91,91,40
"3624",23,"[26]HJHglqIHcdKpcJvcGHqwdCDrmH",168,0.994083,26,169,1,168,1,1,0,1,1,87,86,82,82,40
"3625",24,"[26]HJHglqIHcdKpcJvcGHqwdCDrmH",168,0.994083,26,169,1,168,1,1,0,1,1,88,87,81,81,40
"3626",25,"[26]HJHglqIHcdKpcJvcGHqwdCDrmH",167,0.994048,26,168,1,167,1,1,0,1,1,83,82,85,85,40
"3627",26,"[26]HJHglqIHcdKpcJvcGHqwdCDrmH",163,0.993902,26,164,1,163,1,1,0,1,1,74,73,90,90,40
"3628",27,"[26]HJHglqIHcdKpcJvcGHqwdCDrmH",166,0.994012,26,167,1,166,1,1,0,1,1,82,81,85,85,40
"3629",28,"[26]HJHglqIHcdKpcJvcGHqwdCDrmH",165,0.993976,26,166,1,165,1,1,0,1,1,78,77,88,88,40
"3630",29,"[26]HJHglqIHcdKpcJvcGHqwdCDrmH",178,0.994413,26,179,1,178,1,1,0,1,1,113,112,66,66,40
"3631",30,"[26]HJHglqIHcdKpcJvcGHqwdCDrmH",168,0.994083,26,169,1,168,1,1,0,1,1,86,85,83,83,40
"3632",31,"[26]HJHglqIHcdKpcJvcGHqwdCDrmH",165,0.993976,26,166,1,165,1,1,0,1,1,80,79,86,86,40
"3633",32,"[26]HJHglqIHcdKpcJvcGHqwdCDrmH",163,0.993902,26,164,1,163,1,1,0,1,1,74,73,90,90,40
"3634",33,"[26]HJHglqIHcdKpcJvcGHqwdCDrmH",167,0.994048,26,168,1,167,1,1,0,1,1,85,84,83,83,40
"3635",34,"[26]HJHglqIHcdKpcJvcGHqwdCDrmH",168,0.994083,26,169,1,168,1,1,0,1,1,88,87,81,81,40
"3636",35,"[26]HJHglqIHcdKpcJvcGHqwdCDrmH",165,0.993976,26,166,1,165,1,1,0,1,1,80,79,86,86,40
"3637",36,"[26]HJHglqIHcdKpcJvcGHqwdCDrmH",166,0.994012,26,167,1,166,1,1,0,1,1,83,82,84,84,40
"3638",37,"[26]HJHglqIHcdKpcJvcGHqwdCDrmH",166,0.994012,26,167,1,166,1,1,0,1,1,79,78,88,88,40
"3639",38,"[26]HJHglqIHcdKpcJvcGHqwdCDrmH",169,0.994118,26,170,1,169,1,1,0,1,1,91,90,79,79,40
"3640",39,"[26]HJHglqIHcdKpcJvcGHqwdCDrmH",167,0.994048,26,168,1,167,1,1,0,1,1,83,82,85,85,40
"3641",40,"[26]HJHglqIHcdKpcJvcGHqwdCDrmH",169,0.994118,26,170,1,169,1,1,0,1,1,90,89,80,80,40
"3642",41,"[26]HJHglqIHcdKpcJvcGHqwdCDrmH",165,0.993976,26,166,1,165,1,1,0,1,1,79,78,87,87,40
"3643",42,"[26]HJHglqIHcdKpcJvcGHqwdCDrmH",168,0.994083,26,169,1,168,1,1,0,1,1,88,87,81,81,40
"3644",43,"[26]HJHglqIHcdKpcJvcGHqwdCDrmH",165,0.993976,26,166,1,165,1,1,0,1,1,79,78,87,87,40
"3645",44,"[26]HJHglqIHcdKpcJvcGHqwdCDrmH",166,0.994012,26,167,1,166,1,1,0,1,1,82,81,85,85,40
"3646",45,"[26]HJHglqIHcdKpcJvcGHqwdCDrmH",168,0.994083,26,169,1,168,1,1,0,1,1,87,86,82,82,40
"3647",46,"[26]HJHglqIHcdKpcJvcGHqwdCDrmH",168,0.994083,26,169,1,168,1,1,0,1,1,88,87,81,81,40
"3648",47,"[26]HJHglqIHcdKpcJvcGHqwdCDrmH",167,0.994048,26,168,1,167,1,1,0,1,1,84,83,84,84,40
"3649",48,"[26]HJHglqIHcdKpcJvcGHqwdCDrmH",161,0.993827,26,162,1,161,1,1,0,1,1,69,68,93,93,40
"3650",49,"[26]HJHglqIHcdKpcJvcGHqwdCDrmH",170,0.994152,26,171,1,170,1,1,0,1,1,94,93,77,77,40
"3651",50,"[26]HJHglqIHcdKpcJvcGHqwdCDrmH",167,0.994048,26,168,1,167,1,1,0,1,1,85,84,83,83,40
"3652",51,"[26]HJHglqIHcdKpcJvcGHqwdCDrmH",169,0.994118,26,170,1,169,1,1,0,1,1,89,88,81,81,40
"3653",52,"[26]HJHglqIHcdKpcJvcGHqwdCDrmH",163,0.993902,26,164,1,163,1,1,0,1,1,73,72,91,91,40
"3654",53,"[26]HJHglqIHcdKpcJvcGHqwdCDrmH",171,0.994186,26,172,1,171,1,1,0,1,1,94,93,78,78,40
"3655",54,"[26]HJHglqIHcdKpcJvcGHqwdCDrmH",169,0.994118,26,170,1,169,1,1,0,1,1,89,88,81,81,40
"3656",55,"[26]HJHglqIHcdKpcJvcGHqwdCDrmH",166,0.994012,26,167,1,166,1,1,0,1,1,81,80,86,86,40
"3657",56,"[26]HJHglqIHcdKpcJvcGHqwdCDrmH",166,0.994012,26,167,1,166,1,1,0,1,1,80,79,87,87,40
"3658",57,"[26]HJHglqIHcdKpcJvcGHqwdCDrmH",169,0.994118,26,170,1,169,1,1,0,1,1,89,88,81,81,40
"3659",58,"[26]HJHglqIHcdKpcJvcGHqwdCDrmH",168,0.994083,26,169,1,168,1,1,0,1,1,86,85,83,83,40
"3660",59,"[26]HJHglqIHcdKpcJvcGHqwdCDrmH",170,0.994152,26,171,1,170,1,1,0,1,1,92,91,79,79,40
"3661",60,"[26]HJHglqIHcdKpcJvcGHqwdCDrmH",166,0.994012,26,167,1,166,1,1,0,1,1,83,82,84,84,40
"3662",61,"[26]HJHglqIHcdKpcJvcGHqwdCDrmH",167,0.994048,26,168,1,167,1,1,0,1,1,83,82,85,85,40
"3663",62,"[26]HJHglqIHcdKpcJvcGHqwdCDrmH",160,0.993789,26,161,1,160,1,1,0,1,1,66,65,95,95,40
"3664",63,"[26]HJHglqIHcdKpcJvcGHqwdCDrmH",167,0.994048,26,168,1,167,1,1,0,1,1,82,81,86,86,40
"3665",64,"[26]HJHglqIHcdKpcJvcGHqwdCDrmH",171,0.994186,26,172,1,171,1,1,0,1,1,97,96,75,75,40
"3666",65,"[26]HJHglqIHcdKpcJvcGHqwdCDrmH",166,0.994012,26,167,1,166,1,1,0,1,1,83,82,84,84,40
"3667",66,"[26]HJHglqIHcdKpcJvcGHqwdCDrmH",165,0.993976,26,166,1,165,1,1,0,1,1,78,77,88,88,40
"3668",67,"[26]HJHglqIHcdKpcJvcGHqwdCDrmH",168,0.994083,26,169,1,168,1,1,0,1,1,88,87,81,81,40
"3669",68,"[26]HJHglqIHcdKpcJvcGHqwdCDrmH",167,0.994048,26,168,1,167,1,1,0,1,1,86,85,82,82,40
"3670",69,"[26]HJHglqIHcdKpcJvcGHqwdCDrmH",169,0.994118,26,170,1,169,1,1,0,1,1,89,88,81,81,40
"3671",70,"[26]HJHglqIHcdKpcJvcGHqwdCDrmH",167,0.994048,26,168,1,167,1,1,0,1,1,86,85,82,82,40
"3672",71,"[26]HJHglqIHcdKpcJvcGHqwdCDrmH",164,0.993939,26,165,1,164,1,1,0,1,1,77,76,88,88,40
"3673",72,"[26]HJHglqIHcdKpcJvcGHqwdCDrmH",170,0.994152,26,171,1,170,1,1,0,1,1,93,92,78,78,40
"3674",73,"[26]HJHglqIHcdKpcJvcGHqwdCDrmH",167,0.994048,26,168,1,167,1,1,0,1,1,85,84,83,83,40
"3675",74,"[26]HJHglqIHcdKpcJvcGHqwdCDrmH",169,0.994118,26,170,1,169,1,1,0,1,1,89,88,81,81,40
"3676",75,"[26]HJHglqIHcdKpcJvcGHqwdCDrmH",171,0.994186,26,172,1,171,1,1,0,1,1,95,94,77,77,40
"3677",76,"[26]HJHglqIHcdKpcJvcGHqwdCDrmH",171,0.994186,26,172,1,171,1,1,0,1,1,95,94,77,77,40
"3678",77,"[26]HJHglqIHcdKpcJvcGHqwdCDrmH",165,0.993976,26,166,1,165,1,1,0,1,1,79,78,87,87,40
"3679",78,"[26]HJHglqIHcdKpcJvcGHqwdCDrmH",168,0.994083,26,169,1,168,1,1,0,1,1,85,84,84,84,40
"3680",79,"[26]HJHglqIHcdKpcJvcGHqwdCDrmH",161,0.993827,26,162,1,161,1,1,0,1,1,69,68,93,93,40
"3681",80,"[26]HJHglqIHcdKpcJvcGHqwdCDrmH",166,0.994012,26,167,1,166,1,1,0,1,1,83,82,84,84,40
"3682",81,"[26]HJHglqIHcdKpcJvcGHqwdCDrmH",169,0.994118,26,170,1,169,1,1,0,1,1,89,88,81,81,40
"3683",82,"[26]HJHglqIHcdKpcJvcGHqwdCDrmH",167,0.994048,26,168,1,167,1,1,0,1,1,84,83,84,84,40
"3684",83,"[26]HJHglqIHcdKpcJvcGHqwdCDrmH",169,0.994118,26,170,1,169,1,1,0,1,1,91,90,79,79,40
"3685",84,"[26]HJHglqIHcdKpcJvcGHqwdCDrmH",172,0.99422,26,173,1,172,1,1,0,1,1,99,98,74,74,40
"3686",85,"[26]HJHglqIHcdKpcJvcGHqwdCDrmH",165,0.993976,26,166,1,165,1,1,0,1,1,78,77,88,88,40
"3687",86,"[26]HJHglqIHcdKpcJvcGHqwdCDrmH",167,0.994048,26,168,1,167,1,1,0,1,1,82,81,86,86,40
"3688",87,"[26]HJHglqIHcdKpcJvcGHqwdCDrmH",167,0.994048,26,168,1,167,1,1,0,1,1,82,81,86,86,40
"3689",88,"[26]HJHglqIHcdKpcJvcGHqwdCDrmH",164,0.993939,26,165,1,164,1,1,0,1,1,76,75,89,89,40
"3690",89,"[26]HJHglqIHcdKpcJvcGHqwdCDrmH",169,0.994118,26,170,1,169,1,1,0,1,1,90,89,80,80,40
"3691",90,"[26]HJHglqIHcdKpcJvcGHqwdCDrmH",162,0.993865,26,163,1,162,1,1,0,1,1,71,70,92,92,40
"3692",91,"[26]HJHglqIHcdKpcJvcGHqwdCDrmH",167,0.994048,26,168,1,167,1,1,0,1,1,83,82,85,85,40
"3693",92,"[26]HJHglqIHcdKpcJvcGHqwdCDrmH",167,0.994048,26,168,1,167,1,1,0,1,1,84,83,84,84,40
"3694",93,"[26]HJHglqIHcdKpcJvcGHqwdCDrmH",167,0.994048,26,168,1,167,1,1,0,1,1,83,82,85,85,40
"3695",94,"[26]HJHglqIHcdKpcJvcGHqwdCDrmH",174,0.994286,26,175,1,174,1,1,0,1,1,103,102,72,72,40
"3696",95,"[26]HJHglqIHcdKpcJvcGHqwdCDrmH",169,0.994118,26,170,1,169,1,1,0,1,1,88,87,82,82,40
"3697",96,"[26]HJHglqIHcdKpcJvcGHqwdCDrmH",163,0.993902,26,164,1,163,1,1,0,1,1,74,73,90,90,40
"3698",97,"[26]HJHglqIHcdKpcJvcGHqwdCDrmH",168,0.994083,26,169,1,168,1,1,0,1,1,88,87,81,81,40
"3699",98,"[26]HJHglqIHcdKpcJvcGHqwdCDrmH",172,0.99422,26,173,1,172,1,1,0,1,1,97,96,76,76,40
"3700",99,"[26]HJHglqIHcdKpcJvcGHqwdCDrmH",163,0.993902,26,164,1,163,1,1,0,1,1,75,74,89,89,40
"3701",0,"[27]mJHggqlIHBidKocJvcGHqFdCkum",176,0.99435,27,177,1,176,1,1,0,1,1,90,89,87,87,41
"3702",1,"[27]mJHggqlIHBidKocJvcGHqFdCkum",175,0.994318,27,176,1,175,1,1,0,1,1,84,83,92,92,41
"3703",2,"[27]mJHggqlIHBidKocJvcGHqFdCkum",176,0.99435,27,177,1,176,1,1,0,1,1,90,89,87,87,41
"3704",3,"[27]mJHggqlIHBidKocJvcGHqFdCkum",174,0.994286,27,175,1,174,1,1,0,1,1,81,80,94,94,41
"3705",4,"[27]mJHggqlIHBidKocJvcGHqFdCkum",177,0.994382,27,178,1,177,1,1,0,1,1,92,91,86,86,41
"3706",5,"[27]mJHggqlIHBidKocJvcGHqFdCkum",173,0.994253,27,174,1,173,1,1,0,1,1,80,79,94,94,41
"3707",6,"[27]mJHggqlIHBidKocJvcGHqFdCkum",173,0.994253,27,174,1,173,1,1,0,1,1,81,80,93,93,41
"3708",7,"[27]mJHggqlIHBidKocJvcGHqFdCkum",178,0.994413,27,179,1,178,1,1,0,1,1,97,96,82,82,41
"3709",8,"[27]mJHggqlIHBidKocJvcGHqFdCkum",179,0.994444,27,180,1,179,1,1,0,1,1,100,99,80,80,41
"3710",9,"[27]mJHggqlIHBidKocJvcGHqFdCkum",177,0.994382,27,178,1,177,1,1,0,1,1,93,92,85,85,41
"3711",10,"[27]mJHggqlIHBidKocJvcGHqFdCkum",175,0.994318,27,176,1,175,1,1,0,1,1,87,86,89,89,41
"3712",11,"[27]mJHggqlIHBidKocJvcGHqFdCkum",175,0.994318,27,176,1,175,1,1,0,1,1,86,85,90,90,41
"3713",12,"[27]mJHggqlIHBidKocJvcGHqFdCkum",178,0.994413,27,179,1,178,1,1,0,1,1,93,92,86,86,41
"3714",13,"[27]mJHggqlIHBidKocJvcGHqFdCkum",174,0.994286,27,175,1,174,1,1,0,1,1,83,82,92,92,41
"3715",14,"[27]mJHggqlIHBidKocJvcGHqFdCkum",174,0.994286,27,175,1,174,1,1,0,1,1,79,78,96,96,41
"3716",15,"[27]mJHggqlIHBidKocJvcGHqFdCkum",177,0.994382,27,178,1,177,1,1,0,1,1,93,92,85,85,41
"3717",16,"[27]mJHggqlIHBidKocJvcGHqFdCkum",175,0.994318,27,176,1,175,1,1,0,1,1,87,86,89,89,41
"3718",17,"[27]mJHggqlIHBidKocJvcGHqFdCkum",176,0.99435,27,177,1,176,1,1,0,1,1,88,87,89,89,41
"3719",18,"[27]mJHggqlIHBidKocJvcGHqFdCkum",173,0.994253,27,174,1,173,1,1,0,1,1,79,78,95,95,41
"3720",19,"[27]mJHggqlIHBidKocJvcGHqFdCkum",176,0.99435,27,177,1,176,1,1,0,1,1,89,88,88,88,41
"3721",20,"[27]mJHggqlIHBidKocJvcGHqFdCkum",178,0.994413,27,179,1,178,1,1,0,1,1,96,95,83,83,41
"3722",21,"[27]mJHggqlIHBidKocJvcGHqFdCkum",179,0.994444,27,180,1,179,1,1,0,1,1,101,100,79,79,41
"3723",22,"[27]mJHggqlIHBidKocJvcGHqFdCkum",174,0.994286,27,175,1,174,1,1,0,1,1,81,80,94,94,41
"3724",23,"[27]mJHggqlIHBidKocJvcGHqFdCkum",176,0.99435,27,177,1,176,1,1,0,1,1,90,89,87,87,41
"3725",24,"[27]mJHggqlIHBidKocJvcGHqFdCkum",178,0.994413,27,179,1,178,1,1,0,1,1,96,95,83,83,41
"3726",25,"[27]mJHggqlIHBidKocJvcGHqFdCkum",176,0.99435,27,177,1,176,1,1,0,1,1,88,87,89,89,41
"3727",26,"[27]mJHggqlIHBidKocJvcGHqFdCkum",173,0.994253,27,174,1,173,1,1,0,1,1,79,78,95,95,41
"3728",27,"[27]mJHggqlIHBidKocJvcGHqFdCkum",178,0.994413,27,179,1,178,1,1,0,1,1,94,93,85,85,41
"3729",28,"[27]mJHggqlIHBidKocJvcGHqFdCkum",175,0.994318,27,176,1,175,1,1,0,1,1,87,86,89,89,41
"3730",29,"[27]mJHggqlIHBidKocJvcGHqFdCkum",176,0.99435,27,177,1,176,1,1,0,1,1,89,88,88,88,41
"3731",30,"[27]mJHggqlIHBidKocJvcGHqFdCkum",179,0.994444,27,180,1,179,1,1,0,1,1,98,97,82,82,41
"3732",31,"[27]mJHggqlIHBidKocJvcGHqFdCkum",176,0.99435,27,177,1,176,1,1,0,1,1,90,89,87,87,41
"3733",32,"[27]mJHggqlIHBidKocJvcGHqFdCkum",175,0.994318,27,176,1,175,1,1,0,1,1,85,84,91,91,41
"3734",33,"[27]mJHggqlIHBidKocJvcGHqFdCkum",176,0.99435,27,177,1,176,1,1,0,1,1,90,89,87,87,41
"3735",34,"[27]mJHggqlIHBidKocJvcGHqFdCkum",177,0.994382,27,178,1,177,1,1,0,1,1,94,93,84,84,41
"3736",35,"[27]mJHggqlIHBidKocJvcGHqFdCkum",177,0.994382,27,178,1,177,1,1,0,1,1,92,91,86,86,41
"3737",36,"[27]mJHggqlIHBidKocJvcGHqFdCkum",172,0.99422,27,173,1,172,1,1,0,1,1,77,76,96,96,41
"3738",37,"[27]mJHggqlIHBidKocJvcGHqFdCkum",173,0.994253,27,174,1,173,1,1,0,1,1,78,77,96,96,41
"3739",38,"[27]mJHggqlIHBidKocJvcGHqFdCkum",173,0.994253,27,174,1,173,1,1,0,1,1,79,78,95,95,41
"3740",39,"[27]mJHggqlIHBidKocJvcGHqFdCkum",178,0.994413,27,179,1,178,1,1,0,1,1,96,95,83,83,41
"3741",40,"[27]mJHggqlIHBidKocJvcGHqFdCkum",177,0.994382,27,178,1,177,1,1,0,1,1,90,89,88,88,41
"3742",41,"[27]mJHggqlIHBidKocJvcGHqFdCkum",178,0.994413,27,179,1,178,1,1,0,1,1,93,92,86,86,41
"3743",42,"[27]mJHggqlIHBidKocJvcGHqFdCkum",178,0.994413,27,179,1,178,1,1,0,1,1,96,95,83,83,41
"3744",43,"[27]mJHggqlIHBidKocJvcGHqFdCkum",173,0.994253,27,174,1,173,1,1,0,1,1,79,78,95,95,41
"3745",44,"[27]mJHggqlIHBidKocJvcGHqFdCkum",175,0.994318,27,176,1,175,1,1,0,1,1,87,86,89,89,41
"3746",45,"[27]mJHggqlIHBidKocJvcGHqFdCkum",177,0.994382,27,178,1,177,1,1,0,1,1,90,89,88,88,41
"3747",46,"[27]mJHggqlIHBidKocJvcGHqFdCkum",178,0.994413,27,179,1,178,1,1,0,1,1,95,94,84,84,41
"3748",47,"[27]mJHggqlIHBidKocJvcGHqFdCkum",174,0.994286,27,175,1,174,1,1,0,1,1,83,82,92,92,41
"3749",48,"[27]mJHggqlIHBidKocJvcGHqFdCkum",174,0.994286,27,175,1,174,1,1,0,1,1,83,82,92,92,41
"3750",49,"[27]mJHggqlIHBidKocJvcGHqFdCkum",174,0.994286,27,175,1,174,1,1,0,1,1,78,77,97,97,41
"3751",50,"[27]mJHggqlIHBidKocJvcGHqFdCkum",175,0.994318,27,176,1,175,1,1,0,1,1,85,84,91,91,41
"3752",51,"[27]mJHggqlIHBidKocJvcGHqFdCkum",175,0.994318,27,176,1,175,1,1,0,1,1,87,86,89,89,41
"3753",52,"[27]mJHggqlIHBidKocJvcGHqFdCkum",175,0.994318,27,176,1,175,1,1,0,1,1,87,86,89,89,41
"3754",53,"[27]mJHggqlIHBidKocJvcGHqFdCkum",176,0.99435,27,177,1,176,1,1,0,1,1,89,88,88,88,41
"3755",54,"[27]mJHggqlIHBidKocJvcGHqFdCkum",179,0.994444,27,180,1,179,1,1,0,1,1,100,99,80,80,41
"3756",55,"[27]mJHggqlIHBidKocJvcGHqFdCkum",173,0.994253,27,174,1,173,1,1,0,1,1,79,78,95,95,41
"3757",56,"[27]mJHggqlIHBidKocJvcGHqFdCkum",176,0.99435,27,177,1,176,1,1,0,1,1,88,87,89,89,41
"3758",57,"[27]mJHggqlIHBidKocJvcGHqFdCkum",178,0.994413,27,179,1,178,1,1,0,1,1,93,92,86,86,41
"3759",58,"[27]mJHggqlIHBidKocJvcGHqFdCkum",174,0.994286,27,175,1,174,1,1,0,1,1,80,79,95,95,41
"3760",59,"[27]mJHggqlIHBidKocJvcGHqFdCkum",179,0.994444,27,180,1,179,1,1,0,1,1,99,98,81,81,41
"3761",60,"[27]mJHggqlIHBidKocJvcGHqFdCkum",174,0.994286,27,175,1,174,1,1,0,1,1,84,83,91,91,41
"3762",61,"[27]mJHggqlIHBidKocJvcGHqFdCkum",178,0.994413,27,179,1,178,1,1,0,1,1,97,96,82,82,41
"3763",62,"[27]mJHggqlIHBidKocJvcGHqFdCkum",173,0.994253,27,174,1,173,1,1,0,1,1,80,79,94,94,41
"3764",63,"[27]mJHggqlIHBidKocJvcGHqFdCkum",176,0.99435,27,177,1,176,1,1,0,1,1,88,87,89,89,41
"3765",64,"[27]mJHggqlIHBidKocJvcGHqFdCkum",169,0.994118,27,170,1,169,1,1,0,1,1,67,66,103,103,41
"3766",65,"[27]mJHggqlIHBidKocJvcGHqFdCkum",177,0.994382,27,178,1,177,1,1,0,1,1,91,90,87,87,41
"3767",66,"[27]mJHggqlIHBidKocJvcGHqFdCkum",176,0.99435,27,177,1,176,1,1,0,1,1,90,89,87,87,41
"3768",67,"[27]mJHggqlIHBidKocJvcGHqFdCkum",179,0.994444,27,180,1,179,1,1,0,1,1,101,100,79,79,41
"3769",68,"[27]mJHggqlIHBidKocJvcGHqFdCkum",176,0.99435,27,177,1,176,1,1,0,1,1,88,87,89,89,41
"3770",69,"[27]mJHggqlIHBidKocJvcGHqFdCkum",172,0.99422,27,173,1,172,1,1,0,1,1,77,76,96,96,41
"3771",70,"[27]mJHggqlIHBidKocJvcGHqFdCkum",178,0.994413,27,179,1,178,1,1,0,1,1,95,94,84,84,41
"3772",71,"[27]mJHggqlIHBidKocJvcGHqFdCkum",178,0.994413,27,179,1,178,1,1,0,1,1,96,95,83,83,41
"3773",72,"[27]mJHggqlIHBidKocJvcGHqFdCkum",172,0.99422,27,173,1,172,1,1,0,1,1,75,74,98,98,41
"3774",73,"[27]mJHggqlIHBidKocJvcGHqFdCkum",178,0.994413,27,179,1,178,1,1,0,1,1,92,91,87,87,41
"3775",74,"[27]mJHggqlIHBidKocJvcGHqFdCkum",176,0.99435,27,177,1,176,1,1,0,1,1,88,87,89,89,41
"3776",75,"[27]mJHggqlIHBidKocJvcGHqFdCkum",174,0.994286,27,175,1,174,1,1,0,1,1,81,80,94,94,41
"3777",76,"[27]mJHggqlIHBidKocJvcGHqFdCkum",177,0.994382,27,178,1,177,1,1,0,1,1,93,92,85,85,41
"3778",77,"[27]mJHggqlIHBidKocJvcGHqFdCkum",178,0.994413,27,179,1,178,1,1,0,1,1,96,95,83,83,41
"3779",78,"[27]mJHggqlIHBidKocJvcGHqFdCkum",175,0.994318,27,176,1,175,1,1,0,1,1,85,84,91,91,41
"3780",79,"[27]mJHggqlIHBidKocJvcGHqFdCkum",173,0.994253,27,174,1,173,1,1,0,1,1,77,76,97,97,41
"3781",80,"[27]mJHggqlIHBidKocJvcGHqFdCkum",177,0.994382,27,178,1,177,1,1,0,1,1,91,90,87,87,41
"3782",81,"[27]mJHggqlIHBidKocJvcGHqFdCkum",180,0.994475,27,181,1,180,1,1,0,1,1,101,100,80,80,41
"3783",82,"[27]mJHggqlIHBidKocJvcGHqFdCkum",175,0.994318,27,176,1,175,1,1,0,1,1,87,86,89,89,41
"3784",83,"[27]mJHggqlIHBidKocJvcGHqFdCkum",177,0.994382,27,178,1,177,1,1,0,1,1,92,91,86,86,41
"3785",84,"[27]mJHggqlIHBidKocJvcGHqFdCkum",175,0.994318,27,176,1,175,1,1,0,1,1,87,86,89,89,41
"3786",85,"[27]mJHggqlIHBidKocJvcGHqFdCkum",173,0.994253,27,174,1,173,1,1,0,1,1,81,80,93,93,41
"3787",86,"[27]mJHggqlIHBidKocJvcGHqFdCkum",180,0.994475,27,181,1,180,1,1,0,1,1,100,99,81,81,41
"3788",87,"[27]mJHggqlIHBidKocJvcGHqFdCkum",173,0.994253,27,174,1,173,1,1,0,1,1,81,80,93,93,41
"3789",88,"[27]mJHggqlIHBidKocJvcGHqFdCkum",178,0.994413,27,179,1,178,1,1,0,1,1,95,94,84,84,41
"3790",89,"[27]mJHggqlIHBidKocJvcGHqFdCkum",177,0.994382,27,178,1,177,1,1,0,1,1,94,93,84,84,41
"3791",90,"[27]mJHggqlIHBidKocJvcGHqFdCkum",174,0.994286,27,175,1,174,1,1,0,1,1,84,83,91,91,41
"3792",91,"[27]mJHggqlIHBidKocJvcGHqFdCkum",180,0.994475,27,181,1,180,1,1,0,1,1,102,101,79,79,41
"3793",92,"[27]mJHggqlIHBidKocJvcGHqFdCkum",175,0.994318,27,176,1,175,1,1,0,1,1,85,84,91,91,41
"3794",93,"[27]mJHggqlIHBidKocJvcGHqFdCkum",174,0.994286,27,175,1,174,1,1,0,1,1,84,83,91,91,41
"3795",94,"[27]mJHggqlIHBidKocJvcGHqFdCkum",178,0.994413,27,179,1,178,1,1,0,1,1,97,96,82,82,41
"3796",95,"[27]mJHggqlIHBidKocJvcGHqFdCkum",181,0.994505,27,182,1,181,1,1,0,1,1,104,103,78,78,41
"3797",96,"[27]mJHggqlIHBidKocJvcGHqFdCkum",173,0.994253,27,174,1,173,1,1,0,1,1,79,78,95,95,41
"3798",97,"[27]mJHggqlIHBidKocJvcGHqFdCkum",173,0.994253,27,174,1,173,1,1,0,1,1,81,80,93,93,41
"3799",98,"[27]mJHggqlIHBidKocJvcGHqFdCkum",176,0.99435,27,177,1,176,1,1,0,1,1,90,89,87,87,41
"3800",99,"[27]mJHggqlIHBidKocJvcGHqFdCkum",175,0.994318,27,176,1,175,1,1,0,1,1,85,84,91,91,41
"3801",0,"[27]mJHggqIHcdKpcJvcGHqxdCrclij",163,0.993902,27,164,1,163,1,1,0,1,1,75,74,89,89,42
"3802",1,"[27]mJHggqIHcdKpcJvcGHqxdCrclij",168,0.994083,27,169,1,168,1,1,0,1,1,86,85,83,83,42
"3803",2,"[27]mJHggqIHcdKpcJvcGHqxdCrclij",169,0.994118,27,170,1,169,1,1,0,1,1,90,89,80,80,42
"3804",3,"[27]mJHggqIHcdKpcJvcGHqxdCrclij",164,0.993939,27,165,1,164,1,1,0,1,1,77,76,88,88,42
"3805",4,"[27]mJHggqIHcdKpcJvcGHqxdCrclij",167,0.994048,27,168,1,167,1,1,0,1,1,85,84,83,83,42
"3806",5,"[27]mJHggqIHcdKpcJvcGHqxdCrclij",161,0.993827,27,162,1,161,1,1,0,1,1,67,66,95,95,42
"3807",6,"[27]mJHggqIHcdKpcJvcGHqxdCrclij",165,0.993976,27,166,1,165,1,1,0,1,1,79,78,87,87,42
"3808",7,"[27]mJHggqIHcdKpcJvcGHqxdCrclij",161,0.993827,27,162,1,161,1,1,0,1,1,69,68,93,93,42
"3809",8,"[27]mJHggqIHcdKpcJvcGHqxdCrclij",162,0.993865,27,163,1,162,1,1,0,1,1,71,70,92,92,42
"3810",9,"[27]mJHggqIHcdKpcJvcGHqxdCrclij",166,0.994012,27,167,1,166,1,1,0,1,1,82,81,85,85,42
"3811",10,"[27]mJHggqIHcdKpcJvcGHqxdCrclij",167,0.994048,27,168,1,167,1,1,0,1,1,84,83,84,84,42
"3812",11,"[27]mJHggqIHcdKpcJvcGHqxdCrclij",168,0.994083,27,169,1,168,1,1,0,1,1,86,85,83,83,42
"3813",12,"[27]mJHggqIHcdKpcJvcGHqxdCrclij",162,0.993865,27,163,1,162,1,1,0,1,1,71,70,92,92,42
"3814",13,"[27]mJHggqIHcdKpcJvcGHqxdCrclij",166,0.994012,27,167,1,166,1,1,0,1,1,82,81,85,85,42
"3815",14,"[27]mJHggqIHcdKpcJvcGHqxdCrclij",169,0.994118,27,170,1,169,1,1,0,1,1,91,90,79,79,42
"3816",15,"[27]mJHggqIHcdKpcJvcGHqxdCrclij",166,0.994012,27,167,1,166,1,1,0,1,1,82,81,85,85,42
"3817",16,"[27]mJHggqIHcdKpcJvcGHqxdCrclij",170,0.994152,27,171,1,170,1,1,0,1,1,93,92,78,78,42
"3818",17,"[27]mJHggqIHcdKpcJvcGHqxdCrclij",164,0.993939,27,165,1,164,1,1,0,1,1,75,74,90,90,42
"3819",18,"[27]mJHggqIHcdKpcJvcGHqxdCrclij",165,0.993976,27,166,1,165,1,1,0,1,1,80,79,86,86,42
"3820",19,"[27]mJHggqIHcdKpcJvcGHqxdCrclij",162,0.993865,27,163,1,162,1,1,0,1,1,71,70,92,92,42
"3821",20,"[27]mJHggqIHcdKpcJvcGHqxdCrclij",164,0.993939,27,165,1,164,1,1,0,1,1,76,75,89,89,42
"3822",21,"[27]mJHggqIHcdKpcJvcGHqxdCrclij",165,0.993976,27,166,1,165,1,1,0,1,1,79,78,87,87,42
"3823",22,"[27]mJHggqIHcdKpcJvcGHqxdCrclij",164,0.993939,27,165,1,164,1,1,0,1,1,76,75,89,89,42
"3824",23,"[27]mJHggqIHcdKpcJvcGHqxdCrclij",169,0.994118,27,170,1,169,1,1,0,1,1,87,86,83,83,42
"3825",24,"[27]mJHggqIHcdKpcJvcGHqxdCrclij",166,0.994012,27,167,1,166,1,1,0,1,1,83,82,84,84,42
"3826",25,"[27]mJHggqIHcdKpcJvcGHqxdCrclij",166,0.994012,27,167,1,166,1,1,0,1,1,82,81,85,85,42
"3827",26,"[27]mJHggqIHcdKpcJvcGHqxdCrclij",169,0.994118,27,170,1,169,1,1,0,1,1,90,89,80,80,42
"3828",27,"[27]mJHggqIHcdKpcJvcGHqxdCrclij",163,0.993902,27,164,1,163,1,1,0,1,1,75,74,89,89,42
"3829",28,"[27]mJHggqIHcdKpcJvcGHqxdCrclij",169,0.994118,27,170,1,169,1,1,0,1,1,91,90,79,79,42
"3830",29,"[27]mJHggqIHcdKpcJvcGHqxdCrclij",170,0.994152,27,171,1,170,1,1,0,1,1,93,92,78,78,42
"3831",30,"[27]mJHggqIHcdKpcJvcGHqxdCrclij",166,0.994012,27,167,1,166,1,1,0,1,1,81,80,86,86,42
"3832",31,"[27]mJHggqIHcdKpcJvcGHqxdCrclij",166,0.994012,27,167,1,166,1,1,0,1,1,83,82,84,84,42
"3833",32,"[27]mJHggqIHcdKpcJvcGHqxdCrclij",168,0.994083,27,169,1,168,1,1,0,1,1,87,86,82,82,42
"3834",33,"[27]mJHggqIHcdKpcJvcGHqxdCrclij",169,0.994118,27,170,1,169,1,1,0,1,1,89,88,81,81,42
"3835",34,"[27]mJHggqIHcdKpcJvcGHqxdCrclij",174,0.994286,27,175,1,174,1,1,0,1,1,101,100,74,74,42
"3836",35,"[27]mJHggqIHcdKpcJvcGHqxdCrclij",168,0.994083,27,169,1,168,1,1,0,1,1,88,87,81,81,42
"3837",36,"[27]mJHggqIHcdKpcJvcGHqxdCrclij",165,0.993976,27,166,1,165,1,1,0,1,1,79,78,87,87,42
"3838",37,"[27]mJHggqIHcdKpcJvcGHqxdCrclij",161,0.993827,27,162,1,161,1,1,0,1,1,68,67,94,94,42
"3839",38,"[27]mJHggqIHcdKpcJvcGHqxdCrclij",169,0.994118,27,170,1,169,1,1,0,1,1,90,89,80,80,42
"3840",39,"[27]mJHggqIHcdKpcJvcGHqxdCrclij",165,0.993976,27,166,1,165,1,1,0,1,1,80,79,86,86,42
"3841",40,"[27]mJHggqIHcdKpcJvcGHqxdCrclij",167,0.994048,27,168,1,167,1,1,0,1,1,85,84,83,83,42
"3842",41,"[27]mJHggqIHcdKpcJvcGHqxdCrclij",167,0.994048,27,168,1,167,1,1,0,1,1,85,84,83,83,42
"3843",42,"[27]mJHggqIHcdKpcJvcGHqxdCrclij",164,0.993939,27,165,1,164,1,1,0,1,1,76,75,89,89,42
"3844",43,"[27]mJHggqIHcdKpcJvcGHqxdCrclij",165,0.993976,27,166,1,165,1,1,0,1,1,79,78,87,87,42
"3845",44,"[27]mJHggqIHcdKpcJvcGHqxdCrclij",169,0.994118,27,170,1,169,1,1,0,1,1,91,90,79,79,42
"3846",45,"[27]mJHggqIHcdKpcJvcGHqxdCrclij",165,0.993976,27,166,1,165,1,1,0,1,1,80,79,86,86,42
"3847",46,"[27]mJHggqIHcdKpcJvcGHqxdCrclij",164,0.993939,27,165,1,164,1,1,0,1,1,76,75,89,89,42
"3848",47,"[27]mJHggqIHcdKpcJvcGHqxdCrclij",163,0.993902,27,164,1,163,1,1,0,1,1,74,73,90,90,42
"3849",48,"[27]mJHggqIHcdKpcJvcGHqxdCrclij",168,0.994083,27,169,1,168,1,1,0,1,1,87,86,82,82,42
"3850",49,"[27]mJHggqIHcdKpcJvcGHqxdCrclij",162,0.993865,27,163,1,162,1,1,0,1,1,71,70,92,92,42
"3851",50,"[27]mJHggqIHcdKpcJvcGHqxdCrclij",163,0.993902,27,164,1,163,1,1,0,1,1,75,74,89,89,42
"3852",51,"[27]mJHggqIHcdKpcJvcGHqxdCrclij",171,0.994186,27,172,1,171,1,1,0,1,1,94,93,78,78,42
"3853",52,"[27]mJHggqIHcdKpcJvcGHqxdCrclij",172,0.99422,27,173,1,172,1,1,0,1,1,98,97,75,75,42
"3854",53,"[27]mJHggqIHcdKpcJvcGHqxdCrclij",171,0.994186,27,172,1,171,1,1,0,1,1,97,96,75,75,42
"3855",54,"[27]mJHggqIHcdKpcJvcGHqxdCrclij",171,0.994186,27,172,1,171,1,1,0,1,1,94,93,78,78,42
"3856",55,"[27]mJHggqIHcdKpcJvcGHqxdCrclij",168,0.994083,27,169,1,168,1,1,0,1,1,88,87,81,81,42
"3857",56,"[27]mJHggqIHcdKpcJvcGHqxdCrclij",165,0.993976,27,166,1,165,1,1,0,1,1,78,77,88,88,42
"3858",57,"[27]mJHggqIHcdKpcJvcGHqxdCrclij",170,0.994152,27,171,1,170,1,1,0,1,1,91,90,80,80,42
"3859",58,"[27]mJHggqIHcdKpcJvcGHqxdCrclij",167,0.994048,27,168,1,167,1,1,0,1,1,84,83,84,84,42
"3860",59,"[27]mJHggqIHcdKpcJvcGHqxdCrclij",171,0.994186,27,172,1,171,1,1,0,1,1,95,94,77,77,42
"3861",60,"[27]mJHggqIHcdKpcJvcGHqxdCrclij",165,0.993976,27,166,1,165,1,1,0,1,1,79,78,87,87,42
"3862",61,"[27]mJHggqIHcdKpcJvcGHqxdCrclij",167,0.994048,27,168,1,167,1,1,0,1,1,85,84,83,83,42
"3863",62,"[27]mJHggqIHcdKpcJvcGHqxdCrclij",167,0.994048,27,168,1,167,1,1,0,1,1,85,84,83,83,42
"3864",63,"[27]mJHggqIHcdKpcJvcGHqxdCrclij",167,0.994048,27,168,1,167,1,1,0,1,1,85,84,83,83,42
"3865",64,"[27]mJHggqIHcdKpcJvcGHqxdCrclij",162,0.993865,27,163,1,162,1,1,0,1,1,72,71,91,91,42
"3866",65,"[27]mJHggqIHcdKpcJvcGHqxdCrclij",168,0.994083,27,169,1,168,1,1,0,1,1,87,86,82,82,42
"3867",66,"[27]mJHggqIHcdKpcJvcGHqxdCrclij",170,0.994152,27,171,1,170,1,1,0,1,1,92,91,79,79,42
"3868",67,"[27]mJHggqIHcdKpcJvcGHqxdCrclij",167,0.994048,27,168,1,167,1,1,0,1,1,84,83,84,84,42
"3869",68,"[27]mJHggqIHcdKpcJvcGHqxdCrclij",168,0.994083,27,169,1,168,1,1,0,1,1,87,86,82,82,42
"3870",69,"[27]mJHggqIHcdKpcJvcGHqxdCrclij",162,0.993865,27,163,1,162,1,1,0,1,1,68,67,95,95,42
"3871",70,"[27]mJHggqIHcdKpcJvcGHqxdCrclij",164,0.993939,27,165,1,164,1,1,0,1,1,76,75,89,89,42
"3872",71,"[27]mJHggqIHcdKpcJvcGHqxdCrclij",165,0.993976,27,166,1,165,1,1,0,1,1,79,78,87,87,42
"3873",72,"[27]mJHggqIHcdKpcJvcGHqxdCrclij",172,0.99422,27,173,1,172,1,1,0,1,1,98,97,75,75,42
"3874",73,"[27]mJHggqIHcdKpcJvcGHqxdCrclij",167,0.994048,27,168,1,167,1,1,0,1,1,84,83,84,84,42
"3875",74,"[27]mJHggqIHcdKpcJvcGHqxdCrclij",170,0.994152,27,171,1,170,1,1,0,1,1,92,91,79,79,42
"3876",75,"[27]mJHggqIHcdKpcJvcGHqxdCrclij",163,0.993902,27,164,1,163,1,1,0,1,1,74,73,90,90,42
"3877",76,"[27]mJHggqIHcdKpcJvcGHqxdCrclij",167,0.994048,27,168,1,167,1,1,0,1,1,86,85,82,82,42
"3878",77,"[27]mJHggqIHcdKpcJvcGHqxdCrclij",164,0.993939,27,165,1,164,1,1,0,1,1,76,75,89,89,42
"3879",78,"[27]mJHggqIHcdKpcJvcGHqxdCrclij",166,0.994012,27,167,1,166,1,1,0,1,1,83,82,84,84,42
"3880",79,"[27]mJHggqIHcdKpcJvcGHqxdCrclij",161,0.993827,27,162,1,161,1,1,0,1,1,67,66,95,95,42
"3881",80,"[27]mJHggqIHcdKpcJvcGHqxdCrclij",167,0.994048,27,168,1,167,1,1,0,1,1,84,83,84,84,42
"3882",81,"[27]mJHggqIHcdKpcJvcGHqxdCrclij",167,0.994048,27,168,1,167,1,1,0,1,1,82,81,86,86,42
"3883",82,"[27]mJHggqIHcdKpcJvcGHqxdCrclij",172,0.99422,27,173,1,172,1,1,0,1,1,99,98,74,74,42
"3884",83,"[27]mJHggqIHcdKpcJvcGHqxdCrclij",165,0.993976,27,166,1,165,1,1,0,1,1,79,78,87,87,42
"3885",84,"[27]mJHggqIHcdKpcJvcGHqxdCrclij",165,0.993976,27,166,1,165,1,1,0,1,1,79,78,87,87,42
"3886",85,"[27]mJHggqIHcdKpcJvcGHqxdCrclij",168,0.994083,27,169,1,168,1,1,0,1,1,87,86,82,82,42
"3887",86,"[27]mJHggqIHcdKpcJvcGHqxdCrclij",166,0.994012,27,167,1,166,1,1,0,1,1,79,78,88,88,42
"3888",87,"[27]mJHggqIHcdKpcJvcGHqxdCrclij",166,0.994012,27,167,1,166,1,1,0,1,1,82,81,85,85,42
"3889",88,"[27]mJHggqIHcdKpcJvcGHqxdCrclij",167,0.994048,27,168,1,167,1,1,0,1,1,85,84,83,83,42
"3890",89,"[27]mJHggqIHcdKpcJvcGHqxdCrclij",171,0.994186,27,172,1,171,1,1,0,1,1,94,93,78,78,42
"3891",90,"[27]mJHggqIHcdKpcJvcGHqxdCrclij",167,0.994048,27,168,1,167,1,1,0,1,1,83,82,85,85,42
"3892",91,"[27]mJHggqIHcdKpcJvcGHqxdCrclij",163,0.993902,27,164,1,163,1,1,0,1,1,74,73,90,90,42
"3893",92,"[27]mJHggqIHcdKpcJvcGHqxdCrclij",169,0.994118,27,170,1,169,1,1,0,1,1,90,89,80,80,42
"3894",93,"[27]mJHggqIHcdKpcJvcGHqxdCrclij",170,0.994152,27,171,1,170,1,1,0,1,1,92,91,79,79,42
"3895",94,"[27]mJHggqIHcdKpcJvcGHqxdCrclij",171,0.994186,27,172,1,171,1,1,0,1,1,95,94,77,77,42
"3896",95,"[27]mJHggqIHcdKpcJvcGHqxdCrclij",168,0.994083,27,169,1,168,1,1,0,1,1,87,86,82,82,42
"3897",96,"[27]mJHggqIHcdKpcJvcGHqxdCrclij",169,0.994118,27,170,1,169,1,1,0,1,1,89,88,81,81,42
"3898",97,"[27]mJHggqIHcdKpcJvcGHqxdCrclij",166,0.994012,27,167,1,166,1,1,0,1,1,82,81,85,85,42
"3899",98,"[27]mJHggqIHcdKpcJvcGHqxdCrclij",170,0.994152,27,171,1,170,1,1,0,1,1,92,91,79,79,42
"3900",99,"[27]mJHggqIHcdKpcJvcGHqxdCrclij",167,0.994048,27,168,1,167,1,1,0,1,1,85,84,83,83,42
"3901",0,"[31]mJHqaIgHcAidKpcJvcGHqFdCDbfkmss",178,0.994413,31,179,1,178,1,1,0,1,1,97,96,82,82,43
"3902",1,"[31]mJHqaIgHcAidKpcJvcGHqFdCDbfkmss",177,0.994382,31,178,1,177,1,1,0,1,1,93,92,85,85,43
"3903",2,"[31]mJHqaIgHcAidKpcJvcGHqFdCDbfkmss",179,0.994444,31,180,1,179,1,1,0,1,1,93,92,87,87,43
"3904",3,"[31]mJHqaIgHcAidKpcJvcGHqFdCDbfkmss",179,0.994444,31,180,1,179,1,1,0,1,1,97,96,83,83,43
"3905",4,"[31]mJHqaIgHcAidKpcJvcGHqFdCDbfkmss",173,0.994253,31,174,1,173,1,1,0,1,1,81,80,93,93,43
"3906",5,"[31]mJHqaIgHcAidKpcJvcGHqFdCDbfkmss",178,0.994413,31,179,1,178,1,1,0,1,1,92,91,87,87,43
"3907",6,"[31]mJHqaIgHcAidKpcJvcGHqFdCDbfkmss",173,0.994253,31,174,1,173,1,1,0,1,1,79,78,95,95,43
"3908",7,"[31]mJHqaIgHcAidKpcJvcGHqFdCDbfkmss",175,0.994318,31,176,1,175,1,1,0,1,1,85,84,91,91,43
"3909",8,"[31]mJHqaIgHcAidKpcJvcGHqFdCDbfkmss",176,0.99435,31,177,1,176,1,1,0,1,1,88,87,89,89,43
"3910",9,"[31]mJHqaIgHcAidKpcJvcGHqFdCDbfkmss",177,0.994382,31,178,1,177,1,1,0,1,1,93,92,85,85,43
"3911",10,"[31]mJHqaIgHcAidKpcJvcGHqFdCDbfkmss",179,0.994444,31,180,1,179,1,1,0,1,1,97,96,83,83,43
"3912",11,"[31]mJHqaIgHcAidKpcJvcGHqFdCDbfkmss",177,0.994382,31,178,1,177,1,1,0,1,1,91,90,87,87,43
"3913",12,"[31]mJHqaIgHcAidKpcJvcGHqFdCDbfkmss",179,0.994444,31,180,1,179,1,1,0,1,1,94,93,86,86,43
"3914",13,"[31]mJHqaIgHcAidKpcJvcGHqFdCDbfkmss",179,0.994444,31,180,1,179,1,1,0,1,1,99,98,81,81,43
"3915",14,"[31]mJHqaIgHcAidKpcJvcGHqFdCDbfkmss",172,0.99422,31,173,1,172,1,1,0,1,1,73,72,100,100,43
"3916",15,"[31]mJHqaIgHcAidKpcJvcGHqFdCDbfkmss",176,0.99435,31,177,1,176,1,1,0,1,1,91,90,86,86,43
"3917",16,"[31]mJHqaIgHcAidKpcJvcGHqFdCDbfkmss",176,0.99435,31,177,1,176,1,1,0,1,1,88,87,89,89,43
"3918",17,"[31]mJHqaIgHcAidKpcJvcGHqFdCDbfkmss",185,0.994624,31,186,1,185,1,1,0,1,1,115,114,71,71,43
"3919",18,"[31]mJHqaIgHcAidKpcJvcGHqFdCDbfkmss",177,0.994382,31,178,1,177,1,1,0,1,1,90,89,88,88,43
"3920",19,"[31]mJHqaIgHcAidKpcJvcGHqFdCDbfkmss",172,0.99422,31,173,1,172,1,1,0,1,1,75,74,98,98,43
"3921",20,"[31]mJHqaIgHcAidKpcJvcGHqFdCDbfkmss",175,0.994318,31,176,1,175,1,1,0,1,1,86,85,90,90,43
"3922",21,"[31]mJHqaIgHcAidKpcJvcGHqFdCDbfkmss",176,0.99435,31,177,1,176,1,1,0,1,1,91,90,86,86,43
"3923",22,"[31]mJHqaIgHcAidKpcJvcGHqFdCDbfkmss",178,0.994413,31,179,1,178,1,1,0,1,1,97,96,82,82,43
"3924",23,"[31]mJHqaIgHcAidKpcJvcGHqFdCDbfkmss",178,0.994413,31,179,1,178,1,1,0,1,1,95,94,84,84,43
"3925",24,"[31]mJHqaIgHcAidKpcJvcGHqFdCDbfkmss",175,0.994318,31,176,1,175,1,1,0,1,1,85,84,91,91,43
"3926",25,"[31]mJHqaIgHcAidKpcJvcGHqFdCDbfkmss",176,0.99435,31,177,1,176,1,1,0,1,1,82,81,95,95,43
"3927",26,"[31]mJHqaIgHcAidKpcJvcGHqFdCDbfkmss",178,0.994413,31,179,1,178,1,1,0,1,1,96,95,83,83,43
"3928",27,"[31]mJHqaIgHcAidKpcJvcGHqFdCDbfkmss",179,0.994444,31,180,1,179,1,1,0,1,1,97,96,83,83,43
"3929",28,"[31]mJHqaIgHcAidKpcJvcGHqFdCDbfkmss",174,0.994286,31,175,1,174,1,1,0,1,1,83,82,92,92,43
"3930",29,"[31]mJHqaIgHcAidKpcJvcGHqFdCDbfkmss",179,0.994444,31,180,1,179,1,1,0,1,1,95,94,85,85,43
"3931",30,"[31]mJHqaIgHcAidKpcJvcGHqFdCDbfkmss",173,0.994253,31,174,1,173,1,1,0,1,1,77,76,97,97,43
"3932",31,"[31]mJHqaIgHcAidKpcJvcGHqFdCDbfkmss",173,0.994253,31,174,1,173,1,1,0,1,1,79,78,95,95,43
"3933",32,"[31]mJHqaIgHcAidKpcJvcGHqFdCDbfkmss",175,0.994318,31,176,1,175,1,1,0,1,1,85,84,91,91,43
"3934",33,"[31]mJHqaIgHcAidKpcJvcGHqFdCDbfkmss",174,0.994286,31,175,1,174,1,1,0,1,1,84,83,91,91,43
"3935",34,"[31]mJHqaIgHcAidKpcJvcGHqFdCDbfkmss",172,0.99422,31,173,1,172,1,1,0,1,1,76,75,97,97,43
"3936",35,"[31]mJHqaIgHcAidKpcJvcGHqFdCDbfkmss",174,0.994286,31,175,1,174,1,1,0,1,1,83,82,92,92,43
"3937",36,"[31]mJHqaIgHcAidKpcJvcGHqFdCDbfkmss",177,0.994382,31,178,1,177,1,1,0,1,1,91,90,87,87,43
"3938",37,"[31]mJHqaIgHcAidKpcJvcGHqFdCDbfkmss",176,0.99435,31,177,1,176,1,1,0,1,1,90,89,87,87,43
"3939",38,"[31]mJHqaIgHcAidKpcJvcGHqFdCDbfkmss",173,0.994253,31,174,1,173,1,1,0,1,1,80,79,94,94,43
"3940",39,"[31]mJHqaIgHcAidKpcJvcGHqFdCDbfkmss",171,0.994186,31,172,1,171,1,1,0,1,1,74,73,98,98,43
"3941",40,"[31]mJHqaIgHcAidKpcJvcGHqFdCDbfkmss",179,0.994444,31,180,1,179,1,1,0,1,1,99,98,81,81,43
"3942",41,"[31]mJHqaIgHcAidKpcJvcGHqFdCDbfkmss",173,0.994253,31,174,1,173,1,1,0,1,1,78,77,96,96,43
"3943",42,"[31]mJHqaIgHcAidKpcJvcGHqFdCDbfkmss",177,0.994382,31,178,1,177,1,1,0,1,1,91,90,87,87,43
"3944",43,"[31]mJHqaIgHcAidKpcJvcGHqFdCDbfkmss",173,0.994253,31,174,1,173,1,1,0,1,1,80,79,94,94,43
"3945",44,"[31]mJHqaIgHcAidKpcJvcGHqFdCDbfkmss",178,0.994413,31,179,1,178,1,1,0,1,1,93,92,86,86,43
"3946",45,"[31]mJHqaIgHcAidKpcJvcGHqFdCDbfkmss",176,0.99435,31,177,1,176,1,1,0,1,1,90,89,87,87,43
"3947",46,"[31]mJHqaIgHcAidKpcJvcGHqFdCDbfkmss",174,0.994286,31,175,1,174,1,1,0,1,1,81,80,94,94,43
"3948",47,"[31]mJHqaIgHcAidKpcJvcGHqFdCDbfkmss",178,0.994413,31,179,1,178,1,1,0,1,1,95,94,84,84,43
"3949",48,"[31]mJHqaIgHcAidKpcJvcGHqFdCDbfkmss",177,0.994382,31,178,1,177,1,1,0,1,1,93,92,85,85,43
"3950",49,"[31]mJHqaIgHcAidKpcJvcGHqFdCDbfkmss",176,0.99435,31,177,1,176,1,1,0,1,1,89,88,88,88,43
"3951",50,"[31]mJHqaIgHcAidKpcJvcGHqFdCDbfkmss",175,0.994318,31,176,1,175,1,1,0,1,1,84,83,92,92,43
"3952",51,"[31]mJHqaIgHcAidKpcJvcGHqFdCDbfkmss",179,0.994444,31,180,1,179,1,1,0,1,1,99,98,81,81,43
"3953",52,"[31]mJHqaIgHcAidKpcJvcGHqFdCDbfkmss",178,0.994413,31,179,1,178,1,1,0,1,1,95,94,84,84,43
"3954",53,"[31]mJHqaIgHcAidKpcJvcGHqFdCDbfkmss",174,0.994286,31,175,1,174,1,1,0,1,1,83,82,92,92,43
"3955",54,"[31]mJHqaIgHcAidKpcJvcGHqFdCDbfkmss",175,0.994318,31,176,1,175,1,1,0,1,1,87,86,89,89,43
"3956",55,"[31]mJHqaIgHcAidKpcJvcGHqFdCDbfkmss",179,0.994444,31,180,1,179,1,1,0,1,1,93,92,87,87,43
"3957",56,"[31]mJHqaIgHcAidKpcJvcGHqFdCDbfkmss",178,0.994413,31,179,1,178,1,1,0,1,1,95,94,84,84,43
"3958",57,"[31]mJHqaIgHcAidKpcJvcGHqFdCDbfkmss",179,0.994444,31,180,1,179,1,1,0,1,1,99,98,81,81,43
"3959",58,"[31]mJHqaIgHcAidKpcJvcGHqFdCDbfkmss",176,0.99435,31,177,1,176,1,1,0,1,1,84,83,93,93,43
"3960",59,"[31]mJHqaIgHcAidKpcJvcGHqFdCDbfkmss",179,0.994444,31,180,1,179,1,1,0,1,1,99,98,81,81,43
"3961",60,"[31]mJHqaIgHcAidKpcJvcGHqFdCDbfkmss",176,0.99435,31,177,1,176,1,1,0,1,1,89,88,88,88,43
"3962",61,"[31]mJHqaIgHcAidKpcJvcGHqFdCDbfkmss",174,0.994286,31,175,1,174,1,1,0,1,1,84,83,91,91,43
"3963",62,"[31]mJHqaIgHcAidKpcJvcGHqFdCDbfkmss",173,0.994253,31,174,1,173,1,1,0,1,1,80,79,94,94,43
"3964",63,"[31]mJHqaIgHcAidKpcJvcGHqFdCDbfkmss",175,0.994318,31,176,1,175,1,1,0,1,1,86,85,90,90,43
"3965",64,"[31]mJHqaIgHcAidKpcJvcGHqFdCDbfkmss",176,0.99435,31,177,1,176,1,1,0,1,1,91,90,86,86,43
"3966",65,"[31]mJHqaIgHcAidKpcJvcGHqFdCDbfkmss",177,0.994382,31,178,1,177,1,1,0,1,1,93,92,85,85,43
"3967",66,"[31]mJHqaIgHcAidKpcJvcGHqFdCDbfkmss",176,0.99435,31,177,1,176,1,1,0,1,1,91,90,86,86,43
"3968",67,"[31]mJHqaIgHcAidKpcJvcGHqFdCDbfkmss",169,0.994118,31,170,1,169,1,1,0,1,1,67,66,103,103,43
"3969",68,"[31]mJHqaIgHcAidKpcJvcGHqFdCDbfkmss",173,0.994253,31,174,1,173,1,1,0,1,1,77,76,97,97,43
"3970",69,"[31]mJHqaIgHcAidKpcJvcGHqFdCDbfkmss",177,0.994382,31,178,1,177,1,1,0,1,1,90,89,88,88,43
"3971",70,"[31]mJHqaIgHcAidKpcJvcGHqFdCDbfkmss",173,0.994253,31,174,1,173,1,1,0,1,1,81,80,93,93,43
"3972",71,"[31]mJHqaIgHcAidKpcJvcGHqFdCDbfkmss",178,0.994413,31,179,1,178,1,1,0,1,1,92,91,87,87,43
"3973",72,"[31]mJHqaIgHcAidKpcJvcGHqFdCDbfkmss",177,0.994382,31,178,1,177,1,1,0,1,1,94,93,84,84,43
"3974",73,"[31]mJHqaIgHcAidKpcJvcGHqFdCDbfkmss",174,0.994286,31,175,1,174,1,1,0,1,1,79,78,96,96,43
"3975",74,"[31]mJHqaIgHcAidKpcJvcGHqFdCDbfkmss",180,0.994475,31,181,1,180,1,1,0,1,1,103,102,78,78,43
"3976",75,"[31]mJHqaIgHcAidKpcJvcGHqFdCDbfkmss",172,0.99422,31,173,1,172,1,1,0,1,1,76,75,97,97,43
"3977",76,"[31]mJHqaIgHcAidKpcJvcGHqFdCDbfkmss",176,0.99435,31,177,1,176,1,1,0,1,1,89,88,88,88,43
"3978",77,"[31]mJHqaIgHcAidKpcJvcGHqFdCDbfkmss",173,0.994253,31,174,1,173,1,1,0,1,1,81,80,93,93,43
"3979",78,"[31]mJHqaIgHcAidKpcJvcGHqFdCDbfkmss",178,0.994413,31,179,1,178,1,1,0,1,1,96,95,83,83,43
"3980",79,"[31]mJHqaIgHcAidKpcJvcGHqFdCDbfkmss",174,0.994286,31,175,1,174,1,1,0,1,1,84,83,91,91,43
"3981",80,"[31]mJHqaIgHcAidKpcJvcGHqFdCDbfkmss",176,0.99435,31,177,1,176,1,1,0,1,1,88,87,89,89,43
"3982",81,"[31]mJHqaIgHcAidKpcJvcGHqFdCDbfkmss",174,0.994286,31,175,1,174,1,1,0,1,1,84,83,91,91,43
"3983",82,"[31]mJHqaIgHcAidKpcJvcGHqFdCDbfkmss",177,0.994382,31,178,1,177,1,1,0,1,1,92,91,86,86,43
"3984",83,"[31]mJHqaIgHcAidKpcJvcGHqFdCDbfkmss",172,0.99422,31,173,1,172,1,1,0,1,1,77,76,96,96,43
"3985",84,"[31]mJHqaIgHcAidKpcJvcGHqFdCDbfkmss",181,0.994505,31,182,1,181,1,1,0,1,1,106,105,76,76,43
"3986",85,"[31]mJHqaIgHcAidKpcJvcGHqFdCDbfkmss",177,0.994382,31,178,1,177,1,1,0,1,1,90,89,88,88,43
"3987",86,"[31]mJHqaIgHcAidKpcJvcGHqFdCDbfkmss",179,0.994444,31,180,1,179,1,1,0,1,1,97,96,83,83,43
"3988",87,"[31]mJHqaIgHcAidKpcJvcGHqFdCDbfkmss",175,0.994318,31,176,1,175,1,1,0,1,1,86,85,90,90,43
"3989",88,"[31]mJHqaIgHcAidKpcJvcGHqFdCDbfkmss",182,0.994536,31,183,1,182,1,1,0,1,1,104,103,79,79,43
"3990",89,"[31]mJHqaIgHcAidKpcJvcGHqFdCDbfkmss",176,0.99435,31,177,1,176,1,1,0,1,1,87,86,90,90,43
"3991",90,"[31]mJHqaIgHcAidKpcJvcGHqFdCDbfkmss",176,0.99435,31,177,1,176,1,1,0,1,1,91,90,86,86,43
"3992",91,"[31]mJHqaIgHcAidKpcJvcGHqFdCDbfkmss",173,0.994253,31,174,1,173,1,1,0,1,1,79,78,95,95,43
"3993",92,"[31]mJHqaIgHcAidKpcJvcGHqFdCDbfkmss",177,0.994382,31,178,1,177,1,1,0,1,1,94,93,84,84,43
"3994",93,"[31]mJHqaIgHcAidKpcJvcGHqFdCDbfkmss",172,0.99422,31,173,1,172,1,1,0,1,1,77,76,96,96,43
"3995",94,"[31]mJHqaIgHcAidKpcJvcGHqFdCDbfkmss",177,0.994382,31,178,1,177,1,1,0,1,1,86,85,92,92,43
"3996",95,"[31]mJHqaIgHcAidKpcJvcGHqFdCDbfkmss",176,0.99435,31,177,1,176,1,1,0,1,1,88,87,89,89,43
"3997",96,"[31]mJHqaIgHcAidKpcJvcGHqFdCDbfkmss",175,0.994318,31,176,1,175,1,1,0,1,1,87,86,89,89,43
"3998",97,"[31]mJHqaIgHcAidKpcJvcGHqFdCDbfkmss",170,0.994152,31,171,1,170,1,1,0,1,1,70,69,101,101,43
"3999",98,"[31]mJHqaIgHcAidKpcJvcGHqFdCDbfkmss",174,0.994286,31,175,1,174,1,1,0,1,1,83,82,92,92,43
"4000",99,"[31]mJHqaIgHcAidKpcJvcGHqFdCDbfkmss",177,0.994382,31,178,1,177,1,1,0,1,1,93,92,85,85,43
"4001",0,"[34]vJHggqIrHceldKpcJvcGHqFdCobCyailzh",179,0.994444,34,180,1,179,1,1,0,1,1,100,99,80,80,44
"4002",1,"[34]vJHggqIrHceldKpcJvcGHqFdCobCyailzh",174,0.994286,34,175,1,174,1,1,0,1,1,84,83,91,91,44
"4003",2,"[34]vJHggqIrHceldKpcJvcGHqFdCobCyailzh",173,0.994253,34,174,1,173,1,1,0,1,1,80,79,94,94,44
"4004",3,"[34]vJHggqIrHceldKpcJvcGHqFdCobCyailzh",178,0.994413,34,179,1,178,1,1,0,1,1,97,96,82,82,44
"4005",4,"[34]vJHggqIrHceldKpcJvcGHqFdCobCyailzh",177,0.994382,34,178,1,177,1,1,0,1,1,93,92,85,85,44
"4006",5,"[34]vJHggqIrHceldKpcJvcGHqFdCobCyailzh",175,0.994318,34,176,1,175,1,1,0,1,1,88,87,88,88,44
"4007",6,"[34]vJHggqIrHceldKpcJvcGHqFdCobCyailzh",179,0.994444,34,180,1,179,1,1,0,1,1,100,99,80,80,44
"4008",7,"[34]vJHggqIrHceldKpcJvcGHqFdCobCyailzh",177,0.994382,34,178,1,177,1,1,0,1,1,91,90,87,87,44
"4009",8,"[34]vJHggqIrHceldKpcJvcGHqFdCobCyailzh",176,0.99435,34,177,1,176,1,1,0,1,1,88,87,89,89,44
"4010",9,"[34]vJHggqIrHceldKpcJvcGHqFdCobCyailzh",176,0.99435,34,177,1,176,1,1,0,1,1,88,87,89,89,44
"4011",10,"[34]vJHggqIrHceldKpcJvcGHqFdCobCyailzh",178,0.994413,34,179,1,178,1,1,0,1,1,97,96,82,82,44
"4012",11,"[34]vJHggqIrHceldKpcJvcGHqFdCobCyailzh",177,0.994382,34,178,1,177,1,1,0,1,1,94,93,84,84,44
"4013",12,"[34]vJHggqIrHceldKpcJvcGHqFdCobCyailzh",174,0.994286,34,175,1,174,1,1,0,1,1,84,83,91,91,44
"4014",13,"[34]vJHggqIrHceldKpcJvcGHqFdCobCyailzh",174,0.994286,34,175,1,174,1,1,0,1,1,85,84,90,90,44
"4015",14,"[34]vJHggqIrHceldKpcJvcGHqFdCobCyailzh",173,0.994253,34,174,1,173,1,1,0,1,1,82,81,92,92,44
"4016",15,"[34]vJHggqIrHceldKpcJvcGHqFdCobCyailzh",175,0.994318,34,176,1,175,1,1,0,1,1,87,86,89,89,44
"4017",16,"[34]vJHggqIrHceldKpcJvcGHqFdCobCyailzh",177,0.994382,34,178,1,177,1,1,0,1,1,94,93,84,84,44
"4018",17,"[34]vJHggqIrHceldKpcJvcGHqFdCobCyailzh",178,0.994413,34,179,1,178,1,1,0,1,1,96,95,83,83,44
"4019",18,"[34]vJHggqIrHceldKpcJvcGHqFdCobCyailzh",176,0.99435,34,177,1,176,1,1,0,1,1,91,90,86,86,44
"4020",19,"[34]vJHggqIrHceldKpcJvcGHqFdCobCyailzh",179,0.994444,34,180,1,179,1,1,0,1,1,99,98,81,81,44
"4021",20,"[34]vJHggqIrHceldKpcJvcGHqFdCobCyailzh",176,0.99435,34,177,1,176,1,1,0,1,1,91,90,86,86,44
"4022",21,"[34]vJHggqIrHceldKpcJvcGHqFdCobCyailzh",177,0.994382,34,178,1,177,1,1,0,1,1,95,94,83,83,44
"4023",22,"[34]vJHggqIrHceldKpcJvcGHqFdCobCyailzh",176,0.99435,34,177,1,176,1,1,0,1,1,89,88,88,88,44
"4024",23,"[34]vJHggqIrHceldKpcJvcGHqFdCobCyailzh",177,0.994382,34,178,1,177,1,1,0,1,1,94,93,84,84,44
"4025",24,"[34]vJHggqIrHceldKpcJvcGHqFdCobCyailzh",173,0.994253,34,174,1,173,1,1,0,1,1,80,79,94,94,44
"4026",25,"[34]vJHggqIrHceldKpcJvcGHqFdCobCyailzh",176,0.99435,34,177,1,176,1,1,0,1,1,90,89,87,87,44
"4027",26,"[34]vJHggqIrHceldKpcJvcGHqFdCobCyailzh",179,0.994444,34,180,1,179,1,1,0,1,1,101,100,79,79,44
"4028",27,"[34]vJHggqIrHceldKpcJvcGHqFdCobCyailzh",178,0.994413,34,179,1,178,1,1,0,1,1,97,96,82,82,44
"4029",28,"[34]vJHggqIrHceldKpcJvcGHqFdCobCyailzh",177,0.994382,34,178,1,177,1,1,0,1,1,94,93,84,84,44
"4030",29,"[34]vJHggqIrHceldKpcJvcGHqFdCobCyailzh",180,0.994475,34,181,1,180,1,1,0,1,1,103,102,78,78,44
"4031",30,"[34]vJHggqIrHceldKpcJvcGHqFdCobCyailzh",177,0.994382,34,178,1,177,1,1,0,1,1,95,94,83,83,44
"4032",31,"[34]vJHggqIrHceldKpcJvcGHqFdCobCyailzh",173,0.994253,34,174,1,173,1,1,0,1,1,82,81,92,92,44
"4033",32,"[34]vJHggqIrHceldKpcJvcGHqFdCobCyailzh",174,0.994286,34,175,1,174,1,1,0,1,1,81,80,94,94,44
"4034",33,"[34]vJHggqIrHceldKpcJvcGHqFdCobCyailzh",177,0.994382,34,178,1,177,1,1,0,1,1,93,92,85,85,44
"4035",34,"[34]vJHggqIrHceldKpcJvcGHqFdCobCyailzh",173,0.994253,34,174,1,173,1,1,0,1,1,82,81,92,92,44
"4036",35,"[34]vJHggqIrHceldKpcJvcGHqFdCobCyailzh",179,0.994444,34,180,1,179,1,1,0,1,1,101,100,79,79,44
"4037",36,"[34]vJHggqIrHceldKpcJvcGHqFdCobCyailzh",173,0.994253,34,174,1,173,1,1,0,1,1,81,80,93,93,44
"4038",37,"[34]vJHggqIrHceldKpcJvcGHqFdCobCyailzh",174,0.994286,34,175,1,174,1,1,0,1,1,81,80,94,94,44
"4039",38,"[34]vJHggqIrHceldKpcJvcGHqFdCobCyailzh",173,0.994253,34,174,1,173,1,1,0,1,1,80,79,94,94,44
"4040",39,"[34]vJHggqIrHceldKpcJvcGHqFdCobCyailzh",177,0.994382,34,178,1,177,1,1,0,1,1,94,93,84,84,44
"4041",40,"[34]vJHggqIrHceldKpcJvcGHqFdCobCyailzh",172,0.99422,34,173,1,172,1,1,0,1,1,77,76,96,96,44
"4042",41,"[34]vJHggqIrHceldKpcJvcGHqFdCobCyailzh",179,0.994444,34,180,1,179,1,1,0,1,1,100,99,80,80,44
"4043",42,"[34]vJHggqIrHceldKpcJvcGHqFdCobCyailzh",175,0.994318,34,176,1,175,1,1,0,1,1,88,87,88,88,44
"4044",43,"[34]vJHggqIrHceldKpcJvcGHqFdCobCyailzh",179,0.994444,34,180,1,179,1,1,0,1,1,99,98,81,81,44
"4045",44,"[34]vJHggqIrHceldKpcJvcGHqFdCobCyailzh",178,0.994413,34,179,1,178,1,1,0,1,1,97,96,82,82,44
"4046",45,"[34]vJHggqIrHceldKpcJvcGHqFdCobCyailzh",176,0.99435,34,177,1,176,1,1,0,1,1,92,91,85,85,44
"4047",46,"[34]vJHggqIrHceldKpcJvcGHqFdCobCyailzh",172,0.99422,34,173,1,172,1,1,0,1,1,78,77,95,95,44
"4048",47,"[34]vJHggqIrHceldKpcJvcGHqFdCobCyailzh",182,0.994536,34,183,1,182,1,1,0,1,1,110,109,73,73,44
"4049",48,"[34]vJHggqIrHceldKpcJvcGHqFdCobCyailzh",178,0.994413,34,179,1,178,1,1,0,1,1,97,96,82,82,44
"4050",49,"[34]vJHggqIrHceldKpcJvcGHqFdCobCyailzh",180,0.994475,34,181,1,180,1,1,0,1,1,105,104,76,76,44
"4051",50,"[34]vJHggqIrHceldKpcJvcGHqFdCobCyailzh",176,0.99435,34,177,1,176,1,1,0,1,1,90,89,87,87,44
"4052",51,"[34]vJHggqIrHceldKpcJvcGHqFdCobCyailzh",175,0.994318,34,176,1,175,1,1,0,1,1,88,87,88,88,44
"4053",52,"[34]vJHggqIrHceldKpcJvcGHqFdCobCyailzh",175,0.994318,34,176,1,175,1,1,0,1,1,87,86,89,89,44
"4054",53,"[34]vJHggqIrHceldKpcJvcGHqFdCobCyailzh",177,0.994382,34,178,1,177,1,1,0,1,1,93,92,85,85,44
"4055",54,"[34]vJHggqIrHceldKpcJvcGHqFdCobCyailzh",177,0.994382,34,178,1,177,1,1,0,1,1,94,93,84,84,44
"4056",55,"[34]vJHggqIrHceldKpcJvcGHqFdCobCyailzh",178,0.994413,34,179,1,178,1,1,0,1,1,95,94,84,84,44
"4057",56,"[34]vJHggqIrHceldKpcJvcGHqFdCobCyailzh",177,0.994382,34,178,1,177,1,1,0,1,1,95,94,83,83,44
"4058",57,"[34]vJHggqIrHceldKpcJvcGHqFdCobCyailzh",175,0.994318,34,176,1,175,1,1,0,1,1,85,84,91,91,44
"4059",58,"[34]vJHggqIrHceldKpcJvcGHqFdCobCyailzh",178,0.994413,34,179,1,178,1,1,0,1,1,93,92,86,86,44
"4060",59,"[34]vJHggqIrHceldKpcJvcGHqFdCobCyailzh",176,0.99435,34,177,1,176,1,1,0,1,1,90,89,87,87,44
"4061",60,"[34]vJHggqIrHceldKpcJvcGHqFdCobCyailzh",176,0.99435,34,177,1,176,1,1,0,1,1,91,90,86,86,44
"4062",61,"[34]vJHggqIrHceldKpcJvcGHqFdCobCyailzh",175,0.994318,34,176,1,175,1,1,0,1,1,88,87,88,88,44
"4063",62,"[34]vJHggqIrHceldKpcJvcGHqFdCobCyailzh",178,0.994413,34,179,1,178,1,1,0,1,1,97,96,82,82,44
"4064",63,"[34]vJHggqIrHceldKpcJvcGHqFdCobCyailzh",176,0.99435,34,177,1,176,1,1,0,1,1,91,90,86,86,44
"4065",64,"[34]vJHggqIrHceldKpcJvcGHqFdCobCyailzh",173,0.994253,34,174,1,173,1,1,0,1,1,79,78,95,95,44
"4066",65,"[34]vJHggqIrHceldKpcJvcGHqFdCobCyailzh",179,0.994444,34,180,1,179,1,1,0,1,1,95,94,85,85,44
"4067",66,"[34]vJHggqIrHceldKpcJvcGHqFdCobCyailzh",177,0.994382,34,178,1,177,1,1,0,1,1,94,93,84,84,44
"4068",67,"[34]vJHggqIrHceldKpcJvcGHqFdCobCyailzh",176,0.99435,34,177,1,176,1,1,0,1,1,89,88,88,88,44
"4069",68,"[34]vJHggqIrHceldKpcJvcGHqFdCobCyailzh",175,0.994318,34,176,1,175,1,1,0,1,1,87,86,89,89,44
"4070",69,"[34]vJHggqIrHceldKpcJvcGHqFdCobCyailzh",178,0.994413,34,179,1,178,1,1,0,1,1,93,92,86,86,44
"4071",70,"[34]vJHggqIrHceldKpcJvcGHqFdCobCyailzh",175,0.994318,34,176,1,175,1,1,0,1,1,88,87,88,88,44
"4072",71,"[34]vJHggqIrHceldKpcJvcGHqFdCobCyailzh",173,0.994253,34,174,1,173,1,1,0,1,1,79,78,95,95,44
"4073",72,"[34]vJHggqIrHceldKpcJvcGHqFdCobCyailzh",179,0.994444,34,180,1,179,1,1,0,1,1,99,98,81,81,44
"4074",73,"[34]vJHggqIrHceldKpcJvcGHqFdCobCyailzh",174,0.994286,34,175,1,174,1,1,0,1,1,83,82,92,92,44
"4075",74,"[34]vJHggqIrHceldKpcJvcGHqFdCobCyailzh",175,0.994318,34,176,1,175,1,1,0,1,1,88,87,88,88,44
"4076",75,"[34]vJHggqIrHceldKpcJvcGHqFdCobCyailzh",176,0.99435,34,177,1,176,1,1,0,1,1,90,89,87,87,44
"4077",76,"[34]vJHggqIrHceldKpcJvcGHqFdCobCyailzh",175,0.994318,34,176,1,175,1,1,0,1,1,86,85,90,90,44
"4078",77,"[34]vJHggqIrHceldKpcJvcGHqFdCobCyailzh",180,0.994475,34,181,1,180,1,1,0,1,1,103,102,78,78,44
"4079",78,"[34]vJHggqIrHceldKpcJvcGHqFdCobCyailzh",175,0.994318,34,176,1,175,1,1,0,1,1,88,87,88,88,44
"4080",79,"[34]vJHggqIrHceldKpcJvcGHqFdCobCyailzh",175,0.994318,34,176,1,175,1,1,0,1,1,86,85,90,90,44
"4081",80,"[34]vJHggqIrHceldKpcJvcGHqFdCobCyailzh",174,0.994286,34,175,1,174,1,1,0,1,1,83,82,92,92,44
"4082",81,"[34]vJHggqIrHceldKpcJvcGHqFdCobCyailzh",175,0.994318,34,176,1,175,1,1,0,1,1,87,86,89,89,44
"4083",82,"[34]vJHggqIrHceldKpcJvcGHqFdCobCyailzh",171,0.994186,34,172,1,171,1,1,0,1,1,74,73,98,98,44
"4084",83,"[34]vJHggqIrHceldKpcJvcGHqFdCobCyailzh",174,0.994286,34,175,1,174,1,1,0,1,1,85,84,90,90,44
"4085",84,"[34]vJHggqIrHceldKpcJvcGHqFdCobCyailzh",174,0.994286,34,175,1,174,1,1,0,1,1,80,79,95,95,44
"4086",85,"[34]vJHggqIrHceldKpcJvcGHqFdCobCyailzh",173,0.994253,34,174,1,173,1,1,0,1,1,79,78,95,95,44
"4087",86,"[34]vJHggqIrHceldKpcJvcGHqFdCobCyailzh",175,0.994318,34,176,1,175,1,1,0,1,1,86,85,90,90,44
"4088",87,"[34]vJHggqIrHceldKpcJvcGHqFdCobCyailzh",175,0.994318,34,176,1,175,1,1,0,1,1,86,85,90,90,44
"4089",88,"[34]vJHggqIrHceldKpcJvcGHqFdCobCyailzh",178,0.994413,34,179,1,178,1,1,0,1,1,97,96,82,82,44
"4090",89,"[34]vJHggqIrHceldKpcJvcGHqFdCobCyailzh",180,0.994475,34,181,1,180,1,1,0,1,1,104,103,77,77,44
"4091",90,"[34]vJHggqIrHceldKpcJvcGHqFdCobCyailzh",178,0.994413,34,179,1,178,1,1,0,1,1,96,95,83,83,44
"4092",91,"[34]vJHggqIrHceldKpcJvcGHqFdCobCyailzh",176,0.99435,34,177,1,176,1,1,0,1,1,90,89,87,87,44
"4093",92,"[34]vJHggqIrHceldKpcJvcGHqFdCobCyailzh",177,0.994382,34,178,1,177,1,1,0,1,1,92,91,86,86,44
"4094",93,"[34]vJHggqIrHceldKpcJvcGHqFdCobCyailzh",175,0.994318,34,176,1,175,1,1,0,1,1,86,85,90,90,44
"4095",94,"[34]vJHggqIrHceldKpcJvcGHqFdCobCyailzh",174,0.994286,34,175,1,174,1,1,0,1,1,83,82,92,92,44
"4096",95,"[34]vJHggqIrHceldKpcJvcGHqFdCobCyailzh",178,0.994413,34,179,1,178,1,1,0,1,1,95,94,84,84,44
"4097",96,"[34]vJHggqIrHceldKpcJvcGHqFdCobCyailzh",175,0.994318,34,176,1,175,1,1,0,1,1,87,86,89,89,44
"4098",97,"[34]vJHggqIrHceldKpcJvcGHqFdCobCyailzh",177,0.994382,34,178,1,177,1,1,0,1,1,91,90,87,87,44
"4099",98,"[34]vJHggqIrHceldKpcJvcGHqFdCobCyailzh",174,0.994286,34,175,1,174,1,1,0,1,1,83,82,92,92,44
"4100",99,"[34]vJHggqIrHceldKpcJvcGHqFdCobCyailzh",176,0.99435,34,177,1,176,1,1,0,1,1,92,91,85,85,44
"4101",0,"[30]gJHggqIHcdKocJvcGHqwdCFxklHKci",167,0.994048,30,168,1,167,1,1,0,1,1,85,84,83,83,45
"4102",1,"[30]gJHggqIHcdKocJvcGHqwdCFxklHKci",169,0.994118,30,170,1,169,1,1,0,1,1,88,87,82,82,45
"4103",2,"[30]gJHggqIHcdKocJvcGHqwdCFxklHKci",170,0.994152,30,171,1,170,1,1,0,1,1,93,92,78,78,45
"4104",3,"[30]gJHggqIHcdKocJvcGHqwdCFxklHKci",171,0.994186,30,172,1,171,1,1,0,1,1,94,93,78,78,45
"4105",4,"[30]gJHggqIHcdKocJvcGHqwdCFxklHKci",166,0.994012,30,167,1,166,1,1,0,1,1,81,80,86,86,45
"4106",5,"[30]gJHggqIHcdKocJvcGHqwdCFxklHKci",173,0.994253,30,174,1,173,1,1,0,1,1,101,100,73,73,45
"4107",6,"[30]gJHggqIHcdKocJvcGHqwdCFxklHKci",172,0.99422,30,173,1,172,1,1,0,1,1,99,98,74,74,45
"4108",7,"[30]gJHggqIHcdKocJvcGHqwdCFxklHKci",166,0.994012,30,167,1,166,1,1,0,1,1,81,80,86,86,45
"4109",8,"[30]gJHggqIHcdKocJvcGHqwdCFxklHKci",162,0.993865,30,163,1,162,1,1,0,1,1,72,71,91,91,45
"4110",9,"[30]gJHggqIHcdKocJvcGHqwdCFxklHKci",159,0.99375,30,160,1,159,1,1,0,1,1,63,62,97,97,45
"4111",10,"[30]gJHggqIHcdKocJvcGHqwdCFxklHKci",167,0.994048,30,168,1,167,1,1,0,1,1,83,82,85,85,45
"4112",11,"[30]gJHggqIHcdKocJvcGHqwdCFxklHKci",174,0.994286,30,175,1,174,1,1,0,1,1,103,102,72,72,45
"4113",12,"[30]gJHggqIHcdKocJvcGHqwdCFxklHKci",170,0.994152,30,171,1,170,1,1,0,1,1,92,91,79,79,45
"4114",13,"[30]gJHggqIHcdKocJvcGHqwdCFxklHKci",161,0.993827,30,162,1,161,1,1,0,1,1,69,68,93,93,45
"4115",14,"[30]gJHggqIHcdKocJvcGHqwdCFxklHKci",166,0.994012,30,167,1,166,1,1,0,1,1,81,80,86,86,45
"4116",15,"[30]gJHggqIHcdKocJvcGHqwdCFxklHKci",167,0.994048,30,168,1,167,1,1,0,1,1,84,83,84,84,45
"4117",16,"[30]gJHggqIHcdKocJvcGHqwdCFxklHKci",166,0.994012,30,167,1,166,1,1,0,1,1,81,80,86,86,45
"4118",17,"[30]gJHggqIHcdKocJvcGHqwdCFxklHKci",167,0.994048,30,168,1,167,1,1,0,1,1,85,84,83,83,45
"4119",18,"[30]gJHggqIHcdKocJvcGHqwdCFxklHKci",169,0.994118,30,170,1,169,1,1,0,1,1,89,88,81,81,45
"4120",19,"[30]gJHggqIHcdKocJvcGHqwdCFxklHKci",169,0.994118,30,170,1,169,1,1,0,1,1,91,90,79,79,45
"4121",20,"[30]gJHggqIHcdKocJvcGHqwdCFxklHKci",174,0.994286,30,175,1,174,1,1,0,1,1,104,103,71,71,45
"4122",21,"[30]gJHggqIHcdKocJvcGHqwdCFxklHKci",171,0.994186,30,172,1,171,1,1,0,1,1,96,95,76,76,45
"4123",22,"[30]gJHggqIHcdKocJvcGHqwdCFxklHKci",165,0.993976,30,166,1,165,1,1,0,1,1,80,79,86,86,45
"4124",23,"[30]gJHggqIHcdKocJvcGHqwdCFxklHKci",170,0.994152,30,171,1,170,1,1,0,1,1,92,91,79,79,45
"4125",24,"[30]gJHggqIHcdKocJvcGHqwdCFxklHKci",165,0.993976,30,166,1,165,1,1,0,1,1,80,79,86,86,45
"4126",25,"[30]gJHggqIHcdKocJvcGHqwdCFxklHKci",165,0.993976,30,166,1,165,1,1,0,1,1,79,78,87,87,45
"4127",26,"[30]gJHggqIHcdKocJvcGHqwdCFxklHKci",164,0.993939,30,165,1,164,1,1,0,1,1,76,75,89,89,45
"4128",27,"[30]gJHggqIHcdKocJvcGHqwdCFxklHKci",163,0.993902,30,164,1,163,1,1,0,1,1,74,73,90,90,45
"4129",28,"[30]gJHggqIHcdKocJvcGHqwdCFxklHKci",165,0.993976,30,166,1,165,1,1,0,1,1,79,78,87,87,45
"4130",29,"[30]gJHggqIHcdKocJvcGHqwdCFxklHKci",168,0.994083,30,169,1,168,1,1,0,1,1,87,86,82,82,45
"4131",30,"[30]gJHggqIHcdKocJvcGHqwdCFxklHKci",162,0.993865,30,163,1,162,1,1,0,1,1,70,69,93,93,45
"4132",31,"[30]gJHggqIHcdKocJvcGHqwdCFxklHKci",164,0.993939,30,165,1,164,1,1,0,1,1,77,76,88,88,45
"4133",32,"[30]gJHggqIHcdKocJvcGHqwdCFxklHKci",166,0.994012,30,167,1,166,1,1,0,1,1,81,80,86,86,45
"4134",33,"[30]gJHggqIHcdKocJvcGHqwdCFxklHKci",167,0.994048,30,168,1,167,1,1,0,1,1,86,85,82,82,45
"4135",34,"[30]gJHggqIHcdKocJvcGHqwdCFxklHKci",165,0.993976,30,166,1,165,1,1,0,1,1,80,79,86,86,45
"4136",35,"[30]gJHggqIHcdKocJvcGHqwdCFxklHKci",163,0.993902,30,164,1,163,1,1,0,1,1,75,74,89,89,45
"4137",36,"[30]gJHggqIHcdKocJvcGHqwdCFxklHKci",165,0.993976,30,166,1,165,1,1,0,1,1,80,79,86,86,45
"4138",37,"[30]gJHggqIHcdKocJvcGHqwdCFxklHKci",163,0.993902,30,164,1,163,1,1,0,1,1,74,73,90,90,45
"4139",38,"[30]gJHggqIHcdKocJvcGHqwdCFxklHKci",173,0.994253,30,174,1,173,1,1,0,1,1,102,101,72,72,45
"4140",39,"[30]gJHggqIHcdKocJvcGHqwdCFxklHKci",169,0.994118,30,170,1,169,1,1,0,1,1,89,88,81,81,45
"4141",40,"[30]gJHggqIHcdKocJvcGHqwdCFxklHKci",168,0.994083,30,169,1,168,1,1,0,1,1,86,85,83,83,45
"4142",41,"[30]gJHggqIHcdKocJvcGHqwdCFxklHKci",167,0.994048,30,168,1,167,1,1,0,1,1,85,84,83,83,45
"4143",42,"[30]gJHggqIHcdKocJvcGHqwdCFxklHKci",163,0.993902,30,164,1,163,1,1,0,1,1,74,73,90,90,45
"4144",43,"[30]gJHggqIHcdKocJvcGHqwdCFxklHKci",163,0.993902,30,164,1,163,1,1,0,1,1,74,73,90,90,45
"4145",44,"[30]gJHggqIHcdKocJvcGHqwdCFxklHKci",169,0.994118,30,170,1,169,1,1,0,1,1,90,89,80,80,45
"4146",45,"[30]gJHggqIHcdKocJvcGHqwdCFxklHKci",165,0.993976,30,166,1,165,1,1,0,1,1,79,78,87,87,45
"4147",46,"[30]gJHggqIHcdKocJvcGHqwdCFxklHKci",165,0.993976,30,166,1,165,1,1,0,1,1,80,79,86,86,45
"4148",47,"[30]gJHggqIHcdKocJvcGHqwdCFxklHKci",166,0.994012,30,167,1,166,1,1,0,1,1,83,82,84,84,45
"4149",48,"[30]gJHggqIHcdKocJvcGHqwdCFxklHKci",168,0.994083,30,169,1,168,1,1,0,1,1,88,87,81,81,45
"4150",49,"[30]gJHggqIHcdKocJvcGHqwdCFxklHKci",165,0.993976,30,166,1,165,1,1,0,1,1,78,77,88,88,45
"4151",50,"[30]gJHggqIHcdKocJvcGHqwdCFxklHKci",170,0.994152,30,171,1,170,1,1,0,1,1,92,91,79,79,45
"4152",51,"[30]gJHggqIHcdKocJvcGHqwdCFxklHKci",165,0.993976,30,166,1,165,1,1,0,1,1,80,79,86,86,45
"4153",52,"[30]gJHggqIHcdKocJvcGHqwdCFxklHKci",163,0.993902,30,164,1,163,1,1,0,1,1,75,74,89,89,45
"4154",53,"[30]gJHggqIHcdKocJvcGHqwdCFxklHKci",161,0.993827,30,162,1,161,1,1,0,1,1,68,67,94,94,45
"4155",54,"[30]gJHggqIHcdKocJvcGHqwdCFxklHKci",169,0.994118,30,170,1,169,1,1,0,1,1,90,89,80,80,45
"4156",55,"[30]gJHggqIHcdKocJvcGHqwdCFxklHKci",164,0.993939,30,165,1,164,1,1,0,1,1,77,76,88,88,45
"4157",56,"[30]gJHggqIHcdKocJvcGHqwdCFxklHKci",166,0.994012,30,167,1,166,1,1,0,1,1,82,81,85,85,45
"4158",57,"[30]gJHggqIHcdKocJvcGHqwdCFxklHKci",161,0.993827,30,162,1,161,1,1,0,1,1,68,67,94,94,45
"4159",58,"[30]gJHggqIHcdKocJvcGHqwdCFxklHKci",165,0.993976,30,166,1,165,1,1,0,1,1,80,79,86,86,45
"4160",59,"[30]gJHggqIHcdKocJvcGHqwdCFxklHKci",169,0.994118,30,170,1,169,1,1,0,1,1,91,90,79,79,45
"4161",60,"[30]gJHggqIHcdKocJvcGHqwdCFxklHKci",170,0.994152,30,171,1,170,1,1,0,1,1,93,92,78,78,45
"4162",61,"[30]gJHggqIHcdKocJvcGHqwdCFxklHKci",169,0.994118,30,170,1,169,1,1,0,1,1,88,87,82,82,45
"4163",62,"[30]gJHggqIHcdKocJvcGHqwdCFxklHKci",170,0.994152,30,171,1,170,1,1,0,1,1,93,92,78,78,45
"4164",63,"[30]gJHggqIHcdKocJvcGHqwdCFxklHKci",165,0.993976,30,166,1,165,1,1,0,1,1,79,78,87,87,45
"4165",64,"[30]gJHggqIHcdKocJvcGHqwdCFxklHKci",170,0.994152,30,171,1,170,1,1,0,1,1,92,91,79,79,45
"4166",65,"[30]gJHggqIHcdKocJvcGHqwdCFxklHKci",167,0.994048,30,168,1,167,1,1,0,1,1,86,85,82,82,45
"4167",66,"[30]gJHggqIHcdKocJvcGHqwdCFxklHKci",165,0.993976,30,166,1,165,1,1,0,1,1,79,78,87,87,45
"4168",67,"[30]gJHggqIHcdKocJvcGHqwdCFxklHKci",166,0.994012,30,167,1,166,1,1,0,1,1,81,80,86,86,45
"4169",68,"[30]gJHggqIHcdKocJvcGHqwdCFxklHKci",166,0.994012,30,167,1,166,1,1,0,1,1,83,82,84,84,45
"4170",69,"[30]gJHggqIHcdKocJvcGHqwdCFxklHKci",168,0.994083,30,169,1,168,1,1,0,1,1,88,87,81,81,45
"4171",70,"[30]gJHggqIHcdKocJvcGHqwdCFxklHKci",162,0.993865,30,163,1,162,1,1,0,1,1,72,71,91,91,45
"4172",71,"[30]gJHggqIHcdKocJvcGHqwdCFxklHKci",168,0.994083,30,169,1,168,1,1,0,1,1,87,86,82,82,45
"4173",72,"[30]gJHggqIHcdKocJvcGHqwdCFxklHKci",170,0.994152,30,171,1,170,1,1,0,1,1,93,92,78,78,45
"4174",73,"[30]gJHggqIHcdKocJvcGHqwdCFxklHKci",166,0.994012,30,167,1,166,1,1,0,1,1,81,80,86,86,45
"4175",74,"[30]gJHggqIHcdKocJvcGHqwdCFxklHKci",164,0.993939,30,165,1,164,1,1,0,1,1,76,75,89,89,45
"4176",75,"[30]gJHggqIHcdKocJvcGHqwdCFxklHKci",168,0.994083,30,169,1,168,1,1,0,1,1,86,85,83,83,45
"4177",76,"[30]gJHggqIHcdKocJvcGHqwdCFxklHKci",166,0.994012,30,167,1,166,1,1,0,1,1,82,81,85,85,45
"4178",77,"[30]gJHggqIHcdKocJvcGHqwdCFxklHKci",171,0.994186,30,172,1,171,1,1,0,1,1,94,93,78,78,45
"4179",78,"[30]gJHggqIHcdKocJvcGHqwdCFxklHKci",165,0.993976,30,166,1,165,1,1,0,1,1,80,79,86,86,45
"4180",79,"[30]gJHggqIHcdKocJvcGHqwdCFxklHKci",167,0.994048,30,168,1,167,1,1,0,1,1,86,85,82,82,45
"4181",80,"[30]gJHggqIHcdKocJvcGHqwdCFxklHKci",162,0.993865,30,163,1,162,1,1,0,1,1,72,71,91,91,45
"4182",81,"[30]gJHggqIHcdKocJvcGHqwdCFxklHKci",170,0.994152,30,171,1,170,1,1,0,1,1,92,91,79,79,45
"4183",82,"[30]gJHggqIHcdKocJvcGHqwdCFxklHKci",169,0.994118,30,170,1,169,1,1,0,1,1,89,88,81,81,45
"4184",83,"[30]gJHggqIHcdKocJvcGHqwdCFxklHKci",168,0.994083,30,169,1,168,1,1,0,1,1,85,84,84,84,45
"4185",84,"[30]gJHggqIHcdKocJvcGHqwdCFxklHKci",164,0.993939,30,165,1,164,1,1,0,1,1,76,75,89,89,45
"4186",85,"[30]gJHggqIHcdKocJvcGHqwdCFxklHKci",169,0.994118,30,170,1,169,1,1,0,1,1,89,88,81,81,45
"4187",86,"[30]gJHggqIHcdKocJvcGHqwdCFxklHKci",165,0.993976,30,166,1,165,1,1,0,1,1,78,77,88,88,45
"4188",87,"[30]gJHggqIHcdKocJvcGHqwdCFxklHKci",165,0.993976,30,166,1,165,1,1,0,1,1,78,77,88,88,45
"4189",88,"[30]gJHggqIHcdKocJvcGHqwdCFxklHKci",165,0.993976,30,166,1,165,1,1,0,1,1,79,78,87,87,45
"4190",89,"[30]gJHggqIHcdKocJvcGHqwdCFxklHKci",167,0.994048,30,168,1,167,1,1,0,1,1,85,84,83,83,45
"4191",90,"[30]gJHggqIHcdKocJvcGHqwdCFxklHKci",168,0.994083,30,169,1,168,1,1,0,1,1,87,86,82,82,45
"4192",91,"[30]gJHggqIHcdKocJvcGHqwdCFxklHKci",165,0.993976,30,166,1,165,1,1,0,1,1,78,77,88,88,45
"4193",92,"[30]gJHggqIHcdKocJvcGHqwdCFxklHKci",172,0.99422,30,173,1,172,1,1,0,1,1,98,97,75,75,45
"4194",93,"[30]gJHggqIHcdKocJvcGHqwdCFxklHKci",166,0.994012,30,167,1,166,1,1,0,1,1,82,81,85,85,45
"4195",94,"[30]gJHggqIHcdKocJvcGHqwdCFxklHKci",162,0.993865,30,163,1,162,1,1,0,1,1,72,71,91,91,45
"4196",95,"[30]gJHggqIHcdKocJvcGHqwdCFxklHKci",167,0.994048,30,168,1,167,1,1,0,1,1,83,82,85,85,45
"4197",96,"[30]gJHggqIHcdKocJvcGHqwdCFxklHKci",164,0.993939,30,165,1,164,1,1,0,1,1,76,75,89,89,45
"4198",97,"[30]gJHggqIHcdKocJvcGHqwdCFxklHKci",165,0.993976,30,166,1,165,1,1,0,1,1,80,79,86,86,45
"4199",98,"[30]gJHggqIHcdKocJvcGHqwdCFxklHKci",168,0.994083,30,169,1,168,1,1,0,1,1,86,85,83,83,45
"4200",99,"[30]gJHggqIHcdKocJvcGHqwdCFxklHKci",165,0.993976,30,166,1,165,1,1,0,1,1,79,78,87,87,45
"4201",0,"[25]aJHglqIHcdKpcJvcGHqwdCEDc",169,0.994118,25,170,1,169,1,1,0,1,1,91,90,79,79,46
"4202",1,"[25]aJHglqIHcdKpcJvcGHqwdCEDc",171,0.994186,25,172,1,171,1,1,0,1,1,97,96,75,75,46
"4203",2,"[25]aJHglqIHcdKpcJvcGHqwdCEDc",171,0.994186,25,172,1,171,1,1,0,1,1,96,95,76,76,46
"4204",3,"[25]aJHglqIHcdKpcJvcGHqwdCEDc",170,0.994152,25,171,1,170,1,1,0,1,1,93,92,78,78,46
"4205",4,"[25]aJHglqIHcdKpcJvcGHqwdCEDc",167,0.994048,25,168,1,167,1,1,0,1,1,86,85,82,82,46
"4206",5,"[25]aJHglqIHcdKpcJvcGHqwdCEDc",163,0.993902,25,164,1,163,1,1,0,1,1,73,72,91,91,46
"4207",6,"[25]aJHglqIHcdKpcJvcGHqwdCEDc",168,0.994083,25,169,1,168,1,1,0,1,1,88,87,81,81,46
"4208",7,"[25]aJHglqIHcdKpcJvcGHqwdCEDc",170,0.994152,25,171,1,170,1,1,0,1,1,93,92,78,78,46
"4209",8,"[25]aJHglqIHcdKpcJvcGHqwdCEDc",164,0.993939,25,165,1,164,1,1,0,1,1,76,75,89,89,46
"4210",9,"[25]aJHglqIHcdKpcJvcGHqwdCEDc",167,0.994048,25,168,1,167,1,1,0,1,1,83,82,85,85,46
"4211",10,"[25]aJHglqIHcdKpcJvcGHqwdCEDc",167,0.994048,25,168,1,167,1,1,0,1,1,86,85,82,82,46
"4212",11,"[25]aJHglqIHcdKpcJvcGHqwdCEDc",169,0.994118,25,170,1,169,1,1,0,1,1,86,85,84,84,46
"4213",12,"[25]aJHglqIHcdKpcJvcGHqwdCEDc",166,0.994012,25,167,1,166,1,1,0,1,1,81,80,86,86,46
"4214",13,"[25]aJHglqIHcdKpcJvcGHqwdCEDc",166,0.994012,25,167,1,166,1,1,0,1,1,82,81,85,85,46
"4215",14,"[25]aJHglqIHcdKpcJvcGHqwdCEDc",164,0.993939,25,165,1,164,1,1,0,1,1,77,76,88,88,46
"4216",15,"[25]aJHglqIHcdKpcJvcGHqwdCEDc",165,0.993976,25,166,1,165,1,1,0,1,1,79,78,87,87,46
"4217",16,"[25]aJHglqIHcdKpcJvcGHqwdCEDc",169,0.994118,25,170,1,169,1,1,0,1,1,90,89,80,80,46
"4218",17,"[25]aJHglqIHcdKpcJvcGHqwdCEDc",165,0.993976,25,166,1,165,1,1,0,1,1,80,79,86,86,46
"4219",18,"[25]aJHglqIHcdKpcJvcGHqwdCEDc",165,0.993976,25,166,1,165,1,1,0,1,1,79,78,87,87,46
"4220",19,"[25]aJHglqIHcdKpcJvcGHqwdCEDc",166,0.994012,25,167,1,166,1,1,0,1,1,82,81,85,85,46
"4221",20,"[25]aJHglqIHcdKpcJvcGHqwdCEDc",162,0.993865,25,163,1,162,1,1,0,1,1,72,71,91,91,46
"4222",21,"[25]aJHglqIHcdKpcJvcGHqwdCEDc",167,0.994048,25,168,1,167,1,1,0,1,1,83,82,85,85,46
"4223",22,"[25]aJHglqIHcdKpcJvcGHqwdCEDc",167,0.994048,25,168,1,167,1,1,0,1,1,84,83,84,84,46
"4224",23,"[25]aJHglqIHcdKpcJvcGHqwdCEDc",169,0.994118,25,170,1,169,1,1,0,1,1,90,89,80,80,46
"4225",24,"[25]aJHglqIHcdKpcJvcGHqwdCEDc",168,0.994083,25,169,1,168,1,1,0,1,1,86,85,83,83,46
"4226",25,"[25]aJHglqIHcdKpcJvcGHqwdCEDc",168,0.994083,25,169,1,168,1,1,0,1,1,87,86,82,82,46
"4227",26,"[25]aJHglqIHcdKpcJvcGHqwdCEDc",166,0.994012,25,167,1,166,1,1,0,1,1,81,80,86,86,46
"4228",27,"[25]aJHglqIHcdKpcJvcGHqwdCEDc",164,0.993939,25,165,1,164,1,1,0,1,1,77,76,88,88,46
"4229",28,"[25]aJHglqIHcdKpcJvcGHqwdCEDc",170,0.994152,25,171,1,170,1,1,0,1,1,93,92,78,78,46
"4230",29,"[25]aJHglqIHcdKpcJvcGHqwdCEDc",171,0.994186,25,172,1,171,1,1,0,1,1,97,96,75,75,46
"4231",30,"[25]aJHglqIHcdKpcJvcGHqwdCEDc",167,0.994048,25,168,1,167,1,1,0,1,1,84,83,84,84,46
"4232",31,"[25]aJHglqIHcdKpcJvcGHqwdCEDc",164,0.993939,25,165,1,164,1,1,0,1,1,77,76,88,88,46
"4233",32,"[25]aJHglqIHcdKpcJvcGHqwdCEDc",167,0.994048,25,168,1,167,1,1,0,1,1,86,85,82,82,46
"4234",33,"[25]aJHglqIHcdKpcJvcGHqwdCEDc",167,0.994048,25,168,1,167,1,1,0,1,1,86,85,82,82,46
"4235",34,"[25]aJHglqIHcdKpcJvcGHqwdCEDc",165,0.993976,25,166,1,165,1,1,0,1,1,78,77,88,88,46
"4236",35,"[25]aJHglqIHcdKpcJvcGHqwdCEDc",167,0.994048,25,168,1,167,1,1,0,1,1,84,83,84,84,46
"4237",36,"[25]aJHglqIHcdKpcJvcGHqwdCEDc",167,0.994048,25,168,1,167,1,1,0,1,1,86,85,82,82,46
"4238",37,"[25]aJHglqIHcdKpcJvcGHqwdCEDc",163,0.993902,25,164,1,163,1,1,0,1,1,74,73,90,90,46
"4239",38,"[25]aJHglqIHcdKpcJvcGHqwdCEDc",167,0.994048,25,168,1,167,1,1,0,1,1,83,82,85,85,46
"4240",39,"[25]aJHglqIHcdKpcJvcGHqwdCEDc",171,0.994186,25,172,1,171,1,1,0,1,1,95,94,77,77,46
"4241",40,"[25]aJHglqIHcdKpcJvcGHqwdCEDc",165,0.993976,25,166,1,165,1,1,0,1,1,80,79,86,86,46
"4242",41,"[25]aJHglqIHcdKpcJvcGHqwdCEDc",163,0.993902,25,164,1,163,1,1,0,1,1,75,74,89,89,46
"4243",42,"[25]aJHglqIHcdKpcJvcGHqwdCEDc",166,0.994012,25,167,1,166,1,1,0,1,1,83,82,84,84,46
"4244",43,"[25]aJHglqIHcdKpcJvcGHqwdCEDc",167,0.994048,25,168,1,167,1,1,0,1,1,84,83,84,84,46
"4245",44,"[25]aJHglqIHcdKpcJvcGHqwdCEDc",173,0.994253,25,174,1,173,1,1,0,1,1,101,100,73,73,46
"4246",45,"[25]aJHglqIHcdKpcJvcGHqwdCEDc",169,0.994118,25,170,1,169,1,1,0,1,1,91,90,79,79,46
"4247",46,"[25]aJHglqIHcdKpcJvcGHqwdCEDc",169,0.994118,25,170,1,169,1,1,0,1,1,89,88,81,81,46
"4248",47,"[25]aJHglqIHcdKpcJvcGHqwdCEDc",169,0.994118,25,170,1,169,1,1,0,1,1,89,88,81,81,46
"4249",48,"[25]aJHglqIHcdKpcJvcGHqwdCEDc",163,0.993902,25,164,1,163,1,1,0,1,1,74,73,90,90,46
"4250",49,"[25]aJHglqIHcdKpcJvcGHqwdCEDc",169,0.994118,25,170,1,169,1,1,0,1,1,89,88,81,81,46
"4251",50,"[25]aJHglqIHcdKpcJvcGHqwdCEDc",168,0.994083,25,169,1,168,1,1,0,1,1,87,86,82,82,46
"4252",51,"[25]aJHglqIHcdKpcJvcGHqwdCEDc",167,0.994048,25,168,1,167,1,1,0,1,1,86,85,82,82,46
"4253",52,"[25]aJHglqIHcdKpcJvcGHqwdCEDc",166,0.994012,25,167,1,166,1,1,0,1,1,82,81,85,85,46
"4254",53,"[25]aJHglqIHcdKpcJvcGHqwdCEDc",167,0.994048,25,168,1,167,1,1,0,1,1,85,84,83,83,46
"4255",54,"[25]aJHglqIHcdKpcJvcGHqwdCEDc",171,0.994186,25,172,1,171,1,1,0,1,1,95,94,77,77,46
"4256",55,"[25]aJHglqIHcdKpcJvcGHqwdCEDc",167,0.994048,25,168,1,167,1,1,0,1,1,85,84,83,83,46
"4257",56,"[25]aJHglqIHcdKpcJvcGHqwdCEDc",169,0.994118,25,170,1,169,1,1,0,1,1,89,88,81,81,46
"4258",57,"[25]aJHglqIHcdKpcJvcGHqwdCEDc",167,0.994048,25,168,1,167,1,1,0,1,1,85,84,83,83,46
"4259",58,"[25]aJHglqIHcdKpcJvcGHqwdCEDc",161,0.993827,25,162,1,161,1,1,0,1,1,69,68,93,93,46
"4260",59,"[25]aJHglqIHcdKpcJvcGHqwdCEDc",167,0.994048,25,168,1,167,1,1,0,1,1,85,84,83,83,46
"4261",60,"[25]aJHglqIHcdKpcJvcGHqwdCEDc",164,0.993939,25,165,1,164,1,1,0,1,1,77,76,88,88,46
"4262",61,"[25]aJHglqIHcdKpcJvcGHqwdCEDc",163,0.993902,25,164,1,163,1,1,0,1,1,74,73,90,90,46
"4263",62,"[25]aJHglqIHcdKpcJvcGHqwdCEDc",168,0.994083,25,169,1,168,1,1,0,1,1,87,86,82,82,46
"4264",63,"[25]aJHglqIHcdKpcJvcGHqwdCEDc",169,0.994118,25,170,1,169,1,1,0,1,1,90,89,80,80,46
"4265",64,"[25]aJHglqIHcdKpcJvcGHqwdCEDc",168,0.994083,25,169,1,168,1,1,0,1,1,88,87,81,81,46
"4266",65,"[25]aJHglqIHcdKpcJvcGHqwdCEDc",164,0.993939,25,165,1,164,1,1,0,1,1,76,75,89,89,46
"4267",66,"[25]aJHglqIHcdKpcJvcGHqwdCEDc",166,0.994012,25,167,1,166,1,1,0,1,1,81,80,86,86,46
"4268",67,"[25]aJHglqIHcdKpcJvcGHqwdCEDc",168,0.994083,25,169,1,168,1,1,0,1,1,88,87,81,81,46
"4269",68,"[25]aJHglqIHcdKpcJvcGHqwdCEDc",168,0.994083,25,169,1,168,1,1,0,1,1,86,85,83,83,46
"4270",69,"[25]aJHglqIHcdKpcJvcGHqwdCEDc",165,0.993976,25,166,1,165,1,1,0,1,1,78,77,88,88,46
"4271",70,"[25]aJHglqIHcdKpcJvcGHqwdCEDc",166,0.994012,25,167,1,166,1,1,0,1,1,83,82,84,84,46
"4272",71,"[25]aJHglqIHcdKpcJvcGHqwdCEDc",164,0.993939,25,165,1,164,1,1,0,1,1,77,76,88,88,46
"4273",72,"[25]aJHglqIHcdKpcJvcGHqwdCEDc",166,0.994012,25,167,1,166,1,1,0,1,1,83,82,84,84,46
"4274",73,"[25]aJHglqIHcdKpcJvcGHqwdCEDc",168,0.994083,25,169,1,168,1,1,0,1,1,88,87,81,81,46
"4275",74,"[25]aJHglqIHcdKpcJvcGHqwdCEDc",165,0.993976,25,166,1,165,1,1,0,1,1,79,78,87,87,46
"4276",75,"[25]aJHglqIHcdKpcJvcGHqwdCEDc",170,0.994152,25,171,1,170,1,1,0,1,1,92,91,79,79,46
"4277",76,"[25]aJHglqIHcdKpcJvcGHqwdCEDc",167,0.994048,25,168,1,167,1,1,0,1,1,85,84,83,83,46
"4278",77,"[25]aJHglqIHcdKpcJvcGHqwdCEDc",163,0.993902,25,164,1,163,1,1,0,1,1,75,74,89,89,46
"4279",78,"[25]aJHglqIHcdKpcJvcGHqwdCEDc",166,0.994012,25,167,1,166,1,1,0,1,1,83,82,84,84,46
"4280",79,"[25]aJHglqIHcdKpcJvcGHqwdCEDc",161,0.993827,25,162,1,161,1,1,0,1,1,69,68,93,93,46
"4281",80,"[25]aJHglqIHcdKpcJvcGHqwdCEDc",165,0.993976,25,166,1,165,1,1,0,1,1,79,78,87,87,46
"4282",81,"[25]aJHglqIHcdKpcJvcGHqwdCEDc",170,0.994152,25,171,1,170,1,1,0,1,1,90,89,81,81,46
"4283",82,"[25]aJHglqIHcdKpcJvcGHqwdCEDc",166,0.994012,25,167,1,166,1,1,0,1,1,83,82,84,84,46
"4284",83,"[25]aJHglqIHcdKpcJvcGHqwdCEDc",166,0.994012,25,167,1,166,1,1,0,1,1,82,81,85,85,46
"4285",84,"[25]aJHglqIHcdKpcJvcGHqwdCEDc",164,0.993939,25,165,1,164,1,1,0,1,1,77,76,88,88,46
"4286",85,"[25]aJHglqIHcdKpcJvcGHqwdCEDc",165,0.993976,25,166,1,165,1,1,0,1,1,78,77,88,88,46
"4287",86,"[25]aJHglqIHcdKpcJvcGHqwdCEDc",167,0.994048,25,168,1,167,1,1,0,1,1,85,84,83,83,46
"4288",87,"[25]aJHglqIHcdKpcJvcGHqwdCEDc",163,0.993902,25,164,1,163,1,1,0,1,1,73,72,91,91,46
"4289",88,"[25]aJHglqIHcdKpcJvcGHqwdCEDc",161,0.993827,25,162,1,161,1,1,0,1,1,69,68,93,93,46
"4290",89,"[25]aJHglqIHcdKpcJvcGHqwdCEDc",163,0.993902,25,164,1,163,1,1,0,1,1,74,73,90,90,46
"4291",90,"[25]aJHglqIHcdKpcJvcGHqwdCEDc",171,0.994186,25,172,1,171,1,1,0,1,1,94,93,78,78,46
"4292",91,"[25]aJHglqIHcdKpcJvcGHqwdCEDc",169,0.994118,25,170,1,169,1,1,0,1,1,89,88,81,81,46
"4293",92,"[25]aJHglqIHcdKpcJvcGHqwdCEDc",167,0.994048,25,168,1,167,1,1,0,1,1,85,84,83,83,46
"4294",93,"[25]aJHglqIHcdKpcJvcGHqwdCEDc",164,0.993939,25,165,1,164,1,1,0,1,1,76,75,89,89,46
"4295",94,"[25]aJHglqIHcdKpcJvcGHqwdCEDc",168,0.994083,25,169,1,168,1,1,0,1,1,87,86,82,82,46
"4296",95,"[25]aJHglqIHcdKpcJvcGHqwdCEDc",167,0.994048,25,168,1,167,1,1,0,1,1,83,82,85,85,46
"4297",96,"[25]aJHglqIHcdKpcJvcGHqwdCEDc",163,0.993902,25,164,1,163,1,1,0,1,1,75,74,89,89,46
"4298",97,"[25]aJHglqIHcdKpcJvcGHqwdCEDc",166,0.994012,25,167,1,166,1,1,0,1,1,81,80,86,86,46
"4299",98,"[25]aJHglqIHcdKpcJvcGHqwdCEDc",167,0.994048,25,168,1,167,1,1,0,1,1,84,83,84,84,46
"4300",99,"[25]aJHglqIHcdKpcJvcGHqwdCEDc",166,0.994012,25,167,1,166,1,1,0,1,1,81,80,86,86,46
"4301",0,"[28]sJHglqIHcdKpcJvcGHqvdCjwyJGJ",169,0.994118,28,170,1,169,1,1,0,1,1,88,87,82,82,47
"4302",1,"[28]sJHglqIHcdKpcJvcGHqvdCjwyJGJ",168,0.994083,28,169,1,168,1,1,0,1,1,87,86,82,82,47
"4303",2,"[28]sJHglqIHcdKpcJvcGHqvdCjwyJGJ",163,0.993902,28,164,1,163,1,1,0,1,1,74,73,90,90,47
"4304",3,"[28]sJHglqIHcdKpcJvcGHqvdCjwyJGJ",165,0.993976,28,166,1,165,1,1,0,1,1,80,79,86,86,47
"4305",4,"[28]sJHglqIHcdKpcJvcGHqvdCjwyJGJ",168,0.994083,28,169,1,168,1,1,0,1,1,87,86,82,82,47
"4306",5,"[28]sJHglqIHcdKpcJvcGHqvdCjwyJGJ",168,0.994083,28,169,1,168,1,1,0,1,1,88,87,81,81,47
"4307",6,"[28]sJHglqIHcdKpcJvcGHqvdCjwyJGJ",163,0.993902,28,164,1,163,1,1,0,1,1,73,72,91,91,47
"4308",7,"[28]sJHglqIHcdKpcJvcGHqvdCjwyJGJ",167,0.994048,28,168,1,167,1,1,0,1,1,85,84,83,83,47
"4309",8,"[28]sJHglqIHcdKpcJvcGHqvdCjwyJGJ",168,0.994083,28,169,1,168,1,1,0,1,1,87,86,82,82,47
"4310",9,"[28]sJHglqIHcdKpcJvcGHqvdCjwyJGJ",171,0.994186,28,172,1,171,1,1,0,1,1,96,95,76,76,47
"4311",10,"[28]sJHglqIHcdKpcJvcGHqvdCjwyJGJ",166,0.994012,28,167,1,166,1,1,0,1,1,82,81,85,85,47
"4312",11,"[28]sJHglqIHcdKpcJvcGHqvdCjwyJGJ",162,0.993865,28,163,1,162,1,1,0,1,1,71,70,92,92,47
"4313",12,"[28]sJHglqIHcdKpcJvcGHqvdCjwyJGJ",168,0.994083,28,169,1,168,1,1,0,1,1,87,86,82,82,47
"4314",13,"[28]sJHglqIHcdKpcJvcGHqvdCjwyJGJ",167,0.994048,28,168,1,167,1,1,0,1,1,83,82,85,85,47
"4315",14,"[28]sJHglqIHcdKpcJvcGHqvdCjwyJGJ",167,0.994048,28,168,1,167,1,1,0,1,1,85,84,83,83,47
"4316",15,"[28]sJHglqIHcdKpcJvcGHqvdCjwyJGJ",166,0.994012,28,167,1,166,1,1,0,1,1,83,82,84,84,47
"4317",16,"[28]sJHglqIHcdKpcJvcGHqvdCjwyJGJ",165,0.993976,28,166,1,165,1,1,0,1,1,80,79,86,86,47
"4318",17,"[28]sJHglqIHcdKpcJvcGHqvdCjwyJGJ",165,0.993976,28,166,1,165,1,1,0,1,1,79,78,87,87,47
"4319",18,"[28]sJHglqIHcdKpcJvcGHqvdCjwyJGJ",167,0.994048,28,168,1,167,1,1,0,1,1,85,84,83,83,47
"4320",19,"[28]sJHglqIHcdKpcJvcGHqvdCjwyJGJ",175,0.994318,28,176,1,175,1,1,0,1,1,105,104,71,71,47
"4321",20,"[28]sJHglqIHcdKpcJvcGHqvdCjwyJGJ",166,0.994012,28,167,1,166,1,1,0,1,1,81,80,86,86,47
"4322",21,"[28]sJHglqIHcdKpcJvcGHqvdCjwyJGJ",166,0.994012,28,167,1,166,1,1,0,1,1,81,80,86,86,47
"4323",22,"[28]sJHglqIHcdKpcJvcGHqvdCjwyJGJ",170,0.994152,28,171,1,170,1,1,0,1,1,91,90,80,80,47
"4324",23,"[28]sJHglqIHcdKpcJvcGHqvdCjwyJGJ",169,0.994118,28,170,1,169,1,1,0,1,1,91,90,79,79,47
"4325",24,"[28]sJHglqIHcdKpcJvcGHqvdCjwyJGJ",169,0.994118,28,170,1,169,1,1,0,1,1,89,88,81,81,47
"4326",25,"[28]sJHglqIHcdKpcJvcGHqvdCjwyJGJ",169,0.994118,28,170,1,169,1,1,0,1,1,91,90,79,79,47
"4327",26,"[28]sJHglqIHcdKpcJvcGHqvdCjwyJGJ",162,0.993865,28,163,1,162,1,1,0,1,1,70,69,93,93,47
"4328",27,"[28]sJHglqIHcdKpcJvcGHqvdCjwyJGJ",169,0.994118,28,170,1,169,1,1,0,1,1,89,88,81,81,47
"4329",28,"[28]sJHglqIHcdKpcJvcGHqvdCjwyJGJ",166,0.994012,28,167,1,166,1,1,0,1,1,81,80,86,86,47
"4330",29,"[28]sJHglqIHcdKpcJvcGHqvdCjwyJGJ",167,0.994048,28,168,1,167,1,1,0,1,1,83,82,85,85,47
"4331",30,"[28]sJHglqIHcdKpcJvcGHqvdCjwyJGJ",162,0.993865,28,163,1,162,1,1,0,1,1,70,69,93,93,47
"4332",31,"[28]sJHglqIHcdKpcJvcGHqvdCjwyJGJ",169,0.994118,28,170,1,169,1,1,0,1,1,90,89,80,80,47
"4333",32,"[28]sJHglqIHcdKpcJvcGHqvdCjwyJGJ",167,0.994048,28,168,1,167,1,1,0,1,1,85,84,83,83,47
"4334",33,"[28]sJHglqIHcdKpcJvcGHqvdCjwyJGJ",175,0.994318,28,176,1,175,1,1,0,1,1,105,104,71,71,47
"4335",34,"[28]sJHglqIHcdKpcJvcGHqvdCjwyJGJ",170,0.994152,28,171,1,170,1,1,0,1,1,93,92,78,78,47
"4336",35,"[28]sJHglqIHcdKpcJvcGHqvdCjwyJGJ",168,0.994083,28,169,1,168,1,1,0,1,1,87,86,82,82,47
"4337",36,"[28]sJHglqIHcdKpcJvcGHqvdCjwyJGJ",173,0.994253,28,174,1,173,1,1,0,1,1,99,98,75,75,47
"4338",37,"[28]sJHglqIHcdKpcJvcGHqvdCjwyJGJ",165,0.993976,28,166,1,165,1,1,0,1,1,80,79,86,86,47
"4339",38,"[28]sJHglqIHcdKpcJvcGHqvdCjwyJGJ",168,0.994083,28,169,1,168,1,1,0,1,1,88,87,81,81,47
"4340",39,"[28]sJHglqIHcdKpcJvcGHqvdCjwyJGJ",173,0.994253,28,174,1,173,1,1,0,1,1,101,100,73,73,47
"4341",40,"[28]sJHglqIHcdKpcJvcGHqvdCjwyJGJ",166,0.994012,28,167,1,166,1,1,0,1,1,82,81,85,85,47
"4342",41,"[28]sJHglqIHcdKpcJvcGHqvdCjwyJGJ",170,0.994152,28,171,1,170,1,1,0,1,1,92,91,79,79,47
"4343",42,"[28]sJHglqIHcdKpcJvcGHqvdCjwyJGJ",169,0.994118,28,170,1,169,1,1,0,1,1,89,88,81,81,47
"4344",43,"[28]sJHglqIHcdKpcJvcGHqvdCjwyJGJ",169,0.994118,28,170,1,169,1,1,0,1,1,91,90,79,79,47
"4345",44,"[28]sJHglqIHcdKpcJvcGHqvdCjwyJGJ",170,0.994152,28,171,1,170,1,1,0,1,1,92,91,79,79,47
"4346",45,"[28]sJHglqIHcdKpcJvcGHqvdCjwyJGJ",170,0.994152,28,171,1,170,1,1,0,1,1,91,90,80,80,47
"4347",46,"[28]sJHglqIHcdKpcJvcGHqvdCjwyJGJ",165,0.993976,28,166,1,165,1,1,0,1,1,80,79,86,86,47
"4348",47,"[28]sJHglqIHcdKpcJvcGHqvdCjwyJGJ",168,0.994083,28,169,1,168,1,1,0,1,1,87,86,82,82,47
"4349",48,"[28]sJHglqIHcdKpcJvcGHqvdCjwyJGJ",158,0.993711,28,159,1,158,1,1,0,1,1,60,59,99,99,47
"4350",49,"[28]sJHglqIHcdKpcJvcGHqvdCjwyJGJ",170,0.994152,28,171,1,170,1,1,0,1,1,93,92,78,78,47
"4351",50,"[28]sJHglqIHcdKpcJvcGHqvdCjwyJGJ",166,0.994012,28,167,1,166,1,1,0,1,1,81,80,86,86,47
"4352",51,"[28]sJHglqIHcdKpcJvcGHqvdCjwyJGJ",166,0.994012,28,167,1,166,1,1,0,1,1,79,78,88,88,47
"4353",52,"[28]sJHglqIHcdKpcJvcGHqvdCjwyJGJ",168,0.994083,28,169,1,168,1,1,0,1,1,86,85,83,83,47
"4354",53,"[28]sJHglqIHcdKpcJvcGHqvdCjwyJGJ",167,0.994048,28,168,1,167,1,1,0,1,1,85,84,83,83,47
"4355",54,"[28]sJHglqIHcdKpcJvcGHqvdCjwyJGJ",171,0.994186,28,172,1,171,1,1,0,1,1,95,94,77,77,47
"4356",55,"[28]sJHglqIHcdKpcJvcGHqvdCjwyJGJ",163,0.993902,28,164,1,163,1,1,0,1,1,75,74,89,89,47
"4357",56,"[28]sJHglqIHcdKpcJvcGHqvdCjwyJGJ",173,0.994253,28,174,1,173,1,1,0,1,1,100,99,74,74,47
"4358",57,"[28]sJHglqIHcdKpcJvcGHqvdCjwyJGJ",164,0.993939,28,165,1,164,1,1,0,1,1,77,76,88,88,47
"4359",58,"[28]sJHglqIHcdKpcJvcGHqvdCjwyJGJ",170,0.994152,28,171,1,170,1,1,0,1,1,93,92,78,78,47
"4360",59,"[28]sJHglqIHcdKpcJvcGHqvdCjwyJGJ",170,0.994152,28,171,1,170,1,1,0,1,1,91,90,80,80,47
"4361",60,"[28]sJHglqIHcdKpcJvcGHqvdCjwyJGJ",165,0.993976,28,166,1,165,1,1,0,1,1,78,77,88,88,47
"4362",61,"[28]sJHglqIHcdKpcJvcGHqvdCjwyJGJ",170,0.994152,28,171,1,170,1,1,0,1,1,93,92,78,78,47
"4363",62,"[28]sJHglqIHcdKpcJvcGHqvdCjwyJGJ",169,0.994118,28,170,1,169,1,1,0,1,1,89,88,81,81,47
"4364",63,"[28]sJHglqIHcdKpcJvcGHqvdCjwyJGJ",158,0.993711,28,159,1,158,1,1,0,1,1,60,59,99,99,47
"4365",64,"[28]sJHglqIHcdKpcJvcGHqvdCjwyJGJ",166,0.994012,28,167,1,166,1,1,0,1,1,82,81,85,85,47
"4366",65,"[28]sJHglqIHcdKpcJvcGHqvdCjwyJGJ",167,0.994048,28,168,1,167,1,1,0,1,1,84,83,84,84,47
"4367",66,"[28]sJHglqIHcdKpcJvcGHqvdCjwyJGJ",169,0.994118,28,170,1,169,1,1,0,1,1,90,89,80,80,47
"4368",67,"[28]sJHglqIHcdKpcJvcGHqvdCjwyJGJ",167,0.994048,28,168,1,167,1,1,0,1,1,84,83,84,84,47
"4369",68,"[28]sJHglqIHcdKpcJvcGHqvdCjwyJGJ",169,0.994118,28,170,1,169,1,1,0,1,1,89,88,81,81,47
"4370",69,"[28]sJHglqIHcdKpcJvcGHqvdCjwyJGJ",169,0.994118,28,170,1,169,1,1,0,1,1,88,87,82,82,47
"4371",70,"[28]sJHglqIHcdKpcJvcGHqvdCjwyJGJ",166,0.994012,28,167,1,166,1,1,0,1,1,81,80,86,86,47
"4372",71,"[28]sJHglqIHcdKpcJvcGHqvdCjwyJGJ",170,0.994152,28,171,1,170,1,1,0,1,1,94,93,77,77,47
"4373",72,"[28]sJHglqIHcdKpcJvcGHqvdCjwyJGJ",168,0.994083,28,169,1,168,1,1,0,1,1,88,87,81,81,47
"4374",73,"[28]sJHglqIHcdKpcJvcGHqvdCjwyJGJ",174,0.994286,28,175,1,174,1,1,0,1,1,104,103,71,71,47
"4375",74,"[28]sJHglqIHcdKpcJvcGHqvdCjwyJGJ",163,0.993902,28,164,1,163,1,1,0,1,1,74,73,90,90,47
"4376",75,"[28]sJHglqIHcdKpcJvcGHqvdCjwyJGJ",167,0.994048,28,168,1,167,1,1,0,1,1,83,82,85,85,47
"4377",76,"[28]sJHglqIHcdKpcJvcGHqvdCjwyJGJ",168,0.994083,28,169,1,168,1,1,0,1,1,87,86,82,82,47
"4378",77,"[28]sJHglqIHcdKpcJvcGHqvdCjwyJGJ",166,0.994012,28,167,1,166,1,1,0,1,1,82,81,85,85,47
"4379",78,"[28]sJHglqIHcdKpcJvcGHqvdCjwyJGJ",167,0.994048,28,168,1,167,1,1,0,1,1,84,83,84,84,47
"4380",79,"[28]sJHglqIHcdKpcJvcGHqvdCjwyJGJ",163,0.993902,28,164,1,163,1,1,0,1,1,75,74,89,89,47
"4381",80,"[28]sJHglqIHcdKpcJvcGHqvdCjwyJGJ",173,0.994253,28,174,1,173,1,1,0,1,1,99,98,75,75,47
"4382",81,"[28]sJHglqIHcdKpcJvcGHqvdCjwyJGJ",169,0.994118,28,170,1,169,1,1,0,1,1,91,90,79,79,47
"4383",82,"[28]sJHglqIHcdKpcJvcGHqvdCjwyJGJ",173,0.994253,28,174,1,173,1,1,0,1,1,101,100,73,73,47
"4384",83,"[28]sJHglqIHcdKpcJvcGHqvdCjwyJGJ",166,0.994012,28,167,1,166,1,1,0,1,1,83,82,84,84,47
"4385",84,"[28]sJHglqIHcdKpcJvcGHqvdCjwyJGJ",172,0.99422,28,173,1,172,1,1,0,1,1,98,97,75,75,47
"4386",85,"[28]sJHglqIHcdKpcJvcGHqvdCjwyJGJ",165,0.993976,28,166,1,165,1,1,0,1,1,80,79,86,86,47
"4387",86,"[28]sJHglqIHcdKpcJvcGHqvdCjwyJGJ",171,0.994186,28,172,1,171,1,1,0,1,1,96,95,76,76,47
"4388",87,"[28]sJHglqIHcdKpcJvcGHqvdCjwyJGJ",167,0.994048,28,168,1,167,1,1,0,1,1,84,83,84,84,47
"4389",88,"[28]sJHglqIHcdKpcJvcGHqvdCjwyJGJ",168,0.994083,28,169,1,168,1,1,0,1,1,88,87,81,81,47
"4390",89,"[28]sJHglqIHcdKpcJvcGHqvdCjwyJGJ",169,0.994118,28,170,1,169,1,1,0,1,1,90,89,80,80,47
"4391",90,"[28]sJHglqIHcdKpcJvcGHqvdCjwyJGJ",171,0.994186,28,172,1,171,1,1,0,1,1,96,95,76,76,47
"4392",91,"[28]sJHglqIHcdKpcJvcGHqvdCjwyJGJ",169,0.994118,28,170,1,169,1,1,0,1,1,89,88,81,81,47
"4393",92,"[28]sJHglqIHcdKpcJvcGHqvdCjwyJGJ",167,0.994048,28,168,1,167,1,1,0,1,1,85,84,83,83,47
"4394",93,"[28]sJHglqIHcdKpcJvcGHqvdCjwyJGJ",163,0.993902,28,164,1,163,1,1,0,1,1,73,72,91,91,47
"4395",94,"[28]sJHglqIHcdKpcJvcGHqvdCjwyJGJ",166,0.994012,28,167,1,166,1,1,0,1,1,82,81,85,85,47
"4396",95,"[28]sJHglqIHcdKpcJvcGHqvdCjwyJGJ",171,0.994186,28,172,1,171,1,1,0,1,1,95,94,77,77,47
"4397",96,"[28]sJHglqIHcdKpcJvcGHqvdCjwyJGJ",167,0.994048,28,168,1,167,1,1,0,1,1,85,84,83,83,47
"4398",97,"[28]sJHglqIHcdKpcJvcGHqvdCjwyJGJ",166,0.994012,28,167,1,166,1,1,0,1,1,81,80,86,86,47
"4399",98,"[28]sJHglqIHcdKpcJvcGHqvdCjwyJGJ",167,0.994048,28,168,1,167,1,1,0,1,1,84,83,84,84,47
"4400",99,"[28]sJHglqIHcdKpcJvcGHqvdCjwyJGJ",169,0.994118,28,170,1,169,1,1,0,1,1,90,89,80,80,47
"4401",0,"[28]iJHggqIlHcidKocJvcGHqFdCBBbl",176,0.99435,28,177,1,176,1,1,0,1,1,89,88,88,88,48
"4402",1,"[28]iJHggqIlHcidKocJvcGHqFdCBBbl",173,0.994253,28,174,1,173,1,1,0,1,1,81,80,93,93,48
"4403",2,"[28]iJHggqIlHcidKocJvcGHqFdCBBbl",173,0.994253,28,174,1,173,1,1,0,1,1,80,79,94,94,48
"4404",3,"[28]iJHggqIlHcidKocJvcGHqFdCBBbl",179,0.994444,28,180,1,179,1,1,0,1,1,97,96,83,83,48
"4405",4,"[28]iJHggqIlHcidKocJvcGHqFdCBBbl",177,0.994382,28,178,1,177,1,1,0,1,1,92,91,86,86,48
"4406",5,"[28]iJHggqIlHcidKocJvcGHqFdCBBbl",174,0.994286,28,175,1,174,1,1,0,1,1,83,82,92,92,48
"4407",6,"[28]iJHggqIlHcidKocJvcGHqFdCBBbl",175,0.994318,28,176,1,175,1,1,0,1,1,86,85,90,90,48
"4408",7,"[28]iJHggqIlHcidKocJvcGHqFdCBBbl",178,0.994413,28,179,1,178,1,1,0,1,1,97,96,82,82,48
"4409",8,"[28]iJHggqIlHcidKocJvcGHqFdCBBbl",172,0.99422,28,173,1,172,1,1,0,1,1,77,76,96,96,48
"4410",9,"[28]iJHggqIlHcidKocJvcGHqFdCBBbl",177,0.994382,28,178,1,177,1,1,0,1,1,94,93,84,84,48
"4411",10,"[28]iJHggqIlHcidKocJvcGHqFdCBBbl",173,0.994253,28,174,1,173,1,1,0,1,1,80,79,94,94,48
"4412",11,"[28]iJHggqIlHcidKocJvcGHqFdCBBbl",180,0.994475,28,181,1,180,1,1,0,1,1,101,100,80,80,48
"4413",12,"[28]iJHggqIlHcidKocJvcGHqFdCBBbl",172,0.99422,28,173,1,172,1,1,0,1,1,76,75,97,97,48
"4414",13,"[28]iJHggqIlHcidKocJvcGHqFdCBBbl",176,0.99435,28,177,1,176,1,1,0,1,1,91,90,86,86,48
"4415",14,"[28]iJHggqIlHcidKocJvcGHqFdCBBbl",178,0.994413,28,179,1,178,1,1,0,1,1,97,96,82,82,48
"4416",15,"[28]iJHggqIlHcidKocJvcGHqFdCBBbl",179,0.994444,28,180,1,179,1,1,0,1,1,100,99,80,80,48
"4417",16,"[28]iJHggqIlHcidKocJvcGHqFdCBBbl",176,0.99435,28,177,1,176,1,1,0,1,1,89,88,88,88,48
"4418",17,"[28]iJHggqIlHcidKocJvcGHqFdCBBbl",177,0.994382,28,178,1,177,1,1,0,1,1,93,92,85,85,48
"4419",18,"[28]iJHggqIlHcidKocJvcGHqFdCBBbl",177,0.994382,28,178,1,177,1,1,0,1,1,93,92,85,85,48
"4420",19,"[28]iJHggqIlHcidKocJvcGHqFdCBBbl",176,0.99435,28,177,1,176,1,1,0,1,1,89,88,88,88,48
"4421",20,"[28]iJHggqIlHcidKocJvcGHqFdCBBbl",181,0.994505,28,182,1,181,1,1,0,1,1,105,104,77,77,48
"4422",21,"[28]iJHggqIlHcidKocJvcGHqFdCBBbl",180,0.994475,28,181,1,180,1,1,0,1,1,104,103,77,77,48
"4423",22,"[28]iJHggqIlHcidKocJvcGHqFdCBBbl",173,0.994253,28,174,1,173,1,1,0,1,1,79,78,95,95,48
"4424",23,"[28]iJHggqIlHcidKocJvcGHqFdCBBbl",177,0.994382,28,178,1,177,1,1,0,1,1,94,93,84,84,48
"4425",24,"[28]iJHggqIlHcidKocJvcGHqFdCBBbl",179,0.994444,28,180,1,179,1,1,0,1,1,99,98,81,81,48
"4426",25,"[28]iJHggqIlHcidKocJvcGHqFdCBBbl",176,0.99435,28,177,1,176,1,1,0,1,1,89,88,88,88,48
"4427",26,"[28]iJHggqIlHcidKocJvcGHqFdCBBbl",178,0.994413,28,179,1,178,1,1,0,1,1,96,95,83,83,48
"4428",27,"[28]iJHggqIlHcidKocJvcGHqFdCBBbl",178,0.994413,28,179,1,178,1,1,0,1,1,95,94,84,84,48
"4429",28,"[28]iJHggqIlHcidKocJvcGHqFdCBBbl",176,0.99435,28,177,1,176,1,1,0,1,1,86,85,91,91,48
"4430",29,"[28]iJHggqIlHcidKocJvcGHqFdCBBbl",172,0.99422,28,173,1,172,1,1,0,1,1,76,75,97,97,48
"4431",30,"[28]iJHggqIlHcidKocJvcGHqFdCBBbl",179,0.994444,28,180,1,179,1,1,0,1,1,99,98,81,81,48
"4432",31,"[28]iJHggqIlHcidKocJvcGHqFdCBBbl",176,0.99435,28,177,1,176,1,1,0,1,1,88,87,89,89,48
"4433",32,"[28]iJHggqIlHcidKocJvcGHqFdCBBbl",173,0.994253,28,174,1,173,1,1,0,1,1,77,76,97,97,48
"4434",33,"[28]iJHggqIlHcidKocJvcGHqFdCBBbl",176,0.99435,28,177,1,176,1,1,0,1,1,89,88,88,88,48
"4435",34,"[28]iJHggqIlHcidKocJvcGHqFdCBBbl",178,0.994413,28,179,1,178,1,1,0,1,1,97,96,82,82,48
"4436",35,"[28]iJHggqIlHcidKocJvcGHqFdCBBbl",173,0.994253,28,174,1,173,1,1,0,1,1,80,79,94,94,48
"4437",36,"[28]iJHggqIlHcidKocJvcGHqFdCBBbl",176,0.99435,28,177,1,176,1,1,0,1,1,90,89,87,87,48
"4438",37,"[28]iJHggqIlHcidKocJvcGHqFdCBBbl",176,0.99435,28,177,1,176,1,1,0,1,1,91,90,86,86,48
"4439",38,"[28]iJHggqIlHcidKocJvcGHqFdCBBbl",175,0.994318,28,176,1,175,1,1,0,1,1,87,86,89,89,48
"4440",39,"[28]iJHggqIlHcidKocJvcGHqFdCBBbl",175,0.994318,28,176,1,175,1,1,0,1,1,87,86,89,89,48
"4441",40,"[28]iJHggqIlHcidKocJvcGHqFdCBBbl",176,0.99435,28,177,1,176,1,1,0,1,1,90,89,87,87,48
"4442",41,"[28]iJHggqIlHcidKocJvcGHqFdCBBbl",179,0.994444,28,180,1,179,1,1,0,1,1,96,95,84,84,48
"4443",42,"[28]iJHggqIlHcidKocJvcGHqFdCBBbl",179,0.994444,28,180,1,179,1,1,0,1,1,99,98,81,81,48
"4444",43,"[28]iJHggqIlHcidKocJvcGHqFdCBBbl",173,0.994253,28,174,1,173,1,1,0,1,1,79,78,95,95,48
"4445",44,"[28]iJHggqIlHcidKocJvcGHqFdCBBbl",176,0.99435,28,177,1,176,1,1,0,1,1,89,88,88,88,48
"4446",45,"[28]iJHggqIlHcidKocJvcGHqFdCBBbl",180,0.994475,28,181,1,180,1,1,0,1,1,100,99,81,81,48
"4447",46,"[28]iJHggqIlHcidKocJvcGHqFdCBBbl",175,0.994318,28,176,1,175,1,1,0,1,1,84,83,92,92,48
"4448",47,"[28]iJHggqIlHcidKocJvcGHqFdCBBbl",172,0.99422,28,173,1,172,1,1,0,1,1,76,75,97,97,48
"4449",48,"[28]iJHggqIlHcidKocJvcGHqFdCBBbl",176,0.99435,28,177,1,176,1,1,0,1,1,88,87,89,89,48
"4450",49,"[28]iJHggqIlHcidKocJvcGHqFdCBBbl",179,0.994444,28,180,1,179,1,1,0,1,1,100,99,80,80,48
"4451",50,"[28]iJHggqIlHcidKocJvcGHqFdCBBbl",180,0.994475,28,181,1,180,1,1,0,1,1,102,101,79,79,48
"4452",51,"[28]iJHggqIlHcidKocJvcGHqFdCBBbl",176,0.99435,28,177,1,176,1,1,0,1,1,91,90,86,86,48
"4453",52,"[28]iJHggqIlHcidKocJvcGHqFdCBBbl",175,0.994318,28,176,1,175,1,1,0,1,1,87,86,89,89,48
"4454",53,"[28]iJHggqIlHcidKocJvcGHqFdCBBbl",179,0.994444,28,180,1,179,1,1,0,1,1,98,97,82,82,48
"4455",54,"[28]iJHggqIlHcidKocJvcGHqFdCBBbl",179,0.994444,28,180,1,179,1,1,0,1,1,100,99,80,80,48
"4456",55,"[28]iJHggqIlHcidKocJvcGHqFdCBBbl",177,0.994382,28,178,1,177,1,1,0,1,1,92,91,86,86,48
"4457",56,"[28]iJHggqIlHcidKocJvcGHqFdCBBbl",178,0.994413,28,179,1,178,1,1,0,1,1,95,94,84,84,48
"4458",57,"[28]iJHggqIlHcidKocJvcGHqFdCBBbl",176,0.99435,28,177,1,176,1,1,0,1,1,90,89,87,87,48
"4459",58,"[28]iJHggqIlHcidKocJvcGHqFdCBBbl",178,0.994413,28,179,1,178,1,1,0,1,1,91,90,88,88,48
"4460",59,"[28]iJHggqIlHcidKocJvcGHqFdCBBbl",176,0.99435,28,177,1,176,1,1,0,1,1,89,88,88,88,48
"4461",60,"[28]iJHggqIlHcidKocJvcGHqFdCBBbl",178,0.994413,28,179,1,178,1,1,0,1,1,95,94,84,84,48
"4462",61,"[28]iJHggqIlHcidKocJvcGHqFdCBBbl",175,0.994318,28,176,1,175,1,1,0,1,1,86,85,90,90,48
"4463",62,"[28]iJHggqIlHcidKocJvcGHqFdCBBbl",174,0.994286,28,175,1,174,1,1,0,1,1,83,82,92,92,48
"4464",63,"[28]iJHggqIlHcidKocJvcGHqFdCBBbl",176,0.99435,28,177,1,176,1,1,0,1,1,90,89,87,87,48
"4465",64,"[28]iJHggqIlHcidKocJvcGHqFdCBBbl",180,0.994475,28,181,1,180,1,1,0,1,1,103,102,78,78,48
"4466",65,"[28]iJHggqIlHcidKocJvcGHqFdCBBbl",177,0.994382,28,178,1,177,1,1,0,1,1,92,91,86,86,48
"4467",66,"[28]iJHggqIlHcidKocJvcGHqFdCBBbl",181,0.994505,28,182,1,181,1,1,0,1,1,107,106,75,75,48
"4468",67,"[28]iJHggqIlHcidKocJvcGHqFdCBBbl",178,0.994413,28,179,1,178,1,1,0,1,1,97,96,82,82,48
"4469",68,"[28]iJHggqIlHcidKocJvcGHqFdCBBbl",175,0.994318,28,176,1,175,1,1,0,1,1,87,86,89,89,48
"4470",69,"[28]iJHggqIlHcidKocJvcGHqFdCBBbl",176,0.99435,28,177,1,176,1,1,0,1,1,88,87,89,89,48
"4471",70,"[28]iJHggqIlHcidKocJvcGHqFdCBBbl",171,0.994186,28,172,1,171,1,1,0,1,1,72,71,100,100,48
"4472",71,"[28]iJHggqIlHcidKocJvcGHqFdCBBbl",173,0.994253,28,174,1,173,1,1,0,1,1,80,79,94,94,48
"4473",72,"[28]iJHggqIlHcidKocJvcGHqFdCBBbl",177,0.994382,28,178,1,177,1,1,0,1,1,93,92,85,85,48
"4474",73,"[28]iJHggqIlHcidKocJvcGHqFdCBBbl",174,0.994286,28,175,1,174,1,1,0,1,1,82,81,93,93,48
"4475",74,"[28]iJHggqIlHcidKocJvcGHqFdCBBbl",173,0.994253,28,174,1,173,1,1,0,1,1,80,79,94,94,48
"4476",75,"[28]iJHggqIlHcidKocJvcGHqFdCBBbl",175,0.994318,28,176,1,175,1,1,0,1,1,87,86,89,89,48
"4477",76,"[28]iJHggqIlHcidKocJvcGHqFdCBBbl",176,0.99435,28,177,1,176,1,1,0,1,1,89,88,88,88,48
"4478",77,"[28]iJHggqIlHcidKocJvcGHqFdCBBbl",172,0.99422,28,173,1,172,1,1,0,1,1,77,76,96,96,48
"4479",78,"[28]iJHggqIlHcidKocJvcGHqFdCBBbl",173,0.994253,28,174,1,173,1,1,0,1,1,81,80,93,93,48
"4480",79,"[28]iJHggqIlHcidKocJvcGHqFdCBBbl",177,0.994382,28,178,1,177,1,1,0,1,1,92,91,86,86,48
"4481",80,"[28]iJHggqIlHcidKocJvcGHqFdCBBbl",177,0.994382,28,178,1,177,1,1,0,1,1,93,92,85,85,48
"4482",81,"[28]iJHggqIlHcidKocJvcGHqFdCBBbl",176,0.99435,28,177,1,176,1,1,0,1,1,89,88,88,88,48
"4483",82,"[28]iJHggqIlHcidKocJvcGHqFdCBBbl",174,0.994286,28,175,1,174,1,1,0,1,1,82,81,93,93,48
"4484",83,"[28]iJHggqIlHcidKocJvcGHqFdCBBbl",176,0.99435,28,177,1,176,1,1,0,1,1,87,86,90,90,48
"4485",84,"[28]iJHggqIlHcidKocJvcGHqFdCBBbl",174,0.994286,28,175,1,174,1,1,0,1,1,83,82,92,92,48
"4486",85,"[28]iJHggqIlHcidKocJvcGHqFdCBBbl",176,0.99435,28,177,1,176,1,1,0,1,1,90,89,87,87,48
"4487",86,"[28]iJHggqIlHcidKocJvcGHqFdCBBbl",174,0.994286,28,175,1,174,1,1,0,1,1,83,82,92,92,48
"4488",87,"[28]iJHggqIlHcidKocJvcGHqFdCBBbl",178,0.994413,28,179,1,178,1,1,0,1,1,96,95,83,83,48
"4489",88,"[28]iJHggqIlHcidKocJvcGHqFdCBBbl",173,0.994253,28,174,1,173,1,1,0,1,1,79,78,95,95,48
"4490",89,"[28]iJHggqIlHcidKocJvcGHqFdCBBbl",174,0.994286,28,175,1,174,1,1,0,1,1,84,83,91,91,48
"4491",90,"[28]iJHggqIlHcidKocJvcGHqFdCBBbl",179,0.994444,28,180,1,179,1,1,0,1,1,100,99,80,80,48
"4492",91,"[28]iJHggqIlHcidKocJvcGHqFdCBBbl",179,0.994444,28,180,1,179,1,1,0,1,1,100,99,80,80,48
"4493",92,"[28]iJHggqIlHcidKocJvcGHqFdCBBbl",175,0.994318,28,176,1,175,1,1,0,1,1,85,84,91,91,48
"4494",93,"[28]iJHggqIlHcidKocJvcGHqFdCBBbl",180,0.994475,28,181,1,180,1,1,0,1,1,104,103,77,77,48
"4495",94,"[28]iJHggqIlHcidKocJvcGHqFdCBBbl",178,0.994413,28,179,1,178,1,1,0,1,1,96,95,83,83,48
"4496",95,"[28]iJHggqIlHcidKocJvcGHqFdCBBbl",176,0.99435,28,177,1,176,1,1,0,1,1,90,89,87,87,48
"4497",96,"[28]iJHggqIlHcidKocJvcGHqFdCBBbl",175,0.994318,28,176,1,175,1,1,0,1,1,84,83,92,92,48
"4498",97,"[28]iJHggqIlHcidKocJvcGHqFdCBBbl",181,0.994505,28,182,1,181,1,1,0,1,1,104,103,78,78,48
"4499",98,"[28]iJHggqIlHcidKocJvcGHqFdCBBbl",177,0.994382,28,178,1,177,1,1,0,1,1,90,89,88,88,48
"4500",99,"[28]iJHggqIlHcidKocJvcGHqFdCBBbl",180,0.994475,28,181,1,180,1,1,0,1,1,102,101,79,79,48
"4501",0,"[31]zJHglqIhHcidKpcJvcGHqFdCvtuDwHo",172,0.99422,31,173,1,172,1,1,0,1,1,77,76,96,96,50
"4502",1,"[31]zJHglqIhHcidKpcJvcGHqFdCvtuDwHo",178,0.994413,31,179,1,178,1,1,0,1,1,95,94,84,84,50
"4503",2,"[31]zJHglqIhHcidKpcJvcGHqFdCvtuDwHo",179,0.994444,31,180,1,179,1,1,0,1,1,99,98,81,81,50
"4504",3,"[31]zJHglqIhHcidKpcJvcGHqFdCvtuDwHo",176,0.99435,31,177,1,176,1,1,0,1,1,90,89,87,87,50
"4505",4,"[31]zJHglqIhHcidKpcJvcGHqFdCvtuDwHo",176,0.99435,31,177,1,176,1,1,0,1,1,90,89,87,87,50
"4506",5,"[31]zJHglqIhHcidKpcJvcGHqFdCvtuDwHo",180,0.994475,31,181,1,180,1,1,0,1,1,102,101,79,79,50
"4507",6,"[31]zJHglqIhHcidKpcJvcGHqFdCvtuDwHo",180,0.994475,31,181,1,180,1,1,0,1,1,103,102,78,78,50
"4508",7,"[31]zJHglqIhHcidKpcJvcGHqFdCvtuDwHo",175,0.994318,31,176,1,175,1,1,0,1,1,86,85,90,90,50
"4509",8,"[31]zJHglqIhHcidKpcJvcGHqFdCvtuDwHo",175,0.994318,31,176,1,175,1,1,0,1,1,86,85,90,90,50
"4510",9,"[31]zJHglqIhHcidKpcJvcGHqFdCvtuDwHo",176,0.99435,31,177,1,176,1,1,0,1,1,90,89,87,87,50
"4511",10,"[31]zJHglqIhHcidKpcJvcGHqFdCvtuDwHo",177,0.994382,31,178,1,177,1,1,0,1,1,93,92,85,85,50
"4512",11,"[31]zJHglqIhHcidKpcJvcGHqFdCvtuDwHo",179,0.994444,31,180,1,179,1,1,0,1,1,99,98,81,81,50
"4513",12,"[31]zJHglqIhHcidKpcJvcGHqFdCvtuDwHo",174,0.994286,31,175,1,174,1,1,0,1,1,83,82,92,92,50
"4514",13,"[31]zJHglqIhHcidKpcJvcGHqFdCvtuDwHo",172,0.99422,31,173,1,172,1,1,0,1,1,76,75,97,97,50
"4515",14,"[31]zJHglqIhHcidKpcJvcGHqFdCvtuDwHo",179,0.994444,31,180,1,179,1,1,0,1,1,98,97,82,82,50
"4516",15,"[31]zJHglqIhHcidKpcJvcGHqFdCvtuDwHo",177,0.994382,31,178,1,177,1,1,0,1,1,92,91,86,86,50
"4517",16,"[31]zJHglqIhHcidKpcJvcGHqFdCvtuDwHo",178,0.994413,31,179,1,178,1,1,0,1,1,97,96,82,82,50
"4518",17,"[31]zJHglqIhHcidKpcJvcGHqFdCvtuDwHo",179,0.994444,31,180,1,179,1,1,0,1,1,98,97,82,82,50
"4519",18,"[31]zJHglqIhHcidKpcJvcGHqFdCvtuDwHo",175,0.994318,31,176,1,175,1,1,0,1,1,85,84,91,91,50
"4520",19,"[31]zJHglqIhHcidKpcJvcGHqFdCvtuDwHo",174,0.994286,31,175,1,174,1,1,0,1,1,80,79,95,95,50
"4521",20,"[31]zJHglqIhHcidKpcJvcGHqFdCvtuDwHo",179,0.994444,31,180,1,179,1,1,0,1,1,99,98,81,81,50
"4522",21,"[31]zJHglqIhHcidKpcJvcGHqFdCvtuDwHo",178,0.994413,31,179,1,178,1,1,0,1,1,96,95,83,83,50
"4523",22,"[31]zJHglqIhHcidKpcJvcGHqFdCvtuDwHo",176,0.99435,31,177,1,176,1,1,0,1,1,90,89,87,87,50
"4524",23,"[31]zJHglqIhHcidKpcJvcGHqFdCvtuDwHo",174,0.994286,31,175,1,174,1,1,0,1,1,82,81,93,93,50
"4525",24,"[31]zJHglqIhHcidKpcJvcGHqFdCvtuDwHo",177,0.994382,31,178,1,177,1,1,0,1,1,90,89,88,88,50
"4526",25,"[31]zJHglqIhHcidKpcJvcGHqFdCvtuDwHo",177,0.994382,31,178,1,177,1,1,0,1,1,93,92,85,85,50
"4527",26,"[31]zJHglqIhHcidKpcJvcGHqFdCvtuDwHo",172,0.99422,31,173,1,172,1,1,0,1,1,75,74,98,98,50
"4528",27,"[31]zJHglqIhHcidKpcJvcGHqFdCvtuDwHo",176,0.99435,31,177,1,176,1,1,0,1,1,90,89,87,87,50
"4529",28,"[31]zJHglqIhHcidKpcJvcGHqFdCvtuDwHo",176,0.99435,31,177,1,176,1,1,0,1,1,87,86,90,90,50
"4530",29,"[31]zJHglqIhHcidKpcJvcGHqFdCvtuDwHo",178,0.994413,31,179,1,178,1,1,0,1,1,96,95,83,83,50
"4531",30,"[31]zJHglqIhHcidKpcJvcGHqFdCvtuDwHo",173,0.994253,31,174,1,173,1,1,0,1,1,77,76,97,97,50
"4532",31,"[31]zJHglqIhHcidKpcJvcGHqFdCvtuDwHo",175,0.994318,31,176,1,175,1,1,0,1,1,83,82,93,93,50
"4533",32,"[31]zJHglqIhHcidKpcJvcGHqFdCvtuDwHo",178,0.994413,31,179,1,178,1,1,0,1,1,94,93,85,85,50
"4534",33,"[31]zJHglqIhHcidKpcJvcGHqFdCvtuDwHo",173,0.994253,31,174,1,173,1,1,0,1,1,81,80,93,93,50
"4535",34,"[31]zJHglqIhHcidKpcJvcGHqFdCvtuDwHo",176,0.99435,31,177,1,176,1,1,0,1,1,89,88,88,88,50
"4536",35,"[31]zJHglqIhHcidKpcJvcGHqFdCvtuDwHo",175,0.994318,31,176,1,175,1,1,0,1,1,87,86,89,89,50
"4537",36,"[31]zJHglqIhHcidKpcJvcGHqFdCvtuDwHo",174,0.994286,31,175,1,174,1,1,0,1,1,82,81,93,93,50
"4538",37,"[31]zJHglqIhHcidKpcJvcGHqFdCvtuDwHo",180,0.994475,31,181,1,180,1,1,0,1,1,104,103,77,77,50
"4539",38,"[31]zJHglqIhHcidKpcJvcGHqFdCvtuDwHo",174,0.994286,31,175,1,174,1,1,0,1,1,82,81,93,93,50
"4540",39,"[31]zJHglqIhHcidKpcJvcGHqFdCvtuDwHo",176,0.99435,31,177,1,176,1,1,0,1,1,90,89,87,87,50
"4541",40,"[31]zJHglqIhHcidKpcJvcGHqFdCvtuDwHo",175,0.994318,31,176,1,175,1,1,0,1,1,86,85,90,90,50
"4542",41,"[31]zJHglqIhHcidKpcJvcGHqFdCvtuDwHo",179,0.994444,31,180,1,179,1,1,0,1,1,99,98,81,81,50
"4543",42,"[31]zJHglqIhHcidKpcJvcGHqFdCvtuDwHo",177,0.994382,31,178,1,177,1,1,0,1,1,91,90,87,87,50
"4544",43,"[31]zJHglqIhHcidKpcJvcGHqFdCvtuDwHo",177,0.994382,31,178,1,177,1,1,0,1,1,92,91,86,86,50
"4545",44,"[31]zJHglqIhHcidKpcJvcGHqFdCvtuDwHo",180,0.994475,31,181,1,180,1,1,0,1,1,101,100,80,80,50
"4546",45,"[31]zJHglqIhHcidKpcJvcGHqFdCvtuDwHo",182,0.994536,31,183,1,182,1,1,0,1,1,106,105,77,77,50
"4547",46,"[31]zJHglqIhHcidKpcJvcGHqFdCvtuDwHo",177,0.994382,31,178,1,177,1,1,0,1,1,93,92,85,85,50
"4548",47,"[31]zJHglqIhHcidKpcJvcGHqFdCvtuDwHo",172,0.99422,31,173,1,172,1,1,0,1,1,77,76,96,96,50
"4549",48,"[31]zJHglqIhHcidKpcJvcGHqFdCvtuDwHo",176,0.99435,31,177,1,176,1,1,0,1,1,91,90,86,86,50
"4550",49,"[31]zJHglqIhHcidKpcJvcGHqFdCvtuDwHo",178,0.994413,31,179,1,178,1,1,0,1,1,95,94,84,84,50
"4551",50,"[31]zJHglqIhHcidKpcJvcGHqFdCvtuDwHo",176,0.99435,31,177,1,176,1,1,0,1,1,91,90,86,86,50
"4552",51,"[31]zJHglqIhHcidKpcJvcGHqFdCvtuDwHo",178,0.994413,31,179,1,178,1,1,0,1,1,97,96,82,82,50
"4553",52,"[31]zJHglqIhHcidKpcJvcGHqFdCvtuDwHo",174,0.994286,31,175,1,174,1,1,0,1,1,82,81,93,93,50
"4554",53,"[31]zJHglqIhHcidKpcJvcGHqFdCvtuDwHo",174,0.994286,31,175,1,174,1,1,0,1,1,83,82,92,92,50
"4555",54,"[31]zJHglqIhHcidKpcJvcGHqFdCvtuDwHo",171,0.994186,31,172,1,171,1,1,0,1,1,72,71,100,100,50
"4556",55,"[31]zJHglqIhHcidKpcJvcGHqFdCvtuDwHo",175,0.994318,31,176,1,175,1,1,0,1,1,84,83,92,92,50
"4557",56,"[31]zJHglqIhHcidKpcJvcGHqFdCvtuDwHo",178,0.994413,31,179,1,178,1,1,0,1,1,96,95,83,83,50
"4558",57,"[31]zJHglqIhHcidKpcJvcGHqFdCvtuDwHo",179,0.994444,31,180,1,179,1,1,0,1,1,101,100,79,79,50
"4559",58,"[31]zJHglqIhHcidKpcJvcGHqFdCvtuDwHo",173,0.994253,31,174,1,173,1,1,0,1,1,80,79,94,94,50
"4560",59,"[31]zJHglqIhHcidKpcJvcGHqFdCvtuDwHo",177,0.994382,31,178,1,177,1,1,0,1,1,89,88,89,89,50
"4561",60,"[31]zJHglqIhHcidKpcJvcGHqFdCvtuDwHo",178,0.994413,31,179,1,178,1,1,0,1,1,95,94,84,84,50
"4562",61,"[31]zJHglqIhHcidKpcJvcGHqFdCvtuDwHo",173,0.994253,31,174,1,173,1,1,0,1,1,81,80,93,93,50
"4563",62,"[31]zJHglqIhHcidKpcJvcGHqFdCvtuDwHo",175,0.994318,31,176,1,175,1,1,0,1,1,86,85,90,90,50
"4564",63,"[31]zJHglqIhHcidKpcJvcGHqFdCvtuDwHo",178,0.994413,31,179,1,178,1,1,0,1,1,95,94,84,84,50
"4565",64,"[31]zJHglqIhHcidKpcJvcGHqFdCvtuDwHo",177,0.994382,31,178,1,177,1,1,0,1,1,93,92,85,85,50
"4566",65,"[31]zJHglqIhHcidKpcJvcGHqFdCvtuDwHo",175,0.994318,31,176,1,175,1,1,0,1,1,85,84,91,91,50
"4567",66,"[31]zJHglqIhHcidKpcJvcGHqFdCvtuDwHo",177,0.994382,31,178,1,177,1,1,0,1,1,94,93,84,84,50
"4568",67,"[31]zJHglqIhHcidKpcJvcGHqFdCvtuDwHo",173,0.994253,31,174,1,173,1,1,0,1,1,78,77,96,96,50
"4569",68,"[31]zJHglqIhHcidKpcJvcGHqFdCvtuDwHo",175,0.994318,31,176,1,175,1,1,0,1,1,85,84,91,91,50
"4570",69,"[31]zJHglqIhHcidKpcJvcGHqFdCvtuDwHo",176,0.99435,31,177,1,176,1,1,0,1,1,89,88,88,88,50
"4571",70,"[31]zJHglqIhHcidKpcJvcGHqFdCvtuDwHo",172,0.99422,31,173,1,172,1,1,0,1,1,77,76,96,96,50
"4572",71,"[31]zJHglqIhHcidKpcJvcGHqFdCvtuDwHo",172,0.99422,31,173,1,172,1,1,0,1,1,75,74,98,98,50
"4573",72,"[31]zJHglqIhHcidKpcJvcGHqFdCvtuDwHo",175,0.994318,31,176,1,175,1,1,0,1,1,87,86,89,89,50
"4574",73,"[31]zJHglqIhHcidKpcJvcGHqFdCvtuDwHo",175,0.994318,31,176,1,175,1,1,0,1,1,85,84,91,91,50
"4575",74,"[31]zJHglqIhHcidKpcJvcGHqFdCvtuDwHo",176,0.99435,31,177,1,176,1,1,0,1,1,90,89,87,87,50
"4576",75,"[31]zJHglqIhHcidKpcJvcGHqFdCvtuDwHo",179,0.994444,31,180,1,179,1,1,0,1,1,97,96,83,83,50
"4577",76,"[31]zJHglqIhHcidKpcJvcGHqFdCvtuDwHo",175,0.994318,31,176,1,175,1,1,0,1,1,86,85,90,90,50
"4578",77,"[31]zJHglqIhHcidKpcJvcGHqFdCvtuDwHo",172,0.99422,31,173,1,172,1,1,0,1,1,77,76,96,96,50
"4579",78,"[31]zJHglqIhHcidKpcJvcGHqFdCvtuDwHo",180,0.994475,31,181,1,180,1,1,0,1,1,100,99,81,81,50
"4580",79,"[31]zJHglqIhHcidKpcJvcGHqFdCvtuDwHo",179,0.994444,31,180,1,179,1,1,0,1,1,99,98,81,81,50
"4581",80,"[31]zJHglqIhHcidKpcJvcGHqFdCvtuDwHo",174,0.994286,31,175,1,174,1,1,0,1,1,82,81,93,93,50
"4582",81,"[31]zJHglqIhHcidKpcJvcGHqFdCvtuDwHo",176,0.99435,31,177,1,176,1,1,0,1,1,91,90,86,86,50
"4583",82,"[31]zJHglqIhHcidKpcJvcGHqFdCvtuDwHo",181,0.994505,31,182,1,181,1,1,0,1,1,107,106,75,75,50
"4584",83,"[31]zJHglqIhHcidKpcJvcGHqFdCvtuDwHo",177,0.994382,31,178,1,177,1,1,0,1,1,93,92,85,85,50
"4585",84,"[31]zJHglqIhHcidKpcJvcGHqFdCvtuDwHo",176,0.99435,31,177,1,176,1,1,0,1,1,88,87,89,89,50
"4586",85,"[31]zJHglqIhHcidKpcJvcGHqFdCvtuDwHo",175,0.994318,31,176,1,175,1,1,0,1,1,85,84,91,91,50
"4587",86,"[31]zJHglqIhHcidKpcJvcGHqFdCvtuDwHo",178,0.994413,31,179,1,178,1,1,0,1,1,96,95,83,83,50
"4588",87,"[31]zJHglqIhHcidKpcJvcGHqFdCvtuDwHo",179,0.994444,31,180,1,179,1,1,0,1,1,96,95,84,84,50
"4589",88,"[31]zJHglqIhHcidKpcJvcGHqFdCvtuDwHo",176,0.99435,31,177,1,176,1,1,0,1,1,89,88,88,88,50
"4590",89,"[31]zJHglqIhHcidKpcJvcGHqFdCvtuDwHo",174,0.994286,31,175,1,174,1,1,0,1,1,80,79,95,95,50
"4591",90,"[31]zJHglqIhHcidKpcJvcGHqFdCvtuDwHo",173,0.994253,31,174,1,173,1,1,0,1,1,78,77,96,96,50
"4592",91,"[31]zJHglqIhHcidKpcJvcGHqFdCvtuDwHo",178,0.994413,31,179,1,178,1,1,0,1,1,95,94,84,84,50
"4593",92,"[31]zJHglqIhHcidKpcJvcGHqFdCvtuDwHo",176,0.99435,31,177,1,176,1,1,0,1,1,88,87,89,89,50
"4594",93,"[31]zJHglqIhHcidKpcJvcGHqFdCvtuDwHo",180,0.994475,31,181,1,180,1,1,0,1,1,102,101,79,79,50
"4595",94,"[31]zJHglqIhHcidKpcJvcGHqFdCvtuDwHo",176,0.99435,31,177,1,176,1,1,0,1,1,88,87,89,89,50
"4596",95,"[31]zJHglqIhHcidKpcJvcGHqFdCvtuDwHo",175,0.994318,31,176,1,175,1,1,0,1,1,86,85,90,90,50
"4597",96,"[31]zJHglqIhHcidKpcJvcGHqFdCvtuDwHo",176,0.99435,31,177,1,176,1,1,0,1,1,91,90,86,86,50
"4598",97,"[31]zJHglqIhHcidKpcJvcGHqFdCvtuDwHo",175,0.994318,31,176,1,175,1,1,0,1,1,87,86,89,89,50
"4599",98,"[31]zJHglqIhHcidKpcJvcGHqFdCvtuDwHo",176,0.99435,31,177,1,176,1,1,0,1,1,89,88,88,88,50
"4600",99,"[31]zJHglqIhHcidKpcJvcGHqFdCvtuDwHo",178,0.994413,31,179,1,178,1,1,0,1,1,96,95,83,83,50
"4601",0,"[30]fJHglqIzHcKpcJvcGHqxcCAIaedDjA",165,0.993976,30,166,1,165,1,1,0,1,1,80,79,86,86,51
"4602",1,"[30]fJHglqIzHcKpcJvcGHqxcCAIaedDjA",169,0.994118,30,170,1,169,1,1,0,1,1,90,89,80,80,51
"4603",2,"[30]fJHglqIzHcKpcJvcGHqxcCAIaedDjA",165,0.993976,30,166,1,165,1,1,0,1,1,80,79,86,86,51
"4604",3,"[30]fJHglqIzHcKpcJvcGHqxcCAIaedDjA",165,0.993976,30,166,1,165,1,1,0,1,1,80,79,86,86,51
"4605",4,"[30]fJHglqIzHcKpcJvcGHqxcCAIaedDjA",170,0.994152,30,171,1,170,1,1,0,1,1,90,89,81,81,51
"4606",5,"[30]fJHglqIzHcKpcJvcGHqxcCAIaedDjA",165,0.993976,30,166,1,165,1,1,0,1,1,80,79,86,86,51
"4607",6,"[30]fJHglqIzHcKpcJvcGHqxcCAIaedDjA",164,0.993939,30,165,1,164,1,1,0,1,1,76,75,89,89,51
"4608",7,"[30]fJHglqIzHcKpcJvcGHqxcCAIaedDjA",166,0.994012,30,167,1,166,1,1,0,1,1,83,82,84,84,51
"4609",8,"[30]fJHglqIzHcKpcJvcGHqxcCAIaedDjA",165,0.993976,30,166,1,165,1,1,0,1,1,78,77,88,88,51
"4610",9,"[30]fJHglqIzHcKpcJvcGHqxcCAIaedDjA",168,0.994083,30,169,1,168,1,1,0,1,1,88,87,81,81,51
"4611",10,"[30]fJHglqIzHcKpcJvcGHqxcCAIaedDjA",166,0.994012,30,167,1,166,1,1,0,1,1,81,80,86,86,51
"4612",11,"[30]fJHglqIzHcKpcJvcGHqxcCAIaedDjA",167,0.994048,30,168,1,167,1,1,0,1,1,82,81,86,86,51
"4613",12,"[30]fJHglqIzHcKpcJvcGHqxcCAIaedDjA",163,0.993902,30,164,1,163,1,1,0,1,1,75,74,89,89,51
"4614",13,"[30]fJHglqIzHcKpcJvcGHqxcCAIaedDjA",166,0.994012,30,167,1,166,1,1,0,1,1,82,81,85,85,51
"4615",14,"[30]fJHglqIzHcKpcJvcGHqxcCAIaedDjA",164,0.993939,30,165,1,164,1,1,0,1,1,77,76,88,88,51
"4616",15,"[30]fJHglqIzHcKpcJvcGHqxcCAIaedDjA",168,0.994083,30,169,1,168,1,1,0,1,1,88,87,81,81,51
"4617",16,"[30]fJHglqIzHcKpcJvcGHqxcCAIaedDjA",170,0.994152,30,171,1,170,1,1,0,1,1,93,92,78,78,51
"4618",17,"[30]fJHglqIzHcKpcJvcGHqxcCAIaedDjA",166,0.994012,30,167,1,166,1,1,0,1,1,82,81,85,85,51
"4619",18,"[30]fJHglqIzHcKpcJvcGHqxcCAIaedDjA",163,0.993902,30,164,1,163,1,1,0,1,1,75,74,89,89,51
"4620",19,"[30]fJHglqIzHcKpcJvcGHqxcCAIaedDjA",164,0.993939,30,165,1,164,1,1,0,1,1,76,75,89,89,51
"4621",20,"[30]fJHglqIzHcKpcJvcGHqxcCAIaedDjA",163,0.993902,30,164,1,163,1,1,0,1,1,73,72,91,91,51
"4622",21,"[30]fJHglqIzHcKpcJvcGHqxcCAIaedDjA",165,0.993976,30,166,1,165,1,1,0,1,1,79,78,87,87,51
"4623",22,"[30]fJHglqIzHcKpcJvcGHqxcCAIaedDjA",160,0.993789,30,161,1,160,1,1,0,1,1,66,65,95,95,51
"4624",23,"[30]fJHglqIzHcKpcJvcGHqxcCAIaedDjA",170,0.994152,30,171,1,170,1,1,0,1,1,93,92,78,78,51
"4625",24,"[30]fJHglqIzHcKpcJvcGHqxcCAIaedDjA",166,0.994012,30,167,1,166,1,1,0,1,1,82,81,85,85,51
"4626",25,"[30]fJHglqIzHcKpcJvcGHqxcCAIaedDjA",172,0.99422,30,173,1,172,1,1,0,1,1,97,96,76,76,51
"4627",26,"[30]fJHglqIzHcKpcJvcGHqxcCAIaedDjA",165,0.993976,30,166,1,165,1,1,0,1,1,76,75,90,90,51
"4628",27,"[30]fJHglqIzHcKpcJvcGHqxcCAIaedDjA",166,0.994012,30,167,1,166,1,1,0,1,1,83,82,84,84,51
"4629",28,"[30]fJHglqIzHcKpcJvcGHqxcCAIaedDjA",171,0.994186,30,172,1,171,1,1,0,1,1,95,94,77,77,51
"4630",29,"[30]fJHglqIzHcKpcJvcGHqxcCAIaedDjA",172,0.99422,30,173,1,172,1,1,0,1,1,97,96,76,76,51
"4631",30,"[30]fJHglqIzHcKpcJvcGHqxcCAIaedDjA",165,0.993976,30,166,1,165,1,1,0,1,1,79,78,87,87,51
"4632",31,"[30]fJHglqIzHcKpcJvcGHqxcCAIaedDjA",169,0.994118,30,170,1,169,1,1,0,1,1,91,90,79,79,51
"4633",32,"[30]fJHglqIzHcKpcJvcGHqxcCAIaedDjA",164,0.993939,30,165,1,164,1,1,0,1,1,77,76,88,88,51
"4634",33,"[30]fJHglqIzHcKpcJvcGHqxcCAIaedDjA",163,0.993902,30,164,1,163,1,1,0,1,1,74,73,90,90,51
"4635",34,"[30]fJHglqIzHcKpcJvcGHqxcCAIaedDjA",169,0.994118,30,170,1,169,1,1,0,1,1,89,88,81,81,51
"4636",35,"[30]fJHglqIzHcKpcJvcGHqxcCAIaedDjA",163,0.993902,30,164,1,163,1,1,0,1,1,73,72,91,91,51
"4637",36,"[30]fJHglqIzHcKpcJvcGHqxcCAIaedDjA",169,0.994118,30,170,1,169,1,1,0,1,1,91,90,79,79,51
"4638",37,"[30]fJHglqIzHcKpcJvcGHqxcCAIaedDjA",170,0.994152,30,171,1,170,1,1,0,1,1,92,91,79,79,51
"4639",38,"[30]fJHglqIzHcKpcJvcGHqxcCAIaedDjA",165,0.993976,30,166,1,165,1,1,0,1,1,79,78,87,87,51
"4640",39,"[30]fJHglqIzHcKpcJvcGHqxcCAIaedDjA",169,0.994118,30,170,1,169,1,1,0,1,1,90,89,80,80,51
"4641",40,"[30]fJHglqIzHcKpcJvcGHqxcCAIaedDjA",164,0.993939,30,165,1,164,1,1,0,1,1,77,76,88,88,51
"4642",41,"[30]fJHglqIzHcKpcJvcGHqxcCAIaedDjA",170,0.994152,30,171,1,170,1,1,0,1,1,93,92,78,78,51
"4643",42,"[30]fJHglqIzHcKpcJvcGHqxcCAIaedDjA",162,0.993865,30,163,1,162,1,1,0,1,1,72,71,91,91,51
"4644",43,"[30]fJHglqIzHcKpcJvcGHqxcCAIaedDjA",171,0.994186,30,172,1,171,1,1,0,1,1,97,96,75,75,51
"4645",44,"[30]fJHglqIzHcKpcJvcGHqxcCAIaedDjA",173,0.994253,30,174,1,173,1,1,0,1,1,101,100,73,73,51
"4646",45,"[30]fJHglqIzHcKpcJvcGHqxcCAIaedDjA",163,0.993902,30,164,1,163,1,1,0,1,1,73,72,91,91,51
"4647",46,"[30]fJHglqIzHcKpcJvcGHqxcCAIaedDjA",170,0.994152,30,171,1,170,1,1,0,1,1,92,91,79,79,51
"4648",47,"[30]fJHglqIzHcKpcJvcGHqxcCAIaedDjA",171,0.994186,30,172,1,171,1,1,0,1,1,96,95,76,76,51
"4649",48,"[30]fJHglqIzHcKpcJvcGHqxcCAIaedDjA",163,0.993902,30,164,1,163,1,1,0,1,1,73,72,91,91,51
"4650",49,"[30]fJHglqIzHcKpcJvcGHqxcCAIaedDjA",161,0.993827,30,162,1,161,1,1,0,1,1,68,67,94,94,51
"4651",50,"[30]fJHglqIzHcKpcJvcGHqxcCAIaedDjA",166,0.994012,30,167,1,166,1,1,0,1,1,82,81,85,85,51
"4652",51,"[30]fJHglqIzHcKpcJvcGHqxcCAIaedDjA",166,0.994012,30,167,1,166,1,1,0,1,1,82,81,85,85,51
"4653",52,"[30]fJHglqIzHcKpcJvcGHqxcCAIaedDjA",167,0.994048,30,168,1,167,1,1,0,1,1,84,83,84,84,51
"4654",53,"[30]fJHglqIzHcKpcJvcGHqxcCAIaedDjA",168,0.994083,30,169,1,168,1,1,0,1,1,88,87,81,81,51
"4655",54,"[30]fJHglqIzHcKpcJvcGHqxcCAIaedDjA",168,0.994083,30,169,1,168,1,1,0,1,1,88,87,81,81,51
"4656",55,"[30]fJHglqIzHcKpcJvcGHqxcCAIaedDjA",167,0.994048,30,168,1,167,1,1,0,1,1,86,85,82,82,51
"4657",56,"[30]fJHglqIzHcKpcJvcGHqxcCAIaedDjA",165,0.993976,30,166,1,165,1,1,0,1,1,77,76,89,89,51
"4658",57,"[30]fJHglqIzHcKpcJvcGHqxcCAIaedDjA",166,0.994012,30,167,1,166,1,1,0,1,1,81,80,86,86,51
"4659",58,"[30]fJHglqIzHcKpcJvcGHqxcCAIaedDjA",165,0.993976,30,166,1,165,1,1,0,1,1,78,77,88,88,51
"4660",59,"[30]fJHglqIzHcKpcJvcGHqxcCAIaedDjA",164,0.993939,30,165,1,164,1,1,0,1,1,76,75,89,89,51
"4661",60,"[30]fJHglqIzHcKpcJvcGHqxcCAIaedDjA",166,0.994012,30,167,1,166,1,1,0,1,1,82,81,85,85,51
"4662",61,"[30]fJHglqIzHcKpcJvcGHqxcCAIaedDjA",165,0.993976,30,166,1,165,1,1,0,1,1,79,78,87,87,51
"4663",62,"[30]fJHglqIzHcKpcJvcGHqxcCAIaedDjA",173,0.994253,30,174,1,173,1,1,0,1,1,100,99,74,74,51
"4664",63,"[30]fJHglqIzHcKpcJvcGHqxcCAIaedDjA",163,0.993902,30,164,1,163,1,1,0,1,1,74,73,90,90,51
"4665",64,"[30]fJHglqIzHcKpcJvcGHqxcCAIaedDjA",164,0.993939,30,165,1,164,1,1,0,1,1,77,76,88,88,51
"4666",65,"[30]fJHglqIzHcKpcJvcGHqxcCAIaedDjA",165,0.993976,30,166,1,165,1,1,0,1,1,80,79,86,86,51
"4667",66,"[30]fJHglqIzHcKpcJvcGHqxcCAIaedDjA",166,0.994012,30,167,1,166,1,1,0,1,1,80,79,87,87,51
"4668",67,"[30]fJHglqIzHcKpcJvcGHqxcCAIaedDjA",166,0.994012,30,167,1,166,1,1,0,1,1,81,80,86,86,51
"4669",68,"[30]fJHglqIzHcKpcJvcGHqxcCAIaedDjA",168,0.994083,30,169,1,168,1,1,0,1,1,88,87,81,81,51
"4670",69,"[30]fJHglqIzHcKpcJvcGHqxcCAIaedDjA",165,0.993976,30,166,1,165,1,1,0,1,1,79,78,87,87,51
"4671",70,"[30]fJHglqIzHcKpcJvcGHqxcCAIaedDjA",167,0.994048,30,168,1,167,1,1,0,1,1,84,83,84,84,51
"4672",71,"[30]fJHglqIzHcKpcJvcGHqxcCAIaedDjA",162,0.993865,30,163,1,162,1,1,0,1,1,71,70,92,92,51
"4673",72,"[30]fJHglqIzHcKpcJvcGHqxcCAIaedDjA",167,0.994048,30,168,1,167,1,1,0,1,1,84,83,84,84,51
"4674",73,"[30]fJHglqIzHcKpcJvcGHqxcCAIaedDjA",169,0.994118,30,170,1,169,1,1,0,1,1,89,88,81,81,51
"4675",74,"[30]fJHglqIzHcKpcJvcGHqxcCAIaedDjA",168,0.994083,30,169,1,168,1,1,0,1,1,87,86,82,82,51
"4676",75,"[30]fJHglqIzHcKpcJvcGHqxcCAIaedDjA",169,0.994118,30,170,1,169,1,1,0,1,1,91,90,79,79,51
"4677",76,"[30]fJHglqIzHcKpcJvcGHqxcCAIaedDjA",170,0.994152,30,171,1,170,1,1,0,1,1,91,90,80,80,51
"4678",77,"[30]fJHglqIzHcKpcJvcGHqxcCAIaedDjA",168,0.994083,30,169,1,168,1,1,0,1,1,86,85,83,83,51
"4679",78,"[30]fJHglqIzHcKpcJvcGHqxcCAIaedDjA",168,0.994083,30,169,1,168,1,1,0,1,1,87,86,82,82,51
"4680",79,"[30]fJHglqIzHcKpcJvcGHqxcCAIaedDjA",166,0.994012,30,167,1,166,1,1,0,1,1,82,81,85,85,51
"4681",80,"[30]fJHglqIzHcKpcJvcGHqxcCAIaedDjA",170,0.994152,30,171,1,170,1,1,0,1,1,92,91,79,79,51
"4682",81,"[30]fJHglqIzHcKpcJvcGHqxcCAIaedDjA",164,0.993939,30,165,1,164,1,1,0,1,1,76,75,89,89,51
"4683",82,"[30]fJHglqIzHcKpcJvcGHqxcCAIaedDjA",169,0.994118,30,170,1,169,1,1,0,1,1,87,86,83,83,51
"4684",83,"[30]fJHglqIzHcKpcJvcGHqxcCAIaedDjA",171,0.994186,30,172,1,171,1,1,0,1,1,95,94,77,77,51
"4685",84,"[30]fJHglqIzHcKpcJvcGHqxcCAIaedDjA",167,0.994048,30,168,1,167,1,1,0,1,1,84,83,84,84,51
"4686",85,"[30]fJHglqIzHcKpcJvcGHqxcCAIaedDjA",167,0.994048,30,168,1,167,1,1,0,1,1,84,83,84,84,51
"4687",86,"[30]fJHglqIzHcKpcJvcGHqxcCAIaedDjA",167,0.994048,30,168,1,167,1,1,0,1,1,86,85,82,82,51
"4688",87,"[30]fJHglqIzHcKpcJvcGHqxcCAIaedDjA",171,0.994186,30,172,1,171,1,1,0,1,1,95,94,77,77,51
"4689",88,"[30]fJHglqIzHcKpcJvcGHqxcCAIaedDjA",170,0.994152,30,171,1,170,1,1,0,1,1,91,90,80,80,51
"4690",89,"[30]fJHglqIzHcKpcJvcGHqxcCAIaedDjA",164,0.993939,30,165,1,164,1,1,0,1,1,77,76,88,88,51
"4691",90,"[30]fJHglqIzHcKpcJvcGHqxcCAIaedDjA",162,0.993865,30,163,1,162,1,1,0,1,1,72,71,91,91,51
"4692",91,"[30]fJHglqIzHcKpcJvcGHqxcCAIaedDjA",166,0.994012,30,167,1,166,1,1,0,1,1,81,80,86,86,51
"4693",92,"[30]fJHglqIzHcKpcJvcGHqxcCAIaedDjA",169,0.994118,30,170,1,169,1,1,0,1,1,90,89,80,80,51
"4694",93,"[30]fJHglqIzHcKpcJvcGHqxcCAIaedDjA",169,0.994118,30,170,1,169,1,1,0,1,1,88,87,82,82,51
"4695",94,"[30]fJHglqIzHcKpcJvcGHqxcCAIaedDjA",163,0.993902,30,164,1,163,1,1,0,1,1,75,74,89,89,51
"4696",95,"[30]fJHglqIzHcKpcJvcGHqxcCAIaedDjA",164,0.993939,30,165,1,164,1,1,0,1,1,75,74,90,90,51
"4697",96,"[30]fJHglqIzHcKpcJvcGHqxcCAIaedDjA",169,0.994118,30,170,1,169,1,1,0,1,1,89,88,81,81,51
"4698",97,"[30]fJHglqIzHcKpcJvcGHqxcCAIaedDjA",166,0.994012,30,167,1,166,1,1,0,1,1,78,77,89,89,51
"4699",98,"[30]fJHglqIzHcKpcJvcGHqxcCAIaedDjA",161,0.993827,30,162,1,161,1,1,0,1,1,68,67,94,94,51
"4700",99,"[30]fJHglqIzHcKpcJvcGHqxcCAIaedDjA",170,0.994152,30,171,1,170,1,1,0,1,1,92,91,79,79,51
"4701",0,"[31]mJHglqIHcdKocJvcGHqvdCHukKtFxqg",166,0.994012,31,167,1,166,1,1,0,1,1,79,78,88,88,52
"4702",1,"[31]mJHglqIHcdKocJvcGHqvdCHukKtFxqg",165,0.993976,31,166,1,165,1,1,0,1,1,80,79,86,86,52
"4703",2,"[31]mJHglqIHcdKocJvcGHqvdCHukKtFxqg",169,0.994118,31,170,1,169,1,1,0,1,1,89,88,81,81,52
"4704",3,"[31]mJHglqIHcdKocJvcGHqvdCHukKtFxqg",162,0.993865,31,163,1,162,1,1,0,1,1,71,70,92,92,52
"4705",4,"[31]mJHglqIHcdKocJvcGHqvdCHukKtFxqg",166,0.994012,31,167,1,166,1,1,0,1,1,81,80,86,86,52
"4706",5,"[31]mJHglqIHcdKocJvcGHqvdCHukKtFxqg",165,0.993976,31,166,1,165,1,1,0,1,1,78,77,88,88,52
"4707",6,"[31]mJHglqIHcdKocJvcGHqvdCHukKtFxqg",166,0.994012,31,167,1,166,1,1,0,1,1,83,82,84,84,52
"4708",7,"[31]mJHglqIHcdKocJvcGHqvdCHukKtFxqg",167,0.994048,31,168,1,167,1,1,0,1,1,83,82,85,85,52
"4709",8,"[31]mJHglqIHcdKocJvcGHqvdCHukKtFxqg",163,0.993902,31,164,1,163,1,1,0,1,1,73,72,91,91,52
"4710",9,"[31]mJHglqIHcdKocJvcGHqvdCHukKtFxqg",166,0.994012,31,167,1,166,1,1,0,1,1,81,80,86,86,52
"4711",10,"[31]mJHglqIHcdKocJvcGHqvdCHukKtFxqg",164,0.993939,31,165,1,164,1,1,0,1,1,77,76,88,88,52
"4712",11,"[31]mJHglqIHcdKocJvcGHqvdCHukKtFxqg",167,0.994048,31,168,1,167,1,1,0,1,1,85,84,83,83,52
"4713",12,"[31]mJHglqIHcdKocJvcGHqvdCHukKtFxqg",167,0.994048,31,168,1,167,1,1,0,1,1,83,82,85,85,52
"4714",13,"[31]mJHglqIHcdKocJvcGHqvdCHukKtFxqg",165,0.993976,31,166,1,165,1,1,0,1,1,80,79,86,86,52
"4715",14,"[31]mJHglqIHcdKocJvcGHqvdCHukKtFxqg",166,0.994012,31,167,1,166,1,1,0,1,1,83,82,84,84,52
"4716",15,"[31]mJHglqIHcdKocJvcGHqvdCHukKtFxqg",166,0.994012,31,167,1,166,1,1,0,1,1,83,82,84,84,52
"4717",16,"[31]mJHglqIHcdKocJvcGHqvdCHukKtFxqg",169,0.994118,31,170,1,169,1,1,0,1,1,90,89,80,80,52
"4718",17,"[31]mJHglqIHcdKocJvcGHqvdCHukKtFxqg",171,0.994186,31,172,1,171,1,1,0,1,1,96,95,76,76,52
"4719",18,"[31]mJHglqIHcdKocJvcGHqvdCHukKtFxqg",169,0.994118,31,170,1,169,1,1,0,1,1,91,90,79,79,52
"4720",19,"[31]mJHglqIHcdKocJvcGHqvdCHukKtFxqg",170,0.994152,31,171,1,170,1,1,0,1,1,94,93,77,77,52
"4721",20,"[31]mJHglqIHcdKocJvcGHqvdCHukKtFxqg",174,0.994286,31,175,1,174,1,1,0,1,1,105,104,70,70,52
"4722",21,"[31]mJHglqIHcdKocJvcGHqvdCHukKtFxqg",165,0.993976,31,166,1,165,1,1,0,1,1,79,78,87,87,52
"4723",22,"[31]mJHglqIHcdKocJvcGHqvdCHukKtFxqg",168,0.994083,31,169,1,168,1,1,0,1,1,87,86,82,82,52
"4724",23,"[31]mJHglqIHcdKocJvcGHqvdCHukKtFxqg",172,0.99422,31,173,1,172,1,1,0,1,1,99,98,74,74,52
"4725",24,"[31]mJHglqIHcdKocJvcGHqvdCHukKtFxqg",165,0.993976,31,166,1,165,1,1,0,1,1,77,76,89,89,52
"4726",25,"[31]mJHglqIHcdKocJvcGHqvdCHukKtFxqg",167,0.994048,31,168,1,167,1,1,0,1,1,86,85,82,82,52
"4727",26,"[31]mJHglqIHcdKocJvcGHqvdCHukKtFxqg",165,0.993976,31,166,1,165,1,1,0,1,1,80,79,86,86,52
"4728",27,"[31]mJHglqIHcdKocJvcGHqvdCHukKtFxqg",167,0.994048,31,168,1,167,1,1,0,1,1,85,84,83,83,52
"4729",28,"[31]mJHglqIHcdKocJvcGHqvdCHukKtFxqg",164,0.993939,31,165,1,164,1,1,0,1,1,77,76,88,88,52
"4730",29,"[31]mJHglqIHcdKocJvcGHqvdCHukKtFxqg",169,0.994118,31,170,1,169,1,1,0,1,1,89,88,81,81,52
"4731",30,"[31]mJHglqIHcdKocJvcGHqvdCHukKtFxqg",164,0.993939,31,165,1,164,1,1,0,1,1,76,75,89,89,52
"4732",31,"[31]mJHglqIHcdKocJvcGHqvdCHukKtFxqg",169,0.994118,31,170,1,169,1,1,0,1,1,89,88,81,81,52
"4733",32,"[31]mJHglqIHcdKocJvcGHqvdCHukKtFxqg",169,0.994118,31,170,1,169,1,1,0,1,1,90,89,80,80,52
"4734",33,"[31]mJHglqIHcdKocJvcGHqvdCHukKtFxqg",167,0.994048,31,168,1,167,1,1,0,1,1,84,83,84,84,52
"4735",34,"[31]mJHglqIHcdKocJvcGHqvdCHukKtFxqg",169,0.994118,31,170,1,169,1,1,0,1,1,89,88,81,81,52
"4736",35,"[31]mJHglqIHcdKocJvcGHqvdCHukKtFxqg",169,0.994118,31,170,1,169,1,1,0,1,1,91,90,79,79,52
"4737",36,"[31]mJHglqIHcdKocJvcGHqvdCHukKtFxqg",166,0.994012,31,167,1,166,1,1,0,1,1,83,82,84,84,52
"4738",37,"[31]mJHglqIHcdKocJvcGHqvdCHukKtFxqg",166,0.994012,31,167,1,166,1,1,0,1,1,83,82,84,84,52
"4739",38,"[31]mJHglqIHcdKocJvcGHqvdCHukKtFxqg",164,0.993939,31,165,1,164,1,1,0,1,1,76,75,89,89,52
"4740",39,"[31]mJHglqIHcdKocJvcGHqvdCHukKtFxqg",167,0.994048,31,168,1,167,1,1,0,1,1,84,83,84,84,52
"4741",40,"[31]mJHglqIHcdKocJvcGHqvdCHukKtFxqg",166,0.994012,31,167,1,166,1,1,0,1,1,82,81,85,85,52
"4742",41,"[31]mJHglqIHcdKocJvcGHqvdCHukKtFxqg",169,0.994118,31,170,1,169,1,1,0,1,1,89,88,81,81,52
"4743",42,"[31]mJHglqIHcdKocJvcGHqvdCHukKtFxqg",164,0.993939,31,165,1,164,1,1,0,1,1,77,76,88,88,52
"4744",43,"[31]mJHglqIHcdKocJvcGHqvdCHukKtFxqg",164,0.993939,31,165,1,164,1,1,0,1,1,76,75,89,89,52
"4745",44,"[31]mJHglqIHcdKocJvcGHqvdCHukKtFxqg",166,0.994012,31,167,1,166,1,1,0,1,1,82,81,85,85,52
"4746",45,"[31]mJHglqIHcdKocJvcGHqvdCHukKtFxqg",167,0.994048,31,168,1,167,1,1,0,1,1,83,82,85,85,52
"4747",46,"[31]mJHglqIHcdKocJvcGHqvdCHukKtFxqg",171,0.994186,31,172,1,171,1,1,0,1,1,96,95,76,76,52
"4748",47,"[31]mJHglqIHcdKocJvcGHqvdCHukKtFxqg",160,0.993789,31,161,1,160,1,1,0,1,1,66,65,95,95,52
"4749",48,"[31]mJHglqIHcdKocJvcGHqvdCHukKtFxqg",163,0.993902,31,164,1,163,1,1,0,1,1,74,73,90,90,52
"4750",49,"[31]mJHglqIHcdKocJvcGHqvdCHukKtFxqg",167,0.994048,31,168,1,167,1,1,0,1,1,85,84,83,83,52
"4751",50,"[31]mJHglqIHcdKocJvcGHqvdCHukKtFxqg",163,0.993902,31,164,1,163,1,1,0,1,1,74,73,90,90,52
"4752",51,"[31]mJHglqIHcdKocJvcGHqvdCHukKtFxqg",165,0.993976,31,166,1,165,1,1,0,1,1,78,77,88,88,52
"4753",52,"[31]mJHglqIHcdKocJvcGHqvdCHukKtFxqg",168,0.994083,31,169,1,168,1,1,0,1,1,87,86,82,82,52
"4754",53,"[31]mJHglqIHcdKocJvcGHqvdCHukKtFxqg",164,0.993939,31,165,1,164,1,1,0,1,1,77,76,88,88,52
"4755",54,"[31]mJHglqIHcdKocJvcGHqvdCHukKtFxqg",167,0.994048,31,168,1,167,1,1,0,1,1,86,85,82,82,52
"4756",55,"[31]mJHglqIHcdKocJvcGHqvdCHukKtFxqg",166,0.994012,31,167,1,166,1,1,0,1,1,81,80,86,86,52
"4757",56,"[31]mJHglqIHcdKocJvcGHqvdCHukKtFxqg",166,0.994012,31,167,1,166,1,1,0,1,1,81,80,86,86,52
"4758",57,"[31]mJHglqIHcdKocJvcGHqvdCHukKtFxqg",165,0.993976,31,166,1,165,1,1,0,1,1,80,79,86,86,52
"4759",58,"[31]mJHglqIHcdKocJvcGHqvdCHukKtFxqg",167,0.994048,31,168,1,167,1,1,0,1,1,85,84,83,83,52
"4760",59,"[31]mJHglqIHcdKocJvcGHqvdCHukKtFxqg",168,0.994083,31,169,1,168,1,1,0,1,1,88,87,81,81,52
"4761",60,"[31]mJHglqIHcdKocJvcGHqvdCHukKtFxqg",161,0.993827,31,162,1,161,1,1,0,1,1,69,68,93,93,52
"4762",61,"[31]mJHglqIHcdKocJvcGHqvdCHukKtFxqg",169,0.994118,31,170,1,169,1,1,0,1,1,87,86,83,83,52
"4763",62,"[31]mJHglqIHcdKocJvcGHqvdCHukKtFxqg",167,0.994048,31,168,1,167,1,1,0,1,1,83,82,85,85,52
"4764",63,"[31]mJHglqIHcdKocJvcGHqvdCHukKtFxqg",165,0.993976,31,166,1,165,1,1,0,1,1,79,78,87,87,52
"4765",64,"[31]mJHglqIHcdKocJvcGHqvdCHukKtFxqg",168,0.994083,31,169,1,168,1,1,0,1,1,86,85,83,83,52
"4766",65,"[31]mJHglqIHcdKocJvcGHqvdCHukKtFxqg",170,0.994152,31,171,1,170,1,1,0,1,1,92,91,79,79,52
"4767",66,"[31]mJHglqIHcdKocJvcGHqvdCHukKtFxqg",168,0.994083,31,169,1,168,1,1,0,1,1,88,87,81,81,52
"4768",67,"[31]mJHglqIHcdKocJvcGHqvdCHukKtFxqg",170,0.994152,31,171,1,170,1,1,0,1,1,92,91,79,79,52
"4769",68,"[31]mJHglqIHcdKocJvcGHqvdCHukKtFxqg",167,0.994048,31,168,1,167,1,1,0,1,1,84,83,84,84,52
"4770",69,"[31]mJHglqIHcdKocJvcGHqvdCHukKtFxqg",164,0.993939,31,165,1,164,1,1,0,1,1,77,76,88,88,52
"4771",70,"[31]mJHglqIHcdKocJvcGHqvdCHukKtFxqg",167,0.994048,31,168,1,167,1,1,0,1,1,86,85,82,82,52
"4772",71,"[31]mJHglqIHcdKocJvcGHqvdCHukKtFxqg",166,0.994012,31,167,1,166,1,1,0,1,1,80,79,87,87,52
"4773",72,"[31]mJHglqIHcdKocJvcGHqvdCHukKtFxqg",170,0.994152,31,171,1,170,1,1,0,1,1,93,92,78,78,52
"4774",73,"[31]mJHglqIHcdKocJvcGHqvdCHukKtFxqg",167,0.994048,31,168,1,167,1,1,0,1,1,85,84,83,83,52
"4775",74,"[31]mJHglqIHcdKocJvcGHqvdCHukKtFxqg",169,0.994118,31,170,1,169,1,1,0,1,1,90,89,80,80,52
"4776",75,"[31]mJHglqIHcdKocJvcGHqvdCHukKtFxqg",170,0.994152,31,171,1,170,1,1,0,1,1,92,91,79,79,52
"4777",76,"[31]mJHglqIHcdKocJvcGHqvdCHukKtFxqg",170,0.994152,31,171,1,170,1,1,0,1,1,93,92,78,78,52
"4778",77,"[31]mJHglqIHcdKocJvcGHqvdCHukKtFxqg",170,0.994152,31,171,1,170,1,1,0,1,1,94,93,77,77,52
"4779",78,"[31]mJHglqIHcdKocJvcGHqvdCHukKtFxqg",165,0.993976,31,166,1,165,1,1,0,1,1,80,79,86,86,52
"4780",79,"[31]mJHglqIHcdKocJvcGHqvdCHukKtFxqg",167,0.994048,31,168,1,167,1,1,0,1,1,85,84,83,83,52
"4781",80,"[31]mJHglqIHcdKocJvcGHqvdCHukKtFxqg",167,0.994048,31,168,1,167,1,1,0,1,1,83,82,85,85,52
"4782",81,"[31]mJHglqIHcdKocJvcGHqvdCHukKtFxqg",164,0.993939,31,165,1,164,1,1,0,1,1,77,76,88,88,52
"4783",82,"[31]mJHglqIHcdKocJvcGHqvdCHukKtFxqg",165,0.993976,31,166,1,165,1,1,0,1,1,79,78,87,87,52
"4784",83,"[31]mJHglqIHcdKocJvcGHqvdCHukKtFxqg",165,0.993976,31,166,1,165,1,1,0,1,1,79,78,87,87,52
"4785",84,"[31]mJHglqIHcdKocJvcGHqvdCHukKtFxqg",166,0.994012,31,167,1,166,1,1,0,1,1,82,81,85,85,52
"4786",85,"[31]mJHglqIHcdKocJvcGHqvdCHukKtFxqg",171,0.994186,31,172,1,171,1,1,0,1,1,97,96,75,75,52
"4787",86,"[31]mJHglqIHcdKocJvcGHqvdCHukKtFxqg",168,0.994083,31,169,1,168,1,1,0,1,1,88,87,81,81,52
"4788",87,"[31]mJHglqIHcdKocJvcGHqvdCHukKtFxqg",164,0.993939,31,165,1,164,1,1,0,1,1,77,76,88,88,52
"4789",88,"[31]mJHglqIHcdKocJvcGHqvdCHukKtFxqg",170,0.994152,31,171,1,170,1,1,0,1,1,92,91,79,79,52
"4790",89,"[31]mJHglqIHcdKocJvcGHqvdCHukKtFxqg",163,0.993902,31,164,1,163,1,1,0,1,1,74,73,90,90,52
"4791",90,"[31]mJHglqIHcdKocJvcGHqvdCHukKtFxqg",170,0.994152,31,171,1,170,1,1,0,1,1,93,92,78,78,52
"4792",91,"[31]mJHglqIHcdKocJvcGHqvdCHukKtFxqg",169,0.994118,31,170,1,169,1,1,0,1,1,90,89,80,80,52
"4793",92,"[31]mJHglqIHcdKocJvcGHqvdCHukKtFxqg",164,0.993939,31,165,1,164,1,1,0,1,1,76,75,89,89,52
"4794",93,"[31]mJHglqIHcdKocJvcGHqvdCHukKtFxqg",166,0.994012,31,167,1,166,1,1,0,1,1,81,80,86,86,52
"4795",94,"[31]mJHglqIHcdKocJvcGHqvdCHukKtFxqg",168,0.994083,31,169,1,168,1,1,0,1,1,86,85,83,83,52
"4796",95,"[31]mJHglqIHcdKocJvcGHqvdCHukKtFxqg",171,0.994186,31,172,1,171,1,1,0,1,1,96,95,76,76,52
"4797",96,"[31]mJHglqIHcdKocJvcGHqvdCHukKtFxqg",166,0.994012,31,167,1,166,1,1,0,1,1,81,80,86,86,52
"4798",97,"[31]mJHglqIHcdKocJvcGHqvdCHukKtFxqg",168,0.994083,31,169,1,168,1,1,0,1,1,88,87,81,81,52
"4799",98,"[31]mJHglqIHcdKocJvcGHqvdCHukKtFxqg",169,0.994118,31,170,1,169,1,1,0,1,1,91,90,79,79,52
"4800",99,"[31]mJHglqIHcdKocJvcGHqvdCHukKtFxqg",163,0.993902,31,164,1,163,1,1,0,1,1,75,74,89,89,52
"4801",0,"[33]mJHglqIHcdKocJvcGHqxdCFooKlyJAnju",166,0.994012,33,167,1,166,1,1,0,1,1,82,81,85,85,53
"4802",1,"[33]mJHglqIHcdKocJvcGHqxdCFooKlyJAnju",168,0.994083,33,169,1,168,1,1,0,1,1,86,85,83,83,53
"4803",2,"[33]mJHglqIHcdKocJvcGHqxdCFooKlyJAnju",165,0.993976,33,166,1,165,1,1,0,1,1,79,78,87,87,53
"4804",3,"[33]mJHglqIHcdKocJvcGHqxdCFooKlyJAnju",165,0.993976,33,166,1,165,1,1,0,1,1,79,78,87,87,53
"4805",4,"[33]mJHglqIHcdKocJvcGHqxdCFooKlyJAnju",166,0.994012,33,167,1,166,1,1,0,1,1,83,82,84,84,53
"4806",5,"[33]mJHglqIHcdKocJvcGHqxdCFooKlyJAnju",166,0.994012,33,167,1,166,1,1,0,1,1,80,79,87,87,53
"4807",6,"[33]mJHglqIHcdKocJvcGHqxdCFooKlyJAnju",167,0.994048,33,168,1,167,1,1,0,1,1,84,83,84,84,53
"4808",7,"[33]mJHglqIHcdKocJvcGHqxdCFooKlyJAnju",166,0.994012,33,167,1,166,1,1,0,1,1,81,80,86,86,53
"4809",8,"[33]mJHglqIHcdKocJvcGHqxdCFooKlyJAnju",169,0.994118,33,170,1,169,1,1,0,1,1,89,88,81,81,53
"4810",9,"[33]mJHglqIHcdKocJvcGHqxdCFooKlyJAnju",163,0.993902,33,164,1,163,1,1,0,1,1,72,71,92,92,53
"4811",10,"[33]mJHglqIHcdKocJvcGHqxdCFooKlyJAnju",167,0.994048,33,168,1,167,1,1,0,1,1,85,84,83,83,53
"4812",11,"[33]mJHglqIHcdKocJvcGHqxdCFooKlyJAnju",171,0.994186,33,172,1,171,1,1,0,1,1,95,94,77,77,53
"4813",12,"[33]mJHglqIHcdKocJvcGHqxdCFooKlyJAnju",165,0.993976,33,166,1,165,1,1,0,1,1,79,78,87,87,53
"4814",13,"[33]mJHglqIHcdKocJvcGHqxdCFooKlyJAnju",166,0.994012,33,167,1,166,1,1,0,1,1,82,81,85,85,53
"4815",14,"[33]mJHglqIHcdKocJvcGHqxdCFooKlyJAnju",167,0.994048,33,168,1,167,1,1,0,1,1,86,85,82,82,53
"4816",15,"[33]mJHglqIHcdKocJvcGHqxdCFooKlyJAnju",166,0.994012,33,167,1,166,1,1,0,1,1,80,79,87,87,53
"4817",16,"[33]mJHglqIHcdKocJvcGHqxdCFooKlyJAnju",170,0.994152,33,171,1,170,1,1,0,1,1,92,91,79,79,53
"4818",17,"[33]mJHglqIHcdKocJvcGHqxdCFooKlyJAnju",163,0.993902,33,164,1,163,1,1,0,1,1,75,74,89,89,53
"4819",18,"[33]mJHglqIHcdKocJvcGHqxdCFooKlyJAnju",162,0.993865,33,163,1,162,1,1,0,1,1,72,71,91,91,53
"4820",19,"[33]mJHglqIHcdKocJvcGHqxdCFooKlyJAnju",163,0.993902,33,164,1,163,1,1,0,1,1,75,74,89,89,53
"4821",20,"[33]mJHglqIHcdKocJvcGHqxdCFooKlyJAnju",167,0.994048,33,168,1,167,1,1,0,1,1,85,84,83,83,53
"4822",21,"[33]mJHglqIHcdKocJvcGHqxdCFooKlyJAnju",167,0.994048,33,168,1,167,1,1,0,1,1,82,81,86,86,53
"4823",22,"[33]mJHglqIHcdKocJvcGHqxdCFooKlyJAnju",172,0.99422,33,173,1,172,1,1,0,1,1,98,97,75,75,53
"4824",23,"[33]mJHglqIHcdKocJvcGHqxdCFooKlyJAnju",165,0.993976,33,166,1,165,1,1,0,1,1,79,78,87,87,53
"4825",24,"[33]mJHglqIHcdKocJvcGHqxdCFooKlyJAnju",167,0.994048,33,168,1,167,1,1,0,1,1,85,84,83,83,53
"4826",25,"[33]mJHglqIHcdKocJvcGHqxdCFooKlyJAnju",167,0.994048,33,168,1,167,1,1,0,1,1,86,85,82,82,53
"4827",26,"[33]mJHglqIHcdKocJvcGHqxdCFooKlyJAnju",161,0.993827,33,162,1,161,1,1,0,1,1,67,66,95,95,53
"4828",27,"[33]mJHglqIHcdKocJvcGHqxdCFooKlyJAnju",166,0.994012,33,167,1,166,1,1,0,1,1,82,81,85,85,53
"4829",28,"[33]mJHglqIHcdKocJvcGHqxdCFooKlyJAnju",171,0.994186,33,172,1,171,1,1,0,1,1,95,94,77,77,53
"4830",29,"[33]mJHglqIHcdKocJvcGHqxdCFooKlyJAnju",163,0.993902,33,164,1,163,1,1,0,1,1,75,74,89,89,53
"4831",30,"[33]mJHglqIHcdKocJvcGHqxdCFooKlyJAnju",168,0.994083,33,169,1,168,1,1,0,1,1,87,86,82,82,53
"4832",31,"[33]mJHglqIHcdKocJvcGHqxdCFooKlyJAnju",171,0.994186,33,172,1,171,1,1,0,1,1,96,95,76,76,53
"4833",32,"[33]mJHglqIHcdKocJvcGHqxdCFooKlyJAnju",167,0.994048,33,168,1,167,1,1,0,1,1,85,84,83,83,53
"4834",33,"[33]mJHglqIHcdKocJvcGHqxdCFooKlyJAnju",169,0.994118,33,170,1,169,1,1,0,1,1,90,89,80,80,53
"4835",34,"[33]mJHglqIHcdKocJvcGHqxdCFooKlyJAnju",168,0.994083,33,169,1,168,1,1,0,1,1,86,85,83,83,53
"4836",35,"[33]mJHglqIHcdKocJvcGHqxdCFooKlyJAnju",173,0.994253,33,174,1,173,1,1,0,1,1,102,101,72,72,53
"4837",36,"[33]mJHglqIHcdKocJvcGHqxdCFooKlyJAnju",167,0.994048,33,168,1,167,1,1,0,1,1,84,83,84,84,53
"4838",37,"[33]mJHglqIHcdKocJvcGHqxdCFooKlyJAnju",170,0.994152,33,171,1,170,1,1,0,1,1,92,91,79,79,53
"4839",38,"[33]mJHglqIHcdKocJvcGHqxdCFooKlyJAnju",164,0.993939,33,165,1,164,1,1,0,1,1,77,76,88,88,53
"4840",39,"[33]mJHglqIHcdKocJvcGHqxdCFooKlyJAnju",164,0.993939,33,165,1,164,1,1,0,1,1,77,76,88,88,53
"4841",40,"[33]mJHglqIHcdKocJvcGHqxdCFooKlyJAnju",169,0.994118,33,170,1,169,1,1,0,1,1,90,89,80,80,53
"4842",41,"[33]mJHglqIHcdKocJvcGHqxdCFooKlyJAnju",164,0.993939,33,165,1,164,1,1,0,1,1,77,76,88,88,53
"4843",42,"[33]mJHglqIHcdKocJvcGHqxdCFooKlyJAnju",166,0.994012,33,167,1,166,1,1,0,1,1,82,81,85,85,53
"4844",43,"[33]mJHglqIHcdKocJvcGHqxdCFooKlyJAnju",169,0.994118,33,170,1,169,1,1,0,1,1,89,88,81,81,53
"4845",44,"[33]mJHglqIHcdKocJvcGHqxdCFooKlyJAnju",167,0.994048,33,168,1,167,1,1,0,1,1,83,82,85,85,53
"4846",45,"[33]mJHglqIHcdKocJvcGHqxdCFooKlyJAnju",163,0.993902,33,164,1,163,1,1,0,1,1,72,71,92,92,53
"4847",46,"[33]mJHglqIHcdKocJvcGHqxdCFooKlyJAnju",168,0.994083,33,169,1,168,1,1,0,1,1,87,86,82,82,53
"4848",47,"[33]mJHglqIHcdKocJvcGHqxdCFooKlyJAnju",170,0.994152,33,171,1,170,1,1,0,1,1,92,91,79,79,53
"4849",48,"[33]mJHglqIHcdKocJvcGHqxdCFooKlyJAnju",168,0.994083,33,169,1,168,1,1,0,1,1,88,87,81,81,53
"4850",49,"[33]mJHglqIHcdKocJvcGHqxdCFooKlyJAnju",170,0.994152,33,171,1,170,1,1,0,1,1,92,91,79,79,53
"4851",50,"[33]mJHglqIHcdKocJvcGHqxdCFooKlyJAnju",168,0.994083,33,169,1,168,1,1,0,1,1,88,87,81,81,53
"4852",51,"[33]mJHglqIHcdKocJvcGHqxdCFooKlyJAnju",168,0.994083,33,169,1,168,1,1,0,1,1,88,87,81,81,53
"4853",52,"[33]mJHglqIHcdKocJvcGHqxdCFooKlyJAnju",169,0.994118,33,170,1,169,1,1,0,1,1,89,88,81,81,53
"4854",53,"[33]mJHglqIHcdKocJvcGHqxdCFooKlyJAnju",169,0.994118,33,170,1,169,1,1,0,1,1,90,89,80,80,53
"4855",54,"[33]mJHglqIHcdKocJvcGHqxdCFooKlyJAnju",164,0.993939,33,165,1,164,1,1,0,1,1,77,76,88,88,53
"4856",55,"[33]mJHglqIHcdKocJvcGHqxdCFooKlyJAnju",166,0.994012,33,167,1,166,1,1,0,1,1,82,81,85,85,53
"4857",56,"[33]mJHglqIHcdKocJvcGHqxdCFooKlyJAnju",171,0.994186,33,172,1,171,1,1,0,1,1,93,92,79,79,53
"4858",57,"[33]mJHglqIHcdKocJvcGHqxdCFooKlyJAnju",168,0.994083,33,169,1,168,1,1,0,1,1,88,87,81,81,53
"4859",58,"[33]mJHglqIHcdKocJvcGHqxdCFooKlyJAnju",163,0.993902,33,164,1,163,1,1,0,1,1,73,72,91,91,53
"4860",59,"[33]mJHglqIHcdKocJvcGHqxdCFooKlyJAnju",167,0.994048,33,168,1,167,1,1,0,1,1,84,83,84,84,53
"4861",60,"[33]mJHglqIHcdKocJvcGHqxdCFooKlyJAnju",169,0.994118,33,170,1,169,1,1,0,1,1,88,87,82,82,53
"4862",61,"[33]mJHglqIHcdKocJvcGHqxdCFooKlyJAnju",163,0.993902,33,164,1,163,1,1,0,1,1,73,72,91,91,53
"4863",62,"[33]mJHglqIHcdKocJvcGHqxdCFooKlyJAnju",166,0.994012,33,167,1,166,1,1,0,1,1,82,81,85,85,53
"4864",63,"[33]mJHglqIHcdKocJvcGHqxdCFooKlyJAnju",170,0.994152,33,171,1,170,1,1,0,1,1,91,90,80,80,53
"4865",64,"[33]mJHglqIHcdKocJvcGHqxdCFooKlyJAnju",162,0.993865,33,163,1,162,1,1,0,1,1,72,71,91,91,53
"4866",65,"[33]mJHglqIHcdKocJvcGHqxdCFooKlyJAnju",167,0.994048,33,168,1,167,1,1,0,1,1,84,83,84,84,53
"4867",66,"[33]mJHglqIHcdKocJvcGHqxdCFooKlyJAnju",169,0.994118,33,170,1,169,1,1,0,1,1,88,87,82,82,53
"4868",67,"[33]mJHglqIHcdKocJvcGHqxdCFooKlyJAnju",164,0.993939,33,165,1,164,1,1,0,1,1,76,75,89,89,53
"4869",68,"[33]mJHglqIHcdKocJvcGHqxdCFooKlyJAnju",168,0.994083,33,169,1,168,1,1,0,1,1,87,86,82,82,53
"4870",69,"[33]mJHglqIHcdKocJvcGHqxdCFooKlyJAnju",165,0.993976,33,166,1,165,1,1,0,1,1,80,79,86,86,53
"4871",70,"[33]mJHglqIHcdKocJvcGHqxdCFooKlyJAnju",172,0.99422,33,173,1,172,1,1,0,1,1,98,97,75,75,53
"4872",71,"[33]mJHglqIHcdKocJvcGHqxdCFooKlyJAnju",168,0.994083,33,169,1,168,1,1,0,1,1,88,87,81,81,53
"4873",72,"[33]mJHglqIHcdKocJvcGHqxdCFooKlyJAnju",166,0.994012,33,167,1,166,1,1,0,1,1,82,81,85,85,53
"4874",73,"[33]mJHglqIHcdKocJvcGHqxdCFooKlyJAnju",163,0.993902,33,164,1,163,1,1,0,1,1,74,73,90,90,53
"4875",74,"[33]mJHglqIHcdKocJvcGHqxdCFooKlyJAnju",165,0.993976,33,166,1,165,1,1,0,1,1,79,78,87,87,53
"4876",75,"[33]mJHglqIHcdKocJvcGHqxdCFooKlyJAnju",167,0.994048,33,168,1,167,1,1,0,1,1,80,79,88,88,53
"4877",76,"[33]mJHglqIHcdKocJvcGHqxdCFooKlyJAnju",163,0.993902,33,164,1,163,1,1,0,1,1,74,73,90,90,53
"4878",77,"[33]mJHglqIHcdKocJvcGHqxdCFooKlyJAnju",164,0.993939,33,165,1,164,1,1,0,1,1,74,73,91,91,53
"4879",78,"[33]mJHglqIHcdKocJvcGHqxdCFooKlyJAnju",167,0.994048,33,168,1,167,1,1,0,1,1,86,85,82,82,53
"4880",79,"[33]mJHglqIHcdKocJvcGHqxdCFooKlyJAnju",171,0.994186,33,172,1,171,1,1,0,1,1,95,94,77,77,53
"4881",80,"[33]mJHglqIHcdKocJvcGHqxdCFooKlyJAnju",167,0.994048,33,168,1,167,1,1,0,1,1,82,81,86,86,53
"4882",81,"[33]mJHglqIHcdKocJvcGHqxdCFooKlyJAnju",165,0.993976,33,166,1,165,1,1,0,1,1,80,79,86,86,53
"4883",82,"[33]mJHglqIHcdKocJvcGHqxdCFooKlyJAnju",167,0.994048,33,168,1,167,1,1,0,1,1,83,82,85,85,53
"4884",83,"[33]mJHglqIHcdKocJvcGHqxdCFooKlyJAnju",166,0.994012,33,167,1,166,1,1,0,1,1,80,79,87,87,53
"4885",84,"[33]mJHglqIHcdKocJvcGHqxdCFooKlyJAnju",169,0.994118,33,170,1,169,1,1,0,1,1,90,89,80,80,53
"4886",85,"[33]mJHglqIHcdKocJvcGHqxdCFooKlyJAnju",171,0.994186,33,172,1,171,1,1,0,1,1,95,94,77,77,53
"4887",86,"[33]mJHglqIHcdKocJvcGHqxdCFooKlyJAnju",168,0.994083,33,169,1,168,1,1,0,1,1,88,87,81,81,53
"4888",87,"[33]mJHglqIHcdKocJvcGHqxdCFooKlyJAnju",165,0.993976,33,166,1,165,1,1,0,1,1,80,79,86,86,53
"4889",88,"[33]mJHglqIHcdKocJvcGHqxdCFooKlyJAnju",164,0.993939,33,165,1,164,1,1,0,1,1,76,75,89,89,53
"4890",89,"[33]mJHglqIHcdKocJvcGHqxdCFooKlyJAnju",169,0.994118,33,170,1,169,1,1,0,1,1,89,88,81,81,53
"4891",90,"[33]mJHglqIHcdKocJvcGHqxdCFooKlyJAnju",168,0.994083,33,169,1,168,1,1,0,1,1,88,87,81,81,53
"4892",91,"[33]mJHglqIHcdKocJvcGHqxdCFooKlyJAnju",163,0.993902,33,164,1,163,1,1,0,1,1,74,73,90,90,53
"4893",92,"[33]mJHglqIHcdKocJvcGHqxdCFooKlyJAnju",166,0.994012,33,167,1,166,1,1,0,1,1,80,79,87,87,53
"4894",93,"[33]mJHglqIHcdKocJvcGHqxdCFooKlyJAnju",169,0.994118,33,170,1,169,1,1,0,1,1,89,88,81,81,53
"4895",94,"[33]mJHglqIHcdKocJvcGHqxdCFooKlyJAnju",169,0.994118,33,170,1,169,1,1,0,1,1,90,89,80,80,53
"4896",95,"[33]mJHglqIHcdKocJvcGHqxdCFooKlyJAnju",161,0.993827,33,162,1,161,1,1,0,1,1,69,68,93,93,53
"4897",96,"[33]mJHglqIHcdKocJvcGHqxdCFooKlyJAnju",166,0.994012,33,167,1,166,1,1,0,1,1,82,81,85,85,53
"4898",97,"[33]mJHglqIHcdKocJvcGHqxdCFooKlyJAnju",163,0.993902,33,164,1,163,1,1,0,1,1,72,71,92,92,53
"4899",98,"[33]mJHglqIHcdKocJvcGHqxdCFooKlyJAnju",167,0.994048,33,168,1,167,1,1,0,1,1,86,85,82,82,53
"4900",99,"[33]mJHglqIHcdKocJvcGHqxdCFooKlyJAnju",166,0.994012,33,167,1,166,1,1,0,1,1,83,82,84,84,53
"4901",0,"[27]pJHggqIHcdKpcJvcGHqxdCqycqq",162,0.993865,27,163,1,162,1,1,0,1,1,72,71,91,91,54
"4902",1,"[27]pJHggqIHcdKpcJvcGHqxdCqycqq",167,0.994048,27,168,1,167,1,1,0,1,1,85,84,83,83,54
"4903",2,"[27]pJHggqIHcdKpcJvcGHqxdCqycqq",167,0.994048,27,168,1,167,1,1,0,1,1,85,84,83,83,54
"4904",3,"[27]pJHggqIHcdKpcJvcGHqxdCqycqq",169,0.994118,27,170,1,169,1,1,0,1,1,90,89,80,80,54
"4905",4,"[27]pJHggqIHcdKpcJvcGHqxdCqycqq",167,0.994048,27,168,1,167,1,1,0,1,1,85,84,83,83,54
"4906",5,"[27]pJHggqIHcdKpcJvcGHqxdCqycqq",170,0.994152,27,171,1,170,1,1,0,1,1,94,93,77,77,54
"4907",6,"[27]pJHggqIHcdKpcJvcGHqxdCqycqq",166,0.994012,27,167,1,166,1,1,0,1,1,83,82,84,84,54
"4908",7,"[27]pJHggqIHcdKpcJvcGHqxdCqycqq",165,0.993976,27,166,1,165,1,1,0,1,1,78,77,88,88,54
"4909",8,"[27]pJHggqIHcdKpcJvcGHqxdCqycqq",165,0.993976,27,166,1,165,1,1,0,1,1,80,79,86,86,54
"4910",9,"[27]pJHggqIHcdKpcJvcGHqxdCqycqq",169,0.994118,27,170,1,169,1,1,0,1,1,90,89,80,80,54
"4911",10,"[27]pJHggqIHcdKpcJvcGHqxdCqycqq",168,0.994083,27,169,1,168,1,1,0,1,1,89,88,80,80,54
"4912",11,"[27]pJHggqIHcdKpcJvcGHqxdCqycqq",165,0.993976,27,166,1,165,1,1,0,1,1,79,78,87,87,54
"4913",12,"[27]pJHggqIHcdKpcJvcGHqxdCqycqq",172,0.99422,27,173,1,172,1,1,0,1,1,96,95,77,77,54
"4914",13,"[27]pJHggqIHcdKpcJvcGHqxdCqycqq",162,0.993865,27,163,1,162,1,1,0,1,1,72,71,91,91,54
"4915",14,"[27]pJHggqIHcdKpcJvcGHqxdCqycqq",160,0.993789,27,161,1,160,1,1,0,1,1,66,65,95,95,54
"4916",15,"[27]pJHggqIHcdKpcJvcGHqxdCqycqq",169,0.994118,27,170,1,169,1,1,0,1,1,92,91,78,78,54
"4917",16,"[27]pJHggqIHcdKpcJvcGHqxdCqycqq",165,0.993976,27,166,1,165,1,1,0,1,1,80,79,86,86,54
"4918",17,"[27]pJHggqIHcdKpcJvcGHqxdCqycqq",165,0.993976,27,166,1,165,1,1,0,1,1,79,78,87,87,54
"4919",18,"[27]pJHggqIHcdKpcJvcGHqxdCqycqq",167,0.994048,27,168,1,167,1,1,0,1,1,87,86,81,81,54
"4920",19,"[27]pJHggqIHcdKpcJvcGHqxdCqycqq",167,0.994048,27,168,1,167,1,1,0,1,1,85,84,83,83,54
"4921",20,"[27]pJHggqIHcdKpcJvcGHqxdCqycqq",165,0.993976,27,166,1,165,1,1,0,1,1,80,79,86,86,54
"4922",21,"[27]pJHggqIHcdKpcJvcGHqxdCqycqq",167,0.994048,27,168,1,167,1,1,0,1,1,86,85,82,82,54
"4923",22,"[27]pJHggqIHcdKpcJvcGHqxdCqycqq",163,0.993902,27,164,1,163,1,1,0,1,1,75,74,89,89,54
"4924",23,"[27]pJHggqIHcdKpcJvcGHqxdCqycqq",167,0.994048,27,168,1,167,1,1,0,1,1,85,84,83,83,54
"4925",24,"[27]pJHggqIHcdKpcJvcGHqxdCqycqq",165,0.993976,27,166,1,165,1,1,0,1,1,80,79,86,86,54
"4926",25,"[27]pJHggqIHcdKpcJvcGHqxdCqycqq",171,0.994186,27,172,1,171,1,1,0,1,1,97,96,75,75,54
"4927",26,"[27]pJHggqIHcdKpcJvcGHqxdCqycqq",167,0.994048,27,168,1,167,1,1,0,1,1,84,83,84,84,54
"4928",27,"[27]pJHggqIHcdKpcJvcGHqxdCqycqq",163,0.993902,27,164,1,163,1,1,0,1,1,74,73,90,90,54
"4929",28,"[27]pJHggqIHcdKpcJvcGHqxdCqycqq",168,0.994083,27,169,1,168,1,1,0,1,1,89,88,80,80,54
"4930",29,"[27]pJHggqIHcdKpcJvcGHqxdCqycqq",167,0.994048,27,168,1,167,1,1,0,1,1,84,83,84,84,54
"4931",30,"[27]pJHggqIHcdKpcJvcGHqxdCqycqq",166,0.994012,27,167,1,166,1,1,0,1,1,83,82,84,84,54
"4932",31,"[27]pJHggqIHcdKpcJvcGHqxdCqycqq",164,0.993939,27,165,1,164,1,1,0,1,1,77,76,88,88,54
"4933",32,"[27]pJHggqIHcdKpcJvcGHqxdCqycqq",165,0.993976,27,166,1,165,1,1,0,1,1,80,79,86,86,54
"4934",33,"[27]pJHggqIHcdKpcJvcGHqxdCqycqq",167,0.994048,27,168,1,167,1,1,0,1,1,87,86,81,81,54
"4935",34,"[27]pJHggqIHcdKpcJvcGHqxdCqycqq",165,0.993976,27,166,1,165,1,1,0,1,1,81,80,85,85,54
"4936",35,"[27]pJHggqIHcdKpcJvcGHqxdCqycqq",163,0.993902,27,164,1,163,1,1,0,1,1,75,74,89,89,54
"4937",36,"[27]pJHggqIHcdKpcJvcGHqxdCqycqq",168,0.994083,27,169,1,168,1,1,0,1,1,89,88,80,80,54
"4938",37,"[27]pJHggqIHcdKpcJvcGHqxdCqycqq",170,0.994152,27,171,1,170,1,1,0,1,1,94,93,77,77,54
"4939",38,"[27]pJHggqIHcdKpcJvcGHqxdCqycqq",169,0.994118,27,170,1,169,1,1,0,1,1,90,89,80,80,54
"4940",39,"[27]pJHggqIHcdKpcJvcGHqxdCqycqq",166,0.994012,27,167,1,166,1,1,0,1,1,84,83,83,83,54
"4941",40,"[27]pJHggqIHcdKpcJvcGHqxdCqycqq",167,0.994048,27,168,1,167,1,1,0,1,1,85,84,83,83,54
"4942",41,"[27]pJHggqIHcdKpcJvcGHqxdCqycqq",165,0.993976,27,166,1,165,1,1,0,1,1,81,80,85,85,54
"4943",42,"[27]pJHggqIHcdKpcJvcGHqxdCqycqq",167,0.994048,27,168,1,167,1,1,0,1,1,86,85,82,82,54
"4944",43,"[27]pJHggqIHcdKpcJvcGHqxdCqycqq",164,0.993939,27,165,1,164,1,1,0,1,1,78,77,87,87,54
"4945",44,"[27]pJHggqIHcdKpcJvcGHqxdCqycqq",171,0.994186,27,172,1,171,1,1,0,1,1,98,97,74,74,54
"4946",45,"[27]pJHggqIHcdKpcJvcGHqxdCqycqq",162,0.993865,27,163,1,162,1,1,0,1,1,72,71,91,91,54
"4947",46,"[27]pJHggqIHcdKpcJvcGHqxdCqycqq",163,0.993902,27,164,1,163,1,1,0,1,1,74,73,90,90,54
"4948",47,"[27]pJHggqIHcdKpcJvcGHqxdCqycqq",166,0.994012,27,167,1,166,1,1,0,1,1,81,80,86,86,54
"4949",48,"[27]pJHggqIHcdKpcJvcGHqxdCqycqq",166,0.994012,27,167,1,166,1,1,0,1,1,83,82,84,84,54
"4950",49,"[27]pJHggqIHcdKpcJvcGHqxdCqycqq",167,0.994048,27,168,1,167,1,1,0,1,1,85,84,83,83,54
"4951",50,"[27]pJHggqIHcdKpcJvcGHqxdCqycqq",164,0.993939,27,165,1,164,1,1,0,1,1,77,76,88,88,54
"4952",51,"[27]pJHggqIHcdKpcJvcGHqxdCqycqq",167,0.994048,27,168,1,167,1,1,0,1,1,85,84,83,83,54
"4953",52,"[27]pJHggqIHcdKpcJvcGHqxdCqycqq",171,0.994186,27,172,1,171,1,1,0,1,1,96,95,76,76,54
"4954",53,"[27]pJHggqIHcdKpcJvcGHqxdCqycqq",162,0.993865,27,163,1,162,1,1,0,1,1,72,71,91,91,54
"4955",54,"[27]pJHggqIHcdKpcJvcGHqxdCqycqq",158,0.993711,27,159,1,158,1,1,0,1,1,62,61,97,97,54
"4956",55,"[27]pJHggqIHcdKpcJvcGHqxdCqycqq",165,0.993976,27,166,1,165,1,1,0,1,1,79,78,87,87,54
"4957",56,"[27]pJHggqIHcdKpcJvcGHqxdCqycqq",165,0.993976,27,166,1,165,1,1,0,1,1,81,80,85,85,54
"4958",57,"[27]pJHggqIHcdKpcJvcGHqxdCqycqq",168,0.994083,27,169,1,168,1,1,0,1,1,88,87,81,81,54
"4959",58,"[27]pJHggqIHcdKpcJvcGHqxdCqycqq",173,0.994253,27,174,1,173,1,1,0,1,1,103,102,71,71,54
"4960",59,"[27]pJHggqIHcdKpcJvcGHqxdCqycqq",164,0.993939,27,165,1,164,1,1,0,1,1,78,77,87,87,54
"4961",60,"[27]pJHggqIHcdKpcJvcGHqxdCqycqq",170,0.994152,27,171,1,170,1,1,0,1,1,94,93,77,77,54
"4962",61,"[27]pJHggqIHcdKpcJvcGHqxdCqycqq",162,0.993865,27,163,1,162,1,1,0,1,1,73,72,90,90,54
"4963",62,"[27]pJHggqIHcdKpcJvcGHqxdCqycqq",168,0.994083,27,169,1,168,1,1,0,1,1,87,86,82,82,54
"4964",63,"[27]pJHggqIHcdKpcJvcGHqxdCqycqq",166,0.994012,27,167,1,166,1,1,0,1,1,83,82,84,84,54
"4965",64,"[27]pJHggqIHcdKpcJvcGHqxdCqycqq",163,0.993902,27,164,1,163,1,1,0,1,1,76,75,88,88,54
"4966",65,"[27]pJHggqIHcdKpcJvcGHqxdCqycqq",167,0.994048,27,168,1,167,1,1,0,1,1,86,85,82,82,54
"4967",66,"[27]pJHggqIHcdKpcJvcGHqxdCqycqq",170,0.994152,27,171,1,170,1,1,0,1,1,93,92,78,78,54
"4968",67,"[27]pJHggqIHcdKpcJvcGHqxdCqycqq",166,0.994012,27,167,1,166,1,1,0,1,1,82,81,85,85,54
"4969",68,"[27]pJHggqIHcdKpcJvcGHqxdCqycqq",168,0.994083,27,169,1,168,1,1,0,1,1,86,85,83,83,54
"4970",69,"[27]pJHggqIHcdKpcJvcGHqxdCqycqq",167,0.994048,27,168,1,167,1,1,0,1,1,87,86,81,81,54
"4971",70,"[27]pJHggqIHcdKpcJvcGHqxdCqycqq",163,0.993902,27,164,1,163,1,1,0,1,1,76,75,88,88,54
"4972",71,"[27]pJHggqIHcdKpcJvcGHqxdCqycqq",167,0.994048,27,168,1,167,1,1,0,1,1,86,85,82,82,54
"4973",72,"[27]pJHggqIHcdKpcJvcGHqxdCqycqq",168,0.994083,27,169,1,168,1,1,0,1,1,88,87,81,81,54
"4974",73,"[27]pJHggqIHcdKpcJvcGHqxdCqycqq",168,0.994083,27,169,1,168,1,1,0,1,1,88,87,81,81,54
"4975",74,"[27]pJHggqIHcdKpcJvcGHqxdCqycqq",172,0.99422,27,173,1,172,1,1,0,1,1,100,99,73,73,54
"4976",75,"[27]pJHggqIHcdKpcJvcGHqxdCqycqq",161,0.993827,27,162,1,161,1,1,0,1,1,70,69,92,92,54
"4977",76,"[27]pJHggqIHcdKpcJvcGHqxdCqycqq",167,0.994048,27,168,1,167,1,1,0,1,1,86,85,82,82,54
"4978",77,"[27]pJHggqIHcdKpcJvcGHqxdCqycqq",171,0.994186,27,172,1,171,1,1,0,1,1,97,96,75,75,54
"4979",78,"[27]pJHggqIHcdKpcJvcGHqxdCqycqq",166,0.994012,27,167,1,166,1,1,0,1,1,84,83,83,83,54
"4980",79,"[27]pJHggqIHcdKpcJvcGHqxdCqycqq",170,0.994152,27,171,1,170,1,1,0,1,1,93,92,78,78,54
"4981",80,"[27]pJHggqIHcdKpcJvcGHqxdCqycqq",161,0.993827,27,162,1,161,1,1,0,1,1,69,68,93,93,54
"4982",81,"[27]pJHggqIHcdKpcJvcGHqxdCqycqq",160,0.993789,27,161,1,160,1,1,0,1,1,67,66,94,94,54
"4983",82,"[27]pJHggqIHcdKpcJvcGHqxdCqycqq",169,0.994118,27,170,1,169,1,1,0,1,1,90,89,80,80,54
"4984",83,"[27]pJHggqIHcdKpcJvcGHqxdCqycqq",165,0.993976,27,166,1,165,1,1,0,1,1,81,80,85,85,54
"4985",84,"[27]pJHggqIHcdKpcJvcGHqxdCqycqq",168,0.994083,27,169,1,168,1,1,0,1,1,87,86,82,82,54
"4986",85,"[27]pJHggqIHcdKpcJvcGHqxdCqycqq",160,0.993789,27,161,1,160,1,1,0,1,1,67,66,94,94,54
"4987",86,"[27]pJHggqIHcdKpcJvcGHqxdCqycqq",161,0.993827,27,162,1,161,1,1,0,1,1,69,68,93,93,54
"4988",87,"[27]pJHggqIHcdKpcJvcGHqxdCqycqq",162,0.993865,27,163,1,162,1,1,0,1,1,72,71,91,91,54
"4989",88,"[27]pJHggqIHcdKpcJvcGHqxdCqycqq",172,0.99422,27,173,1,172,1,1,0,1,1,100,99,73,73,54
"4990",89,"[27]pJHggqIHcdKpcJvcGHqxdCqycqq",169,0.994118,27,170,1,169,1,1,0,1,1,91,90,79,79,54
"4991",90,"[27]pJHggqIHcdKpcJvcGHqxdCqycqq",165,0.993976,27,166,1,165,1,1,0,1,1,81,80,85,85,54
"4992",91,"[27]pJHggqIHcdKpcJvcGHqxdCqycqq",166,0.994012,27,167,1,166,1,1,0,1,1,84,83,83,83,54
"4993",92,"[27]pJHggqIHcdKpcJvcGHqxdCqycqq",168,0.994083,27,169,1,168,1,1,0,1,1,87,86,82,82,54
"4994",93,"[27]pJHggqIHcdKpcJvcGHqxdCqycqq",170,0.994152,27,171,1,170,1,1,0,1,1,95,94,76,76,54
"4995",94,"[27]pJHggqIHcdKpcJvcGHqxdCqycqq",167,0.994048,27,168,1,167,1,1,0,1,1,83,82,85,85,54
"4996",95,"[27]pJHggqIHcdKpcJvcGHqxdCqycqq",169,0.994118,27,170,1,169,1,1,0,1,1,91,90,79,79,54
"4997",96,"[27]pJHggqIHcdKpcJvcGHqxdCqycqq",166,0.994012,27,167,1,166,1,1,0,1,1,82,81,85,85,54
"4998",97,"[27]pJHggqIHcdKpcJvcGHqxdCqycqq",163,0.993902,27,164,1,163,1,1,0,1,1,75,74,89,89,54
"4999",98,"[27]pJHggqIHcdKpcJvcGHqxdCqycqq",167,0.994048,27,168,1,167,1,1,0,1,1,86,85,82,82,54
"5000",99,"[27]pJHggqIHcdKpcJvcGHqxdCqycqq",165,0.993976,27,166,1,165,1,1,0,1,1,79,78,87,87,54
"5001",0,"[30]wJHggyqIHBidKpcJvcGHqFdCFjclbt",179,0.994444,30,180,1,179,1,1,0,1,1,99,98,81,81,55
"5002",1,"[30]wJHggyqIHBidKpcJvcGHqFdCFjclbt",172,0.99422,30,173,1,172,1,1,0,1,1,74,73,99,99,55
"5003",2,"[30]wJHggyqIHBidKpcJvcGHqFdCFjclbt",182,0.994536,30,183,1,182,1,1,0,1,1,110,109,73,73,55
"5004",3,"[30]wJHggyqIHBidKpcJvcGHqFdCFjclbt",178,0.994413,30,179,1,178,1,1,0,1,1,96,95,83,83,55
"5005",4,"[30]wJHggyqIHBidKpcJvcGHqFdCFjclbt",178,0.994413,30,179,1,178,1,1,0,1,1,97,96,82,82,55
"5006",5,"[30]wJHggyqIHBidKpcJvcGHqFdCFjclbt",176,0.99435,30,177,1,176,1,1,0,1,1,88,87,89,89,55
"5007",6,"[30]wJHggyqIHBidKpcJvcGHqFdCFjclbt",172,0.99422,30,173,1,172,1,1,0,1,1,76,75,97,97,55
"5008",7,"[30]wJHggyqIHBidKpcJvcGHqFdCFjclbt",179,0.994444,30,180,1,179,1,1,0,1,1,99,98,81,81,55
"5009",8,"[30]wJHggyqIHBidKpcJvcGHqFdCFjclbt",173,0.994253,30,174,1,173,1,1,0,1,1,80,79,94,94,55
"5010",9,"[30]wJHggyqIHBidKpcJvcGHqFdCFjclbt",173,0.994253,30,174,1,173,1,1,0,1,1,79,78,95,95,55
"5011",10,"[30]wJHggyqIHBidKpcJvcGHqFdCFjclbt",179,0.994444,30,180,1,179,1,1,0,1,1,99,98,81,81,55
"5012",11,"[30]wJHggyqIHBidKpcJvcGHqFdCFjclbt",173,0.994253,30,174,1,173,1,1,0,1,1,80,79,94,94,55
"5013",12,"[30]wJHggyqIHBidKpcJvcGHqFdCFjclbt",175,0.994318,30,176,1,175,1,1,0,1,1,85,84,91,91,55
"5014",13,"[30]wJHggyqIHBidKpcJvcGHqFdCFjclbt",183,0.994565,30,184,1,183,1,1,0,1,1,111,110,73,73,55
"5015",14,"[30]wJHggyqIHBidKpcJvcGHqFdCFjclbt",175,0.994318,30,176,1,175,1,1,0,1,1,87,86,89,89,55
"5016",15,"[30]wJHggyqIHBidKpcJvcGHqFdCFjclbt",172,0.99422,30,173,1,172,1,1,0,1,1,77,76,96,96,55
"5017",16,"[30]wJHggyqIHBidKpcJvcGHqFdCFjclbt",175,0.994318,30,176,1,175,1,1,0,1,1,87,86,89,89,55
"5018",17,"[30]wJHggyqIHBidKpcJvcGHqFdCFjclbt",173,0.994253,30,174,1,173,1,1,0,1,1,80,79,94,94,55
"5019",18,"[30]wJHggyqIHBidKpcJvcGHqFdCFjclbt",177,0.994382,30,178,1,177,1,1,0,1,1,92,91,86,86,55
"5020",19,"[30]wJHggyqIHBidKpcJvcGHqFdCFjclbt",177,0.994382,30,178,1,177,1,1,0,1,1,94,93,84,84,55
"5021",20,"[30]wJHggyqIHBidKpcJvcGHqFdCFjclbt",175,0.994318,30,176,1,175,1,1,0,1,1,87,86,89,89,55
"5022",21,"[30]wJHggyqIHBidKpcJvcGHqFdCFjclbt",178,0.994413,30,179,1,178,1,1,0,1,1,97,96,82,82,55
"5023",22,"[30]wJHggyqIHBidKpcJvcGHqFdCFjclbt",174,0.994286,30,175,1,174,1,1,0,1,1,83,82,92,92,55
"5024",23,"[30]wJHggyqIHBidKpcJvcGHqFdCFjclbt",170,0.994152,30,171,1,170,1,1,0,1,1,71,70,100,100,55
"5025",24,"[30]wJHggyqIHBidKpcJvcGHqFdCFjclbt",173,0.994253,30,174,1,173,1,1,0,1,1,78,77,96,96,55
"5026",25,"[30]wJHggyqIHBidKpcJvcGHqFdCFjclbt",172,0.99422,30,173,1,172,1,1,0,1,1,75,74,98,98,55
"5027",26,"[30]wJHggyqIHBidKpcJvcGHqFdCFjclbt",181,0.994505,30,182,1,181,1,1,0,1,1,105,104,77,77,55
"5028",27,"[30]wJHggyqIHBidKpcJvcGHqFdCFjclbt",178,0.994413,30,179,1,178,1,1,0,1,1,96,95,83,83,55
"5029",28,"[30]wJHggyqIHBidKpcJvcGHqFdCFjclbt",177,0.994382,30,178,1,177,1,1,0,1,1,94,93,84,84,55
"5030",29,"[30]wJHggyqIHBidKpcJvcGHqFdCFjclbt",170,0.994152,30,171,1,170,1,1,0,1,1,68,67,103,103,55
"5031",30,"[30]wJHggyqIHBidKpcJvcGHqFdCFjclbt",173,0.994253,30,174,1,173,1,1,0,1,1,79,78,95,95,55
"5032",31,"[30]wJHggyqIHBidKpcJvcGHqFdCFjclbt",173,0.994253,30,174,1,173,1,1,0,1,1,80,79,94,94,55
"5033",32,"[30]wJHggyqIHBidKpcJvcGHqFdCFjclbt",178,0.994413,30,179,1,178,1,1,0,1,1,95,94,84,84,55
"5034",33,"[30]wJHggyqIHBidKpcJvcGHqFdCFjclbt",174,0.994286,30,175,1,174,1,1,0,1,1,84,83,91,91,55
"5035",34,"[30]wJHggyqIHBidKpcJvcGHqFdCFjclbt",178,0.994413,30,179,1,178,1,1,0,1,1,94,93,85,85,55
"5036",35,"[30]wJHggyqIHBidKpcJvcGHqFdCFjclbt",175,0.994318,30,176,1,175,1,1,0,1,1,85,84,91,91,55
"5037",36,"[30]wJHggyqIHBidKpcJvcGHqFdCFjclbt",175,0.994318,30,176,1,175,1,1,0,1,1,86,85,90,90,55
"5038",37,"[30]wJHggyqIHBidKpcJvcGHqFdCFjclbt",180,0.994475,30,181,1,180,1,1,0,1,1,102,101,79,79,55
"5039",38,"[30]wJHggyqIHBidKpcJvcGHqFdCFjclbt",178,0.994413,30,179,1,178,1,1,0,1,1,95,94,84,84,55
"5040",39,"[30]wJHggyqIHBidKpcJvcGHqFdCFjclbt",178,0.994413,30,179,1,178,1,1,0,1,1,97,96,82,82,55
"5041",40,"[30]wJHggyqIHBidKpcJvcGHqFdCFjclbt",175,0.994318,30,176,1,175,1,1,0,1,1,84,83,92,92,55
"5042",41,"[30]wJHggyqIHBidKpcJvcGHqFdCFjclbt",177,0.994382,30,178,1,177,1,1,0,1,1,94,93,84,84,55
"5043",42,"[30]wJHggyqIHBidKpcJvcGHqFdCFjclbt",176,0.99435,30,177,1,176,1,1,0,1,1,89,88,88,88,55
"5044",43,"[30]wJHggyqIHBidKpcJvcGHqFdCFjclbt",177,0.994382,30,178,1,177,1,1,0,1,1,92,91,86,86,55
"5045",44,"[30]wJHggyqIHBidKpcJvcGHqFdCFjclbt",171,0.994186,30,172,1,171,1,1,0,1,1,74,73,98,98,55
"5046",45,"[30]wJHggyqIHBidKpcJvcGHqFdCFjclbt",172,0.99422,30,173,1,172,1,1,0,1,1,74,73,99,99,55
"5047",46,"[30]wJHggyqIHBidKpcJvcGHqFdCFjclbt",172,0.99422,30,173,1,172,1,1,0,1,1,75,74,98,98,55
"5048",47,"[30]wJHggyqIHBidKpcJvcGHqFdCFjclbt",180,0.994475,30,181,1,180,1,1,0,1,1,103,102,78,78,55
"5049",48,"[30]wJHggyqIHBidKpcJvcGHqFdCFjclbt",180,0.994475,30,181,1,180,1,1,0,1,1,101,100,80,80,55
"5050",49,"[30]wJHggyqIHBidKpcJvcGHqFdCFjclbt",181,0.994505,30,182,1,181,1,1,0,1,1,107,106,75,75,55
"5051",50,"[30]wJHggyqIHBidKpcJvcGHqFdCFjclbt",178,0.994413,30,179,1,178,1,1,0,1,1,97,96,82,82,55
"5052",51,"[30]wJHggyqIHBidKpcJvcGHqFdCFjclbt",176,0.99435,30,177,1,176,1,1,0,1,1,89,88,88,88,55
"5053",52,"[30]wJHggyqIHBidKpcJvcGHqFdCFjclbt",179,0.994444,30,180,1,179,1,1,0,1,1,98,97,82,82,55
"5054",53,"[30]wJHggyqIHBidKpcJvcGHqFdCFjclbt",177,0.994382,30,178,1,177,1,1,0,1,1,93,92,85,85,55
"5055",54,"[30]wJHggyqIHBidKpcJvcGHqFdCFjclbt",176,0.99435,30,177,1,176,1,1,0,1,1,90,89,87,87,55
"5056",55,"[30]wJHggyqIHBidKpcJvcGHqFdCFjclbt",178,0.994413,30,179,1,178,1,1,0,1,1,96,95,83,83,55
"5057",56,"[30]wJHggyqIHBidKpcJvcGHqFdCFjclbt",177,0.994382,30,178,1,177,1,1,0,1,1,93,92,85,85,55
"5058",57,"[30]wJHggyqIHBidKpcJvcGHqFdCFjclbt",177,0.994382,30,178,1,177,1,1,0,1,1,90,89,88,88,55
"5059",58,"[30]wJHggyqIHBidKpcJvcGHqFdCFjclbt",182,0.994536,30,183,1,182,1,1,0,1,1,108,107,75,75,55
"5060",59,"[30]wJHggyqIHBidKpcJvcGHqFdCFjclbt",174,0.994286,30,175,1,174,1,1,0,1,1,82,81,93,93,55
"5061",60,"[30]wJHggyqIHBidKpcJvcGHqFdCFjclbt",170,0.994152,30,171,1,170,1,1,0,1,1,71,70,100,100,55
"5062",61,"[30]wJHggyqIHBidKpcJvcGHqFdCFjclbt",172,0.99422,30,173,1,172,1,1,0,1,1,77,76,96,96,55
"5063",62,"[30]wJHggyqIHBidKpcJvcGHqFdCFjclbt",174,0.994286,30,175,1,174,1,1,0,1,1,82,81,93,93,55
"5064",63,"[30]wJHggyqIHBidKpcJvcGHqFdCFjclbt",181,0.994505,30,182,1,181,1,1,0,1,1,106,105,76,76,55
"5065",64,"[30]wJHggyqIHBidKpcJvcGHqFdCFjclbt",173,0.994253,30,174,1,173,1,1,0,1,1,81,80,93,93,55
"5066",65,"[30]wJHggyqIHBidKpcJvcGHqFdCFjclbt",177,0.994382,30,178,1,177,1,1,0,1,1,93,92,85,85,55
"5067",66,"[30]wJHggyqIHBidKpcJvcGHqFdCFjclbt",174,0.994286,30,175,1,174,1,1,0,1,1,83,82,92,92,55
"5068",67,"[30]wJHggyqIHBidKpcJvcGHqFdCFjclbt",173,0.994253,30,174,1,173,1,1,0,1,1,80,79,94,94,55
"5069",68,"[30]wJHggyqIHBidKpcJvcGHqFdCFjclbt",174,0.994286,30,175,1,174,1,1,0,1,1,84,83,91,91,55
"5070",69,"[30]wJHggyqIHBidKpcJvcGHqFdCFjclbt",176,0.99435,30,177,1,176,1,1,0,1,1,88,87,89,89,55
"5071",70,"[30]wJHggyqIHBidKpcJvcGHqFdCFjclbt",177,0.994382,30,178,1,177,1,1,0,1,1,93,92,85,85,55
"5072",71,"[30]wJHggyqIHBidKpcJvcGHqFdCFjclbt",177,0.994382,30,178,1,177,1,1,0,1,1,91,90,87,87,55
"5073",72,"[30]wJHggyqIHBidKpcJvcGHqFdCFjclbt",172,0.99422,30,173,1,172,1,1,0,1,1,76,75,97,97,55
"5074",73,"[30]wJHggyqIHBidKpcJvcGHqFdCFjclbt",175,0.994318,30,176,1,175,1,1,0,1,1,86,85,90,90,55
"5075",74,"[30]wJHggyqIHBidKpcJvcGHqFdCFjclbt",177,0.994382,30,178,1,177,1,1,0,1,1,94,93,84,84,55
"5076",75,"[30]wJHggyqIHBidKpcJvcGHqFdCFjclbt",174,0.994286,30,175,1,174,1,1,0,1,1,83,82,92,92,55
"5077",76,"[30]wJHggyqIHBidKpcJvcGHqFdCFjclbt",174,0.994286,30,175,1,174,1,1,0,1,1,83,82,92,92,55
"5078",77,"[30]wJHggyqIHBidKpcJvcGHqFdCFjclbt",176,0.99435,30,177,1,176,1,1,0,1,1,90,89,87,87,55
"5079",78,"[30]wJHggyqIHBidKpcJvcGHqFdCFjclbt",176,0.99435,30,177,1,176,1,1,0,1,1,89,88,88,88,55
"5080",79,"[30]wJHggyqIHBidKpcJvcGHqFdCFjclbt",178,0.994413,30,179,1,178,1,1,0,1,1,97,96,82,82,55
"5081",80,"[30]wJHggyqIHBidKpcJvcGHqFdCFjclbt",173,0.994253,30,174,1,173,1,1,0,1,1,79,78,95,95,55
"5082",81,"[30]wJHggyqIHBidKpcJvcGHqFdCFjclbt",177,0.994382,30,178,1,177,1,1,0,1,1,94,93,84,84,55
"5083",82,"[30]wJHggyqIHBidKpcJvcGHqFdCFjclbt",179,0.994444,30,180,1,179,1,1,0,1,1,100,99,80,80,55
"5084",83,"[30]wJHggyqIHBidKpcJvcGHqFdCFjclbt",174,0.994286,30,175,1,174,1,1,0,1,1,82,81,93,93,55
"5085",84,"[30]wJHggyqIHBidKpcJvcGHqFdCFjclbt",173,0.994253,30,174,1,173,1,1,0,1,1,78,77,96,96,55
"5086",85,"[30]wJHggyqIHBidKpcJvcGHqFdCFjclbt",180,0.994475,30,181,1,180,1,1,0,1,1,102,101,79,79,55
"5087",86,"[30]wJHggyqIHBidKpcJvcGHqFdCFjclbt",176,0.99435,30,177,1,176,1,1,0,1,1,91,90,86,86,55
"5088",87,"[30]wJHggyqIHBidKpcJvcGHqFdCFjclbt",173,0.994253,30,174,1,173,1,1,0,1,1,80,79,94,94,55
"5089",88,"[30]wJHggyqIHBidKpcJvcGHqFdCFjclbt",181,0.994505,30,182,1,181,1,1,0,1,1,104,103,78,78,55
"5090",89,"[30]wJHggyqIHBidKpcJvcGHqFdCFjclbt",180,0.994475,30,181,1,180,1,1,0,1,1,101,100,80,80,55
"5091",90,"[30]wJHggyqIHBidKpcJvcGHqFdCFjclbt",179,0.994444,30,180,1,179,1,1,0,1,1,100,99,80,80,55
"5092",91,"[30]wJHggyqIHBidKpcJvcGHqFdCFjclbt",178,0.994413,30,179,1,178,1,1,0,1,1,94,93,85,85,55
"5093",92,"[30]wJHggyqIHBidKpcJvcGHqFdCFjclbt",178,0.994413,30,179,1,178,1,1,0,1,1,96,95,83,83,55
"5094",93,"[30]wJHggyqIHBidKpcJvcGHqFdCFjclbt",175,0.994318,30,176,1,175,1,1,0,1,1,86,85,90,90,55
"5095",94,"[30]wJHggyqIHBidKpcJvcGHqFdCFjclbt",174,0.994286,30,175,1,174,1,1,0,1,1,83,82,92,92,55
"5096",95,"[30]wJHggyqIHBidKpcJvcGHqFdCFjclbt",178,0.994413,30,179,1,178,1,1,0,1,1,97,96,82,82,55
"5097",96,"[30]wJHggyqIHBidKpcJvcGHqFdCFjclbt",173,0.994253,30,174,1,173,1,1,0,1,1,79,78,95,95,55
"5098",97,"[30]wJHggyqIHBidKpcJvcGHqFdCFjclbt",182,0.994536,30,183,1,182,1,1,0,1,1,109,108,74,74,55
"5099",98,"[30]wJHggyqIHBidKpcJvcGHqFdCFjclbt",176,0.99435,30,177,1,176,1,1,0,1,1,90,89,87,87,55
"5100",99,"[30]wJHggyqIHBidKpcJvcGHqFdCFjclbt",175,0.994318,30,176,1,175,1,1,0,1,1,87,86,89,89,55
"5101",0,"[26]eJHggqiIHcdKocJvcGHqxdCBHf",169,0.994118,26,170,1,169,1,1,0,1,1,91,90,79,79,56
"5102",1,"[26]eJHggqiIHcdKocJvcGHqxdCBHf",170,0.994152,26,171,1,170,1,1,0,1,1,91,90,80,80,56
"5103",2,"[26]eJHggqiIHcdKocJvcGHqxdCBHf",166,0.994012,26,167,1,166,1,1,0,1,1,82,81,85,85,56
"5104",3,"[26]eJHggqiIHcdKocJvcGHqxdCBHf",169,0.994118,26,170,1,169,1,1,0,1,1,91,90,79,79,56
"5105",4,"[26]eJHggqiIHcdKocJvcGHqxdCBHf",171,0.994186,26,172,1,171,1,1,0,1,1,94,93,78,78,56
"5106",5,"[26]eJHggqiIHcdKocJvcGHqxdCBHf",165,0.993976,26,166,1,165,1,1,0,1,1,79,78,87,87,56
"5107",6,"[26]eJHggqiIHcdKocJvcGHqxdCBHf",169,0.994118,26,170,1,169,1,1,0,1,1,90,89,80,80,56
"5108",7,"[26]eJHggqiIHcdKocJvcGHqxdCBHf",171,0.994186,26,172,1,171,1,1,0,1,1,96,95,76,76,56
"5109",8,"[26]eJHggqiIHcdKocJvcGHqxdCBHf",165,0.993976,26,166,1,165,1,1,0,1,1,80,79,86,86,56
"5110",9,"[26]eJHggqiIHcdKocJvcGHqxdCBHf",167,0.994048,26,168,1,167,1,1,0,1,1,85,84,83,83,56
"5111",10,"[26]eJHggqiIHcdKocJvcGHqxdCBHf",168,0.994083,26,169,1,168,1,1,0,1,1,83,82,86,86,56
"5112",11,"[26]eJHggqiIHcdKocJvcGHqxdCBHf",165,0.993976,26,166,1,165,1,1,0,1,1,78,77,88,88,56
"5113",12,"[26]eJHggqiIHcdKocJvcGHqxdCBHf",164,0.993939,26,165,1,164,1,1,0,1,1,77,76,88,88,56
"5114",13,"[26]eJHggqiIHcdKocJvcGHqxdCBHf",169,0.994118,26,170,1,169,1,1,0,1,1,89,88,81,81,56
"5115",14,"[26]eJHggqiIHcdKocJvcGHqxdCBHf",167,0.994048,26,168,1,167,1,1,0,1,1,84,83,84,84,56
"5116",15,"[26]eJHggqiIHcdKocJvcGHqxdCBHf",168,0.994083,26,169,1,168,1,1,0,1,1,88,87,81,81,56
"5117",16,"[26]eJHggqiIHcdKocJvcGHqxdCBHf",166,0.994012,26,167,1,166,1,1,0,1,1,82,81,85,85,56
"5118",17,"[26]eJHggqiIHcdKocJvcGHqxdCBHf",168,0.994083,26,169,1,168,1,1,0,1,1,87,86,82,82,56
"5119",18,"[26]eJHggqiIHcdKocJvcGHqxdCBHf",165,0.993976,26,166,1,165,1,1,0,1,1,79,78,87,87,56
"5120",19,"[26]eJHggqiIHcdKocJvcGHqxdCBHf",164,0.993939,26,165,1,164,1,1,0,1,1,77,76,88,88,56
"5121",20,"[26]eJHggqiIHcdKocJvcGHqxdCBHf",165,0.993976,26,166,1,165,1,1,0,1,1,79,78,87,87,56
"5122",21,"[26]eJHggqiIHcdKocJvcGHqxdCBHf",165,0.993976,26,166,1,165,1,1,0,1,1,79,78,87,87,56
"5123",22,"[26]eJHggqiIHcdKocJvcGHqxdCBHf",169,0.994118,26,170,1,169,1,1,0,1,1,90,89,80,80,56
"5124",23,"[26]eJHggqiIHcdKocJvcGHqxdCBHf",167,0.994048,26,168,1,167,1,1,0,1,1,85,84,83,83,56
"5125",24,"[26]eJHggqiIHcdKocJvcGHqxdCBHf",164,0.993939,26,165,1,164,1,1,0,1,1,76,75,89,89,56
"5126",25,"[26]eJHggqiIHcdKocJvcGHqxdCBHf",162,0.993865,26,163,1,162,1,1,0,1,1,71,70,92,92,56
"5127",26,"[26]eJHggqiIHcdKocJvcGHqxdCBHf",165,0.993976,26,166,1,165,1,1,0,1,1,80,79,86,86,56
"5128",27,"[26]eJHggqiIHcdKocJvcGHqxdCBHf",166,0.994012,26,167,1,166,1,1,0,1,1,82,81,85,85,56
"5129",28,"[26]eJHggqiIHcdKocJvcGHqxdCBHf",169,0.994118,26,170,1,169,1,1,0,1,1,90,89,80,80,56
"5130",29,"[26]eJHggqiIHcdKocJvcGHqxdCBHf",165,0.993976,26,166,1,165,1,1,0,1,1,79,78,87,87,56
"5131",30,"[26]eJHggqiIHcdKocJvcGHqxdCBHf",171,0.994186,26,172,1,171,1,1,0,1,1,95,94,77,77,56
"5132",31,"[26]eJHggqiIHcdKocJvcGHqxdCBHf",167,0.994048,26,168,1,167,1,1,0,1,1,86,85,82,82,56
"5133",32,"[26]eJHggqiIHcdKocJvcGHqxdCBHf",166,0.994012,26,167,1,166,1,1,0,1,1,81,80,86,86,56
"5134",33,"[26]eJHggqiIHcdKocJvcGHqxdCBHf",169,0.994118,26,170,1,169,1,1,0,1,1,90,89,80,80,56
"5135",34,"[26]eJHggqiIHcdKocJvcGHqxdCBHf",164,0.993939,26,165,1,164,1,1,0,1,1,75,74,90,90,56
"5136",35,"[26]eJHggqiIHcdKocJvcGHqxdCBHf",164,0.993939,26,165,1,164,1,1,0,1,1,78,77,87,87,56
"5137",36,"[26]eJHggqiIHcdKocJvcGHqxdCBHf",166,0.994012,26,167,1,166,1,1,0,1,1,83,82,84,84,56
"5138",37,"[26]eJHggqiIHcdKocJvcGHqxdCBHf",168,0.994083,26,169,1,168,1,1,0,1,1,89,88,80,80,56
"5139",38,"[26]eJHggqiIHcdKocJvcGHqxdCBHf",169,0.994118,26,170,1,169,1,1,0,1,1,90,89,80,80,56
"5140",39,"[26]eJHggqiIHcdKocJvcGHqxdCBHf",170,0.994152,26,171,1,170,1,1,0,1,1,93,92,78,78,56
"5141",40,"[26]eJHggqiIHcdKocJvcGHqxdCBHf",165,0.993976,26,166,1,165,1,1,0,1,1,80,79,86,86,56
"5142",41,"[26]eJHggqiIHcdKocJvcGHqxdCBHf",172,0.99422,26,173,1,172,1,1,0,1,1,100,99,73,73,56
"5143",42,"[26]eJHggqiIHcdKocJvcGHqxdCBHf",168,0.994083,26,169,1,168,1,1,0,1,1,87,86,82,82,56
"5144",43,"[26]eJHggqiIHcdKocJvcGHqxdCBHf",167,0.994048,26,168,1,167,1,1,0,1,1,85,84,83,83,56
"5145",44,"[26]eJHggqiIHcdKocJvcGHqxdCBHf",164,0.993939,26,165,1,164,1,1,0,1,1,76,75,89,89,56
"5146",45,"[26]eJHggqiIHcdKocJvcGHqxdCBHf",168,0.994083,26,169,1,168,1,1,0,1,1,89,88,80,80,56
"5147",46,"[26]eJHggqiIHcdKocJvcGHqxdCBHf",165,0.993976,26,166,1,165,1,1,0,1,1,79,78,87,87,56
"5148",47,"[26]eJHggqiIHcdKocJvcGHqxdCBHf",170,0.994152,26,171,1,170,1,1,0,1,1,93,92,78,78,56
"5149",48,"[26]eJHggqiIHcdKocJvcGHqxdCBHf",167,0.994048,26,168,1,167,1,1,0,1,1,86,85,82,82,56
"5150",49,"[26]eJHggqiIHcdKocJvcGHqxdCBHf",166,0.994012,26,167,1,166,1,1,0,1,1,79,78,88,88,56
"5151",50,"[26]eJHggqiIHcdKocJvcGHqxdCBHf",162,0.993865,26,163,1,162,1,1,0,1,1,70,69,93,93,56
"5152",51,"[26]eJHggqiIHcdKocJvcGHqxdCBHf",165,0.993976,26,166,1,165,1,1,0,1,1,79,78,87,87,56
"5153",52,"[26]eJHggqiIHcdKocJvcGHqxdCBHf",168,0.994083,26,169,1,168,1,1,0,1,1,89,88,80,80,56
"5154",53,"[26]eJHggqiIHcdKocJvcGHqxdCBHf",173,0.994253,26,174,1,173,1,1,0,1,1,102,101,72,72,56
"5155",54,"[26]eJHggqiIHcdKocJvcGHqxdCBHf",166,0.994012,26,167,1,166,1,1,0,1,1,82,81,85,85,56
"5156",55,"[26]eJHggqiIHcdKocJvcGHqxdCBHf",164,0.993939,26,165,1,164,1,1,0,1,1,76,75,89,89,56
"5157",56,"[26]eJHggqiIHcdKocJvcGHqxdCBHf",169,0.994118,26,170,1,169,1,1,0,1,1,90,89,80,80,56
"5158",57,"[26]eJHggqiIHcdKocJvcGHqxdCBHf",168,0.994083,26,169,1,168,1,1,0,1,1,87,86,82,82,56
"5159",58,"[26]eJHggqiIHcdKocJvcGHqxdCBHf",167,0.994048,26,168,1,167,1,1,0,1,1,84,83,84,84,56
"5160",59,"[26]eJHggqiIHcdKocJvcGHqxdCBHf",169,0.994118,26,170,1,169,1,1,0,1,1,90,89,80,80,56
"5161",60,"[26]eJHggqiIHcdKocJvcGHqxdCBHf",166,0.994012,26,167,1,166,1,1,0,1,1,82,81,85,85,56
"5162",61,"[26]eJHggqiIHcdKocJvcGHqxdCBHf",167,0.994048,26,168,1,167,1,1,0,1,1,85,84,83,83,56
"5163",62,"[26]eJHggqiIHcdKocJvcGHqxdCBHf",169,0.994118,26,170,1,169,1,1,0,1,1,91,90,79,79,56
"5164",63,"[26]eJHggqiIHcdKocJvcGHqxdCBHf",167,0.994048,26,168,1,167,1,1,0,1,1,85,84,83,83,56
"5165",64,"[26]eJHggqiIHcdKocJvcGHqxdCBHf",167,0.994048,26,168,1,167,1,1,0,1,1,84,83,84,84,56
"5166",65,"[26]eJHggqiIHcdKocJvcGHqxdCBHf",169,0.994118,26,170,1,169,1,1,0,1,1,90,89,80,80,56
"5167",66,"[26]eJHggqiIHcdKocJvcGHqxdCBHf",163,0.993902,26,164,1,163,1,1,0,1,1,75,74,89,89,56
"5168",67,"[26]eJHggqiIHcdKocJvcGHqxdCBHf",174,0.994286,26,175,1,174,1,1,0,1,1,103,102,72,72,56
"5169",68,"[26]eJHggqiIHcdKocJvcGHqxdCBHf",170,0.994152,26,171,1,170,1,1,0,1,1,94,93,77,77,56
"5170",69,"[26]eJHggqiIHcdKocJvcGHqxdCBHf",167,0.994048,26,168,1,167,1,1,0,1,1,85,84,83,83,56
"5171",70,"[26]eJHggqiIHcdKocJvcGHqxdCBHf",165,0.993976,26,166,1,165,1,1,0,1,1,79,78,87,87,56
"5172",71,"[26]eJHggqiIHcdKocJvcGHqxdCBHf",173,0.994253,26,174,1,173,1,1,0,1,1,102,101,72,72,56
"5173",72,"[26]eJHggqiIHcdKocJvcGHqxdCBHf",168,0.994083,26,169,1,168,1,1,0,1,1,87,86,82,82,56
"5174",73,"[26]eJHggqiIHcdKocJvcGHqxdCBHf",165,0.993976,26,166,1,165,1,1,0,1,1,79,78,87,87,56
"5175",74,"[26]eJHggqiIHcdKocJvcGHqxdCBHf",167,0.994048,26,168,1,167,1,1,0,1,1,84,83,84,84,56
"5176",75,"[26]eJHggqiIHcdKocJvcGHqxdCBHf",166,0.994012,26,167,1,166,1,1,0,1,1,81,80,86,86,56
"5177",76,"[26]eJHggqiIHcdKocJvcGHqxdCBHf",161,0.993827,26,162,1,161,1,1,0,1,1,68,67,94,94,56
"5178",77,"[26]eJHggqiIHcdKocJvcGHqxdCBHf",168,0.994083,26,169,1,168,1,1,0,1,1,87,86,82,82,56
"5179",78,"[26]eJHggqiIHcdKocJvcGHqxdCBHf",165,0.993976,26,166,1,165,1,1,0,1,1,80,79,86,86,56
"5180",79,"[26]eJHggqiIHcdKocJvcGHqxdCBHf",171,0.994186,26,172,1,171,1,1,0,1,1,97,96,75,75,56
"5181",80,"[26]eJHggqiIHcdKocJvcGHqxdCBHf",165,0.993976,26,166,1,165,1,1,0,1,1,80,79,86,86,56
"5182",81,"[26]eJHggqiIHcdKocJvcGHqxdCBHf",165,0.993976,26,166,1,165,1,1,0,1,1,79,78,87,87,56
"5183",82,"[26]eJHggqiIHcdKocJvcGHqxdCBHf",165,0.993976,26,166,1,165,1,1,0,1,1,80,79,86,86,56
"5184",83,"[26]eJHggqiIHcdKocJvcGHqxdCBHf",166,0.994012,26,167,1,166,1,1,0,1,1,83,82,84,84,56
"5185",84,"[26]eJHggqiIHcdKocJvcGHqxdCBHf",166,0.994012,26,167,1,166,1,1,0,1,1,81,80,86,86,56
"5186",85,"[26]eJHggqiIHcdKocJvcGHqxdCBHf",166,0.994012,26,167,1,166,1,1,0,1,1,82,81,85,85,56
"5187",86,"[26]eJHggqiIHcdKocJvcGHqxdCBHf",166,0.994012,26,167,1,166,1,1,0,1,1,80,79,87,87,56
"5188",87,"[26]eJHggqiIHcdKocJvcGHqxdCBHf",167,0.994048,26,168,1,167,1,1,0,1,1,86,85,82,82,56
"5189",88,"[26]eJHggqiIHcdKocJvcGHqxdCBHf",160,0.993789,26,161,1,160,1,1,0,1,1,67,66,94,94,56
"5190",89,"[26]eJHggqiIHcdKocJvcGHqxdCBHf",167,0.994048,26,168,1,167,1,1,0,1,1,85,84,83,83,56
"5191",90,"[26]eJHggqiIHcdKocJvcGHqxdCBHf",167,0.994048,26,168,1,167,1,1,0,1,1,85,84,83,83,56
"5192",91,"[26]eJHggqiIHcdKocJvcGHqxdCBHf",165,0.993976,26,166,1,165,1,1,0,1,1,79,78,87,87,56
"5193",92,"[26]eJHggqiIHcdKocJvcGHqxdCBHf",168,0.994083,26,169,1,168,1,1,0,1,1,88,87,81,81,56
"5194",93,"[26]eJHggqiIHcdKocJvcGHqxdCBHf",167,0.994048,26,168,1,167,1,1,0,1,1,86,85,82,82,56
"5195",94,"[26]eJHggqiIHcdKocJvcGHqxdCBHf",165,0.993976,26,166,1,165,1,1,0,1,1,79,78,87,87,56
"5196",95,"[26]eJHggqiIHcdKocJvcGHqxdCBHf",170,0.994152,26,171,1,170,1,1,0,1,1,91,90,80,80,56
"5197",96,"[26]eJHggqiIHcdKocJvcGHqxdCBHf",169,0.994118,26,170,1,169,1,1,0,1,1,89,88,81,81,56
"5198",97,"[26]eJHggqiIHcdKocJvcGHqxdCBHf",161,0.993827,26,162,1,161,1,1,0,1,1,69,68,93,93,56
"5199",98,"[26]eJHggqiIHcdKocJvcGHqxdCBHf",168,0.994083,26,169,1,168,1,1,0,1,1,89,88,80,80,56
"5200",99,"[26]eJHggqiIHcdKocJvcGHqxdCBHf",170,0.994152,26,171,1,170,1,1,0,1,1,92,91,79,79,56
"5201",0,"[33]rJHggqIeHBidKocJvcGHqFdCKdyozdDgw",177,0.994382,33,178,1,177,1,1,0,1,1,89,88,89,89,57
"5202",1,"[33]rJHggqIeHBidKocJvcGHqFdCKdyozdDgw",173,0.994253,33,174,1,173,1,1,0,1,1,79,78,95,95,57
"5203",2,"[33]rJHggqIeHBidKocJvcGHqFdCKdyozdDgw",181,0.994505,33,182,1,181,1,1,0,1,1,104,103,78,78,57
"5204",3,"[33]rJHggqIeHBidKocJvcGHqFdCKdyozdDgw",176,0.99435,33,177,1,176,1,1,0,1,1,90,89,87,87,57
"5205",4,"[33]rJHggqIeHBidKocJvcGHqFdCKdyozdDgw",177,0.994382,33,178,1,177,1,1,0,1,1,93,92,85,85,57
"5206",5,"[33]rJHggqIeHBidKocJvcGHqFdCKdyozdDgw",177,0.994382,33,178,1,177,1,1,0,1,1,92,91,86,86,57
"5207",6,"[33]rJHggqIeHBidKocJvcGHqFdCKdyozdDgw",175,0.994318,33,176,1,175,1,1,0,1,1,87,86,89,89,57
"5208",7,"[33]rJHggqIeHBidKocJvcGHqFdCKdyozdDgw",183,0.994565,33,184,1,183,1,1,0,1,1,114,113,70,70,57
"5209",8,"[33]rJHggqIeHBidKocJvcGHqFdCKdyozdDgw",181,0.994505,33,182,1,181,1,1,0,1,1,100,99,82,82,57
"5210",9,"[33]rJHggqIeHBidKocJvcGHqFdCKdyozdDgw",172,0.99422,33,173,1,172,1,1,0,1,1,76,75,97,97,57
"5211",10,"[33]rJHggqIeHBidKocJvcGHqFdCKdyozdDgw",175,0.994318,33,176,1,175,1,1,0,1,1,87,86,89,89,57
"5212",11,"[33]rJHggqIeHBidKocJvcGHqFdCKdyozdDgw",176,0.99435,33,177,1,176,1,1,0,1,1,89,88,88,88,57
"5213",12,"[33]rJHggqIeHBidKocJvcGHqFdCKdyozdDgw",178,0.994413,33,179,1,178,1,1,0,1,1,97,96,82,82,57
"5214",13,"[33]rJHggqIeHBidKocJvcGHqFdCKdyozdDgw",177,0.994382,33,178,1,177,1,1,0,1,1,91,90,87,87,57
"5215",14,"[33]rJHggqIeHBidKocJvcGHqFdCKdyozdDgw",180,0.994475,33,181,1,180,1,1,0,1,1,99,98,82,82,57
"5216",15,"[33]rJHggqIeHBidKocJvcGHqFdCKdyozdDgw",176,0.99435,33,177,1,176,1,1,0,1,1,90,89,87,87,57
"5217",16,"[33]rJHggqIeHBidKocJvcGHqFdCKdyozdDgw",179,0.994444,33,180,1,179,1,1,0,1,1,100,99,80,80,57
"5218",17,"[33]rJHggqIeHBidKocJvcGHqFdCKdyozdDgw",173,0.994253,33,174,1,173,1,1,0,1,1,80,79,94,94,57
"5219",18,"[33]rJHggqIeHBidKocJvcGHqFdCKdyozdDgw",173,0.994253,33,174,1,173,1,1,0,1,1,78,77,96,96,57
"5220",19,"[33]rJHggqIeHBidKocJvcGHqFdCKdyozdDgw",177,0.994382,33,178,1,177,1,1,0,1,1,92,91,86,86,57
"5221",20,"[33]rJHggqIeHBidKocJvcGHqFdCKdyozdDgw",180,0.994475,33,181,1,180,1,1,0,1,1,103,102,78,78,57
"5222",21,"[33]rJHggqIeHBidKocJvcGHqFdCKdyozdDgw",175,0.994318,33,176,1,175,1,1,0,1,1,86,85,90,90,57
"5223",22,"[33]rJHggqIeHBidKocJvcGHqFdCKdyozdDgw",174,0.994286,33,175,1,174,1,1,0,1,1,82,81,93,93,57
"5224",23,"[33]rJHggqIeHBidKocJvcGHqFdCKdyozdDgw",176,0.99435,33,177,1,176,1,1,0,1,1,88,87,89,89,57
"5225",24,"[33]rJHggqIeHBidKocJvcGHqFdCKdyozdDgw",178,0.994413,33,179,1,178,1,1,0,1,1,97,96,82,82,57
"5226",25,"[33]rJHggqIeHBidKocJvcGHqFdCKdyozdDgw",175,0.994318,33,176,1,175,1,1,0,1,1,87,86,89,89,57
"5227",26,"[33]rJHggqIeHBidKocJvcGHqFdCKdyozdDgw",177,0.994382,33,178,1,177,1,1,0,1,1,92,91,86,86,57
"5228",27,"[33]rJHggqIeHBidKocJvcGHqFdCKdyozdDgw",173,0.994253,33,174,1,173,1,1,0,1,1,81,80,93,93,57
"5229",28,"[33]rJHggqIeHBidKocJvcGHqFdCKdyozdDgw",175,0.994318,33,176,1,175,1,1,0,1,1,86,85,90,90,57
"5230",29,"[33]rJHggqIeHBidKocJvcGHqFdCKdyozdDgw",174,0.994286,33,175,1,174,1,1,0,1,1,82,81,93,93,57
"5231",30,"[33]rJHggqIeHBidKocJvcGHqFdCKdyozdDgw",176,0.99435,33,177,1,176,1,1,0,1,1,90,89,87,87,57
"5232",31,"[33]rJHggqIeHBidKocJvcGHqFdCKdyozdDgw",172,0.99422,33,173,1,172,1,1,0,1,1,76,75,97,97,57
"5233",32,"[33]rJHggqIeHBidKocJvcGHqFdCKdyozdDgw",175,0.994318,33,176,1,175,1,1,0,1,1,84,83,92,92,57
"5234",33,"[33]rJHggqIeHBidKocJvcGHqFdCKdyozdDgw",177,0.994382,33,178,1,177,1,1,0,1,1,92,91,86,86,57
"5235",34,"[33]rJHggqIeHBidKocJvcGHqFdCKdyozdDgw",175,0.994318,33,176,1,175,1,1,0,1,1,85,84,91,91,57
"5236",35,"[33]rJHggqIeHBidKocJvcGHqFdCKdyozdDgw",177,0.994382,33,178,1,177,1,1,0,1,1,92,91,86,86,57
"5237",36,"[33]rJHggqIeHBidKocJvcGHqFdCKdyozdDgw",172,0.99422,33,173,1,172,1,1,0,1,1,77,76,96,96,57
"5238",37,"[33]rJHggqIeHBidKocJvcGHqFdCKdyozdDgw",174,0.994286,33,175,1,174,1,1,0,1,1,84,83,91,91,57
"5239",38,"[33]rJHggqIeHBidKocJvcGHqFdCKdyozdDgw",176,0.99435,33,177,1,176,1,1,0,1,1,90,89,87,87,57
"5240",39,"[33]rJHggqIeHBidKocJvcGHqFdCKdyozdDgw",173,0.994253,33,174,1,173,1,1,0,1,1,79,78,95,95,57
"5241",40,"[33]rJHggqIeHBidKocJvcGHqFdCKdyozdDgw",177,0.994382,33,178,1,177,1,1,0,1,1,88,87,90,90,57
"5242",41,"[33]rJHggqIeHBidKocJvcGHqFdCKdyozdDgw",174,0.994286,33,175,1,174,1,1,0,1,1,82,81,93,93,57
"5243",42,"[33]rJHggqIeHBidKocJvcGHqFdCKdyozdDgw",180,0.994475,33,181,1,180,1,1,0,1,1,100,99,81,81,57
"5244",43,"[33]rJHggqIeHBidKocJvcGHqFdCKdyozdDgw",174,0.994286,33,175,1,174,1,1,0,1,1,82,81,93,93,57
"5245",44,"[33]rJHggqIeHBidKocJvcGHqFdCKdyozdDgw",177,0.994382,33,178,1,177,1,1,0,1,1,93,92,85,85,57
"5246",45,"[33]rJHggqIeHBidKocJvcGHqFdCKdyozdDgw",177,0.994382,33,178,1,177,1,1,0,1,1,93,92,85,85,57
"5247",46,"[33]rJHggqIeHBidKocJvcGHqFdCKdyozdDgw",179,0.994444,33,180,1,179,1,1,0,1,1,99,98,81,81,57
"5248",47,"[33]rJHggqIeHBidKocJvcGHqFdCKdyozdDgw",175,0.994318,33,176,1,175,1,1,0,1,1,86,85,90,90,57
"5249",48,"[33]rJHggqIeHBidKocJvcGHqFdCKdyozdDgw",178,0.994413,33,179,1,178,1,1,0,1,1,95,94,84,84,57
"5250",49,"[33]rJHggqIeHBidKocJvcGHqFdCKdyozdDgw",180,0.994475,33,181,1,180,1,1,0,1,1,102,101,79,79,57
"5251",50,"[33]rJHggqIeHBidKocJvcGHqFdCKdyozdDgw",173,0.994253,33,174,1,173,1,1,0,1,1,80,79,94,94,57
"5252",51,"[33]rJHggqIeHBidKocJvcGHqFdCKdyozdDgw",177,0.994382,33,178,1,177,1,1,0,1,1,93,92,85,85,57
"5253",52,"[33]rJHggqIeHBidKocJvcGHqFdCKdyozdDgw",175,0.994318,33,176,1,175,1,1,0,1,1,85,84,91,91,57
"5254",53,"[33]rJHggqIeHBidKocJvcGHqFdCKdyozdDgw",178,0.994413,33,179,1,178,1,1,0,1,1,96,95,83,83,57
"5255",54,"[33]rJHggqIeHBidKocJvcGHqFdCKdyozdDgw",174,0.994286,33,175,1,174,1,1,0,1,1,84,83,91,91,57
"5256",55,"[33]rJHggqIeHBidKocJvcGHqFdCKdyozdDgw",175,0.994318,33,176,1,175,1,1,0,1,1,84,83,92,92,57
"5257",56,"[33]rJHggqIeHBidKocJvcGHqFdCKdyozdDgw",177,0.994382,33,178,1,177,1,1,0,1,1,93,92,85,85,57
"5258",57,"[33]rJHggqIeHBidKocJvcGHqFdCKdyozdDgw",175,0.994318,33,176,1,175,1,1,0,1,1,84,83,92,92,57
"5259",58,"[33]rJHggqIeHBidKocJvcGHqFdCKdyozdDgw",181,0.994505,33,182,1,181,1,1,0,1,1,103,102,79,79,57
"5260",59,"[33]rJHggqIeHBidKocJvcGHqFdCKdyozdDgw",174,0.994286,33,175,1,174,1,1,0,1,1,82,81,93,93,57
"5261",60,"[33]rJHggqIeHBidKocJvcGHqFdCKdyozdDgw",175,0.994318,33,176,1,175,1,1,0,1,1,86,85,90,90,57
"5262",61,"[33]rJHggqIeHBidKocJvcGHqFdCKdyozdDgw",177,0.994382,33,178,1,177,1,1,0,1,1,93,92,85,85,57
"5263",62,"[33]rJHggqIeHBidKocJvcGHqFdCKdyozdDgw",178,0.994413,33,179,1,178,1,1,0,1,1,96,95,83,83,57
"5264",63,"[33]rJHggqIeHBidKocJvcGHqFdCKdyozdDgw",176,0.99435,33,177,1,176,1,1,0,1,1,90,89,87,87,57
"5265",64,"[33]rJHggqIeHBidKocJvcGHqFdCKdyozdDgw",178,0.994413,33,179,1,178,1,1,0,1,1,94,93,85,85,57
"5266",65,"[33]rJHggqIeHBidKocJvcGHqFdCKdyozdDgw",179,0.994444,33,180,1,179,1,1,0,1,1,98,97,82,82,57
"5267",66,"[33]rJHggqIeHBidKocJvcGHqFdCKdyozdDgw",180,0.994475,33,181,1,180,1,1,0,1,1,100,99,81,81,57
"5268",67,"[33]rJHggqIeHBidKocJvcGHqFdCKdyozdDgw",177,0.994382,33,178,1,177,1,1,0,1,1,88,87,90,90,57
"5269",68,"[33]rJHggqIeHBidKocJvcGHqFdCKdyozdDgw",176,0.99435,33,177,1,176,1,1,0,1,1,89,88,88,88,57
"5270",69,"[33]rJHggqIeHBidKocJvcGHqFdCKdyozdDgw",171,0.994186,33,172,1,171,1,1,0,1,1,74,73,98,98,57
"5271",70,"[33]rJHggqIeHBidKocJvcGHqFdCKdyozdDgw",178,0.994413,33,179,1,178,1,1,0,1,1,94,93,85,85,57
"5272",71,"[33]rJHggqIeHBidKocJvcGHqFdCKdyozdDgw",173,0.994253,33,174,1,173,1,1,0,1,1,80,79,94,94,57
"5273",72,"[33]rJHggqIeHBidKocJvcGHqFdCKdyozdDgw",179,0.994444,33,180,1,179,1,1,0,1,1,100,99,80,80,57
"5274",73,"[33]rJHggqIeHBidKocJvcGHqFdCKdyozdDgw",175,0.994318,33,176,1,175,1,1,0,1,1,85,84,91,91,57
"5275",74,"[33]rJHggqIeHBidKocJvcGHqFdCKdyozdDgw",176,0.99435,33,177,1,176,1,1,0,1,1,88,87,89,89,57
"5276",75,"[33]rJHggqIeHBidKocJvcGHqFdCKdyozdDgw",177,0.994382,33,178,1,177,1,1,0,1,1,92,91,86,86,57
"5277",76,"[33]rJHggqIeHBidKocJvcGHqFdCKdyozdDgw",175,0.994318,33,176,1,175,1,1,0,1,1,83,82,93,93,57
"5278",77,"[33]rJHggqIeHBidKocJvcGHqFdCKdyozdDgw",178,0.994413,33,179,1,178,1,1,0,1,1,95,94,84,84,57
"5279",78,"[33]rJHggqIeHBidKocJvcGHqFdCKdyozdDgw",181,0.994505,33,182,1,181,1,1,0,1,1,105,104,77,77,57
"5280",79,"[33]rJHggqIeHBidKocJvcGHqFdCKdyozdDgw",177,0.994382,33,178,1,177,1,1,0,1,1,92,91,86,86,57
"5281",80,"[33]rJHggqIeHBidKocJvcGHqFdCKdyozdDgw",175,0.994318,33,176,1,175,1,1,0,1,1,85,84,91,91,57
"5282",81,"[33]rJHggqIeHBidKocJvcGHqFdCKdyozdDgw",178,0.994413,33,179,1,178,1,1,0,1,1,96,95,83,83,57
"5283",82,"[33]rJHggqIeHBidKocJvcGHqFdCKdyozdDgw",176,0.99435,33,177,1,176,1,1,0,1,1,88,87,89,89,57
"5284",83,"[33]rJHggqIeHBidKocJvcGHqFdCKdyozdDgw",179,0.994444,33,180,1,179,1,1,0,1,1,99,98,81,81,57
"5285",84,"[33]rJHggqIeHBidKocJvcGHqFdCKdyozdDgw",173,0.994253,33,174,1,173,1,1,0,1,1,80,79,94,94,57
"5286",85,"[33]rJHggqIeHBidKocJvcGHqFdCKdyozdDgw",172,0.99422,33,173,1,172,1,1,0,1,1,77,76,96,96,57
"5287",86,"[33]rJHggqIeHBidKocJvcGHqFdCKdyozdDgw",179,0.994444,33,180,1,179,1,1,0,1,1,98,97,82,82,57
"5288",87,"[33]rJHggqIeHBidKocJvcGHqFdCKdyozdDgw",176,0.99435,33,177,1,176,1,1,0,1,1,89,88,88,88,57
"5289",88,"[33]rJHggqIeHBidKocJvcGHqFdCKdyozdDgw",177,0.994382,33,178,1,177,1,1,0,1,1,93,92,85,85,57
"5290",89,"[33]rJHggqIeHBidKocJvcGHqFdCKdyozdDgw",176,0.99435,33,177,1,176,1,1,0,1,1,89,88,88,88,57
"5291",90,"[33]rJHggqIeHBidKocJvcGHqFdCKdyozdDgw",179,0.994444,33,180,1,179,1,1,0,1,1,98,97,82,82,57
"5292",91,"[33]rJHggqIeHBidKocJvcGHqFdCKdyozdDgw",179,0.994444,33,180,1,179,1,1,0,1,1,100,99,80,80,57
"5293",92,"[33]rJHggqIeHBidKocJvcGHqFdCKdyozdDgw",175,0.994318,33,176,1,175,1,1,0,1,1,85,84,91,91,57
"5294",93,"[33]rJHggqIeHBidKocJvcGHqFdCKdyozdDgw",177,0.994382,33,178,1,177,1,1,0,1,1,91,90,87,87,57
"5295",94,"[33]rJHggqIeHBidKocJvcGHqFdCKdyozdDgw",179,0.994444,33,180,1,179,1,1,0,1,1,98,97,82,82,57
"5296",95,"[33]rJHggqIeHBidKocJvcGHqFdCKdyozdDgw",173,0.994253,33,174,1,173,1,1,0,1,1,79,78,95,95,57
"5297",96,"[33]rJHggqIeHBidKocJvcGHqFdCKdyozdDgw",177,0.994382,33,178,1,177,1,1,0,1,1,89,88,89,89,57
"5298",97,"[33]rJHggqIeHBidKocJvcGHqFdCKdyozdDgw",173,0.994253,33,174,1,173,1,1,0,1,1,80,79,94,94,57
"5299",98,"[33]rJHggqIeHBidKocJvcGHqFdCKdyozdDgw",179,0.994444,33,180,1,179,1,1,0,1,1,92,91,88,88,57
"5300",99,"[33]rJHggqIeHBidKocJvcGHqFdCKdyozdDgw",176,0.99435,33,177,1,176,1,1,0,1,1,91,90,86,86,57
"5301",0,"[31]cJHggqIFdHcdKocJvcGHqvdCDHtkfvn",165,0.993976,31,166,1,165,1,1,0,1,1,80,79,86,86,58
"5302",1,"[31]cJHggqIFdHcdKocJvcGHqvdCDHtkfvn",167,0.994048,31,168,1,167,1,1,0,1,1,85,84,83,83,58
"5303",2,"[31]cJHggqIFdHcdKocJvcGHqvdCDHtkfvn",168,0.994083,31,169,1,168,1,1,0,1,1,87,86,82,82,58
"5304",3,"[31]cJHggqIFdHcdKocJvcGHqvdCDHtkfvn",164,0.993939,31,165,1,164,1,1,0,1,1,76,75,89,89,58
"5305",4,"[31]cJHggqIFdHcdKocJvcGHqvdCDHtkfvn",164,0.993939,31,165,1,164,1,1,0,1,1,78,77,87,87,58
"5306",5,"[31]cJHggqIFdHcdKocJvcGHqvdCDHtkfvn",169,0.994118,31,170,1,169,1,1,0,1,1,90,89,80,80,58
"5307",6,"[31]cJHggqIFdHcdKocJvcGHqvdCDHtkfvn",168,0.994083,31,169,1,168,1,1,0,1,1,88,87,81,81,58
"5308",7,"[31]cJHggqIFdHcdKocJvcGHqvdCDHtkfvn",167,0.994048,31,168,1,167,1,1,0,1,1,85,84,83,83,58
"5309",8,"[31]cJHggqIFdHcdKocJvcGHqvdCDHtkfvn",167,0.994048,31,168,1,167,1,1,0,1,1,86,85,82,82,58
"5310",9,"[31]cJHggqIFdHcdKocJvcGHqvdCDHtkfvn",165,0.993976,31,166,1,165,1,1,0,1,1,79,78,87,87,58
"5311",10,"[31]cJHggqIFdHcdKocJvcGHqvdCDHtkfvn",161,0.993827,31,162,1,161,1,1,0,1,1,70,69,92,92,58
"5312",11,"[31]cJHggqIFdHcdKocJvcGHqvdCDHtkfvn",168,0.994083,31,169,1,168,1,1,0,1,1,88,87,81,81,58
"5313",12,"[31]cJHggqIFdHcdKocJvcGHqvdCDHtkfvn",170,0.994152,31,171,1,170,1,1,0,1,1,93,92,78,78,58
"5314",13,"[31]cJHggqIFdHcdKocJvcGHqvdCDHtkfvn",166,0.994012,31,167,1,166,1,1,0,1,1,83,82,84,84,58
"5315",14,"[31]cJHggqIFdHcdKocJvcGHqvdCDHtkfvn",167,0.994048,31,168,1,167,1,1,0,1,1,86,85,82,82,58
"5316",15,"[31]cJHggqIFdHcdKocJvcGHqvdCDHtkfvn",167,0.994048,31,168,1,167,1,1,0,1,1,84,83,84,84,58
"5317",16,"[31]cJHggqIFdHcdKocJvcGHqvdCDHtkfvn",166,0.994012,31,167,1,166,1,1,0,1,1,83,82,84,84,58
"5318",17,"[31]cJHggqIFdHcdKocJvcGHqvdCDHtkfvn",168,0.994083,31,169,1,168,1,1,0,1,1,88,87,81,81,58
"5319",18,"[31]cJHggqIFdHcdKocJvcGHqvdCDHtkfvn",169,0.994118,31,170,1,169,1,1,0,1,1,90,89,80,80,58
"5320",19,"[31]cJHggqIFdHcdKocJvcGHqvdCDHtkfvn",165,0.993976,31,166,1,165,1,1,0,1,1,80,79,86,86,58
"5321",20,"[31]cJHggqIFdHcdKocJvcGHqvdCDHtkfvn",161,0.993827,31,162,1,161,1,1,0,1,1,69,68,93,93,58
"5322",21,"[31]cJHggqIFdHcdKocJvcGHqvdCDHtkfvn",166,0.994012,31,167,1,166,1,1,0,1,1,83,82,84,84,58
"5323",22,"[31]cJHggqIFdHcdKocJvcGHqvdCDHtkfvn",165,0.993976,31,166,1,165,1,1,0,1,1,81,80,85,85,58
"5324",23,"[31]cJHggqIFdHcdKocJvcGHqvdCDHtkfvn",169,0.994118,31,170,1,169,1,1,0,1,1,91,90,79,79,58
"5325",24,"[31]cJHggqIFdHcdKocJvcGHqvdCDHtkfvn",166,0.994012,31,167,1,166,1,1,0,1,1,83,82,84,84,58
"5326",25,"[31]cJHggqIFdHcdKocJvcGHqvdCDHtkfvn",163,0.993902,31,164,1,163,1,1,0,1,1,75,74,89,89,58
"5327",26,"[31]cJHggqIFdHcdKocJvcGHqvdCDHtkfvn",167,0.994048,31,168,1,167,1,1,0,1,1,85,84,83,83,58
"5328",27,"[31]cJHggqIFdHcdKocJvcGHqvdCDHtkfvn",168,0.994083,31,169,1,168,1,1,0,1,1,87,86,82,82,58
"5329",28,"[31]cJHggqIFdHcdKocJvcGHqvdCDHtkfvn",172,0.99422,31,173,1,172,1,1,0,1,1,99,98,74,74,58
"5330",29,"[31]cJHggqIFdHcdKocJvcGHqvdCDHtkfvn",167,0.994048,31,168,1,167,1,1,0,1,1,86,85,82,82,58
"5331",30,"[31]cJHggqIFdHcdKocJvcGHqvdCDHtkfvn",168,0.994083,31,169,1,168,1,1,0,1,1,87,86,82,82,58
"5332",31,"[31]cJHggqIFdHcdKocJvcGHqvdCDHtkfvn",167,0.994048,31,168,1,167,1,1,0,1,1,86,85,82,82,58
"5333",32,"[31]cJHggqIFdHcdKocJvcGHqvdCDHtkfvn",170,0.994152,31,171,1,170,1,1,0,1,1,93,92,78,78,58
"5334",33,"[31]cJHggqIFdHcdKocJvcGHqvdCDHtkfvn",174,0.994286,31,175,1,174,1,1,0,1,1,103,102,72,72,58
"5335",34,"[31]cJHggqIFdHcdKocJvcGHqvdCDHtkfvn",168,0.994083,31,169,1,168,1,1,0,1,1,86,85,83,83,58
"5336",35,"[31]cJHggqIFdHcdKocJvcGHqvdCDHtkfvn",161,0.993827,31,162,1,161,1,1,0,1,1,69,68,93,93,58
"5337",36,"[31]cJHggqIFdHcdKocJvcGHqvdCDHtkfvn",168,0.994083,31,169,1,168,1,1,0,1,1,89,88,80,80,58
"5338",37,"[31]cJHggqIFdHcdKocJvcGHqvdCDHtkfvn",163,0.993902,31,164,1,163,1,1,0,1,1,74,73,90,90,58
"5339",38,"[31]cJHggqIFdHcdKocJvcGHqvdCDHtkfvn",170,0.994152,31,171,1,170,1,1,0,1,1,91,90,80,80,58
"5340",39,"[31]cJHggqIFdHcdKocJvcGHqvdCDHtkfvn",166,0.994012,31,167,1,166,1,1,0,1,1,82,81,85,85,58
"5341",40,"[31]cJHggqIFdHcdKocJvcGHqvdCDHtkfvn",163,0.993902,31,164,1,163,1,1,0,1,1,74,73,90,90,58
"5342",41,"[31]cJHggqIFdHcdKocJvcGHqvdCDHtkfvn",167,0.994048,31,168,1,167,1,1,0,1,1,84,83,84,84,58
"5343",42,"[31]cJHggqIFdHcdKocJvcGHqvdCDHtkfvn",173,0.994253,31,174,1,173,1,1,0,1,1,101,100,73,73,58
"5344",43,"[31]cJHggqIFdHcdKocJvcGHqvdCDHtkfvn",162,0.993865,31,163,1,162,1,1,0,1,1,72,71,91,91,58
"5345",44,"[31]cJHggqIFdHcdKocJvcGHqvdCDHtkfvn",163,0.993902,31,164,1,163,1,1,0,1,1,71,70,93,93,58
"5346",45,"[31]cJHggqIFdHcdKocJvcGHqvdCDHtkfvn",165,0.993976,31,166,1,165,1,1,0,1,1,80,79,86,86,58
"5347",46,"[31]cJHggqIFdHcdKocJvcGHqvdCDHtkfvn",168,0.994083,31,169,1,168,1,1,0,1,1,87,86,82,82,58
"5348",47,"[31]cJHggqIFdHcdKocJvcGHqvdCDHtkfvn",169,0.994118,31,170,1,169,1,1,0,1,1,88,87,82,82,58
"5349",48,"[31]cJHggqIFdHcdKocJvcGHqvdCDHtkfvn",162,0.993865,31,163,1,162,1,1,0,1,1,72,71,91,91,58
"5350",49,"[31]cJHggqIFdHcdKocJvcGHqvdCDHtkfvn",167,0.994048,31,168,1,167,1,1,0,1,1,86,85,82,82,58
"5351",50,"[31]cJHggqIFdHcdKocJvcGHqvdCDHtkfvn",164,0.993939,31,165,1,164,1,1,0,1,1,77,76,88,88,58
"5352",51,"[31]cJHggqIFdHcdKocJvcGHqvdCDHtkfvn",169,0.994118,31,170,1,169,1,1,0,1,1,89,88,81,81,58
"5353",52,"[31]cJHggqIFdHcdKocJvcGHqvdCDHtkfvn",172,0.99422,31,173,1,172,1,1,0,1,1,98,97,75,75,58
"5354",53,"[31]cJHggqIFdHcdKocJvcGHqvdCDHtkfvn",167,0.994048,31,168,1,167,1,1,0,1,1,86,85,82,82,58
"5355",54,"[31]cJHggqIFdHcdKocJvcGHqvdCDHtkfvn",169,0.994118,31,170,1,169,1,1,0,1,1,91,90,79,79,58
"5356",55,"[31]cJHggqIFdHcdKocJvcGHqvdCDHtkfvn",173,0.994253,31,174,1,173,1,1,0,1,1,103,102,71,71,58
"5357",56,"[31]cJHggqIFdHcdKocJvcGHqvdCDHtkfvn",167,0.994048,31,168,1,167,1,1,0,1,1,84,83,84,84,58
"5358",57,"[31]cJHggqIFdHcdKocJvcGHqvdCDHtkfvn",168,0.994083,31,169,1,168,1,1,0,1,1,88,87,81,81,58
"5359",58,"[31]cJHggqIFdHcdKocJvcGHqvdCDHtkfvn",171,0.994186,31,172,1,171,1,1,0,1,1,96,95,76,76,58
"5360",59,"[31]cJHggqIFdHcdKocJvcGHqvdCDHtkfvn",165,0.993976,31,166,1,165,1,1,0,1,1,80,79,86,86,58
"5361",60,"[31]cJHggqIFdHcdKocJvcGHqvdCDHtkfvn",164,0.993939,31,165,1,164,1,1,0,1,1,78,77,87,87,58
"5362",61,"[31]cJHggqIFdHcdKocJvcGHqvdCDHtkfvn",169,0.994118,31,170,1,169,1,1,0,1,1,90,89,80,80,58
"5363",62,"[31]cJHggqIFdHcdKocJvcGHqvdCDHtkfvn",170,0.994152,31,171,1,170,1,1,0,1,1,92,91,79,79,58
"5364",63,"[31]cJHggqIFdHcdKocJvcGHqvdCDHtkfvn",172,0.99422,31,173,1,172,1,1,0,1,1,98,97,75,75,58
"5365",64,"[31]cJHggqIFdHcdKocJvcGHqvdCDHtkfvn",165,0.993976,31,166,1,165,1,1,0,1,1,80,79,86,86,58
"5366",65,"[31]cJHggqIFdHcdKocJvcGHqvdCDHtkfvn",168,0.994083,31,169,1,168,1,1,0,1,1,87,86,82,82,58
"5367",66,"[31]cJHggqIFdHcdKocJvcGHqvdCDHtkfvn",165,0.993976,31,166,1,165,1,1,0,1,1,78,77,88,88,58
"5368",67,"[31]cJHggqIFdHcdKocJvcGHqvdCDHtkfvn",168,0.994083,31,169,1,168,1,1,0,1,1,88,87,81,81,58
"5369",68,"[31]cJHggqIFdHcdKocJvcGHqvdCDHtkfvn",169,0.994118,31,170,1,169,1,1,0,1,1,90,89,80,80,58
"5370",69,"[31]cJHggqIFdHcdKocJvcGHqvdCDHtkfvn",169,0.994118,31,170,1,169,1,1,0,1,1,90,89,80,80,58
"5371",70,"[31]cJHggqIFdHcdKocJvcGHqvdCDHtkfvn",168,0.994083,31,169,1,168,1,1,0,1,1,88,87,81,81,58
"5372",71,"[31]cJHggqIFdHcdKocJvcGHqvdCDHtkfvn",170,0.994152,31,171,1,170,1,1,0,1,1,94,93,77,77,58
"5373",72,"[31]cJHggqIFdHcdKocJvcGHqvdCDHtkfvn",169,0.994118,31,170,1,169,1,1,0,1,1,89,88,81,81,58
"5374",73,"[31]cJHggqIFdHcdKocJvcGHqvdCDHtkfvn",169,0.994118,31,170,1,169,1,1,0,1,1,90,89,80,80,58
"5375",74,"[31]cJHggqIFdHcdKocJvcGHqvdCDHtkfvn",167,0.994048,31,168,1,167,1,1,0,1,1,85,84,83,83,58
"5376",75,"[31]cJHggqIFdHcdKocJvcGHqvdCDHtkfvn",168,0.994083,31,169,1,168,1,1,0,1,1,88,87,81,81,58
"5377",76,"[31]cJHggqIFdHcdKocJvcGHqvdCDHtkfvn",161,0.993827,31,162,1,161,1,1,0,1,1,70,69,92,92,58
"5378",77,"[31]cJHggqIFdHcdKocJvcGHqvdCDHtkfvn",170,0.994152,31,171,1,170,1,1,0,1,1,94,93,77,77,58
"5379",78,"[31]cJHggqIFdHcdKocJvcGHqvdCDHtkfvn",162,0.993865,31,163,1,162,1,1,0,1,1,72,71,91,91,58
"5380",79,"[31]cJHggqIFdHcdKocJvcGHqvdCDHtkfvn",165,0.993976,31,166,1,165,1,1,0,1,1,80,79,86,86,58
"5381",80,"[31]cJHggqIFdHcdKocJvcGHqvdCDHtkfvn",171,0.994186,31,172,1,171,1,1,0,1,1,97,96,75,75,58
"5382",81,"[31]cJHggqIFdHcdKocJvcGHqvdCDHtkfvn",169,0.994118,31,170,1,169,1,1,0,1,1,90,89,80,80,58
"5383",82,"[31]cJHggqIFdHcdKocJvcGHqvdCDHtkfvn",166,0.994012,31,167,1,166,1,1,0,1,1,83,82,84,84,58
"5384",83,"[31]cJHggqIFdHcdKocJvcGHqvdCDHtkfvn",167,0.994048,31,168,1,167,1,1,0,1,1,84,83,84,84,58
"5385",84,"[31]cJHggqIFdHcdKocJvcGHqvdCDHtkfvn",164,0.993939,31,165,1,164,1,1,0,1,1,77,76,88,88,58
"5386",85,"[31]cJHggqIFdHcdKocJvcGHqvdCDHtkfvn",164,0.993939,31,165,1,164,1,1,0,1,1,78,77,87,87,58
"5387",86,"[31]cJHggqIFdHcdKocJvcGHqvdCDHtkfvn",166,0.994012,31,167,1,166,1,1,0,1,1,83,82,84,84,58
"5388",87,"[31]cJHggqIFdHcdKocJvcGHqvdCDHtkfvn",166,0.994012,31,167,1,166,1,1,0,1,1,83,82,84,84,58
"5389",88,"[31]cJHggqIFdHcdKocJvcGHqvdCDHtkfvn",161,0.993827,31,162,1,161,1,1,0,1,1,68,67,94,94,58
"5390",89,"[31]cJHggqIFdHcdKocJvcGHqvdCDHtkfvn",162,0.993865,31,163,1,162,1,1,0,1,1,70,69,93,93,58
"5391",90,"[31]cJHggqIFdHcdKocJvcGHqvdCDHtkfvn",166,0.994012,31,167,1,166,1,1,0,1,1,82,81,85,85,58
"5392",91,"[31]cJHggqIFdHcdKocJvcGHqvdCDHtkfvn",167,0.994048,31,168,1,167,1,1,0,1,1,83,82,85,85,58
"5393",92,"[31]cJHggqIFdHcdKocJvcGHqvdCDHtkfvn",169,0.994118,31,170,1,169,1,1,0,1,1,88,87,82,82,58
"5394",93,"[31]cJHggqIFdHcdKocJvcGHqvdCDHtkfvn",166,0.994012,31,167,1,166,1,1,0,1,1,82,81,85,85,58
"5395",94,"[31]cJHggqIFdHcdKocJvcGHqvdCDHtkfvn",173,0.994253,31,174,1,173,1,1,0,1,1,102,101,72,72,58
"5396",95,"[31]cJHggqIFdHcdKocJvcGHqvdCDHtkfvn",164,0.993939,31,165,1,164,1,1,0,1,1,78,77,87,87,58
"5397",96,"[31]cJHggqIFdHcdKocJvcGHqvdCDHtkfvn",164,0.993939,31,165,1,164,1,1,0,1,1,78,77,87,87,58
"5398",97,"[31]cJHggqIFdHcdKocJvcGHqvdCDHtkfvn",165,0.993976,31,166,1,165,1,1,0,1,1,80,79,86,86,58
"5399",98,"[31]cJHggqIFdHcdKocJvcGHqvdCDHtkfvn",166,0.994012,31,167,1,166,1,1,0,1,1,82,81,85,85,58
"5400",99,"[31]cJHggqIFdHcdKocJvcGHqvdCDHtkfvn",166,0.994012,31,167,1,166,1,1,0,1,1,81,80,86,86,58
"5401",0,"[28]GJHglqIBHcGldKpcJvcGHqFdCqwn",175,0.994318,28,176,1,175,1,1,0,1,1,87,86,89,89,59
"5402",1,"[28]GJHglqIBHcGldKpcJvcGHqFdCqwn",177,0.994382,28,178,1,177,1,1,0,1,1,95,94,83,83,59
"5403",2,"[28]GJHglqIBHcGldKpcJvcGHqFdCqwn",177,0.994382,28,178,1,177,1,1,0,1,1,93,92,85,85,59
"5404",3,"[28]GJHglqIBHcGldKpcJvcGHqFdCqwn",173,0.994253,28,174,1,173,1,1,0,1,1,81,80,93,93,59
"5405",4,"[28]GJHglqIBHcGldKpcJvcGHqFdCqwn",175,0.994318,28,176,1,175,1,1,0,1,1,87,86,89,89,59
"5406",5,"[28]GJHglqIBHcGldKpcJvcGHqFdCqwn",176,0.99435,28,177,1,176,1,1,0,1,1,89,88,88,88,59
"5407",6,"[28]GJHglqIBHcGldKpcJvcGHqFdCqwn",176,0.99435,28,177,1,176,1,1,0,1,1,90,89,87,87,59
"5408",7,"[28]GJHglqIBHcGldKpcJvcGHqFdCqwn",177,0.994382,28,178,1,177,1,1,0,1,1,93,92,85,85,59
"5409",8,"[28]GJHglqIBHcGldKpcJvcGHqFdCqwn",175,0.994318,28,176,1,175,1,1,0,1,1,86,85,90,90,59
"5410",9,"[28]GJHglqIBHcGldKpcJvcGHqFdCqwn",171,0.994186,28,172,1,171,1,1,0,1,1,73,72,99,99,59
"5411",10,"[28]GJHglqIBHcGldKpcJvcGHqFdCqwn",173,0.994253,28,174,1,173,1,1,0,1,1,81,80,93,93,59
"5412",11,"[28]GJHglqIBHcGldKpcJvcGHqFdCqwn",176,0.99435,28,177,1,176,1,1,0,1,1,88,87,89,89,59
"5413",12,"[28]GJHglqIBHcGldKpcJvcGHqFdCqwn",177,0.994382,28,178,1,177,1,1,0,1,1,94,93,84,84,59
"5414",13,"[28]GJHglqIBHcGldKpcJvcGHqFdCqwn",179,0.994444,28,180,1,179,1,1,0,1,1,100,99,80,80,59
"5415",14,"[28]GJHglqIBHcGldKpcJvcGHqFdCqwn",182,0.994536,28,183,1,182,1,1,0,1,1,110,109,73,73,59
"5416",15,"[28]GJHglqIBHcGldKpcJvcGHqFdCqwn",175,0.994318,28,176,1,175,1,1,0,1,1,87,86,89,89,59
"5417",16,"[28]GJHglqIBHcGldKpcJvcGHqFdCqwn",176,0.99435,28,177,1,176,1,1,0,1,1,90,89,87,87,59
"5418",17,"[28]GJHglqIBHcGldKpcJvcGHqFdCqwn",179,0.994444,28,180,1,179,1,1,0,1,1,100,99,80,80,59
"5419",18,"[28]GJHglqIBHcGldKpcJvcGHqFdCqwn",175,0.994318,28,176,1,175,1,1,0,1,1,87,86,89,89,59
"5420",19,"[28]GJHglqIBHcGldKpcJvcGHqFdCqwn",174,0.994286,28,175,1,174,1,1,0,1,1,84,83,91,91,59
"5421",20,"[28]GJHglqIBHcGldKpcJvcGHqFdCqwn",176,0.99435,28,177,1,176,1,1,0,1,1,92,91,85,85,59
"5422",21,"[28]GJHglqIBHcGldKpcJvcGHqFdCqwn",174,0.994286,28,175,1,174,1,1,0,1,1,84,83,91,91,59
"5423",22,"[28]GJHglqIBHcGldKpcJvcGHqFdCqwn",174,0.994286,28,175,1,174,1,1,0,1,1,84,83,91,91,59
"5424",23,"[28]GJHglqIBHcGldKpcJvcGHqFdCqwn",179,0.994444,28,180,1,179,1,1,0,1,1,101,100,79,79,59
"5425",24,"[28]GJHglqIBHcGldKpcJvcGHqFdCqwn",176,0.99435,28,177,1,176,1,1,0,1,1,91,90,86,86,59
"5426",25,"[28]GJHglqIBHcGldKpcJvcGHqFdCqwn",174,0.994286,28,175,1,174,1,1,0,1,1,84,83,91,91,59
"5427",26,"[28]GJHglqIBHcGldKpcJvcGHqFdCqwn",176,0.99435,28,177,1,176,1,1,0,1,1,91,90,86,86,59
"5428",27,"[28]GJHglqIBHcGldKpcJvcGHqFdCqwn",177,0.994382,28,178,1,177,1,1,0,1,1,92,91,86,86,59
"5429",28,"[28]GJHglqIBHcGldKpcJvcGHqFdCqwn",173,0.994253,28,174,1,173,1,1,0,1,1,80,79,94,94,59
"5430",29,"[28]GJHglqIBHcGldKpcJvcGHqFdCqwn",171,0.994186,28,172,1,171,1,1,0,1,1,75,74,97,97,59
"5431",30,"[28]GJHglqIBHcGldKpcJvcGHqFdCqwn",178,0.994413,28,179,1,178,1,1,0,1,1,98,97,81,81,59
"5432",31,"[28]GJHglqIBHcGldKpcJvcGHqFdCqwn",181,0.994505,28,182,1,181,1,1,0,1,1,104,103,78,78,59
"5433",32,"[28]GJHglqIBHcGldKpcJvcGHqFdCqwn",174,0.994286,28,175,1,174,1,1,0,1,1,84,83,91,91,59
"5434",33,"[28]GJHglqIBHcGldKpcJvcGHqFdCqwn",175,0.994318,28,176,1,175,1,1,0,1,1,88,87,88,88,59
"5435",34,"[28]GJHglqIBHcGldKpcJvcGHqFdCqwn",175,0.994318,28,176,1,175,1,1,0,1,1,86,85,90,90,59
"5436",35,"[28]GJHglqIBHcGldKpcJvcGHqFdCqwn",177,0.994382,28,178,1,177,1,1,0,1,1,88,87,90,90,59
"5437",36,"[28]GJHglqIBHcGldKpcJvcGHqFdCqwn",177,0.994382,28,178,1,177,1,1,0,1,1,95,94,83,83,59
"5438",37,"[28]GJHglqIBHcGldKpcJvcGHqFdCqwn",177,0.994382,28,178,1,177,1,1,0,1,1,94,93,84,84,59
"5439",38,"[28]GJHglqIBHcGldKpcJvcGHqFdCqwn",175,0.994318,28,176,1,175,1,1,0,1,1,86,85,90,90,59
"5440",39,"[28]GJHglqIBHcGldKpcJvcGHqFdCqwn",178,0.994413,28,179,1,178,1,1,0,1,1,97,96,82,82,59
"5441",40,"[28]GJHglqIBHcGldKpcJvcGHqFdCqwn",175,0.994318,28,176,1,175,1,1,0,1,1,85,84,91,91,59
"5442",41,"[28]GJHglqIBHcGldKpcJvcGHqFdCqwn",179,0.994444,28,180,1,179,1,1,0,1,1,102,101,78,78,59
"5443",42,"[28]GJHglqIBHcGldKpcJvcGHqFdCqwn",177,0.994382,28,178,1,177,1,1,0,1,1,94,93,84,84,59
"5444",43,"[28]GJHglqIBHcGldKpcJvcGHqFdCqwn",173,0.994253,28,174,1,173,1,1,0,1,1,80,79,94,94,59
"5445",44,"[28]GJHglqIBHcGldKpcJvcGHqFdCqwn",179,0.994444,28,180,1,179,1,1,0,1,1,99,98,81,81,59
"5446",45,"[28]GJHglqIBHcGldKpcJvcGHqFdCqwn",176,0.99435,28,177,1,176,1,1,0,1,1,91,90,86,86,59
"5447",46,"[28]GJHglqIBHcGldKpcJvcGHqFdCqwn",171,0.994186,28,172,1,171,1,1,0,1,1,75,74,97,97,59
"5448",47,"[28]GJHglqIBHcGldKpcJvcGHqFdCqwn",175,0.994318,28,176,1,175,1,1,0,1,1,86,85,90,90,59
"5449",48,"[28]GJHglqIBHcGldKpcJvcGHqFdCqwn",176,0.99435,28,177,1,176,1,1,0,1,1,92,91,85,85,59
"5450",49,"[28]GJHglqIBHcGldKpcJvcGHqFdCqwn",178,0.994413,28,179,1,178,1,1,0,1,1,97,96,82,82,59
"5451",50,"[28]GJHglqIBHcGldKpcJvcGHqFdCqwn",175,0.994318,28,176,1,175,1,1,0,1,1,87,86,89,89,59
"5452",51,"[28]GJHglqIBHcGldKpcJvcGHqFdCqwn",178,0.994413,28,179,1,178,1,1,0,1,1,97,96,82,82,59
"5453",52,"[28]GJHglqIBHcGldKpcJvcGHqFdCqwn",174,0.994286,28,175,1,174,1,1,0,1,1,83,82,92,92,59
"5454",53,"[28]GJHglqIBHcGldKpcJvcGHqFdCqwn",178,0.994413,28,179,1,178,1,1,0,1,1,96,95,83,83,59
"5455",54,"[28]GJHglqIBHcGldKpcJvcGHqFdCqwn",176,0.99435,28,177,1,176,1,1,0,1,1,91,90,86,86,59
"5456",55,"[28]GJHglqIBHcGldKpcJvcGHqFdCqwn",172,0.99422,28,173,1,172,1,1,0,1,1,77,76,96,96,59
"5457",56,"[28]GJHglqIBHcGldKpcJvcGHqFdCqwn",173,0.994253,28,174,1,173,1,1,0,1,1,82,81,92,92,59
"5458",57,"[28]GJHglqIBHcGldKpcJvcGHqFdCqwn",175,0.994318,28,176,1,175,1,1,0,1,1,85,84,91,91,59
"5459",58,"[28]GJHglqIBHcGldKpcJvcGHqFdCqwn",177,0.994382,28,178,1,177,1,1,0,1,1,90,89,88,88,59
"5460",59,"[28]GJHglqIBHcGldKpcJvcGHqFdCqwn",172,0.99422,28,173,1,172,1,1,0,1,1,78,77,95,95,59
"5461",60,"[28]GJHglqIBHcGldKpcJvcGHqFdCqwn",176,0.99435,28,177,1,176,1,1,0,1,1,91,90,86,86,59
"5462",61,"[28]GJHglqIBHcGldKpcJvcGHqFdCqwn",173,0.994253,28,174,1,173,1,1,0,1,1,82,81,92,92,59
"5463",62,"[28]GJHglqIBHcGldKpcJvcGHqFdCqwn",175,0.994318,28,176,1,175,1,1,0,1,1,87,86,89,89,59
"5464",63,"[28]GJHglqIBHcGldKpcJvcGHqFdCqwn",178,0.994413,28,179,1,178,1,1,0,1,1,96,95,83,83,59
"5465",64,"[28]GJHglqIBHcGldKpcJvcGHqFdCqwn",176,0.99435,28,177,1,176,1,1,0,1,1,91,90,86,86,59
"5466",65,"[28]GJHglqIBHcGldKpcJvcGHqFdCqwn",172,0.99422,28,173,1,172,1,1,0,1,1,77,76,96,96,59
"5467",66,"[28]GJHglqIBHcGldKpcJvcGHqFdCqwn",178,0.994413,28,179,1,178,1,1,0,1,1,93,92,86,86,59
"5468",67,"[28]GJHglqIBHcGldKpcJvcGHqFdCqwn",177,0.994382,28,178,1,177,1,1,0,1,1,95,94,83,83,59
"5469",68,"[28]GJHglqIBHcGldKpcJvcGHqFdCqwn",175,0.994318,28,176,1,175,1,1,0,1,1,88,87,88,88,59
"5470",69,"[28]GJHglqIBHcGldKpcJvcGHqFdCqwn",176,0.99435,28,177,1,176,1,1,0,1,1,89,88,88,88,59
"5471",70,"[28]GJHglqIBHcGldKpcJvcGHqFdCqwn",178,0.994413,28,179,1,178,1,1,0,1,1,96,95,83,83,59
"5472",71,"[28]GJHglqIBHcGldKpcJvcGHqFdCqwn",174,0.994286,28,175,1,174,1,1,0,1,1,85,84,90,90,59
"5473",72,"[28]GJHglqIBHcGldKpcJvcGHqFdCqwn",172,0.99422,28,173,1,172,1,1,0,1,1,75,74,98,98,59
"5474",73,"[28]GJHglqIBHcGldKpcJvcGHqFdCqwn",175,0.994318,28,176,1,175,1,1,0,1,1,88,87,88,88,59
"5475",74,"[28]GJHglqIBHcGldKpcJvcGHqFdCqwn",176,0.99435,28,177,1,176,1,1,0,1,1,88,87,89,89,59
"5476",75,"[28]GJHglqIBHcGldKpcJvcGHqFdCqwn",177,0.994382,28,178,1,177,1,1,0,1,1,92,91,86,86,59
"5477",76,"[28]GJHglqIBHcGldKpcJvcGHqFdCqwn",179,0.994444,28,180,1,179,1,1,0,1,1,101,100,79,79,59
"5478",77,"[28]GJHglqIBHcGldKpcJvcGHqFdCqwn",174,0.994286,28,175,1,174,1,1,0,1,1,84,83,91,91,59
"5479",78,"[28]GJHglqIBHcGldKpcJvcGHqFdCqwn",176,0.99435,28,177,1,176,1,1,0,1,1,90,89,87,87,59
"5480",79,"[28]GJHglqIBHcGldKpcJvcGHqFdCqwn",176,0.99435,28,177,1,176,1,1,0,1,1,92,91,85,85,59
"5481",80,"[28]GJHglqIBHcGldKpcJvcGHqFdCqwn",174,0.994286,28,175,1,174,1,1,0,1,1,85,84,90,90,59
"5482",81,"[28]GJHglqIBHcGldKpcJvcGHqFdCqwn",178,0.994413,28,179,1,178,1,1,0,1,1,95,94,84,84,59
"5483",82,"[28]GJHglqIBHcGldKpcJvcGHqFdCqwn",176,0.99435,28,177,1,176,1,1,0,1,1,90,89,87,87,59
"5484",83,"[28]GJHglqIBHcGldKpcJvcGHqFdCqwn",175,0.994318,28,176,1,175,1,1,0,1,1,87,86,89,89,59
"5485",84,"[28]GJHglqIBHcGldKpcJvcGHqFdCqwn",175,0.994318,28,176,1,175,1,1,0,1,1,86,85,90,90,59
"5486",85,"[28]GJHglqIBHcGldKpcJvcGHqFdCqwn",173,0.994253,28,174,1,173,1,1,0,1,1,79,78,95,95,59
"5487",86,"[28]GJHglqIBHcGldKpcJvcGHqFdCqwn",174,0.994286,28,175,1,174,1,1,0,1,1,84,83,91,91,59
"5488",87,"[28]GJHglqIBHcGldKpcJvcGHqFdCqwn",175,0.994318,28,176,1,175,1,1,0,1,1,87,86,89,89,59
"5489",88,"[28]GJHglqIBHcGldKpcJvcGHqFdCqwn",175,0.994318,28,176,1,175,1,1,0,1,1,86,85,90,90,59
"5490",89,"[28]GJHglqIBHcGldKpcJvcGHqFdCqwn",174,0.994286,28,175,1,174,1,1,0,1,1,85,84,90,90,59
"5491",90,"[28]GJHglqIBHcGldKpcJvcGHqFdCqwn",170,0.994152,28,171,1,170,1,1,0,1,1,72,71,99,99,59
"5492",91,"[28]GJHglqIBHcGldKpcJvcGHqFdCqwn",177,0.994382,28,178,1,177,1,1,0,1,1,95,94,83,83,59
"5493",92,"[28]GJHglqIBHcGldKpcJvcGHqFdCqwn",171,0.994186,28,172,1,171,1,1,0,1,1,74,73,98,98,59
"5494",93,"[28]GJHglqIBHcGldKpcJvcGHqFdCqwn",176,0.99435,28,177,1,176,1,1,0,1,1,91,90,86,86,59
"5495",94,"[28]GJHglqIBHcGldKpcJvcGHqFdCqwn",177,0.994382,28,178,1,177,1,1,0,1,1,94,93,84,84,59
"5496",95,"[28]GJHglqIBHcGldKpcJvcGHqFdCqwn",177,0.994382,28,178,1,177,1,1,0,1,1,94,93,84,84,59
"5497",96,"[28]GJHglqIBHcGldKpcJvcGHqFdCqwn",175,0.994318,28,176,1,175,1,1,0,1,1,86,85,90,90,59
"5498",97,"[28]GJHglqIBHcGldKpcJvcGHqFdCqwn",180,0.994475,28,181,1,180,1,1,0,1,1,103,102,78,78,59
"5499",98,"[28]GJHglqIBHcGldKpcJvcGHqFdCqwn",174,0.994286,28,175,1,174,1,1,0,1,1,82,81,93,93,59
"5500",99,"[28]GJHglqIBHcGldKpcJvcGHqFdCqwn",177,0.994382,28,178,1,177,1,1,0,1,1,94,93,84,84,59
"5501",0,"[29]zJbgHqaIHcidKpcJvcGHqFdCiKAtm",173,0.994253,29,174,1,173,1,1,0,1,1,78,77,96,96,60
"5502",1,"[29]zJbgHqaIHcidKpcJvcGHqFdCiKAtm",176,0.99435,29,177,1,176,1,1,0,1,1,89,88,88,88,60
"5503",2,"[29]zJbgHqaIHcidKpcJvcGHqFdCiKAtm",178,0.994413,29,179,1,178,1,1,0,1,1,95,94,84,84,60
"5504",3,"[29]zJbgHqaIHcidKpcJvcGHqFdCiKAtm",171,0.994186,29,172,1,171,1,1,0,1,1,74,73,98,98,60
"5505",4,"[29]zJbgHqaIHcidKpcJvcGHqFdCiKAtm",179,0.994444,29,180,1,179,1,1,0,1,1,100,99,80,80,60
"5506",5,"[29]zJbgHqaIHcidKpcJvcGHqFdCiKAtm",176,0.99435,29,177,1,176,1,1,0,1,1,88,87,89,89,60
"5507",6,"[29]zJbgHqaIHcidKpcJvcGHqFdCiKAtm",176,0.99435,29,177,1,176,1,1,0,1,1,89,88,88,88,60
"5508",7,"[29]zJbgHqaIHcidKpcJvcGHqFdCiKAtm",176,0.99435,29,177,1,176,1,1,0,1,1,90,89,87,87,60
"5509",8,"[29]zJbgHqaIHcidKpcJvcGHqFdCiKAtm",181,0.994505,29,182,1,181,1,1,0,1,1,107,106,75,75,60
"5510",9,"[29]zJbgHqaIHcidKpcJvcGHqFdCiKAtm",179,0.994444,29,180,1,179,1,1,0,1,1,99,98,81,81,60
"5511",10,"[29]zJbgHqaIHcidKpcJvcGHqFdCiKAtm",172,0.99422,29,173,1,172,1,1,0,1,1,74,73,99,99,60
"5512",11,"[29]zJbgHqaIHcidKpcJvcGHqFdCiKAtm",176,0.99435,29,177,1,176,1,1,0,1,1,88,87,89,89,60
"5513",12,"[29]zJbgHqaIHcidKpcJvcGHqFdCiKAtm",177,0.994382,29,178,1,177,1,1,0,1,1,92,91,86,86,60
"5514",13,"[29]zJbgHqaIHcidKpcJvcGHqFdCiKAtm",172,0.99422,29,173,1,172,1,1,0,1,1,77,76,96,96,60
"5515",14,"[29]zJbgHqaIHcidKpcJvcGHqFdCiKAtm",170,0.994152,29,171,1,170,1,1,0,1,1,71,70,100,100,60
"5516",15,"[29]zJbgHqaIHcidKpcJvcGHqFdCiKAtm",178,0.994413,29,179,1,178,1,1,0,1,1,94,93,85,85,60
"5517",16,"[29]zJbgHqaIHcidKpcJvcGHqFdCiKAtm",172,0.99422,29,173,1,172,1,1,0,1,1,76,75,97,97,60
"5518",17,"[29]zJbgHqaIHcidKpcJvcGHqFdCiKAtm",177,0.994382,29,178,1,177,1,1,0,1,1,88,87,90,90,60
"5519",18,"[29]zJbgHqaIHcidKpcJvcGHqFdCiKAtm",177,0.994382,29,178,1,177,1,1,0,1,1,93,92,85,85,60
"5520",19,"[29]zJbgHqaIHcidKpcJvcGHqFdCiKAtm",174,0.994286,29,175,1,174,1,1,0,1,1,81,80,94,94,60
"5521",20,"[29]zJbgHqaIHcidKpcJvcGHqFdCiKAtm",179,0.994444,29,180,1,179,1,1,0,1,1,99,98,81,81,60
"5522",21,"[29]zJbgHqaIHcidKpcJvcGHqFdCiKAtm",180,0.994475,29,181,1,180,1,1,0,1,1,104,103,77,77,60
"5523",22,"[29]zJbgHqaIHcidKpcJvcGHqFdCiKAtm",174,0.994286,29,175,1,174,1,1,0,1,1,83,82,92,92,60
"5524",23,"[29]zJbgHqaIHcidKpcJvcGHqFdCiKAtm",176,0.99435,29,177,1,176,1,1,0,1,1,89,88,88,88,60
"5525",24,"[29]zJbgHqaIHcidKpcJvcGHqFdCiKAtm",173,0.994253,29,174,1,173,1,1,0,1,1,79,78,95,95,60
"5526",25,"[29]zJbgHqaIHcidKpcJvcGHqFdCiKAtm",179,0.994444,29,180,1,179,1,1,0,1,1,98,97,82,82,60
"5527",26,"[29]zJbgHqaIHcidKpcJvcGHqFdCiKAtm",177,0.994382,29,178,1,177,1,1,0,1,1,91,90,87,87,60
"5528",27,"[29]zJbgHqaIHcidKpcJvcGHqFdCiKAtm",179,0.994444,29,180,1,179,1,1,0,1,1,98,97,82,82,60
"5529",28,"[29]zJbgHqaIHcidKpcJvcGHqFdCiKAtm",176,0.99435,29,177,1,176,1,1,0,1,1,91,90,86,86,60
"5530",29,"[29]zJbgHqaIHcidKpcJvcGHqFdCiKAtm",178,0.994413,29,179,1,178,1,1,0,1,1,95,94,84,84,60
"5531",30,"[29]zJbgHqaIHcidKpcJvcGHqFdCiKAtm",176,0.99435,29,177,1,176,1,1,0,1,1,89,88,88,88,60
"5532",31,"[29]zJbgHqaIHcidKpcJvcGHqFdCiKAtm",177,0.994382,29,178,1,177,1,1,0,1,1,93,92,85,85,60
"5533",32,"[29]zJbgHqaIHcidKpcJvcGHqFdCiKAtm",175,0.994318,29,176,1,175,1,1,0,1,1,86,85,90,90,60
"5534",33,"[29]zJbgHqaIHcidKpcJvcGHqFdCiKAtm",174,0.994286,29,175,1,174,1,1,0,1,1,84,83,91,91,60
"5535",34,"[29]zJbgHqaIHcidKpcJvcGHqFdCiKAtm",177,0.994382,29,178,1,177,1,1,0,1,1,91,90,87,87,60
"5536",35,"[29]zJbgHqaIHcidKpcJvcGHqFdCiKAtm",177,0.994382,29,178,1,177,1,1,0,1,1,94,93,84,84,60
"5537",36,"[29]zJbgHqaIHcidKpcJvcGHqFdCiKAtm",173,0.994253,29,174,1,173,1,1,0,1,1,77,76,97,97,60
"5538",37,"[29]zJbgHqaIHcidKpcJvcGHqFdCiKAtm",175,0.994318,29,176,1,175,1,1,0,1,1,86,85,90,90,60
"5539",38,"[29]zJbgHqaIHcidKpcJvcGHqFdCiKAtm",178,0.994413,29,179,1,178,1,1,0,1,1,95,94,84,84,60
"5540",39,"[29]zJbgHqaIHcidKpcJvcGHqFdCiKAtm",174,0.994286,29,175,1,174,1,1,0,1,1,83,82,92,92,60
"5541",40,"[29]zJbgHqaIHcidKpcJvcGHqFdCiKAtm",171,0.994186,29,172,1,171,1,1,0,1,1,74,73,98,98,60
"5542",41,"[29]zJbgHqaIHcidKpcJvcGHqFdCiKAtm",175,0.994318,29,176,1,175,1,1,0,1,1,87,86,89,89,60
"5543",42,"[29]zJbgHqaIHcidKpcJvcGHqFdCiKAtm",178,0.994413,29,179,1,178,1,1,0,1,1,96,95,83,83,60
"5544",43,"[29]zJbgHqaIHcidKpcJvcGHqFdCiKAtm",179,0.994444,29,180,1,179,1,1,0,1,1,100,99,80,80,60
"5545",44,"[29]zJbgHqaIHcidKpcJvcGHqFdCiKAtm",176,0.99435,29,177,1,176,1,1,0,1,1,88,87,89,89,60
"5546",45,"[29]zJbgHqaIHcidKpcJvcGHqFdCiKAtm",176,0.99435,29,177,1,176,1,1,0,1,1,90,89,87,87,60
"5547",46,"[29]zJbgHqaIHcidKpcJvcGHqFdCiKAtm",173,0.994253,29,174,1,173,1,1,0,1,1,79,78,95,95,60
"5548",47,"[29]zJbgHqaIHcidKpcJvcGHqFdCiKAtm",178,0.994413,29,179,1,178,1,1,0,1,1,94,93,85,85,60
"5549",48,"[29]zJbgHqaIHcidKpcJvcGHqFdCiKAtm",174,0.994286,29,175,1,174,1,1,0,1,1,83,82,92,92,60
"5550",49,"[29]zJbgHqaIHcidKpcJvcGHqFdCiKAtm",175,0.994318,29,176,1,175,1,1,0,1,1,86,85,90,90,60
"5551",50,"[29]zJbgHqaIHcidKpcJvcGHqFdCiKAtm",176,0.99435,29,177,1,176,1,1,0,1,1,90,89,87,87,60
"5552",51,"[29]zJbgHqaIHcidKpcJvcGHqFdCiKAtm",175,0.994318,29,176,1,175,1,1,0,1,1,86,85,90,90,60
"5553",52,"[29]zJbgHqaIHcidKpcJvcGHqFdCiKAtm",178,0.994413,29,179,1,178,1,1,0,1,1,97,96,82,82,60
"5554",53,"[29]zJbgHqaIHcidKpcJvcGHqFdCiKAtm",176,0.99435,29,177,1,176,1,1,0,1,1,88,87,89,89,60
"5555",54,"[29]zJbgHqaIHcidKpcJvcGHqFdCiKAtm",176,0.99435,29,177,1,176,1,1,0,1,1,88,87,89,89,60
"5556",55,"[29]zJbgHqaIHcidKpcJvcGHqFdCiKAtm",175,0.994318,29,176,1,175,1,1,0,1,1,87,86,89,89,60
"5557",56,"[29]zJbgHqaIHcidKpcJvcGHqFdCiKAtm",175,0.994318,29,176,1,175,1,1,0,1,1,85,84,91,91,60
"5558",57,"[29]zJbgHqaIHcidKpcJvcGHqFdCiKAtm",173,0.994253,29,174,1,173,1,1,0,1,1,78,77,96,96,60
"5559",58,"[29]zJbgHqaIHcidKpcJvcGHqFdCiKAtm",174,0.994286,29,175,1,174,1,1,0,1,1,82,81,93,93,60
"5560",59,"[29]zJbgHqaIHcidKpcJvcGHqFdCiKAtm",177,0.994382,29,178,1,177,1,1,0,1,1,93,92,85,85,60
"5561",60,"[29]zJbgHqaIHcidKpcJvcGHqFdCiKAtm",181,0.994505,29,182,1,181,1,1,0,1,1,104,103,78,78,60
"5562",61,"[29]zJbgHqaIHcidKpcJvcGHqFdCiKAtm",178,0.994413,29,179,1,178,1,1,0,1,1,97,96,82,82,60
"5563",62,"[29]zJbgHqaIHcidKpcJvcGHqFdCiKAtm",174,0.994286,29,175,1,174,1,1,0,1,1,84,83,91,91,60
"5564",63,"[29]zJbgHqaIHcidKpcJvcGHqFdCiKAtm",176,0.99435,29,177,1,176,1,1,0,1,1,88,87,89,89,60
"5565",64,"[29]zJbgHqaIHcidKpcJvcGHqFdCiKAtm",174,0.994286,29,175,1,174,1,1,0,1,1,82,81,93,93,60
"5566",65,"[29]zJbgHqaIHcidKpcJvcGHqFdCiKAtm",177,0.994382,29,178,1,177,1,1,0,1,1,93,92,85,85,60
"5567",66,"[29]zJbgHqaIHcidKpcJvcGHqFdCiKAtm",175,0.994318,29,176,1,175,1,1,0,1,1,87,86,89,89,60
"5568",67,"[29]zJbgHqaIHcidKpcJvcGHqFdCiKAtm",174,0.994286,29,175,1,174,1,1,0,1,1,82,81,93,93,60
"5569",68,"[29]zJbgHqaIHcidKpcJvcGHqFdCiKAtm",177,0.994382,29,178,1,177,1,1,0,1,1,94,93,84,84,60
"5570",69,"[29]zJbgHqaIHcidKpcJvcGHqFdCiKAtm",177,0.994382,29,178,1,177,1,1,0,1,1,90,89,88,88,60
"5571",70,"[29]zJbgHqaIHcidKpcJvcGHqFdCiKAtm",178,0.994413,29,179,1,178,1,1,0,1,1,97,96,82,82,60
"5572",71,"[29]zJbgHqaIHcidKpcJvcGHqFdCiKAtm",177,0.994382,29,178,1,177,1,1,0,1,1,92,91,86,86,60
"5573",72,"[29]zJbgHqaIHcidKpcJvcGHqFdCiKAtm",175,0.994318,29,176,1,175,1,1,0,1,1,86,85,90,90,60
"5574",73,"[29]zJbgHqaIHcidKpcJvcGHqFdCiKAtm",178,0.994413,29,179,1,178,1,1,0,1,1,95,94,84,84,60
"5575",74,"[29]zJbgHqaIHcidKpcJvcGHqFdCiKAtm",177,0.994382,29,178,1,177,1,1,0,1,1,91,90,87,87,60
"5576",75,"[29]zJbgHqaIHcidKpcJvcGHqFdCiKAtm",179,0.994444,29,180,1,179,1,1,0,1,1,101,100,79,79,60
"5577",76,"[29]zJbgHqaIHcidKpcJvcGHqFdCiKAtm",175,0.994318,29,176,1,175,1,1,0,1,1,84,83,92,92,60
"5578",77,"[29]zJbgHqaIHcidKpcJvcGHqFdCiKAtm",178,0.994413,29,179,1,178,1,1,0,1,1,96,95,83,83,60
"5579",78,"[29]zJbgHqaIHcidKpcJvcGHqFdCiKAtm",177,0.994382,29,178,1,177,1,1,0,1,1,93,92,85,85,60
"5580",79,"[29]zJbgHqaIHcidKpcJvcGHqFdCiKAtm",177,0.994382,29,178,1,177,1,1,0,1,1,92,91,86,86,60
"5581",80,"[29]zJbgHqaIHcidKpcJvcGHqFdCiKAtm",179,0.994444,29,180,1,179,1,1,0,1,1,101,100,79,79,60
"5582",81,"[29]zJbgHqaIHcidKpcJvcGHqFdCiKAtm",178,0.994413,29,179,1,178,1,1,0,1,1,94,93,85,85,60
"5583",82,"[29]zJbgHqaIHcidKpcJvcGHqFdCiKAtm",170,0.994152,29,171,1,170,1,1,0,1,1,68,67,103,103,60
"5584",83,"[29]zJbgHqaIHcidKpcJvcGHqFdCiKAtm",175,0.994318,29,176,1,175,1,1,0,1,1,85,84,91,91,60
"5585",84,"[29]zJbgHqaIHcidKpcJvcGHqFdCiKAtm",178,0.994413,29,179,1,178,1,1,0,1,1,92,91,87,87,60
"5586",85,"[29]zJbgHqaIHcidKpcJvcGHqFdCiKAtm",174,0.994286,29,175,1,174,1,1,0,1,1,83,82,92,92,60
"5587",86,"[29]zJbgHqaIHcidKpcJvcGHqFdCiKAtm",178,0.994413,29,179,1,178,1,1,0,1,1,97,96,82,82,60
"5588",87,"[29]zJbgHqaIHcidKpcJvcGHqFdCiKAtm",177,0.994382,29,178,1,177,1,1,0,1,1,93,92,85,85,60
"5589",88,"[29]zJbgHqaIHcidKpcJvcGHqFdCiKAtm",175,0.994318,29,176,1,175,1,1,0,1,1,86,85,90,90,60
"5590",89,"[29]zJbgHqaIHcidKpcJvcGHqFdCiKAtm",173,0.994253,29,174,1,173,1,1,0,1,1,78,77,96,96,60
"5591",90,"[29]zJbgHqaIHcidKpcJvcGHqFdCiKAtm",174,0.994286,29,175,1,174,1,1,0,1,1,83,82,92,92,60
"5592",91,"[29]zJbgHqaIHcidKpcJvcGHqFdCiKAtm",176,0.99435,29,177,1,176,1,1,0,1,1,90,89,87,87,60
"5593",92,"[29]zJbgHqaIHcidKpcJvcGHqFdCiKAtm",173,0.994253,29,174,1,173,1,1,0,1,1,80,79,94,94,60
"5594",93,"[29]zJbgHqaIHcidKpcJvcGHqFdCiKAtm",177,0.994382,29,178,1,177,1,1,0,1,1,93,92,85,85,60
"5595",94,"[29]zJbgHqaIHcidKpcJvcGHqFdCiKAtm",175,0.994318,29,176,1,175,1,1,0,1,1,85,84,91,91,60
"5596",95,"[29]zJbgHqaIHcidKpcJvcGHqFdCiKAtm",180,0.994475,29,181,1,180,1,1,0,1,1,100,99,81,81,60
"5597",96,"[29]zJbgHqaIHcidKpcJvcGHqFdCiKAtm",179,0.994444,29,180,1,179,1,1,0,1,1,99,98,81,81,60
"5598",97,"[29]zJbgHqaIHcidKpcJvcGHqFdCiKAtm",177,0.994382,29,178,1,177,1,1,0,1,1,94,93,84,84,60
"5599",98,"[29]zJbgHqaIHcidKpcJvcGHqFdCiKAtm",177,0.994382,29,178,1,177,1,1,0,1,1,91,90,87,87,60
"5600",99,"[29]zJbgHqaIHcidKpcJvcGHqFdCiKAtm",179,0.994444,29,180,1,179,1,1,0,1,1,98,97,82,82,60
"5601",0,"[32]hJHggqIHcxdKocJvcGHqxdCqqzeocoyC",160,0.993789,32,161,1,160,1,1,0,1,1,66,65,95,95,61
"5602",1,"[32]hJHggqIHcxdKocJvcGHqxdCqqzeocoyC",163,0.993902,32,164,1,163,1,1,0,1,1,75,74,89,89,61
"5603",2,"[32]hJHggqIHcxdKocJvcGHqxdCqqzeocoyC",162,0.993865,32,163,1,162,1,1,0,1,1,71,70,92,92,61
"5604",3,"[32]hJHggqIHcxdKocJvcGHqxdCqqzeocoyC",166,0.994012,32,167,1,166,1,1,0,1,1,82,81,85,85,61
"5605",4,"[32]hJHggqIHcxdKocJvcGHqxdCqqzeocoyC",173,0.994253,32,174,1,173,1,1,0,1,1,101,100,73,73,61
"5606",5,"[32]hJHggqIHcxdKocJvcGHqxdCqqzeocoyC",164,0.993939,32,165,1,164,1,1,0,1,1,77,76,88,88,61
"5607",6,"[32]hJHggqIHcxdKocJvcGHqxdCqqzeocoyC",167,0.994048,32,168,1,167,1,1,0,1,1,85,84,83,83,61
"5608",7,"[32]hJHggqIHcxdKocJvcGHqxdCqqzeocoyC",163,0.993902,32,164,1,163,1,1,0,1,1,74,73,90,90,61
"5609",8,"[32]hJHggqIHcxdKocJvcGHqxdCqqzeocoyC",170,0.994152,32,171,1,170,1,1,0,1,1,93,92,78,78,61
"5610",9,"[32]hJHggqIHcxdKocJvcGHqxdCqqzeocoyC",169,0.994118,32,170,1,169,1,1,0,1,1,90,89,80,80,61
"5611",10,"[32]hJHggqIHcxdKocJvcGHqxdCqqzeocoyC",167,0.994048,32,168,1,167,1,1,0,1,1,84,83,84,84,61
"5612",11,"[32]hJHggqIHcxdKocJvcGHqxdCqqzeocoyC",167,0.994048,32,168,1,167,1,1,0,1,1,83,82,85,85,61
"5613",12,"[32]hJHggqIHcxdKocJvcGHqxdCqqzeocoyC",164,0.993939,32,165,1,164,1,1,0,1,1,76,75,89,89,61
"5614",13,"[32]hJHggqIHcxdKocJvcGHqxdCqqzeocoyC",170,0.994152,32,171,1,170,1,1,0,1,1,92,91,79,79,61
"5615",14,"[32]hJHggqIHcxdKocJvcGHqxdCqqzeocoyC",174,0.994286,32,175,1,174,1,1,0,1,1,103,102,72,72,61
"5616",15,"[32]hJHggqIHcxdKocJvcGHqxdCqqzeocoyC",169,0.994118,32,170,1,169,1,1,0,1,1,89,88,81,81,61
"5617",16,"[32]hJHggqIHcxdKocJvcGHqxdCqqzeocoyC",169,0.994118,32,170,1,169,1,1,0,1,1,90,89,80,80,61
"5618",17,"[32]hJHggqIHcxdKocJvcGHqxdCqqzeocoyC",169,0.994118,32,170,1,169,1,1,0,1,1,90,89,80,80,61
"5619",18,"[32]hJHggqIHcxdKocJvcGHqxdCqqzeocoyC",172,0.99422,32,173,1,172,1,1,0,1,1,99,98,74,74,61
"5620",19,"[32]hJHggqIHcxdKocJvcGHqxdCqqzeocoyC",169,0.994118,32,170,1,169,1,1,0,1,1,89,88,81,81,61
"5621",20,"[32]hJHggqIHcxdKocJvcGHqxdCqqzeocoyC",171,0.994186,32,172,1,171,1,1,0,1,1,95,94,77,77,61
"5622",21,"[32]hJHggqIHcxdKocJvcGHqxdCqqzeocoyC",165,0.993976,32,166,1,165,1,1,0,1,1,80,79,86,86,61
"5623",22,"[32]hJHggqIHcxdKocJvcGHqxdCqqzeocoyC",164,0.993939,32,165,1,164,1,1,0,1,1,76,75,89,89,61
"5624",23,"[32]hJHggqIHcxdKocJvcGHqxdCqqzeocoyC",170,0.994152,32,171,1,170,1,1,0,1,1,94,93,77,77,61
"5625",24,"[32]hJHggqIHcxdKocJvcGHqxdCqqzeocoyC",170,0.994152,32,171,1,170,1,1,0,1,1,93,92,78,78,61
"5626",25,"[32]hJHggqIHcxdKocJvcGHqxdCqqzeocoyC",173,0.994253,32,174,1,173,1,1,0,1,1,101,100,73,73,61
"5627",26,"[32]hJHggqIHcxdKocJvcGHqxdCqqzeocoyC",172,0.99422,32,173,1,172,1,1,0,1,1,99,98,74,74,61
"5628",27,"[32]hJHggqIHcxdKocJvcGHqxdCqqzeocoyC",167,0.994048,32,168,1,167,1,1,0,1,1,85,84,83,83,61
"5629",28,"[32]hJHggqIHcxdKocJvcGHqxdCqqzeocoyC",165,0.993976,32,166,1,165,1,1,0,1,1,79,78,87,87,61
"5630",29,"[32]hJHggqIHcxdKocJvcGHqxdCqqzeocoyC",166,0.994012,32,167,1,166,1,1,0,1,1,82,81,85,85,61
"5631",30,"[32]hJHggqIHcxdKocJvcGHqxdCqqzeocoyC",165,0.993976,32,166,1,165,1,1,0,1,1,80,79,86,86,61
"5632",31,"[32]hJHggqIHcxdKocJvcGHqxdCqqzeocoyC",168,0.994083,32,169,1,168,1,1,0,1,1,87,86,82,82,61
"5633",32,"[32]hJHggqIHcxdKocJvcGHqxdCqqzeocoyC",163,0.993902,32,164,1,163,1,1,0,1,1,74,73,90,90,61
"5634",33,"[32]hJHggqIHcxdKocJvcGHqxdCqqzeocoyC",170,0.994152,32,171,1,170,1,1,0,1,1,92,91,79,79,61
"5635",34,"[32]hJHggqIHcxdKocJvcGHqxdCqqzeocoyC",167,0.994048,32,168,1,167,1,1,0,1,1,85,84,83,83,61
"5636",35,"[32]hJHggqIHcxdKocJvcGHqxdCqqzeocoyC",168,0.994083,32,169,1,168,1,1,0,1,1,89,88,80,80,61
"5637",36,"[32]hJHggqIHcxdKocJvcGHqxdCqqzeocoyC",166,0.994012,32,167,1,166,1,1,0,1,1,83,82,84,84,61
"5638",37,"[32]hJHggqIHcxdKocJvcGHqxdCqqzeocoyC",166,0.994012,32,167,1,166,1,1,0,1,1,82,81,85,85,61
"5639",38,"[32]hJHggqIHcxdKocJvcGHqxdCqqzeocoyC",163,0.993902,32,164,1,163,1,1,0,1,1,74,73,90,90,61
"5640",39,"[32]hJHggqIHcxdKocJvcGHqxdCqqzeocoyC",166,0.994012,32,167,1,166,1,1,0,1,1,81,80,86,86,61
"5641",40,"[32]hJHggqIHcxdKocJvcGHqxdCqqzeocoyC",167,0.994048,32,168,1,167,1,1,0,1,1,86,85,82,82,61
"5642",41,"[32]hJHggqIHcxdKocJvcGHqxdCqqzeocoyC",167,0.994048,32,168,1,167,1,1,0,1,1,85,84,83,83,61
"5643",42,"[32]hJHggqIHcxdKocJvcGHqxdCqqzeocoyC",171,0.994186,32,172,1,171,1,1,0,1,1,96,95,76,76,61
"5644",43,"[32]hJHggqIHcxdKocJvcGHqxdCqqzeocoyC",166,0.994012,32,167,1,166,1,1,0,1,1,83,82,84,84,61
"5645",44,"[32]hJHggqIHcxdKocJvcGHqxdCqqzeocoyC",168,0.994083,32,169,1,168,1,1,0,1,1,89,88,80,80,61
"5646",45,"[32]hJHggqIHcxdKocJvcGHqxdCqqzeocoyC",169,0.994118,32,170,1,169,1,1,0,1,1,90,89,80,80,61
"5647",46,"[32]hJHggqIHcxdKocJvcGHqxdCqqzeocoyC",164,0.993939,32,165,1,164,1,1,0,1,1,77,76,88,88,61
"5648",47,"[32]hJHggqIHcxdKocJvcGHqxdCqqzeocoyC",161,0.993827,32,162,1,161,1,1,0,1,1,68,67,94,94,61
"5649",48,"[32]hJHggqIHcxdKocJvcGHqxdCqqzeocoyC",168,0.994083,32,169,1,168,1,1,0,1,1,87,86,82,82,61
"5650",49,"[32]hJHggqIHcxdKocJvcGHqxdCqqzeocoyC",166,0.994012,32,167,1,166,1,1,0,1,1,83,82,84,84,61
"5651",50,"[32]hJHggqIHcxdKocJvcGHqxdCqqzeocoyC",168,0.994083,32,169,1,168,1,1,0,1,1,87,86,82,82,61
"5652",51,"[32]hJHggqIHcxdKocJvcGHqxdCqqzeocoyC",166,0.994012,32,167,1,166,1,1,0,1,1,82,81,85,85,61
"5653",52,"[32]hJHggqIHcxdKocJvcGHqxdCqqzeocoyC",168,0.994083,32,169,1,168,1,1,0,1,1,89,88,80,80,61
"5654",53,"[32]hJHggqIHcxdKocJvcGHqxdCqqzeocoyC",168,0.994083,32,169,1,168,1,1,0,1,1,88,87,81,81,61
"5655",54,"[32]hJHggqIHcxdKocJvcGHqxdCqqzeocoyC",166,0.994012,32,167,1,166,1,1,0,1,1,83,82,84,84,61
"5656",55,"[32]hJHggqIHcxdKocJvcGHqxdCqqzeocoyC",164,0.993939,32,165,1,164,1,1,0,1,1,76,75,89,89,61
"5657",56,"[32]hJHggqIHcxdKocJvcGHqxdCqqzeocoyC",166,0.994012,32,167,1,166,1,1,0,1,1,83,82,84,84,61
"5658",57,"[32]hJHggqIHcxdKocJvcGHqxdCqqzeocoyC",167,0.994048,32,168,1,167,1,1,0,1,1,84,83,84,84,61
"5659",58,"[32]hJHggqIHcxdKocJvcGHqxdCqqzeocoyC",169,0.994118,32,170,1,169,1,1,0,1,1,90,89,80,80,61
"5660",59,"[32]hJHggqIHcxdKocJvcGHqxdCqqzeocoyC",167,0.994048,32,168,1,167,1,1,0,1,1,86,85,82,82,61
"5661",60,"[32]hJHggqIHcxdKocJvcGHqxdCqqzeocoyC",163,0.993902,32,164,1,163,1,1,0,1,1,75,74,89,89,61
"5662",61,"[32]hJHggqIHcxdKocJvcGHqxdCqqzeocoyC",168,0.994083,32,169,1,168,1,1,0,1,1,87,86,82,82,61
"5663",62,"[32]hJHggqIHcxdKocJvcGHqxdCqqzeocoyC",170,0.994152,32,171,1,170,1,1,0,1,1,93,92,78,78,61
"5664",63,"[32]hJHggqIHcxdKocJvcGHqxdCqqzeocoyC",168,0.994083,32,169,1,168,1,1,0,1,1,87,86,82,82,61
"5665",64,"[32]hJHggqIHcxdKocJvcGHqxdCqqzeocoyC",170,0.994152,32,171,1,170,1,1,0,1,1,93,92,78,78,61
"5666",65,"[32]hJHggqIHcxdKocJvcGHqxdCqqzeocoyC",166,0.994012,32,167,1,166,1,1,0,1,1,82,81,85,85,61
"5667",66,"[32]hJHggqIHcxdKocJvcGHqxdCqqzeocoyC",164,0.993939,32,165,1,164,1,1,0,1,1,77,76,88,88,61
"5668",67,"[32]hJHggqIHcxdKocJvcGHqxdCqqzeocoyC",164,0.993939,32,165,1,164,1,1,0,1,1,76,75,89,89,61
"5669",68,"[32]hJHggqIHcxdKocJvcGHqxdCqqzeocoyC",168,0.994083,32,169,1,168,1,1,0,1,1,87,86,82,82,61
"5670",69,"[32]hJHggqIHcxdKocJvcGHqxdCqqzeocoyC",168,0.994083,32,169,1,168,1,1,0,1,1,89,88,80,80,61
"5671",70,"[32]hJHggqIHcxdKocJvcGHqxdCqqzeocoyC",166,0.994012,32,167,1,166,1,1,0,1,1,83,82,84,84,61
"5672",71,"[32]hJHggqIHcxdKocJvcGHqxdCqqzeocoyC",165,0.993976,32,166,1,165,1,1,0,1,1,79,78,87,87,61
"5673",72,"[32]hJHggqIHcxdKocJvcGHqxdCqqzeocoyC",166,0.994012,32,167,1,166,1,1,0,1,1,80,79,87,87,61
"5674",73,"[32]hJHggqIHcxdKocJvcGHqxdCqqzeocoyC",166,0.994012,32,167,1,166,1,1,0,1,1,83,82,84,84,61
"5675",74,"[32]hJHggqIHcxdKocJvcGHqxdCqqzeocoyC",167,0.994048,32,168,1,167,1,1,0,1,1,85,84,83,83,61
"5676",75,"[32]hJHggqIHcxdKocJvcGHqxdCqqzeocoyC",161,0.993827,32,162,1,161,1,1,0,1,1,69,68,93,93,61
"5677",76,"[32]hJHggqIHcxdKocJvcGHqxdCqqzeocoyC",165,0.993976,32,166,1,165,1,1,0,1,1,80,79,86,86,61
"5678",77,"[32]hJHggqIHcxdKocJvcGHqxdCqqzeocoyC",165,0.993976,32,166,1,165,1,1,0,1,1,80,79,86,86,61
"5679",78,"[32]hJHggqIHcxdKocJvcGHqxdCqqzeocoyC",172,0.99422,32,173,1,172,1,1,0,1,1,97,96,76,76,61
"5680",79,"[32]hJHggqIHcxdKocJvcGHqxdCqqzeocoyC",164,0.993939,32,165,1,164,1,1,0,1,1,78,77,87,87,61
"5681",80,"[32]hJHggqIHcxdKocJvcGHqxdCqqzeocoyC",164,0.993939,32,165,1,164,1,1,0,1,1,77,76,88,88,61
"5682",81,"[32]hJHggqIHcxdKocJvcGHqxdCqqzeocoyC",167,0.994048,32,168,1,167,1,1,0,1,1,82,81,86,86,61
"5683",82,"[32]hJHggqIHcxdKocJvcGHqxdCqqzeocoyC",168,0.994083,32,169,1,168,1,1,0,1,1,87,86,82,82,61
"5684",83,"[32]hJHggqIHcxdKocJvcGHqxdCqqzeocoyC",163,0.993902,32,164,1,163,1,1,0,1,1,75,74,89,89,61
"5685",84,"[32]hJHggqIHcxdKocJvcGHqxdCqqzeocoyC",167,0.994048,32,168,1,167,1,1,0,1,1,86,85,82,82,61
"5686",85,"[32]hJHggqIHcxdKocJvcGHqxdCqqzeocoyC",171,0.994186,32,172,1,171,1,1,0,1,1,95,94,77,77,61
"5687",86,"[32]hJHggqIHcxdKocJvcGHqxdCqqzeocoyC",164,0.993939,32,165,1,164,1,1,0,1,1,77,76,88,88,61
"5688",87,"[32]hJHggqIHcxdKocJvcGHqxdCqqzeocoyC",167,0.994048,32,168,1,167,1,1,0,1,1,83,82,85,85,61
"5689",88,"[32]hJHggqIHcxdKocJvcGHqxdCqqzeocoyC",169,0.994118,32,170,1,169,1,1,0,1,1,90,89,80,80,61
"5690",89,"[32]hJHggqIHcxdKocJvcGHqxdCqqzeocoyC",165,0.993976,32,166,1,165,1,1,0,1,1,79,78,87,87,61
"5691",90,"[32]hJHggqIHcxdKocJvcGHqxdCqqzeocoyC",165,0.993976,32,166,1,165,1,1,0,1,1,80,79,86,86,61
"5692",91,"[32]hJHggqIHcxdKocJvcGHqxdCqqzeocoyC",167,0.994048,32,168,1,167,1,1,0,1,1,84,83,84,84,61
"5693",92,"[32]hJHggqIHcxdKocJvcGHqxdCqqzeocoyC",165,0.993976,32,166,1,165,1,1,0,1,1,79,78,87,87,61
"5694",93,"[32]hJHggqIHcxdKocJvcGHqxdCqqzeocoyC",164,0.993939,32,165,1,164,1,1,0,1,1,76,75,89,89,61
"5695",94,"[32]hJHggqIHcxdKocJvcGHqxdCqqzeocoyC",165,0.993976,32,166,1,165,1,1,0,1,1,79,78,87,87,61
"5696",95,"[32]hJHggqIHcxdKocJvcGHqxdCqqzeocoyC",169,0.994118,32,170,1,169,1,1,0,1,1,89,88,81,81,61
"5697",96,"[32]hJHggqIHcxdKocJvcGHqxdCqqzeocoyC",165,0.993976,32,166,1,165,1,1,0,1,1,80,79,86,86,61
"5698",97,"[32]hJHggqIHcxdKocJvcGHqxdCqqzeocoyC",175,0.994318,32,176,1,175,1,1,0,1,1,106,105,70,70,61
"5699",98,"[32]hJHggqIHcxdKocJvcGHqxdCqqzeocoyC",166,0.994012,32,167,1,166,1,1,0,1,1,82,81,85,85,61
"5700",99,"[32]hJHggqIHcxdKocJvcGHqxdCqqzeocoyC",167,0.994048,32,168,1,167,1,1,0,1,1,86,85,82,82,61
"5701",0,"[26]gJHggqIHcdKpcJvcGHqwdCijGA",161,0.993827,26,162,1,161,1,1,0,1,1,68,67,94,94,62
"5702",1,"[26]gJHggqIHcdKpcJvcGHqwdCijGA",167,0.994048,26,168,1,167,1,1,0,1,1,84,83,84,84,62
"5703",2,"[26]gJHggqIHcdKpcJvcGHqwdCijGA",169,0.994118,26,170,1,169,1,1,0,1,1,91,90,79,79,62
"5704",3,"[26]gJHggqIHcdKpcJvcGHqwdCijGA",165,0.993976,26,166,1,165,1,1,0,1,1,80,79,86,86,62
"5705",4,"[26]gJHggqIHcdKpcJvcGHqwdCijGA",170,0.994152,26,171,1,170,1,1,0,1,1,93,92,78,78,62
"5706",5,"[26]gJHggqIHcdKpcJvcGHqwdCijGA",164,0.993939,26,165,1,164,1,1,0,1,1,75,74,90,90,62
"5707",6,"[26]gJHggqIHcdKpcJvcGHqwdCijGA",160,0.993789,26,161,1,160,1,1,0,1,1,66,65,95,95,62
"5708",7,"[26]gJHggqIHcdKpcJvcGHqwdCijGA",170,0.994152,26,171,1,170,1,1,0,1,1,94,93,77,77,62
"5709",8,"[26]gJHggqIHcdKpcJvcGHqwdCijGA",168,0.994083,26,169,1,168,1,1,0,1,1,88,87,81,81,62
"5710",9,"[26]gJHggqIHcdKpcJvcGHqwdCijGA",165,0.993976,26,166,1,165,1,1,0,1,1,80,79,86,86,62
"5711",10,"[26]gJHggqIHcdKpcJvcGHqwdCijGA",169,0.994118,26,170,1,169,1,1,0,1,1,89,88,81,81,62
"5712",11,"[26]gJHggqIHcdKpcJvcGHqwdCijGA",166,0.994012,26,167,1,166,1,1,0,1,1,81,80,86,86,62
"5713",12,"[26]gJHggqIHcdKpcJvcGHqwdCijGA",167,0.994048,26,168,1,167,1,1,0,1,1,85,84,83,83,62
"5714",13,"[26]gJHggqIHcdKpcJvcGHqwdCijGA",165,0.993976,26,166,1,165,1,1,0,1,1,79,78,87,87,62
"5715",14,"[26]gJHggqIHcdKpcJvcGHqwdCijGA",165,0.993976,26,166,1,165,1,1,0,1,1,78,77,88,88,62
"5716",15,"[26]gJHggqIHcdKpcJvcGHqwdCijGA",166,0.994012,26,167,1,166,1,1,0,1,1,83,82,84,84,62
"5717",16,"[26]gJHggqIHcdKpcJvcGHqwdCijGA",169,0.994118,26,170,1,169,1,1,0,1,1,90,89,80,80,62
"5718",17,"[26]gJHggqIHcdKpcJvcGHqwdCijGA",171,0.994186,26,172,1,171,1,1,0,1,1,94,93,78,78,62
"5719",18,"[26]gJHggqIHcdKpcJvcGHqwdCijGA",169,0.994118,26,170,1,169,1,1,0,1,1,86,85,84,84,62
"5720",19,"[26]gJHggqIHcdKpcJvcGHqwdCijGA",164,0.993939,26,165,1,164,1,1,0,1,1,76,75,89,89,62
"5721",20,"[26]gJHggqIHcdKpcJvcGHqwdCijGA",163,0.993902,26,164,1,163,1,1,0,1,1,73,72,91,91,62
"5722",21,"[26]gJHggqIHcdKpcJvcGHqwdCijGA",169,0.994118,26,170,1,169,1,1,0,1,1,89,88,81,81,62
"5723",22,"[26]gJHggqIHcdKpcJvcGHqwdCijGA",163,0.993902,26,164,1,163,1,1,0,1,1,73,72,91,91,62
"5724",23,"[26]gJHggqIHcdKpcJvcGHqwdCijGA",163,0.993902,26,164,1,163,1,1,0,1,1,73,72,91,91,62
"5725",24,"[26]gJHggqIHcdKpcJvcGHqwdCijGA",166,0.994012,26,167,1,166,1,1,0,1,1,83,82,84,84,62
"5726",25,"[26]gJHggqIHcdKpcJvcGHqwdCijGA",170,0.994152,26,171,1,170,1,1,0,1,1,93,92,78,78,62
"5727",26,"[26]gJHggqIHcdKpcJvcGHqwdCijGA",170,0.994152,26,171,1,170,1,1,0,1,1,92,91,79,79,62
"5728",27,"[26]gJHggqIHcdKpcJvcGHqwdCijGA",169,0.994118,26,170,1,169,1,1,0,1,1,90,89,80,80,62
"5729",28,"[26]gJHggqIHcdKpcJvcGHqwdCijGA",166,0.994012,26,167,1,166,1,1,0,1,1,83,82,84,84,62
"5730",29,"[26]gJHggqIHcdKpcJvcGHqwdCijGA",169,0.994118,26,170,1,169,1,1,0,1,1,89,88,81,81,62
"5731",30,"[26]gJHggqIHcdKpcJvcGHqwdCijGA",171,0.994186,26,172,1,171,1,1,0,1,1,95,94,77,77,62
"5732",31,"[26]gJHggqIHcdKpcJvcGHqwdCijGA",167,0.994048,26,168,1,167,1,1,0,1,1,84,83,84,84,62
"5733",32,"[26]gJHggqIHcdKpcJvcGHqwdCijGA",168,0.994083,26,169,1,168,1,1,0,1,1,88,87,81,81,62
"5734",33,"[26]gJHggqIHcdKpcJvcGHqwdCijGA",170,0.994152,26,171,1,170,1,1,0,1,1,93,92,78,78,62
"5735",34,"[26]gJHggqIHcdKpcJvcGHqwdCijGA",166,0.994012,26,167,1,166,1,1,0,1,1,83,82,84,84,62
"5736",35,"[26]gJHggqIHcdKpcJvcGHqwdCijGA",165,0.993976,26,166,1,165,1,1,0,1,1,77,76,89,89,62
"5737",36,"[26]gJHggqIHcdKpcJvcGHqwdCijGA",165,0.993976,26,166,1,165,1,1,0,1,1,79,78,87,87,62
"5738",37,"[26]gJHggqIHcdKpcJvcGHqwdCijGA",162,0.993865,26,163,1,162,1,1,0,1,1,72,71,91,91,62
"5739",38,"[26]gJHggqIHcdKpcJvcGHqwdCijGA",170,0.994152,26,171,1,170,1,1,0,1,1,93,92,78,78,62
"5740",39,"[26]gJHggqIHcdKpcJvcGHqwdCijGA",171,0.994186,26,172,1,171,1,1,0,1,1,96,95,76,76,62
"5741",40,"[26]gJHggqIHcdKpcJvcGHqwdCijGA",169,0.994118,26,170,1,169,1,1,0,1,1,91,90,79,79,62
"5742",41,"[26]gJHggqIHcdKpcJvcGHqwdCijGA",169,0.994118,26,170,1,169,1,1,0,1,1,89,88,81,81,62
"5743",42,"[26]gJHggqIHcdKpcJvcGHqwdCijGA",168,0.994083,26,169,1,168,1,1,0,1,1,88,87,81,81,62
"5744",43,"[26]gJHggqIHcdKpcJvcGHqwdCijGA",168,0.994083,26,169,1,168,1,1,0,1,1,88,87,81,81,62
"5745",44,"[26]gJHggqIHcdKpcJvcGHqwdCijGA",164,0.993939,26,165,1,164,1,1,0,1,1,75,74,90,90,62
"5746",45,"[26]gJHggqIHcdKpcJvcGHqwdCijGA",171,0.994186,26,172,1,171,1,1,0,1,1,95,94,77,77,62
"5747",46,"[26]gJHggqIHcdKpcJvcGHqwdCijGA",168,0.994083,26,169,1,168,1,1,0,1,1,87,86,82,82,62
"5748",47,"[26]gJHggqIHcdKpcJvcGHqwdCijGA",165,0.993976,26,166,1,165,1,1,0,1,1,78,77,88,88,62
"5749",48,"[26]gJHggqIHcdKpcJvcGHqwdCijGA",169,0.994118,26,170,1,169,1,1,0,1,1,89,88,81,81,62
"5750",49,"[26]gJHggqIHcdKpcJvcGHqwdCijGA",166,0.994012,26,167,1,166,1,1,0,1,1,82,81,85,85,62
"5751",50,"[26]gJHggqIHcdKpcJvcGHqwdCijGA",166,0.994012,26,167,1,166,1,1,0,1,1,81,80,86,86,62
"5752",51,"[26]gJHggqIHcdKpcJvcGHqwdCijGA",165,0.993976,26,166,1,165,1,1,0,1,1,79,78,87,87,62
"5753",52,"[26]gJHggqIHcdKpcJvcGHqwdCijGA",168,0.994083,26,169,1,168,1,1,0,1,1,85,84,84,84,62
"5754",53,"[26]gJHggqIHcdKpcJvcGHqwdCijGA",170,0.994152,26,171,1,170,1,1,0,1,1,92,91,79,79,62
"5755",54,"[26]gJHggqIHcdKpcJvcGHqwdCijGA",171,0.994186,26,172,1,171,1,1,0,1,1,96,95,76,76,62
"5756",55,"[26]gJHggqIHcdKpcJvcGHqwdCijGA",164,0.993939,26,165,1,164,1,1,0,1,1,77,76,88,88,62
"5757",56,"[26]gJHggqIHcdKpcJvcGHqwdCijGA",166,0.994012,26,167,1,166,1,1,0,1,1,80,79,87,87,62
"5758",57,"[26]gJHggqIHcdKpcJvcGHqwdCijGA",170,0.994152,26,171,1,170,1,1,0,1,1,92,91,79,79,62
"5759",58,"[26]gJHggqIHcdKpcJvcGHqwdCijGA",166,0.994012,26,167,1,166,1,1,0,1,1,83,82,84,84,62
"5760",59,"[26]gJHggqIHcdKpcJvcGHqwdCijGA",166,0.994012,26,167,1,166,1,1,0,1,1,82,81,85,85,62
"5761",60,"[26]gJHggqIHcdKpcJvcGHqwdCijGA",167,0.994048,26,168,1,167,1,1,0,1,1,86,85,82,82,62
"5762",61,"[26]gJHggqIHcdKpcJvcGHqwdCijGA",170,0.994152,26,171,1,170,1,1,0,1,1,93,92,78,78,62
"5763",62,"[26]gJHggqIHcdKpcJvcGHqwdCijGA",167,0.994048,26,168,1,167,1,1,0,1,1,85,84,83,83,62
"5764",63,"[26]gJHggqIHcdKpcJvcGHqwdCijGA",168,0.994083,26,169,1,168,1,1,0,1,1,88,87,81,81,62
"5765",64,"[26]gJHggqIHcdKpcJvcGHqwdCijGA",158,0.993711,26,159,1,158,1,1,0,1,1,60,59,99,99,62
"5766",65,"[26]gJHggqIHcdKpcJvcGHqwdCijGA",166,0.994012,26,167,1,166,1,1,0,1,1,81,80,86,86,62
"5767",66,"[26]gJHggqIHcdKpcJvcGHqwdCijGA",164,0.993939,26,165,1,164,1,1,0,1,1,77,76,88,88,62
"5768",67,"[26]gJHggqIHcdKpcJvcGHqwdCijGA",169,0.994118,26,170,1,169,1,1,0,1,1,91,90,79,79,62
"5769",68,"[26]gJHggqIHcdKpcJvcGHqwdCijGA",167,0.994048,26,168,1,167,1,1,0,1,1,86,85,82,82,62
"5770",69,"[26]gJHggqIHcdKpcJvcGHqwdCijGA",166,0.994012,26,167,1,166,1,1,0,1,1,82,81,85,85,62
"5771",70,"[26]gJHggqIHcdKpcJvcGHqwdCijGA",170,0.994152,26,171,1,170,1,1,0,1,1,93,92,78,78,62
"5772",71,"[26]gJHggqIHcdKpcJvcGHqwdCijGA",166,0.994012,26,167,1,166,1,1,0,1,1,83,82,84,84,62
"5773",72,"[26]gJHggqIHcdKpcJvcGHqwdCijGA",166,0.994012,26,167,1,166,1,1,0,1,1,82,81,85,85,62
"5774",73,"[26]gJHggqIHcdKpcJvcGHqwdCijGA",168,0.994083,26,169,1,168,1,1,0,1,1,87,86,82,82,62
"5775",74,"[26]gJHggqIHcdKpcJvcGHqwdCijGA",170,0.994152,26,171,1,170,1,1,0,1,1,94,93,77,77,62
"5776",75,"[26]gJHggqIHcdKpcJvcGHqwdCijGA",171,0.994186,26,172,1,171,1,1,0,1,1,97,96,75,75,62
"5777",76,"[26]gJHggqIHcdKpcJvcGHqwdCijGA",167,0.994048,26,168,1,167,1,1,0,1,1,86,85,82,82,62
"5778",77,"[26]gJHggqIHcdKpcJvcGHqwdCijGA",166,0.994012,26,167,1,166,1,1,0,1,1,82,81,85,85,62
"5779",78,"[26]gJHggqIHcdKpcJvcGHqwdCijGA",170,0.994152,26,171,1,170,1,1,0,1,1,94,93,77,77,62
"5780",79,"[26]gJHggqIHcdKpcJvcGHqwdCijGA",167,0.994048,26,168,1,167,1,1,0,1,1,86,85,82,82,62
"5781",80,"[26]gJHggqIHcdKpcJvcGHqwdCijGA",166,0.994012,26,167,1,166,1,1,0,1,1,83,82,84,84,62
"5782",81,"[26]gJHggqIHcdKpcJvcGHqwdCijGA",163,0.993902,26,164,1,163,1,1,0,1,1,75,74,89,89,62
"5783",82,"[26]gJHggqIHcdKpcJvcGHqwdCijGA",169,0.994118,26,170,1,169,1,1,0,1,1,89,88,81,81,62
"5784",83,"[26]gJHggqIHcdKpcJvcGHqwdCijGA",168,0.994083,26,169,1,168,1,1,0,1,1,87,86,82,82,62
"5785",84,"[26]gJHggqIHcdKpcJvcGHqwdCijGA",171,0.994186,26,172,1,171,1,1,0,1,1,95,94,77,77,62
"5786",85,"[26]gJHggqIHcdKpcJvcGHqwdCijGA",161,0.993827,26,162,1,161,1,1,0,1,1,69,68,93,93,62
"5787",86,"[26]gJHggqIHcdKpcJvcGHqwdCijGA",171,0.994186,26,172,1,171,1,1,0,1,1,95,94,77,77,62
"5788",87,"[26]gJHggqIHcdKpcJvcGHqwdCijGA",165,0.993976,26,166,1,165,1,1,0,1,1,79,78,87,87,62
"5789",88,"[26]gJHggqIHcdKpcJvcGHqwdCijGA",169,0.994118,26,170,1,169,1,1,0,1,1,88,87,82,82,62
"5790",89,"[26]gJHggqIHcdKpcJvcGHqwdCijGA",172,0.99422,26,173,1,172,1,1,0,1,1,94,93,79,79,62
"5791",90,"[26]gJHggqIHcdKpcJvcGHqwdCijGA",170,0.994152,26,171,1,170,1,1,0,1,1,93,92,78,78,62
"5792",91,"[26]gJHggqIHcdKpcJvcGHqwdCijGA",166,0.994012,26,167,1,166,1,1,0,1,1,82,81,85,85,62
"5793",92,"[26]gJHggqIHcdKpcJvcGHqwdCijGA",167,0.994048,26,168,1,167,1,1,0,1,1,85,84,83,83,62
"5794",93,"[26]gJHggqIHcdKpcJvcGHqwdCijGA",172,0.99422,26,173,1,172,1,1,0,1,1,99,98,74,74,62
"5795",94,"[26]gJHggqIHcdKpcJvcGHqwdCijGA",169,0.994118,26,170,1,169,1,1,0,1,1,90,89,80,80,62
"5796",95,"[26]gJHggqIHcdKpcJvcGHqwdCijGA",165,0.993976,26,166,1,165,1,1,0,1,1,79,78,87,87,62
"5797",96,"[26]gJHggqIHcdKpcJvcGHqwdCijGA",170,0.994152,26,171,1,170,1,1,0,1,1,93,92,78,78,62
"5798",97,"[26]gJHggqIHcdKpcJvcGHqwdCijGA",163,0.993902,26,164,1,163,1,1,0,1,1,75,74,89,89,62
"5799",98,"[26]gJHggqIHcdKpcJvcGHqwdCijGA",167,0.994048,26,168,1,167,1,1,0,1,1,84,83,84,84,62
"5800",99,"[26]gJHggqIHcdKpcJvcGHqwdCijGA",166,0.994012,26,167,1,166,1,1,0,1,1,83,82,84,84,62
"5801",0,"[31]xJHggqlIHcidKpcJvcGHqFdCstcxvJw",178,0.994413,31,179,1,178,1,1,0,1,1,95,94,84,84,63
"5802",1,"[31]xJHggqlIHcidKpcJvcGHqFdCstcxvJw",176,0.99435,31,177,1,176,1,1,0,1,1,89,88,88,88,63
"5803",2,"[31]xJHggqlIHcidKpcJvcGHqFdCstcxvJw",175,0.994318,31,176,1,175,1,1,0,1,1,85,84,91,91,63
"5804",3,"[31]xJHggqlIHcidKpcJvcGHqFdCstcxvJw",182,0.994536,31,183,1,182,1,1,0,1,1,108,107,75,75,63
"5805",4,"[31]xJHggqlIHcidKpcJvcGHqFdCstcxvJw",175,0.994318,31,176,1,175,1,1,0,1,1,86,85,90,90,63
"5806",5,"[31]xJHggqlIHcidKpcJvcGHqFdCstcxvJw",177,0.994382,31,178,1,177,1,1,0,1,1,91,90,87,87,63
"5807",6,"[31]xJHggqlIHcidKpcJvcGHqFdCstcxvJw",172,0.99422,31,173,1,172,1,1,0,1,1,73,72,100,100,63
"5808",7,"[31]xJHggqlIHcidKpcJvcGHqFdCstcxvJw",178,0.994413,31,179,1,178,1,1,0,1,1,96,95,83,83,63
"5809",8,"[31]xJHggqlIHcidKpcJvcGHqFdCstcxvJw",173,0.994253,31,174,1,173,1,1,0,1,1,79,78,95,95,63
"5810",9,"[31]xJHggqlIHcidKpcJvcGHqFdCstcxvJw",176,0.99435,31,177,1,176,1,1,0,1,1,88,87,89,89,63
"5811",10,"[31]xJHggqlIHcidKpcJvcGHqFdCstcxvJw",174,0.994286,31,175,1,174,1,1,0,1,1,79,78,96,96,63
"5812",11,"[31]xJHggqlIHcidKpcJvcGHqFdCstcxvJw",178,0.994413,31,179,1,178,1,1,0,1,1,95,94,84,84,63
"5813",12,"[31]xJHggqlIHcidKpcJvcGHqFdCstcxvJw",174,0.994286,31,175,1,174,1,1,0,1,1,83,82,92,92,63
"5814",13,"[31]xJHggqlIHcidKpcJvcGHqFdCstcxvJw",173,0.994253,31,174,1,173,1,1,0,1,1,80,79,94,94,63
"5815",14,"[31]xJHggqlIHcidKpcJvcGHqFdCstcxvJw",178,0.994413,31,179,1,178,1,1,0,1,1,97,96,82,82,63
"5816",15,"[31]xJHggqlIHcidKpcJvcGHqFdCstcxvJw",177,0.994382,31,178,1,177,1,1,0,1,1,93,92,85,85,63
"5817",16,"[31]xJHggqlIHcidKpcJvcGHqFdCstcxvJw",177,0.994382,31,178,1,177,1,1,0,1,1,93,92,85,85,63
"5818",17,"[31]xJHggqlIHcidKpcJvcGHqFdCstcxvJw",173,0.994253,31,174,1,173,1,1,0,1,1,80,79,94,94,63
"5819",18,"[31]xJHggqlIHcidKpcJvcGHqFdCstcxvJw",176,0.99435,31,177,1,176,1,1,0,1,1,88,87,89,89,63
"5820",19,"[31]xJHggqlIHcidKpcJvcGHqFdCstcxvJw",177,0.994382,31,178,1,177,1,1,0,1,1,93,92,85,85,63
"5821",20,"[31]xJHggqlIHcidKpcJvcGHqFdCstcxvJw",177,0.994382,31,178,1,177,1,1,0,1,1,92,91,86,86,63
"5822",21,"[31]xJHggqlIHcidKpcJvcGHqFdCstcxvJw",179,0.994444,31,180,1,179,1,1,0,1,1,100,99,80,80,63
"5823",22,"[31]xJHggqlIHcidKpcJvcGHqFdCstcxvJw",182,0.994536,31,183,1,182,1,1,0,1,1,110,109,73,73,63
"5824",23,"[31]xJHggqlIHcidKpcJvcGHqFdCstcxvJw",177,0.994382,31,178,1,177,1,1,0,1,1,93,92,85,85,63
"5825",24,"[31]xJHggqlIHcidKpcJvcGHqFdCstcxvJw",177,0.994382,31,178,1,177,1,1,0,1,1,93,92,85,85,63
"5826",25,"[31]xJHggqlIHcidKpcJvcGHqFdCstcxvJw",179,0.994444,31,180,1,179,1,1,0,1,1,100,99,80,80,63
"5827",26,"[31]xJHggqlIHcidKpcJvcGHqFdCstcxvJw",174,0.994286,31,175,1,174,1,1,0,1,1,82,81,93,93,63
"5828",27,"[31]xJHggqlIHcidKpcJvcGHqFdCstcxvJw",180,0.994475,31,181,1,180,1,1,0,1,1,100,99,81,81,63
"5829",28,"[31]xJHggqlIHcidKpcJvcGHqFdCstcxvJw",174,0.994286,31,175,1,174,1,1,0,1,1,84,83,91,91,63
"5830",29,"[31]xJHggqlIHcidKpcJvcGHqFdCstcxvJw",171,0.994186,31,172,1,171,1,1,0,1,1,74,73,98,98,63
"5831",30,"[31]xJHggqlIHcidKpcJvcGHqFdCstcxvJw",176,0.99435,31,177,1,176,1,1,0,1,1,88,87,89,89,63
"5832",31,"[31]xJHggqlIHcidKpcJvcGHqFdCstcxvJw",177,0.994382,31,178,1,177,1,1,0,1,1,94,93,84,84,63
"5833",32,"[31]xJHggqlIHcidKpcJvcGHqFdCstcxvJw",178,0.994413,31,179,1,178,1,1,0,1,1,96,95,83,83,63
"5834",33,"[31]xJHggqlIHcidKpcJvcGHqFdCstcxvJw",176,0.99435,31,177,1,176,1,1,0,1,1,87,86,90,90,63
"5835",34,"[31]xJHggqlIHcidKpcJvcGHqFdCstcxvJw",178,0.994413,31,179,1,178,1,1,0,1,1,96,95,83,83,63
"5836",35,"[31]xJHggqlIHcidKpcJvcGHqFdCstcxvJw",171,0.994186,31,172,1,171,1,1,0,1,1,71,70,101,101,63
"5837",36,"[31]xJHggqlIHcidKpcJvcGHqFdCstcxvJw",177,0.994382,31,178,1,177,1,1,0,1,1,92,91,86,86,63
"5838",37,"[31]xJHggqlIHcidKpcJvcGHqFdCstcxvJw",174,0.994286,31,175,1,174,1,1,0,1,1,83,82,92,92,63
"5839",38,"[31]xJHggqlIHcidKpcJvcGHqFdCstcxvJw",179,0.994444,31,180,1,179,1,1,0,1,1,98,97,82,82,63
"5840",39,"[31]xJHggqlIHcidKpcJvcGHqFdCstcxvJw",179,0.994444,31,180,1,179,1,1,0,1,1,98,97,82,82,63
"5841",40,"[31]xJHggqlIHcidKpcJvcGHqFdCstcxvJw",177,0.994382,31,178,1,177,1,1,0,1,1,92,91,86,86,63
"5842",41,"[31]xJHggqlIHcidKpcJvcGHqFdCstcxvJw",176,0.99435,31,177,1,176,1,1,0,1,1,88,87,89,89,63
"5843",42,"[31]xJHggqlIHcidKpcJvcGHqFdCstcxvJw",178,0.994413,31,179,1,178,1,1,0,1,1,96,95,83,83,63
"5844",43,"[31]xJHggqlIHcidKpcJvcGHqFdCstcxvJw",176,0.99435,31,177,1,176,1,1,0,1,1,90,89,87,87,63
"5845",44,"[31]xJHggqlIHcidKpcJvcGHqFdCstcxvJw",177,0.994382,31,178,1,177,1,1,0,1,1,91,90,87,87,63
"5846",45,"[31]xJHggqlIHcidKpcJvcGHqFdCstcxvJw",178,0.994413,31,179,1,178,1,1,0,1,1,97,96,82,82,63
"5847",46,"[31]xJHggqlIHcidKpcJvcGHqFdCstcxvJw",172,0.99422,31,173,1,172,1,1,0,1,1,76,75,97,97,63
"5848",47,"[31]xJHggqlIHcidKpcJvcGHqFdCstcxvJw",178,0.994413,31,179,1,178,1,1,0,1,1,95,94,84,84,63
"5849",48,"[31]xJHggqlIHcidKpcJvcGHqFdCstcxvJw",174,0.994286,31,175,1,174,1,1,0,1,1,82,81,93,93,63
"5850",49,"[31]xJHggqlIHcidKpcJvcGHqFdCstcxvJw",176,0.99435,31,177,1,176,1,1,0,1,1,90,89,87,87,63
"5851",50,"[31]xJHggqlIHcidKpcJvcGHqFdCstcxvJw",175,0.994318,31,176,1,175,1,1,0,1,1,87,86,89,89,63
"5852",51,"[31]xJHggqlIHcidKpcJvcGHqFdCstcxvJw",179,0.994444,31,180,1,179,1,1,0,1,1,99,98,81,81,63
"5853",52,"[31]xJHggqlIHcidKpcJvcGHqFdCstcxvJw",168,0.994083,31,169,1,168,1,1,0,1,1,64,63,105,105,63
"5854",53,"[31]xJHggqlIHcidKpcJvcGHqFdCstcxvJw",178,0.994413,31,179,1,178,1,1,0,1,1,97,96,82,82,63
"5855",54,"[31]xJHggqlIHcidKpcJvcGHqFdCstcxvJw",175,0.994318,31,176,1,175,1,1,0,1,1,86,85,90,90,63
"5856",55,"[31]xJHggqlIHcidKpcJvcGHqFdCstcxvJw",175,0.994318,31,176,1,175,1,1,0,1,1,85,84,91,91,63
"5857",56,"[31]xJHggqlIHcidKpcJvcGHqFdCstcxvJw",176,0.99435,31,177,1,176,1,1,0,1,1,91,90,86,86,63
"5858",57,"[31]xJHggqlIHcidKpcJvcGHqFdCstcxvJw",176,0.99435,31,177,1,176,1,1,0,1,1,87,86,90,90,63
"5859",58,"[31]xJHggqlIHcidKpcJvcGHqFdCstcxvJw",178,0.994413,31,179,1,178,1,1,0,1,1,95,94,84,84,63
"5860",59,"[31]xJHggqlIHcidKpcJvcGHqFdCstcxvJw",178,0.994413,31,179,1,178,1,1,0,1,1,95,94,84,84,63
"5861",60,"[31]xJHggqlIHcidKpcJvcGHqFdCstcxvJw",174,0.994286,31,175,1,174,1,1,0,1,1,82,81,93,93,63
"5862",61,"[31]xJHggqlIHcidKpcJvcGHqFdCstcxvJw",178,0.994413,31,179,1,178,1,1,0,1,1,95,94,84,84,63
"5863",62,"[31]xJHggqlIHcidKpcJvcGHqFdCstcxvJw",175,0.994318,31,176,1,175,1,1,0,1,1,86,85,90,90,63
"5864",63,"[31]xJHggqlIHcidKpcJvcGHqFdCstcxvJw",175,0.994318,31,176,1,175,1,1,0,1,1,85,84,91,91,63
"5865",64,"[31]xJHggqlIHcidKpcJvcGHqFdCstcxvJw",176,0.99435,31,177,1,176,1,1,0,1,1,89,88,88,88,63
"5866",65,"[31]xJHggqlIHcidKpcJvcGHqFdCstcxvJw",181,0.994505,31,182,1,181,1,1,0,1,1,106,105,76,76,63
"5867",66,"[31]xJHggqlIHcidKpcJvcGHqFdCstcxvJw",175,0.994318,31,176,1,175,1,1,0,1,1,87,86,89,89,63
"5868",67,"[31]xJHggqlIHcidKpcJvcGHqFdCstcxvJw",178,0.994413,31,179,1,178,1,1,0,1,1,96,95,83,83,63
"5869",68,"[31]xJHggqlIHcidKpcJvcGHqFdCstcxvJw",178,0.994413,31,179,1,178,1,1,0,1,1,96,95,83,83,63
"5870",69,"[31]xJHggqlIHcidKpcJvcGHqFdCstcxvJw",175,0.994318,31,176,1,175,1,1,0,1,1,86,85,90,90,63
"5871",70,"[31]xJHggqlIHcidKpcJvcGHqFdCstcxvJw",179,0.994444,31,180,1,179,1,1,0,1,1,101,100,79,79,63
"5872",71,"[31]xJHggqlIHcidKpcJvcGHqFdCstcxvJw",174,0.994286,31,175,1,174,1,1,0,1,1,84,83,91,91,63
"5873",72,"[31]xJHggqlIHcidKpcJvcGHqFdCstcxvJw",177,0.994382,31,178,1,177,1,1,0,1,1,93,92,85,85,63
"5874",73,"[31]xJHggqlIHcidKpcJvcGHqFdCstcxvJw",175,0.994318,31,176,1,175,1,1,0,1,1,84,83,92,92,63
"5875",74,"[31]xJHggqlIHcidKpcJvcGHqFdCstcxvJw",177,0.994382,31,178,1,177,1,1,0,1,1,93,92,85,85,63
"5876",75,"[31]xJHggqlIHcidKpcJvcGHqFdCstcxvJw",181,0.994505,31,182,1,181,1,1,0,1,1,103,102,79,79,63
"5877",76,"[31]xJHggqlIHcidKpcJvcGHqFdCstcxvJw",177,0.994382,31,178,1,177,1,1,0,1,1,92,91,86,86,63
"5878",77,"[31]xJHggqlIHcidKpcJvcGHqFdCstcxvJw",177,0.994382,31,178,1,177,1,1,0,1,1,94,93,84,84,63
"5879",78,"[31]xJHggqlIHcidKpcJvcGHqFdCstcxvJw",176,0.99435,31,177,1,176,1,1,0,1,1,89,88,88,88,63
"5880",79,"[31]xJHggqlIHcidKpcJvcGHqFdCstcxvJw",180,0.994475,31,181,1,180,1,1,0,1,1,102,101,79,79,63
"5881",80,"[31]xJHggqlIHcidKpcJvcGHqFdCstcxvJw",176,0.99435,31,177,1,176,1,1,0,1,1,89,88,88,88,63
"5882",81,"[31]xJHggqlIHcidKpcJvcGHqFdCstcxvJw",179,0.994444,31,180,1,179,1,1,0,1,1,100,99,80,80,63
"5883",82,"[31]xJHggqlIHcidKpcJvcGHqFdCstcxvJw",176,0.99435,31,177,1,176,1,1,0,1,1,89,88,88,88,63
"5884",83,"[31]xJHggqlIHcidKpcJvcGHqFdCstcxvJw",174,0.994286,31,175,1,174,1,1,0,1,1,82,81,93,93,63
"5885",84,"[31]xJHggqlIHcidKpcJvcGHqFdCstcxvJw",177,0.994382,31,178,1,177,1,1,0,1,1,92,91,86,86,63
"5886",85,"[31]xJHggqlIHcidKpcJvcGHqFdCstcxvJw",178,0.994413,31,179,1,178,1,1,0,1,1,96,95,83,83,63
"5887",86,"[31]xJHggqlIHcidKpcJvcGHqFdCstcxvJw",176,0.99435,31,177,1,176,1,1,0,1,1,88,87,89,89,63
"5888",87,"[31]xJHggqlIHcidKpcJvcGHqFdCstcxvJw",174,0.994286,31,175,1,174,1,1,0,1,1,84,83,91,91,63
"5889",88,"[31]xJHggqlIHcidKpcJvcGHqFdCstcxvJw",175,0.994318,31,176,1,175,1,1,0,1,1,87,86,89,89,63
"5890",89,"[31]xJHggqlIHcidKpcJvcGHqFdCstcxvJw",177,0.994382,31,178,1,177,1,1,0,1,1,91,90,87,87,63
"5891",90,"[31]xJHggqlIHcidKpcJvcGHqFdCstcxvJw",178,0.994413,31,179,1,178,1,1,0,1,1,97,96,82,82,63
"5892",91,"[31]xJHggqlIHcidKpcJvcGHqFdCstcxvJw",176,0.99435,31,177,1,176,1,1,0,1,1,89,88,88,88,63
"5893",92,"[31]xJHggqlIHcidKpcJvcGHqFdCstcxvJw",177,0.994382,31,178,1,177,1,1,0,1,1,92,91,86,86,63
"5894",93,"[31]xJHggqlIHcidKpcJvcGHqFdCstcxvJw",176,0.99435,31,177,1,176,1,1,0,1,1,89,88,88,88,63
"5895",94,"[31]xJHggqlIHcidKpcJvcGHqFdCstcxvJw",177,0.994382,31,178,1,177,1,1,0,1,1,93,92,85,85,63
"5896",95,"[31]xJHggqlIHcidKpcJvcGHqFdCstcxvJw",177,0.994382,31,178,1,177,1,1,0,1,1,94,93,84,84,63
"5897",96,"[31]xJHggqlIHcidKpcJvcGHqFdCstcxvJw",177,0.994382,31,178,1,177,1,1,0,1,1,92,91,86,86,63
"5898",97,"[31]xJHggqlIHcidKpcJvcGHqFdCstcxvJw",179,0.994444,31,180,1,179,1,1,0,1,1,98,97,82,82,63
"5899",98,"[31]xJHggqlIHcidKpcJvcGHqFdCstcxvJw",175,0.994318,31,176,1,175,1,1,0,1,1,86,85,90,90,63
"5900",99,"[31]xJHggqlIHcidKpcJvcGHqFdCstcxvJw",176,0.99435,31,177,1,176,1,1,0,1,1,90,89,87,87,63
"5901",0,"[30]uJHggqIHcjidKpcJvcGHqFdCFtpqwK",172,0.99422,30,173,1,172,1,1,0,1,1,77,76,96,96,64
"5902",1,"[30]uJHggqIHcjidKpcJvcGHqFdCFtpqwK",173,0.994253,30,174,1,173,1,1,0,1,1,79,78,95,95,64
"5903",2,"[30]uJHggqIHcjidKpcJvcGHqFdCFtpqwK",177,0.994382,30,178,1,177,1,1,0,1,1,90,89,88,88,64
"5904",3,"[30]uJHggqIHcjidKpcJvcGHqFdCFtpqwK",176,0.99435,30,177,1,176,1,1,0,1,1,90,89,87,87,64
"5905",4,"[30]uJHggqIHcjidKpcJvcGHqFdCFtpqwK",175,0.994318,30,176,1,175,1,1,0,1,1,87,86,89,89,64
"5906",5,"[30]uJHggqIHcjidKpcJvcGHqFdCFtpqwK",173,0.994253,30,174,1,173,1,1,0,1,1,77,76,97,97,64
"5907",6,"[30]uJHggqIHcjidKpcJvcGHqFdCFtpqwK",173,0.994253,30,174,1,173,1,1,0,1,1,78,77,96,96,64
"5908",7,"[30]uJHggqIHcjidKpcJvcGHqFdCFtpqwK",177,0.994382,30,178,1,177,1,1,0,1,1,91,90,87,87,64
"5909",8,"[30]uJHggqIHcjidKpcJvcGHqFdCFtpqwK",177,0.994382,30,178,1,177,1,1,0,1,1,92,91,86,86,64
"5910",9,"[30]uJHggqIHcjidKpcJvcGHqFdCFtpqwK",179,0.994444,30,180,1,179,1,1,0,1,1,99,98,81,81,64
"5911",10,"[30]uJHggqIHcjidKpcJvcGHqFdCFtpqwK",177,0.994382,30,178,1,177,1,1,0,1,1,94,93,84,84,64
"5912",11,"[30]uJHggqIHcjidKpcJvcGHqFdCFtpqwK",175,0.994318,30,176,1,175,1,1,0,1,1,87,86,89,89,64
"5913",12,"[30]uJHggqIHcjidKpcJvcGHqFdCFtpqwK",180,0.994475,30,181,1,180,1,1,0,1,1,103,102,78,78,64
"5914",13,"[30]uJHggqIHcjidKpcJvcGHqFdCFtpqwK",178,0.994413,30,179,1,178,1,1,0,1,1,94,93,85,85,64
"5915",14,"[30]uJHggqIHcjidKpcJvcGHqFdCFtpqwK",177,0.994382,30,178,1,177,1,1,0,1,1,92,91,86,86,64
"5916",15,"[30]uJHggqIHcjidKpcJvcGHqFdCFtpqwK",176,0.99435,30,177,1,176,1,1,0,1,1,89,88,88,88,64
"5917",16,"[30]uJHggqIHcjidKpcJvcGHqFdCFtpqwK",174,0.994286,30,175,1,174,1,1,0,1,1,82,81,93,93,64
"5918",17,"[30]uJHggqIHcjidKpcJvcGHqFdCFtpqwK",176,0.99435,30,177,1,176,1,1,0,1,1,89,88,88,88,64
"5919",18,"[30]uJHggqIHcjidKpcJvcGHqFdCFtpqwK",179,0.994444,30,180,1,179,1,1,0,1,1,98,97,82,82,64
"5920",19,"[30]uJHggqIHcjidKpcJvcGHqFdCFtpqwK",175,0.994318,30,176,1,175,1,1,0,1,1,87,86,89,89,64
"5921",20,"[30]uJHggqIHcjidKpcJvcGHqFdCFtpqwK",174,0.994286,30,175,1,174,1,1,0,1,1,82,81,93,93,64
"5922",21,"[30]uJHggqIHcjidKpcJvcGHqFdCFtpqwK",175,0.994318,30,176,1,175,1,1,0,1,1,87,86,89,89,64
"5923",22,"[30]uJHggqIHcjidKpcJvcGHqFdCFtpqwK",175,0.994318,30,176,1,175,1,1,0,1,1,86,85,90,90,64
"5924",23,"[30]uJHggqIHcjidKpcJvcGHqFdCFtpqwK",171,0.994186,30,172,1,171,1,1,0,1,1,73,72,99,99,64
"5925",24,"[30]uJHggqIHcjidKpcJvcGHqFdCFtpqwK",177,0.994382,30,178,1,177,1,1,0,1,1,93,92,85,85,64
"5926",25,"[30]uJHggqIHcjidKpcJvcGHqFdCFtpqwK",175,0.994318,30,176,1,175,1,1,0,1,1,87,86,89,89,64
"5927",26,"[30]uJHggqIHcjidKpcJvcGHqFdCFtpqwK",177,0.994382,30,178,1,177,1,1,0,1,1,94,93,84,84,64
"5928",27,"[30]uJHggqIHcjidKpcJvcGHqFdCFtpqwK",177,0.994382,30,178,1,177,1,1,0,1,1,91,90,87,87,64
"5929",28,"[30]uJHggqIHcjidKpcJvcGHqFdCFtpqwK",178,0.994413,30,179,1,178,1,1,0,1,1,95,94,84,84,64
"5930",29,"[30]uJHggqIHcjidKpcJvcGHqFdCFtpqwK",176,0.99435,30,177,1,176,1,1,0,1,1,87,86,90,90,64
"5931",30,"[30]uJHggqIHcjidKpcJvcGHqFdCFtpqwK",176,0.99435,30,177,1,176,1,1,0,1,1,88,87,89,89,64
"5932",31,"[30]uJHggqIHcjidKpcJvcGHqFdCFtpqwK",176,0.99435,30,177,1,176,1,1,0,1,1,91,90,86,86,64
"5933",32,"[30]uJHggqIHcjidKpcJvcGHqFdCFtpqwK",175,0.994318,30,176,1,175,1,1,0,1,1,87,86,89,89,64
"5934",33,"[30]uJHggqIHcjidKpcJvcGHqFdCFtpqwK",176,0.99435,30,177,1,176,1,1,0,1,1,88,87,89,89,64
"5935",34,"[30]uJHggqIHcjidKpcJvcGHqFdCFtpqwK",174,0.994286,30,175,1,174,1,1,0,1,1,84,83,91,91,64
"5936",35,"[30]uJHggqIHcjidKpcJvcGHqFdCFtpqwK",172,0.99422,30,173,1,172,1,1,0,1,1,77,76,96,96,64
"5937",36,"[30]uJHggqIHcjidKpcJvcGHqFdCFtpqwK",177,0.994382,30,178,1,177,1,1,0,1,1,91,90,87,87,64
"5938",37,"[30]uJHggqIHcjidKpcJvcGHqFdCFtpqwK",174,0.994286,30,175,1,174,1,1,0,1,1,84,83,91,91,64
"5939",38,"[30]uJHggqIHcjidKpcJvcGHqFdCFtpqwK",177,0.994382,30,178,1,177,1,1,0,1,1,93,92,85,85,64
"5940",39,"[30]uJHggqIHcjidKpcJvcGHqFdCFtpqwK",179,0.994444,30,180,1,179,1,1,0,1,1,98,97,82,82,64
"5941",40,"[30]uJHggqIHcjidKpcJvcGHqFdCFtpqwK",173,0.994253,30,174,1,173,1,1,0,1,1,79,78,95,95,64
"5942",41,"[30]uJHggqIHcjidKpcJvcGHqFdCFtpqwK",177,0.994382,30,178,1,177,1,1,0,1,1,93,92,85,85,64
"5943",42,"[30]uJHggqIHcjidKpcJvcGHqFdCFtpqwK",179,0.994444,30,180,1,179,1,1,0,1,1,98,97,82,82,64
"5944",43,"[30]uJHggqIHcjidKpcJvcGHqFdCFtpqwK",175,0.994318,30,176,1,175,1,1,0,1,1,84,83,92,92,64
"5945",44,"[30]uJHggqIHcjidKpcJvcGHqFdCFtpqwK",176,0.99435,30,177,1,176,1,1,0,1,1,89,88,88,88,64
"5946",45,"[30]uJHggqIHcjidKpcJvcGHqFdCFtpqwK",174,0.994286,30,175,1,174,1,1,0,1,1,84,83,91,91,64
"5947",46,"[30]uJHggqIHcjidKpcJvcGHqFdCFtpqwK",175,0.994318,30,176,1,175,1,1,0,1,1,87,86,89,89,64
"5948",47,"[30]uJHggqIHcjidKpcJvcGHqFdCFtpqwK",175,0.994318,30,176,1,175,1,1,0,1,1,85,84,91,91,64
"5949",48,"[30]uJHggqIHcjidKpcJvcGHqFdCFtpqwK",177,0.994382,30,178,1,177,1,1,0,1,1,92,91,86,86,64
"5950",49,"[30]uJHggqIHcjidKpcJvcGHqFdCFtpqwK",174,0.994286,30,175,1,174,1,1,0,1,1,84,83,91,91,64
"5951",50,"[30]uJHggqIHcjidKpcJvcGHqFdCFtpqwK",176,0.99435,30,177,1,176,1,1,0,1,1,88,87,89,89,64
"5952",51,"[30]uJHggqIHcjidKpcJvcGHqFdCFtpqwK",176,0.99435,30,177,1,176,1,1,0,1,1,88,87,89,89,64
"5953",52,"[30]uJHggqIHcjidKpcJvcGHqFdCFtpqwK",173,0.994253,30,174,1,173,1,1,0,1,1,79,78,95,95,64
"5954",53,"[30]uJHggqIHcjidKpcJvcGHqFdCFtpqwK",175,0.994318,30,176,1,175,1,1,0,1,1,87,86,89,89,64
"5955",54,"[30]uJHggqIHcjidKpcJvcGHqFdCFtpqwK",172,0.99422,30,173,1,172,1,1,0,1,1,76,75,97,97,64
"5956",55,"[30]uJHggqIHcjidKpcJvcGHqFdCFtpqwK",178,0.994413,30,179,1,178,1,1,0,1,1,97,96,82,82,64
"5957",56,"[30]uJHggqIHcjidKpcJvcGHqFdCFtpqwK",172,0.99422,30,173,1,172,1,1,0,1,1,76,75,97,97,64
"5958",57,"[30]uJHggqIHcjidKpcJvcGHqFdCFtpqwK",177,0.994382,30,178,1,177,1,1,0,1,1,93,92,85,85,64
"5959",58,"[30]uJHggqIHcjidKpcJvcGHqFdCFtpqwK",172,0.99422,30,173,1,172,1,1,0,1,1,76,75,97,97,64
"5960",59,"[30]uJHggqIHcjidKpcJvcGHqFdCFtpqwK",173,0.994253,30,174,1,173,1,1,0,1,1,78,77,96,96,64
"5961",60,"[30]uJHggqIHcjidKpcJvcGHqFdCFtpqwK",177,0.994382,30,178,1,177,1,1,0,1,1,93,92,85,85,64
"5962",61,"[30]uJHggqIHcjidKpcJvcGHqFdCFtpqwK",176,0.99435,30,177,1,176,1,1,0,1,1,88,87,89,89,64
"5963",62,"[30]uJHggqIHcjidKpcJvcGHqFdCFtpqwK",178,0.994413,30,179,1,178,1,1,0,1,1,91,90,88,88,64
"5964",63,"[30]uJHggqIHcjidKpcJvcGHqFdCFtpqwK",174,0.994286,30,175,1,174,1,1,0,1,1,83,82,92,92,64
"5965",64,"[30]uJHggqIHcjidKpcJvcGHqFdCFtpqwK",177,0.994382,30,178,1,177,1,1,0,1,1,93,92,85,85,64
"5966",65,"[30]uJHggqIHcjidKpcJvcGHqFdCFtpqwK",178,0.994413,30,179,1,178,1,1,0,1,1,95,94,84,84,64
"5967",66,"[30]uJHggqIHcjidKpcJvcGHqFdCFtpqwK",177,0.994382,30,178,1,177,1,1,0,1,1,93,92,85,85,64
"5968",67,"[30]uJHggqIHcjidKpcJvcGHqFdCFtpqwK",177,0.994382,30,178,1,177,1,1,0,1,1,92,91,86,86,64
"5969",68,"[30]uJHggqIHcjidKpcJvcGHqFdCFtpqwK",176,0.99435,30,177,1,176,1,1,0,1,1,89,88,88,88,64
"5970",69,"[30]uJHggqIHcjidKpcJvcGHqFdCFtpqwK",174,0.994286,30,175,1,174,1,1,0,1,1,81,80,94,94,64
"5971",70,"[30]uJHggqIHcjidKpcJvcGHqFdCFtpqwK",174,0.994286,30,175,1,174,1,1,0,1,1,82,81,93,93,64
"5972",71,"[30]uJHggqIHcjidKpcJvcGHqFdCFtpqwK",174,0.994286,30,175,1,174,1,1,0,1,1,82,81,93,93,64
"5973",72,"[30]uJHggqIHcjidKpcJvcGHqFdCFtpqwK",177,0.994382,30,178,1,177,1,1,0,1,1,90,89,88,88,64
"5974",73,"[30]uJHggqIHcjidKpcJvcGHqFdCFtpqwK",174,0.994286,30,175,1,174,1,1,0,1,1,83,82,92,92,64
"5975",74,"[30]uJHggqIHcjidKpcJvcGHqFdCFtpqwK",179,0.994444,30,180,1,179,1,1,0,1,1,100,99,80,80,64
"5976",75,"[30]uJHggqIHcjidKpcJvcGHqFdCFtpqwK",182,0.994536,30,183,1,182,1,1,0,1,1,105,104,78,78,64
"5977",76,"[30]uJHggqIHcjidKpcJvcGHqFdCFtpqwK",176,0.99435,30,177,1,176,1,1,0,1,1,91,90,86,86,64
"5978",77,"[30]uJHggqIHcjidKpcJvcGHqFdCFtpqwK",179,0.994444,30,180,1,179,1,1,0,1,1,98,97,82,82,64
"5979",78,"[30]uJHggqIHcjidKpcJvcGHqFdCFtpqwK",173,0.994253,30,174,1,173,1,1,0,1,1,81,80,93,93,64
"5980",79,"[30]uJHggqIHcjidKpcJvcGHqFdCFtpqwK",177,0.994382,30,178,1,177,1,1,0,1,1,91,90,87,87,64
"5981",80,"[30]uJHggqIHcjidKpcJvcGHqFdCFtpqwK",177,0.994382,30,178,1,177,1,1,0,1,1,90,89,88,88,64
"5982",81,"[30]uJHggqIHcjidKpcJvcGHqFdCFtpqwK",178,0.994413,30,179,1,178,1,1,0,1,1,95,94,84,84,64
"5983",82,"[30]uJHggqIHcjidKpcJvcGHqFdCFtpqwK",174,0.994286,30,175,1,174,1,1,0,1,1,82,81,93,93,64
"5984",83,"[30]uJHggqIHcjidKpcJvcGHqFdCFtpqwK",175,0.994318,30,176,1,175,1,1,0,1,1,85,84,91,91,64
"5985",84,"[30]uJHggqIHcjidKpcJvcGHqFdCFtpqwK",177,0.994382,30,178,1,177,1,1,0,1,1,92,91,86,86,64
"5986",85,"[30]uJHggqIHcjidKpcJvcGHqFdCFtpqwK",178,0.994413,30,179,1,178,1,1,0,1,1,95,94,84,84,64
"5987",86,"[30]uJHggqIHcjidKpcJvcGHqFdCFtpqwK",177,0.994382,30,178,1,177,1,1,0,1,1,89,88,89,89,64
"5988",87,"[30]uJHggqIHcjidKpcJvcGHqFdCFtpqwK",176,0.99435,30,177,1,176,1,1,0,1,1,90,89,87,87,64
"5989",88,"[30]uJHggqIHcjidKpcJvcGHqFdCFtpqwK",178,0.994413,30,179,1,178,1,1,0,1,1,95,94,84,84,64
"5990",89,"[30]uJHggqIHcjidKpcJvcGHqFdCFtpqwK",173,0.994253,30,174,1,173,1,1,0,1,1,78,77,96,96,64
"5991",90,"[30]uJHggqIHcjidKpcJvcGHqFdCFtpqwK",174,0.994286,30,175,1,174,1,1,0,1,1,83,82,92,92,64
"5992",91,"[30]uJHggqIHcjidKpcJvcGHqFdCFtpqwK",173,0.994253,30,174,1,173,1,1,0,1,1,80,79,94,94,64
"5993",92,"[30]uJHggqIHcjidKpcJvcGHqFdCFtpqwK",175,0.994318,30,176,1,175,1,1,0,1,1,85,84,91,91,64
"5994",93,"[30]uJHggqIHcjidKpcJvcGHqFdCFtpqwK",178,0.994413,30,179,1,178,1,1,0,1,1,97,96,82,82,64
"5995",94,"[30]uJHggqIHcjidKpcJvcGHqFdCFtpqwK",177,0.994382,30,178,1,177,1,1,0,1,1,92,91,86,86,64
"5996",95,"[30]uJHggqIHcjidKpcJvcGHqFdCFtpqwK",179,0.994444,30,180,1,179,1,1,0,1,1,97,96,83,83,64
"5997",96,"[30]uJHggqIHcjidKpcJvcGHqFdCFtpqwK",175,0.994318,30,176,1,175,1,1,0,1,1,87,86,89,89,64
"5998",97,"[30]uJHggqIHcjidKpcJvcGHqFdCFtpqwK",179,0.994444,30,180,1,179,1,1,0,1,1,99,98,81,81,64
"5999",98,"[30]uJHggqIHcjidKpcJvcGHqFdCFtpqwK",174,0.994286,30,175,1,174,1,1,0,1,1,83,82,92,92,64
"6000",99,"[30]uJHggqIHcjidKpcJvcGHqFdCFtpqwK",175,0.994318,30,176,1,175,1,1,0,1,1,87,86,89,89,64
"6001",0,"[28]zJHggqIHcdKpcJvcGHqwdCeCqxJD",167,0.994048,28,168,1,167,1,1,0,1,1,86,85,82,82,65
"6002",1,"[28]zJHggqIHcdKpcJvcGHqwdCeCqxJD",165,0.993976,28,166,1,165,1,1,0,1,1,80,79,86,86,65
"6003",2,"[28]zJHggqIHcdKpcJvcGHqwdCeCqxJD",169,0.994118,28,170,1,169,1,1,0,1,1,88,87,82,82,65
"6004",3,"[28]zJHggqIHcdKpcJvcGHqwdCeCqxJD",164,0.993939,28,165,1,164,1,1,0,1,1,76,75,89,89,65
"6005",4,"[28]zJHggqIHcdKpcJvcGHqwdCeCqxJD",168,0.994083,28,169,1,168,1,1,0,1,1,88,87,81,81,65
"6006",5,"[28]zJHggqIHcdKpcJvcGHqwdCeCqxJD",166,0.994012,28,167,1,166,1,1,0,1,1,81,80,86,86,65
"6007",6,"[28]zJHggqIHcdKpcJvcGHqwdCeCqxJD",167,0.994048,28,168,1,167,1,1,0,1,1,84,83,84,84,65
"6008",7,"[28]zJHggqIHcdKpcJvcGHqwdCeCqxJD",166,0.994012,28,167,1,166,1,1,0,1,1,83,82,84,84,65
"6009",8,"[28]zJHggqIHcdKpcJvcGHqwdCeCqxJD",171,0.994186,28,172,1,171,1,1,0,1,1,96,95,76,76,65
"6010",9,"[28]zJHggqIHcdKpcJvcGHqwdCeCqxJD",163,0.993902,28,164,1,163,1,1,0,1,1,75,74,89,89,65
"6011",10,"[28]zJHggqIHcdKpcJvcGHqwdCeCqxJD",164,0.993939,28,165,1,164,1,1,0,1,1,76,75,89,89,65
"6012",11,"[28]zJHggqIHcdKpcJvcGHqwdCeCqxJD",166,0.994012,28,167,1,166,1,1,0,1,1,82,81,85,85,65
"6013",12,"[28]zJHggqIHcdKpcJvcGHqwdCeCqxJD",166,0.994012,28,167,1,166,1,1,0,1,1,81,80,86,86,65
"6014",13,"[28]zJHggqIHcdKpcJvcGHqwdCeCqxJD",164,0.993939,28,165,1,164,1,1,0,1,1,77,76,88,88,65
"6015",14,"[28]zJHggqIHcdKpcJvcGHqwdCeCqxJD",162,0.993865,28,163,1,162,1,1,0,1,1,71,70,92,92,65
"6016",15,"[28]zJHggqIHcdKpcJvcGHqwdCeCqxJD",169,0.994118,28,170,1,169,1,1,0,1,1,88,87,82,82,65
"6017",16,"[28]zJHggqIHcdKpcJvcGHqwdCeCqxJD",164,0.993939,28,165,1,164,1,1,0,1,1,76,75,89,89,65
"6018",17,"[28]zJHggqIHcdKpcJvcGHqwdCeCqxJD",163,0.993902,28,164,1,163,1,1,0,1,1,75,74,89,89,65
"6019",18,"[28]zJHggqIHcdKpcJvcGHqwdCeCqxJD",169,0.994118,28,170,1,169,1,1,0,1,1,89,88,81,81,65
"6020",19,"[28]zJHggqIHcdKpcJvcGHqwdCeCqxJD",164,0.993939,28,165,1,164,1,1,0,1,1,76,75,89,89,65
"6021",20,"[28]zJHggqIHcdKpcJvcGHqwdCeCqxJD",169,0.994118,28,170,1,169,1,1,0,1,1,91,90,79,79,65
"6022",21,"[28]zJHggqIHcdKpcJvcGHqwdCeCqxJD",169,0.994118,28,170,1,169,1,1,0,1,1,91,90,79,79,65
"6023",22,"[28]zJHggqIHcdKpcJvcGHqwdCeCqxJD",166,0.994012,28,167,1,166,1,1,0,1,1,83,82,84,84,65
"6024",23,"[28]zJHggqIHcdKpcJvcGHqwdCeCqxJD",176,0.99435,28,177,1,176,1,1,0,1,1,109,108,68,68,65
"6025",24,"[28]zJHggqIHcdKpcJvcGHqwdCeCqxJD",170,0.994152,28,171,1,170,1,1,0,1,1,93,92,78,78,65
"6026",25,"[28]zJHggqIHcdKpcJvcGHqwdCeCqxJD",170,0.994152,28,171,1,170,1,1,0,1,1,93,92,78,78,65
"6027",26,"[28]zJHggqIHcdKpcJvcGHqwdCeCqxJD",172,0.99422,28,173,1,172,1,1,0,1,1,98,97,75,75,65
"6028",27,"[28]zJHggqIHcdKpcJvcGHqwdCeCqxJD",170,0.994152,28,171,1,170,1,1,0,1,1,92,91,79,79,65
"6029",28,"[28]zJHggqIHcdKpcJvcGHqwdCeCqxJD",165,0.993976,28,166,1,165,1,1,0,1,1,80,79,86,86,65
"6030",29,"[28]zJHggqIHcdKpcJvcGHqwdCeCqxJD",172,0.99422,28,173,1,172,1,1,0,1,1,97,96,76,76,65
"6031",30,"[28]zJHggqIHcdKpcJvcGHqwdCeCqxJD",170,0.994152,28,171,1,170,1,1,0,1,1,93,92,78,78,65
"6032",31,"[28]zJHggqIHcdKpcJvcGHqwdCeCqxJD",165,0.993976,28,166,1,165,1,1,0,1,1,78,77,88,88,65
"6033",32,"[28]zJHggqIHcdKpcJvcGHqwdCeCqxJD",169,0.994118,28,170,1,169,1,1,0,1,1,90,89,80,80,65
"6034",33,"[28]zJHggqIHcdKpcJvcGHqwdCeCqxJD",170,0.994152,28,171,1,170,1,1,0,1,1,93,92,78,78,65
"6035",34,"[28]zJHggqIHcdKpcJvcGHqwdCeCqxJD",168,0.994083,28,169,1,168,1,1,0,1,1,87,86,82,82,65
"6036",35,"[28]zJHggqIHcdKpcJvcGHqwdCeCqxJD",161,0.993827,28,162,1,161,1,1,0,1,1,69,68,93,93,65
"6037",36,"[28]zJHggqIHcdKpcJvcGHqwdCeCqxJD",165,0.993976,28,166,1,165,1,1,0,1,1,79,78,87,87,65
"6038",37,"[28]zJHggqIHcdKpcJvcGHqwdCeCqxJD",168,0.994083,28,169,1,168,1,1,0,1,1,88,87,81,81,65
"6039",38,"[28]zJHggqIHcdKpcJvcGHqwdCeCqxJD",168,0.994083,28,169,1,168,1,1,0,1,1,87,86,82,82,65
"6040",39,"[28]zJHggqIHcdKpcJvcGHqwdCeCqxJD",167,0.994048,28,168,1,167,1,1,0,1,1,85,84,83,83,65
"6041",40,"[28]zJHggqIHcdKpcJvcGHqwdCeCqxJD",169,0.994118,28,170,1,169,1,1,0,1,1,90,89,80,80,65
"6042",41,"[28]zJHggqIHcdKpcJvcGHqwdCeCqxJD",165,0.993976,28,166,1,165,1,1,0,1,1,80,79,86,86,65
"6043",42,"[28]zJHggqIHcdKpcJvcGHqwdCeCqxJD",176,0.99435,28,177,1,176,1,1,0,1,1,108,107,69,69,65
"6044",43,"[28]zJHggqIHcdKpcJvcGHqwdCeCqxJD",166,0.994012,28,167,1,166,1,1,0,1,1,80,79,87,87,65
"6045",44,"[28]zJHggqIHcdKpcJvcGHqwdCeCqxJD",168,0.994083,28,169,1,168,1,1,0,1,1,88,87,81,81,65
"6046",45,"[28]zJHggqIHcdKpcJvcGHqwdCeCqxJD",163,0.993902,28,164,1,163,1,1,0,1,1,75,74,89,89,65
"6047",46,"[28]zJHggqIHcdKpcJvcGHqwdCeCqxJD",163,0.993902,28,164,1,163,1,1,0,1,1,74,73,90,90,65
"6048",47,"[28]zJHggqIHcdKpcJvcGHqwdCeCqxJD",167,0.994048,28,168,1,167,1,1,0,1,1,85,84,83,83,65
"6049",48,"[28]zJHggqIHcdKpcJvcGHqwdCeCqxJD",165,0.993976,28,166,1,165,1,1,0,1,1,80,79,86,86,65
"6050",49,"[28]zJHggqIHcdKpcJvcGHqwdCeCqxJD",168,0.994083,28,169,1,168,1,1,0,1,1,88,87,81,81,65
"6051",50,"[28]zJHggqIHcdKpcJvcGHqwdCeCqxJD",167,0.994048,28,168,1,167,1,1,0,1,1,86,85,82,82,65
"6052",51,"[28]zJHggqIHcdKpcJvcGHqwdCeCqxJD",165,0.993976,28,166,1,165,1,1,0,1,1,80,79,86,86,65
"6053",52,"[28]zJHggqIHcdKpcJvcGHqwdCeCqxJD",165,0.993976,28,166,1,165,1,1,0,1,1,78,77,88,88,65
"6054",53,"[28]zJHggqIHcdKpcJvcGHqwdCeCqxJD",169,0.994118,28,170,1,169,1,1,0,1,1,91,90,79,79,65
"6055",54,"[28]zJHggqIHcdKpcJvcGHqwdCeCqxJD",170,0.994152,28,171,1,170,1,1,0,1,1,94,93,77,77,65
"6056",55,"[28]zJHggqIHcdKpcJvcGHqwdCeCqxJD",169,0.994118,28,170,1,169,1,1,0,1,1,89,88,81,81,65
"6057",56,"[28]zJHggqIHcdKpcJvcGHqwdCeCqxJD",169,0.994118,28,170,1,169,1,1,0,1,1,89,88,81,81,65
"6058",57,"[28]zJHggqIHcdKpcJvcGHqwdCeCqxJD",166,0.994012,28,167,1,166,1,1,0,1,1,82,81,85,85,65
"6059",58,"[28]zJHggqIHcdKpcJvcGHqwdCeCqxJD",168,0.994083,28,169,1,168,1,1,0,1,1,88,87,81,81,65
"6060",59,"[28]zJHggqIHcdKpcJvcGHqwdCeCqxJD",169,0.994118,28,170,1,169,1,1,0,1,1,87,86,83,83,65
"6061",60,"[28]zJHggqIHcdKpcJvcGHqwdCeCqxJD",167,0.994048,28,168,1,167,1,1,0,1,1,85,84,83,83,65
"6062",61,"[28]zJHggqIHcdKpcJvcGHqwdCeCqxJD",173,0.994253,28,174,1,173,1,1,0,1,1,99,98,75,75,65
"6063",62,"[28]zJHggqIHcdKpcJvcGHqwdCeCqxJD",168,0.994083,28,169,1,168,1,1,0,1,1,87,86,82,82,65
"6064",63,"[28]zJHggqIHcdKpcJvcGHqwdCeCqxJD",165,0.993976,28,166,1,165,1,1,0,1,1,78,77,88,88,65
"6065",64,"[28]zJHggqIHcdKpcJvcGHqwdCeCqxJD",172,0.99422,28,173,1,172,1,1,0,1,1,98,97,75,75,65
"6066",65,"[28]zJHggqIHcdKpcJvcGHqwdCeCqxJD",172,0.99422,28,173,1,172,1,1,0,1,1,98,97,75,75,65
"6067",66,"[28]zJHggqIHcdKpcJvcGHqwdCeCqxJD",162,0.993865,28,163,1,162,1,1,0,1,1,72,71,91,91,65
"6068",67,"[28]zJHggqIHcdKpcJvcGHqwdCeCqxJD",170,0.994152,28,171,1,170,1,1,0,1,1,92,91,79,79,65
"6069",68,"[28]zJHggqIHcdKpcJvcGHqwdCeCqxJD",165,0.993976,28,166,1,165,1,1,0,1,1,79,78,87,87,65
"6070",69,"[28]zJHggqIHcdKpcJvcGHqwdCeCqxJD",171,0.994186,28,172,1,171,1,1,0,1,1,94,93,78,78,65
"6071",70,"[28]zJHggqIHcdKpcJvcGHqwdCeCqxJD",164,0.993939,28,165,1,164,1,1,0,1,1,76,75,89,89,65
"6072",71,"[28]zJHggqIHcdKpcJvcGHqwdCeCqxJD",169,0.994118,28,170,1,169,1,1,0,1,1,90,89,80,80,65
"6073",72,"[28]zJHggqIHcdKpcJvcGHqwdCeCqxJD",170,0.994152,28,171,1,170,1,1,0,1,1,93,92,78,78,65
"6074",73,"[28]zJHggqIHcdKpcJvcGHqwdCeCqxJD",173,0.994253,28,174,1,173,1,1,0,1,1,102,101,72,72,65
"6075",74,"[28]zJHggqIHcdKpcJvcGHqwdCeCqxJD",166,0.994012,28,167,1,166,1,1,0,1,1,81,80,86,86,65
"6076",75,"[28]zJHggqIHcdKpcJvcGHqwdCeCqxJD",165,0.993976,28,166,1,165,1,1,0,1,1,78,77,88,88,65
"6077",76,"[28]zJHggqIHcdKpcJvcGHqwdCeCqxJD",167,0.994048,28,168,1,167,1,1,0,1,1,86,85,82,82,65
"6078",77,"[28]zJHggqIHcdKpcJvcGHqwdCeCqxJD",166,0.994012,28,167,1,166,1,1,0,1,1,82,81,85,85,65
"6079",78,"[28]zJHggqIHcdKpcJvcGHqwdCeCqxJD",168,0.994083,28,169,1,168,1,1,0,1,1,87,86,82,82,65
"6080",79,"[28]zJHggqIHcdKpcJvcGHqwdCeCqxJD",167,0.994048,28,168,1,167,1,1,0,1,1,85,84,83,83,65
"6081",80,"[28]zJHggqIHcdKpcJvcGHqwdCeCqxJD",163,0.993902,28,164,1,163,1,1,0,1,1,74,73,90,90,65
"6082",81,"[28]zJHggqIHcdKpcJvcGHqwdCeCqxJD",164,0.993939,28,165,1,164,1,1,0,1,1,76,75,89,89,65
"6083",82,"[28]zJHggqIHcdKpcJvcGHqwdCeCqxJD",169,0.994118,28,170,1,169,1,1,0,1,1,89,88,81,81,65
"6084",83,"[28]zJHggqIHcdKpcJvcGHqwdCeCqxJD",164,0.993939,28,165,1,164,1,1,0,1,1,75,74,90,90,65
"6085",84,"[28]zJHggqIHcdKpcJvcGHqwdCeCqxJD",167,0.994048,28,168,1,167,1,1,0,1,1,86,85,82,82,65
"6086",85,"[28]zJHggqIHcdKpcJvcGHqwdCeCqxJD",164,0.993939,28,165,1,164,1,1,0,1,1,76,75,89,89,65
"6087",86,"[28]zJHggqIHcdKpcJvcGHqwdCeCqxJD",167,0.994048,28,168,1,167,1,1,0,1,1,85,84,83,83,65
"6088",87,"[28]zJHggqIHcdKpcJvcGHqwdCeCqxJD",168,0.994083,28,169,1,168,1,1,0,1,1,88,87,81,81,65
"6089",88,"[28]zJHggqIHcdKpcJvcGHqwdCeCqxJD",168,0.994083,28,169,1,168,1,1,0,1,1,88,87,81,81,65
"6090",89,"[28]zJHggqIHcdKpcJvcGHqwdCeCqxJD",166,0.994012,28,167,1,166,1,1,0,1,1,82,81,85,85,65
"6091",90,"[28]zJHggqIHcdKpcJvcGHqwdCeCqxJD",165,0.993976,28,166,1,165,1,1,0,1,1,79,78,87,87,65
"6092",91,"[28]zJHggqIHcdKpcJvcGHqwdCeCqxJD",170,0.994152,28,171,1,170,1,1,0,1,1,93,92,78,78,65
"6093",92,"[28]zJHggqIHcdKpcJvcGHqwdCeCqxJD",166,0.994012,28,167,1,166,1,1,0,1,1,81,80,86,86,65
"6094",93,"[28]zJHggqIHcdKpcJvcGHqwdCeCqxJD",168,0.994083,28,169,1,168,1,1,0,1,1,87,86,82,82,65
"6095",94,"[28]zJHggqIHcdKpcJvcGHqwdCeCqxJD",168,0.994083,28,169,1,168,1,1,0,1,1,87,86,82,82,65
"6096",95,"[28]zJHggqIHcdKpcJvcGHqwdCeCqxJD",165,0.993976,28,166,1,165,1,1,0,1,1,80,79,86,86,65
"6097",96,"[28]zJHggqIHcdKpcJvcGHqwdCeCqxJD",165,0.993976,28,166,1,165,1,1,0,1,1,79,78,87,87,65
"6098",97,"[28]zJHggqIHcdKpcJvcGHqwdCeCqxJD",164,0.993939,28,165,1,164,1,1,0,1,1,77,76,88,88,65
"6099",98,"[28]zJHggqIHcdKpcJvcGHqwdCeCqxJD",169,0.994118,28,170,1,169,1,1,0,1,1,89,88,81,81,65
"6100",99,"[28]zJHggqIHcdKpcJvcGHqwdCeCqxJD",165,0.993976,28,166,1,165,1,1,0,1,1,80,79,86,86,65
"6101",0,"[30]cJHggqIHcdKocJvcGHqxdCjbmCxpwm",170,0.994152,30,171,1,170,1,1,0,1,1,94,93,77,77,66
"6102",1,"[30]cJHggqIHcdKocJvcGHqxdCjbmCxpwm",166,0.994012,30,167,1,166,1,1,0,1,1,81,80,86,86,66
"6103",2,"[30]cJHggqIHcdKocJvcGHqxdCjbmCxpwm",167,0.994048,30,168,1,167,1,1,0,1,1,84,83,84,84,66
"6104",3,"[30]cJHggqIHcdKocJvcGHqxdCjbmCxpwm",170,0.994152,30,171,1,170,1,1,0,1,1,92,91,79,79,66
"6105",4,"[30]cJHggqIHcdKocJvcGHqxdCjbmCxpwm",166,0.994012,30,167,1,166,1,1,0,1,1,81,80,86,86,66
"6106",5,"[30]cJHggqIHcdKocJvcGHqxdCjbmCxpwm",167,0.994048,30,168,1,167,1,1,0,1,1,85,84,83,83,66
"6107",6,"[30]cJHggqIHcdKocJvcGHqxdCjbmCxpwm",164,0.993939,30,165,1,164,1,1,0,1,1,77,76,88,88,66
"6108",7,"[30]cJHggqIHcdKocJvcGHqxdCjbmCxpwm",165,0.993976,30,166,1,165,1,1,0,1,1,79,78,87,87,66
"6109",8,"[30]cJHggqIHcdKocJvcGHqxdCjbmCxpwm",167,0.994048,30,168,1,167,1,1,0,1,1,84,83,84,84,66
"6110",9,"[30]cJHggqIHcdKocJvcGHqxdCjbmCxpwm",170,0.994152,30,171,1,170,1,1,0,1,1,93,92,78,78,66
"6111",10,"[30]cJHggqIHcdKocJvcGHqxdCjbmCxpwm",172,0.99422,30,173,1,172,1,1,0,1,1,99,98,74,74,66
"6112",11,"[30]cJHggqIHcdKocJvcGHqxdCjbmCxpwm",165,0.993976,30,166,1,165,1,1,0,1,1,80,79,86,86,66
"6113",12,"[30]cJHggqIHcdKocJvcGHqxdCjbmCxpwm",166,0.994012,30,167,1,166,1,1,0,1,1,83,82,84,84,66
"6114",13,"[30]cJHggqIHcdKocJvcGHqxdCjbmCxpwm",163,0.993902,30,164,1,163,1,1,0,1,1,73,72,91,91,66
"6115",14,"[30]cJHggqIHcdKocJvcGHqxdCjbmCxpwm",163,0.993902,30,164,1,163,1,1,0,1,1,74,73,90,90,66
"6116",15,"[30]cJHggqIHcdKocJvcGHqxdCjbmCxpwm",168,0.994083,30,169,1,168,1,1,0,1,1,88,87,81,81,66
"6117",16,"[30]cJHggqIHcdKocJvcGHqxdCjbmCxpwm",171,0.994186,30,172,1,171,1,1,0,1,1,95,94,77,77,66
"6118",17,"[30]cJHggqIHcdKocJvcGHqxdCjbmCxpwm",171,0.994186,30,172,1,171,1,1,0,1,1,94,93,78,78,66
"6119",18,"[30]cJHggqIHcdKocJvcGHqxdCjbmCxpwm",164,0.993939,30,165,1,164,1,1,0,1,1,75,74,90,90,66
"6120",19,"[30]cJHggqIHcdKocJvcGHqxdCjbmCxpwm",168,0.994083,30,169,1,168,1,1,0,1,1,87,86,82,82,66
"6121",20,"[30]cJHggqIHcdKocJvcGHqxdCjbmCxpwm",169,0.994118,30,170,1,169,1,1,0,1,1,90,89,80,80,66
"6122",21,"[30]cJHggqIHcdKocJvcGHqxdCjbmCxpwm",163,0.993902,30,164,1,163,1,1,0,1,1,74,73,90,90,66
"6123",22,"[30]cJHggqIHcdKocJvcGHqxdCjbmCxpwm",164,0.993939,30,165,1,164,1,1,0,1,1,75,74,90,90,66
"6124",23,"[30]cJHggqIHcdKocJvcGHqxdCjbmCxpwm",166,0.994012,30,167,1,166,1,1,0,1,1,83,82,84,84,66
"6125",24,"[30]cJHggqIHcdKocJvcGHqxdCjbmCxpwm",173,0.994253,30,174,1,173,1,1,0,1,1,99,98,75,75,66
"6126",25,"[30]cJHggqIHcdKocJvcGHqxdCjbmCxpwm",169,0.994118,30,170,1,169,1,1,0,1,1,90,89,80,80,66
"6127",26,"[30]cJHggqIHcdKocJvcGHqxdCjbmCxpwm",166,0.994012,30,167,1,166,1,1,0,1,1,81,80,86,86,66
"6128",27,"[30]cJHggqIHcdKocJvcGHqxdCjbmCxpwm",166,0.994012,30,167,1,166,1,1,0,1,1,82,81,85,85,66
"6129",28,"[30]cJHggqIHcdKocJvcGHqxdCjbmCxpwm",162,0.993865,30,163,1,162,1,1,0,1,1,71,70,92,92,66
"6130",29,"[30]cJHggqIHcdKocJvcGHqxdCjbmCxpwm",168,0.994083,30,169,1,168,1,1,0,1,1,88,87,81,81,66
"6131",30,"[30]cJHggqIHcdKocJvcGHqxdCjbmCxpwm",167,0.994048,30,168,1,167,1,1,0,1,1,85,84,83,83,66
"6132",31,"[30]cJHggqIHcdKocJvcGHqxdCjbmCxpwm",160,0.993789,30,161,1,160,1,1,0,1,1,65,64,96,96,66
"6133",32,"[30]cJHggqIHcdKocJvcGHqxdCjbmCxpwm",162,0.993865,30,163,1,162,1,1,0,1,1,70,69,93,93,66
"6134",33,"[30]cJHggqIHcdKocJvcGHqxdCjbmCxpwm",170,0.994152,30,171,1,170,1,1,0,1,1,93,92,78,78,66
"6135",34,"[30]cJHggqIHcdKocJvcGHqxdCjbmCxpwm",164,0.993939,30,165,1,164,1,1,0,1,1,76,75,89,89,66
"6136",35,"[30]cJHggqIHcdKocJvcGHqxdCjbmCxpwm",168,0.994083,30,169,1,168,1,1,0,1,1,87,86,82,82,66
"6137",36,"[30]cJHggqIHcdKocJvcGHqxdCjbmCxpwm",167,0.994048,30,168,1,167,1,1,0,1,1,86,85,82,82,66
"6138",37,"[30]cJHggqIHcdKocJvcGHqxdCjbmCxpwm",160,0.993789,30,161,1,160,1,1,0,1,1,66,65,95,95,66
"6139",38,"[30]cJHggqIHcdKocJvcGHqxdCjbmCxpwm",165,0.993976,30,166,1,165,1,1,0,1,1,80,79,86,86,66
"6140",39,"[30]cJHggqIHcdKocJvcGHqxdCjbmCxpwm",168,0.994083,30,169,1,168,1,1,0,1,1,86,85,83,83,66
"6141",40,"[30]cJHggqIHcdKocJvcGHqxdCjbmCxpwm",168,0.994083,30,169,1,168,1,1,0,1,1,88,87,81,81,66
"6142",41,"[30]cJHggqIHcdKocJvcGHqxdCjbmCxpwm",175,0.994318,30,176,1,175,1,1,0,1,1,105,104,71,71,66
"6143",42,"[30]cJHggqIHcdKocJvcGHqxdCjbmCxpwm",170,0.994152,30,171,1,170,1,1,0,1,1,93,92,78,78,66
"6144",43,"[30]cJHggqIHcdKocJvcGHqxdCjbmCxpwm",171,0.994186,30,172,1,171,1,1,0,1,1,97,96,75,75,66
"6145",44,"[30]cJHggqIHcdKocJvcGHqxdCjbmCxpwm",172,0.99422,30,173,1,172,1,1,0,1,1,98,97,75,75,66
"6146",45,"[30]cJHggqIHcdKocJvcGHqxdCjbmCxpwm",165,0.993976,30,166,1,165,1,1,0,1,1,78,77,88,88,66
"6147",46,"[30]cJHggqIHcdKocJvcGHqxdCjbmCxpwm",169,0.994118,30,170,1,169,1,1,0,1,1,90,89,80,80,66
"6148",47,"[30]cJHggqIHcdKocJvcGHqxdCjbmCxpwm",166,0.994012,30,167,1,166,1,1,0,1,1,81,80,86,86,66
"6149",48,"[30]cJHggqIHcdKocJvcGHqxdCjbmCxpwm",167,0.994048,30,168,1,167,1,1,0,1,1,84,83,84,84,66
"6150",49,"[30]cJHggqIHcdKocJvcGHqxdCjbmCxpwm",166,0.994012,30,167,1,166,1,1,0,1,1,82,81,85,85,66
"6151",50,"[30]cJHggqIHcdKocJvcGHqxdCjbmCxpwm",167,0.994048,30,168,1,167,1,1,0,1,1,85,84,83,83,66
"6152",51,"[30]cJHggqIHcdKocJvcGHqxdCjbmCxpwm",163,0.993902,30,164,1,163,1,1,0,1,1,75,74,89,89,66
"6153",52,"[30]cJHggqIHcdKocJvcGHqxdCjbmCxpwm",168,0.994083,30,169,1,168,1,1,0,1,1,86,85,83,83,66
"6154",53,"[30]cJHggqIHcdKocJvcGHqxdCjbmCxpwm",163,0.993902,30,164,1,163,1,1,0,1,1,75,74,89,89,66
"6155",54,"[30]cJHggqIHcdKocJvcGHqxdCjbmCxpwm",163,0.993902,30,164,1,163,1,1,0,1,1,75,74,89,89,66
"6156",55,"[30]cJHggqIHcdKocJvcGHqxdCjbmCxpwm",163,0.993902,30,164,1,163,1,1,0,1,1,73,72,91,91,66
"6157",56,"[30]cJHggqIHcdKocJvcGHqxdCjbmCxpwm",168,0.994083,30,169,1,168,1,1,0,1,1,88,87,81,81,66
"6158",57,"[30]cJHggqIHcdKocJvcGHqxdCjbmCxpwm",172,0.99422,30,173,1,172,1,1,0,1,1,97,96,76,76,66
"6159",58,"[30]cJHggqIHcdKocJvcGHqxdCjbmCxpwm",162,0.993865,30,163,1,162,1,1,0,1,1,70,69,93,93,66
"6160",59,"[30]cJHggqIHcdKocJvcGHqxdCjbmCxpwm",172,0.99422,30,173,1,172,1,1,0,1,1,97,96,76,76,66
"6161",60,"[30]cJHggqIHcdKocJvcGHqxdCjbmCxpwm",165,0.993976,30,166,1,165,1,1,0,1,1,80,79,86,86,66
"6162",61,"[30]cJHggqIHcdKocJvcGHqxdCjbmCxpwm",165,0.993976,30,166,1,165,1,1,0,1,1,79,78,87,87,66
"6163",62,"[30]cJHggqIHcdKocJvcGHqxdCjbmCxpwm",165,0.993976,30,166,1,165,1,1,0,1,1,79,78,87,87,66
"6164",63,"[30]cJHggqIHcdKocJvcGHqxdCjbmCxpwm",168,0.994083,30,169,1,168,1,1,0,1,1,88,87,81,81,66
"6165",64,"[30]cJHggqIHcdKocJvcGHqxdCjbmCxpwm",166,0.994012,30,167,1,166,1,1,0,1,1,82,81,85,85,66
"6166",65,"[30]cJHggqIHcdKocJvcGHqxdCjbmCxpwm",162,0.993865,30,163,1,162,1,1,0,1,1,71,70,92,92,66
"6167",66,"[30]cJHggqIHcdKocJvcGHqxdCjbmCxpwm",165,0.993976,30,166,1,165,1,1,0,1,1,80,79,86,86,66
"6168",67,"[30]cJHggqIHcdKocJvcGHqxdCjbmCxpwm",169,0.994118,30,170,1,169,1,1,0,1,1,89,88,81,81,66
"6169",68,"[30]cJHggqIHcdKocJvcGHqxdCjbmCxpwm",167,0.994048,30,168,1,167,1,1,0,1,1,84,83,84,84,66
"6170",69,"[30]cJHggqIHcdKocJvcGHqxdCjbmCxpwm",166,0.994012,30,167,1,166,1,1,0,1,1,82,81,85,85,66
"6171",70,"[30]cJHggqIHcdKocJvcGHqxdCjbmCxpwm",168,0.994083,30,169,1,168,1,1,0,1,1,88,87,81,81,66
"6172",71,"[30]cJHggqIHcdKocJvcGHqxdCjbmCxpwm",169,0.994118,30,170,1,169,1,1,0,1,1,89,88,81,81,66
"6173",72,"[30]cJHggqIHcdKocJvcGHqxdCjbmCxpwm",168,0.994083,30,169,1,168,1,1,0,1,1,87,86,82,82,66
"6174",73,"[30]cJHggqIHcdKocJvcGHqxdCjbmCxpwm",165,0.993976,30,166,1,165,1,1,0,1,1,80,79,86,86,66
"6175",74,"[30]cJHggqIHcdKocJvcGHqxdCjbmCxpwm",169,0.994118,30,170,1,169,1,1,0,1,1,89,88,81,81,66
"6176",75,"[30]cJHggqIHcdKocJvcGHqxdCjbmCxpwm",170,0.994152,30,171,1,170,1,1,0,1,1,94,93,77,77,66
"6177",76,"[30]cJHggqIHcdKocJvcGHqxdCjbmCxpwm",165,0.993976,30,166,1,165,1,1,0,1,1,79,78,87,87,66
"6178",77,"[30]cJHggqIHcdKocJvcGHqxdCjbmCxpwm",165,0.993976,30,166,1,165,1,1,0,1,1,78,77,88,88,66
"6179",78,"[30]cJHggqIHcdKocJvcGHqxdCjbmCxpwm",162,0.993865,30,163,1,162,1,1,0,1,1,71,70,92,92,66
"6180",79,"[30]cJHggqIHcdKocJvcGHqxdCjbmCxpwm",163,0.993902,30,164,1,163,1,1,0,1,1,75,74,89,89,66
"6181",80,"[30]cJHggqIHcdKocJvcGHqxdCjbmCxpwm",166,0.994012,30,167,1,166,1,1,0,1,1,81,80,86,86,66
"6182",81,"[30]cJHggqIHcdKocJvcGHqxdCjbmCxpwm",168,0.994083,30,169,1,168,1,1,0,1,1,87,86,82,82,66
"6183",82,"[30]cJHggqIHcdKocJvcGHqxdCjbmCxpwm",171,0.994186,30,172,1,171,1,1,0,1,1,95,94,77,77,66
"6184",83,"[30]cJHggqIHcdKocJvcGHqxdCjbmCxpwm",169,0.994118,30,170,1,169,1,1,0,1,1,91,90,79,79,66
"6185",84,"[30]cJHggqIHcdKocJvcGHqxdCjbmCxpwm",165,0.993976,30,166,1,165,1,1,0,1,1,80,79,86,86,66
"6186",85,"[30]cJHggqIHcdKocJvcGHqxdCjbmCxpwm",162,0.993865,30,163,1,162,1,1,0,1,1,70,69,93,93,66
"6187",86,"[30]cJHggqIHcdKocJvcGHqxdCjbmCxpwm",170,0.994152,30,171,1,170,1,1,0,1,1,93,92,78,78,66
"6188",87,"[30]cJHggqIHcdKocJvcGHqxdCjbmCxpwm",165,0.993976,30,166,1,165,1,1,0,1,1,80,79,86,86,66
"6189",88,"[30]cJHggqIHcdKocJvcGHqxdCjbmCxpwm",163,0.993902,30,164,1,163,1,1,0,1,1,73,72,91,91,66
"6190",89,"[30]cJHggqIHcdKocJvcGHqxdCjbmCxpwm",164,0.993939,30,165,1,164,1,1,0,1,1,77,76,88,88,66
"6191",90,"[30]cJHggqIHcdKocJvcGHqxdCjbmCxpwm",171,0.994186,30,172,1,171,1,1,0,1,1,94,93,78,78,66
"6192",91,"[30]cJHggqIHcdKocJvcGHqxdCjbmCxpwm",162,0.993865,30,163,1,162,1,1,0,1,1,70,69,93,93,66
"6193",92,"[30]cJHggqIHcdKocJvcGHqxdCjbmCxpwm",167,0.994048,30,168,1,167,1,1,0,1,1,85,84,83,83,66
"6194",93,"[30]cJHggqIHcdKocJvcGHqxdCjbmCxpwm",172,0.99422,30,173,1,172,1,1,0,1,1,98,97,75,75,66
"6195",94,"[30]cJHggqIHcdKocJvcGHqxdCjbmCxpwm",168,0.994083,30,169,1,168,1,1,0,1,1,87,86,82,82,66
"6196",95,"[30]cJHggqIHcdKocJvcGHqxdCjbmCxpwm",167,0.994048,30,168,1,167,1,1,0,1,1,83,82,85,85,66
"6197",96,"[30]cJHggqIHcdKocJvcGHqxdCjbmCxpwm",167,0.994048,30,168,1,167,1,1,0,1,1,84,83,84,84,66
"6198",97,"[30]cJHggqIHcdKocJvcGHqxdCjbmCxpwm",171,0.994186,30,172,1,171,1,1,0,1,1,95,94,77,77,66
"6199",98,"[30]cJHggqIHcdKocJvcGHqxdCjbmCxpwm",169,0.994118,30,170,1,169,1,1,0,1,1,91,90,79,79,66
"6200",99,"[30]cJHggqIHcdKocJvcGHqxdCjbmCxpwm",164,0.993939,30,165,1,164,1,1,0,1,1,77,76,88,88,66
"6201",0,"[29]sJHggqIvHcAldKpcJvcGHqFdCFbsg",175,0.994318,29,176,1,175,1,1,0,1,1,88,87,88,88,67
"6202",1,"[29]sJHggqIvHcAldKpcJvcGHqFdCFbsg",179,0.994444,29,180,1,179,1,1,0,1,1,99,98,81,81,67
"6203",2,"[29]sJHggqIvHcAldKpcJvcGHqFdCFbsg",178,0.994413,29,179,1,178,1,1,0,1,1,98,97,81,81,67
"6204",3,"[29]sJHggqIvHcAldKpcJvcGHqFdCFbsg",180,0.994475,29,181,1,180,1,1,0,1,1,98,97,83,83,67
"6205",4,"[29]sJHggqIvHcAldKpcJvcGHqFdCFbsg",170,0.994152,29,171,1,170,1,1,0,1,1,72,71,99,99,67
"6206",5,"[29]sJHggqIvHcAldKpcJvcGHqFdCFbsg",174,0.994286,29,175,1,174,1,1,0,1,1,85,84,90,90,67
"6207",6,"[29]sJHggqIvHcAldKpcJvcGHqFdCFbsg",177,0.994382,29,178,1,177,1,1,0,1,1,94,93,84,84,67
"6208",7,"[29]sJHggqIvHcAldKpcJvcGHqFdCFbsg",180,0.994475,29,181,1,180,1,1,0,1,1,102,101,79,79,67
"6209",8,"[29]sJHggqIvHcAldKpcJvcGHqFdCFbsg",175,0.994318,29,176,1,175,1,1,0,1,1,86,85,90,90,67
"6210",9,"[29]sJHggqIvHcAldKpcJvcGHqFdCFbsg",173,0.994253,29,174,1,173,1,1,0,1,1,81,80,93,93,67
"6211",10,"[29]sJHggqIvHcAldKpcJvcGHqFdCFbsg",178,0.994413,29,179,1,178,1,1,0,1,1,96,95,83,83,67
"6212",11,"[29]sJHggqIvHcAldKpcJvcGHqFdCFbsg",176,0.99435,29,177,1,176,1,1,0,1,1,92,91,85,85,67
"6213",12,"[29]sJHggqIvHcAldKpcJvcGHqFdCFbsg",173,0.994253,29,174,1,173,1,1,0,1,1,79,78,95,95,67
"6214",13,"[29]sJHggqIvHcAldKpcJvcGHqFdCFbsg",176,0.99435,29,177,1,176,1,1,0,1,1,91,90,86,86,67
"6215",14,"[29]sJHggqIvHcAldKpcJvcGHqFdCFbsg",171,0.994186,29,172,1,171,1,1,0,1,1,72,71,100,100,67
"6216",15,"[29]sJHggqIvHcAldKpcJvcGHqFdCFbsg",176,0.99435,29,177,1,176,1,1,0,1,1,92,91,85,85,67
"6217",16,"[29]sJHggqIvHcAldKpcJvcGHqFdCFbsg",175,0.994318,29,176,1,175,1,1,0,1,1,87,86,89,89,67
"6218",17,"[29]sJHggqIvHcAldKpcJvcGHqFdCFbsg",175,0.994318,29,176,1,175,1,1,0,1,1,87,86,89,89,67
"6219",18,"[29]sJHggqIvHcAldKpcJvcGHqFdCFbsg",171,0.994186,29,172,1,171,1,1,0,1,1,74,73,98,98,67
"6220",19,"[29]sJHggqIvHcAldKpcJvcGHqFdCFbsg",179,0.994444,29,180,1,179,1,1,0,1,1,100,99,80,80,67
"6221",20,"[29]sJHggqIvHcAldKpcJvcGHqFdCFbsg",175,0.994318,29,176,1,175,1,1,0,1,1,85,84,91,91,67
"6222",21,"[29]sJHggqIvHcAldKpcJvcGHqFdCFbsg",173,0.994253,29,174,1,173,1,1,0,1,1,79,78,95,95,67
"6223",22,"[29]sJHggqIvHcAldKpcJvcGHqFdCFbsg",179,0.994444,29,180,1,179,1,1,0,1,1,99,98,81,81,67
"6224",23,"[29]sJHggqIvHcAldKpcJvcGHqFdCFbsg",172,0.99422,29,173,1,172,1,1,0,1,1,78,77,95,95,67
"6225",24,"[29]sJHggqIvHcAldKpcJvcGHqFdCFbsg",177,0.994382,29,178,1,177,1,1,0,1,1,93,92,85,85,67
"6226",25,"[29]sJHggqIvHcAldKpcJvcGHqFdCFbsg",176,0.99435,29,177,1,176,1,1,0,1,1,90,89,87,87,67
"6227",26,"[29]sJHggqIvHcAldKpcJvcGHqFdCFbsg",179,0.994444,29,180,1,179,1,1,0,1,1,102,101,78,78,67
"6228",27,"[29]sJHggqIvHcAldKpcJvcGHqFdCFbsg",179,0.994444,29,180,1,179,1,1,0,1,1,98,97,82,82,67
"6229",28,"[29]sJHggqIvHcAldKpcJvcGHqFdCFbsg",178,0.994413,29,179,1,178,1,1,0,1,1,98,97,81,81,67
"6230",29,"[29]sJHggqIvHcAldKpcJvcGHqFdCFbsg",181,0.994505,29,182,1,181,1,1,0,1,1,106,105,76,76,67
"6231",30,"[29]sJHggqIvHcAldKpcJvcGHqFdCFbsg",173,0.994253,29,174,1,173,1,1,0,1,1,81,80,93,93,67
"6232",31,"[29]sJHggqIvHcAldKpcJvcGHqFdCFbsg",176,0.99435,29,177,1,176,1,1,0,1,1,89,88,88,88,67
"6233",32,"[29]sJHggqIvHcAldKpcJvcGHqFdCFbsg",173,0.994253,29,174,1,173,1,1,0,1,1,79,78,95,95,67
"6234",33,"[29]sJHggqIvHcAldKpcJvcGHqFdCFbsg",174,0.994286,29,175,1,174,1,1,0,1,1,85,84,90,90,67
"6235",34,"[29]sJHggqIvHcAldKpcJvcGHqFdCFbsg",174,0.994286,29,175,1,174,1,1,0,1,1,84,83,91,91,67
"6236",35,"[29]sJHggqIvHcAldKpcJvcGHqFdCFbsg",175,0.994318,29,176,1,175,1,1,0,1,1,87,86,89,89,67
"6237",36,"[29]sJHggqIvHcAldKpcJvcGHqFdCFbsg",171,0.994186,29,172,1,171,1,1,0,1,1,73,72,99,99,67
"6238",37,"[29]sJHggqIvHcAldKpcJvcGHqFdCFbsg",179,0.994444,29,180,1,179,1,1,0,1,1,97,96,83,83,67
"6239",38,"[29]sJHggqIvHcAldKpcJvcGHqFdCFbsg",179,0.994444,29,180,1,179,1,1,0,1,1,95,94,85,85,67
"6240",39,"[29]sJHggqIvHcAldKpcJvcGHqFdCFbsg",175,0.994318,29,176,1,175,1,1,0,1,1,88,87,88,88,67
"6241",40,"[29]sJHggqIvHcAldKpcJvcGHqFdCFbsg",176,0.99435,29,177,1,176,1,1,0,1,1,90,89,87,87,67
"6242",41,"[29]sJHggqIvHcAldKpcJvcGHqFdCFbsg",172,0.99422,29,173,1,172,1,1,0,1,1,77,76,96,96,67
"6243",42,"[29]sJHggqIvHcAldKpcJvcGHqFdCFbsg",181,0.994505,29,182,1,181,1,1,0,1,1,104,103,78,78,67
"6244",43,"[29]sJHggqIvHcAldKpcJvcGHqFdCFbsg",175,0.994318,29,176,1,175,1,1,0,1,1,88,87,88,88,67
"6245",44,"[29]sJHggqIvHcAldKpcJvcGHqFdCFbsg",172,0.99422,29,173,1,172,1,1,0,1,1,76,75,97,97,67
"6246",45,"[29]sJHggqIvHcAldKpcJvcGHqFdCFbsg",174,0.994286,29,175,1,174,1,1,0,1,1,83,82,92,92,67
"6247",46,"[29]sJHggqIvHcAldKpcJvcGHqFdCFbsg",173,0.994253,29,174,1,173,1,1,0,1,1,79,78,95,95,67
"6248",47,"[29]sJHggqIvHcAldKpcJvcGHqFdCFbsg",174,0.994286,29,175,1,174,1,1,0,1,1,85,84,90,90,67
"6249",48,"[29]sJHggqIvHcAldKpcJvcGHqFdCFbsg",174,0.994286,29,175,1,174,1,1,0,1,1,81,80,94,94,67
"6250",49,"[29]sJHggqIvHcAldKpcJvcGHqFdCFbsg",173,0.994253,29,174,1,173,1,1,0,1,1,81,80,93,93,67
"6251",50,"[29]sJHggqIvHcAldKpcJvcGHqFdCFbsg",179,0.994444,29,180,1,179,1,1,0,1,1,100,99,80,80,67
"6252",51,"[29]sJHggqIvHcAldKpcJvcGHqFdCFbsg",173,0.994253,29,174,1,173,1,1,0,1,1,80,79,94,94,67
"6253",52,"[29]sJHggqIvHcAldKpcJvcGHqFdCFbsg",175,0.994318,29,176,1,175,1,1,0,1,1,87,86,89,89,67
"6254",53,"[29]sJHggqIvHcAldKpcJvcGHqFdCFbsg",176,0.99435,29,177,1,176,1,1,0,1,1,91,90,86,86,67
"6255",54,"[29]sJHggqIvHcAldKpcJvcGHqFdCFbsg",170,0.994152,29,171,1,170,1,1,0,1,1,72,71,99,99,67
"6256",55,"[29]sJHggqIvHcAldKpcJvcGHqFdCFbsg",179,0.994444,29,180,1,179,1,1,0,1,1,100,99,80,80,67
"6257",56,"[29]sJHggqIvHcAldKpcJvcGHqFdCFbsg",176,0.99435,29,177,1,176,1,1,0,1,1,84,83,93,93,67
"6258",57,"[29]sJHggqIvHcAldKpcJvcGHqFdCFbsg",175,0.994318,29,176,1,175,1,1,0,1,1,85,84,91,91,67
"6259",58,"[29]sJHggqIvHcAldKpcJvcGHqFdCFbsg",181,0.994505,29,182,1,181,1,1,0,1,1,103,102,79,79,67
"6260",59,"[29]sJHggqIvHcAldKpcJvcGHqFdCFbsg",179,0.994444,29,180,1,179,1,1,0,1,1,99,98,81,81,67
"6261",60,"[29]sJHggqIvHcAldKpcJvcGHqFdCFbsg",175,0.994318,29,176,1,175,1,1,0,1,1,86,85,90,90,67
"6262",61,"[29]sJHggqIvHcAldKpcJvcGHqFdCFbsg",175,0.994318,29,176,1,175,1,1,0,1,1,88,87,88,88,67
"6263",62,"[29]sJHggqIvHcAldKpcJvcGHqFdCFbsg",179,0.994444,29,180,1,179,1,1,0,1,1,102,101,78,78,67
"6264",63,"[29]sJHggqIvHcAldKpcJvcGHqFdCFbsg",173,0.994253,29,174,1,173,1,1,0,1,1,80,79,94,94,67
"6265",64,"[29]sJHggqIvHcAldKpcJvcGHqFdCFbsg",174,0.994286,29,175,1,174,1,1,0,1,1,84,83,91,91,67
"6266",65,"[29]sJHggqIvHcAldKpcJvcGHqFdCFbsg",176,0.99435,29,177,1,176,1,1,0,1,1,91,90,86,86,67
"6267",66,"[29]sJHggqIvHcAldKpcJvcGHqFdCFbsg",175,0.994318,29,176,1,175,1,1,0,1,1,84,83,92,92,67
"6268",67,"[29]sJHggqIvHcAldKpcJvcGHqFdCFbsg",175,0.994318,29,176,1,175,1,1,0,1,1,86,85,90,90,67
"6269",68,"[29]sJHggqIvHcAldKpcJvcGHqFdCFbsg",177,0.994382,29,178,1,177,1,1,0,1,1,95,94,83,83,67
"6270",69,"[29]sJHggqIvHcAldKpcJvcGHqFdCFbsg",175,0.994318,29,176,1,175,1,1,0,1,1,86,85,90,90,67
"6271",70,"[29]sJHggqIvHcAldKpcJvcGHqFdCFbsg",178,0.994413,29,179,1,178,1,1,0,1,1,96,95,83,83,67
"6272",71,"[29]sJHggqIvHcAldKpcJvcGHqFdCFbsg",175,0.994318,29,176,1,175,1,1,0,1,1,85,84,91,91,67
"6273",72,"[29]sJHggqIvHcAldKpcJvcGHqFdCFbsg",178,0.994413,29,179,1,178,1,1,0,1,1,97,96,82,82,67
"6274",73,"[29]sJHggqIvHcAldKpcJvcGHqFdCFbsg",174,0.994286,29,175,1,174,1,1,0,1,1,84,83,91,91,67
"6275",74,"[29]sJHggqIvHcAldKpcJvcGHqFdCFbsg",176,0.99435,29,177,1,176,1,1,0,1,1,90,89,87,87,67
"6276",75,"[29]sJHggqIvHcAldKpcJvcGHqFdCFbsg",178,0.994413,29,179,1,178,1,1,0,1,1,96,95,83,83,67
"6277",76,"[29]sJHggqIvHcAldKpcJvcGHqFdCFbsg",172,0.99422,29,173,1,172,1,1,0,1,1,76,75,97,97,67
"6278",77,"[29]sJHggqIvHcAldKpcJvcGHqFdCFbsg",172,0.99422,29,173,1,172,1,1,0,1,1,74,73,99,99,67
"6279",78,"[29]sJHggqIvHcAldKpcJvcGHqFdCFbsg",173,0.994253,29,174,1,173,1,1,0,1,1,82,81,92,92,67
"6280",79,"[29]sJHggqIvHcAldKpcJvcGHqFdCFbsg",175,0.994318,29,176,1,175,1,1,0,1,1,86,85,90,90,67
"6281",80,"[29]sJHggqIvHcAldKpcJvcGHqFdCFbsg",177,0.994382,29,178,1,177,1,1,0,1,1,91,90,87,87,67
"6282",81,"[29]sJHggqIvHcAldKpcJvcGHqFdCFbsg",174,0.994286,29,175,1,174,1,1,0,1,1,84,83,91,91,67
"6283",82,"[29]sJHggqIvHcAldKpcJvcGHqFdCFbsg",176,0.99435,29,177,1,176,1,1,0,1,1,91,90,86,86,67
"6284",83,"[29]sJHggqIvHcAldKpcJvcGHqFdCFbsg",178,0.994413,29,179,1,178,1,1,0,1,1,97,96,82,82,67
"6285",84,"[29]sJHggqIvHcAldKpcJvcGHqFdCFbsg",176,0.99435,29,177,1,176,1,1,0,1,1,90,89,87,87,67
"6286",85,"[29]sJHggqIvHcAldKpcJvcGHqFdCFbsg",172,0.99422,29,173,1,172,1,1,0,1,1,78,77,95,95,67
"6287",86,"[29]sJHggqIvHcAldKpcJvcGHqFdCFbsg",177,0.994382,29,178,1,177,1,1,0,1,1,92,91,86,86,67
"6288",87,"[29]sJHggqIvHcAldKpcJvcGHqFdCFbsg",177,0.994382,29,178,1,177,1,1,0,1,1,91,90,87,87,67
"6289",88,"[29]sJHggqIvHcAldKpcJvcGHqFdCFbsg",172,0.99422,29,173,1,172,1,1,0,1,1,76,75,97,97,67
"6290",89,"[29]sJHggqIvHcAldKpcJvcGHqFdCFbsg",174,0.994286,29,175,1,174,1,1,0,1,1,83,82,92,92,67
"6291",90,"[29]sJHggqIvHcAldKpcJvcGHqFdCFbsg",173,0.994253,29,174,1,173,1,1,0,1,1,81,80,93,93,67
"6292",91,"[29]sJHggqIvHcAldKpcJvcGHqFdCFbsg",176,0.99435,29,177,1,176,1,1,0,1,1,88,87,89,89,67
"6293",92,"[29]sJHggqIvHcAldKpcJvcGHqFdCFbsg",176,0.99435,29,177,1,176,1,1,0,1,1,89,88,88,88,67
"6294",93,"[29]sJHggqIvHcAldKpcJvcGHqFdCFbsg",177,0.994382,29,178,1,177,1,1,0,1,1,93,92,85,85,67
"6295",94,"[29]sJHggqIvHcAldKpcJvcGHqFdCFbsg",176,0.99435,29,177,1,176,1,1,0,1,1,90,89,87,87,67
"6296",95,"[29]sJHggqIvHcAldKpcJvcGHqFdCFbsg",177,0.994382,29,178,1,177,1,1,0,1,1,93,92,85,85,67
"6297",96,"[29]sJHggqIvHcAldKpcJvcGHqFdCFbsg",175,0.994318,29,176,1,175,1,1,0,1,1,85,84,91,91,67
"6298",97,"[29]sJHggqIvHcAldKpcJvcGHqFdCFbsg",174,0.994286,29,175,1,174,1,1,0,1,1,84,83,91,91,67
"6299",98,"[29]sJHggqIvHcAldKpcJvcGHqFdCFbsg",175,0.994318,29,176,1,175,1,1,0,1,1,88,87,88,88,67
"6300",99,"[29]sJHggqIvHcAldKpcJvcGHqFdCFbsg",175,0.994318,29,176,1,175,1,1,0,1,1,85,84,91,91,67
"6301",0,"[29]vJHggqIGHcidKpcJvcGHqFdCCqCIy",176,0.99435,29,177,1,176,1,1,0,1,1,89,88,88,88,68
"6302",1,"[29]vJHggqIGHcidKpcJvcGHqFdCCqCIy",179,0.994444,29,180,1,179,1,1,0,1,1,99,98,81,81,68
"6303",2,"[29]vJHggqIGHcidKpcJvcGHqFdCCqCIy",180,0.994475,29,181,1,180,1,1,0,1,1,100,99,81,81,68
"6304",3,"[29]vJHggqIGHcidKpcJvcGHqFdCCqCIy",175,0.994318,29,176,1,175,1,1,0,1,1,86,85,90,90,68
"6305",4,"[29]vJHggqIGHcidKpcJvcGHqFdCCqCIy",175,0.994318,29,176,1,175,1,1,0,1,1,82,81,94,94,68
"6306",5,"[29]vJHggqIGHcidKpcJvcGHqFdCCqCIy",175,0.994318,29,176,1,175,1,1,0,1,1,85,84,91,91,68
"6307",6,"[29]vJHggqIGHcidKpcJvcGHqFdCCqCIy",174,0.994286,29,175,1,174,1,1,0,1,1,81,80,94,94,68
"6308",7,"[29]vJHggqIGHcidKpcJvcGHqFdCCqCIy",175,0.994318,29,176,1,175,1,1,0,1,1,85,84,91,91,68
"6309",8,"[29]vJHggqIGHcidKpcJvcGHqFdCCqCIy",174,0.994286,29,175,1,174,1,1,0,1,1,80,79,95,95,68
"6310",9,"[29]vJHggqIGHcidKpcJvcGHqFdCCqCIy",171,0.994186,29,172,1,171,1,1,0,1,1,72,71,100,100,68
"6311",10,"[29]vJHggqIGHcidKpcJvcGHqFdCCqCIy",173,0.994253,29,174,1,173,1,1,0,1,1,81,80,93,93,68
"6312",11,"[29]vJHggqIGHcidKpcJvcGHqFdCCqCIy",181,0.994505,29,182,1,181,1,1,0,1,1,101,100,81,81,68
"6313",12,"[29]vJHggqIGHcidKpcJvcGHqFdCCqCIy",176,0.99435,29,177,1,176,1,1,0,1,1,88,87,89,89,68
"6314",13,"[29]vJHggqIGHcidKpcJvcGHqFdCCqCIy",177,0.994382,29,178,1,177,1,1,0,1,1,91,90,87,87,68
"6315",14,"[29]vJHggqIGHcidKpcJvcGHqFdCCqCIy",177,0.994382,29,178,1,177,1,1,0,1,1,91,90,87,87,68
"6316",15,"[29]vJHggqIGHcidKpcJvcGHqFdCCqCIy",172,0.99422,29,173,1,172,1,1,0,1,1,76,75,97,97,68
"6317",16,"[29]vJHggqIGHcidKpcJvcGHqFdCCqCIy",175,0.994318,29,176,1,175,1,1,0,1,1,86,85,90,90,68
"6318",17,"[29]vJHggqIGHcidKpcJvcGHqFdCCqCIy",172,0.99422,29,173,1,172,1,1,0,1,1,77,76,96,96,68
"6319",18,"[29]vJHggqIGHcidKpcJvcGHqFdCCqCIy",179,0.994444,29,180,1,179,1,1,0,1,1,96,95,84,84,68
"6320",19,"[29]vJHggqIGHcidKpcJvcGHqFdCCqCIy",181,0.994505,29,182,1,181,1,1,0,1,1,105,104,77,77,68
"6321",20,"[29]vJHggqIGHcidKpcJvcGHqFdCCqCIy",175,0.994318,29,176,1,175,1,1,0,1,1,87,86,89,89,68
"6322",21,"[29]vJHggqIGHcidKpcJvcGHqFdCCqCIy",173,0.994253,29,174,1,173,1,1,0,1,1,78,77,96,96,68
"6323",22,"[29]vJHggqIGHcidKpcJvcGHqFdCCqCIy",176,0.99435,29,177,1,176,1,1,0,1,1,88,87,89,89,68
"6324",23,"[29]vJHggqIGHcidKpcJvcGHqFdCCqCIy",174,0.994286,29,175,1,174,1,1,0,1,1,80,79,95,95,68
"6325",24,"[29]vJHggqIGHcidKpcJvcGHqFdCCqCIy",176,0.99435,29,177,1,176,1,1,0,1,1,90,89,87,87,68
"6326",25,"[29]vJHggqIGHcidKpcJvcGHqFdCCqCIy",179,0.994444,29,180,1,179,1,1,0,1,1,99,98,81,81,68
"6327",26,"[29]vJHggqIGHcidKpcJvcGHqFdCCqCIy",182,0.994536,29,183,1,182,1,1,0,1,1,108,107,75,75,68
"6328",27,"[29]vJHggqIGHcidKpcJvcGHqFdCCqCIy",175,0.994318,29,176,1,175,1,1,0,1,1,87,86,89,89,68
"6329",28,"[29]vJHggqIGHcidKpcJvcGHqFdCCqCIy",175,0.994318,29,176,1,175,1,1,0,1,1,85,84,91,91,68
"6330",29,"[29]vJHggqIGHcidKpcJvcGHqFdCCqCIy",178,0.994413,29,179,1,178,1,1,0,1,1,96,95,83,83,68
"6331",30,"[29]vJHggqIGHcidKpcJvcGHqFdCCqCIy",177,0.994382,29,178,1,177,1,1,0,1,1,93,92,85,85,68
"6332",31,"[29]vJHggqIGHcidKpcJvcGHqFdCCqCIy",176,0.99435,29,177,1,176,1,1,0,1,1,91,90,86,86,68
"6333",32,"[29]vJHggqIGHcidKpcJvcGHqFdCCqCIy",178,0.994413,29,179,1,178,1,1,0,1,1,95,94,84,84,68
"6334",33,"[29]vJHggqIGHcidKpcJvcGHqFdCCqCIy",178,0.994413,29,179,1,178,1,1,0,1,1,95,94,84,84,68
"6335",34,"[29]vJHggqIGHcidKpcJvcGHqFdCCqCIy",182,0.994536,29,183,1,182,1,1,0,1,1,106,105,77,77,68
"6336",35,"[29]vJHggqIGHcidKpcJvcGHqFdCCqCIy",179,0.994444,29,180,1,179,1,1,0,1,1,99,98,81,81,68
"6337",36,"[29]vJHggqIGHcidKpcJvcGHqFdCCqCIy",176,0.99435,29,177,1,176,1,1,0,1,1,88,87,89,89,68
"6338",37,"[29]vJHggqIGHcidKpcJvcGHqFdCCqCIy",178,0.994413,29,179,1,178,1,1,0,1,1,97,96,82,82,68
"6339",38,"[29]vJHggqIGHcidKpcJvcGHqFdCCqCIy",180,0.994475,29,181,1,180,1,1,0,1,1,103,102,78,78,68
"6340",39,"[29]vJHggqIGHcidKpcJvcGHqFdCCqCIy",174,0.994286,29,175,1,174,1,1,0,1,1,82,81,93,93,68
"6341",40,"[29]vJHggqIGHcidKpcJvcGHqFdCCqCIy",173,0.994253,29,174,1,173,1,1,0,1,1,80,79,94,94,68
"6342",41,"[29]vJHggqIGHcidKpcJvcGHqFdCCqCIy",179,0.994444,29,180,1,179,1,1,0,1,1,101,100,79,79,68
"6343",42,"[29]vJHggqIGHcidKpcJvcGHqFdCCqCIy",174,0.994286,29,175,1,174,1,1,0,1,1,81,80,94,94,68
"6344",43,"[29]vJHggqIGHcidKpcJvcGHqFdCCqCIy",177,0.994382,29,178,1,177,1,1,0,1,1,92,91,86,86,68
"6345",44,"[29]vJHggqIGHcidKpcJvcGHqFdCCqCIy",178,0.994413,29,179,1,178,1,1,0,1,1,94,93,85,85,68
"6346",45,"[29]vJHggqIGHcidKpcJvcGHqFdCCqCIy",175,0.994318,29,176,1,175,1,1,0,1,1,83,82,93,93,68
"6347",46,"[29]vJHggqIGHcidKpcJvcGHqFdCCqCIy",173,0.994253,29,174,1,173,1,1,0,1,1,80,79,94,94,68
"6348",47,"[29]vJHggqIGHcidKpcJvcGHqFdCCqCIy",174,0.994286,29,175,1,174,1,1,0,1,1,84,83,91,91,68
"6349",48,"[29]vJHggqIGHcidKpcJvcGHqFdCCqCIy",180,0.994475,29,181,1,180,1,1,0,1,1,101,100,80,80,68
"6350",49,"[29]vJHggqIGHcidKpcJvcGHqFdCCqCIy",176,0.99435,29,177,1,176,1,1,0,1,1,91,90,86,86,68
"6351",50,"[29]vJHggqIGHcidKpcJvcGHqFdCCqCIy",175,0.994318,29,176,1,175,1,1,0,1,1,87,86,89,89,68
"6352",51,"[29]vJHggqIGHcidKpcJvcGHqFdCCqCIy",176,0.99435,29,177,1,176,1,1,0,1,1,88,87,89,89,68
"6353",52,"[29]vJHggqIGHcidKpcJvcGHqFdCCqCIy",177,0.994382,29,178,1,177,1,1,0,1,1,93,92,85,85,68
"6354",53,"[29]vJHggqIGHcidKpcJvcGHqFdCCqCIy",176,0.99435,29,177,1,176,1,1,0,1,1,90,89,87,87,68
"6355",54,"[29]vJHggqIGHcidKpcJvcGHqFdCCqCIy",176,0.99435,29,177,1,176,1,1,0,1,1,90,89,87,87,68
"6356",55,"[29]vJHggqIGHcidKpcJvcGHqFdCCqCIy",176,0.99435,29,177,1,176,1,1,0,1,1,91,90,86,86,68
"6357",56,"[29]vJHggqIGHcidKpcJvcGHqFdCCqCIy",173,0.994253,29,174,1,173,1,1,0,1,1,78,77,96,96,68
"6358",57,"[29]vJHggqIGHcidKpcJvcGHqFdCCqCIy",174,0.994286,29,175,1,174,1,1,0,1,1,82,81,93,93,68
"6359",58,"[29]vJHggqIGHcidKpcJvcGHqFdCCqCIy",178,0.994413,29,179,1,178,1,1,0,1,1,95,94,84,84,68
"6360",59,"[29]vJHggqIGHcidKpcJvcGHqFdCCqCIy",177,0.994382,29,178,1,177,1,1,0,1,1,93,92,85,85,68
"6361",60,"[29]vJHggqIGHcidKpcJvcGHqFdCCqCIy",176,0.99435,29,177,1,176,1,1,0,1,1,89,88,88,88,68
"6362",61,"[29]vJHggqIGHcidKpcJvcGHqFdCCqCIy",177,0.994382,29,178,1,177,1,1,0,1,1,93,92,85,85,68
"6363",62,"[29]vJHggqIGHcidKpcJvcGHqFdCCqCIy",175,0.994318,29,176,1,175,1,1,0,1,1,84,83,92,92,68
"6364",63,"[29]vJHggqIGHcidKpcJvcGHqFdCCqCIy",174,0.994286,29,175,1,174,1,1,0,1,1,83,82,92,92,68
"6365",64,"[29]vJHggqIGHcidKpcJvcGHqFdCCqCIy",180,0.994475,29,181,1,180,1,1,0,1,1,103,102,78,78,68
"6366",65,"[29]vJHggqIGHcidKpcJvcGHqFdCCqCIy",177,0.994382,29,178,1,177,1,1,0,1,1,90,89,88,88,68
"6367",66,"[29]vJHggqIGHcidKpcJvcGHqFdCCqCIy",178,0.994413,29,179,1,178,1,1,0,1,1,97,96,82,82,68
"6368",67,"[29]vJHggqIGHcidKpcJvcGHqFdCCqCIy",175,0.994318,29,176,1,175,1,1,0,1,1,84,83,92,92,68
"6369",68,"[29]vJHggqIGHcidKpcJvcGHqFdCCqCIy",172,0.99422,29,173,1,172,1,1,0,1,1,77,76,96,96,68
"6370",69,"[29]vJHggqIGHcidKpcJvcGHqFdCCqCIy",174,0.994286,29,175,1,174,1,1,0,1,1,84,83,91,91,68
"6371",70,"[29]vJHggqIGHcidKpcJvcGHqFdCCqCIy",178,0.994413,29,179,1,178,1,1,0,1,1,96,95,83,83,68
"6372",71,"[29]vJHggqIGHcidKpcJvcGHqFdCCqCIy",171,0.994186,29,172,1,171,1,1,0,1,1,74,73,98,98,68
"6373",72,"[29]vJHggqIGHcidKpcJvcGHqFdCCqCIy",179,0.994444,29,180,1,179,1,1,0,1,1,100,99,80,80,68
"6374",73,"[29]vJHggqIGHcidKpcJvcGHqFdCCqCIy",176,0.99435,29,177,1,176,1,1,0,1,1,90,89,87,87,68
"6375",74,"[29]vJHggqIGHcidKpcJvcGHqFdCCqCIy",177,0.994382,29,178,1,177,1,1,0,1,1,93,92,85,85,68
"6376",75,"[29]vJHggqIGHcidKpcJvcGHqFdCCqCIy",175,0.994318,29,176,1,175,1,1,0,1,1,85,84,91,91,68
"6377",76,"[29]vJHggqIGHcidKpcJvcGHqFdCCqCIy",173,0.994253,29,174,1,173,1,1,0,1,1,81,80,93,93,68
"6378",77,"[29]vJHggqIGHcidKpcJvcGHqFdCCqCIy",179,0.994444,29,180,1,179,1,1,0,1,1,97,96,83,83,68
"6379",78,"[29]vJHggqIGHcidKpcJvcGHqFdCCqCIy",176,0.99435,29,177,1,176,1,1,0,1,1,90,89,87,87,68
"6380",79,"[29]vJHggqIGHcidKpcJvcGHqFdCCqCIy",180,0.994475,29,181,1,180,1,1,0,1,1,103,102,78,78,68
"6381",80,"[29]vJHggqIGHcidKpcJvcGHqFdCCqCIy",180,0.994475,29,181,1,180,1,1,0,1,1,104,103,77,77,68
"6382",81,"[29]vJHggqIGHcidKpcJvcGHqFdCCqCIy",173,0.994253,29,174,1,173,1,1,0,1,1,79,78,95,95,68
"6383",82,"[29]vJHggqIGHcidKpcJvcGHqFdCCqCIy",174,0.994286,29,175,1,174,1,1,0,1,1,81,80,94,94,68
"6384",83,"[29]vJHggqIGHcidKpcJvcGHqFdCCqCIy",176,0.99435,29,177,1,176,1,1,0,1,1,89,88,88,88,68
"6385",84,"[29]vJHggqIGHcidKpcJvcGHqFdCCqCIy",174,0.994286,29,175,1,174,1,1,0,1,1,81,80,94,94,68
"6386",85,"[29]vJHggqIGHcidKpcJvcGHqFdCCqCIy",172,0.99422,29,173,1,172,1,1,0,1,1,76,75,97,97,68
"6387",86,"[29]vJHggqIGHcidKpcJvcGHqFdCCqCIy",174,0.994286,29,175,1,174,1,1,0,1,1,84,83,91,91,68
"6388",87,"[29]vJHggqIGHcidKpcJvcGHqFdCCqCIy",177,0.994382,29,178,1,177,1,1,0,1,1,93,92,85,85,68
"6389",88,"[29]vJHggqIGHcidKpcJvcGHqFdCCqCIy",176,0.99435,29,177,1,176,1,1,0,1,1,91,90,86,86,68
"6390",89,"[29]vJHggqIGHcidKpcJvcGHqFdCCqCIy",174,0.994286,29,175,1,174,1,1,0,1,1,84,83,91,91,68
"6391",90,"[29]vJHggqIGHcidKpcJvcGHqFdCCqCIy",177,0.994382,29,178,1,177,1,1,0,1,1,92,91,86,86,68
"6392",91,"[29]vJHggqIGHcidKpcJvcGHqFdCCqCIy",176,0.99435,29,177,1,176,1,1,0,1,1,87,86,90,90,68
"6393",92,"[29]vJHggqIGHcidKpcJvcGHqFdCCqCIy",175,0.994318,29,176,1,175,1,1,0,1,1,86,85,90,90,68
"6394",93,"[29]vJHggqIGHcidKpcJvcGHqFdCCqCIy",180,0.994475,29,181,1,180,1,1,0,1,1,103,102,78,78,68
"6395",94,"[29]vJHggqIGHcidKpcJvcGHqFdCCqCIy",176,0.99435,29,177,1,176,1,1,0,1,1,90,89,87,87,68
"6396",95,"[29]vJHggqIGHcidKpcJvcGHqFdCCqCIy",179,0.994444,29,180,1,179,1,1,0,1,1,97,96,83,83,68
"6397",96,"[29]vJHggqIGHcidKpcJvcGHqFdCCqCIy",177,0.994382,29,178,1,177,1,1,0,1,1,91,90,87,87,68
"6398",97,"[29]vJHggqIGHcidKpcJvcGHqFdCCqCIy",175,0.994318,29,176,1,175,1,1,0,1,1,87,86,89,89,68
"6399",98,"[29]vJHggqIGHcidKpcJvcGHqFdCCqCIy",176,0.99435,29,177,1,176,1,1,0,1,1,86,85,91,91,68
"6400",99,"[29]vJHggqIGHcidKpcJvcGHqFdCCqCIy",178,0.994413,29,179,1,178,1,1,0,1,1,88,87,91,91,68
"6401",0,"[34]wJHggqIHchidKocJvcGHqFdCCDCEgphzmy",177,0.994382,34,178,1,177,1,1,0,1,1,94,93,84,84,69
"6402",1,"[34]wJHggqIHchidKocJvcGHqFdCCDCEgphzmy",175,0.994318,34,176,1,175,1,1,0,1,1,85,84,91,91,69
"6403",2,"[34]wJHggqIHchidKocJvcGHqFdCCDCEgphzmy",179,0.994444,34,180,1,179,1,1,0,1,1,98,97,82,82,69
"6404",3,"[34]wJHggqIHchidKocJvcGHqFdCCDCEgphzmy",179,0.994444,34,180,1,179,1,1,0,1,1,99,98,81,81,69
"6405",4,"[34]wJHggqIHchidKocJvcGHqFdCCDCEgphzmy",177,0.994382,34,178,1,177,1,1,0,1,1,94,93,84,84,69
"6406",5,"[34]wJHggqIHchidKocJvcGHqFdCCDCEgphzmy",179,0.994444,34,180,1,179,1,1,0,1,1,101,100,79,79,69
"6407",6,"[34]wJHggqIHchidKocJvcGHqFdCCDCEgphzmy",176,0.99435,34,177,1,176,1,1,0,1,1,89,88,88,88,69
"6408",7,"[34]wJHggqIHchidKocJvcGHqFdCCDCEgphzmy",176,0.99435,34,177,1,176,1,1,0,1,1,88,87,89,89,69
"6409",8,"[34]wJHggqIHchidKocJvcGHqFdCCDCEgphzmy",173,0.994253,34,174,1,173,1,1,0,1,1,78,77,96,96,69
"6410",9,"[34]wJHggqIHchidKocJvcGHqFdCCDCEgphzmy",175,0.994318,34,176,1,175,1,1,0,1,1,87,86,89,89,69
"6411",10,"[34]wJHggqIHchidKocJvcGHqFdCCDCEgphzmy",182,0.994536,34,183,1,182,1,1,0,1,1,109,108,74,74,69
"6412",11,"[34]wJHggqIHchidKocJvcGHqFdCCDCEgphzmy",178,0.994413,34,179,1,178,1,1,0,1,1,97,96,82,82,69
"6413",12,"[34]wJHggqIHchidKocJvcGHqFdCCDCEgphzmy",175,0.994318,34,176,1,175,1,1,0,1,1,87,86,89,89,69
"6414",13,"[34]wJHggqIHchidKocJvcGHqFdCCDCEgphzmy",181,0.994505,34,182,1,181,1,1,0,1,1,106,105,76,76,69
"6415",14,"[34]wJHggqIHchidKocJvcGHqFdCCDCEgphzmy",173,0.994253,34,174,1,173,1,1,0,1,1,78,77,96,96,69
"6416",15,"[34]wJHggqIHchidKocJvcGHqFdCCDCEgphzmy",174,0.994286,34,175,1,174,1,1,0,1,1,82,81,93,93,69
"6417",16,"[34]wJHggqIHchidKocJvcGHqFdCCDCEgphzmy",176,0.99435,34,177,1,176,1,1,0,1,1,89,88,88,88,69
"6418",17,"[34]wJHggqIHchidKocJvcGHqFdCCDCEgphzmy",177,0.994382,34,178,1,177,1,1,0,1,1,92,91,86,86,69
"6419",18,"[34]wJHggqIHchidKocJvcGHqFdCCDCEgphzmy",179,0.994444,34,180,1,179,1,1,0,1,1,98,97,82,82,69
"6420",19,"[34]wJHggqIHchidKocJvcGHqFdCCDCEgphzmy",175,0.994318,34,176,1,175,1,1,0,1,1,84,83,92,92,69
"6421",20,"[34]wJHggqIHchidKocJvcGHqFdCCDCEgphzmy",176,0.99435,34,177,1,176,1,1,0,1,1,89,88,88,88,69
"6422",21,"[34]wJHggqIHchidKocJvcGHqFdCCDCEgphzmy",178,0.994413,34,179,1,178,1,1,0,1,1,97,96,82,82,69
"6423",22,"[34]wJHggqIHchidKocJvcGHqFdCCDCEgphzmy",172,0.99422,34,173,1,172,1,1,0,1,1,77,76,96,96,69
"6424",23,"[34]wJHggqIHchidKocJvcGHqFdCCDCEgphzmy",175,0.994318,34,176,1,175,1,1,0,1,1,85,84,91,91,69
"6425",24,"[34]wJHggqIHchidKocJvcGHqFdCCDCEgphzmy",177,0.994382,34,178,1,177,1,1,0,1,1,92,91,86,86,69
"6426",25,"[34]wJHggqIHchidKocJvcGHqFdCCDCEgphzmy",175,0.994318,34,176,1,175,1,1,0,1,1,86,85,90,90,69
"6427",26,"[34]wJHggqIHchidKocJvcGHqFdCCDCEgphzmy",174,0.994286,34,175,1,174,1,1,0,1,1,81,80,94,94,69
"6428",27,"[34]wJHggqIHchidKocJvcGHqFdCCDCEgphzmy",178,0.994413,34,179,1,178,1,1,0,1,1,92,91,87,87,69
"6429",28,"[34]wJHggqIHchidKocJvcGHqFdCCDCEgphzmy",178,0.994413,34,179,1,178,1,1,0,1,1,95,94,84,84,69
"6430",29,"[34]wJHggqIHchidKocJvcGHqFdCCDCEgphzmy",174,0.994286,34,175,1,174,1,1,0,1,1,83,82,92,92,69
"6431",30,"[34]wJHggqIHchidKocJvcGHqFdCCDCEgphzmy",177,0.994382,34,178,1,177,1,1,0,1,1,94,93,84,84,69
"6432",31,"[34]wJHggqIHchidKocJvcGHqFdCCDCEgphzmy",177,0.994382,34,178,1,177,1,1,0,1,1,93,92,85,85,69
"6433",32,"[34]wJHggqIHchidKocJvcGHqFdCCDCEgphzmy",177,0.994382,34,178,1,177,1,1,0,1,1,90,89,88,88,69
"6434",33,"[34]wJHggqIHchidKocJvcGHqFdCCDCEgphzmy",177,0.994382,34,178,1,177,1,1,0,1,1,92,91,86,86,69
"6435",34,"[34]wJHggqIHchidKocJvcGHqFdCCDCEgphzmy",174,0.994286,34,175,1,174,1,1,0,1,1,82,81,93,93,69
"6436",35,"[34]wJHggqIHchidKocJvcGHqFdCCDCEgphzmy",176,0.99435,34,177,1,176,1,1,0,1,1,90,89,87,87,69
"6437",36,"[34]wJHggqIHchidKocJvcGHqFdCCDCEgphzmy",179,0.994444,34,180,1,179,1,1,0,1,1,99,98,81,81,69
"6438",37,"[34]wJHggqIHchidKocJvcGHqFdCCDCEgphzmy",177,0.994382,34,178,1,177,1,1,0,1,1,91,90,87,87,69
"6439",38,"[34]wJHggqIHchidKocJvcGHqFdCCDCEgphzmy",169,0.994118,34,170,1,169,1,1,0,1,1,67,66,103,103,69
"6440",39,"[34]wJHggqIHchidKocJvcGHqFdCCDCEgphzmy",177,0.994382,34,178,1,177,1,1,0,1,1,88,87,90,90,69
"6441",40,"[34]wJHggqIHchidKocJvcGHqFdCCDCEgphzmy",177,0.994382,34,178,1,177,1,1,0,1,1,92,91,86,86,69
"6442",41,"[34]wJHggqIHchidKocJvcGHqFdCCDCEgphzmy",184,0.994595,34,185,1,184,1,1,0,1,1,114,113,71,71,69
"6443",42,"[34]wJHggqIHchidKocJvcGHqFdCCDCEgphzmy",175,0.994318,34,176,1,175,1,1,0,1,1,84,83,92,92,69
"6444",43,"[34]wJHggqIHchidKocJvcGHqFdCCDCEgphzmy",172,0.99422,34,173,1,172,1,1,0,1,1,76,75,97,97,69
"6445",44,"[34]wJHggqIHchidKocJvcGHqFdCCDCEgphzmy",174,0.994286,34,175,1,174,1,1,0,1,1,82,81,93,93,69
"6446",45,"[34]wJHggqIHchidKocJvcGHqFdCCDCEgphzmy",177,0.994382,34,178,1,177,1,1,0,1,1,92,91,86,86,69
"6447",46,"[34]wJHggqIHchidKocJvcGHqFdCCDCEgphzmy",175,0.994318,34,176,1,175,1,1,0,1,1,87,86,89,89,69
"6448",47,"[34]wJHggqIHchidKocJvcGHqFdCCDCEgphzmy",175,0.994318,34,176,1,175,1,1,0,1,1,87,86,89,89,69
"6449",48,"[34]wJHggqIHchidKocJvcGHqFdCCDCEgphzmy",174,0.994286,34,175,1,174,1,1,0,1,1,81,80,94,94,69
"6450",49,"[34]wJHggqIHchidKocJvcGHqFdCCDCEgphzmy",176,0.99435,34,177,1,176,1,1,0,1,1,88,87,89,89,69
"6451",50,"[34]wJHggqIHchidKocJvcGHqFdCCDCEgphzmy",182,0.994536,34,183,1,182,1,1,0,1,1,108,107,75,75,69
"6452",51,"[34]wJHggqIHchidKocJvcGHqFdCCDCEgphzmy",177,0.994382,34,178,1,177,1,1,0,1,1,91,90,87,87,69
"6453",52,"[34]wJHggqIHchidKocJvcGHqFdCCDCEgphzmy",171,0.994186,34,172,1,171,1,1,0,1,1,74,73,98,98,69
"6454",53,"[34]wJHggqIHchidKocJvcGHqFdCCDCEgphzmy",178,0.994413,34,179,1,178,1,1,0,1,1,96,95,83,83,69
"6455",54,"[34]wJHggqIHchidKocJvcGHqFdCCDCEgphzmy",179,0.994444,34,180,1,179,1,1,0,1,1,97,96,83,83,69
"6456",55,"[34]wJHggqIHchidKocJvcGHqFdCCDCEgphzmy",176,0.99435,34,177,1,176,1,1,0,1,1,88,87,89,89,69
"6457",56,"[34]wJHggqIHchidKocJvcGHqFdCCDCEgphzmy",175,0.994318,34,176,1,175,1,1,0,1,1,85,84,91,91,69
"6458",57,"[34]wJHggqIHchidKocJvcGHqFdCCDCEgphzmy",174,0.994286,34,175,1,174,1,1,0,1,1,83,82,92,92,69
"6459",58,"[34]wJHggqIHchidKocJvcGHqFdCCDCEgphzmy",178,0.994413,34,179,1,178,1,1,0,1,1,97,96,82,82,69
"6460",59,"[34]wJHggqIHchidKocJvcGHqFdCCDCEgphzmy",177,0.994382,34,178,1,177,1,1,0,1,1,93,92,85,85,69
"6461",60,"[34]wJHggqIHchidKocJvcGHqFdCCDCEgphzmy",177,0.994382,34,178,1,177,1,1,0,1,1,91,90,87,87,69
"6462",61,"[34]wJHggqIHchidKocJvcGHqFdCCDCEgphzmy",180,0.994475,34,181,1,180,1,1,0,1,1,100,99,81,81,69
"6463",62,"[34]wJHggqIHchidKocJvcGHqFdCCDCEgphzmy",175,0.994318,34,176,1,175,1,1,0,1,1,83,82,93,93,69
"6464",63,"[34]wJHggqIHchidKocJvcGHqFdCCDCEgphzmy",179,0.994444,34,180,1,179,1,1,0,1,1,97,96,83,83,69
"6465",64,"[34]wJHggqIHchidKocJvcGHqFdCCDCEgphzmy",176,0.99435,34,177,1,176,1,1,0,1,1,89,88,88,88,69
"6466",65,"[34]wJHggqIHchidKocJvcGHqFdCCDCEgphzmy",178,0.994413,34,179,1,178,1,1,0,1,1,95,94,84,84,69
"6467",66,"[34]wJHggqIHchidKocJvcGHqFdCCDCEgphzmy",175,0.994318,34,176,1,175,1,1,0,1,1,86,85,90,90,69
"6468",67,"[34]wJHggqIHchidKocJvcGHqFdCCDCEgphzmy",176,0.99435,34,177,1,176,1,1,0,1,1,87,86,90,90,69
"6469",68,"[34]wJHggqIHchidKocJvcGHqFdCCDCEgphzmy",177,0.994382,34,178,1,177,1,1,0,1,1,91,90,87,87,69
"6470",69,"[34]wJHggqIHchidKocJvcGHqFdCCDCEgphzmy",176,0.99435,34,177,1,176,1,1,0,1,1,89,88,88,88,69
"6471",70,"[34]wJHggqIHchidKocJvcGHqFdCCDCEgphzmy",178,0.994413,34,179,1,178,1,1,0,1,1,95,94,84,84,69
"6472",71,"[34]wJHggqIHchidKocJvcGHqFdCCDCEgphzmy",178,0.994413,34,179,1,178,1,1,0,1,1,96,95,83,83,69
"6473",72,"[34]wJHggqIHchidKocJvcGHqFdCCDCEgphzmy",176,0.99435,34,177,1,176,1,1,0,1,1,91,90,86,86,69
"6474",73,"[34]wJHggqIHchidKocJvcGHqFdCCDCEgphzmy",180,0.994475,34,181,1,180,1,1,0,1,1,101,100,80,80,69
"6475",74,"[34]wJHggqIHchidKocJvcGHqFdCCDCEgphzmy",173,0.994253,34,174,1,173,1,1,0,1,1,80,79,94,94,69
"6476",75,"[34]wJHggqIHchidKocJvcGHqFdCCDCEgphzmy",174,0.994286,34,175,1,174,1,1,0,1,1,82,81,93,93,69
"6477",76,"[34]wJHggqIHchidKocJvcGHqFdCCDCEgphzmy",179,0.994444,34,180,1,179,1,1,0,1,1,100,99,80,80,69
"6478",77,"[34]wJHggqIHchidKocJvcGHqFdCCDCEgphzmy",173,0.994253,34,174,1,173,1,1,0,1,1,80,79,94,94,69
"6479",78,"[34]wJHggqIHchidKocJvcGHqFdCCDCEgphzmy",179,0.994444,34,180,1,179,1,1,0,1,1,98,97,82,82,69
"6480",79,"[34]wJHggqIHchidKocJvcGHqFdCCDCEgphzmy",174,0.994286,34,175,1,174,1,1,0,1,1,83,82,92,92,69
"6481",80,"[34]wJHggqIHchidKocJvcGHqFdCCDCEgphzmy",177,0.994382,34,178,1,177,1,1,0,1,1,93,92,85,85,69
"6482",81,"[34]wJHggqIHchidKocJvcGHqFdCCDCEgphzmy",176,0.99435,34,177,1,176,1,1,0,1,1,89,88,88,88,69
"6483",82,"[34]wJHggqIHchidKocJvcGHqFdCCDCEgphzmy",176,0.99435,34,177,1,176,1,1,0,1,1,90,89,87,87,69
"6484",83,"[34]wJHggqIHchidKocJvcGHqFdCCDCEgphzmy",172,0.99422,34,173,1,172,1,1,0,1,1,76,75,97,97,69
"6485",84,"[34]wJHggqIHchidKocJvcGHqFdCCDCEgphzmy",174,0.994286,34,175,1,174,1,1,0,1,1,84,83,91,91,69
"6486",85,"[34]wJHggqIHchidKocJvcGHqFdCCDCEgphzmy",174,0.994286,34,175,1,174,1,1,0,1,1,82,81,93,93,69
"6487",86,"[34]wJHggqIHchidKocJvcGHqFdCCDCEgphzmy",174,0.994286,34,175,1,174,1,1,0,1,1,84,83,91,91,69
"6488",87,"[34]wJHggqIHchidKocJvcGHqFdCCDCEgphzmy",178,0.994413,34,179,1,178,1,1,0,1,1,97,96,82,82,69
"6489",88,"[34]wJHggqIHchidKocJvcGHqFdCCDCEgphzmy",176,0.99435,34,177,1,176,1,1,0,1,1,90,89,87,87,69
"6490",89,"[34]wJHggqIHchidKocJvcGHqFdCCDCEgphzmy",179,0.994444,34,180,1,179,1,1,0,1,1,100,99,80,80,69
"6491",90,"[34]wJHggqIHchidKocJvcGHqFdCCDCEgphzmy",177,0.994382,34,178,1,177,1,1,0,1,1,93,92,85,85,69
"6492",91,"[34]wJHggqIHchidKocJvcGHqFdCCDCEgphzmy",177,0.994382,34,178,1,177,1,1,0,1,1,92,91,86,86,69
"6493",92,"[34]wJHggqIHchidKocJvcGHqFdCCDCEgphzmy",174,0.994286,34,175,1,174,1,1,0,1,1,83,82,92,92,69
"6494",93,"[34]wJHggqIHchidKocJvcGHqFdCCDCEgphzmy",180,0.994475,34,181,1,180,1,1,0,1,1,100,99,81,81,69
"6495",94,"[34]wJHggqIHchidKocJvcGHqFdCCDCEgphzmy",175,0.994318,34,176,1,175,1,1,0,1,1,86,85,90,90,69
"6496",95,"[34]wJHggqIHchidKocJvcGHqFdCCDCEgphzmy",179,0.994444,34,180,1,179,1,1,0,1,1,99,98,81,81,69
"6497",96,"[34]wJHggqIHchidKocJvcGHqFdCCDCEgphzmy",169,0.994118,34,170,1,169,1,1,0,1,1,66,65,104,104,69
"6498",97,"[34]wJHggqIHchidKocJvcGHqFdCCDCEgphzmy",177,0.994382,34,178,1,177,1,1,0,1,1,94,93,84,84,69
"6499",98,"[34]wJHggqIHchidKocJvcGHqFdCCDCEgphzmy",179,0.994444,34,180,1,179,1,1,0,1,1,99,98,81,81,69
"6500",99,"[34]wJHggqIHchidKocJvcGHqFdCCDCEgphzmy",176,0.99435,34,177,1,176,1,1,0,1,1,90,89,87,87,69
"6501",0,"[29]gJHglqImHcidKpcJvcGHqFdCxJhdh",170,0.994152,29,171,1,170,1,1,0,1,1,70,69,101,101,70
"6502",1,"[29]gJHglqImHcidKpcJvcGHqFdCxJhdh",173,0.994253,29,174,1,173,1,1,0,1,1,80,79,94,94,70
"6503",2,"[29]gJHglqImHcidKpcJvcGHqFdCxJhdh",178,0.994413,29,179,1,178,1,1,0,1,1,94,93,85,85,70
"6504",3,"[29]gJHglqImHcidKpcJvcGHqFdCxJhdh",174,0.994286,29,175,1,174,1,1,0,1,1,82,81,93,93,70
"6505",4,"[29]gJHglqImHcidKpcJvcGHqFdCxJhdh",176,0.99435,29,177,1,176,1,1,0,1,1,90,89,87,87,70
"6506",5,"[29]gJHglqImHcidKpcJvcGHqFdCxJhdh",177,0.994382,29,178,1,177,1,1,0,1,1,93,92,85,85,70
"6507",6,"[29]gJHglqImHcidKpcJvcGHqFdCxJhdh",173,0.994253,29,174,1,173,1,1,0,1,1,79,78,95,95,70
"6508",7,"[29]gJHglqImHcidKpcJvcGHqFdCxJhdh",178,0.994413,29,179,1,178,1,1,0,1,1,94,93,85,85,70
"6509",8,"[29]gJHglqImHcidKpcJvcGHqFdCxJhdh",178,0.994413,29,179,1,178,1,1,0,1,1,90,89,89,89,70
"6510",9,"[29]gJHglqImHcidKpcJvcGHqFdCxJhdh",181,0.994505,29,182,1,181,1,1,0,1,1,106,105,76,76,70
"6511",10,"[29]gJHglqImHcidKpcJvcGHqFdCxJhdh",177,0.994382,29,178,1,177,1,1,0,1,1,94,93,84,84,70
"6512",11,"[29]gJHglqImHcidKpcJvcGHqFdCxJhdh",177,0.994382,29,178,1,177,1,1,0,1,1,92,91,86,86,70
"6513",12,"[29]gJHglqImHcidKpcJvcGHqFdCxJhdh",177,0.994382,29,178,1,177,1,1,0,1,1,92,91,86,86,70
"6514",13,"[29]gJHglqImHcidKpcJvcGHqFdCxJhdh",175,0.994318,29,176,1,175,1,1,0,1,1,84,83,92,92,70
"6515",14,"[29]gJHglqImHcidKpcJvcGHqFdCxJhdh",177,0.994382,29,178,1,177,1,1,0,1,1,93,92,85,85,70
"6516",15,"[29]gJHglqImHcidKpcJvcGHqFdCxJhdh",174,0.994286,29,175,1,174,1,1,0,1,1,83,82,92,92,70
"6517",16,"[29]gJHglqImHcidKpcJvcGHqFdCxJhdh",176,0.99435,29,177,1,176,1,1,0,1,1,89,88,88,88,70
"6518",17,"[29]gJHglqImHcidKpcJvcGHqFdCxJhdh",178,0.994413,29,179,1,178,1,1,0,1,1,96,95,83,83,70
"6519",18,"[29]gJHglqImHcidKpcJvcGHqFdCxJhdh",178,0.994413,29,179,1,178,1,1,0,1,1,97,96,82,82,70
"6520",19,"[29]gJHglqImHcidKpcJvcGHqFdCxJhdh",175,0.994318,29,176,1,175,1,1,0,1,1,87,86,89,89,70
"6521",20,"[29]gJHglqImHcidKpcJvcGHqFdCxJhdh",177,0.994382,29,178,1,177,1,1,0,1,1,91,90,87,87,70
"6522",21,"[29]gJHglqImHcidKpcJvcGHqFdCxJhdh",173,0.994253,29,174,1,173,1,1,0,1,1,81,80,93,93,70
"6523",22,"[29]gJHglqImHcidKpcJvcGHqFdCxJhdh",178,0.994413,29,179,1,178,1,1,0,1,1,95,94,84,84,70
"6524",23,"[29]gJHglqImHcidKpcJvcGHqFdCxJhdh",175,0.994318,29,176,1,175,1,1,0,1,1,86,85,90,90,70
"6525",24,"[29]gJHglqImHcidKpcJvcGHqFdCxJhdh",175,0.994318,29,176,1,175,1,1,0,1,1,87,86,89,89,70
"6526",25,"[29]gJHglqImHcidKpcJvcGHqFdCxJhdh",176,0.99435,29,177,1,176,1,1,0,1,1,90,89,87,87,70
"6527",26,"[29]gJHglqImHcidKpcJvcGHqFdCxJhdh",175,0.994318,29,176,1,175,1,1,0,1,1,86,85,90,90,70
"6528",27,"[29]gJHglqImHcidKpcJvcGHqFdCxJhdh",178,0.994413,29,179,1,178,1,1,0,1,1,96,95,83,83,70
"6529",28,"[29]gJHglqImHcidKpcJvcGHqFdCxJhdh",169,0.994118,29,170,1,169,1,1,0,1,1,66,65,104,104,70
"6530",29,"[29]gJHglqImHcidKpcJvcGHqFdCxJhdh",175,0.994318,29,176,1,175,1,1,0,1,1,86,85,90,90,70
"6531",30,"[29]gJHglqImHcidKpcJvcGHqFdCxJhdh",176,0.99435,29,177,1,176,1,1,0,1,1,89,88,88,88,70
"6532",31,"[29]gJHglqImHcidKpcJvcGHqFdCxJhdh",174,0.994286,29,175,1,174,1,1,0,1,1,82,81,93,93,70
"6533",32,"[29]gJHglqImHcidKpcJvcGHqFdCxJhdh",171,0.994186,29,172,1,171,1,1,0,1,1,73,72,99,99,70
"6534",33,"[29]gJHglqImHcidKpcJvcGHqFdCxJhdh",175,0.994318,29,176,1,175,1,1,0,1,1,86,85,90,90,70
"6535",34,"[29]gJHglqImHcidKpcJvcGHqFdCxJhdh",172,0.99422,29,173,1,172,1,1,0,1,1,77,76,96,96,70
"6536",35,"[29]gJHglqImHcidKpcJvcGHqFdCxJhdh",179,0.994444,29,180,1,179,1,1,0,1,1,99,98,81,81,70
"6537",36,"[29]gJHglqImHcidKpcJvcGHqFdCxJhdh",174,0.994286,29,175,1,174,1,1,0,1,1,82,81,93,93,70
"6538",37,"[29]gJHglqImHcidKpcJvcGHqFdCxJhdh",177,0.994382,29,178,1,177,1,1,0,1,1,90,89,88,88,70
"6539",38,"[29]gJHglqImHcidKpcJvcGHqFdCxJhdh",178,0.994413,29,179,1,178,1,1,0,1,1,96,95,83,83,70
"6540",39,"[29]gJHglqImHcidKpcJvcGHqFdCxJhdh",177,0.994382,29,178,1,177,1,1,0,1,1,91,90,87,87,70
"6541",40,"[29]gJHglqImHcidKpcJvcGHqFdCxJhdh",176,0.99435,29,177,1,176,1,1,0,1,1,90,89,87,87,70
"6542",41,"[29]gJHglqImHcidKpcJvcGHqFdCxJhdh",177,0.994382,29,178,1,177,1,1,0,1,1,93,92,85,85,70
"6543",42,"[29]gJHglqImHcidKpcJvcGHqFdCxJhdh",179,0.994444,29,180,1,179,1,1,0,1,1,97,96,83,83,70
"6544",43,"[29]gJHglqImHcidKpcJvcGHqFdCxJhdh",176,0.99435,29,177,1,176,1,1,0,1,1,91,90,86,86,70
"6545",44,"[29]gJHglqImHcidKpcJvcGHqFdCxJhdh",176,0.99435,29,177,1,176,1,1,0,1,1,89,88,88,88,70
"6546",45,"[29]gJHglqImHcidKpcJvcGHqFdCxJhdh",173,0.994253,29,174,1,173,1,1,0,1,1,79,78,95,95,70
"6547",46,"[29]gJHglqImHcidKpcJvcGHqFdCxJhdh",179,0.994444,29,180,1,179,1,1,0,1,1,100,99,80,80,70
"6548",47,"[29]gJHglqImHcidKpcJvcGHqFdCxJhdh",177,0.994382,29,178,1,177,1,1,0,1,1,90,89,88,88,70
"6549",48,"[29]gJHglqImHcidKpcJvcGHqFdCxJhdh",177,0.994382,29,178,1,177,1,1,0,1,1,91,90,87,87,70
"6550",49,"[29]gJHglqImHcidKpcJvcGHqFdCxJhdh",178,0.994413,29,179,1,178,1,1,0,1,1,95,94,84,84,70
"6551",50,"[29]gJHglqImHcidKpcJvcGHqFdCxJhdh",178,0.994413,29,179,1,178,1,1,0,1,1,93,92,86,86,70
"6552",51,"[29]gJHglqImHcidKpcJvcGHqFdCxJhdh",175,0.994318,29,176,1,175,1,1,0,1,1,86,85,90,90,70
"6553",52,"[29]gJHglqImHcidKpcJvcGHqFdCxJhdh",176,0.99435,29,177,1,176,1,1,0,1,1,90,89,87,87,70
"6554",53,"[29]gJHglqImHcidKpcJvcGHqFdCxJhdh",175,0.994318,29,176,1,175,1,1,0,1,1,86,85,90,90,70
"6555",54,"[29]gJHglqImHcidKpcJvcGHqFdCxJhdh",173,0.994253,29,174,1,173,1,1,0,1,1,79,78,95,95,70
"6556",55,"[29]gJHglqImHcidKpcJvcGHqFdCxJhdh",175,0.994318,29,176,1,175,1,1,0,1,1,87,86,89,89,70
"6557",56,"[29]gJHglqImHcidKpcJvcGHqFdCxJhdh",180,0.994475,29,181,1,180,1,1,0,1,1,102,101,79,79,70
"6558",57,"[29]gJHglqImHcidKpcJvcGHqFdCxJhdh",174,0.994286,29,175,1,174,1,1,0,1,1,84,83,91,91,70
"6559",58,"[29]gJHglqImHcidKpcJvcGHqFdCxJhdh",178,0.994413,29,179,1,178,1,1,0,1,1,95,94,84,84,70
"6560",59,"[29]gJHglqImHcidKpcJvcGHqFdCxJhdh",179,0.994444,29,180,1,179,1,1,0,1,1,96,95,84,84,70
"6561",60,"[29]gJHglqImHcidKpcJvcGHqFdCxJhdh",169,0.994118,29,170,1,169,1,1,0,1,1,67,66,103,103,70
"6562",61,"[29]gJHglqImHcidKpcJvcGHqFdCxJhdh",177,0.994382,29,178,1,177,1,1,0,1,1,93,92,85,85,70
"6563",62,"[29]gJHglqImHcidKpcJvcGHqFdCxJhdh",177,0.994382,29,178,1,177,1,1,0,1,1,93,92,85,85,70
"6564",63,"[29]gJHglqImHcidKpcJvcGHqFdCxJhdh",176,0.99435,29,177,1,176,1,1,0,1,1,90,89,87,87,70
"6565",64,"[29]gJHglqImHcidKpcJvcGHqFdCxJhdh",178,0.994413,29,179,1,178,1,1,0,1,1,96,95,83,83,70
"6566",65,"[29]gJHglqImHcidKpcJvcGHqFdCxJhdh",177,0.994382,29,178,1,177,1,1,0,1,1,94,93,84,84,70
"6567",66,"[29]gJHglqImHcidKpcJvcGHqFdCxJhdh",170,0.994152,29,171,1,170,1,1,0,1,1,70,69,101,101,70
"6568",67,"[29]gJHglqImHcidKpcJvcGHqFdCxJhdh",180,0.994475,29,181,1,180,1,1,0,1,1,99,98,82,82,70
"6569",68,"[29]gJHglqImHcidKpcJvcGHqFdCxJhdh",174,0.994286,29,175,1,174,1,1,0,1,1,84,83,91,91,70
"6570",69,"[29]gJHglqImHcidKpcJvcGHqFdCxJhdh",177,0.994382,29,178,1,177,1,1,0,1,1,93,92,85,85,70
"6571",70,"[29]gJHglqImHcidKpcJvcGHqFdCxJhdh",177,0.994382,29,178,1,177,1,1,0,1,1,92,91,86,86,70
"6572",71,"[29]gJHglqImHcidKpcJvcGHqFdCxJhdh",177,0.994382,29,178,1,177,1,1,0,1,1,93,92,85,85,70
"6573",72,"[29]gJHglqImHcidKpcJvcGHqFdCxJhdh",174,0.994286,29,175,1,174,1,1,0,1,1,84,83,91,91,70
"6574",73,"[29]gJHglqImHcidKpcJvcGHqFdCxJhdh",177,0.994382,29,178,1,177,1,1,0,1,1,91,90,87,87,70
"6575",74,"[29]gJHglqImHcidKpcJvcGHqFdCxJhdh",172,0.99422,29,173,1,172,1,1,0,1,1,74,73,99,99,70
"6576",75,"[29]gJHglqImHcidKpcJvcGHqFdCxJhdh",176,0.99435,29,177,1,176,1,1,0,1,1,91,90,86,86,70
"6577",76,"[29]gJHglqImHcidKpcJvcGHqFdCxJhdh",176,0.99435,29,177,1,176,1,1,0,1,1,91,90,86,86,70
"6578",77,"[29]gJHglqImHcidKpcJvcGHqFdCxJhdh",175,0.994318,29,176,1,175,1,1,0,1,1,86,85,90,90,70
"6579",78,"[29]gJHglqImHcidKpcJvcGHqFdCxJhdh",180,0.994475,29,181,1,180,1,1,0,1,1,104,103,77,77,70
"6580",79,"[29]gJHglqImHcidKpcJvcGHqFdCxJhdh",177,0.994382,29,178,1,177,1,1,0,1,1,88,87,90,90,70
"6581",80,"[29]gJHglqImHcidKpcJvcGHqFdCxJhdh",177,0.994382,29,178,1,177,1,1,0,1,1,92,91,86,86,70
"6582",81,"[29]gJHglqImHcidKpcJvcGHqFdCxJhdh",176,0.99435,29,177,1,176,1,1,0,1,1,89,88,88,88,70
"6583",82,"[29]gJHglqImHcidKpcJvcGHqFdCxJhdh",177,0.994382,29,178,1,177,1,1,0,1,1,93,92,85,85,70
"6584",83,"[29]gJHglqImHcidKpcJvcGHqFdCxJhdh",181,0.994505,29,182,1,181,1,1,0,1,1,105,104,77,77,70
"6585",84,"[29]gJHglqImHcidKpcJvcGHqFdCxJhdh",176,0.99435,29,177,1,176,1,1,0,1,1,88,87,89,89,70
"6586",85,"[29]gJHglqImHcidKpcJvcGHqFdCxJhdh",174,0.994286,29,175,1,174,1,1,0,1,1,83,82,92,92,70
"6587",86,"[29]gJHglqImHcidKpcJvcGHqFdCxJhdh",173,0.994253,29,174,1,173,1,1,0,1,1,80,79,94,94,70
"6588",87,"[29]gJHglqImHcidKpcJvcGHqFdCxJhdh",177,0.994382,29,178,1,177,1,1,0,1,1,91,90,87,87,70
"6589",88,"[29]gJHglqImHcidKpcJvcGHqFdCxJhdh",177,0.994382,29,178,1,177,1,1,0,1,1,94,93,84,84,70
"6590",89,"[29]gJHglqImHcidKpcJvcGHqFdCxJhdh",175,0.994318,29,176,1,175,1,1,0,1,1,85,84,91,91,70
"6591",90,"[29]gJHglqImHcidKpcJvcGHqFdCxJhdh",179,0.994444,29,180,1,179,1,1,0,1,1,99,98,81,81,70
"6592",91,"[29]gJHglqImHcidKpcJvcGHqFdCxJhdh",177,0.994382,29,178,1,177,1,1,0,1,1,92,91,86,86,70
"6593",92,"[29]gJHglqImHcidKpcJvcGHqFdCxJhdh",174,0.994286,29,175,1,174,1,1,0,1,1,81,80,94,94,70
"6594",93,"[29]gJHglqImHcidKpcJvcGHqFdCxJhdh",177,0.994382,29,178,1,177,1,1,0,1,1,93,92,85,85,70
"6595",94,"[29]gJHglqImHcidKpcJvcGHqFdCxJhdh",173,0.994253,29,174,1,173,1,1,0,1,1,80,79,94,94,70
"6596",95,"[29]gJHglqImHcidKpcJvcGHqFdCxJhdh",176,0.99435,29,177,1,176,1,1,0,1,1,89,88,88,88,70
"6597",96,"[29]gJHglqImHcidKpcJvcGHqFdCxJhdh",175,0.994318,29,176,1,175,1,1,0,1,1,87,86,89,89,70
"6598",97,"[29]gJHglqImHcidKpcJvcGHqFdCxJhdh",175,0.994318,29,176,1,175,1,1,0,1,1,87,86,89,89,70
"6599",98,"[29]gJHglqImHcidKpcJvcGHqFdCxJhdh",179,0.994444,29,180,1,179,1,1,0,1,1,98,97,82,82,70
"6600",99,"[29]gJHglqImHcidKpcJvcGHqFdCxJhdh",174,0.994286,29,175,1,174,1,1,0,1,1,84,83,91,91,70
"6601",0,"[28]uJHggqkIHcidKocJvcGHqFdCjatE",175,0.994318,28,176,1,175,1,1,0,1,1,86,85,90,90,71
"6602",1,"[28]uJHggqkIHcidKocJvcGHqFdCjatE",169,0.994118,28,170,1,169,1,1,0,1,1,67,66,103,103,71
"6603",2,"[28]uJHggqkIHcidKocJvcGHqFdCjatE",175,0.994318,28,176,1,175,1,1,0,1,1,86,85,90,90,71
"6604",3,"[28]uJHggqkIHcidKocJvcGHqFdCjatE",175,0.994318,28,176,1,175,1,1,0,1,1,85,84,91,91,71
"6605",4,"[28]uJHggqkIHcidKocJvcGHqFdCjatE",176,0.99435,28,177,1,176,1,1,0,1,1,87,86,90,90,71
"6606",5,"[28]uJHggqkIHcidKocJvcGHqFdCjatE",179,0.994444,28,180,1,179,1,1,0,1,1,99,98,81,81,71
"6607",6,"[28]uJHggqkIHcidKocJvcGHqFdCjatE",173,0.994253,28,174,1,173,1,1,0,1,1,80,79,94,94,71
"6608",7,"[28]uJHggqkIHcidKocJvcGHqFdCjatE",179,0.994444,28,180,1,179,1,1,0,1,1,99,98,81,81,71
"6609",8,"[28]uJHggqkIHcidKocJvcGHqFdCjatE",174,0.994286,28,175,1,174,1,1,0,1,1,81,80,94,94,71
"6610",9,"[28]uJHggqkIHcidKocJvcGHqFdCjatE",174,0.994286,28,175,1,174,1,1,0,1,1,83,82,92,92,71
"6611",10,"[28]uJHggqkIHcidKocJvcGHqFdCjatE",174,0.994286,28,175,1,174,1,1,0,1,1,83,82,92,92,71
"6612",11,"[28]uJHggqkIHcidKocJvcGHqFdCjatE",181,0.994505,28,182,1,181,1,1,0,1,1,106,105,76,76,71
"6613",12,"[28]uJHggqkIHcidKocJvcGHqFdCjatE",177,0.994382,28,178,1,177,1,1,0,1,1,91,90,87,87,71
"6614",13,"[28]uJHggqkIHcidKocJvcGHqFdCjatE",175,0.994318,28,176,1,175,1,1,0,1,1,85,84,91,91,71
"6615",14,"[28]uJHggqkIHcidKocJvcGHqFdCjatE",174,0.994286,28,175,1,174,1,1,0,1,1,84,83,91,91,71
"6616",15,"[28]uJHggqkIHcidKocJvcGHqFdCjatE",175,0.994318,28,176,1,175,1,1,0,1,1,86,85,90,90,71
"6617",16,"[28]uJHggqkIHcidKocJvcGHqFdCjatE",176,0.99435,28,177,1,176,1,1,0,1,1,90,89,87,87,71
"6618",17,"[28]uJHggqkIHcidKocJvcGHqFdCjatE",180,0.994475,28,181,1,180,1,1,0,1,1,103,102,78,78,71
"6619",18,"[28]uJHggqkIHcidKocJvcGHqFdCjatE",177,0.994382,28,178,1,177,1,1,0,1,1,92,91,86,86,71
"6620",19,"[28]uJHggqkIHcidKocJvcGHqFdCjatE",176,0.99435,28,177,1,176,1,1,0,1,1,89,88,88,88,71
"6621",20,"[28]uJHggqkIHcidKocJvcGHqFdCjatE",177,0.994382,28,178,1,177,1,1,0,1,1,91,90,87,87,71
"6622",21,"[28]uJHggqkIHcidKocJvcGHqFdCjatE",176,0.99435,28,177,1,176,1,1,0,1,1,90,89,87,87,71
"6623",22,"[28]uJHggqkIHcidKocJvcGHqFdCjatE",180,0.994475,28,181,1,180,1,1,0,1,1,102,101,79,79,71
"6624",23,"[28]uJHggqkIHcidKocJvcGHqFdCjatE",177,0.994382,28,178,1,177,1,1,0,1,1,92,91,86,86,71
"6625",24,"[28]uJHggqkIHcidKocJvcGHqFdCjatE",176,0.99435,28,177,1,176,1,1,0,1,1,90,89,87,87,71
"6626",25,"[28]uJHggqkIHcidKocJvcGHqFdCjatE",170,0.994152,28,171,1,170,1,1,0,1,1,71,70,100,100,71
"6627",26,"[28]uJHggqkIHcidKocJvcGHqFdCjatE",177,0.994382,28,178,1,177,1,1,0,1,1,93,92,85,85,71
"6628",27,"[28]uJHggqkIHcidKocJvcGHqFdCjatE",177,0.994382,28,178,1,177,1,1,0,1,1,94,93,84,84,71
"6629",28,"[28]uJHggqkIHcidKocJvcGHqFdCjatE",176,0.99435,28,177,1,176,1,1,0,1,1,90,89,87,87,71
"6630",29,"[28]uJHggqkIHcidKocJvcGHqFdCjatE",181,0.994505,28,182,1,181,1,1,0,1,1,106,105,76,76,71
"6631",30,"[28]uJHggqkIHcidKocJvcGHqFdCjatE",177,0.994382,28,178,1,177,1,1,0,1,1,93,92,85,85,71
"6632",31,"[28]uJHggqkIHcidKocJvcGHqFdCjatE",180,0.994475,28,181,1,180,1,1,0,1,1,104,103,77,77,71
"6633",32,"[28]uJHggqkIHcidKocJvcGHqFdCjatE",174,0.994286,28,175,1,174,1,1,0,1,1,83,82,92,92,71
"6634",33,"[28]uJHggqkIHcidKocJvcGHqFdCjatE",176,0.99435,28,177,1,176,1,1,0,1,1,90,89,87,87,71
"6635",34,"[28]uJHggqkIHcidKocJvcGHqFdCjatE",176,0.99435,28,177,1,176,1,1,0,1,1,90,89,87,87,71
"6636",35,"[28]uJHggqkIHcidKocJvcGHqFdCjatE",171,0.994186,28,172,1,171,1,1,0,1,1,72,71,100,100,71
"6637",36,"[28]uJHggqkIHcidKocJvcGHqFdCjatE",174,0.994286,28,175,1,174,1,1,0,1,1,83,82,92,92,71
"6638",37,"[28]uJHggqkIHcidKocJvcGHqFdCjatE",175,0.994318,28,176,1,175,1,1,0,1,1,85,84,91,91,71
"6639",38,"[28]uJHggqkIHcidKocJvcGHqFdCjatE",175,0.994318,28,176,1,175,1,1,0,1,1,87,86,89,89,71
"6640",39,"[28]uJHggqkIHcidKocJvcGHqFdCjatE",173,0.994253,28,174,1,173,1,1,0,1,1,78,77,96,96,71
"6641",40,"[28]uJHggqkIHcidKocJvcGHqFdCjatE",181,0.994505,28,182,1,181,1,1,0,1,1,107,106,75,75,71
"6642",41,"[28]uJHggqkIHcidKocJvcGHqFdCjatE",179,0.994444,28,180,1,179,1,1,0,1,1,99,98,81,81,71
"6643",42,"[28]uJHggqkIHcidKocJvcGHqFdCjatE",174,0.994286,28,175,1,174,1,1,0,1,1,84,83,91,91,71
"6644",43,"[28]uJHggqkIHcidKocJvcGHqFdCjatE",174,0.994286,28,175,1,174,1,1,0,1,1,83,82,92,92,71
"6645",44,"[28]uJHggqkIHcidKocJvcGHqFdCjatE",178,0.994413,28,179,1,178,1,1,0,1,1,94,93,85,85,71
"6646",45,"[28]uJHggqkIHcidKocJvcGHqFdCjatE",176,0.99435,28,177,1,176,1,1,0,1,1,90,89,87,87,71
"6647",46,"[28]uJHggqkIHcidKocJvcGHqFdCjatE",176,0.99435,28,177,1,176,1,1,0,1,1,89,88,88,88,71
"6648",47,"[28]uJHggqkIHcidKocJvcGHqFdCjatE",178,0.994413,28,179,1,178,1,1,0,1,1,95,94,84,84,71
"6649",48,"[28]uJHggqkIHcidKocJvcGHqFdCjatE",175,0.994318,28,176,1,175,1,1,0,1,1,86,85,90,90,71
"6650",49,"[28]uJHggqkIHcidKocJvcGHqFdCjatE",179,0.994444,28,180,1,179,1,1,0,1,1,98,97,82,82,71
"6651",50,"[28]uJHggqkIHcidKocJvcGHqFdCjatE",174,0.994286,28,175,1,174,1,1,0,1,1,84,83,91,91,71
"6652",51,"[28]uJHggqkIHcidKocJvcGHqFdCjatE",175,0.994318,28,176,1,175,1,1,0,1,1,87,86,89,89,71
"6653",52,"[28]uJHggqkIHcidKocJvcGHqFdCjatE",176,0.99435,28,177,1,176,1,1,0,1,1,88,87,89,89,71
"6654",53,"[28]uJHggqkIHcidKocJvcGHqFdCjatE",176,0.99435,28,177,1,176,1,1,0,1,1,90,89,87,87,71
"6655",54,"[28]uJHggqkIHcidKocJvcGHqFdCjatE",177,0.994382,28,178,1,177,1,1,0,1,1,92,91,86,86,71
"6656",55,"[28]uJHggqkIHcidKocJvcGHqFdCjatE",174,0.994286,28,175,1,174,1,1,0,1,1,83,82,92,92,71
"6657",56,"[28]uJHggqkIHcidKocJvcGHqFdCjatE",177,0.994382,28,178,1,177,1,1,0,1,1,93,92,85,85,71
"6658",57,"[28]uJHggqkIHcidKocJvcGHqFdCjatE",175,0.994318,28,176,1,175,1,1,0,1,1,87,86,89,89,71
"6659",58,"[28]uJHggqkIHcidKocJvcGHqFdCjatE",174,0.994286,28,175,1,174,1,1,0,1,1,83,82,92,92,71
"6660",59,"[28]uJHggqkIHcidKocJvcGHqFdCjatE",178,0.994413,28,179,1,178,1,1,0,1,1,96,95,83,83,71
"6661",60,"[28]uJHggqkIHcidKocJvcGHqFdCjatE",178,0.994413,28,179,1,178,1,1,0,1,1,93,92,86,86,71
"6662",61,"[28]uJHggqkIHcidKocJvcGHqFdCjatE",176,0.99435,28,177,1,176,1,1,0,1,1,91,90,86,86,71
"6663",62,"[28]uJHggqkIHcidKocJvcGHqFdCjatE",175,0.994318,28,176,1,175,1,1,0,1,1,85,84,91,91,71
"6664",63,"[28]uJHggqkIHcidKocJvcGHqFdCjatE",175,0.994318,28,176,1,175,1,1,0,1,1,86,85,90,90,71
"6665",64,"[28]uJHggqkIHcidKocJvcGHqFdCjatE",175,0.994318,28,176,1,175,1,1,0,1,1,84,83,92,92,71
"6666",65,"[28]uJHggqkIHcidKocJvcGHqFdCjatE",177,0.994382,28,178,1,177,1,1,0,1,1,92,91,86,86,71
"6667",66,"[28]uJHggqkIHcidKocJvcGHqFdCjatE",176,0.99435,28,177,1,176,1,1,0,1,1,88,87,89,89,71
"6668",67,"[28]uJHggqkIHcidKocJvcGHqFdCjatE",176,0.99435,28,177,1,176,1,1,0,1,1,89,88,88,88,71
"6669",68,"[28]uJHggqkIHcidKocJvcGHqFdCjatE",174,0.994286,28,175,1,174,1,1,0,1,1,81,80,94,94,71
"6670",69,"[28]uJHggqkIHcidKocJvcGHqFdCjatE",172,0.99422,28,173,1,172,1,1,0,1,1,77,76,96,96,71
"6671",70,"[28]uJHggqkIHcidKocJvcGHqFdCjatE",176,0.99435,28,177,1,176,1,1,0,1,1,91,90,86,86,71
"6672",71,"[28]uJHggqkIHcidKocJvcGHqFdCjatE",172,0.99422,28,173,1,172,1,1,0,1,1,77,76,96,96,71
"6673",72,"[28]uJHggqkIHcidKocJvcGHqFdCjatE",184,0.994595,28,185,1,184,1,1,0,1,1,117,116,68,68,71
"6674",73,"[28]uJHggqkIHcidKocJvcGHqFdCjatE",178,0.994413,28,179,1,178,1,1,0,1,1,97,96,82,82,71
"6675",74,"[28]uJHggqkIHcidKocJvcGHqFdCjatE",176,0.99435,28,177,1,176,1,1,0,1,1,88,87,89,89,71
"6676",75,"[28]uJHggqkIHcidKocJvcGHqFdCjatE",178,0.994413,28,179,1,178,1,1,0,1,1,97,96,82,82,71
"6677",76,"[28]uJHggqkIHcidKocJvcGHqFdCjatE",173,0.994253,28,174,1,173,1,1,0,1,1,80,79,94,94,71
"6678",77,"[28]uJHggqkIHcidKocJvcGHqFdCjatE",173,0.994253,28,174,1,173,1,1,0,1,1,80,79,94,94,71
"6679",78,"[28]uJHggqkIHcidKocJvcGHqFdCjatE",177,0.994382,28,178,1,177,1,1,0,1,1,91,90,87,87,71
"6680",79,"[28]uJHggqkIHcidKocJvcGHqFdCjatE",173,0.994253,28,174,1,173,1,1,0,1,1,80,79,94,94,71
"6681",80,"[28]uJHggqkIHcidKocJvcGHqFdCjatE",173,0.994253,28,174,1,173,1,1,0,1,1,81,80,93,93,71
"6682",81,"[28]uJHggqkIHcidKocJvcGHqFdCjatE",175,0.994318,28,176,1,175,1,1,0,1,1,84,83,92,92,71
"6683",82,"[28]uJHggqkIHcidKocJvcGHqFdCjatE",176,0.99435,28,177,1,176,1,1,0,1,1,90,89,87,87,71
"6684",83,"[28]uJHggqkIHcidKocJvcGHqFdCjatE",171,0.994186,28,172,1,171,1,1,0,1,1,73,72,99,99,71
"6685",84,"[28]uJHggqkIHcidKocJvcGHqFdCjatE",176,0.99435,28,177,1,176,1,1,0,1,1,90,89,87,87,71
"6686",85,"[28]uJHggqkIHcidKocJvcGHqFdCjatE",176,0.99435,28,177,1,176,1,1,0,1,1,88,87,89,89,71
"6687",86,"[28]uJHggqkIHcidKocJvcGHqFdCjatE",178,0.994413,28,179,1,178,1,1,0,1,1,93,92,86,86,71
"6688",87,"[28]uJHggqkIHcidKocJvcGHqFdCjatE",173,0.994253,28,174,1,173,1,1,0,1,1,79,78,95,95,71
"6689",88,"[28]uJHggqkIHcidKocJvcGHqFdCjatE",177,0.994382,28,178,1,177,1,1,0,1,1,93,92,85,85,71
"6690",89,"[28]uJHggqkIHcidKocJvcGHqFdCjatE",180,0.994475,28,181,1,180,1,1,0,1,1,100,99,81,81,71
"6691",90,"[28]uJHggqkIHcidKocJvcGHqFdCjatE",178,0.994413,28,179,1,178,1,1,0,1,1,95,94,84,84,71
"6692",91,"[28]uJHggqkIHcidKocJvcGHqFdCjatE",178,0.994413,28,179,1,178,1,1,0,1,1,97,96,82,82,71
"6693",92,"[28]uJHggqkIHcidKocJvcGHqFdCjatE",174,0.994286,28,175,1,174,1,1,0,1,1,83,82,92,92,71
"6694",93,"[28]uJHggqkIHcidKocJvcGHqFdCjatE",175,0.994318,28,176,1,175,1,1,0,1,1,87,86,89,89,71
"6695",94,"[28]uJHggqkIHcidKocJvcGHqFdCjatE",176,0.99435,28,177,1,176,1,1,0,1,1,91,90,86,86,71
"6696",95,"[28]uJHggqkIHcidKocJvcGHqFdCjatE",173,0.994253,28,174,1,173,1,1,0,1,1,79,78,95,95,71
"6697",96,"[28]uJHggqkIHcidKocJvcGHqFdCjatE",176,0.99435,28,177,1,176,1,1,0,1,1,90,89,87,87,71
"6698",97,"[28]uJHggqkIHcidKocJvcGHqFdCjatE",177,0.994382,28,178,1,177,1,1,0,1,1,93,92,85,85,71
"6699",98,"[28]uJHggqkIHcidKocJvcGHqFdCjatE",173,0.994253,28,174,1,173,1,1,0,1,1,78,77,96,96,71
"6700",99,"[28]uJHggqkIHcidKocJvcGHqFdCjatE",177,0.994382,28,178,1,177,1,1,0,1,1,92,91,86,86,71
"6701",0,"[31]CJHggqIjHcFldKpcJvcGHqFdCyrKxge",178,0.994413,31,179,1,178,1,1,0,1,1,97,96,82,82,72
"6702",1,"[31]CJHggqIjHcFldKpcJvcGHqFdCyrKxge",174,0.994286,31,175,1,174,1,1,0,1,1,83,82,92,92,72
"6703",2,"[31]CJHggqIjHcFldKpcJvcGHqFdCyrKxge",173,0.994253,31,174,1,173,1,1,0,1,1,82,81,92,92,72
"6704",3,"[31]CJHggqIjHcFldKpcJvcGHqFdCyrKxge",171,0.994186,31,172,1,171,1,1,0,1,1,75,74,97,97,72
"6705",4,"[31]CJHggqIjHcFldKpcJvcGHqFdCyrKxge",174,0.994286,31,175,1,174,1,1,0,1,1,84,83,91,91,72
"6706",5,"[31]CJHggqIjHcFldKpcJvcGHqFdCyrKxge",171,0.994186,31,172,1,171,1,1,0,1,1,75,74,97,97,72
"6707",6,"[31]CJHggqIjHcFldKpcJvcGHqFdCyrKxge",176,0.99435,31,177,1,176,1,1,0,1,1,91,90,86,86,72
"6708",7,"[31]CJHggqIjHcFldKpcJvcGHqFdCyrKxge",178,0.994413,31,179,1,178,1,1,0,1,1,96,95,83,83,72
"6709",8,"[31]CJHggqIjHcFldKpcJvcGHqFdCyrKxge",178,0.994413,31,179,1,178,1,1,0,1,1,96,95,83,83,72
"6710",9,"[31]CJHggqIjHcFldKpcJvcGHqFdCyrKxge",175,0.994318,31,176,1,175,1,1,0,1,1,86,85,90,90,72
"6711",10,"[31]CJHggqIjHcFldKpcJvcGHqFdCyrKxge",173,0.994253,31,174,1,173,1,1,0,1,1,81,80,93,93,72
"6712",11,"[31]CJHggqIjHcFldKpcJvcGHqFdCyrKxge",175,0.994318,31,176,1,175,1,1,0,1,1,87,86,89,89,72
"6713",12,"[31]CJHggqIjHcFldKpcJvcGHqFdCyrKxge",171,0.994186,31,172,1,171,1,1,0,1,1,74,73,98,98,72
"6714",13,"[31]CJHggqIjHcFldKpcJvcGHqFdCyrKxge",178,0.994413,31,179,1,178,1,1,0,1,1,94,93,85,85,72
"6715",14,"[31]CJHggqIjHcFldKpcJvcGHqFdCyrKxge",176,0.99435,31,177,1,176,1,1,0,1,1,89,88,88,88,72
"6716",15,"[31]CJHggqIjHcFldKpcJvcGHqFdCyrKxge",175,0.994318,31,176,1,175,1,1,0,1,1,86,85,90,90,72
"6717",16,"[31]CJHggqIjHcFldKpcJvcGHqFdCyrKxge",177,0.994382,31,178,1,177,1,1,0,1,1,93,92,85,85,72
"6718",17,"[31]CJHggqIjHcFldKpcJvcGHqFdCyrKxge",178,0.994413,31,179,1,178,1,1,0,1,1,98,97,81,81,72
"6719",18,"[31]CJHggqIjHcFldKpcJvcGHqFdCyrKxge",173,0.994253,31,174,1,173,1,1,0,1,1,81,80,93,93,72
"6720",19,"[31]CJHggqIjHcFldKpcJvcGHqFdCyrKxge",174,0.994286,31,175,1,174,1,1,0,1,1,84,83,91,91,72
"6721",20,"[31]CJHggqIjHcFldKpcJvcGHqFdCyrKxge",179,0.994444,31,180,1,179,1,1,0,1,1,101,100,79,79,72
"6722",21,"[31]CJHggqIjHcFldKpcJvcGHqFdCyrKxge",173,0.994253,31,174,1,173,1,1,0,1,1,82,81,92,92,72
"6723",22,"[31]CJHggqIjHcFldKpcJvcGHqFdCyrKxge",174,0.994286,31,175,1,174,1,1,0,1,1,84,83,91,91,72
"6724",23,"[31]CJHggqIjHcFldKpcJvcGHqFdCyrKxge",177,0.994382,31,178,1,177,1,1,0,1,1,92,91,86,86,72
"6725",24,"[31]CJHggqIjHcFldKpcJvcGHqFdCyrKxge",176,0.99435,31,177,1,176,1,1,0,1,1,92,91,85,85,72
"6726",25,"[31]CJHggqIjHcFldKpcJvcGHqFdCyrKxge",172,0.99422,31,173,1,172,1,1,0,1,1,78,77,95,95,72
"6727",26,"[31]CJHggqIjHcFldKpcJvcGHqFdCyrKxge",178,0.994413,31,179,1,178,1,1,0,1,1,96,95,83,83,72
"6728",27,"[31]CJHggqIjHcFldKpcJvcGHqFdCyrKxge",172,0.99422,31,173,1,172,1,1,0,1,1,78,77,95,95,72
"6729",28,"[31]CJHggqIjHcFldKpcJvcGHqFdCyrKxge",172,0.99422,31,173,1,172,1,1,0,1,1,78,77,95,95,72
"6730",29,"[31]CJHggqIjHcFldKpcJvcGHqFdCyrKxge",175,0.994318,31,176,1,175,1,1,0,1,1,87,86,89,89,72
"6731",30,"[31]CJHggqIjHcFldKpcJvcGHqFdCyrKxge",176,0.99435,31,177,1,176,1,1,0,1,1,89,88,88,88,72
"6732",31,"[31]CJHggqIjHcFldKpcJvcGHqFdCyrKxge",173,0.994253,31,174,1,173,1,1,0,1,1,79,78,95,95,72
"6733",32,"[31]CJHggqIjHcFldKpcJvcGHqFdCyrKxge",178,0.994413,31,179,1,178,1,1,0,1,1,97,96,82,82,72
"6734",33,"[31]CJHggqIjHcFldKpcJvcGHqFdCyrKxge",175,0.994318,31,176,1,175,1,1,0,1,1,87,86,89,89,72
"6735",34,"[31]CJHggqIjHcFldKpcJvcGHqFdCyrKxge",176,0.99435,31,177,1,176,1,1,0,1,1,89,88,88,88,72
"6736",35,"[31]CJHggqIjHcFldKpcJvcGHqFdCyrKxge",175,0.994318,31,176,1,175,1,1,0,1,1,87,86,89,89,72
"6737",36,"[31]CJHggqIjHcFldKpcJvcGHqFdCyrKxge",178,0.994413,31,179,1,178,1,1,0,1,1,97,96,82,82,72
"6738",37,"[31]CJHggqIjHcFldKpcJvcGHqFdCyrKxge",179,0.994444,31,180,1,179,1,1,0,1,1,100,99,80,80,72
"6739",38,"[31]CJHggqIjHcFldKpcJvcGHqFdCyrKxge",177,0.994382,31,178,1,177,1,1,0,1,1,91,90,87,87,72
"6740",39,"[31]CJHggqIjHcFldKpcJvcGHqFdCyrKxge",178,0.994413,31,179,1,178,1,1,0,1,1,96,95,83,83,72
"6741",40,"[31]CJHggqIjHcFldKpcJvcGHqFdCyrKxge",178,0.994413,31,179,1,178,1,1,0,1,1,94,93,85,85,72
"6742",41,"[31]CJHggqIjHcFldKpcJvcGHqFdCyrKxge",174,0.994286,31,175,1,174,1,1,0,1,1,83,82,92,92,72
"6743",42,"[31]CJHggqIjHcFldKpcJvcGHqFdCyrKxge",177,0.994382,31,178,1,177,1,1,0,1,1,95,94,83,83,72
"6744",43,"[31]CJHggqIjHcFldKpcJvcGHqFdCyrKxge",176,0.99435,31,177,1,176,1,1,0,1,1,91,90,86,86,72
"6745",44,"[31]CJHggqIjHcFldKpcJvcGHqFdCyrKxge",178,0.994413,31,179,1,178,1,1,0,1,1,95,94,84,84,72
"6746",45,"[31]CJHggqIjHcFldKpcJvcGHqFdCyrKxge",176,0.99435,31,177,1,176,1,1,0,1,1,89,88,88,88,72
"6747",46,"[31]CJHggqIjHcFldKpcJvcGHqFdCyrKxge",176,0.99435,31,177,1,176,1,1,0,1,1,89,88,88,88,72
"6748",47,"[31]CJHggqIjHcFldKpcJvcGHqFdCyrKxge",180,0.994475,31,181,1,180,1,1,0,1,1,102,101,79,79,72
"6749",48,"[31]CJHggqIjHcFldKpcJvcGHqFdCyrKxge",177,0.994382,31,178,1,177,1,1,0,1,1,93,92,85,85,72
"6750",49,"[31]CJHggqIjHcFldKpcJvcGHqFdCyrKxge",179,0.994444,31,180,1,179,1,1,0,1,1,100,99,80,80,72
"6751",50,"[31]CJHggqIjHcFldKpcJvcGHqFdCyrKxge",176,0.99435,31,177,1,176,1,1,0,1,1,90,89,87,87,72
"6752",51,"[31]CJHggqIjHcFldKpcJvcGHqFdCyrKxge",175,0.994318,31,176,1,175,1,1,0,1,1,87,86,89,89,72
"6753",52,"[31]CJHggqIjHcFldKpcJvcGHqFdCyrKxge",170,0.994152,31,171,1,170,1,1,0,1,1,70,69,101,101,72
"6754",53,"[31]CJHggqIjHcFldKpcJvcGHqFdCyrKxge",177,0.994382,31,178,1,177,1,1,0,1,1,93,92,85,85,72
"6755",54,"[31]CJHggqIjHcFldKpcJvcGHqFdCyrKxge",174,0.994286,31,175,1,174,1,1,0,1,1,82,81,93,93,72
"6756",55,"[31]CJHggqIjHcFldKpcJvcGHqFdCyrKxge",175,0.994318,31,176,1,175,1,1,0,1,1,87,86,89,89,72
"6757",56,"[31]CJHggqIjHcFldKpcJvcGHqFdCyrKxge",174,0.994286,31,175,1,174,1,1,0,1,1,84,83,91,91,72
"6758",57,"[31]CJHggqIjHcFldKpcJvcGHqFdCyrKxge",176,0.99435,31,177,1,176,1,1,0,1,1,90,89,87,87,72
"6759",58,"[31]CJHggqIjHcFldKpcJvcGHqFdCyrKxge",176,0.99435,31,177,1,176,1,1,0,1,1,90,89,87,87,72
"6760",59,"[31]CJHggqIjHcFldKpcJvcGHqFdCyrKxge",179,0.994444,31,180,1,179,1,1,0,1,1,100,99,80,80,72
"6761",60,"[31]CJHggqIjHcFldKpcJvcGHqFdCyrKxge",184,0.994595,31,185,1,184,1,1,0,1,1,115,114,70,70,72
"6762",61,"[31]CJHggqIjHcFldKpcJvcGHqFdCyrKxge",176,0.99435,31,177,1,176,1,1,0,1,1,90,89,87,87,72
"6763",62,"[31]CJHggqIjHcFldKpcJvcGHqFdCyrKxge",177,0.994382,31,178,1,177,1,1,0,1,1,95,94,83,83,72
"6764",63,"[31]CJHggqIjHcFldKpcJvcGHqFdCyrKxge",172,0.99422,31,173,1,172,1,1,0,1,1,76,75,97,97,72
"6765",64,"[31]CJHggqIjHcFldKpcJvcGHqFdCyrKxge",175,0.994318,31,176,1,175,1,1,0,1,1,86,85,90,90,72
"6766",65,"[31]CJHggqIjHcFldKpcJvcGHqFdCyrKxge",173,0.994253,31,174,1,173,1,1,0,1,1,80,79,94,94,72
"6767",66,"[31]CJHggqIjHcFldKpcJvcGHqFdCyrKxge",174,0.994286,31,175,1,174,1,1,0,1,1,83,82,92,92,72
"6768",67,"[31]CJHggqIjHcFldKpcJvcGHqFdCyrKxge",175,0.994318,31,176,1,175,1,1,0,1,1,88,87,88,88,72
"6769",68,"[31]CJHggqIjHcFldKpcJvcGHqFdCyrKxge",176,0.99435,31,177,1,176,1,1,0,1,1,90,89,87,87,72
"6770",69,"[31]CJHggqIjHcFldKpcJvcGHqFdCyrKxge",176,0.99435,31,177,1,176,1,1,0,1,1,90,89,87,87,72
"6771",70,"[31]CJHggqIjHcFldKpcJvcGHqFdCyrKxge",175,0.994318,31,176,1,175,1,1,0,1,1,86,85,90,90,72
"6772",71,"[31]CJHggqIjHcFldKpcJvcGHqFdCyrKxge",176,0.99435,31,177,1,176,1,1,0,1,1,89,88,88,88,72
"6773",72,"[31]CJHggqIjHcFldKpcJvcGHqFdCyrKxge",177,0.994382,31,178,1,177,1,1,0,1,1,92,91,86,86,72
"6774",73,"[31]CJHggqIjHcFldKpcJvcGHqFdCyrKxge",176,0.99435,31,177,1,176,1,1,0,1,1,91,90,86,86,72
"6775",74,"[31]CJHggqIjHcFldKpcJvcGHqFdCyrKxge",176,0.99435,31,177,1,176,1,1,0,1,1,91,90,86,86,72
"6776",75,"[31]CJHggqIjHcFldKpcJvcGHqFdCyrKxge",178,0.994413,31,179,1,178,1,1,0,1,1,96,95,83,83,72
"6777",76,"[31]CJHggqIjHcFldKpcJvcGHqFdCyrKxge",172,0.99422,31,173,1,172,1,1,0,1,1,78,77,95,95,72
"6778",77,"[31]CJHggqIjHcFldKpcJvcGHqFdCyrKxge",175,0.994318,31,176,1,175,1,1,0,1,1,86,85,90,90,72
"6779",78,"[31]CJHggqIjHcFldKpcJvcGHqFdCyrKxge",176,0.99435,31,177,1,176,1,1,0,1,1,91,90,86,86,72
"6780",79,"[31]CJHggqIjHcFldKpcJvcGHqFdCyrKxge",173,0.994253,31,174,1,173,1,1,0,1,1,82,81,92,92,72
"6781",80,"[31]CJHggqIjHcFldKpcJvcGHqFdCyrKxge",175,0.994318,31,176,1,175,1,1,0,1,1,85,84,91,91,72
"6782",81,"[31]CJHggqIjHcFldKpcJvcGHqFdCyrKxge",178,0.994413,31,179,1,178,1,1,0,1,1,96,95,83,83,72
"6783",82,"[31]CJHggqIjHcFldKpcJvcGHqFdCyrKxge",175,0.994318,31,176,1,175,1,1,0,1,1,87,86,89,89,72
"6784",83,"[31]CJHggqIjHcFldKpcJvcGHqFdCyrKxge",177,0.994382,31,178,1,177,1,1,0,1,1,91,90,87,87,72
"6785",84,"[31]CJHggqIjHcFldKpcJvcGHqFdCyrKxge",173,0.994253,31,174,1,173,1,1,0,1,1,80,79,94,94,72
"6786",85,"[31]CJHggqIjHcFldKpcJvcGHqFdCyrKxge",176,0.99435,31,177,1,176,1,1,0,1,1,91,90,86,86,72
"6787",86,"[31]CJHggqIjHcFldKpcJvcGHqFdCyrKxge",173,0.994253,31,174,1,173,1,1,0,1,1,81,80,93,93,72
"6788",87,"[31]CJHggqIjHcFldKpcJvcGHqFdCyrKxge",178,0.994413,31,179,1,178,1,1,0,1,1,96,95,83,83,72
"6789",88,"[31]CJHggqIjHcFldKpcJvcGHqFdCyrKxge",179,0.994444,31,180,1,179,1,1,0,1,1,101,100,79,79,72
"6790",89,"[31]CJHggqIjHcFldKpcJvcGHqFdCyrKxge",173,0.994253,31,174,1,173,1,1,0,1,1,80,79,94,94,72
"6791",90,"[31]CJHggqIjHcFldKpcJvcGHqFdCyrKxge",180,0.994475,31,181,1,180,1,1,0,1,1,101,100,80,80,72
"6792",91,"[31]CJHggqIjHcFldKpcJvcGHqFdCyrKxge",175,0.994318,31,176,1,175,1,1,0,1,1,86,85,90,90,72
"6793",92,"[31]CJHggqIjHcFldKpcJvcGHqFdCyrKxge",172,0.99422,31,173,1,172,1,1,0,1,1,76,75,97,97,72
"6794",93,"[31]CJHggqIjHcFldKpcJvcGHqFdCyrKxge",172,0.99422,31,173,1,172,1,1,0,1,1,76,75,97,97,72
"6795",94,"[31]CJHggqIjHcFldKpcJvcGHqFdCyrKxge",176,0.99435,31,177,1,176,1,1,0,1,1,90,89,87,87,72
"6796",95,"[31]CJHggqIjHcFldKpcJvcGHqFdCyrKxge",177,0.994382,31,178,1,177,1,1,0,1,1,91,90,87,87,72
"6797",96,"[31]CJHggqIjHcFldKpcJvcGHqFdCyrKxge",174,0.994286,31,175,1,174,1,1,0,1,1,84,83,91,91,72
"6798",97,"[31]CJHggqIjHcFldKpcJvcGHqFdCyrKxge",174,0.994286,31,175,1,174,1,1,0,1,1,84,83,91,91,72
"6799",98,"[31]CJHggqIjHcFldKpcJvcGHqFdCyrKxge",172,0.99422,31,173,1,172,1,1,0,1,1,78,77,95,95,72
"6800",99,"[31]CJHggqIjHcFldKpcJvcGHqFdCyrKxge",175,0.994318,31,176,1,175,1,1,0,1,1,88,87,88,88,72
"6801",0,"[26]bJHggqIHcHidKpcJvcGHqFdCtc",176,0.99435,26,177,1,176,1,1,0,1,1,90,89,87,87,73
"6802",1,"[26]bJHggqIHcHidKpcJvcGHqFdCtc",174,0.994286,26,175,1,174,1,1,0,1,1,83,82,92,92,73
"6803",2,"[26]bJHggqIHcHidKpcJvcGHqFdCtc",176,0.99435,26,177,1,176,1,1,0,1,1,90,89,87,87,73
"6804",3,"[26]bJHggqIHcHidKpcJvcGHqFdCtc",173,0.994253,26,174,1,173,1,1,0,1,1,81,80,93,93,73
"6805",4,"[26]bJHggqIHcHidKpcJvcGHqFdCtc",174,0.994286,26,175,1,174,1,1,0,1,1,83,82,92,92,73
"6806",5,"[26]bJHggqIHcHidKpcJvcGHqFdCtc",172,0.99422,26,173,1,172,1,1,0,1,1,75,74,98,98,73
"6807",6,"[26]bJHggqIHcHidKpcJvcGHqFdCtc",176,0.99435,26,177,1,176,1,1,0,1,1,88,87,89,89,73
"6808",7,"[26]bJHggqIHcHidKpcJvcGHqFdCtc",178,0.994413,26,179,1,178,1,1,0,1,1,97,96,82,82,73
"6809",8,"[26]bJHggqIHcHidKpcJvcGHqFdCtc",178,0.994413,26,179,1,178,1,1,0,1,1,95,94,84,84,73
"6810",9,"[26]bJHggqIHcHidKpcJvcGHqFdCtc",181,0.994505,26,182,1,181,1,1,0,1,1,107,106,75,75,73
"6811",10,"[26]bJHggqIHcHidKpcJvcGHqFdCtc",176,0.99435,26,177,1,176,1,1,0,1,1,89,88,88,88,73
"6812",11,"[26]bJHggqIHcHidKpcJvcGHqFdCtc",177,0.994382,26,178,1,177,1,1,0,1,1,93,92,85,85,73
"6813",12,"[26]bJHggqIHcHidKpcJvcGHqFdCtc",177,0.994382,26,178,1,177,1,1,0,1,1,92,91,86,86,73
"6814",13,"[26]bJHggqIHcHidKpcJvcGHqFdCtc",179,0.994444,26,180,1,179,1,1,0,1,1,99,98,81,81,73
"6815",14,"[26]bJHggqIHcHidKpcJvcGHqFdCtc",172,0.99422,26,173,1,172,1,1,0,1,1,77,76,96,96,73
"6816",15,"[26]bJHggqIHcHidKpcJvcGHqFdCtc",179,0.994444,26,180,1,179,1,1,0,1,1,97,96,83,83,73
"6817",16,"[26]bJHggqIHcHidKpcJvcGHqFdCtc",173,0.994253,26,174,1,173,1,1,0,1,1,81,80,93,93,73
"6818",17,"[26]bJHggqIHcHidKpcJvcGHqFdCtc",177,0.994382,26,178,1,177,1,1,0,1,1,92,91,86,86,73
"6819",18,"[26]bJHggqIHcHidKpcJvcGHqFdCtc",173,0.994253,26,174,1,173,1,1,0,1,1,80,79,94,94,73
"6820",19,"[26]bJHggqIHcHidKpcJvcGHqFdCtc",180,0.994475,26,181,1,180,1,1,0,1,1,100,99,81,81,73
"6821",20,"[26]bJHggqIHcHidKpcJvcGHqFdCtc",176,0.99435,26,177,1,176,1,1,0,1,1,88,87,89,89,73
"6822",21,"[26]bJHggqIHcHidKpcJvcGHqFdCtc",179,0.994444,26,180,1,179,1,1,0,1,1,100,99,80,80,73
"6823",22,"[26]bJHggqIHcHidKpcJvcGHqFdCtc",175,0.994318,26,176,1,175,1,1,0,1,1,86,85,90,90,73
"6824",23,"[26]bJHggqIHcHidKpcJvcGHqFdCtc",174,0.994286,26,175,1,174,1,1,0,1,1,83,82,92,92,73
"6825",24,"[26]bJHggqIHcHidKpcJvcGHqFdCtc",174,0.994286,26,175,1,174,1,1,0,1,1,82,81,93,93,73
"6826",25,"[26]bJHggqIHcHidKpcJvcGHqFdCtc",177,0.994382,26,178,1,177,1,1,0,1,1,91,90,87,87,73
"6827",26,"[26]bJHggqIHcHidKpcJvcGHqFdCtc",176,0.99435,26,177,1,176,1,1,0,1,1,88,87,89,89,73
"6828",27,"[26]bJHggqIHcHidKpcJvcGHqFdCtc",179,0.994444,26,180,1,179,1,1,0,1,1,99,98,81,81,73
"6829",28,"[26]bJHggqIHcHidKpcJvcGHqFdCtc",176,0.99435,26,177,1,176,1,1,0,1,1,89,88,88,88,73
"6830",29,"[26]bJHggqIHcHidKpcJvcGHqFdCtc",173,0.994253,26,174,1,173,1,1,0,1,1,80,79,94,94,73
"6831",30,"[26]bJHggqIHcHidKpcJvcGHqFdCtc",173,0.994253,26,174,1,173,1,1,0,1,1,81,80,93,93,73
"6832",31,"[26]bJHggqIHcHidKpcJvcGHqFdCtc",178,0.994413,26,179,1,178,1,1,0,1,1,96,95,83,83,73
"6833",32,"[26]bJHggqIHcHidKpcJvcGHqFdCtc",177,0.994382,26,178,1,177,1,1,0,1,1,93,92,85,85,73
"6834",33,"[26]bJHggqIHcHidKpcJvcGHqFdCtc",179,0.994444,26,180,1,179,1,1,0,1,1,100,99,80,80,73
"6835",34,"[26]bJHggqIHcHidKpcJvcGHqFdCtc",176,0.99435,26,177,1,176,1,1,0,1,1,89,88,88,88,73
"6836",35,"[26]bJHggqIHcHidKpcJvcGHqFdCtc",180,0.994475,26,181,1,180,1,1,0,1,1,101,100,80,80,73
"6837",36,"[26]bJHggqIHcHidKpcJvcGHqFdCtc",174,0.994286,26,175,1,174,1,1,0,1,1,82,81,93,93,73
"6838",37,"[26]bJHggqIHcHidKpcJvcGHqFdCtc",176,0.99435,26,177,1,176,1,1,0,1,1,89,88,88,88,73
"6839",38,"[26]bJHggqIHcHidKpcJvcGHqFdCtc",174,0.994286,26,175,1,174,1,1,0,1,1,82,81,93,93,73
"6840",39,"[26]bJHggqIHcHidKpcJvcGHqFdCtc",175,0.994318,26,176,1,175,1,1,0,1,1,86,85,90,90,73
"6841",40,"[26]bJHggqIHcHidKpcJvcGHqFdCtc",179,0.994444,26,180,1,179,1,1,0,1,1,98,97,82,82,73
"6842",41,"[26]bJHggqIHcHidKpcJvcGHqFdCtc",175,0.994318,26,176,1,175,1,1,0,1,1,87,86,89,89,73
"6843",42,"[26]bJHggqIHcHidKpcJvcGHqFdCtc",174,0.994286,26,175,1,174,1,1,0,1,1,84,83,91,91,73
"6844",43,"[26]bJHggqIHcHidKpcJvcGHqFdCtc",175,0.994318,26,176,1,175,1,1,0,1,1,87,86,89,89,73
"6845",44,"[26]bJHggqIHcHidKpcJvcGHqFdCtc",179,0.994444,26,180,1,179,1,1,0,1,1,100,99,80,80,73
"6846",45,"[26]bJHggqIHcHidKpcJvcGHqFdCtc",176,0.99435,26,177,1,176,1,1,0,1,1,89,88,88,88,73
"6847",46,"[26]bJHggqIHcHidKpcJvcGHqFdCtc",179,0.994444,26,180,1,179,1,1,0,1,1,99,98,81,81,73
"6848",47,"[26]bJHggqIHcHidKpcJvcGHqFdCtc",173,0.994253,26,174,1,173,1,1,0,1,1,80,79,94,94,73
"6849",48,"[26]bJHggqIHcHidKpcJvcGHqFdCtc",173,0.994253,26,174,1,173,1,1,0,1,1,79,78,95,95,73
"6850",49,"[26]bJHggqIHcHidKpcJvcGHqFdCtc",176,0.99435,26,177,1,176,1,1,0,1,1,90,89,87,87,73
"6851",50,"[26]bJHggqIHcHidKpcJvcGHqFdCtc",177,0.994382,26,178,1,177,1,1,0,1,1,93,92,85,85,73
"6852",51,"[26]bJHggqIHcHidKpcJvcGHqFdCtc",178,0.994413,26,179,1,178,1,1,0,1,1,96,95,83,83,73
"6853",52,"[26]bJHggqIHcHidKpcJvcGHqFdCtc",172,0.99422,26,173,1,172,1,1,0,1,1,75,74,98,98,73
"6854",53,"[26]bJHggqIHcHidKpcJvcGHqFdCtc",177,0.994382,26,178,1,177,1,1,0,1,1,93,92,85,85,73
"6855",54,"[26]bJHggqIHcHidKpcJvcGHqFdCtc",178,0.994413,26,179,1,178,1,1,0,1,1,97,96,82,82,73
"6856",55,"[26]bJHggqIHcHidKpcJvcGHqFdCtc",171,0.994186,26,172,1,171,1,1,0,1,1,73,72,99,99,73
"6857",56,"[26]bJHggqIHcHidKpcJvcGHqFdCtc",179,0.994444,26,180,1,179,1,1,0,1,1,100,99,80,80,73
"6858",57,"[26]bJHggqIHcHidKpcJvcGHqFdCtc",178,0.994413,26,179,1,178,1,1,0,1,1,97,96,82,82,73
"6859",58,"[26]bJHggqIHcHidKpcJvcGHqFdCtc",175,0.994318,26,176,1,175,1,1,0,1,1,85,84,91,91,73
"6860",59,"[26]bJHggqIHcHidKpcJvcGHqFdCtc",174,0.994286,26,175,1,174,1,1,0,1,1,83,82,92,92,73
"6861",60,"[26]bJHggqIHcHidKpcJvcGHqFdCtc",179,0.994444,26,180,1,179,1,1,0,1,1,101,100,79,79,73
"6862",61,"[26]bJHggqIHcHidKpcJvcGHqFdCtc",176,0.99435,26,177,1,176,1,1,0,1,1,90,89,87,87,73
"6863",62,"[26]bJHggqIHcHidKpcJvcGHqFdCtc",181,0.994505,26,182,1,181,1,1,0,1,1,105,104,77,77,73
"6864",63,"[26]bJHggqIHcHidKpcJvcGHqFdCtc",175,0.994318,26,176,1,175,1,1,0,1,1,83,82,93,93,73
"6865",64,"[26]bJHggqIHcHidKpcJvcGHqFdCtc",177,0.994382,26,178,1,177,1,1,0,1,1,91,90,87,87,73
"6866",65,"[26]bJHggqIHcHidKpcJvcGHqFdCtc",176,0.99435,26,177,1,176,1,1,0,1,1,88,87,89,89,73
"6867",66,"[26]bJHggqIHcHidKpcJvcGHqFdCtc",173,0.994253,26,174,1,173,1,1,0,1,1,81,80,93,93,73
"6868",67,"[26]bJHggqIHcHidKpcJvcGHqFdCtc",177,0.994382,26,178,1,177,1,1,0,1,1,92,91,86,86,73
"6869",68,"[26]bJHggqIHcHidKpcJvcGHqFdCtc",176,0.99435,26,177,1,176,1,1,0,1,1,90,89,87,87,73
"6870",69,"[26]bJHggqIHcHidKpcJvcGHqFdCtc",177,0.994382,26,178,1,177,1,1,0,1,1,91,90,87,87,73
"6871",70,"[26]bJHggqIHcHidKpcJvcGHqFdCtc",175,0.994318,26,176,1,175,1,1,0,1,1,84,83,92,92,73
"6872",71,"[26]bJHggqIHcHidKpcJvcGHqFdCtc",172,0.99422,26,173,1,172,1,1,0,1,1,77,76,96,96,73
"6873",72,"[26]bJHggqIHcHidKpcJvcGHqFdCtc",176,0.99435,26,177,1,176,1,1,0,1,1,88,87,89,89,73
"6874",73,"[26]bJHggqIHcHidKpcJvcGHqFdCtc",179,0.994444,26,180,1,179,1,1,0,1,1,98,97,82,82,73
"6875",74,"[26]bJHggqIHcHidKpcJvcGHqFdCtc",176,0.99435,26,177,1,176,1,1,0,1,1,88,87,89,89,73
"6876",75,"[26]bJHggqIHcHidKpcJvcGHqFdCtc",173,0.994253,26,174,1,173,1,1,0,1,1,80,79,94,94,73
"6877",76,"[26]bJHggqIHcHidKpcJvcGHqFdCtc",171,0.994186,26,172,1,171,1,1,0,1,1,72,71,100,100,73
"6878",77,"[26]bJHggqIHcHidKpcJvcGHqFdCtc",178,0.994413,26,179,1,178,1,1,0,1,1,92,91,87,87,73
"6879",78,"[26]bJHggqIHcHidKpcJvcGHqFdCtc",180,0.994475,26,181,1,180,1,1,0,1,1,102,101,79,79,73
"6880",79,"[26]bJHggqIHcHidKpcJvcGHqFdCtc",181,0.994505,26,182,1,181,1,1,0,1,1,107,106,75,75,73
"6881",80,"[26]bJHggqIHcHidKpcJvcGHqFdCtc",177,0.994382,26,178,1,177,1,1,0,1,1,91,90,87,87,73
"6882",81,"[26]bJHggqIHcHidKpcJvcGHqFdCtc",177,0.994382,26,178,1,177,1,1,0,1,1,92,91,86,86,73
"6883",82,"[26]bJHggqIHcHidKpcJvcGHqFdCtc",173,0.994253,26,174,1,173,1,1,0,1,1,77,76,97,97,73
"6884",83,"[26]bJHggqIHcHidKpcJvcGHqFdCtc",178,0.994413,26,179,1,178,1,1,0,1,1,93,92,86,86,73
"6885",84,"[26]bJHggqIHcHidKpcJvcGHqFdCtc",174,0.994286,26,175,1,174,1,1,0,1,1,83,82,92,92,73
"6886",85,"[26]bJHggqIHcHidKpcJvcGHqFdCtc",180,0.994475,26,181,1,180,1,1,0,1,1,101,100,80,80,73
"6887",86,"[26]bJHggqIHcHidKpcJvcGHqFdCtc",173,0.994253,26,174,1,173,1,1,0,1,1,80,79,94,94,73
"6888",87,"[26]bJHggqIHcHidKpcJvcGHqFdCtc",176,0.99435,26,177,1,176,1,1,0,1,1,89,88,88,88,73
"6889",88,"[26]bJHggqIHcHidKpcJvcGHqFdCtc",173,0.994253,26,174,1,173,1,1,0,1,1,78,77,96,96,73
"6890",89,"[26]bJHggqIHcHidKpcJvcGHqFdCtc",177,0.994382,26,178,1,177,1,1,0,1,1,92,91,86,86,73
"6891",90,"[26]bJHggqIHcHidKpcJvcGHqFdCtc",173,0.994253,26,174,1,173,1,1,0,1,1,81,80,93,93,73
"6892",91,"[26]bJHggqIHcHidKpcJvcGHqFdCtc",177,0.994382,26,178,1,177,1,1,0,1,1,94,93,84,84,73
"6893",92,"[26]bJHggqIHcHidKpcJvcGHqFdCtc",176,0.99435,26,177,1,176,1,1,0,1,1,90,89,87,87,73
"6894",93,"[26]bJHggqIHcHidKpcJvcGHqFdCtc",179,0.994444,26,180,1,179,1,1,0,1,1,96,95,84,84,73
"6895",94,"[26]bJHggqIHcHidKpcJvcGHqFdCtc",171,0.994186,26,172,1,171,1,1,0,1,1,73,72,99,99,73
"6896",95,"[26]bJHggqIHcHidKpcJvcGHqFdCtc",178,0.994413,26,179,1,178,1,1,0,1,1,96,95,83,83,73
"6897",96,"[26]bJHggqIHcHidKpcJvcGHqFdCtc",177,0.994382,26,178,1,177,1,1,0,1,1,92,91,86,86,73
"6898",97,"[26]bJHggqIHcHidKpcJvcGHqFdCtc",174,0.994286,26,175,1,174,1,1,0,1,1,82,81,93,93,73
"6899",98,"[26]bJHggqIHcHidKpcJvcGHqFdCtc",174,0.994286,26,175,1,174,1,1,0,1,1,83,82,92,92,73
"6900",99,"[26]bJHggqIHcHidKpcJvcGHqFdCtc",176,0.99435,26,177,1,176,1,1,0,1,1,89,88,88,88,73
"6901",0,"[35]wJHggqIbGHcldKocJvcGHqFdCaFielIgpms",175,0.994318,35,176,1,175,1,1,0,1,1,87,86,89,89,74
"6902",1,"[35]wJHggqIbGHcldKocJvcGHqFdCaFielIgpms",173,0.994253,35,174,1,173,1,1,0,1,1,79,78,95,95,74
"6903",2,"[35]wJHggqIbGHcldKocJvcGHqFdCaFielIgpms",176,0.99435,35,177,1,176,1,1,0,1,1,90,89,87,87,74
"6904",3,"[35]wJHggqIbGHcldKocJvcGHqFdCaFielIgpms",180,0.994475,35,181,1,180,1,1,0,1,1,104,103,77,77,74
"6905",4,"[35]wJHggqIbGHcldKocJvcGHqFdCaFielIgpms",177,0.994382,35,178,1,177,1,1,0,1,1,93,92,85,85,74
"6906",5,"[35]wJHggqIbGHcldKocJvcGHqFdCaFielIgpms",176,0.99435,35,177,1,176,1,1,0,1,1,90,89,87,87,74
"6907",6,"[35]wJHggqIbGHcldKocJvcGHqFdCaFielIgpms",173,0.994253,35,174,1,173,1,1,0,1,1,79,78,95,95,74
"6908",7,"[35]wJHggqIbGHcldKocJvcGHqFdCaFielIgpms",171,0.994186,35,172,1,171,1,1,0,1,1,75,74,97,97,74
"6909",8,"[35]wJHggqIbGHcldKocJvcGHqFdCaFielIgpms",175,0.994318,35,176,1,175,1,1,0,1,1,88,87,88,88,74
"6910",9,"[35]wJHggqIbGHcldKocJvcGHqFdCaFielIgpms",177,0.994382,35,178,1,177,1,1,0,1,1,94,93,84,84,74
"6911",10,"[35]wJHggqIbGHcldKocJvcGHqFdCaFielIgpms",174,0.994286,35,175,1,174,1,1,0,1,1,85,84,90,90,74
"6912",11,"[35]wJHggqIbGHcldKocJvcGHqFdCaFielIgpms",173,0.994253,35,174,1,173,1,1,0,1,1,80,79,94,94,74
"6913",12,"[35]wJHggqIbGHcldKocJvcGHqFdCaFielIgpms",177,0.994382,35,178,1,177,1,1,0,1,1,93,92,85,85,74
"6914",13,"[35]wJHggqIbGHcldKocJvcGHqFdCaFielIgpms",176,0.99435,35,177,1,176,1,1,0,1,1,91,90,86,86,74
"6915",14,"[35]wJHggqIbGHcldKocJvcGHqFdCaFielIgpms",179,0.994444,35,180,1,179,1,1,0,1,1,99,98,81,81,74
"6916",15,"[35]wJHggqIbGHcldKocJvcGHqFdCaFielIgpms",173,0.994253,35,174,1,173,1,1,0,1,1,80,79,94,94,74
"6917",16,"[35]wJHggqIbGHcldKocJvcGHqFdCaFielIgpms",174,0.994286,35,175,1,174,1,1,0,1,1,84,83,91,91,74
"6918",17,"[35]wJHggqIbGHcldKocJvcGHqFdCaFielIgpms",176,0.99435,35,177,1,176,1,1,0,1,1,89,88,88,88,74
"6919",18,"[35]wJHggqIbGHcldKocJvcGHqFdCaFielIgpms",179,0.994444,35,180,1,179,1,1,0,1,1,98,97,82,82,74
"6920",19,"[35]wJHggqIbGHcldKocJvcGHqFdCaFielIgpms",178,0.994413,35,179,1,178,1,1,0,1,1,98,97,81,81,74
"6921",20,"[35]wJHggqIbGHcldKocJvcGHqFdCaFielIgpms",175,0.994318,35,176,1,175,1,1,0,1,1,88,87,88,88,74
"6922",21,"[35]wJHggqIbGHcldKocJvcGHqFdCaFielIgpms",178,0.994413,35,179,1,178,1,1,0,1,1,96,95,83,83,74
"6923",22,"[35]wJHggqIbGHcldKocJvcGHqFdCaFielIgpms",175,0.994318,35,176,1,175,1,1,0,1,1,86,85,90,90,74
"6924",23,"[35]wJHggqIbGHcldKocJvcGHqFdCaFielIgpms",178,0.994413,35,179,1,178,1,1,0,1,1,95,94,84,84,74
"6925",24,"[35]wJHggqIbGHcldKocJvcGHqFdCaFielIgpms",173,0.994253,35,174,1,173,1,1,0,1,1,82,81,92,92,74
"6926",25,"[35]wJHggqIbGHcldKocJvcGHqFdCaFielIgpms",176,0.99435,35,177,1,176,1,1,0,1,1,91,90,86,86,74
"6927",26,"[35]wJHggqIbGHcldKocJvcGHqFdCaFielIgpms",176,0.99435,35,177,1,176,1,1,0,1,1,91,90,86,86,74
"6928",27,"[35]wJHggqIbGHcldKocJvcGHqFdCaFielIgpms",174,0.994286,35,175,1,174,1,1,0,1,1,84,83,91,91,74
"6929",28,"[35]wJHggqIbGHcldKocJvcGHqFdCaFielIgpms",177,0.994382,35,178,1,177,1,1,0,1,1,91,90,87,87,74
"6930",29,"[35]wJHggqIbGHcldKocJvcGHqFdCaFielIgpms",176,0.99435,35,177,1,176,1,1,0,1,1,89,88,88,88,74
"6931",30,"[35]wJHggqIbGHcldKocJvcGHqFdCaFielIgpms",170,0.994152,35,171,1,170,1,1,0,1,1,70,69,101,101,74
"6932",31,"[35]wJHggqIbGHcldKocJvcGHqFdCaFielIgpms",171,0.994186,35,172,1,171,1,1,0,1,1,74,73,98,98,74
"6933",32,"[35]wJHggqIbGHcldKocJvcGHqFdCaFielIgpms",180,0.994475,35,181,1,180,1,1,0,1,1,104,103,77,77,74
"6934",33,"[35]wJHggqIbGHcldKocJvcGHqFdCaFielIgpms",174,0.994286,35,175,1,174,1,1,0,1,1,84,83,91,91,74
"6935",34,"[35]wJHggqIbGHcldKocJvcGHqFdCaFielIgpms",178,0.994413,35,179,1,178,1,1,0,1,1,97,96,82,82,74
"6936",35,"[35]wJHggqIbGHcldKocJvcGHqFdCaFielIgpms",175,0.994318,35,176,1,175,1,1,0,1,1,88,87,88,88,74
"6937",36,"[35]wJHggqIbGHcldKocJvcGHqFdCaFielIgpms",178,0.994413,35,179,1,178,1,1,0,1,1,96,95,83,83,74
"6938",37,"[35]wJHggqIbGHcldKocJvcGHqFdCaFielIgpms",173,0.994253,35,174,1,173,1,1,0,1,1,82,81,92,92,74
"6939",38,"[35]wJHggqIbGHcldKocJvcGHqFdCaFielIgpms",176,0.99435,35,177,1,176,1,1,0,1,1,89,88,88,88,74
"6940",39,"[35]wJHggqIbGHcldKocJvcGHqFdCaFielIgpms",176,0.99435,35,177,1,176,1,1,0,1,1,91,90,86,86,74
"6941",40,"[35]wJHggqIbGHcldKocJvcGHqFdCaFielIgpms",177,0.994382,35,178,1,177,1,1,0,1,1,91,90,87,87,74
"6942",41,"[35]wJHggqIbGHcldKocJvcGHqFdCaFielIgpms",178,0.994413,35,179,1,178,1,1,0,1,1,97,96,82,82,74
"6943",42,"[35]wJHggqIbGHcldKocJvcGHqFdCaFielIgpms",176,0.99435,35,177,1,176,1,1,0,1,1,91,90,86,86,74
"6944",43,"[35]wJHggqIbGHcldKocJvcGHqFdCaFielIgpms",177,0.994382,35,178,1,177,1,1,0,1,1,94,93,84,84,74
"6945",44,"[35]wJHggqIbGHcldKocJvcGHqFdCaFielIgpms",178,0.994413,35,179,1,178,1,1,0,1,1,97,96,82,82,74
"6946",45,"[35]wJHggqIbGHcldKocJvcGHqFdCaFielIgpms",174,0.994286,35,175,1,174,1,1,0,1,1,84,83,91,91,74
"6947",46,"[35]wJHggqIbGHcldKocJvcGHqFdCaFielIgpms",174,0.994286,35,175,1,174,1,1,0,1,1,82,81,93,93,74
"6948",47,"[35]wJHggqIbGHcldKocJvcGHqFdCaFielIgpms",175,0.994318,35,176,1,175,1,1,0,1,1,88,87,88,88,74
"6949",48,"[35]wJHggqIbGHcldKocJvcGHqFdCaFielIgpms",178,0.994413,35,179,1,178,1,1,0,1,1,97,96,82,82,74
"6950",49,"[35]wJHggqIbGHcldKocJvcGHqFdCaFielIgpms",176,0.99435,35,177,1,176,1,1,0,1,1,89,88,88,88,74
"6951",50,"[35]wJHggqIbGHcldKocJvcGHqFdCaFielIgpms",176,0.99435,35,177,1,176,1,1,0,1,1,91,90,86,86,74
"6952",51,"[35]wJHggqIbGHcldKocJvcGHqFdCaFielIgpms",178,0.994413,35,179,1,178,1,1,0,1,1,97,96,82,82,74
"6953",52,"[35]wJHggqIbGHcldKocJvcGHqFdCaFielIgpms",178,0.994413,35,179,1,178,1,1,0,1,1,97,96,82,82,74
"6954",53,"[35]wJHggqIbGHcldKocJvcGHqFdCaFielIgpms",175,0.994318,35,176,1,175,1,1,0,1,1,86,85,90,90,74
"6955",54,"[35]wJHggqIbGHcldKocJvcGHqFdCaFielIgpms",176,0.99435,35,177,1,176,1,1,0,1,1,90,89,87,87,74
"6956",55,"[35]wJHggqIbGHcldKocJvcGHqFdCaFielIgpms",179,0.994444,35,180,1,179,1,1,0,1,1,102,101,78,78,74
"6957",56,"[35]wJHggqIbGHcldKocJvcGHqFdCaFielIgpms",177,0.994382,35,178,1,177,1,1,0,1,1,94,93,84,84,74
"6958",57,"[35]wJHggqIbGHcldKocJvcGHqFdCaFielIgpms",176,0.99435,35,177,1,176,1,1,0,1,1,91,90,86,86,74
"6959",58,"[35]wJHggqIbGHcldKocJvcGHqFdCaFielIgpms",176,0.99435,35,177,1,176,1,1,0,1,1,92,91,85,85,74
"6960",59,"[35]wJHggqIbGHcldKocJvcGHqFdCaFielIgpms",172,0.99422,35,173,1,172,1,1,0,1,1,76,75,97,97,74
"6961",60,"[35]wJHggqIbGHcldKocJvcGHqFdCaFielIgpms",175,0.994318,35,176,1,175,1,1,0,1,1,85,84,91,91,74
"6962",61,"[35]wJHggqIbGHcldKocJvcGHqFdCaFielIgpms",175,0.994318,35,176,1,175,1,1,0,1,1,88,87,88,88,74
"6963",62,"[35]wJHggqIbGHcldKocJvcGHqFdCaFielIgpms",176,0.99435,35,177,1,176,1,1,0,1,1,88,87,89,89,74
"6964",63,"[35]wJHggqIbGHcldKocJvcGHqFdCaFielIgpms",175,0.994318,35,176,1,175,1,1,0,1,1,88,87,88,88,74
"6965",64,"[35]wJHggqIbGHcldKocJvcGHqFdCaFielIgpms",170,0.994152,35,171,1,170,1,1,0,1,1,71,70,100,100,74
"6966",65,"[35]wJHggqIbGHcldKocJvcGHqFdCaFielIgpms",176,0.99435,35,177,1,176,1,1,0,1,1,91,90,86,86,74
"6967",66,"[35]wJHggqIbGHcldKocJvcGHqFdCaFielIgpms",176,0.99435,35,177,1,176,1,1,0,1,1,91,90,86,86,74
"6968",67,"[35]wJHggqIbGHcldKocJvcGHqFdCaFielIgpms",176,0.99435,35,177,1,176,1,1,0,1,1,90,89,87,87,74
"6969",68,"[35]wJHggqIbGHcldKocJvcGHqFdCaFielIgpms",175,0.994318,35,176,1,175,1,1,0,1,1,88,87,88,88,74
"6970",69,"[35]wJHggqIbGHcldKocJvcGHqFdCaFielIgpms",172,0.99422,35,173,1,172,1,1,0,1,1,78,77,95,95,74
"6971",70,"[35]wJHggqIbGHcldKocJvcGHqFdCaFielIgpms",177,0.994382,35,178,1,177,1,1,0,1,1,93,92,85,85,74
"6972",71,"[35]wJHggqIbGHcldKocJvcGHqFdCaFielIgpms",181,0.994505,35,182,1,181,1,1,0,1,1,107,106,75,75,74
"6973",72,"[35]wJHggqIbGHcldKocJvcGHqFdCaFielIgpms",175,0.994318,35,176,1,175,1,1,0,1,1,87,86,89,89,74
"6974",73,"[35]wJHggqIbGHcldKocJvcGHqFdCaFielIgpms",173,0.994253,35,174,1,173,1,1,0,1,1,80,79,94,94,74
"6975",74,"[35]wJHggqIbGHcldKocJvcGHqFdCaFielIgpms",175,0.994318,35,176,1,175,1,1,0,1,1,88,87,88,88,74
"6976",75,"[35]wJHggqIbGHcldKocJvcGHqFdCaFielIgpms",177,0.994382,35,178,1,177,1,1,0,1,1,94,93,84,84,74
"6977",76,"[35]wJHggqIbGHcldKocJvcGHqFdCaFielIgpms",175,0.994318,35,176,1,175,1,1,0,1,1,86,85,90,90,74
"6978",77,"[35]wJHggqIbGHcldKocJvcGHqFdCaFielIgpms",175,0.994318,35,176,1,175,1,1,0,1,1,86,85,90,90,74
"6979",78,"[35]wJHggqIbGHcldKocJvcGHqFdCaFielIgpms",175,0.994318,35,176,1,175,1,1,0,1,1,87,86,89,89,74
"6980",79,"[35]wJHggqIbGHcldKocJvcGHqFdCaFielIgpms",172,0.99422,35,173,1,172,1,1,0,1,1,77,76,96,96,74
"6981",80,"[35]wJHggqIbGHcldKocJvcGHqFdCaFielIgpms",178,0.994413,35,179,1,178,1,1,0,1,1,98,97,81,81,74
"6982",81,"[35]wJHggqIbGHcldKocJvcGHqFdCaFielIgpms",174,0.994286,35,175,1,174,1,1,0,1,1,83,82,92,92,74
"6983",82,"[35]wJHggqIbGHcldKocJvcGHqFdCaFielIgpms",178,0.994413,35,179,1,178,1,1,0,1,1,98,97,81,81,74
"6984",83,"[35]wJHggqIbGHcldKocJvcGHqFdCaFielIgpms",174,0.994286,35,175,1,174,1,1,0,1,1,84,83,91,91,74
"6985",84,"[35]wJHggqIbGHcldKocJvcGHqFdCaFielIgpms",172,0.99422,35,173,1,172,1,1,0,1,1,78,77,95,95,74
"6986",85,"[35]wJHggqIbGHcldKocJvcGHqFdCaFielIgpms",175,0.994318,35,176,1,175,1,1,0,1,1,87,86,89,89,74
"6987",86,"[35]wJHggqIbGHcldKocJvcGHqFdCaFielIgpms",172,0.99422,35,173,1,172,1,1,0,1,1,76,75,97,97,74
"6988",87,"[35]wJHggqIbGHcldKocJvcGHqFdCaFielIgpms",172,0.99422,35,173,1,172,1,1,0,1,1,76,75,97,97,74
"6989",88,"[35]wJHggqIbGHcldKocJvcGHqFdCaFielIgpms",170,0.994152,35,171,1,170,1,1,0,1,1,72,71,99,99,74
"6990",89,"[35]wJHggqIbGHcldKocJvcGHqFdCaFielIgpms",175,0.994318,35,176,1,175,1,1,0,1,1,87,86,89,89,74
"6991",90,"[35]wJHggqIbGHcldKocJvcGHqFdCaFielIgpms",173,0.994253,35,174,1,173,1,1,0,1,1,80,79,94,94,74
"6992",91,"[35]wJHggqIbGHcldKocJvcGHqFdCaFielIgpms",177,0.994382,35,178,1,177,1,1,0,1,1,95,94,83,83,74
"6993",92,"[35]wJHggqIbGHcldKocJvcGHqFdCaFielIgpms",174,0.994286,35,175,1,174,1,1,0,1,1,84,83,91,91,74
"6994",93,"[35]wJHggqIbGHcldKocJvcGHqFdCaFielIgpms",170,0.994152,35,171,1,170,1,1,0,1,1,71,70,100,100,74
"6995",94,"[35]wJHggqIbGHcldKocJvcGHqFdCaFielIgpms",171,0.994186,35,172,1,171,1,1,0,1,1,74,73,98,98,74
"6996",95,"[35]wJHggqIbGHcldKocJvcGHqFdCaFielIgpms",177,0.994382,35,178,1,177,1,1,0,1,1,93,92,85,85,74
"6997",96,"[35]wJHggqIbGHcldKocJvcGHqFdCaFielIgpms",175,0.994318,35,176,1,175,1,1,0,1,1,85,84,91,91,74
"6998",97,"[35]wJHggqIbGHcldKocJvcGHqFdCaFielIgpms",174,0.994286,35,175,1,174,1,1,0,1,1,82,81,93,93,74
"6999",98,"[35]wJHggqIbGHcldKocJvcGHqFdCaFielIgpms",183,0.994565,35,184,1,183,1,1,0,1,1,112,111,72,72,74
"7000",99,"[35]wJHggqIbGHcldKocJvcGHqFdCaFielIgpms",177,0.994382,35,178,1,177,1,1,0,1,1,93,92,85,85,74
"7001",0,"[30]uJHggqjIHcdKpcJvcGHqwdCysfKAIg",168,0.994083,30,169,1,168,1,1,0,1,1,89,88,80,80,75
"7002",1,"[30]uJHggqjIHcdKpcJvcGHqwdCysfKAIg",164,0.993939,30,165,1,164,1,1,0,1,1,76,75,89,89,75
"7003",2,"[30]uJHggqjIHcdKpcJvcGHqwdCysfKAIg",170,0.994152,30,171,1,170,1,1,0,1,1,91,90,80,80,75
"7004",3,"[30]uJHggqjIHcdKpcJvcGHqwdCysfKAIg",169,0.994118,30,170,1,169,1,1,0,1,1,90,89,80,80,75
"7005",4,"[30]uJHggqjIHcdKpcJvcGHqwdCysfKAIg",160,0.993789,30,161,1,160,1,1,0,1,1,65,64,96,96,75
"7006",5,"[30]uJHggqjIHcdKpcJvcGHqwdCysfKAIg",164,0.993939,30,165,1,164,1,1,0,1,1,78,77,87,87,75
"7007",6,"[30]uJHggqjIHcdKpcJvcGHqwdCysfKAIg",168,0.994083,30,169,1,168,1,1,0,1,1,87,86,82,82,75
"7008",7,"[30]uJHggqjIHcdKpcJvcGHqwdCysfKAIg",175,0.994318,30,176,1,175,1,1,0,1,1,105,104,71,71,75
"7009",8,"[30]uJHggqjIHcdKpcJvcGHqwdCysfKAIg",162,0.993865,30,163,1,162,1,1,0,1,1,70,69,93,93,75
"7010",9,"[30]uJHggqjIHcdKpcJvcGHqwdCysfKAIg",165,0.993976,30,166,1,165,1,1,0,1,1,80,79,86,86,75
"7011",10,"[30]uJHggqjIHcdKpcJvcGHqwdCysfKAIg",164,0.993939,30,165,1,164,1,1,0,1,1,77,76,88,88,75
"7012",11,"[30]uJHggqjIHcdKpcJvcGHqwdCysfKAIg",165,0.993976,30,166,1,165,1,1,0,1,1,79,78,87,87,75
"7013",12,"[30]uJHggqjIHcdKpcJvcGHqwdCysfKAIg",164,0.993939,30,165,1,164,1,1,0,1,1,77,76,88,88,75
"7014",13,"[30]uJHggqjIHcdKpcJvcGHqwdCysfKAIg",166,0.994012,30,167,1,166,1,1,0,1,1,83,82,84,84,75
"7015",14,"[30]uJHggqjIHcdKpcJvcGHqwdCysfKAIg",167,0.994048,30,168,1,167,1,1,0,1,1,85,84,83,83,75
"7016",15,"[30]uJHggqjIHcdKpcJvcGHqwdCysfKAIg",169,0.994118,30,170,1,169,1,1,0,1,1,89,88,81,81,75
"7017",16,"[30]uJHggqjIHcdKpcJvcGHqwdCysfKAIg",172,0.99422,30,173,1,172,1,1,0,1,1,97,96,76,76,75
"7018",17,"[30]uJHggqjIHcdKpcJvcGHqwdCysfKAIg",166,0.994012,30,167,1,166,1,1,0,1,1,81,80,86,86,75
"7019",18,"[30]uJHggqjIHcdKpcJvcGHqwdCysfKAIg",168,0.994083,30,169,1,168,1,1,0,1,1,87,86,82,82,75
"7020",19,"[30]uJHggqjIHcdKpcJvcGHqwdCysfKAIg",165,0.993976,30,166,1,165,1,1,0,1,1,80,79,86,86,75
"7021",20,"[30]uJHggqjIHcdKpcJvcGHqwdCysfKAIg",165,0.993976,30,166,1,165,1,1,0,1,1,80,79,86,86,75
"7022",21,"[30]uJHggqjIHcdKpcJvcGHqwdCysfKAIg",170,0.994152,30,171,1,170,1,1,0,1,1,93,92,78,78,75
"7023",22,"[30]uJHggqjIHcdKpcJvcGHqwdCysfKAIg",168,0.994083,30,169,1,168,1,1,0,1,1,88,87,81,81,75
"7024",23,"[30]uJHggqjIHcdKpcJvcGHqwdCysfKAIg",170,0.994152,30,171,1,170,1,1,0,1,1,93,92,78,78,75
"7025",24,"[30]uJHggqjIHcdKpcJvcGHqwdCysfKAIg",165,0.993976,30,166,1,165,1,1,0,1,1,78,77,88,88,75
"7026",25,"[30]uJHggqjIHcdKpcJvcGHqwdCysfKAIg",164,0.993939,30,165,1,164,1,1,0,1,1,77,76,88,88,75
"7027",26,"[30]uJHggqjIHcdKpcJvcGHqwdCysfKAIg",166,0.994012,30,167,1,166,1,1,0,1,1,82,81,85,85,75
"7028",27,"[30]uJHggqjIHcdKpcJvcGHqwdCysfKAIg",174,0.994286,30,175,1,174,1,1,0,1,1,104,103,71,71,75
"7029",28,"[30]uJHggqjIHcdKpcJvcGHqwdCysfKAIg",169,0.994118,30,170,1,169,1,1,0,1,1,90,89,80,80,75
"7030",29,"[30]uJHggqjIHcdKpcJvcGHqwdCysfKAIg",170,0.994152,30,171,1,170,1,1,0,1,1,94,93,77,77,75
"7031",30,"[30]uJHggqjIHcdKpcJvcGHqwdCysfKAIg",166,0.994012,30,167,1,166,1,1,0,1,1,82,81,85,85,75
"7032",31,"[30]uJHggqjIHcdKpcJvcGHqwdCysfKAIg",166,0.994012,30,167,1,166,1,1,0,1,1,82,81,85,85,75
"7033",32,"[30]uJHggqjIHcdKpcJvcGHqwdCysfKAIg",169,0.994118,30,170,1,169,1,1,0,1,1,91,90,79,79,75
"7034",33,"[30]uJHggqjIHcdKpcJvcGHqwdCysfKAIg",168,0.994083,30,169,1,168,1,1,0,1,1,89,88,80,80,75
"7035",34,"[30]uJHggqjIHcdKpcJvcGHqwdCysfKAIg",164,0.993939,30,165,1,164,1,1,0,1,1,78,77,87,87,75
"7036",35,"[30]uJHggqjIHcdKpcJvcGHqwdCysfKAIg",170,0.994152,30,171,1,170,1,1,0,1,1,93,92,78,78,75
"7037",36,"[30]uJHggqjIHcdKpcJvcGHqwdCysfKAIg",169,0.994118,30,170,1,169,1,1,0,1,1,90,89,80,80,75
"7038",37,"[30]uJHggqjIHcdKpcJvcGHqwdCysfKAIg",162,0.993865,30,163,1,162,1,1,0,1,1,72,71,91,91,75
"7039",38,"[30]uJHggqjIHcdKpcJvcGHqwdCysfKAIg",169,0.994118,30,170,1,169,1,1,0,1,1,89,88,81,81,75
"7040",39,"[30]uJHggqjIHcdKpcJvcGHqwdCysfKAIg",170,0.994152,30,171,1,170,1,1,0,1,1,93,92,78,78,75
"7041",40,"[30]uJHggqjIHcdKpcJvcGHqwdCysfKAIg",168,0.994083,30,169,1,168,1,1,0,1,1,88,87,81,81,75
"7042",41,"[30]uJHggqjIHcdKpcJvcGHqwdCysfKAIg",162,0.993865,30,163,1,162,1,1,0,1,1,71,70,92,92,75
"7043",42,"[30]uJHggqjIHcdKpcJvcGHqwdCysfKAIg",164,0.993939,30,165,1,164,1,1,0,1,1,77,76,88,88,75
"7044",43,"[30]uJHggqjIHcdKpcJvcGHqwdCysfKAIg",168,0.994083,30,169,1,168,1,1,0,1,1,87,86,82,82,75
"7045",44,"[30]uJHggqjIHcdKpcJvcGHqwdCysfKAIg",161,0.993827,30,162,1,161,1,1,0,1,1,68,67,94,94,75
"7046",45,"[30]uJHggqjIHcdKpcJvcGHqwdCysfKAIg",164,0.993939,30,165,1,164,1,1,0,1,1,75,74,90,90,75
"7047",46,"[30]uJHggqjIHcdKpcJvcGHqwdCysfKAIg",164,0.993939,30,165,1,164,1,1,0,1,1,75,74,90,90,75
"7048",47,"[30]uJHggqjIHcdKpcJvcGHqwdCysfKAIg",165,0.993976,30,166,1,165,1,1,0,1,1,80,79,86,86,75
"7049",48,"[30]uJHggqjIHcdKpcJvcGHqwdCysfKAIg",164,0.993939,30,165,1,164,1,1,0,1,1,78,77,87,87,75
"7050",49,"[30]uJHggqjIHcdKpcJvcGHqwdCysfKAIg",169,0.994118,30,170,1,169,1,1,0,1,1,89,88,81,81,75
"7051",50,"[30]uJHggqjIHcdKpcJvcGHqwdCysfKAIg",167,0.994048,30,168,1,167,1,1,0,1,1,86,85,82,82,75
"7052",51,"[30]uJHggqjIHcdKpcJvcGHqwdCysfKAIg",161,0.993827,30,162,1,161,1,1,0,1,1,68,67,94,94,75
"7053",52,"[30]uJHggqjIHcdKpcJvcGHqwdCysfKAIg",166,0.994012,30,167,1,166,1,1,0,1,1,83,82,84,84,75
"7054",53,"[30]uJHggqjIHcdKpcJvcGHqwdCysfKAIg",163,0.993902,30,164,1,163,1,1,0,1,1,74,73,90,90,75
"7055",54,"[30]uJHggqjIHcdKpcJvcGHqwdCysfKAIg",168,0.994083,30,169,1,168,1,1,0,1,1,87,86,82,82,75
"7056",55,"[30]uJHggqjIHcdKpcJvcGHqwdCysfKAIg",162,0.993865,30,163,1,162,1,1,0,1,1,72,71,91,91,75
"7057",56,"[30]uJHggqjIHcdKpcJvcGHqwdCysfKAIg",168,0.994083,30,169,1,168,1,1,0,1,1,88,87,81,81,75
"7058",57,"[30]uJHggqjIHcdKpcJvcGHqwdCysfKAIg",168,0.994083,30,169,1,168,1,1,0,1,1,89,88,80,80,75
"7059",58,"[30]uJHggqjIHcdKpcJvcGHqwdCysfKAIg",165,0.993976,30,166,1,165,1,1,0,1,1,80,79,86,86,75
"7060",59,"[30]uJHggqjIHcdKpcJvcGHqwdCysfKAIg",166,0.994012,30,167,1,166,1,1,0,1,1,83,82,84,84,75
"7061",60,"[30]uJHggqjIHcdKpcJvcGHqwdCysfKAIg",163,0.993902,30,164,1,163,1,1,0,1,1,75,74,89,89,75
"7062",61,"[30]uJHggqjIHcdKpcJvcGHqwdCysfKAIg",164,0.993939,30,165,1,164,1,1,0,1,1,74,73,91,91,75
"7063",62,"[30]uJHggqjIHcdKpcJvcGHqwdCysfKAIg",166,0.994012,30,167,1,166,1,1,0,1,1,80,79,87,87,75
"7064",63,"[30]uJHggqjIHcdKpcJvcGHqwdCysfKAIg",168,0.994083,30,169,1,168,1,1,0,1,1,88,87,81,81,75
"7065",64,"[30]uJHggqjIHcdKpcJvcGHqwdCysfKAIg",166,0.994012,30,167,1,166,1,1,0,1,1,82,81,85,85,75
"7066",65,"[30]uJHggqjIHcdKpcJvcGHqwdCysfKAIg",168,0.994083,30,169,1,168,1,1,0,1,1,88,87,81,81,75
"7067",66,"[30]uJHggqjIHcdKpcJvcGHqwdCysfKAIg",173,0.994253,30,174,1,173,1,1,0,1,1,97,96,77,77,75
"7068",67,"[30]uJHggqjIHcdKpcJvcGHqwdCysfKAIg",168,0.994083,30,169,1,168,1,1,0,1,1,87,86,82,82,75
"7069",68,"[30]uJHggqjIHcdKpcJvcGHqwdCysfKAIg",167,0.994048,30,168,1,167,1,1,0,1,1,86,85,82,82,75
"7070",69,"[30]uJHggqjIHcdKpcJvcGHqwdCysfKAIg",166,0.994012,30,167,1,166,1,1,0,1,1,82,81,85,85,75
"7071",70,"[30]uJHggqjIHcdKpcJvcGHqwdCysfKAIg",167,0.994048,30,168,1,167,1,1,0,1,1,86,85,82,82,75
"7072",71,"[30]uJHggqjIHcdKpcJvcGHqwdCysfKAIg",169,0.994118,30,170,1,169,1,1,0,1,1,90,89,80,80,75
"7073",72,"[30]uJHggqjIHcdKpcJvcGHqwdCysfKAIg",163,0.993902,30,164,1,163,1,1,0,1,1,74,73,90,90,75
"7074",73,"[30]uJHggqjIHcdKpcJvcGHqwdCysfKAIg",168,0.994083,30,169,1,168,1,1,0,1,1,88,87,81,81,75
"7075",74,"[30]uJHggqjIHcdKpcJvcGHqwdCysfKAIg",164,0.993939,30,165,1,164,1,1,0,1,1,77,76,88,88,75
"7076",75,"[30]uJHggqjIHcdKpcJvcGHqwdCysfKAIg",170,0.994152,30,171,1,170,1,1,0,1,1,90,89,81,81,75
"7077",76,"[30]uJHggqjIHcdKpcJvcGHqwdCysfKAIg",165,0.993976,30,166,1,165,1,1,0,1,1,80,79,86,86,75
"7078",77,"[30]uJHggqjIHcdKpcJvcGHqwdCysfKAIg",166,0.994012,30,167,1,166,1,1,0,1,1,83,82,84,84,75
"7079",78,"[30]uJHggqjIHcdKpcJvcGHqwdCysfKAIg",167,0.994048,30,168,1,167,1,1,0,1,1,85,84,83,83,75
"7080",79,"[30]uJHggqjIHcdKpcJvcGHqwdCysfKAIg",167,0.994048,30,168,1,167,1,1,0,1,1,84,83,84,84,75
"7081",80,"[30]uJHggqjIHcdKpcJvcGHqwdCysfKAIg",170,0.994152,30,171,1,170,1,1,0,1,1,94,93,77,77,75
"7082",81,"[30]uJHggqjIHcdKpcJvcGHqwdCysfKAIg",168,0.994083,30,169,1,168,1,1,0,1,1,88,87,81,81,75
"7083",82,"[30]uJHggqjIHcdKpcJvcGHqwdCysfKAIg",167,0.994048,30,168,1,167,1,1,0,1,1,85,84,83,83,75
"7084",83,"[30]uJHggqjIHcdKpcJvcGHqwdCysfKAIg",162,0.993865,30,163,1,162,1,1,0,1,1,72,71,91,91,75
"7085",84,"[30]uJHggqjIHcdKpcJvcGHqwdCysfKAIg",170,0.994152,30,171,1,170,1,1,0,1,1,91,90,80,80,75
"7086",85,"[30]uJHggqjIHcdKpcJvcGHqwdCysfKAIg",167,0.994048,30,168,1,167,1,1,0,1,1,84,83,84,84,75
"7087",86,"[30]uJHggqjIHcdKpcJvcGHqwdCysfKAIg",162,0.993865,30,163,1,162,1,1,0,1,1,72,71,91,91,75
"7088",87,"[30]uJHggqjIHcdKpcJvcGHqwdCysfKAIg",168,0.994083,30,169,1,168,1,1,0,1,1,86,85,83,83,75
"7089",88,"[30]uJHggqjIHcdKpcJvcGHqwdCysfKAIg",161,0.993827,30,162,1,161,1,1,0,1,1,69,68,93,93,75
"7090",89,"[30]uJHggqjIHcdKpcJvcGHqwdCysfKAIg",167,0.994048,30,168,1,167,1,1,0,1,1,84,83,84,84,75
"7091",90,"[30]uJHggqjIHcdKpcJvcGHqwdCysfKAIg",173,0.994253,30,174,1,173,1,1,0,1,1,100,99,74,74,75
"7092",91,"[30]uJHggqjIHcdKpcJvcGHqwdCysfKAIg",163,0.993902,30,164,1,163,1,1,0,1,1,75,74,89,89,75
"7093",92,"[30]uJHggqjIHcdKpcJvcGHqwdCysfKAIg",164,0.993939,30,165,1,164,1,1,0,1,1,78,77,87,87,75
"7094",93,"[30]uJHggqjIHcdKpcJvcGHqwdCysfKAIg",170,0.994152,30,171,1,170,1,1,0,1,1,93,92,78,78,75
"7095",94,"[30]uJHggqjIHcdKpcJvcGHqwdCysfKAIg",168,0.994083,30,169,1,168,1,1,0,1,1,87,86,82,82,75
"7096",95,"[30]uJHggqjIHcdKpcJvcGHqwdCysfKAIg",169,0.994118,30,170,1,169,1,1,0,1,1,89,88,81,81,75
"7097",96,"[30]uJHggqjIHcdKpcJvcGHqwdCysfKAIg",169,0.994118,30,170,1,169,1,1,0,1,1,91,90,79,79,75
"7098",97,"[30]uJHggqjIHcdKpcJvcGHqwdCysfKAIg",166,0.994012,30,167,1,166,1,1,0,1,1,81,80,86,86,75
"7099",98,"[30]uJHggqjIHcdKpcJvcGHqwdCysfKAIg",165,0.993976,30,166,1,165,1,1,0,1,1,80,79,86,86,75
"7100",99,"[30]uJHggqjIHcdKpcJvcGHqwdCysfKAIg",172,0.99422,30,173,1,172,1,1,0,1,1,99,98,74,74,75
"7101",0,"[43]zJHglqIEHcdKpcJvcGHqvdCinqgHdJjolAfufwvDydr",168,0.994083,43,169,1,168,1,1,0,1,1,87,86,82,82,76
"7102",1,"[43]zJHglqIEHcdKpcJvcGHqvdCinqgHdJjolAfufwvDydr",166,0.994012,43,167,1,166,1,1,0,1,1,83,82,84,84,76
"7103",2,"[43]zJHglqIEHcdKpcJvcGHqvdCinqgHdJjolAfufwvDydr",166,0.994012,43,167,1,166,1,1,0,1,1,83,82,84,84,76
"7104",3,"[43]zJHglqIEHcdKpcJvcGHqvdCinqgHdJjolAfufwvDydr",167,0.994048,43,168,1,167,1,1,0,1,1,84,83,84,84,76
"7105",4,"[43]zJHglqIEHcdKpcJvcGHqvdCinqgHdJjolAfufwvDydr",168,0.994083,43,169,1,168,1,1,0,1,1,87,86,82,82,76
"7106",5,"[43]zJHglqIEHcdKpcJvcGHqvdCinqgHdJjolAfufwvDydr",164,0.993939,43,165,1,164,1,1,0,1,1,78,77,87,87,76
"7107",6,"[43]zJHglqIEHcdKpcJvcGHqvdCinqgHdJjolAfufwvDydr",169,0.994118,43,170,1,169,1,1,0,1,1,91,90,79,79,76
"7108",7,"[43]zJHglqIEHcdKpcJvcGHqvdCinqgHdJjolAfufwvDydr",167,0.994048,43,168,1,167,1,1,0,1,1,86,85,82,82,76
"7109",8,"[43]zJHglqIEHcdKpcJvcGHqvdCinqgHdJjolAfufwvDydr",171,0.994186,43,172,1,171,1,1,0,1,1,96,95,76,76,76
"7110",9,"[43]zJHglqIEHcdKpcJvcGHqvdCinqgHdJjolAfufwvDydr",170,0.994152,43,171,1,170,1,1,0,1,1,93,92,78,78,76
"7111",10,"[43]zJHglqIEHcdKpcJvcGHqvdCinqgHdJjolAfufwvDydr",160,0.993789,43,161,1,160,1,1,0,1,1,67,66,94,94,76
"7112",11,"[43]zJHglqIEHcdKpcJvcGHqvdCinqgHdJjolAfufwvDydr",162,0.993865,43,163,1,162,1,1,0,1,1,71,70,92,92,76
"7113",12,"[43]zJHglqIEHcdKpcJvcGHqvdCinqgHdJjolAfufwvDydr",167,0.994048,43,168,1,167,1,1,0,1,1,84,83,84,84,76
"7114",13,"[43]zJHglqIEHcdKpcJvcGHqvdCinqgHdJjolAfufwvDydr",168,0.994083,43,169,1,168,1,1,0,1,1,88,87,81,81,76
"7115",14,"[43]zJHglqIEHcdKpcJvcGHqvdCinqgHdJjolAfufwvDydr",167,0.994048,43,168,1,167,1,1,0,1,1,86,85,82,82,76
"7116",15,"[43]zJHglqIEHcdKpcJvcGHqvdCinqgHdJjolAfufwvDydr",170,0.994152,43,171,1,170,1,1,0,1,1,91,90,80,80,76
"7117",16,"[43]zJHglqIEHcdKpcJvcGHqvdCinqgHdJjolAfufwvDydr",166,0.994012,43,167,1,166,1,1,0,1,1,82,81,85,85,76
"7118",17,"[43]zJHglqIEHcdKpcJvcGHqvdCinqgHdJjolAfufwvDydr",166,0.994012,43,167,1,166,1,1,0,1,1,81,80,86,86,76
"7119",18,"[43]zJHglqIEHcdKpcJvcGHqvdCinqgHdJjolAfufwvDydr",172,0.99422,43,173,1,172,1,1,0,1,1,96,95,77,77,76
"7120",19,"[43]zJHglqIEHcdKpcJvcGHqvdCinqgHdJjolAfufwvDydr",164,0.993939,43,165,1,164,1,1,0,1,1,77,76,88,88,76
"7121",20,"[43]zJHglqIEHcdKpcJvcGHqvdCinqgHdJjolAfufwvDydr",168,0.994083,43,169,1,168,1,1,0,1,1,86,85,83,83,76
"7122",21,"[43]zJHglqIEHcdKpcJvcGHqvdCinqgHdJjolAfufwvDydr",163,0.993902,43,164,1,163,1,1,0,1,1,74,73,90,90,76
"7123",22,"[43]zJHglqIEHcdKpcJvcGHqvdCinqgHdJjolAfufwvDydr",167,0.994048,43,168,1,167,1,1,0,1,1,84,83,84,84,76
"7124",23,"[43]zJHglqIEHcdKpcJvcGHqvdCinqgHdJjolAfufwvDydr",170,0.994152,43,171,1,170,1,1,0,1,1,89,88,82,82,76
"7125",24,"[43]zJHglqIEHcdKpcJvcGHqvdCinqgHdJjolAfufwvDydr",171,0.994186,43,172,1,171,1,1,0,1,1,96,95,76,76,76
"7126",25,"[43]zJHglqIEHcdKpcJvcGHqvdCinqgHdJjolAfufwvDydr",164,0.993939,43,165,1,164,1,1,0,1,1,75,74,90,90,76
"7127",26,"[43]zJHglqIEHcdKpcJvcGHqvdCinqgHdJjolAfufwvDydr",171,0.994186,43,172,1,171,1,1,0,1,1,95,94,77,77,76
"7128",27,"[43]zJHglqIEHcdKpcJvcGHqvdCinqgHdJjolAfufwvDydr",170,0.994152,43,171,1,170,1,1,0,1,1,92,91,79,79,76
"7129",28,"[43]zJHglqIEHcdKpcJvcGHqvdCinqgHdJjolAfufwvDydr",162,0.993865,43,163,1,162,1,1,0,1,1,71,70,92,92,76
"7130",29,"[43]zJHglqIEHcdKpcJvcGHqvdCinqgHdJjolAfufwvDydr",164,0.993939,43,165,1,164,1,1,0,1,1,78,77,87,87,76
"7131",30,"[43]zJHglqIEHcdKpcJvcGHqvdCinqgHdJjolAfufwvDydr",166,0.994012,43,167,1,166,1,1,0,1,1,83,82,84,84,76
"7132",31,"[43]zJHglqIEHcdKpcJvcGHqvdCinqgHdJjolAfufwvDydr",170,0.994152,43,171,1,170,1,1,0,1,1,94,93,77,77,76
"7133",32,"[43]zJHglqIEHcdKpcJvcGHqvdCinqgHdJjolAfufwvDydr",166,0.994012,43,167,1,166,1,1,0,1,1,82,81,85,85,76
"7134",33,"[43]zJHglqIEHcdKpcJvcGHqvdCinqgHdJjolAfufwvDydr",167,0.994048,43,168,1,167,1,1,0,1,1,83,82,85,85,76
"7135",34,"[43]zJHglqIEHcdKpcJvcGHqvdCinqgHdJjolAfufwvDydr",169,0.994118,43,170,1,169,1,1,0,1,1,91,90,79,79,76
"7136",35,"[43]zJHglqIEHcdKpcJvcGHqvdCinqgHdJjolAfufwvDydr",168,0.994083,43,169,1,168,1,1,0,1,1,88,87,81,81,76
"7137",36,"[43]zJHglqIEHcdKpcJvcGHqvdCinqgHdJjolAfufwvDydr",162,0.993865,43,163,1,162,1,1,0,1,1,72,71,91,91,76
"7138",37,"[43]zJHglqIEHcdKpcJvcGHqvdCinqgHdJjolAfufwvDydr",166,0.994012,43,167,1,166,1,1,0,1,1,82,81,85,85,76
"7139",38,"[43]zJHglqIEHcdKpcJvcGHqvdCinqgHdJjolAfufwvDydr",168,0.994083,43,169,1,168,1,1,0,1,1,87,86,82,82,76
"7140",39,"[43]zJHglqIEHcdKpcJvcGHqvdCinqgHdJjolAfufwvDydr",167,0.994048,43,168,1,167,1,1,0,1,1,86,85,82,82,76
"7141",40,"[43]zJHglqIEHcdKpcJvcGHqvdCinqgHdJjolAfufwvDydr",165,0.993976,43,166,1,165,1,1,0,1,1,78,77,88,88,76
"7142",41,"[43]zJHglqIEHcdKpcJvcGHqvdCinqgHdJjolAfufwvDydr",167,0.994048,43,168,1,167,1,1,0,1,1,85,84,83,83,76
"7143",42,"[43]zJHglqIEHcdKpcJvcGHqvdCinqgHdJjolAfufwvDydr",166,0.994012,43,167,1,166,1,1,0,1,1,81,80,86,86,76
"7144",43,"[43]zJHglqIEHcdKpcJvcGHqvdCinqgHdJjolAfufwvDydr",164,0.993939,43,165,1,164,1,1,0,1,1,77,76,88,88,76
"7145",44,"[43]zJHglqIEHcdKpcJvcGHqvdCinqgHdJjolAfufwvDydr",164,0.993939,43,165,1,164,1,1,0,1,1,76,75,89,89,76
"7146",45,"[43]zJHglqIEHcdKpcJvcGHqvdCinqgHdJjolAfufwvDydr",163,0.993902,43,164,1,163,1,1,0,1,1,73,72,91,91,76
"7147",46,"[43]zJHglqIEHcdKpcJvcGHqvdCinqgHdJjolAfufwvDydr",167,0.994048,43,168,1,167,1,1,0,1,1,86,85,82,82,76
"7148",47,"[43]zJHglqIEHcdKpcJvcGHqvdCinqgHdJjolAfufwvDydr",167,0.994048,43,168,1,167,1,1,0,1,1,84,83,84,84,76
"7149",48,"[43]zJHglqIEHcdKpcJvcGHqvdCinqgHdJjolAfufwvDydr",166,0.994012,43,167,1,166,1,1,0,1,1,82,81,85,85,76
"7150",49,"[43]zJHglqIEHcdKpcJvcGHqvdCinqgHdJjolAfufwvDydr",168,0.994083,43,169,1,168,1,1,0,1,1,86,85,83,83,76
"7151",50,"[43]zJHglqIEHcdKpcJvcGHqvdCinqgHdJjolAfufwvDydr",170,0.994152,43,171,1,170,1,1,0,1,1,91,90,80,80,76
"7152",51,"[43]zJHglqIEHcdKpcJvcGHqvdCinqgHdJjolAfufwvDydr",165,0.993976,43,166,1,165,1,1,0,1,1,80,79,86,86,76
"7153",52,"[43]zJHglqIEHcdKpcJvcGHqvdCinqgHdJjolAfufwvDydr",175,0.994318,43,176,1,175,1,1,0,1,1,106,105,70,70,76
"7154",53,"[43]zJHglqIEHcdKpcJvcGHqvdCinqgHdJjolAfufwvDydr",167,0.994048,43,168,1,167,1,1,0,1,1,84,83,84,84,76
"7155",54,"[43]zJHglqIEHcdKpcJvcGHqvdCinqgHdJjolAfufwvDydr",167,0.994048,43,168,1,167,1,1,0,1,1,85,84,83,83,76
"7156",55,"[43]zJHglqIEHcdKpcJvcGHqvdCinqgHdJjolAfufwvDydr",167,0.994048,43,168,1,167,1,1,0,1,1,86,85,82,82,76
"7157",56,"[43]zJHglqIEHcdKpcJvcGHqvdCinqgHdJjolAfufwvDydr",171,0.994186,43,172,1,171,1,1,0,1,1,95,94,77,77,76
"7158",57,"[43]zJHglqIEHcdKpcJvcGHqvdCinqgHdJjolAfufwvDydr",168,0.994083,43,169,1,168,1,1,0,1,1,88,87,81,81,76
"7159",58,"[43]zJHglqIEHcdKpcJvcGHqvdCinqgHdJjolAfufwvDydr",170,0.994152,43,171,1,170,1,1,0,1,1,92,91,79,79,76
"7160",59,"[43]zJHglqIEHcdKpcJvcGHqvdCinqgHdJjolAfufwvDydr",164,0.993939,43,165,1,164,1,1,0,1,1,76,75,89,89,76
"7161",60,"[43]zJHglqIEHcdKpcJvcGHqvdCinqgHdJjolAfufwvDydr",164,0.993939,43,165,1,164,1,1,0,1,1,77,76,88,88,76
"7162",61,"[43]zJHglqIEHcdKpcJvcGHqvdCinqgHdJjolAfufwvDydr",166,0.994012,43,167,1,166,1,1,0,1,1,81,80,86,86,76
"7163",62,"[43]zJHglqIEHcdKpcJvcGHqvdCinqgHdJjolAfufwvDydr",165,0.993976,43,166,1,165,1,1,0,1,1,79,78,87,87,76
"7164",63,"[43]zJHglqIEHcdKpcJvcGHqvdCinqgHdJjolAfufwvDydr",168,0.994083,43,169,1,168,1,1,0,1,1,87,86,82,82,76
"7165",64,"[43]zJHglqIEHcdKpcJvcGHqvdCinqgHdJjolAfufwvDydr",164,0.993939,43,165,1,164,1,1,0,1,1,77,76,88,88,76
"7166",65,"[43]zJHglqIEHcdKpcJvcGHqvdCinqgHdJjolAfufwvDydr",166,0.994012,43,167,1,166,1,1,0,1,1,82,81,85,85,76
"7167",66,"[43]zJHglqIEHcdKpcJvcGHqvdCinqgHdJjolAfufwvDydr",159,0.99375,43,160,1,159,1,1,0,1,1,64,63,96,96,76
"7168",67,"[43]zJHglqIEHcdKpcJvcGHqvdCinqgHdJjolAfufwvDydr",171,0.994186,43,172,1,171,1,1,0,1,1,96,95,76,76,76
"7169",68,"[43]zJHglqIEHcdKpcJvcGHqvdCinqgHdJjolAfufwvDydr",160,0.993789,43,161,1,160,1,1,0,1,1,67,66,94,94,76
"7170",69,"[43]zJHglqIEHcdKpcJvcGHqvdCinqgHdJjolAfufwvDydr",164,0.993939,43,165,1,164,1,1,0,1,1,77,76,88,88,76
"7171",70,"[43]zJHglqIEHcdKpcJvcGHqvdCinqgHdJjolAfufwvDydr",171,0.994186,43,172,1,171,1,1,0,1,1,94,93,78,78,76
"7172",71,"[43]zJHglqIEHcdKpcJvcGHqvdCinqgHdJjolAfufwvDydr",166,0.994012,43,167,1,166,1,1,0,1,1,82,81,85,85,76
"7173",72,"[43]zJHglqIEHcdKpcJvcGHqvdCinqgHdJjolAfufwvDydr",163,0.993902,43,164,1,163,1,1,0,1,1,73,72,91,91,76
"7174",73,"[43]zJHglqIEHcdKpcJvcGHqvdCinqgHdJjolAfufwvDydr",166,0.994012,43,167,1,166,1,1,0,1,1,81,80,86,86,76
"7175",74,"[43]zJHglqIEHcdKpcJvcGHqvdCinqgHdJjolAfufwvDydr",171,0.994186,43,172,1,171,1,1,0,1,1,96,95,76,76,76
"7176",75,"[43]zJHglqIEHcdKpcJvcGHqvdCinqgHdJjolAfufwvDydr",167,0.994048,43,168,1,167,1,1,0,1,1,85,84,83,83,76
"7177",76,"[43]zJHglqIEHcdKpcJvcGHqvdCinqgHdJjolAfufwvDydr",167,0.994048,43,168,1,167,1,1,0,1,1,85,84,83,83,76
"7178",77,"[43]zJHglqIEHcdKpcJvcGHqvdCinqgHdJjolAfufwvDydr",170,0.994152,43,171,1,170,1,1,0,1,1,94,93,77,77,76
"7179",78,"[43]zJHglqIEHcdKpcJvcGHqvdCinqgHdJjolAfufwvDydr",168,0.994083,43,169,1,168,1,1,0,1,1,88,87,81,81,76
"7180",79,"[43]zJHglqIEHcdKpcJvcGHqvdCinqgHdJjolAfufwvDydr",167,0.994048,43,168,1,167,1,1,0,1,1,85,84,83,83,76
"7181",80,"[43]zJHglqIEHcdKpcJvcGHqvdCinqgHdJjolAfufwvDydr",170,0.994152,43,171,1,170,1,1,0,1,1,94,93,77,77,76
"7182",81,"[43]zJHglqIEHcdKpcJvcGHqvdCinqgHdJjolAfufwvDydr",168,0.994083,43,169,1,168,1,1,0,1,1,86,85,83,83,76
"7183",82,"[43]zJHglqIEHcdKpcJvcGHqvdCinqgHdJjolAfufwvDydr",174,0.994286,43,175,1,174,1,1,0,1,1,104,103,71,71,76
"7184",83,"[43]zJHglqIEHcdKpcJvcGHqvdCinqgHdJjolAfufwvDydr",165,0.993976,43,166,1,165,1,1,0,1,1,79,78,87,87,76
"7185",84,"[43]zJHglqIEHcdKpcJvcGHqvdCinqgHdJjolAfufwvDydr",164,0.993939,43,165,1,164,1,1,0,1,1,77,76,88,88,76
"7186",85,"[43]zJHglqIEHcdKpcJvcGHqvdCinqgHdJjolAfufwvDydr",165,0.993976,43,166,1,165,1,1,0,1,1,77,76,89,89,76
"7187",86,"[43]zJHglqIEHcdKpcJvcGHqvdCinqgHdJjolAfufwvDydr",170,0.994152,43,171,1,170,1,1,0,1,1,94,93,77,77,76
"7188",87,"[43]zJHglqIEHcdKpcJvcGHqvdCinqgHdJjolAfufwvDydr",168,0.994083,43,169,1,168,1,1,0,1,1,88,87,81,81,76
"7189",88,"[43]zJHglqIEHcdKpcJvcGHqvdCinqgHdJjolAfufwvDydr",171,0.994186,43,172,1,171,1,1,0,1,1,96,95,76,76,76
"7190",89,"[43]zJHglqIEHcdKpcJvcGHqvdCinqgHdJjolAfufwvDydr",172,0.99422,43,173,1,172,1,1,0,1,1,100,99,73,73,76
"7191",90,"[43]zJHglqIEHcdKpcJvcGHqvdCinqgHdJjolAfufwvDydr",172,0.99422,43,173,1,172,1,1,0,1,1,97,96,76,76,76
"7192",91,"[43]zJHglqIEHcdKpcJvcGHqvdCinqgHdJjolAfufwvDydr",165,0.993976,43,166,1,165,1,1,0,1,1,80,79,86,86,76
"7193",92,"[43]zJHglqIEHcdKpcJvcGHqvdCinqgHdJjolAfufwvDydr",170,0.994152,43,171,1,170,1,1,0,1,1,93,92,78,78,76
"7194",93,"[43]zJHglqIEHcdKpcJvcGHqvdCinqgHdJjolAfufwvDydr",168,0.994083,43,169,1,168,1,1,0,1,1,87,86,82,82,76
"7195",94,"[43]zJHglqIEHcdKpcJvcGHqvdCinqgHdJjolAfufwvDydr",168,0.994083,43,169,1,168,1,1,0,1,1,89,88,80,80,76
"7196",95,"[43]zJHglqIEHcdKpcJvcGHqvdCinqgHdJjolAfufwvDydr",166,0.994012,43,167,1,166,1,1,0,1,1,83,82,84,84,76
"7197",96,"[43]zJHglqIEHcdKpcJvcGHqvdCinqgHdJjolAfufwvDydr",166,0.994012,43,167,1,166,1,1,0,1,1,83,82,84,84,76
"7198",97,"[43]zJHglqIEHcdKpcJvcGHqvdCinqgHdJjolAfufwvDydr",170,0.994152,43,171,1,170,1,1,0,1,1,93,92,78,78,76
"7199",98,"[43]zJHglqIEHcdKpcJvcGHqvdCinqgHdJjolAfufwvDydr",168,0.994083,43,169,1,168,1,1,0,1,1,87,86,82,82,76
"7200",99,"[43]zJHglqIEHcdKpcJvcGHqvdCinqgHdJjolAfufwvDydr",170,0.994152,43,171,1,170,1,1,0,1,1,92,91,79,79,76
"7201",0,"[28]tJHggqIHcgdKocJvcGHqvdCgxrvI",168,0.994083,28,169,1,168,1,1,0,1,1,88,87,81,81,77
"7202",1,"[28]tJHggqIHcgdKocJvcGHqvdCgxrvI",171,0.994186,28,172,1,171,1,1,0,1,1,95,94,77,77,77
"7203",2,"[28]tJHggqIHcgdKocJvcGHqvdCgxrvI",170,0.994152,28,171,1,170,1,1,0,1,1,92,91,79,79,77
"7204",3,"[28]tJHggqIHcgdKocJvcGHqvdCgxrvI",168,0.994083,28,169,1,168,1,1,0,1,1,89,88,80,80,77
"7205",4,"[28]tJHggqIHcgdKocJvcGHqvdCgxrvI",169,0.994118,28,170,1,169,1,1,0,1,1,90,89,80,80,77
"7206",5,"[28]tJHggqIHcgdKocJvcGHqvdCgxrvI",166,0.994012,28,167,1,166,1,1,0,1,1,83,82,84,84,77
"7207",6,"[28]tJHggqIHcgdKocJvcGHqvdCgxrvI",168,0.994083,28,169,1,168,1,1,0,1,1,89,88,80,80,77
"7208",7,"[28]tJHggqIHcgdKocJvcGHqvdCgxrvI",163,0.993902,28,164,1,163,1,1,0,1,1,75,74,89,89,77
"7209",8,"[28]tJHggqIHcgdKocJvcGHqvdCgxrvI",170,0.994152,28,171,1,170,1,1,0,1,1,93,92,78,78,77
"7210",9,"[28]tJHggqIHcgdKocJvcGHqvdCgxrvI",166,0.994012,28,167,1,166,1,1,0,1,1,82,81,85,85,77
"7211",10,"[28]tJHggqIHcgdKocJvcGHqvdCgxrvI",174,0.994286,28,175,1,174,1,1,0,1,1,102,101,73,73,77
"7212",11,"[28]tJHggqIHcgdKocJvcGHqvdCgxrvI",168,0.994083,28,169,1,168,1,1,0,1,1,86,85,83,83,77
"7213",12,"[28]tJHggqIHcgdKocJvcGHqvdCgxrvI",170,0.994152,28,171,1,170,1,1,0,1,1,94,93,77,77,77
"7214",13,"[28]tJHggqIHcgdKocJvcGHqvdCgxrvI",167,0.994048,28,168,1,167,1,1,0,1,1,83,82,85,85,77
"7215",14,"[28]tJHggqIHcgdKocJvcGHqvdCgxrvI",166,0.994012,28,167,1,166,1,1,0,1,1,83,82,84,84,77
"7216",15,"[28]tJHggqIHcgdKocJvcGHqvdCgxrvI",165,0.993976,28,166,1,165,1,1,0,1,1,80,79,86,86,77
"7217",16,"[28]tJHggqIHcgdKocJvcGHqvdCgxrvI",162,0.993865,28,163,1,162,1,1,0,1,1,72,71,91,91,77
"7218",17,"[28]tJHggqIHcgdKocJvcGHqvdCgxrvI",163,0.993902,28,164,1,163,1,1,0,1,1,73,72,91,91,77
"7219",18,"[28]tJHggqIHcgdKocJvcGHqvdCgxrvI",168,0.994083,28,169,1,168,1,1,0,1,1,87,86,82,82,77
"7220",19,"[28]tJHggqIHcgdKocJvcGHqvdCgxrvI",163,0.993902,28,164,1,163,1,1,0,1,1,75,74,89,89,77
"7221",20,"[28]tJHggqIHcgdKocJvcGHqvdCgxrvI",161,0.993827,28,162,1,161,1,1,0,1,1,69,68,93,93,77
"7222",21,"[28]tJHggqIHcgdKocJvcGHqvdCgxrvI",169,0.994118,28,170,1,169,1,1,0,1,1,88,87,82,82,77
"7223",22,"[28]tJHggqIHcgdKocJvcGHqvdCgxrvI",166,0.994012,28,167,1,166,1,1,0,1,1,82,81,85,85,77
"7224",23,"[28]tJHggqIHcgdKocJvcGHqvdCgxrvI",162,0.993865,28,163,1,162,1,1,0,1,1,71,70,92,92,77
"7225",24,"[28]tJHggqIHcgdKocJvcGHqvdCgxrvI",167,0.994048,28,168,1,167,1,1,0,1,1,86,85,82,82,77
"7226",25,"[28]tJHggqIHcgdKocJvcGHqvdCgxrvI",171,0.994186,28,172,1,171,1,1,0,1,1,96,95,76,76,77
"7227",26,"[28]tJHggqIHcgdKocJvcGHqvdCgxrvI",168,0.994083,28,169,1,168,1,1,0,1,1,87,86,82,82,77
"7228",27,"[28]tJHggqIHcgdKocJvcGHqvdCgxrvI",162,0.993865,28,163,1,162,1,1,0,1,1,69,68,94,94,77
"7229",28,"[28]tJHggqIHcgdKocJvcGHqvdCgxrvI",166,0.994012,28,167,1,166,1,1,0,1,1,83,82,84,84,77
"7230",29,"[28]tJHggqIHcgdKocJvcGHqvdCgxrvI",167,0.994048,28,168,1,167,1,1,0,1,1,86,85,82,82,77
"7231",30,"[28]tJHggqIHcgdKocJvcGHqvdCgxrvI",166,0.994012,28,167,1,166,1,1,0,1,1,81,80,86,86,77
"7232",31,"[28]tJHggqIHcgdKocJvcGHqvdCgxrvI",165,0.993976,28,166,1,165,1,1,0,1,1,80,79,86,86,77
"7233",32,"[28]tJHggqIHcgdKocJvcGHqvdCgxrvI",168,0.994083,28,169,1,168,1,1,0,1,1,87,86,82,82,77
"7234",33,"[28]tJHggqIHcgdKocJvcGHqvdCgxrvI",163,0.993902,28,164,1,163,1,1,0,1,1,75,74,89,89,77
"7235",34,"[28]tJHggqIHcgdKocJvcGHqvdCgxrvI",161,0.993827,28,162,1,161,1,1,0,1,1,68,67,94,94,77
"7236",35,"[28]tJHggqIHcgdKocJvcGHqvdCgxrvI",168,0.994083,28,169,1,168,1,1,0,1,1,88,87,81,81,77
"7237",36,"[28]tJHggqIHcgdKocJvcGHqvdCgxrvI",170,0.994152,28,171,1,170,1,1,0,1,1,93,92,78,78,77
"7238",37,"[28]tJHggqIHcgdKocJvcGHqvdCgxrvI",174,0.994286,28,175,1,174,1,1,0,1,1,103,102,72,72,77
"7239",38,"[28]tJHggqIHcgdKocJvcGHqvdCgxrvI",168,0.994083,28,169,1,168,1,1,0,1,1,88,87,81,81,77
"7240",39,"[28]tJHggqIHcgdKocJvcGHqvdCgxrvI",166,0.994012,28,167,1,166,1,1,0,1,1,82,81,85,85,77
"7241",40,"[28]tJHggqIHcgdKocJvcGHqvdCgxrvI",168,0.994083,28,169,1,168,1,1,0,1,1,88,87,81,81,77
"7242",41,"[28]tJHggqIHcgdKocJvcGHqvdCgxrvI",168,0.994083,28,169,1,168,1,1,0,1,1,89,88,80,80,77
"7243",42,"[28]tJHggqIHcgdKocJvcGHqvdCgxrvI",170,0.994152,28,171,1,170,1,1,0,1,1,93,92,78,78,77
"7244",43,"[28]tJHggqIHcgdKocJvcGHqvdCgxrvI",163,0.993902,28,164,1,163,1,1,0,1,1,75,74,89,89,77
"7245",44,"[28]tJHggqIHcgdKocJvcGHqvdCgxrvI",169,0.994118,28,170,1,169,1,1,0,1,1,91,90,79,79,77
"7246",45,"[28]tJHggqIHcgdKocJvcGHqvdCgxrvI",172,0.99422,28,173,1,172,1,1,0,1,1,99,98,74,74,77
"7247",46,"[28]tJHggqIHcgdKocJvcGHqvdCgxrvI",167,0.994048,28,168,1,167,1,1,0,1,1,84,83,84,84,77
"7248",47,"[28]tJHggqIHcgdKocJvcGHqvdCgxrvI",164,0.993939,28,165,1,164,1,1,0,1,1,78,77,87,87,77
"7249",48,"[28]tJHggqIHcgdKocJvcGHqvdCgxrvI",159,0.99375,28,160,1,159,1,1,0,1,1,62,61,98,98,77
"7250",49,"[28]tJHggqIHcgdKocJvcGHqvdCgxrvI",166,0.994012,28,167,1,166,1,1,0,1,1,82,81,85,85,77
"7251",50,"[28]tJHggqIHcgdKocJvcGHqvdCgxrvI",166,0.994012,28,167,1,166,1,1,0,1,1,81,80,86,86,77
"7252",51,"[28]tJHggqIHcgdKocJvcGHqvdCgxrvI",165,0.993976,28,166,1,165,1,1,0,1,1,79,78,87,87,77
"7253",52,"[28]tJHggqIHcgdKocJvcGHqvdCgxrvI",171,0.994186,28,172,1,171,1,1,0,1,1,95,94,77,77,77
"7254",53,"[28]tJHggqIHcgdKocJvcGHqvdCgxrvI",170,0.994152,28,171,1,170,1,1,0,1,1,94,93,77,77,77
"7255",54,"[28]tJHggqIHcgdKocJvcGHqvdCgxrvI",171,0.994186,28,172,1,171,1,1,0,1,1,94,93,78,78,77
"7256",55,"[28]tJHggqIHcgdKocJvcGHqvdCgxrvI",166,0.994012,28,167,1,166,1,1,0,1,1,82,81,85,85,77
"7257",56,"[28]tJHggqIHcgdKocJvcGHqvdCgxrvI",172,0.99422,28,173,1,172,1,1,0,1,1,99,98,74,74,77
"7258",57,"[28]tJHggqIHcgdKocJvcGHqvdCgxrvI",169,0.994118,28,170,1,169,1,1,0,1,1,90,89,80,80,77
"7259",58,"[28]tJHggqIHcgdKocJvcGHqvdCgxrvI",172,0.99422,28,173,1,172,1,1,0,1,1,96,95,77,77,77
"7260",59,"[28]tJHggqIHcgdKocJvcGHqvdCgxrvI",172,0.99422,28,173,1,172,1,1,0,1,1,99,98,74,74,77
"7261",60,"[28]tJHggqIHcgdKocJvcGHqvdCgxrvI",163,0.993902,28,164,1,163,1,1,0,1,1,74,73,90,90,77
"7262",61,"[28]tJHggqIHcgdKocJvcGHqvdCgxrvI",168,0.994083,28,169,1,168,1,1,0,1,1,89,88,80,80,77
"7263",62,"[28]tJHggqIHcgdKocJvcGHqvdCgxrvI",165,0.993976,28,166,1,165,1,1,0,1,1,79,78,87,87,77
"7264",63,"[28]tJHggqIHcgdKocJvcGHqvdCgxrvI",170,0.994152,28,171,1,170,1,1,0,1,1,92,91,79,79,77
"7265",64,"[28]tJHggqIHcgdKocJvcGHqvdCgxrvI",168,0.994083,28,169,1,168,1,1,0,1,1,88,87,81,81,77
"7266",65,"[28]tJHggqIHcgdKocJvcGHqvdCgxrvI",168,0.994083,28,169,1,168,1,1,0,1,1,87,86,82,82,77
"7267",66,"[28]tJHggqIHcgdKocJvcGHqvdCgxrvI",168,0.994083,28,169,1,168,1,1,0,1,1,87,86,82,82,77
"7268",67,"[28]tJHggqIHcgdKocJvcGHqvdCgxrvI",169,0.994118,28,170,1,169,1,1,0,1,1,90,89,80,80,77
"7269",68,"[28]tJHggqIHcgdKocJvcGHqvdCgxrvI",170,0.994152,28,171,1,170,1,1,0,1,1,92,91,79,79,77
"7270",69,"[28]tJHggqIHcgdKocJvcGHqvdCgxrvI",165,0.993976,28,166,1,165,1,1,0,1,1,80,79,86,86,77
"7271",70,"[28]tJHggqIHcgdKocJvcGHqvdCgxrvI",166,0.994012,28,167,1,166,1,1,0,1,1,80,79,87,87,77
"7272",71,"[28]tJHggqIHcgdKocJvcGHqvdCgxrvI",162,0.993865,28,163,1,162,1,1,0,1,1,70,69,93,93,77
"7273",72,"[28]tJHggqIHcgdKocJvcGHqvdCgxrvI",171,0.994186,28,172,1,171,1,1,0,1,1,97,96,75,75,77
"7274",73,"[28]tJHggqIHcgdKocJvcGHqvdCgxrvI",164,0.993939,28,165,1,164,1,1,0,1,1,77,76,88,88,77
"7275",74,"[28]tJHggqIHcgdKocJvcGHqvdCgxrvI",166,0.994012,28,167,1,166,1,1,0,1,1,82,81,85,85,77
"7276",75,"[28]tJHggqIHcgdKocJvcGHqvdCgxrvI",171,0.994186,28,172,1,171,1,1,0,1,1,97,96,75,75,77
"7277",76,"[28]tJHggqIHcgdKocJvcGHqvdCgxrvI",166,0.994012,28,167,1,166,1,1,0,1,1,83,82,84,84,77
"7278",77,"[28]tJHggqIHcgdKocJvcGHqvdCgxrvI",166,0.994012,28,167,1,166,1,1,0,1,1,82,81,85,85,77
"7279",78,"[28]tJHggqIHcgdKocJvcGHqvdCgxrvI",164,0.993939,28,165,1,164,1,1,0,1,1,76,75,89,89,77
"7280",79,"[28]tJHggqIHcgdKocJvcGHqvdCgxrvI",166,0.994012,28,167,1,166,1,1,0,1,1,83,82,84,84,77
"7281",80,"[28]tJHggqIHcgdKocJvcGHqvdCgxrvI",174,0.994286,28,175,1,174,1,1,0,1,1,104,103,71,71,77
"7282",81,"[28]tJHggqIHcgdKocJvcGHqvdCgxrvI",169,0.994118,28,170,1,169,1,1,0,1,1,89,88,81,81,77
"7283",82,"[28]tJHggqIHcgdKocJvcGHqvdCgxrvI",168,0.994083,28,169,1,168,1,1,0,1,1,88,87,81,81,77
"7284",83,"[28]tJHggqIHcgdKocJvcGHqvdCgxrvI",168,0.994083,28,169,1,168,1,1,0,1,1,87,86,82,82,77
"7285",84,"[28]tJHggqIHcgdKocJvcGHqvdCgxrvI",168,0.994083,28,169,1,168,1,1,0,1,1,86,85,83,83,77
"7286",85,"[28]tJHggqIHcgdKocJvcGHqvdCgxrvI",164,0.993939,28,165,1,164,1,1,0,1,1,75,74,90,90,77
"7287",86,"[28]tJHggqIHcgdKocJvcGHqvdCgxrvI",169,0.994118,28,170,1,169,1,1,0,1,1,90,89,80,80,77
"7288",87,"[28]tJHggqIHcgdKocJvcGHqvdCgxrvI",165,0.993976,28,166,1,165,1,1,0,1,1,79,78,87,87,77
"7289",88,"[28]tJHggqIHcgdKocJvcGHqvdCgxrvI",164,0.993939,28,165,1,164,1,1,0,1,1,76,75,89,89,77
"7290",89,"[28]tJHggqIHcgdKocJvcGHqvdCgxrvI",170,0.994152,28,171,1,170,1,1,0,1,1,94,93,77,77,77
"7291",90,"[28]tJHggqIHcgdKocJvcGHqvdCgxrvI",169,0.994118,28,170,1,169,1,1,0,1,1,89,88,81,81,77
"7292",91,"[28]tJHggqIHcgdKocJvcGHqvdCgxrvI",167,0.994048,28,168,1,167,1,1,0,1,1,84,83,84,84,77
"7293",92,"[28]tJHggqIHcgdKocJvcGHqvdCgxrvI",168,0.994083,28,169,1,168,1,1,0,1,1,88,87,81,81,77
"7294",93,"[28]tJHggqIHcgdKocJvcGHqvdCgxrvI",168,0.994083,28,169,1,168,1,1,0,1,1,88,87,81,81,77
"7295",94,"[28]tJHggqIHcgdKocJvcGHqvdCgxrvI",169,0.994118,28,170,1,169,1,1,0,1,1,90,89,80,80,77
"7296",95,"[28]tJHggqIHcgdKocJvcGHqvdCgxrvI",171,0.994186,28,172,1,171,1,1,0,1,1,96,95,76,76,77
"7297",96,"[28]tJHggqIHcgdKocJvcGHqvdCgxrvI",163,0.993902,28,164,1,163,1,1,0,1,1,74,73,90,90,77
"7298",97,"[28]tJHggqIHcgdKocJvcGHqvdCgxrvI",162,0.993865,28,163,1,162,1,1,0,1,1,72,71,91,91,77
"7299",98,"[28]tJHggqIHcgdKocJvcGHqvdCgxrvI",162,0.993865,28,163,1,162,1,1,0,1,1,71,70,92,92,77
"7300",99,"[28]tJHggqIHcgdKocJvcGHqvdCgxrvI",166,0.994012,28,167,1,166,1,1,0,1,1,83,82,84,84,77
"7301",0,"[29]mJHggqIFHcdKpcJvcGHqvdCjEuxal",168,0.994083,29,169,1,168,1,1,0,1,1,87,86,82,82,78
"7302",1,"[29]mJHggqIFHcdKpcJvcGHqvdCjEuxal",170,0.994152,29,171,1,170,1,1,0,1,1,92,91,79,79,78
"7303",2,"[29]mJHggqIFHcdKpcJvcGHqvdCjEuxal",166,0.994012,29,167,1,166,1,1,0,1,1,82,81,85,85,78
"7304",3,"[29]mJHggqIFHcdKpcJvcGHqvdCjEuxal",174,0.994286,29,175,1,174,1,1,0,1,1,101,100,74,74,78
"7305",4,"[29]mJHggqIFHcdKpcJvcGHqvdCjEuxal",163,0.993902,29,164,1,163,1,1,0,1,1,73,72,91,91,78
"7306",5,"[29]mJHggqIFHcdKpcJvcGHqvdCjEuxal",172,0.99422,29,173,1,172,1,1,0,1,1,97,96,76,76,78
"7307",6,"[29]mJHggqIFHcdKpcJvcGHqvdCjEuxal",168,0.994083,29,169,1,168,1,1,0,1,1,89,88,80,80,78
"7308",7,"[29]mJHggqIFHcdKpcJvcGHqvdCjEuxal",166,0.994012,29,167,1,166,1,1,0,1,1,82,81,85,85,78
"7309",8,"[29]mJHggqIFHcdKpcJvcGHqvdCjEuxal",167,0.994048,29,168,1,167,1,1,0,1,1,86,85,82,82,78
"7310",9,"[29]mJHggqIFHcdKpcJvcGHqvdCjEuxal",171,0.994186,29,172,1,171,1,1,0,1,1,95,94,77,77,78
"7311",10,"[29]mJHggqIFHcdKpcJvcGHqvdCjEuxal",165,0.993976,29,166,1,165,1,1,0,1,1,77,76,89,89,78
"7312",11,"[29]mJHggqIFHcdKpcJvcGHqvdCjEuxal",168,0.994083,29,169,1,168,1,1,0,1,1,88,87,81,81,78
"7313",12,"[29]mJHggqIFHcdKpcJvcGHqvdCjEuxal",163,0.993902,29,164,1,163,1,1,0,1,1,75,74,89,89,78
"7314",13,"[29]mJHggqIFHcdKpcJvcGHqvdCjEuxal",174,0.994286,29,175,1,174,1,1,0,1,1,103,102,72,72,78
"7315",14,"[29]mJHggqIFHcdKpcJvcGHqvdCjEuxal",171,0.994186,29,172,1,171,1,1,0,1,1,96,95,76,76,78
"7316",15,"[29]mJHggqIFHcdKpcJvcGHqvdCjEuxal",166,0.994012,29,167,1,166,1,1,0,1,1,82,81,85,85,78
"7317",16,"[29]mJHggqIFHcdKpcJvcGHqvdCjEuxal",174,0.994286,29,175,1,174,1,1,0,1,1,104,103,71,71,78
"7318",17,"[29]mJHggqIFHcdKpcJvcGHqvdCjEuxal",166,0.994012,29,167,1,166,1,1,0,1,1,83,82,84,84,78
"7319",18,"[29]mJHggqIFHcdKpcJvcGHqvdCjEuxal",166,0.994012,29,167,1,166,1,1,0,1,1,82,81,85,85,78
"7320",19,"[29]mJHggqIFHcdKpcJvcGHqvdCjEuxal",169,0.994118,29,170,1,169,1,1,0,1,1,90,89,80,80,78
"7321",20,"[29]mJHggqIFHcdKpcJvcGHqvdCjEuxal",167,0.994048,29,168,1,167,1,1,0,1,1,86,85,82,82,78
"7322",21,"[29]mJHggqIFHcdKpcJvcGHqvdCjEuxal",164,0.993939,29,165,1,164,1,1,0,1,1,76,75,89,89,78
"7323",22,"[29]mJHggqIFHcdKpcJvcGHqvdCjEuxal",167,0.994048,29,168,1,167,1,1,0,1,1,84,83,84,84,78
"7324",23,"[29]mJHggqIFHcdKpcJvcGHqvdCjEuxal",167,0.994048,29,168,1,167,1,1,0,1,1,83,82,85,85,78
"7325",24,"[29]mJHggqIFHcdKpcJvcGHqvdCjEuxal",170,0.994152,29,171,1,170,1,1,0,1,1,92,91,79,79,78
"7326",25,"[29]mJHggqIFHcdKpcJvcGHqvdCjEuxal",164,0.993939,29,165,1,164,1,1,0,1,1,76,75,89,89,78
"7327",26,"[29]mJHggqIFHcdKpcJvcGHqvdCjEuxal",164,0.993939,29,165,1,164,1,1,0,1,1,74,73,91,91,78
"7328",27,"[29]mJHggqIFHcdKpcJvcGHqvdCjEuxal",163,0.993902,29,164,1,163,1,1,0,1,1,74,73,90,90,78
"7329",28,"[29]mJHggqIFHcdKpcJvcGHqvdCjEuxal",167,0.994048,29,168,1,167,1,1,0,1,1,86,85,82,82,78
"7330",29,"[29]mJHggqIFHcdKpcJvcGHqvdCjEuxal",163,0.993902,29,164,1,163,1,1,0,1,1,73,72,91,91,78
"7331",30,"[29]mJHggqIFHcdKpcJvcGHqvdCjEuxal",170,0.994152,29,171,1,170,1,1,0,1,1,92,91,79,79,78
"7332",31,"[29]mJHggqIFHcdKpcJvcGHqvdCjEuxal",168,0.994083,29,169,1,168,1,1,0,1,1,89,88,80,80,78
"7333",32,"[29]mJHggqIFHcdKpcJvcGHqvdCjEuxal",167,0.994048,29,168,1,167,1,1,0,1,1,85,84,83,83,78
"7334",33,"[29]mJHggqIFHcdKpcJvcGHqvdCjEuxal",166,0.994012,29,167,1,166,1,1,0,1,1,82,81,85,85,78
"7335",34,"[29]mJHggqIFHcdKpcJvcGHqvdCjEuxal",163,0.993902,29,164,1,163,1,1,0,1,1,75,74,89,89,78
"7336",35,"[29]mJHggqIFHcdKpcJvcGHqvdCjEuxal",165,0.993976,29,166,1,165,1,1,0,1,1,80,79,86,86,78
"7337",36,"[29]mJHggqIFHcdKpcJvcGHqvdCjEuxal",169,0.994118,29,170,1,169,1,1,0,1,1,91,90,79,79,78
"7338",37,"[29]mJHggqIFHcdKpcJvcGHqvdCjEuxal",164,0.993939,29,165,1,164,1,1,0,1,1,77,76,88,88,78
"7339",38,"[29]mJHggqIFHcdKpcJvcGHqvdCjEuxal",171,0.994186,29,172,1,171,1,1,0,1,1,96,95,76,76,78
"7340",39,"[29]mJHggqIFHcdKpcJvcGHqvdCjEuxal",168,0.994083,29,169,1,168,1,1,0,1,1,89,88,80,80,78
"7341",40,"[29]mJHggqIFHcdKpcJvcGHqvdCjEuxal",162,0.993865,29,163,1,162,1,1,0,1,1,70,69,93,93,78
"7342",41,"[29]mJHggqIFHcdKpcJvcGHqvdCjEuxal",171,0.994186,29,172,1,171,1,1,0,1,1,97,96,75,75,78
"7343",42,"[29]mJHggqIFHcdKpcJvcGHqvdCjEuxal",174,0.994286,29,175,1,174,1,1,0,1,1,103,102,72,72,78
"7344",43,"[29]mJHggqIFHcdKpcJvcGHqvdCjEuxal",168,0.994083,29,169,1,168,1,1,0,1,1,85,84,84,84,78
"7345",44,"[29]mJHggqIFHcdKpcJvcGHqvdCjEuxal",165,0.993976,29,166,1,165,1,1,0,1,1,80,79,86,86,78
"7346",45,"[29]mJHggqIFHcdKpcJvcGHqvdCjEuxal",164,0.993939,29,165,1,164,1,1,0,1,1,76,75,89,89,78
"7347",46,"[29]mJHggqIFHcdKpcJvcGHqvdCjEuxal",166,0.994012,29,167,1,166,1,1,0,1,1,82,81,85,85,78
"7348",47,"[29]mJHggqIFHcdKpcJvcGHqvdCjEuxal",167,0.994048,29,168,1,167,1,1,0,1,1,85,84,83,83,78
"7349",48,"[29]mJHggqIFHcdKpcJvcGHqvdCjEuxal",164,0.993939,29,165,1,164,1,1,0,1,1,78,77,87,87,78
"7350",49,"[29]mJHggqIFHcdKpcJvcGHqvdCjEuxal",163,0.993902,29,164,1,163,1,1,0,1,1,74,73,90,90,78
"7351",50,"[29]mJHggqIFHcdKpcJvcGHqvdCjEuxal",167,0.994048,29,168,1,167,1,1,0,1,1,86,85,82,82,78
"7352",51,"[29]mJHggqIFHcdKpcJvcGHqvdCjEuxal",169,0.994118,29,170,1,169,1,1,0,1,1,88,87,82,82,78
"7353",52,"[29]mJHggqIFHcdKpcJvcGHqvdCjEuxal",165,0.993976,29,166,1,165,1,1,0,1,1,80,79,86,86,78
"7354",53,"[29]mJHggqIFHcdKpcJvcGHqvdCjEuxal",172,0.99422,29,173,1,172,1,1,0,1,1,98,97,75,75,78
"7355",54,"[29]mJHggqIFHcdKpcJvcGHqvdCjEuxal",168,0.994083,29,169,1,168,1,1,0,1,1,88,87,81,81,78
"7356",55,"[29]mJHggqIFHcdKpcJvcGHqvdCjEuxal",172,0.99422,29,173,1,172,1,1,0,1,1,95,94,78,78,78
"7357",56,"[29]mJHggqIFHcdKpcJvcGHqvdCjEuxal",169,0.994118,29,170,1,169,1,1,0,1,1,90,89,80,80,78
"7358",57,"[29]mJHggqIFHcdKpcJvcGHqvdCjEuxal",167,0.994048,29,168,1,167,1,1,0,1,1,85,84,83,83,78
"7359",58,"[29]mJHggqIFHcdKpcJvcGHqvdCjEuxal",172,0.99422,29,173,1,172,1,1,0,1,1,100,99,73,73,78
"7360",59,"[29]mJHggqIFHcdKpcJvcGHqvdCjEuxal",167,0.994048,29,168,1,167,1,1,0,1,1,82,81,86,86,78
"7361",60,"[29]mJHggqIFHcdKpcJvcGHqvdCjEuxal",172,0.99422,29,173,1,172,1,1,0,1,1,99,98,74,74,78
"7362",61,"[29]mJHggqIFHcdKpcJvcGHqvdCjEuxal",166,0.994012,29,167,1,166,1,1,0,1,1,82,81,85,85,78
"7363",62,"[29]mJHggqIFHcdKpcJvcGHqvdCjEuxal",171,0.994186,29,172,1,171,1,1,0,1,1,93,92,79,79,78
"7364",63,"[29]mJHggqIFHcdKpcJvcGHqvdCjEuxal",164,0.993939,29,165,1,164,1,1,0,1,1,77,76,88,88,78
"7365",64,"[29]mJHggqIFHcdKpcJvcGHqvdCjEuxal",166,0.994012,29,167,1,166,1,1,0,1,1,82,81,85,85,78
"7366",65,"[29]mJHggqIFHcdKpcJvcGHqvdCjEuxal",168,0.994083,29,169,1,168,1,1,0,1,1,88,87,81,81,78
"7367",66,"[29]mJHggqIFHcdKpcJvcGHqvdCjEuxal",166,0.994012,29,167,1,166,1,1,0,1,1,83,82,84,84,78
"7368",67,"[29]mJHggqIFHcdKpcJvcGHqvdCjEuxal",166,0.994012,29,167,1,166,1,1,0,1,1,83,82,84,84,78
"7369",68,"[29]mJHggqIFHcdKpcJvcGHqvdCjEuxal",165,0.993976,29,166,1,165,1,1,0,1,1,78,77,88,88,78
"7370",69,"[29]mJHggqIFHcdKpcJvcGHqvdCjEuxal",164,0.993939,29,165,1,164,1,1,0,1,1,75,74,90,90,78
"7371",70,"[29]mJHggqIFHcdKpcJvcGHqvdCjEuxal",170,0.994152,29,171,1,170,1,1,0,1,1,94,93,77,77,78
"7372",71,"[29]mJHggqIFHcdKpcJvcGHqvdCjEuxal",166,0.994012,29,167,1,166,1,1,0,1,1,82,81,85,85,78
"7373",72,"[29]mJHggqIFHcdKpcJvcGHqvdCjEuxal",168,0.994083,29,169,1,168,1,1,0,1,1,89,88,80,80,78
"7374",73,"[29]mJHggqIFHcdKpcJvcGHqvdCjEuxal",169,0.994118,29,170,1,169,1,1,0,1,1,89,88,81,81,78
"7375",74,"[29]mJHggqIFHcdKpcJvcGHqvdCjEuxal",170,0.994152,29,171,1,170,1,1,0,1,1,93,92,78,78,78
"7376",75,"[29]mJHggqIFHcdKpcJvcGHqvdCjEuxal",165,0.993976,29,166,1,165,1,1,0,1,1,77,76,89,89,78
"7377",76,"[29]mJHggqIFHcdKpcJvcGHqvdCjEuxal",168,0.994083,29,169,1,168,1,1,0,1,1,88,87,81,81,78
"7378",77,"[29]mJHggqIFHcdKpcJvcGHqvdCjEuxal",167,0.994048,29,168,1,167,1,1,0,1,1,84,83,84,84,78
"7379",78,"[29]mJHggqIFHcdKpcJvcGHqvdCjEuxal",170,0.994152,29,171,1,170,1,1,0,1,1,90,89,81,81,78
"7380",79,"[29]mJHggqIFHcdKpcJvcGHqvdCjEuxal",172,0.99422,29,173,1,172,1,1,0,1,1,99,98,74,74,78
"7381",80,"[29]mJHggqIFHcdKpcJvcGHqvdCjEuxal",166,0.994012,29,167,1,166,1,1,0,1,1,82,81,85,85,78
"7382",81,"[29]mJHggqIFHcdKpcJvcGHqvdCjEuxal",171,0.994186,29,172,1,171,1,1,0,1,1,94,93,78,78,78
"7383",82,"[29]mJHggqIFHcdKpcJvcGHqvdCjEuxal",171,0.994186,29,172,1,171,1,1,0,1,1,95,94,77,77,78
"7384",83,"[29]mJHggqIFHcdKpcJvcGHqvdCjEuxal",166,0.994012,29,167,1,166,1,1,0,1,1,81,80,86,86,78
"7385",84,"[29]mJHggqIFHcdKpcJvcGHqvdCjEuxal",171,0.994186,29,172,1,171,1,1,0,1,1,97,96,75,75,78
"7386",85,"[29]mJHggqIFHcdKpcJvcGHqvdCjEuxal",168,0.994083,29,169,1,168,1,1,0,1,1,88,87,81,81,78
"7387",86,"[29]mJHggqIFHcdKpcJvcGHqvdCjEuxal",166,0.994012,29,167,1,166,1,1,0,1,1,82,81,85,85,78
"7388",87,"[29]mJHggqIFHcdKpcJvcGHqvdCjEuxal",169,0.994118,29,170,1,169,1,1,0,1,1,90,89,80,80,78
"7389",88,"[29]mJHggqIFHcdKpcJvcGHqvdCjEuxal",164,0.993939,29,165,1,164,1,1,0,1,1,77,76,88,88,78
"7390",89,"[29]mJHggqIFHcdKpcJvcGHqvdCjEuxal",166,0.994012,29,167,1,166,1,1,0,1,1,81,80,86,86,78
"7391",90,"[29]mJHggqIFHcdKpcJvcGHqvdCjEuxal",169,0.994118,29,170,1,169,1,1,0,1,1,91,90,79,79,78
"7392",91,"[29]mJHggqIFHcdKpcJvcGHqvdCjEuxal",166,0.994012,29,167,1,166,1,1,0,1,1,81,80,86,86,78
"7393",92,"[29]mJHggqIFHcdKpcJvcGHqvdCjEuxal",170,0.994152,29,171,1,170,1,1,0,1,1,91,90,80,80,78
"7394",93,"[29]mJHggqIFHcdKpcJvcGHqvdCjEuxal",168,0.994083,29,169,1,168,1,1,0,1,1,87,86,82,82,78
"7395",94,"[29]mJHggqIFHcdKpcJvcGHqvdCjEuxal",168,0.994083,29,169,1,168,1,1,0,1,1,87,86,82,82,78
"7396",95,"[29]mJHggqIFHcdKpcJvcGHqvdCjEuxal",166,0.994012,29,167,1,166,1,1,0,1,1,82,81,85,85,78
"7397",96,"[29]mJHggqIFHcdKpcJvcGHqvdCjEuxal",166,0.994012,29,167,1,166,1,1,0,1,1,82,81,85,85,78
"7398",97,"[29]mJHggqIFHcdKpcJvcGHqvdCjEuxal",172,0.99422,29,173,1,172,1,1,0,1,1,100,99,73,73,78
"7399",98,"[29]mJHggqIFHcdKpcJvcGHqvdCjEuxal",166,0.994012,29,167,1,166,1,1,0,1,1,81,80,86,86,78
"7400",99,"[29]mJHggqIFHcdKpcJvcGHqvdCjEuxal",165,0.993976,29,166,1,165,1,1,0,1,1,80,79,86,86,78
"7401",0,"[27]CJHglqIHcidKocJvcGHqxdClFwn",160,0.993789,27,161,1,160,1,1,0,1,1,67,66,94,94,79
"7402",1,"[27]CJHglqIHcidKocJvcGHqxdClFwn",166,0.994012,27,167,1,166,1,1,0,1,1,81,80,86,86,79
"7403",2,"[27]CJHglqIHcidKocJvcGHqxdClFwn",166,0.994012,27,167,1,166,1,1,0,1,1,82,81,85,85,79
"7404",3,"[27]CJHglqIHcidKocJvcGHqxdClFwn",170,0.994152,27,171,1,170,1,1,0,1,1,93,92,78,78,79
"7405",4,"[27]CJHglqIHcidKocJvcGHqxdClFwn",168,0.994083,27,169,1,168,1,1,0,1,1,87,86,82,82,79
"7406",5,"[27]CJHglqIHcidKocJvcGHqxdClFwn",168,0.994083,27,169,1,168,1,1,0,1,1,88,87,81,81,79
"7407",6,"[27]CJHglqIHcidKocJvcGHqxdClFwn",168,0.994083,27,169,1,168,1,1,0,1,1,84,83,85,85,79
"7408",7,"[27]CJHglqIHcidKocJvcGHqxdClFwn",163,0.993902,27,164,1,163,1,1,0,1,1,73,72,91,91,79
"7409",8,"[27]CJHglqIHcidKocJvcGHqxdClFwn",162,0.993865,27,163,1,162,1,1,0,1,1,72,71,91,91,79
"7410",9,"[27]CJHglqIHcidKocJvcGHqxdClFwn",168,0.994083,27,169,1,168,1,1,0,1,1,88,87,81,81,79
"7411",10,"[27]CJHglqIHcidKocJvcGHqxdClFwn",170,0.994152,27,171,1,170,1,1,0,1,1,93,92,78,78,79
"7412",11,"[27]CJHglqIHcidKocJvcGHqxdClFwn",167,0.994048,27,168,1,167,1,1,0,1,1,84,83,84,84,79
"7413",12,"[27]CJHglqIHcidKocJvcGHqxdClFwn",169,0.994118,27,170,1,169,1,1,0,1,1,89,88,81,81,79
"7414",13,"[27]CJHglqIHcidKocJvcGHqxdClFwn",167,0.994048,27,168,1,167,1,1,0,1,1,85,84,83,83,79
"7415",14,"[27]CJHglqIHcidKocJvcGHqxdClFwn",164,0.993939,27,165,1,164,1,1,0,1,1,76,75,89,89,79
"7416",15,"[27]CJHglqIHcidKocJvcGHqxdClFwn",168,0.994083,27,169,1,168,1,1,0,1,1,87,86,82,82,79
"7417",16,"[27]CJHglqIHcidKocJvcGHqxdClFwn",169,0.994118,27,170,1,169,1,1,0,1,1,91,90,79,79,79
"7418",17,"[27]CJHglqIHcidKocJvcGHqxdClFwn",167,0.994048,27,168,1,167,1,1,0,1,1,86,85,82,82,79
"7419",18,"[27]CJHglqIHcidKocJvcGHqxdClFwn",164,0.993939,27,165,1,164,1,1,0,1,1,76,75,89,89,79
"7420",19,"[27]CJHglqIHcidKocJvcGHqxdClFwn",172,0.99422,27,173,1,172,1,1,0,1,1,98,97,75,75,79
"7421",20,"[27]CJHglqIHcidKocJvcGHqxdClFwn",160,0.993789,27,161,1,160,1,1,0,1,1,66,65,95,95,79
"7422",21,"[27]CJHglqIHcidKocJvcGHqxdClFwn",164,0.993939,27,165,1,164,1,1,0,1,1,77,76,88,88,79
"7423",22,"[27]CJHglqIHcidKocJvcGHqxdClFwn",166,0.994012,27,167,1,166,1,1,0,1,1,81,80,86,86,79
"7424",23,"[27]CJHglqIHcidKocJvcGHqxdClFwn",167,0.994048,27,168,1,167,1,1,0,1,1,86,85,82,82,79
"7425",24,"[27]CJHglqIHcidKocJvcGHqxdClFwn",167,0.994048,27,168,1,167,1,1,0,1,1,85,84,83,83,79
"7426",25,"[27]CJHglqIHcidKocJvcGHqxdClFwn",163,0.993902,27,164,1,163,1,1,0,1,1,75,74,89,89,79
"7427",26,"[27]CJHglqIHcidKocJvcGHqxdClFwn",170,0.994152,27,171,1,170,1,1,0,1,1,93,92,78,78,79
"7428",27,"[27]CJHglqIHcidKocJvcGHqxdClFwn",166,0.994012,27,167,1,166,1,1,0,1,1,82,81,85,85,79
"7429",28,"[27]CJHglqIHcidKocJvcGHqxdClFwn",163,0.993902,27,164,1,163,1,1,0,1,1,73,72,91,91,79
"7430",29,"[27]CJHglqIHcidKocJvcGHqxdClFwn",166,0.994012,27,167,1,166,1,1,0,1,1,83,82,84,84,79
"7431",30,"[27]CJHglqIHcidKocJvcGHqxdClFwn",168,0.994083,27,169,1,168,1,1,0,1,1,88,87,81,81,79
"7432",31,"[27]CJHglqIHcidKocJvcGHqxdClFwn",167,0.994048,27,168,1,167,1,1,0,1,1,85,84,83,83,79
"7433",32,"[27]CJHglqIHcidKocJvcGHqxdClFwn",170,0.994152,27,171,1,170,1,1,0,1,1,93,92,78,78,79
"7434",33,"[27]CJHglqIHcidKocJvcGHqxdClFwn",168,0.994083,27,169,1,168,1,1,0,1,1,88,87,81,81,79
"7435",34,"[27]CJHglqIHcidKocJvcGHqxdClFwn",170,0.994152,27,171,1,170,1,1,0,1,1,92,91,79,79,79
"7436",35,"[27]CJHglqIHcidKocJvcGHqxdClFwn",172,0.99422,27,173,1,172,1,1,0,1,1,96,95,77,77,79
"7437",36,"[27]CJHglqIHcidKocJvcGHqxdClFwn",163,0.993902,27,164,1,163,1,1,0,1,1,74,73,90,90,79
"7438",37,"[27]CJHglqIHcidKocJvcGHqxdClFwn",170,0.994152,27,171,1,170,1,1,0,1,1,92,91,79,79,79
"7439",38,"[27]CJHglqIHcidKocJvcGHqxdClFwn",168,0.994083,27,169,1,168,1,1,0,1,1,88,87,81,81,79
"7440",39,"[27]CJHglqIHcidKocJvcGHqxdClFwn",168,0.994083,27,169,1,168,1,1,0,1,1,87,86,82,82,79
"7441",40,"[27]CJHglqIHcidKocJvcGHqxdClFwn",167,0.994048,27,168,1,167,1,1,0,1,1,86,85,82,82,79
"7442",41,"[27]CJHglqIHcidKocJvcGHqxdClFwn",169,0.994118,27,170,1,169,1,1,0,1,1,89,88,81,81,79
"7443",42,"[27]CJHglqIHcidKocJvcGHqxdClFwn",165,0.993976,27,166,1,165,1,1,0,1,1,79,78,87,87,79
"7444",43,"[27]CJHglqIHcidKocJvcGHqxdClFwn",175,0.994318,27,176,1,175,1,1,0,1,1,107,106,69,69,79
"7445",44,"[27]CJHglqIHcidKocJvcGHqxdClFwn",170,0.994152,27,171,1,170,1,1,0,1,1,93,92,78,78,79
"7446",45,"[27]CJHglqIHcidKocJvcGHqxdClFwn",169,0.994118,27,170,1,169,1,1,0,1,1,89,88,81,81,79
"7447",46,"[27]CJHglqIHcidKocJvcGHqxdClFwn",163,0.993902,27,164,1,163,1,1,0,1,1,72,71,92,92,79
"7448",47,"[27]CJHglqIHcidKocJvcGHqxdClFwn",163,0.993902,27,164,1,163,1,1,0,1,1,74,73,90,90,79
"7449",48,"[27]CJHglqIHcidKocJvcGHqxdClFwn",167,0.994048,27,168,1,167,1,1,0,1,1,84,83,84,84,79
"7450",49,"[27]CJHglqIHcidKocJvcGHqxdClFwn",166,0.994012,27,167,1,166,1,1,0,1,1,83,82,84,84,79
"7451",50,"[27]CJHglqIHcidKocJvcGHqxdClFwn",169,0.994118,27,170,1,169,1,1,0,1,1,90,89,80,80,79
"7452",51,"[27]CJHglqIHcidKocJvcGHqxdClFwn",166,0.994012,27,167,1,166,1,1,0,1,1,81,80,86,86,79
"7453",52,"[27]CJHglqIHcidKocJvcGHqxdClFwn",169,0.994118,27,170,1,169,1,1,0,1,1,89,88,81,81,79
"7454",53,"[27]CJHglqIHcidKocJvcGHqxdClFwn",170,0.994152,27,171,1,170,1,1,0,1,1,93,92,78,78,79
"7455",54,"[27]CJHglqIHcidKocJvcGHqxdClFwn",164,0.993939,27,165,1,164,1,1,0,1,1,76,75,89,89,79
"7456",55,"[27]CJHglqIHcidKocJvcGHqxdClFwn",163,0.993902,27,164,1,163,1,1,0,1,1,74,73,90,90,79
"7457",56,"[27]CJHglqIHcidKocJvcGHqxdClFwn",167,0.994048,27,168,1,167,1,1,0,1,1,85,84,83,83,79
"7458",57,"[27]CJHglqIHcidKocJvcGHqxdClFwn",168,0.994083,27,169,1,168,1,1,0,1,1,88,87,81,81,79
"7459",58,"[27]CJHglqIHcidKocJvcGHqxdClFwn",166,0.994012,27,167,1,166,1,1,0,1,1,82,81,85,85,79
"7460",59,"[27]CJHglqIHcidKocJvcGHqxdClFwn",170,0.994152,27,171,1,170,1,1,0,1,1,92,91,79,79,79
"7461",60,"[27]CJHglqIHcidKocJvcGHqxdClFwn",170,0.994152,27,171,1,170,1,1,0,1,1,94,93,77,77,79
"7462",61,"[27]CJHglqIHcidKocJvcGHqxdClFwn",164,0.993939,27,165,1,164,1,1,0,1,1,77,76,88,88,79
"7463",62,"[27]CJHglqIHcidKocJvcGHqxdClFwn",167,0.994048,27,168,1,167,1,1,0,1,1,85,84,83,83,79
"7464",63,"[27]CJHglqIHcidKocJvcGHqxdClFwn",169,0.994118,27,170,1,169,1,1,0,1,1,90,89,80,80,79
"7465",64,"[27]CJHglqIHcidKocJvcGHqxdClFwn",170,0.994152,27,171,1,170,1,1,0,1,1,93,92,78,78,79
"7466",65,"[27]CJHglqIHcidKocJvcGHqxdClFwn",167,0.994048,27,168,1,167,1,1,0,1,1,85,84,83,83,79
"7467",66,"[27]CJHglqIHcidKocJvcGHqxdClFwn",165,0.993976,27,166,1,165,1,1,0,1,1,79,78,87,87,79
"7468",67,"[27]CJHglqIHcidKocJvcGHqxdClFwn",161,0.993827,27,162,1,161,1,1,0,1,1,68,67,94,94,79
"7469",68,"[27]CJHglqIHcidKocJvcGHqxdClFwn",164,0.993939,27,165,1,164,1,1,0,1,1,74,73,91,91,79
"7470",69,"[27]CJHglqIHcidKocJvcGHqxdClFwn",163,0.993902,27,164,1,163,1,1,0,1,1,73,72,91,91,79
"7471",70,"[27]CJHglqIHcidKocJvcGHqxdClFwn",170,0.994152,27,171,1,170,1,1,0,1,1,94,93,77,77,79
"7472",71,"[27]CJHglqIHcidKocJvcGHqxdClFwn",167,0.994048,27,168,1,167,1,1,0,1,1,85,84,83,83,79
"7473",72,"[27]CJHglqIHcidKocJvcGHqxdClFwn",160,0.993789,27,161,1,160,1,1,0,1,1,66,65,95,95,79
"7474",73,"[27]CJHglqIHcidKocJvcGHqxdClFwn",171,0.994186,27,172,1,171,1,1,0,1,1,95,94,77,77,79
"7475",74,"[27]CJHglqIHcidKocJvcGHqxdClFwn",166,0.994012,27,167,1,166,1,1,0,1,1,83,82,84,84,79
"7476",75,"[27]CJHglqIHcidKocJvcGHqxdClFwn",170,0.994152,27,171,1,170,1,1,0,1,1,92,91,79,79,79
"7477",76,"[27]CJHglqIHcidKocJvcGHqxdClFwn",168,0.994083,27,169,1,168,1,1,0,1,1,87,86,82,82,79
"7478",77,"[27]CJHglqIHcidKocJvcGHqxdClFwn",171,0.994186,27,172,1,171,1,1,0,1,1,95,94,77,77,79
"7479",78,"[27]CJHglqIHcidKocJvcGHqxdClFwn",172,0.99422,27,173,1,172,1,1,0,1,1,97,96,76,76,79
"7480",79,"[27]CJHglqIHcidKocJvcGHqxdClFwn",159,0.99375,27,160,1,159,1,1,0,1,1,64,63,96,96,79
"7481",80,"[27]CJHglqIHcidKocJvcGHqxdClFwn",168,0.994083,27,169,1,168,1,1,0,1,1,87,86,82,82,79
"7482",81,"[27]CJHglqIHcidKocJvcGHqxdClFwn",171,0.994186,27,172,1,171,1,1,0,1,1,93,92,79,79,79
"7483",82,"[27]CJHglqIHcidKocJvcGHqxdClFwn",168,0.994083,27,169,1,168,1,1,0,1,1,87,86,82,82,79
"7484",83,"[27]CJHglqIHcidKocJvcGHqxdClFwn",167,0.994048,27,168,1,167,1,1,0,1,1,86,85,82,82,79
"7485",84,"[27]CJHglqIHcidKocJvcGHqxdClFwn",171,0.994186,27,172,1,171,1,1,0,1,1,95,94,77,77,79
"7486",85,"[27]CJHglqIHcidKocJvcGHqxdClFwn",165,0.993976,27,166,1,165,1,1,0,1,1,80,79,86,86,79
"7487",86,"[27]CJHglqIHcidKocJvcGHqxdClFwn",171,0.994186,27,172,1,171,1,1,0,1,1,96,95,76,76,79
"7488",87,"[27]CJHglqIHcidKocJvcGHqxdClFwn",168,0.994083,27,169,1,168,1,1,0,1,1,88,87,81,81,79
"7489",88,"[27]CJHglqIHcidKocJvcGHqxdClFwn",165,0.993976,27,166,1,165,1,1,0,1,1,80,79,86,86,79
"7490",89,"[27]CJHglqIHcidKocJvcGHqxdClFwn",165,0.993976,27,166,1,165,1,1,0,1,1,79,78,87,87,79
"7491",90,"[27]CJHglqIHcidKocJvcGHqxdClFwn",167,0.994048,27,168,1,167,1,1,0,1,1,86,85,82,82,79
"7492",91,"[27]CJHglqIHcidKocJvcGHqxdClFwn",167,0.994048,27,168,1,167,1,1,0,1,1,85,84,83,83,79
"7493",92,"[27]CJHglqIHcidKocJvcGHqxdClFwn",168,0.994083,27,169,1,168,1,1,0,1,1,86,85,83,83,79
"7494",93,"[27]CJHglqIHcidKocJvcGHqxdClFwn",170,0.994152,27,171,1,170,1,1,0,1,1,91,90,80,80,79
"7495",94,"[27]CJHglqIHcidKocJvcGHqxdClFwn",170,0.994152,27,171,1,170,1,1,0,1,1,92,91,79,79,79
"7496",95,"[27]CJHglqIHcidKocJvcGHqxdClFwn",166,0.994012,27,167,1,166,1,1,0,1,1,82,81,85,85,79
"7497",96,"[27]CJHglqIHcidKocJvcGHqxdClFwn",160,0.993789,27,161,1,160,1,1,0,1,1,67,66,94,94,79
"7498",97,"[27]CJHglqIHcidKocJvcGHqxdClFwn",166,0.994012,27,167,1,166,1,1,0,1,1,83,82,84,84,79
"7499",98,"[27]CJHglqIHcidKocJvcGHqxdClFwn",165,0.993976,27,166,1,165,1,1,0,1,1,78,77,88,88,79
"7500",99,"[27]CJHglqIHcidKocJvcGHqxdClFwn",166,0.994012,27,167,1,166,1,1,0,1,1,81,80,86,86,79
"7501",0,"[30]EJHqIhhHBgdKocJxcGHqvdCDlCGtBh",166,0.994012,30,167,1,166,1,1,0,1,1,81,80,86,86,80
"7502",1,"[30]EJHqIhhHBgdKocJxcGHqvdCDlCGtBh",167,0.994048,30,168,1,167,1,1,0,1,1,84,83,84,84,80
"7503",2,"[30]EJHqIhhHBgdKocJxcGHqvdCDlCGtBh",168,0.994083,30,169,1,168,1,1,0,1,1,86,85,83,83,80
"7504",3,"[30]EJHqIhhHBgdKocJxcGHqvdCDlCGtBh",167,0.994048,30,168,1,167,1,1,0,1,1,86,85,82,82,80
"7505",4,"[30]EJHqIhhHBgdKocJxcGHqvdCDlCGtBh",168,0.994083,30,169,1,168,1,1,0,1,1,88,87,81,81,80
"7506",5,"[30]EJHqIhhHBgdKocJxcGHqvdCDlCGtBh",164,0.993939,30,165,1,164,1,1,0,1,1,77,76,88,88,80
"7507",6,"[30]EJHqIhhHBgdKocJxcGHqvdCDlCGtBh",166,0.994012,30,167,1,166,1,1,0,1,1,83,82,84,84,80
"7508",7,"[30]EJHqIhhHBgdKocJxcGHqvdCDlCGtBh",163,0.993902,30,164,1,163,1,1,0,1,1,75,74,89,89,80
"7509",8,"[30]EJHqIhhHBgdKocJxcGHqvdCDlCGtBh",162,0.993865,30,163,1,162,1,1,0,1,1,70,69,93,93,80
"7510",9,"[30]EJHqIhhHBgdKocJxcGHqvdCDlCGtBh",176,0.99435,30,177,1,176,1,1,0,1,1,102,101,75,75,80
"7511",10,"[30]EJHqIhhHBgdKocJxcGHqvdCDlCGtBh",162,0.993865,30,163,1,162,1,1,0,1,1,71,70,92,92,80
"7512",11,"[30]EJHqIhhHBgdKocJxcGHqvdCDlCGtBh",166,0.994012,30,167,1,166,1,1,0,1,1,80,79,87,87,80
"7513",12,"[30]EJHqIhhHBgdKocJxcGHqvdCDlCGtBh",171,0.994186,30,172,1,171,1,1,0,1,1,96,95,76,76,80
"7514",13,"[30]EJHqIhhHBgdKocJxcGHqvdCDlCGtBh",168,0.994083,30,169,1,168,1,1,0,1,1,86,85,83,83,80
"7515",14,"[30]EJHqIhhHBgdKocJxcGHqvdCDlCGtBh",167,0.994048,30,168,1,167,1,1,0,1,1,84,83,84,84,80
"7516",15,"[30]EJHqIhhHBgdKocJxcGHqvdCDlCGtBh",169,0.994118,30,170,1,169,1,1,0,1,1,88,87,82,82,80
"7517",16,"[30]EJHqIhhHBgdKocJxcGHqvdCDlCGtBh",167,0.994048,30,168,1,167,1,1,0,1,1,85,84,83,83,80
"7518",17,"[30]EJHqIhhHBgdKocJxcGHqvdCDlCGtBh",164,0.993939,30,165,1,164,1,1,0,1,1,76,75,89,89,80
"7519",18,"[30]EJHqIhhHBgdKocJxcGHqvdCDlCGtBh",173,0.994253,30,174,1,173,1,1,0,1,1,97,96,77,77,80
"7520",19,"[30]EJHqIhhHBgdKocJxcGHqvdCDlCGtBh",176,0.99435,30,177,1,176,1,1,0,1,1,104,103,73,73,80
"7521",20,"[30]EJHqIhhHBgdKocJxcGHqvdCDlCGtBh",169,0.994118,30,170,1,169,1,1,0,1,1,88,87,82,82,80
"7522",21,"[30]EJHqIhhHBgdKocJxcGHqvdCDlCGtBh",166,0.994012,30,167,1,166,1,1,0,1,1,81,80,86,86,80
"7523",22,"[30]EJHqIhhHBgdKocJxcGHqvdCDlCGtBh",169,0.994118,30,170,1,169,1,1,0,1,1,86,85,84,84,80
"7524",23,"[30]EJHqIhhHBgdKocJxcGHqvdCDlCGtBh",172,0.99422,30,173,1,172,1,1,0,1,1,95,94,78,78,80
"7525",24,"[30]EJHqIhhHBgdKocJxcGHqvdCDlCGtBh",168,0.994083,30,169,1,168,1,1,0,1,1,89,88,80,80,80
"7526",25,"[30]EJHqIhhHBgdKocJxcGHqvdCDlCGtBh",172,0.99422,30,173,1,172,1,1,0,1,1,91,90,82,82,80
"7527",26,"[30]EJHqIhhHBgdKocJxcGHqvdCDlCGtBh",161,0.993827,30,162,1,161,1,1,0,1,1,69,68,93,93,80
"7528",27,"[30]EJHqIhhHBgdKocJxcGHqvdCDlCGtBh",166,0.994012,30,167,1,166,1,1,0,1,1,81,80,86,86,80
"7529",28,"[30]EJHqIhhHBgdKocJxcGHqvdCDlCGtBh",169,0.994118,30,170,1,169,1,1,0,1,1,90,89,80,80,80
"7530",29,"[30]EJHqIhhHBgdKocJxcGHqvdCDlCGtBh",176,0.99435,30,177,1,176,1,1,0,1,1,103,102,74,74,80
"7531",30,"[30]EJHqIhhHBgdKocJxcGHqvdCDlCGtBh",170,0.994152,30,171,1,170,1,1,0,1,1,92,91,79,79,80
"7532",31,"[30]EJHqIhhHBgdKocJxcGHqvdCDlCGtBh",170,0.994152,30,171,1,170,1,1,0,1,1,87,86,84,84,80
"7533",32,"[30]EJHqIhhHBgdKocJxcGHqvdCDlCGtBh",163,0.993902,30,164,1,163,1,1,0,1,1,73,72,91,91,80
"7534",33,"[30]EJHqIhhHBgdKocJxcGHqvdCDlCGtBh",167,0.994048,30,168,1,167,1,1,0,1,1,83,82,85,85,80
"7535",34,"[30]EJHqIhhHBgdKocJxcGHqvdCDlCGtBh",168,0.994083,30,169,1,168,1,1,0,1,1,86,85,83,83,80
"7536",35,"[30]EJHqIhhHBgdKocJxcGHqvdCDlCGtBh",172,0.99422,30,173,1,172,1,1,0,1,1,95,94,78,78,80
"7537",36,"[30]EJHqIhhHBgdKocJxcGHqvdCDlCGtBh",169,0.994118,30,170,1,169,1,1,0,1,1,90,89,80,80,80
"7538",37,"[30]EJHqIhhHBgdKocJxcGHqvdCDlCGtBh",172,0.99422,30,173,1,172,1,1,0,1,1,99,98,74,74,80
"7539",38,"[30]EJHqIhhHBgdKocJxcGHqvdCDlCGtBh",169,0.994118,30,170,1,169,1,1,0,1,1,89,88,81,81,80
"7540",39,"[30]EJHqIhhHBgdKocJxcGHqvdCDlCGtBh",170,0.994152,30,171,1,170,1,1,0,1,1,92,91,79,79,80
"7541",40,"[30]EJHqIhhHBgdKocJxcGHqvdCDlCGtBh",164,0.993939,30,165,1,164,1,1,0,1,1,77,76,88,88,80
"7542",41,"[30]EJHqIhhHBgdKocJxcGHqvdCDlCGtBh",169,0.994118,30,170,1,169,1,1,0,1,1,91,90,79,79,80
"7543",42,"[30]EJHqIhhHBgdKocJxcGHqvdCDlCGtBh",168,0.994083,30,169,1,168,1,1,0,1,1,88,87,81,81,80
"7544",43,"[30]EJHqIhhHBgdKocJxcGHqvdCDlCGtBh",164,0.993939,30,165,1,164,1,1,0,1,1,76,75,89,89,80
"7545",44,"[30]EJHqIhhHBgdKocJxcGHqvdCDlCGtBh",168,0.994083,30,169,1,168,1,1,0,1,1,88,87,81,81,80
"7546",45,"[30]EJHqIhhHBgdKocJxcGHqvdCDlCGtBh",174,0.994286,30,175,1,174,1,1,0,1,1,104,103,71,71,80
"7547",46,"[30]EJHqIhhHBgdKocJxcGHqvdCDlCGtBh",167,0.994048,30,168,1,167,1,1,0,1,1,85,84,83,83,80
"7548",47,"[30]EJHqIhhHBgdKocJxcGHqvdCDlCGtBh",172,0.99422,30,173,1,172,1,1,0,1,1,97,96,76,76,80
"7549",48,"[30]EJHqIhhHBgdKocJxcGHqvdCDlCGtBh",166,0.994012,30,167,1,166,1,1,0,1,1,83,82,84,84,80
"7550",49,"[30]EJHqIhhHBgdKocJxcGHqvdCDlCGtBh",162,0.993865,30,163,1,162,1,1,0,1,1,71,70,92,92,80
"7551",50,"[30]EJHqIhhHBgdKocJxcGHqvdCDlCGtBh",164,0.993939,30,165,1,164,1,1,0,1,1,78,77,87,87,80
"7552",51,"[30]EJHqIhhHBgdKocJxcGHqvdCDlCGtBh",166,0.994012,30,167,1,166,1,1,0,1,1,82,81,85,85,80
"7553",52,"[30]EJHqIhhHBgdKocJxcGHqvdCDlCGtBh",167,0.994048,30,168,1,167,1,1,0,1,1,83,82,85,85,80
"7554",53,"[30]EJHqIhhHBgdKocJxcGHqvdCDlCGtBh",167,0.994048,30,168,1,167,1,1,0,1,1,85,84,83,83,80
"7555",54,"[30]EJHqIhhHBgdKocJxcGHqvdCDlCGtBh",163,0.993902,30,164,1,163,1,1,0,1,1,72,71,92,92,80
"7556",55,"[30]EJHqIhhHBgdKocJxcGHqvdCDlCGtBh",174,0.994286,30,175,1,174,1,1,0,1,1,101,100,74,74,80
"7557",56,"[30]EJHqIhhHBgdKocJxcGHqvdCDlCGtBh",166,0.994012,30,167,1,166,1,1,0,1,1,79,78,88,88,80
"7558",57,"[30]EJHqIhhHBgdKocJxcGHqvdCDlCGtBh",163,0.993902,30,164,1,163,1,1,0,1,1,75,74,89,89,80
"7559",58,"[30]EJHqIhhHBgdKocJxcGHqvdCDlCGtBh",166,0.994012,30,167,1,166,1,1,0,1,1,81,80,86,86,80
"7560",59,"[30]EJHqIhhHBgdKocJxcGHqvdCDlCGtBh",165,0.993976,30,166,1,165,1,1,0,1,1,80,79,86,86,80
"7561",60,"[30]EJHqIhhHBgdKocJxcGHqvdCDlCGtBh",170,0.994152,30,171,1,170,1,1,0,1,1,92,91,79,79,80
"7562",61,"[30]EJHqIhhHBgdKocJxcGHqvdCDlCGtBh",171,0.994186,30,172,1,171,1,1,0,1,1,95,94,77,77,80
"7563",62,"[30]EJHqIhhHBgdKocJxcGHqvdCDlCGtBh",164,0.993939,30,165,1,164,1,1,0,1,1,75,74,90,90,80
"7564",63,"[30]EJHqIhhHBgdKocJxcGHqvdCDlCGtBh",160,0.993789,30,161,1,160,1,1,0,1,1,67,66,94,94,80
"7565",64,"[30]EJHqIhhHBgdKocJxcGHqvdCDlCGtBh",162,0.993865,30,163,1,162,1,1,0,1,1,72,71,91,91,80
"7566",65,"[30]EJHqIhhHBgdKocJxcGHqvdCDlCGtBh",168,0.994083,30,169,1,168,1,1,0,1,1,88,87,81,81,80
"7567",66,"[30]EJHqIhhHBgdKocJxcGHqvdCDlCGtBh",171,0.994186,30,172,1,171,1,1,0,1,1,96,95,76,76,80
"7568",67,"[30]EJHqIhhHBgdKocJxcGHqvdCDlCGtBh",166,0.994012,30,167,1,166,1,1,0,1,1,82,81,85,85,80
"7569",68,"[30]EJHqIhhHBgdKocJxcGHqvdCDlCGtBh",170,0.994152,30,171,1,170,1,1,0,1,1,92,91,79,79,80
"7570",69,"[30]EJHqIhhHBgdKocJxcGHqvdCDlCGtBh",165,0.993976,30,166,1,165,1,1,0,1,1,78,77,88,88,80
"7571",70,"[30]EJHqIhhHBgdKocJxcGHqvdCDlCGtBh",168,0.994083,30,169,1,168,1,1,0,1,1,89,88,80,80,80
"7572",71,"[30]EJHqIhhHBgdKocJxcGHqvdCDlCGtBh",165,0.993976,30,166,1,165,1,1,0,1,1,80,79,86,86,80
"7573",72,"[30]EJHqIhhHBgdKocJxcGHqvdCDlCGtBh",166,0.994012,30,167,1,166,1,1,0,1,1,81,80,86,86,80
"7574",73,"[30]EJHqIhhHBgdKocJxcGHqvdCDlCGtBh",162,0.993865,30,163,1,162,1,1,0,1,1,70,69,93,93,80
"7575",74,"[30]EJHqIhhHBgdKocJxcGHqvdCDlCGtBh",161,0.993827,30,162,1,161,1,1,0,1,1,69,68,93,93,80
"7576",75,"[30]EJHqIhhHBgdKocJxcGHqvdCDlCGtBh",167,0.994048,30,168,1,167,1,1,0,1,1,85,84,83,83,80
"7577",76,"[30]EJHqIhhHBgdKocJxcGHqvdCDlCGtBh",172,0.99422,30,173,1,172,1,1,0,1,1,98,97,75,75,80
"7578",77,"[30]EJHqIhhHBgdKocJxcGHqvdCDlCGtBh",166,0.994012,30,167,1,166,1,1,0,1,1,83,82,84,84,80
"7579",78,"[30]EJHqIhhHBgdKocJxcGHqvdCDlCGtBh",162,0.993865,30,163,1,162,1,1,0,1,1,70,69,93,93,80
"7580",79,"[30]EJHqIhhHBgdKocJxcGHqvdCDlCGtBh",165,0.993976,30,166,1,165,1,1,0,1,1,80,79,86,86,80
"7581",80,"[30]EJHqIhhHBgdKocJxcGHqvdCDlCGtBh",169,0.994118,30,170,1,169,1,1,0,1,1,90,89,80,80,80
"7582",81,"[30]EJHqIhhHBgdKocJxcGHqvdCDlCGtBh",171,0.994186,30,172,1,171,1,1,0,1,1,96,95,76,76,80
"7583",82,"[30]EJHqIhhHBgdKocJxcGHqvdCDlCGtBh",169,0.994118,30,170,1,169,1,1,0,1,1,89,88,81,81,80
"7584",83,"[30]EJHqIhhHBgdKocJxcGHqvdCDlCGtBh",161,0.993827,30,162,1,161,1,1,0,1,1,69,68,93,93,80
"7585",84,"[30]EJHqIhhHBgdKocJxcGHqvdCDlCGtBh",167,0.994048,30,168,1,167,1,1,0,1,1,84,83,84,84,80
"7586",85,"[30]EJHqIhhHBgdKocJxcGHqvdCDlCGtBh",160,0.993789,30,161,1,160,1,1,0,1,1,66,65,95,95,80
"7587",86,"[30]EJHqIhhHBgdKocJxcGHqvdCDlCGtBh",170,0.994152,30,171,1,170,1,1,0,1,1,89,88,82,82,80
"7588",87,"[30]EJHqIhhHBgdKocJxcGHqvdCDlCGtBh",164,0.993939,30,165,1,164,1,1,0,1,1,78,77,87,87,80
"7589",88,"[30]EJHqIhhHBgdKocJxcGHqvdCDlCGtBh",166,0.994012,30,167,1,166,1,1,0,1,1,82,81,85,85,80
"7590",89,"[30]EJHqIhhHBgdKocJxcGHqvdCDlCGtBh",170,0.994152,30,171,1,170,1,1,0,1,1,94,93,77,77,80
"7591",90,"[30]EJHqIhhHBgdKocJxcGHqvdCDlCGtBh",171,0.994186,30,172,1,171,1,1,0,1,1,91,90,81,81,80
"7592",91,"[30]EJHqIhhHBgdKocJxcGHqvdCDlCGtBh",166,0.994012,30,167,1,166,1,1,0,1,1,81,80,86,86,80
"7593",92,"[30]EJHqIhhHBgdKocJxcGHqvdCDlCGtBh",163,0.993902,30,164,1,163,1,1,0,1,1,74,73,90,90,80
"7594",93,"[30]EJHqIhhHBgdKocJxcGHqvdCDlCGtBh",163,0.993902,30,164,1,163,1,1,0,1,1,74,73,90,90,80
"7595",94,"[30]EJHqIhhHBgdKocJxcGHqvdCDlCGtBh",163,0.993902,30,164,1,163,1,1,0,1,1,74,73,90,90,80
"7596",95,"[30]EJHqIhhHBgdKocJxcGHqvdCDlCGtBh",167,0.994048,30,168,1,167,1,1,0,1,1,84,83,84,84,80
"7597",96,"[30]EJHqIhhHBgdKocJxcGHqvdCDlCGtBh",171,0.994186,30,172,1,171,1,1,0,1,1,96,95,76,76,80
"7598",97,"[30]EJHqIhhHBgdKocJxcGHqvdCDlCGtBh",166,0.994012,30,167,1,166,1,1,0,1,1,83,82,84,84,80
"7599",98,"[30]EJHqIhhHBgdKocJxcGHqvdCDlCGtBh",171,0.994186,30,172,1,171,1,1,0,1,1,94,93,78,78,80
"7600",99,"[30]EJHqIhhHBgdKocJxcGHqvdCDlCGtBh",164,0.993939,30,165,1,164,1,1,0,1,1,77,76,88,88,80
"7601",0,"[25]wJHglqIHcdKocJvcGHqxdCGln",166,0.994012,25,167,1,166,1,1,0,1,1,81,80,86,86,81
"7602",1,"[25]wJHglqIHcdKocJvcGHqxdCGln",164,0.993939,25,165,1,164,1,1,0,1,1,77,76,88,88,81
"7603",2,"[25]wJHglqIHcdKocJvcGHqxdCGln",164,0.993939,25,165,1,164,1,1,0,1,1,75,74,90,90,81
"7604",3,"[25]wJHglqIHcdKocJvcGHqxdCGln",166,0.994012,25,167,1,166,1,1,0,1,1,82,81,85,85,81
"7605",4,"[25]wJHglqIHcdKocJvcGHqxdCGln",171,0.994186,25,172,1,171,1,1,0,1,1,96,95,76,76,81
"7606",5,"[25]wJHglqIHcdKocJvcGHqxdCGln",170,0.994152,25,171,1,170,1,1,0,1,1,92,91,79,79,81
"7607",6,"[25]wJHglqIHcdKocJvcGHqxdCGln",165,0.993976,25,166,1,165,1,1,0,1,1,79,78,87,87,81
"7608",7,"[25]wJHglqIHcdKocJvcGHqxdCGln",166,0.994012,25,167,1,166,1,1,0,1,1,81,80,86,86,81
"7609",8,"[25]wJHglqIHcdKocJvcGHqxdCGln",168,0.994083,25,169,1,168,1,1,0,1,1,88,87,81,81,81
"7610",9,"[25]wJHglqIHcdKocJvcGHqxdCGln",170,0.994152,25,171,1,170,1,1,0,1,1,90,89,81,81,81
"7611",10,"[25]wJHglqIHcdKocJvcGHqxdCGln",166,0.994012,25,167,1,166,1,1,0,1,1,81,80,86,86,81
"7612",11,"[25]wJHglqIHcdKocJvcGHqxdCGln",169,0.994118,25,170,1,169,1,1,0,1,1,88,87,82,82,81
"7613",12,"[25]wJHglqIHcdKocJvcGHqxdCGln",170,0.994152,25,171,1,170,1,1,0,1,1,91,90,80,80,81
"7614",13,"[25]wJHglqIHcdKocJvcGHqxdCGln",170,0.994152,25,171,1,170,1,1,0,1,1,93,92,78,78,81
"7615",14,"[25]wJHglqIHcdKocJvcGHqxdCGln",160,0.993789,25,161,1,160,1,1,0,1,1,66,65,95,95,81
"7616",15,"[25]wJHglqIHcdKocJvcGHqxdCGln",169,0.994118,25,170,1,169,1,1,0,1,1,90,89,80,80,81
"7617",16,"[25]wJHglqIHcdKocJvcGHqxdCGln",166,0.994012,25,167,1,166,1,1,0,1,1,81,80,86,86,81
"7618",17,"[25]wJHglqIHcdKocJvcGHqxdCGln",166,0.994012,25,167,1,166,1,1,0,1,1,81,80,86,86,81
"7619",18,"[25]wJHglqIHcdKocJvcGHqxdCGln",168,0.994083,25,169,1,168,1,1,0,1,1,86,85,83,83,81
"7620",19,"[25]wJHglqIHcdKocJvcGHqxdCGln",168,0.994083,25,169,1,168,1,1,0,1,1,85,84,84,84,81
"7621",20,"[25]wJHglqIHcdKocJvcGHqxdCGln",163,0.993902,25,164,1,163,1,1,0,1,1,75,74,89,89,81
"7622",21,"[25]wJHglqIHcdKocJvcGHqxdCGln",169,0.994118,25,170,1,169,1,1,0,1,1,91,90,79,79,81
"7623",22,"[25]wJHglqIHcdKocJvcGHqxdCGln",166,0.994012,25,167,1,166,1,1,0,1,1,80,79,87,87,81
"7624",23,"[25]wJHglqIHcdKocJvcGHqxdCGln",168,0.994083,25,169,1,168,1,1,0,1,1,88,87,81,81,81
"7625",24,"[25]wJHglqIHcdKocJvcGHqxdCGln",162,0.993865,25,163,1,162,1,1,0,1,1,71,70,92,92,81
"7626",25,"[25]wJHglqIHcdKocJvcGHqxdCGln",160,0.993789,25,161,1,160,1,1,0,1,1,65,64,96,96,81
"7627",26,"[25]wJHglqIHcdKocJvcGHqxdCGln",169,0.994118,25,170,1,169,1,1,0,1,1,90,89,80,80,81
"7628",27,"[25]wJHglqIHcdKocJvcGHqxdCGln",173,0.994253,25,174,1,173,1,1,0,1,1,102,101,72,72,81
"7629",28,"[25]wJHglqIHcdKocJvcGHqxdCGln",163,0.993902,25,164,1,163,1,1,0,1,1,75,74,89,89,81
"7630",29,"[25]wJHglqIHcdKocJvcGHqxdCGln",166,0.994012,25,167,1,166,1,1,0,1,1,82,81,85,85,81
"7631",30,"[25]wJHglqIHcdKocJvcGHqxdCGln",170,0.994152,25,171,1,170,1,1,0,1,1,93,92,78,78,81
"7632",31,"[25]wJHglqIHcdKocJvcGHqxdCGln",163,0.993902,25,164,1,163,1,1,0,1,1,75,74,89,89,81
"7633",32,"[25]wJHglqIHcdKocJvcGHqxdCGln",166,0.994012,25,167,1,166,1,1,0,1,1,81,80,86,86,81
"7634",33,"[25]wJHglqIHcdKocJvcGHqxdCGln",164,0.993939,25,165,1,164,1,1,0,1,1,77,76,88,88,81
"7635",34,"[25]wJHglqIHcdKocJvcGHqxdCGln",168,0.994083,25,169,1,168,1,1,0,1,1,86,85,83,83,81
"7636",35,"[25]wJHglqIHcdKocJvcGHqxdCGln",175,0.994318,25,176,1,175,1,1,0,1,1,105,104,71,71,81
"7637",36,"[25]wJHglqIHcdKocJvcGHqxdCGln",176,0.99435,25,177,1,176,1,1,0,1,1,106,105,71,71,81
"7638",37,"[25]wJHglqIHcdKocJvcGHqxdCGln",170,0.994152,25,171,1,170,1,1,0,1,1,92,91,79,79,81
"7639",38,"[25]wJHglqIHcdKocJvcGHqxdCGln",169,0.994118,25,170,1,169,1,1,0,1,1,89,88,81,81,81
"7640",39,"[25]wJHglqIHcdKocJvcGHqxdCGln",163,0.993902,25,164,1,163,1,1,0,1,1,74,73,90,90,81
"7641",40,"[25]wJHglqIHcdKocJvcGHqxdCGln",169,0.994118,25,170,1,169,1,1,0,1,1,90,89,80,80,81
"7642",41,"[25]wJHglqIHcdKocJvcGHqxdCGln",168,0.994083,25,169,1,168,1,1,0,1,1,87,86,82,82,81
"7643",42,"[25]wJHglqIHcdKocJvcGHqxdCGln",165,0.993976,25,166,1,165,1,1,0,1,1,75,74,91,91,81
"7644",43,"[25]wJHglqIHcdKocJvcGHqxdCGln",170,0.994152,25,171,1,170,1,1,0,1,1,93,92,78,78,81
"7645",44,"[25]wJHglqIHcdKocJvcGHqxdCGln",163,0.993902,25,164,1,163,1,1,0,1,1,73,72,91,91,81
"7646",45,"[25]wJHglqIHcdKocJvcGHqxdCGln",171,0.994186,25,172,1,171,1,1,0,1,1,96,95,76,76,81
"7647",46,"[25]wJHglqIHcdKocJvcGHqxdCGln",166,0.994012,25,167,1,166,1,1,0,1,1,81,80,86,86,81
"7648",47,"[25]wJHglqIHcdKocJvcGHqxdCGln",166,0.994012,25,167,1,166,1,1,0,1,1,81,80,86,86,81
"7649",48,"[25]wJHglqIHcdKocJvcGHqxdCGln",165,0.993976,25,166,1,165,1,1,0,1,1,80,79,86,86,81
"7650",49,"[25]wJHglqIHcdKocJvcGHqxdCGln",165,0.993976,25,166,1,165,1,1,0,1,1,78,77,88,88,81
"7651",50,"[25]wJHglqIHcdKocJvcGHqxdCGln",171,0.994186,25,172,1,171,1,1,0,1,1,96,95,76,76,81
"7652",51,"[25]wJHglqIHcdKocJvcGHqxdCGln",162,0.993865,25,163,1,162,1,1,0,1,1,72,71,91,91,81
"7653",52,"[25]wJHglqIHcdKocJvcGHqxdCGln",166,0.994012,25,167,1,166,1,1,0,1,1,79,78,88,88,81
"7654",53,"[25]wJHglqIHcdKocJvcGHqxdCGln",169,0.994118,25,170,1,169,1,1,0,1,1,89,88,81,81,81
"7655",54,"[25]wJHglqIHcdKocJvcGHqxdCGln",167,0.994048,25,168,1,167,1,1,0,1,1,84,83,84,84,81
"7656",55,"[25]wJHglqIHcdKocJvcGHqxdCGln",167,0.994048,25,168,1,167,1,1,0,1,1,85,84,83,83,81
"7657",56,"[25]wJHglqIHcdKocJvcGHqxdCGln",165,0.993976,25,166,1,165,1,1,0,1,1,78,77,88,88,81
"7658",57,"[25]wJHglqIHcdKocJvcGHqxdCGln",168,0.994083,25,169,1,168,1,1,0,1,1,84,83,85,85,81
"7659",58,"[25]wJHglqIHcdKocJvcGHqxdCGln",166,0.994012,25,167,1,166,1,1,0,1,1,83,82,84,84,81
"7660",59,"[25]wJHglqIHcdKocJvcGHqxdCGln",167,0.994048,25,168,1,167,1,1,0,1,1,86,85,82,82,81
"7661",60,"[25]wJHglqIHcdKocJvcGHqxdCGln",169,0.994118,25,170,1,169,1,1,0,1,1,89,88,81,81,81
"7662",61,"[25]wJHglqIHcdKocJvcGHqxdCGln",165,0.993976,25,166,1,165,1,1,0,1,1,78,77,88,88,81
"7663",62,"[25]wJHglqIHcdKocJvcGHqxdCGln",166,0.994012,25,167,1,166,1,1,0,1,1,82,81,85,85,81
"7664",63,"[25]wJHglqIHcdKocJvcGHqxdCGln",167,0.994048,25,168,1,167,1,1,0,1,1,86,85,82,82,81
"7665",64,"[25]wJHglqIHcdKocJvcGHqxdCGln",167,0.994048,25,168,1,167,1,1,0,1,1,85,84,83,83,81
"7666",65,"[25]wJHglqIHcdKocJvcGHqxdCGln",170,0.994152,25,171,1,170,1,1,0,1,1,94,93,77,77,81
"7667",66,"[25]wJHglqIHcdKocJvcGHqxdCGln",167,0.994048,25,168,1,167,1,1,0,1,1,84,83,84,84,81
"7668",67,"[25]wJHglqIHcdKocJvcGHqxdCGln",165,0.993976,25,166,1,165,1,1,0,1,1,80,79,86,86,81
"7669",68,"[25]wJHglqIHcdKocJvcGHqxdCGln",163,0.993902,25,164,1,163,1,1,0,1,1,74,73,90,90,81
"7670",69,"[25]wJHglqIHcdKocJvcGHqxdCGln",169,0.994118,25,170,1,169,1,1,0,1,1,90,89,80,80,81
"7671",70,"[25]wJHglqIHcdKocJvcGHqxdCGln",170,0.994152,25,171,1,170,1,1,0,1,1,93,92,78,78,81
"7672",71,"[25]wJHglqIHcdKocJvcGHqxdCGln",168,0.994083,25,169,1,168,1,1,0,1,1,87,86,82,82,81
"7673",72,"[25]wJHglqIHcdKocJvcGHqxdCGln",166,0.994012,25,167,1,166,1,1,0,1,1,81,80,86,86,81
"7674",73,"[25]wJHglqIHcdKocJvcGHqxdCGln",165,0.993976,25,166,1,165,1,1,0,1,1,79,78,87,87,81
"7675",74,"[25]wJHglqIHcdKocJvcGHqxdCGln",166,0.994012,25,167,1,166,1,1,0,1,1,81,80,86,86,81
"7676",75,"[25]wJHglqIHcdKocJvcGHqxdCGln",167,0.994048,25,168,1,167,1,1,0,1,1,84,83,84,84,81
"7677",76,"[25]wJHglqIHcdKocJvcGHqxdCGln",162,0.993865,25,163,1,162,1,1,0,1,1,71,70,92,92,81
"7678",77,"[25]wJHglqIHcdKocJvcGHqxdCGln",176,0.99435,25,177,1,176,1,1,0,1,1,108,107,69,69,81
"7679",78,"[25]wJHglqIHcdKocJvcGHqxdCGln",164,0.993939,25,165,1,164,1,1,0,1,1,77,76,88,88,81
"7680",79,"[25]wJHglqIHcdKocJvcGHqxdCGln",167,0.994048,25,168,1,167,1,1,0,1,1,84,83,84,84,81
"7681",80,"[25]wJHglqIHcdKocJvcGHqxdCGln",169,0.994118,25,170,1,169,1,1,0,1,1,91,90,79,79,81
"7682",81,"[25]wJHglqIHcdKocJvcGHqxdCGln",167,0.994048,25,168,1,167,1,1,0,1,1,82,81,86,86,81
"7683",82,"[25]wJHglqIHcdKocJvcGHqxdCGln",167,0.994048,25,168,1,167,1,1,0,1,1,84,83,84,84,81
"7684",83,"[25]wJHglqIHcdKocJvcGHqxdCGln",168,0.994083,25,169,1,168,1,1,0,1,1,87,86,82,82,81
"7685",84,"[25]wJHglqIHcdKocJvcGHqxdCGln",163,0.993902,25,164,1,163,1,1,0,1,1,75,74,89,89,81
"7686",85,"[25]wJHglqIHcdKocJvcGHqxdCGln",165,0.993976,25,166,1,165,1,1,0,1,1,80,79,86,86,81
"7687",86,"[25]wJHglqIHcdKocJvcGHqxdCGln",164,0.993939,25,165,1,164,1,1,0,1,1,77,76,88,88,81
"7688",87,"[25]wJHglqIHcdKocJvcGHqxdCGln",166,0.994012,25,167,1,166,1,1,0,1,1,82,81,85,85,81
"7689",88,"[25]wJHglqIHcdKocJvcGHqxdCGln",167,0.994048,25,168,1,167,1,1,0,1,1,85,84,83,83,81
"7690",89,"[25]wJHglqIHcdKocJvcGHqxdCGln",164,0.993939,25,165,1,164,1,1,0,1,1,76,75,89,89,81
"7691",90,"[25]wJHglqIHcdKocJvcGHqxdCGln",172,0.99422,25,173,1,172,1,1,0,1,1,96,95,77,77,81
"7692",91,"[25]wJHglqIHcdKocJvcGHqxdCGln",171,0.994186,25,172,1,171,1,1,0,1,1,96,95,76,76,81
"7693",92,"[25]wJHglqIHcdKocJvcGHqxdCGln",163,0.993902,25,164,1,163,1,1,0,1,1,75,74,89,89,81
"7694",93,"[25]wJHglqIHcdKocJvcGHqxdCGln",169,0.994118,25,170,1,169,1,1,0,1,1,88,87,82,82,81
"7695",94,"[25]wJHglqIHcdKocJvcGHqxdCGln",167,0.994048,25,168,1,167,1,1,0,1,1,85,84,83,83,81
"7696",95,"[25]wJHglqIHcdKocJvcGHqxdCGln",173,0.994253,25,174,1,173,1,1,0,1,1,97,96,77,77,81
"7697",96,"[25]wJHglqIHcdKocJvcGHqxdCGln",169,0.994118,25,170,1,169,1,1,0,1,1,90,89,80,80,81
"7698",97,"[25]wJHglqIHcdKocJvcGHqxdCGln",174,0.994286,25,175,1,174,1,1,0,1,1,103,102,72,72,81
"7699",98,"[25]wJHglqIHcdKocJvcGHqxdCGln",171,0.994186,25,172,1,171,1,1,0,1,1,97,96,75,75,81
"7700",99,"[25]wJHglqIHcdKocJvcGHqxdCGln",162,0.993865,25,163,1,162,1,1,0,1,1,69,68,94,94,81
"7701",0,"[27]EJHiqIHcdKocJvcGHqxdCueenbF",166,0.994012,27,167,1,166,1,1,0,1,1,82,81,85,85,82
"7702",1,"[27]EJHiqIHcdKocJvcGHqxdCueenbF",169,0.994118,27,170,1,169,1,1,0,1,1,91,90,79,79,82
"7703",2,"[27]EJHiqIHcdKocJvcGHqxdCueenbF",169,0.994118,27,170,1,169,1,1,0,1,1,86,85,84,84,82
"7704",3,"[27]EJHiqIHcdKocJvcGHqxdCueenbF",162,0.993865,27,163,1,162,1,1,0,1,1,70,69,93,93,82
"7705",4,"[27]EJHiqIHcdKocJvcGHqxdCueenbF",170,0.994152,27,171,1,170,1,1,0,1,1,91,90,80,80,82
"7706",5,"[27]EJHiqIHcdKocJvcGHqxdCueenbF",164,0.993939,27,165,1,164,1,1,0,1,1,77,76,88,88,82
"7707",6,"[27]EJHiqIHcdKocJvcGHqxdCueenbF",165,0.993976,27,166,1,165,1,1,0,1,1,79,78,87,87,82
"7708",7,"[27]EJHiqIHcdKocJvcGHqxdCueenbF",171,0.994186,27,172,1,171,1,1,0,1,1,93,92,79,79,82
"7709",8,"[27]EJHiqIHcdKocJvcGHqxdCueenbF",169,0.994118,27,170,1,169,1,1,0,1,1,89,88,81,81,82
"7710",9,"[27]EJHiqIHcdKocJvcGHqxdCueenbF",166,0.994012,27,167,1,166,1,1,0,1,1,80,79,87,87,82
"7711",10,"[27]EJHiqIHcdKocJvcGHqxdCueenbF",169,0.994118,27,170,1,169,1,1,0,1,1,88,87,82,82,82
"7712",11,"[27]EJHiqIHcdKocJvcGHqxdCueenbF",169,0.994118,27,170,1,169,1,1,0,1,1,89,88,81,81,82
"7713",12,"[27]EJHiqIHcdKocJvcGHqxdCueenbF",168,0.994083,27,169,1,168,1,1,0,1,1,87,86,82,82,82
"7714",13,"[27]EJHiqIHcdKocJvcGHqxdCueenbF",170,0.994152,27,171,1,170,1,1,0,1,1,92,91,79,79,82
"7715",14,"[27]EJHiqIHcdKocJvcGHqxdCueenbF",170,0.994152,27,171,1,170,1,1,0,1,1,91,90,80,80,82
"7716",15,"[27]EJHiqIHcdKocJvcGHqxdCueenbF",169,0.994118,27,170,1,169,1,1,0,1,1,88,87,82,82,82
"7717",16,"[27]EJHiqIHcdKocJvcGHqxdCueenbF",171,0.994186,27,172,1,171,1,1,0,1,1,95,94,77,77,82
"7718",17,"[27]EJHiqIHcdKocJvcGHqxdCueenbF",171,0.994186,27,172,1,171,1,1,0,1,1,94,93,78,78,82
"7719",18,"[27]EJHiqIHcdKocJvcGHqxdCueenbF",169,0.994118,27,170,1,169,1,1,0,1,1,90,89,80,80,82
"7720",19,"[27]EJHiqIHcdKocJvcGHqxdCueenbF",164,0.993939,27,165,1,164,1,1,0,1,1,75,74,90,90,82
"7721",20,"[27]EJHiqIHcdKocJvcGHqxdCueenbF",168,0.994083,27,169,1,168,1,1,0,1,1,88,87,81,81,82
"7722",21,"[27]EJHiqIHcdKocJvcGHqxdCueenbF",164,0.993939,27,165,1,164,1,1,0,1,1,75,74,90,90,82
"7723",22,"[27]EJHiqIHcdKocJvcGHqxdCueenbF",168,0.994083,27,169,1,168,1,1,0,1,1,84,83,85,85,82
"7724",23,"[27]EJHiqIHcdKocJvcGHqxdCueenbF",171,0.994186,27,172,1,171,1,1,0,1,1,95,94,77,77,82
"7725",24,"[27]EJHiqIHcdKocJvcGHqxdCueenbF",170,0.994152,27,171,1,170,1,1,0,1,1,91,90,80,80,82
"7726",25,"[27]EJHiqIHcdKocJvcGHqxdCueenbF",165,0.993976,27,166,1,165,1,1,0,1,1,78,77,88,88,82
"7727",26,"[27]EJHiqIHcdKocJvcGHqxdCueenbF",172,0.99422,27,173,1,172,1,1,0,1,1,98,97,75,75,82
"7728",27,"[27]EJHiqIHcdKocJvcGHqxdCueenbF",167,0.994048,27,168,1,167,1,1,0,1,1,85,84,83,83,82
"7729",28,"[27]EJHiqIHcdKocJvcGHqxdCueenbF",171,0.994186,27,172,1,171,1,1,0,1,1,95,94,77,77,82
"7730",29,"[27]EJHiqIHcdKocJvcGHqxdCueenbF",172,0.99422,27,173,1,172,1,1,0,1,1,95,94,78,78,82
"7731",30,"[27]EJHiqIHcdKocJvcGHqxdCueenbF",170,0.994152,27,171,1,170,1,1,0,1,1,92,91,79,79,82
"7732",31,"[27]EJHiqIHcdKocJvcGHqxdCueenbF",164,0.993939,27,165,1,164,1,1,0,1,1,76,75,89,89,82
"7733",32,"[27]EJHiqIHcdKocJvcGHqxdCueenbF",166,0.994012,27,167,1,166,1,1,0,1,1,82,81,85,85,82
"7734",33,"[27]EJHiqIHcdKocJvcGHqxdCueenbF",168,0.994083,27,169,1,168,1,1,0,1,1,87,86,82,82,82
"7735",34,"[27]EJHiqIHcdKocJvcGHqxdCueenbF",160,0.993789,27,161,1,160,1,1,0,1,1,66,65,95,95,82
"7736",35,"[27]EJHiqIHcdKocJvcGHqxdCueenbF",172,0.99422,27,173,1,172,1,1,0,1,1,99,98,74,74,82
"7737",36,"[27]EJHiqIHcdKocJvcGHqxdCueenbF",169,0.994118,27,170,1,169,1,1,0,1,1,90,89,80,80,82
"7738",37,"[27]EJHiqIHcdKocJvcGHqxdCueenbF",165,0.993976,27,166,1,165,1,1,0,1,1,78,77,88,88,82
"7739",38,"[27]EJHiqIHcdKocJvcGHqxdCueenbF",163,0.993902,27,164,1,163,1,1,0,1,1,70,69,94,94,82
"7740",39,"[27]EJHiqIHcdKocJvcGHqxdCueenbF",165,0.993976,27,166,1,165,1,1,0,1,1,78,77,88,88,82
"7741",40,"[27]EJHiqIHcdKocJvcGHqxdCueenbF",166,0.994012,27,167,1,166,1,1,0,1,1,83,82,84,84,82
"7742",41,"[27]EJHiqIHcdKocJvcGHqxdCueenbF",169,0.994118,27,170,1,169,1,1,0,1,1,90,89,80,80,82
"7743",42,"[27]EJHiqIHcdKocJvcGHqxdCueenbF",169,0.994118,27,170,1,169,1,1,0,1,1,90,89,80,80,82
"7744",43,"[27]EJHiqIHcdKocJvcGHqxdCueenbF",166,0.994012,27,167,1,166,1,1,0,1,1,82,81,85,85,82
"7745",44,"[27]EJHiqIHcdKocJvcGHqxdCueenbF",169,0.994118,27,170,1,169,1,1,0,1,1,90,89,80,80,82
"7746",45,"[27]EJHiqIHcdKocJvcGHqxdCueenbF",170,0.994152,27,171,1,170,1,1,0,1,1,93,92,78,78,82
"7747",46,"[27]EJHiqIHcdKocJvcGHqxdCueenbF",168,0.994083,27,169,1,168,1,1,0,1,1,86,85,83,83,82
"7748",47,"[27]EJHiqIHcdKocJvcGHqxdCueenbF",168,0.994083,27,169,1,168,1,1,0,1,1,88,87,81,81,82
"7749",48,"[27]EJHiqIHcdKocJvcGHqxdCueenbF",170,0.994152,27,171,1,170,1,1,0,1,1,93,92,78,78,82
"7750",49,"[27]EJHiqIHcdKocJvcGHqxdCueenbF",164,0.993939,27,165,1,164,1,1,0,1,1,77,76,88,88,82
"7751",50,"[27]EJHiqIHcdKocJvcGHqxdCueenbF",163,0.993902,27,164,1,163,1,1,0,1,1,72,71,92,92,82
"7752",51,"[27]EJHiqIHcdKocJvcGHqxdCueenbF",164,0.993939,27,165,1,164,1,1,0,1,1,75,74,90,90,82
"7753",52,"[27]EJHiqIHcdKocJvcGHqxdCueenbF",165,0.993976,27,166,1,165,1,1,0,1,1,78,77,88,88,82
"7754",53,"[27]EJHiqIHcdKocJvcGHqxdCueenbF",166,0.994012,27,167,1,166,1,1,0,1,1,81,80,86,86,82
"7755",54,"[27]EJHiqIHcdKocJvcGHqxdCueenbF",164,0.993939,27,165,1,164,1,1,0,1,1,76,75,89,89,82
"7756",55,"[27]EJHiqIHcdKocJvcGHqxdCueenbF",169,0.994118,27,170,1,169,1,1,0,1,1,89,88,81,81,82
"7757",56,"[27]EJHiqIHcdKocJvcGHqxdCueenbF",167,0.994048,27,168,1,167,1,1,0,1,1,83,82,85,85,82
"7758",57,"[27]EJHiqIHcdKocJvcGHqxdCueenbF",169,0.994118,27,170,1,169,1,1,0,1,1,89,88,81,81,82
"7759",58,"[27]EJHiqIHcdKocJvcGHqxdCueenbF",165,0.993976,27,166,1,165,1,1,0,1,1,78,77,88,88,82
"7760",59,"[27]EJHiqIHcdKocJvcGHqxdCueenbF",168,0.994083,27,169,1,168,1,1,0,1,1,88,87,81,81,82
"7761",60,"[27]EJHiqIHcdKocJvcGHqxdCueenbF",164,0.993939,27,165,1,164,1,1,0,1,1,77,76,88,88,82
"7762",61,"[27]EJHiqIHcdKocJvcGHqxdCueenbF",166,0.994012,27,167,1,166,1,1,0,1,1,83,82,84,84,82
"7763",62,"[27]EJHiqIHcdKocJvcGHqxdCueenbF",165,0.993976,27,166,1,165,1,1,0,1,1,80,79,86,86,82
"7764",63,"[27]EJHiqIHcdKocJvcGHqxdCueenbF",162,0.993865,27,163,1,162,1,1,0,1,1,71,70,92,92,82
"7765",64,"[27]EJHiqIHcdKocJvcGHqxdCueenbF",163,0.993902,27,164,1,163,1,1,0,1,1,71,70,93,93,82
"7766",65,"[27]EJHiqIHcdKocJvcGHqxdCueenbF",166,0.994012,27,167,1,166,1,1,0,1,1,83,82,84,84,82
"7767",66,"[27]EJHiqIHcdKocJvcGHqxdCueenbF",162,0.993865,27,163,1,162,1,1,0,1,1,69,68,94,94,82
"7768",67,"[27]EJHiqIHcdKocJvcGHqxdCueenbF",163,0.993902,27,164,1,163,1,1,0,1,1,74,73,90,90,82
"7769",68,"[27]EJHiqIHcdKocJvcGHqxdCueenbF",166,0.994012,27,167,1,166,1,1,0,1,1,83,82,84,84,82
"7770",69,"[27]EJHiqIHcdKocJvcGHqxdCueenbF",171,0.994186,27,172,1,171,1,1,0,1,1,95,94,77,77,82
"7771",70,"[27]EJHiqIHcdKocJvcGHqxdCueenbF",168,0.994083,27,169,1,168,1,1,0,1,1,83,82,86,86,82
"7772",71,"[27]EJHiqIHcdKocJvcGHqxdCueenbF",165,0.993976,27,166,1,165,1,1,0,1,1,77,76,89,89,82
"7773",72,"[27]EJHiqIHcdKocJvcGHqxdCueenbF",164,0.993939,27,165,1,164,1,1,0,1,1,76,75,89,89,82
"7774",73,"[27]EJHiqIHcdKocJvcGHqxdCueenbF",169,0.994118,27,170,1,169,1,1,0,1,1,89,88,81,81,82
"7775",74,"[27]EJHiqIHcdKocJvcGHqxdCueenbF",165,0.993976,27,166,1,165,1,1,0,1,1,78,77,88,88,82
"7776",75,"[27]EJHiqIHcdKocJvcGHqxdCueenbF",166,0.994012,27,167,1,166,1,1,0,1,1,80,79,87,87,82
"7777",76,"[27]EJHiqIHcdKocJvcGHqxdCueenbF",169,0.994118,27,170,1,169,1,1,0,1,1,88,87,82,82,82
"7778",77,"[27]EJHiqIHcdKocJvcGHqxdCueenbF",170,0.994152,27,171,1,170,1,1,0,1,1,93,92,78,78,82
"7779",78,"[27]EJHiqIHcdKocJvcGHqxdCueenbF",172,0.99422,27,173,1,172,1,1,0,1,1,99,98,74,74,82
"7780",79,"[27]EJHiqIHcdKocJvcGHqxdCueenbF",166,0.994012,27,167,1,166,1,1,0,1,1,79,78,88,88,82
"7781",80,"[27]EJHiqIHcdKocJvcGHqxdCueenbF",168,0.994083,27,169,1,168,1,1,0,1,1,88,87,81,81,82
"7782",81,"[27]EJHiqIHcdKocJvcGHqxdCueenbF",168,0.994083,27,169,1,168,1,1,0,1,1,86,85,83,83,82
"7783",82,"[27]EJHiqIHcdKocJvcGHqxdCueenbF",165,0.993976,27,166,1,165,1,1,0,1,1,79,78,87,87,82
"7784",83,"[27]EJHiqIHcdKocJvcGHqxdCueenbF",166,0.994012,27,167,1,166,1,1,0,1,1,82,81,85,85,82
"7785",84,"[27]EJHiqIHcdKocJvcGHqxdCueenbF",162,0.993865,27,163,1,162,1,1,0,1,1,71,70,92,92,82
"7786",85,"[27]EJHiqIHcdKocJvcGHqxdCueenbF",170,0.994152,27,171,1,170,1,1,0,1,1,94,93,77,77,82
"7787",86,"[27]EJHiqIHcdKocJvcGHqxdCueenbF",167,0.994048,27,168,1,167,1,1,0,1,1,85,84,83,83,82
"7788",87,"[27]EJHiqIHcdKocJvcGHqxdCueenbF",170,0.994152,27,171,1,170,1,1,0,1,1,94,93,77,77,82
"7789",88,"[27]EJHiqIHcdKocJvcGHqxdCueenbF",165,0.993976,27,166,1,165,1,1,0,1,1,80,79,86,86,82
"7790",89,"[27]EJHiqIHcdKocJvcGHqxdCueenbF",169,0.994118,27,170,1,169,1,1,0,1,1,90,89,80,80,82
"7791",90,"[27]EJHiqIHcdKocJvcGHqxdCueenbF",168,0.994083,27,169,1,168,1,1,0,1,1,88,87,81,81,82
"7792",91,"[27]EJHiqIHcdKocJvcGHqxdCueenbF",166,0.994012,27,167,1,166,1,1,0,1,1,83,82,84,84,82
"7793",92,"[27]EJHiqIHcdKocJvcGHqxdCueenbF",166,0.994012,27,167,1,166,1,1,0,1,1,80,79,87,87,82
"7794",93,"[27]EJHiqIHcdKocJvcGHqxdCueenbF",171,0.994186,27,172,1,171,1,1,0,1,1,95,94,77,77,82
"7795",94,"[27]EJHiqIHcdKocJvcGHqxdCueenbF",166,0.994012,27,167,1,166,1,1,0,1,1,83,82,84,84,82
"7796",95,"[27]EJHiqIHcdKocJvcGHqxdCueenbF",168,0.994083,27,169,1,168,1,1,0,1,1,88,87,81,81,82
"7797",96,"[27]EJHiqIHcdKocJvcGHqxdCueenbF",170,0.994152,27,171,1,170,1,1,0,1,1,92,91,79,79,82
"7798",97,"[27]EJHiqIHcdKocJvcGHqxdCueenbF",167,0.994048,27,168,1,167,1,1,0,1,1,82,81,86,86,82
"7799",98,"[27]EJHiqIHcdKocJvcGHqxdCueenbF",169,0.994118,27,170,1,169,1,1,0,1,1,89,88,81,81,82
"7800",99,"[27]EJHiqIHcdKocJvcGHqxdCueenbF",158,0.993711,27,159,1,158,1,1,0,1,1,60,59,99,99,82
"7801",0,"[27]AJHggqIgHcidKpcJvcGHqFdCewA",179,0.994444,27,180,1,179,1,1,0,1,1,98,97,82,82,83
"7802",1,"[27]AJHggqIgHcidKpcJvcGHqFdCewA",174,0.994286,27,175,1,174,1,1,0,1,1,84,83,91,91,83
"7803",2,"[27]AJHggqIgHcidKpcJvcGHqFdCewA",175,0.994318,27,176,1,175,1,1,0,1,1,85,84,91,91,83
"7804",3,"[27]AJHggqIgHcidKpcJvcGHqFdCewA",180,0.994475,27,181,1,180,1,1,0,1,1,102,101,79,79,83
"7805",4,"[27]AJHggqIgHcidKpcJvcGHqFdCewA",178,0.994413,27,179,1,178,1,1,0,1,1,96,95,83,83,83
"7806",5,"[27]AJHggqIgHcidKpcJvcGHqFdCewA",175,0.994318,27,176,1,175,1,1,0,1,1,87,86,89,89,83
"7807",6,"[27]AJHggqIgHcidKpcJvcGHqFdCewA",177,0.994382,27,178,1,177,1,1,0,1,1,92,91,86,86,83
"7808",7,"[27]AJHggqIgHcidKpcJvcGHqFdCewA",177,0.994382,27,178,1,177,1,1,0,1,1,91,90,87,87,83
"7809",8,"[27]AJHggqIgHcidKpcJvcGHqFdCewA",177,0.994382,27,178,1,177,1,1,0,1,1,91,90,87,87,83
"7810",9,"[27]AJHggqIgHcidKpcJvcGHqFdCewA",176,0.99435,27,177,1,176,1,1,0,1,1,88,87,89,89,83
"7811",10,"[27]AJHggqIgHcidKpcJvcGHqFdCewA",173,0.994253,27,174,1,173,1,1,0,1,1,81,80,93,93,83
"7812",11,"[27]AJHggqIgHcidKpcJvcGHqFdCewA",176,0.99435,27,177,1,176,1,1,0,1,1,90,89,87,87,83
"7813",12,"[27]AJHggqIgHcidKpcJvcGHqFdCewA",182,0.994536,27,183,1,182,1,1,0,1,1,110,109,73,73,83
"7814",13,"[27]AJHggqIgHcidKpcJvcGHqFdCewA",178,0.994413,27,179,1,178,1,1,0,1,1,95,94,84,84,83
"7815",14,"[27]AJHggqIgHcidKpcJvcGHqFdCewA",172,0.99422,27,173,1,172,1,1,0,1,1,74,73,99,99,83
"7816",15,"[27]AJHggqIgHcidKpcJvcGHqFdCewA",175,0.994318,27,176,1,175,1,1,0,1,1,87,86,89,89,83
"7817",16,"[27]AJHggqIgHcidKpcJvcGHqFdCewA",176,0.99435,27,177,1,176,1,1,0,1,1,90,89,87,87,83
"7818",17,"[27]AJHggqIgHcidKpcJvcGHqFdCewA",172,0.99422,27,173,1,172,1,1,0,1,1,77,76,96,96,83
"7819",18,"[27]AJHggqIgHcidKpcJvcGHqFdCewA",178,0.994413,27,179,1,178,1,1,0,1,1,95,94,84,84,83
"7820",19,"[27]AJHggqIgHcidKpcJvcGHqFdCewA",175,0.994318,27,176,1,175,1,1,0,1,1,87,86,89,89,83
"7821",20,"[27]AJHggqIgHcidKpcJvcGHqFdCewA",178,0.994413,27,179,1,178,1,1,0,1,1,96,95,83,83,83
"7822",21,"[27]AJHggqIgHcidKpcJvcGHqFdCewA",173,0.994253,27,174,1,173,1,1,0,1,1,80,79,94,94,83
"7823",22,"[27]AJHggqIgHcidKpcJvcGHqFdCewA",176,0.99435,27,177,1,176,1,1,0,1,1,90,89,87,87,83
"7824",23,"[27]AJHggqIgHcidKpcJvcGHqFdCewA",176,0.99435,27,177,1,176,1,1,0,1,1,90,89,87,87,83
"7825",24,"[27]AJHggqIgHcidKpcJvcGHqFdCewA",177,0.994382,27,178,1,177,1,1,0,1,1,92,91,86,86,83
"7826",25,"[27]AJHggqIgHcidKpcJvcGHqFdCewA",174,0.994286,27,175,1,174,1,1,0,1,1,83,82,92,92,83
"7827",26,"[27]AJHggqIgHcidKpcJvcGHqFdCewA",176,0.99435,27,177,1,176,1,1,0,1,1,87,86,90,90,83
"7828",27,"[27]AJHggqIgHcidKpcJvcGHqFdCewA",174,0.994286,27,175,1,174,1,1,0,1,1,82,81,93,93,83
"7829",28,"[27]AJHggqIgHcidKpcJvcGHqFdCewA",173,0.994253,27,174,1,173,1,1,0,1,1,78,77,96,96,83
"7830",29,"[27]AJHggqIgHcidKpcJvcGHqFdCewA",174,0.994286,27,175,1,174,1,1,0,1,1,83,82,92,92,83
"7831",30,"[27]AJHggqIgHcidKpcJvcGHqFdCewA",173,0.994253,27,174,1,173,1,1,0,1,1,80,79,94,94,83
"7832",31,"[27]AJHggqIgHcidKpcJvcGHqFdCewA",176,0.99435,27,177,1,176,1,1,0,1,1,88,87,89,89,83
"7833",32,"[27]AJHggqIgHcidKpcJvcGHqFdCewA",178,0.994413,27,179,1,178,1,1,0,1,1,97,96,82,82,83
"7834",33,"[27]AJHggqIgHcidKpcJvcGHqFdCewA",182,0.994536,27,183,1,182,1,1,0,1,1,106,105,77,77,83
"7835",34,"[27]AJHggqIgHcidKpcJvcGHqFdCewA",174,0.994286,27,175,1,174,1,1,0,1,1,82,81,93,93,83
"7836",35,"[27]AJHggqIgHcidKpcJvcGHqFdCewA",177,0.994382,27,178,1,177,1,1,0,1,1,91,90,87,87,83
"7837",36,"[27]AJHggqIgHcidKpcJvcGHqFdCewA",178,0.994413,27,179,1,178,1,1,0,1,1,97,96,82,82,83
"7838",37,"[27]AJHggqIgHcidKpcJvcGHqFdCewA",172,0.99422,27,173,1,172,1,1,0,1,1,77,76,96,96,83
"7839",38,"[27]AJHggqIgHcidKpcJvcGHqFdCewA",176,0.99435,27,177,1,176,1,1,0,1,1,88,87,89,89,83
"7840",39,"[27]AJHggqIgHcidKpcJvcGHqFdCewA",176,0.99435,27,177,1,176,1,1,0,1,1,89,88,88,88,83
"7841",40,"[27]AJHggqIgHcidKpcJvcGHqFdCewA",180,0.994475,27,181,1,180,1,1,0,1,1,104,103,77,77,83
"7842",41,"[27]AJHggqIgHcidKpcJvcGHqFdCewA",173,0.994253,27,174,1,173,1,1,0,1,1,80,79,94,94,83
"7843",42,"[27]AJHggqIgHcidKpcJvcGHqFdCewA",174,0.994286,27,175,1,174,1,1,0,1,1,80,79,95,95,83
"7844",43,"[27]AJHggqIgHcidKpcJvcGHqFdCewA",174,0.994286,27,175,1,174,1,1,0,1,1,81,80,94,94,83
"7845",44,"[27]AJHggqIgHcidKpcJvcGHqFdCewA",177,0.994382,27,178,1,177,1,1,0,1,1,90,89,88,88,83
"7846",45,"[27]AJHggqIgHcidKpcJvcGHqFdCewA",176,0.99435,27,177,1,176,1,1,0,1,1,88,87,89,89,83
"7847",46,"[27]AJHggqIgHcidKpcJvcGHqFdCewA",172,0.99422,27,173,1,172,1,1,0,1,1,77,76,96,96,83
"7848",47,"[27]AJHggqIgHcidKpcJvcGHqFdCewA",174,0.994286,27,175,1,174,1,1,0,1,1,83,82,92,92,83
"7849",48,"[27]AJHggqIgHcidKpcJvcGHqFdCewA",176,0.99435,27,177,1,176,1,1,0,1,1,89,88,88,88,83
"7850",49,"[27]AJHggqIgHcidKpcJvcGHqFdCewA",175,0.994318,27,176,1,175,1,1,0,1,1,86,85,90,90,83
"7851",50,"[27]AJHggqIgHcidKpcJvcGHqFdCewA",175,0.994318,27,176,1,175,1,1,0,1,1,86,85,90,90,83
"7852",51,"[27]AJHggqIgHcidKpcJvcGHqFdCewA",180,0.994475,27,181,1,180,1,1,0,1,1,103,102,78,78,83
"7853",52,"[27]AJHggqIgHcidKpcJvcGHqFdCewA",179,0.994444,27,180,1,179,1,1,0,1,1,100,99,80,80,83
"7854",53,"[27]AJHggqIgHcidKpcJvcGHqFdCewA",177,0.994382,27,178,1,177,1,1,0,1,1,91,90,87,87,83
"7855",54,"[27]AJHggqIgHcidKpcJvcGHqFdCewA",175,0.994318,27,176,1,175,1,1,0,1,1,86,85,90,90,83
"7856",55,"[27]AJHggqIgHcidKpcJvcGHqFdCewA",176,0.99435,27,177,1,176,1,1,0,1,1,90,89,87,87,83
"7857",56,"[27]AJHggqIgHcidKpcJvcGHqFdCewA",177,0.994382,27,178,1,177,1,1,0,1,1,93,92,85,85,83
"7858",57,"[27]AJHggqIgHcidKpcJvcGHqFdCewA",179,0.994444,27,180,1,179,1,1,0,1,1,99,98,81,81,83
"7859",58,"[27]AJHggqIgHcidKpcJvcGHqFdCewA",177,0.994382,27,178,1,177,1,1,0,1,1,93,92,85,85,83
"7860",59,"[27]AJHggqIgHcidKpcJvcGHqFdCewA",176,0.99435,27,177,1,176,1,1,0,1,1,89,88,88,88,83
"7861",60,"[27]AJHggqIgHcidKpcJvcGHqFdCewA",174,0.994286,27,175,1,174,1,1,0,1,1,80,79,95,95,83
"7862",61,"[27]AJHggqIgHcidKpcJvcGHqFdCewA",176,0.99435,27,177,1,176,1,1,0,1,1,89,88,88,88,83
"7863",62,"[27]AJHggqIgHcidKpcJvcGHqFdCewA",180,0.994475,27,181,1,180,1,1,0,1,1,101,100,80,80,83
"7864",63,"[27]AJHggqIgHcidKpcJvcGHqFdCewA",174,0.994286,27,175,1,174,1,1,0,1,1,82,81,93,93,83
"7865",64,"[27]AJHggqIgHcidKpcJvcGHqFdCewA",174,0.994286,27,175,1,174,1,1,0,1,1,80,79,95,95,83
"7866",65,"[27]AJHggqIgHcidKpcJvcGHqFdCewA",181,0.994505,27,182,1,181,1,1,0,1,1,105,104,77,77,83
"7867",66,"[27]AJHggqIgHcidKpcJvcGHqFdCewA",177,0.994382,27,178,1,177,1,1,0,1,1,93,92,85,85,83
"7868",67,"[27]AJHggqIgHcidKpcJvcGHqFdCewA",179,0.994444,27,180,1,179,1,1,0,1,1,96,95,84,84,83
"7869",68,"[27]AJHggqIgHcidKpcJvcGHqFdCewA",176,0.99435,27,177,1,176,1,1,0,1,1,90,89,87,87,83
"7870",69,"[27]AJHggqIgHcidKpcJvcGHqFdCewA",180,0.994475,27,181,1,180,1,1,0,1,1,100,99,81,81,83
"7871",70,"[27]AJHggqIgHcidKpcJvcGHqFdCewA",179,0.994444,27,180,1,179,1,1,0,1,1,97,96,83,83,83
"7872",71,"[27]AJHggqIgHcidKpcJvcGHqFdCewA",174,0.994286,27,175,1,174,1,1,0,1,1,83,82,92,92,83
"7873",72,"[27]AJHggqIgHcidKpcJvcGHqFdCewA",178,0.994413,27,179,1,178,1,1,0,1,1,96,95,83,83,83
"7874",73,"[27]AJHggqIgHcidKpcJvcGHqFdCewA",175,0.994318,27,176,1,175,1,1,0,1,1,87,86,89,89,83
"7875",74,"[27]AJHggqIgHcidKpcJvcGHqFdCewA",177,0.994382,27,178,1,177,1,1,0,1,1,93,92,85,85,83
"7876",75,"[27]AJHggqIgHcidKpcJvcGHqFdCewA",177,0.994382,27,178,1,177,1,1,0,1,1,93,92,85,85,83
"7877",76,"[27]AJHggqIgHcidKpcJvcGHqFdCewA",175,0.994318,27,176,1,175,1,1,0,1,1,86,85,90,90,83
"7878",77,"[27]AJHggqIgHcidKpcJvcGHqFdCewA",178,0.994413,27,179,1,178,1,1,0,1,1,97,96,82,82,83
"7879",78,"[27]AJHggqIgHcidKpcJvcGHqFdCewA",177,0.994382,27,178,1,177,1,1,0,1,1,93,92,85,85,83
"7880",79,"[27]AJHggqIgHcidKpcJvcGHqFdCewA",174,0.994286,27,175,1,174,1,1,0,1,1,83,82,92,92,83
"7881",80,"[27]AJHggqIgHcidKpcJvcGHqFdCewA",178,0.994413,27,179,1,178,1,1,0,1,1,96,95,83,83,83
"7882",81,"[27]AJHggqIgHcidKpcJvcGHqFdCewA",178,0.994413,27,179,1,178,1,1,0,1,1,95,94,84,84,83
"7883",82,"[27]AJHggqIgHcidKpcJvcGHqFdCewA",176,0.99435,27,177,1,176,1,1,0,1,1,89,88,88,88,83
"7884",83,"[27]AJHggqIgHcidKpcJvcGHqFdCewA",176,0.99435,27,177,1,176,1,1,0,1,1,90,89,87,87,83
"7885",84,"[27]AJHggqIgHcidKpcJvcGHqFdCewA",176,0.99435,27,177,1,176,1,1,0,1,1,91,90,86,86,83
"7886",85,"[27]AJHggqIgHcidKpcJvcGHqFdCewA",175,0.994318,27,176,1,175,1,1,0,1,1,87,86,89,89,83
"7887",86,"[27]AJHggqIgHcidKpcJvcGHqFdCewA",177,0.994382,27,178,1,177,1,1,0,1,1,94,93,84,84,83
"7888",87,"[27]AJHggqIgHcidKpcJvcGHqFdCewA",175,0.994318,27,176,1,175,1,1,0,1,1,86,85,90,90,83
"7889",88,"[27]AJHggqIgHcidKpcJvcGHqFdCewA",180,0.994475,27,181,1,180,1,1,0,1,1,103,102,78,78,83
"7890",89,"[27]AJHggqIgHcidKpcJvcGHqFdCewA",172,0.99422,27,173,1,172,1,1,0,1,1,77,76,96,96,83
"7891",90,"[27]AJHggqIgHcidKpcJvcGHqFdCewA",178,0.994413,27,179,1,178,1,1,0,1,1,97,96,82,82,83
"7892",91,"[27]AJHggqIgHcidKpcJvcGHqFdCewA",177,0.994382,27,178,1,177,1,1,0,1,1,92,91,86,86,83
"7893",92,"[27]AJHggqIgHcidKpcJvcGHqFdCewA",177,0.994382,27,178,1,177,1,1,0,1,1,92,91,86,86,83
"7894",93,"[27]AJHggqIgHcidKpcJvcGHqFdCewA",178,0.994413,27,179,1,178,1,1,0,1,1,96,95,83,83,83
"7895",94,"[27]AJHggqIgHcidKpcJvcGHqFdCewA",176,0.99435,27,177,1,176,1,1,0,1,1,90,89,87,87,83
"7896",95,"[27]AJHggqIgHcidKpcJvcGHqFdCewA",178,0.994413,27,179,1,178,1,1,0,1,1,93,92,86,86,83
"7897",96,"[27]AJHggqIgHcidKpcJvcGHqFdCewA",174,0.994286,27,175,1,174,1,1,0,1,1,84,83,91,91,83
"7898",97,"[27]AJHggqIgHcidKpcJvcGHqFdCewA",176,0.99435,27,177,1,176,1,1,0,1,1,89,88,88,88,83
"7899",98,"[27]AJHggqIgHcidKpcJvcGHqFdCewA",175,0.994318,27,176,1,175,1,1,0,1,1,87,86,89,89,83
"7900",99,"[27]AJHggqIgHcidKpcJvcGHqFdCewA",176,0.99435,27,177,1,176,1,1,0,1,1,90,89,87,87,83
"7901",0,"[24]lJHggqIHcdKocJvcGHqwdCrn",168,0.994083,24,169,1,168,1,1,0,1,1,86,85,83,83,84
"7902",1,"[24]lJHggqIHcdKocJvcGHqwdCrn",170,0.994152,24,171,1,170,1,1,0,1,1,92,91,79,79,84
"7903",2,"[24]lJHggqIHcdKocJvcGHqwdCrn",170,0.994152,24,171,1,170,1,1,0,1,1,93,92,78,78,84
"7904",3,"[24]lJHggqIHcdKocJvcGHqwdCrn",168,0.994083,24,169,1,168,1,1,0,1,1,87,86,82,82,84
"7905",4,"[24]lJHggqIHcdKocJvcGHqwdCrn",167,0.994048,24,168,1,167,1,1,0,1,1,84,83,84,84,84
"7906",5,"[24]lJHggqIHcdKocJvcGHqwdCrn",169,0.994118,24,170,1,169,1,1,0,1,1,90,89,80,80,84
"7907",6,"[24]lJHggqIHcdKocJvcGHqwdCrn",163,0.993902,24,164,1,163,1,1,0,1,1,75,74,89,89,84
"7908",7,"[24]lJHggqIHcdKocJvcGHqwdCrn",167,0.994048,24,168,1,167,1,1,0,1,1,86,85,82,82,84
"7909",8,"[24]lJHggqIHcdKocJvcGHqwdCrn",169,0.994118,24,170,1,169,1,1,0,1,1,90,89,80,80,84
"7910",9,"[24]lJHggqIHcdKocJvcGHqwdCrn",168,0.994083,24,169,1,168,1,1,0,1,1,88,87,81,81,84
"7911",10,"[24]lJHggqIHcdKocJvcGHqwdCrn",167,0.994048,24,168,1,167,1,1,0,1,1,85,84,83,83,84
"7912",11,"[24]lJHggqIHcdKocJvcGHqwdCrn",170,0.994152,24,171,1,170,1,1,0,1,1,93,92,78,78,84
"7913",12,"[24]lJHggqIHcdKocJvcGHqwdCrn",162,0.993865,24,163,1,162,1,1,0,1,1,72,71,91,91,84
"7914",13,"[24]lJHggqIHcdKocJvcGHqwdCrn",166,0.994012,24,167,1,166,1,1,0,1,1,83,82,84,84,84
"7915",14,"[24]lJHggqIHcdKocJvcGHqwdCrn",164,0.993939,24,165,1,164,1,1,0,1,1,77,76,88,88,84
"7916",15,"[24]lJHggqIHcdKocJvcGHqwdCrn",162,0.993865,24,163,1,162,1,1,0,1,1,71,70,92,92,84
"7917",16,"[24]lJHggqIHcdKocJvcGHqwdCrn",166,0.994012,24,167,1,166,1,1,0,1,1,81,80,86,86,84
"7918",17,"[24]lJHggqIHcdKocJvcGHqwdCrn",166,0.994012,24,167,1,166,1,1,0,1,1,81,80,86,86,84
"7919",18,"[24]lJHggqIHcdKocJvcGHqwdCrn",167,0.994048,24,168,1,167,1,1,0,1,1,85,84,83,83,84
"7920",19,"[24]lJHggqIHcdKocJvcGHqwdCrn",166,0.994012,24,167,1,166,1,1,0,1,1,83,82,84,84,84
"7921",20,"[24]lJHggqIHcdKocJvcGHqwdCrn",168,0.994083,24,169,1,168,1,1,0,1,1,88,87,81,81,84
"7922",21,"[24]lJHggqIHcdKocJvcGHqwdCrn",162,0.993865,24,163,1,162,1,1,0,1,1,71,70,92,92,84
"7923",22,"[24]lJHggqIHcdKocJvcGHqwdCrn",165,0.993976,24,166,1,165,1,1,0,1,1,79,78,87,87,84
"7924",23,"[24]lJHggqIHcdKocJvcGHqwdCrn",167,0.994048,24,168,1,167,1,1,0,1,1,85,84,83,83,84
"7925",24,"[24]lJHggqIHcdKocJvcGHqwdCrn",170,0.994152,24,171,1,170,1,1,0,1,1,92,91,79,79,84
"7926",25,"[24]lJHggqIHcdKocJvcGHqwdCrn",168,0.994083,24,169,1,168,1,1,0,1,1,88,87,81,81,84
"7927",26,"[24]lJHggqIHcdKocJvcGHqwdCrn",166,0.994012,24,167,1,166,1,1,0,1,1,82,81,85,85,84
"7928",27,"[24]lJHggqIHcdKocJvcGHqwdCrn",165,0.993976,24,166,1,165,1,1,0,1,1,80,79,86,86,84
"7929",28,"[24]lJHggqIHcdKocJvcGHqwdCrn",169,0.994118,24,170,1,169,1,1,0,1,1,91,90,79,79,84
"7930",29,"[24]lJHggqIHcdKocJvcGHqwdCrn",166,0.994012,24,167,1,166,1,1,0,1,1,83,82,84,84,84
"7931",30,"[24]lJHggqIHcdKocJvcGHqwdCrn",170,0.994152,24,171,1,170,1,1,0,1,1,93,92,78,78,84
"7932",31,"[24]lJHggqIHcdKocJvcGHqwdCrn",170,0.994152,24,171,1,170,1,1,0,1,1,91,90,80,80,84
"7933",32,"[24]lJHggqIHcdKocJvcGHqwdCrn",165,0.993976,24,166,1,165,1,1,0,1,1,80,79,86,86,84
"7934",33,"[24]lJHggqIHcdKocJvcGHqwdCrn",167,0.994048,24,168,1,167,1,1,0,1,1,85,84,83,83,84
"7935",34,"[24]lJHggqIHcdKocJvcGHqwdCrn",172,0.99422,24,173,1,172,1,1,0,1,1,99,98,74,74,84
"7936",35,"[24]lJHggqIHcdKocJvcGHqwdCrn",168,0.994083,24,169,1,168,1,1,0,1,1,87,86,82,82,84
"7937",36,"[24]lJHggqIHcdKocJvcGHqwdCrn",166,0.994012,24,167,1,166,1,1,0,1,1,81,80,86,86,84
"7938",37,"[24]lJHggqIHcdKocJvcGHqwdCrn",166,0.994012,24,167,1,166,1,1,0,1,1,83,82,84,84,84
"7939",38,"[24]lJHggqIHcdKocJvcGHqwdCrn",166,0.994012,24,167,1,166,1,1,0,1,1,82,81,85,85,84
"7940",39,"[24]lJHggqIHcdKocJvcGHqwdCrn",164,0.993939,24,165,1,164,1,1,0,1,1,76,75,89,89,84
"7941",40,"[24]lJHggqIHcdKocJvcGHqwdCrn",169,0.994118,24,170,1,169,1,1,0,1,1,90,89,80,80,84
"7942",41,"[24]lJHggqIHcdKocJvcGHqwdCrn",170,0.994152,24,171,1,170,1,1,0,1,1,94,93,77,77,84
"7943",42,"[24]lJHggqIHcdKocJvcGHqwdCrn",164,0.993939,24,165,1,164,1,1,0,1,1,77,76,88,88,84
"7944",43,"[24]lJHggqIHcdKocJvcGHqwdCrn",169,0.994118,24,170,1,169,1,1,0,1,1,89,88,81,81,84
"7945",44,"[24]lJHggqIHcdKocJvcGHqwdCrn",165,0.993976,24,166,1,165,1,1,0,1,1,79,78,87,87,84
"7946",45,"[24]lJHggqIHcdKocJvcGHqwdCrn",172,0.99422,24,173,1,172,1,1,0,1,1,98,97,75,75,84
"7947",46,"[24]lJHggqIHcdKocJvcGHqwdCrn",165,0.993976,24,166,1,165,1,1,0,1,1,79,78,87,87,84
"7948",47,"[24]lJHggqIHcdKocJvcGHqwdCrn",166,0.994012,24,167,1,166,1,1,0,1,1,80,79,87,87,84
"7949",48,"[24]lJHggqIHcdKocJvcGHqwdCrn",170,0.994152,24,171,1,170,1,1,0,1,1,94,93,77,77,84
"7950",49,"[24]lJHggqIHcdKocJvcGHqwdCrn",170,0.994152,24,171,1,170,1,1,0,1,1,92,91,79,79,84
"7951",50,"[24]lJHggqIHcdKocJvcGHqwdCrn",168,0.994083,24,169,1,168,1,1,0,1,1,86,85,83,83,84
"7952",51,"[24]lJHggqIHcdKocJvcGHqwdCrn",163,0.993902,24,164,1,163,1,1,0,1,1,74,73,90,90,84
"7953",52,"[24]lJHggqIHcdKocJvcGHqwdCrn",169,0.994118,24,170,1,169,1,1,0,1,1,90,89,80,80,84
"7954",53,"[24]lJHggqIHcdKocJvcGHqwdCrn",170,0.994152,24,171,1,170,1,1,0,1,1,93,92,78,78,84
"7955",54,"[24]lJHggqIHcdKocJvcGHqwdCrn",169,0.994118,24,170,1,169,1,1,0,1,1,87,86,83,83,84
"7956",55,"[24]lJHggqIHcdKocJvcGHqwdCrn",160,0.993789,24,161,1,160,1,1,0,1,1,66,65,95,95,84
"7957",56,"[24]lJHggqIHcdKocJvcGHqwdCrn",167,0.994048,24,168,1,167,1,1,0,1,1,84,83,84,84,84
"7958",57,"[24]lJHggqIHcdKocJvcGHqwdCrn",167,0.994048,24,168,1,167,1,1,0,1,1,82,81,86,86,84
"7959",58,"[24]lJHggqIHcdKocJvcGHqwdCrn",168,0.994083,24,169,1,168,1,1,0,1,1,86,85,83,83,84
"7960",59,"[24]lJHggqIHcdKocJvcGHqwdCrn",168,0.994083,24,169,1,168,1,1,0,1,1,87,86,82,82,84
"7961",60,"[24]lJHggqIHcdKocJvcGHqwdCrn",161,0.993827,24,162,1,161,1,1,0,1,1,68,67,94,94,84
"7962",61,"[24]lJHggqIHcdKocJvcGHqwdCrn",167,0.994048,24,168,1,167,1,1,0,1,1,84,83,84,84,84
"7963",62,"[24]lJHggqIHcdKocJvcGHqwdCrn",165,0.993976,24,166,1,165,1,1,0,1,1,80,79,86,86,84
"7964",63,"[24]lJHggqIHcdKocJvcGHqwdCrn",170,0.994152,24,171,1,170,1,1,0,1,1,92,91,79,79,84
"7965",64,"[24]lJHggqIHcdKocJvcGHqwdCrn",166,0.994012,24,167,1,166,1,1,0,1,1,83,82,84,84,84
"7966",65,"[24]lJHggqIHcdKocJvcGHqwdCrn",166,0.994012,24,167,1,166,1,1,0,1,1,82,81,85,85,84
"7967",66,"[24]lJHggqIHcdKocJvcGHqwdCrn",169,0.994118,24,170,1,169,1,1,0,1,1,89,88,81,81,84
"7968",67,"[24]lJHggqIHcdKocJvcGHqwdCrn",168,0.994083,24,169,1,168,1,1,0,1,1,87,86,82,82,84
"7969",68,"[24]lJHggqIHcdKocJvcGHqwdCrn",169,0.994118,24,170,1,169,1,1,0,1,1,90,89,80,80,84
"7970",69,"[24]lJHggqIHcdKocJvcGHqwdCrn",163,0.993902,24,164,1,163,1,1,0,1,1,72,71,92,92,84
"7971",70,"[24]lJHggqIHcdKocJvcGHqwdCrn",165,0.993976,24,166,1,165,1,1,0,1,1,79,78,87,87,84
"7972",71,"[24]lJHggqIHcdKocJvcGHqwdCrn",162,0.993865,24,163,1,162,1,1,0,1,1,69,68,94,94,84
"7973",72,"[24]lJHggqIHcdKocJvcGHqwdCrn",162,0.993865,24,163,1,162,1,1,0,1,1,70,69,93,93,84
"7974",73,"[24]lJHggqIHcdKocJvcGHqwdCrn",171,0.994186,24,172,1,171,1,1,0,1,1,95,94,77,77,84
"7975",74,"[24]lJHggqIHcdKocJvcGHqwdCrn",166,0.994012,24,167,1,166,1,1,0,1,1,83,82,84,84,84
"7976",75,"[24]lJHggqIHcdKocJvcGHqwdCrn",164,0.993939,24,165,1,164,1,1,0,1,1,75,74,90,90,84
"7977",76,"[24]lJHggqIHcdKocJvcGHqwdCrn",162,0.993865,24,163,1,162,1,1,0,1,1,70,69,93,93,84
"7978",77,"[24]lJHggqIHcdKocJvcGHqwdCrn",169,0.994118,24,170,1,169,1,1,0,1,1,91,90,79,79,84
"7979",78,"[24]lJHggqIHcdKocJvcGHqwdCrn",163,0.993902,24,164,1,163,1,1,0,1,1,75,74,89,89,84
"7980",79,"[24]lJHggqIHcdKocJvcGHqwdCrn",165,0.993976,24,166,1,165,1,1,0,1,1,80,79,86,86,84
"7981",80,"[24]lJHggqIHcdKocJvcGHqwdCrn",163,0.993902,24,164,1,163,1,1,0,1,1,74,73,90,90,84
"7982",81,"[24]lJHggqIHcdKocJvcGHqwdCrn",163,0.993902,24,164,1,163,1,1,0,1,1,75,74,89,89,84
"7983",82,"[24]lJHggqIHcdKocJvcGHqwdCrn",166,0.994012,24,167,1,166,1,1,0,1,1,83,82,84,84,84
"7984",83,"[24]lJHggqIHcdKocJvcGHqwdCrn",166,0.994012,24,167,1,166,1,1,0,1,1,82,81,85,85,84
"7985",84,"[24]lJHggqIHcdKocJvcGHqwdCrn",169,0.994118,24,170,1,169,1,1,0,1,1,89,88,81,81,84
"7986",85,"[24]lJHggqIHcdKocJvcGHqwdCrn",163,0.993902,24,164,1,163,1,1,0,1,1,75,74,89,89,84
"7987",86,"[24]lJHggqIHcdKocJvcGHqwdCrn",168,0.994083,24,169,1,168,1,1,0,1,1,87,86,82,82,84
"7988",87,"[24]lJHggqIHcdKocJvcGHqwdCrn",169,0.994118,24,170,1,169,1,1,0,1,1,91,90,79,79,84
"7989",88,"[24]lJHggqIHcdKocJvcGHqwdCrn",171,0.994186,24,172,1,171,1,1,0,1,1,95,94,77,77,84
"7990",89,"[24]lJHggqIHcdKocJvcGHqwdCrn",164,0.993939,24,165,1,164,1,1,0,1,1,76,75,89,89,84
"7991",90,"[24]lJHggqIHcdKocJvcGHqwdCrn",169,0.994118,24,170,1,169,1,1,0,1,1,89,88,81,81,84
"7992",91,"[24]lJHggqIHcdKocJvcGHqwdCrn",168,0.994083,24,169,1,168,1,1,0,1,1,85,84,84,84,84
"7993",92,"[24]lJHggqIHcdKocJvcGHqwdCrn",167,0.994048,24,168,1,167,1,1,0,1,1,85,84,83,83,84
"7994",93,"[24]lJHggqIHcdKocJvcGHqwdCrn",167,0.994048,24,168,1,167,1,1,0,1,1,83,82,85,85,84
"7995",94,"[24]lJHggqIHcdKocJvcGHqwdCrn",165,0.993976,24,166,1,165,1,1,0,1,1,80,79,86,86,84
"7996",95,"[24]lJHggqIHcdKocJvcGHqwdCrn",167,0.994048,24,168,1,167,1,1,0,1,1,85,84,83,83,84
"7997",96,"[24]lJHggqIHcdKocJvcGHqwdCrn",167,0.994048,24,168,1,167,1,1,0,1,1,84,83,84,84,84
"7998",97,"[24]lJHggqIHcdKocJvcGHqwdCrn",169,0.994118,24,170,1,169,1,1,0,1,1,89,88,81,81,84
"7999",98,"[24]lJHggqIHcdKocJvcGHqwdCrn",166,0.994012,24,167,1,166,1,1,0,1,1,80,79,87,87,84
"8000",99,"[24]lJHggqIHcdKocJvcGHqwdCrn",169,0.994118,24,170,1,169,1,1,0,1,1,90,89,80,80,84
"8001",0,"[33]oJHglqxIEyHHcvidKpcJvcGHqFdCIgaee",178,0.994413,33,179,1,178,1,1,0,1,1,96,95,83,83,85
"8002",1,"[33]oJHglqxIEyHHcvidKpcJvcGHqFdCIgaee",174,0.994286,33,175,1,174,1,1,0,1,1,85,84,90,90,85
"8003",2,"[33]oJHglqxIEyHHcvidKpcJvcGHqFdCIgaee",175,0.994318,33,176,1,175,1,1,0,1,1,90,89,86,86,85
"8004",3,"[33]oJHglqxIEyHHcvidKpcJvcGHqFdCIgaee",175,0.994318,33,176,1,175,1,1,0,1,1,91,90,85,85,85
"8005",4,"[33]oJHglqxIEyHHcvidKpcJvcGHqFdCIgaee",175,0.994318,33,176,1,175,1,1,0,1,1,90,89,86,86,85
"8006",5,"[33]oJHglqxIEyHHcvidKpcJvcGHqFdCIgaee",173,0.994253,33,174,1,173,1,1,0,1,1,83,82,91,91,85
"8007",6,"[33]oJHglqxIEyHHcvidKpcJvcGHqFdCIgaee",175,0.994318,33,176,1,175,1,1,0,1,1,90,89,86,86,85
"8008",7,"[33]oJHglqxIEyHHcvidKpcJvcGHqFdCIgaee",170,0.994152,33,171,1,170,1,1,0,1,1,73,72,98,98,85
"8009",8,"[33]oJHglqxIEyHHcvidKpcJvcGHqFdCIgaee",172,0.99422,33,173,1,172,1,1,0,1,1,81,80,92,92,85
"8010",9,"[33]oJHglqxIEyHHcvidKpcJvcGHqFdCIgaee",173,0.994253,33,174,1,173,1,1,0,1,1,83,82,91,91,85
"8011",10,"[33]oJHglqxIEyHHcvidKpcJvcGHqFdCIgaee",174,0.994286,33,175,1,174,1,1,0,1,1,86,85,89,89,85
"8012",11,"[33]oJHglqxIEyHHcvidKpcJvcGHqFdCIgaee",181,0.994505,33,182,1,181,1,1,0,1,1,109,108,73,73,85
"8013",12,"[33]oJHglqxIEyHHcvidKpcJvcGHqFdCIgaee",178,0.994413,33,179,1,178,1,1,0,1,1,99,98,80,80,85
"8014",13,"[33]oJHglqxIEyHHcvidKpcJvcGHqFdCIgaee",176,0.99435,33,177,1,176,1,1,0,1,1,95,94,82,82,85
"8015",14,"[33]oJHglqxIEyHHcvidKpcJvcGHqFdCIgaee",174,0.994286,33,175,1,174,1,1,0,1,1,88,87,87,87,85
"8016",15,"[33]oJHglqxIEyHHcvidKpcJvcGHqFdCIgaee",172,0.99422,33,173,1,172,1,1,0,1,1,80,79,93,93,85
"8017",16,"[33]oJHglqxIEyHHcvidKpcJvcGHqFdCIgaee",170,0.994152,33,171,1,170,1,1,0,1,1,74,73,97,97,85
"8018",17,"[33]oJHglqxIEyHHcvidKpcJvcGHqFdCIgaee",174,0.994286,33,175,1,174,1,1,0,1,1,87,86,88,88,85
"8019",18,"[33]oJHglqxIEyHHcvidKpcJvcGHqFdCIgaee",177,0.994382,33,178,1,177,1,1,0,1,1,94,93,84,84,85
"8020",19,"[33]oJHglqxIEyHHcvidKpcJvcGHqFdCIgaee",178,0.994413,33,179,1,178,1,1,0,1,1,100,99,79,79,85
"8021",20,"[33]oJHglqxIEyHHcvidKpcJvcGHqFdCIgaee",171,0.994186,33,172,1,171,1,1,0,1,1,74,73,98,98,85
"8022",21,"[33]oJHglqxIEyHHcvidKpcJvcGHqFdCIgaee",170,0.994152,33,171,1,170,1,1,0,1,1,75,74,96,96,85
"8023",22,"[33]oJHglqxIEyHHcvidKpcJvcGHqFdCIgaee",172,0.99422,33,173,1,172,1,1,0,1,1,80,79,93,93,85
"8024",23,"[33]oJHglqxIEyHHcvidKpcJvcGHqFdCIgaee",175,0.994318,33,176,1,175,1,1,0,1,1,90,89,86,86,85
"8025",24,"[33]oJHglqxIEyHHcvidKpcJvcGHqFdCIgaee",177,0.994382,33,178,1,177,1,1,0,1,1,95,94,83,83,85
"8026",25,"[33]oJHglqxIEyHHcvidKpcJvcGHqFdCIgaee",174,0.994286,33,175,1,174,1,1,0,1,1,88,87,87,87,85
"8027",26,"[33]oJHglqxIEyHHcvidKpcJvcGHqFdCIgaee",174,0.994286,33,175,1,174,1,1,0,1,1,86,85,89,89,85
"8028",27,"[33]oJHglqxIEyHHcvidKpcJvcGHqFdCIgaee",178,0.994413,33,179,1,178,1,1,0,1,1,99,98,80,80,85
"8029",28,"[33]oJHglqxIEyHHcvidKpcJvcGHqFdCIgaee",179,0.994444,33,180,1,179,1,1,0,1,1,104,103,76,76,85
"8030",29,"[33]oJHglqxIEyHHcvidKpcJvcGHqFdCIgaee",173,0.994253,33,174,1,173,1,1,0,1,1,83,82,91,91,85
"8031",30,"[33]oJHglqxIEyHHcvidKpcJvcGHqFdCIgaee",173,0.994253,33,174,1,173,1,1,0,1,1,83,82,91,91,85
"8032",31,"[33]oJHglqxIEyHHcvidKpcJvcGHqFdCIgaee",173,0.994253,33,174,1,173,1,1,0,1,1,84,83,90,90,85
"8033",32,"[33]oJHglqxIEyHHcvidKpcJvcGHqFdCIgaee",173,0.994253,33,174,1,173,1,1,0,1,1,85,84,89,89,85
"8034",33,"[33]oJHglqxIEyHHcvidKpcJvcGHqFdCIgaee",179,0.994444,33,180,1,179,1,1,0,1,1,104,103,76,76,85
"8035",34,"[33]oJHglqxIEyHHcvidKpcJvcGHqFdCIgaee",172,0.99422,33,173,1,172,1,1,0,1,1,80,79,93,93,85
"8036",35,"[33]oJHglqxIEyHHcvidKpcJvcGHqFdCIgaee",174,0.994286,33,175,1,174,1,1,0,1,1,86,85,89,89,85
"8037",36,"[33]oJHglqxIEyHHcvidKpcJvcGHqFdCIgaee",170,0.994152,33,171,1,170,1,1,0,1,1,74,73,97,97,85
"8038",37,"[33]oJHglqxIEyHHcvidKpcJvcGHqFdCIgaee",174,0.994286,33,175,1,174,1,1,0,1,1,85,84,90,90,85
"8039",38,"[33]oJHglqxIEyHHcvidKpcJvcGHqFdCIgaee",173,0.994253,33,174,1,173,1,1,0,1,1,82,81,92,92,85
"8040",39,"[33]oJHglqxIEyHHcvidKpcJvcGHqFdCIgaee",179,0.994444,33,180,1,179,1,1,0,1,1,102,101,78,78,85
"8041",40,"[33]oJHglqxIEyHHcvidKpcJvcGHqFdCIgaee",172,0.99422,33,173,1,172,1,1,0,1,1,81,80,92,92,85
"8042",41,"[33]oJHglqxIEyHHcvidKpcJvcGHqFdCIgaee",177,0.994382,33,178,1,177,1,1,0,1,1,97,96,81,81,85
"8043",42,"[33]oJHglqxIEyHHcvidKpcJvcGHqFdCIgaee",175,0.994318,33,176,1,175,1,1,0,1,1,89,88,87,87,85
"8044",43,"[33]oJHglqxIEyHHcvidKpcJvcGHqFdCIgaee",175,0.994318,33,176,1,175,1,1,0,1,1,89,88,87,87,85
"8045",44,"[33]oJHglqxIEyHHcvidKpcJvcGHqFdCIgaee",177,0.994382,33,178,1,177,1,1,0,1,1,97,96,81,81,85
"8046",45,"[33]oJHglqxIEyHHcvidKpcJvcGHqFdCIgaee",176,0.99435,33,177,1,176,1,1,0,1,1,91,90,86,86,85
"8047",46,"[33]oJHglqxIEyHHcvidKpcJvcGHqFdCIgaee",176,0.99435,33,177,1,176,1,1,0,1,1,93,92,84,84,85
"8048",47,"[33]oJHglqxIEyHHcvidKpcJvcGHqFdCIgaee",173,0.994253,33,174,1,173,1,1,0,1,1,84,83,90,90,85
"8049",48,"[33]oJHglqxIEyHHcvidKpcJvcGHqFdCIgaee",175,0.994318,33,176,1,175,1,1,0,1,1,90,89,86,86,85
"8050",49,"[33]oJHglqxIEyHHcvidKpcJvcGHqFdCIgaee",172,0.99422,33,173,1,172,1,1,0,1,1,79,78,94,94,85
"8051",50,"[33]oJHglqxIEyHHcvidKpcJvcGHqFdCIgaee",175,0.994318,33,176,1,175,1,1,0,1,1,89,88,87,87,85
"8052",51,"[33]oJHglqxIEyHHcvidKpcJvcGHqFdCIgaee",176,0.99435,33,177,1,176,1,1,0,1,1,94,93,83,83,85
"8053",52,"[33]oJHglqxIEyHHcvidKpcJvcGHqFdCIgaee",174,0.994286,33,175,1,174,1,1,0,1,1,86,85,89,89,85
"8054",53,"[33]oJHglqxIEyHHcvidKpcJvcGHqFdCIgaee",179,0.994444,33,180,1,179,1,1,0,1,1,103,102,77,77,85
"8055",54,"[33]oJHglqxIEyHHcvidKpcJvcGHqFdCIgaee",178,0.994413,33,179,1,178,1,1,0,1,1,101,100,78,78,85
"8056",55,"[33]oJHglqxIEyHHcvidKpcJvcGHqFdCIgaee",170,0.994152,33,171,1,170,1,1,0,1,1,70,69,101,101,85
"8057",56,"[33]oJHglqxIEyHHcvidKpcJvcGHqFdCIgaee",170,0.994152,33,171,1,170,1,1,0,1,1,72,71,99,99,85
"8058",57,"[33]oJHglqxIEyHHcvidKpcJvcGHqFdCIgaee",176,0.99435,33,177,1,176,1,1,0,1,1,94,93,83,83,85
"8059",58,"[33]oJHglqxIEyHHcvidKpcJvcGHqFdCIgaee",176,0.99435,33,177,1,176,1,1,0,1,1,92,91,85,85,85
"8060",59,"[33]oJHglqxIEyHHcvidKpcJvcGHqFdCIgaee",178,0.994413,33,179,1,178,1,1,0,1,1,99,98,80,80,85
"8061",60,"[33]oJHglqxIEyHHcvidKpcJvcGHqFdCIgaee",177,0.994382,33,178,1,177,1,1,0,1,1,96,95,82,82,85
"8062",61,"[33]oJHglqxIEyHHcvidKpcJvcGHqFdCIgaee",172,0.99422,33,173,1,172,1,1,0,1,1,79,78,94,94,85
"8063",62,"[33]oJHglqxIEyHHcvidKpcJvcGHqFdCIgaee",176,0.99435,33,177,1,176,1,1,0,1,1,94,93,83,83,85
"8064",63,"[33]oJHglqxIEyHHcvidKpcJvcGHqFdCIgaee",174,0.994286,33,175,1,174,1,1,0,1,1,83,82,92,92,85
"8065",64,"[33]oJHglqxIEyHHcvidKpcJvcGHqFdCIgaee",178,0.994413,33,179,1,178,1,1,0,1,1,100,99,79,79,85
"8066",65,"[33]oJHglqxIEyHHcvidKpcJvcGHqFdCIgaee",176,0.99435,33,177,1,176,1,1,0,1,1,92,91,85,85,85
"8067",66,"[33]oJHglqxIEyHHcvidKpcJvcGHqFdCIgaee",175,0.994318,33,176,1,175,1,1,0,1,1,91,90,85,85,85
"8068",67,"[33]oJHglqxIEyHHcvidKpcJvcGHqFdCIgaee",180,0.994475,33,181,1,180,1,1,0,1,1,108,107,73,73,85
"8069",68,"[33]oJHglqxIEyHHcvidKpcJvcGHqFdCIgaee",177,0.994382,33,178,1,177,1,1,0,1,1,98,97,80,80,85
"8070",69,"[33]oJHglqxIEyHHcvidKpcJvcGHqFdCIgaee",175,0.994318,33,176,1,175,1,1,0,1,1,91,90,85,85,85
"8071",70,"[33]oJHglqxIEyHHcvidKpcJvcGHqFdCIgaee",176,0.99435,33,177,1,176,1,1,0,1,1,95,94,82,82,85
"8072",71,"[33]oJHglqxIEyHHcvidKpcJvcGHqFdCIgaee",180,0.994475,33,181,1,180,1,1,0,1,1,107,106,74,74,85
"8073",72,"[33]oJHglqxIEyHHcvidKpcJvcGHqFdCIgaee",170,0.994152,33,171,1,170,1,1,0,1,1,75,74,96,96,85
"8074",73,"[33]oJHglqxIEyHHcvidKpcJvcGHqFdCIgaee",174,0.994286,33,175,1,174,1,1,0,1,1,86,85,89,89,85
"8075",74,"[33]oJHglqxIEyHHcvidKpcJvcGHqFdCIgaee",174,0.994286,33,175,1,174,1,1,0,1,1,87,86,88,88,85
"8076",75,"[33]oJHglqxIEyHHcvidKpcJvcGHqFdCIgaee",177,0.994382,33,178,1,177,1,1,0,1,1,94,93,84,84,85
"8077",76,"[33]oJHglqxIEyHHcvidKpcJvcGHqFdCIgaee",178,0.994413,33,179,1,178,1,1,0,1,1,97,96,82,82,85
"8078",77,"[33]oJHglqxIEyHHcvidKpcJvcGHqFdCIgaee",177,0.994382,33,178,1,177,1,1,0,1,1,95,94,83,83,85
"8079",78,"[33]oJHglqxIEyHHcvidKpcJvcGHqFdCIgaee",175,0.994318,33,176,1,175,1,1,0,1,1,89,88,87,87,85
"8080",79,"[33]oJHglqxIEyHHcvidKpcJvcGHqFdCIgaee",173,0.994253,33,174,1,173,1,1,0,1,1,84,83,90,90,85
"8081",80,"[33]oJHglqxIEyHHcvidKpcJvcGHqFdCIgaee",173,0.994253,33,174,1,173,1,1,0,1,1,84,83,90,90,85
"8082",81,"[33]oJHglqxIEyHHcvidKpcJvcGHqFdCIgaee",167,0.994048,33,168,1,167,1,1,0,1,1,63,62,105,105,85
"8083",82,"[33]oJHglqxIEyHHcvidKpcJvcGHqFdCIgaee",174,0.994286,33,175,1,174,1,1,0,1,1,85,84,90,90,85
"8084",83,"[33]oJHglqxIEyHHcvidKpcJvcGHqFdCIgaee",180,0.994475,33,181,1,180,1,1,0,1,1,105,104,76,76,85
"8085",84,"[33]oJHglqxIEyHHcvidKpcJvcGHqFdCIgaee",172,0.99422,33,173,1,172,1,1,0,1,1,80,79,93,93,85
"8086",85,"[33]oJHglqxIEyHHcvidKpcJvcGHqFdCIgaee",170,0.994152,33,171,1,170,1,1,0,1,1,75,74,96,96,85
"8087",86,"[33]oJHglqxIEyHHcvidKpcJvcGHqFdCIgaee",172,0.99422,33,173,1,172,1,1,0,1,1,81,80,92,92,85
"8088",87,"[33]oJHglqxIEyHHcvidKpcJvcGHqFdCIgaee",174,0.994286,33,175,1,174,1,1,0,1,1,86,85,89,89,85
"8089",88,"[33]oJHglqxIEyHHcvidKpcJvcGHqFdCIgaee",176,0.99435,33,177,1,176,1,1,0,1,1,92,91,85,85,85
"8090",89,"[33]oJHglqxIEyHHcvidKpcJvcGHqFdCIgaee",175,0.994318,33,176,1,175,1,1,0,1,1,88,87,88,88,85
"8091",90,"[33]oJHglqxIEyHHcvidKpcJvcGHqFdCIgaee",180,0.994475,33,181,1,180,1,1,0,1,1,107,106,74,74,85
"8092",91,"[33]oJHglqxIEyHHcvidKpcJvcGHqFdCIgaee",174,0.994286,33,175,1,174,1,1,0,1,1,88,87,87,87,85
"8093",92,"[33]oJHglqxIEyHHcvidKpcJvcGHqFdCIgaee",175,0.994318,33,176,1,175,1,1,0,1,1,90,89,86,86,85
"8094",93,"[33]oJHglqxIEyHHcvidKpcJvcGHqFdCIgaee",173,0.994253,33,174,1,173,1,1,0,1,1,83,82,91,91,85
"8095",94,"[33]oJHglqxIEyHHcvidKpcJvcGHqFdCIgaee",175,0.994318,33,176,1,175,1,1,0,1,1,88,87,88,88,85
"8096",95,"[33]oJHglqxIEyHHcvidKpcJvcGHqFdCIgaee",173,0.994253,33,174,1,173,1,1,0,1,1,84,83,90,90,85
"8097",96,"[33]oJHglqxIEyHHcvidKpcJvcGHqFdCIgaee",180,0.994475,33,181,1,180,1,1,0,1,1,104,103,77,77,85
"8098",97,"[33]oJHglqxIEyHHcvidKpcJvcGHqFdCIgaee",179,0.994444,33,180,1,179,1,1,0,1,1,102,101,78,78,85
"8099",98,"[33]oJHglqxIEyHHcvidKpcJvcGHqFdCIgaee",175,0.994318,33,176,1,175,1,1,0,1,1,90,89,86,86,85
"8100",99,"[33]oJHglqxIEyHHcvidKpcJvcGHqFdCIgaee",175,0.994318,33,176,1,175,1,1,0,1,1,90,89,86,86,85
"8101",0,"[31]cJHglqIjHBidKocJxcGHqFdCqjiytuw",178,0.994413,31,179,1,178,1,1,0,1,1,97,96,82,82,87
"8102",1,"[31]cJHglqIjHBidKocJxcGHqFdCqjiytuw",177,0.994382,31,178,1,177,1,1,0,1,1,92,91,86,86,87
"8103",2,"[31]cJHglqIjHBidKocJxcGHqFdCqjiytuw",176,0.99435,31,177,1,176,1,1,0,1,1,88,87,89,89,87
"8104",3,"[31]cJHglqIjHBidKocJxcGHqFdCqjiytuw",178,0.994413,31,179,1,178,1,1,0,1,1,97,96,82,82,87
"8105",4,"[31]cJHglqIjHBidKocJxcGHqFdCqjiytuw",176,0.99435,31,177,1,176,1,1,0,1,1,89,88,88,88,87
"8106",5,"[31]cJHglqIjHBidKocJxcGHqFdCqjiytuw",180,0.994475,31,181,1,180,1,1,0,1,1,101,100,80,80,87
"8107",6,"[31]cJHglqIjHBidKocJxcGHqFdCqjiytuw",173,0.994253,31,174,1,173,1,1,0,1,1,79,78,95,95,87
"8108",7,"[31]cJHglqIjHBidKocJxcGHqFdCqjiytuw",177,0.994382,31,178,1,177,1,1,0,1,1,94,93,84,84,87
"8109",8,"[31]cJHglqIjHBidKocJxcGHqFdCqjiytuw",176,0.99435,31,177,1,176,1,1,0,1,1,88,87,89,89,87
"8110",9,"[31]cJHglqIjHBidKocJxcGHqFdCqjiytuw",172,0.99422,31,173,1,172,1,1,0,1,1,77,76,96,96,87
"8111",10,"[31]cJHglqIjHBidKocJxcGHqFdCqjiytuw",177,0.994382,31,178,1,177,1,1,0,1,1,94,93,84,84,87
"8112",11,"[31]cJHglqIjHBidKocJxcGHqFdCqjiytuw",177,0.994382,31,178,1,177,1,1,0,1,1,92,91,86,86,87
"8113",12,"[31]cJHglqIjHBidKocJxcGHqFdCqjiytuw",176,0.99435,31,177,1,176,1,1,0,1,1,89,88,88,88,87
"8114",13,"[31]cJHglqIjHBidKocJxcGHqFdCqjiytuw",176,0.99435,31,177,1,176,1,1,0,1,1,88,87,89,89,87
"8115",14,"[31]cJHglqIjHBidKocJxcGHqFdCqjiytuw",175,0.994318,31,176,1,175,1,1,0,1,1,83,82,93,93,87
"8116",15,"[31]cJHglqIjHBidKocJxcGHqFdCqjiytuw",178,0.994413,31,179,1,178,1,1,0,1,1,95,94,84,84,87
"8117",16,"[31]cJHglqIjHBidKocJxcGHqFdCqjiytuw",179,0.994444,31,180,1,179,1,1,0,1,1,100,99,80,80,87
"8118",17,"[31]cJHglqIjHBidKocJxcGHqFdCqjiytuw",176,0.99435,31,177,1,176,1,1,0,1,1,91,90,86,86,87
"8119",18,"[31]cJHglqIjHBidKocJxcGHqFdCqjiytuw",176,0.99435,31,177,1,176,1,1,0,1,1,89,88,88,88,87
"8120",19,"[31]cJHglqIjHBidKocJxcGHqFdCqjiytuw",179,0.994444,31,180,1,179,1,1,0,1,1,101,100,79,79,87
"8121",20,"[31]cJHglqIjHBidKocJxcGHqFdCqjiytuw",176,0.99435,31,177,1,176,1,1,0,1,1,89,88,88,88,87
"8122",21,"[31]cJHglqIjHBidKocJxcGHqFdCqjiytuw",178,0.994413,31,179,1,178,1,1,0,1,1,97,96,82,82,87
"8123",22,"[31]cJHglqIjHBidKocJxcGHqFdCqjiytuw",177,0.994382,31,178,1,177,1,1,0,1,1,90,89,88,88,87
"8124",23,"[31]cJHglqIjHBidKocJxcGHqFdCqjiytuw",174,0.994286,31,175,1,174,1,1,0,1,1,83,82,92,92,87
"8125",24,"[31]cJHglqIjHBidKocJxcGHqFdCqjiytuw",184,0.994595,31,185,1,184,1,1,0,1,1,112,111,73,73,87
"8126",25,"[31]cJHglqIjHBidKocJxcGHqFdCqjiytuw",178,0.994413,31,179,1,178,1,1,0,1,1,97,96,82,82,87
"8127",26,"[31]cJHglqIjHBidKocJxcGHqFdCqjiytuw",180,0.994475,31,181,1,180,1,1,0,1,1,101,100,80,80,87
"8128",27,"[31]cJHglqIjHBidKocJxcGHqFdCqjiytuw",173,0.994253,31,174,1,173,1,1,0,1,1,80,79,94,94,87
"8129",28,"[31]cJHglqIjHBidKocJxcGHqFdCqjiytuw",174,0.994286,31,175,1,174,1,1,0,1,1,82,81,93,93,87
"8130",29,"[31]cJHglqIjHBidKocJxcGHqFdCqjiytuw",171,0.994186,31,172,1,171,1,1,0,1,1,73,72,99,99,87
"8131",30,"[31]cJHglqIjHBidKocJxcGHqFdCqjiytuw",173,0.994253,31,174,1,173,1,1,0,1,1,80,79,94,94,87
"8132",31,"[31]cJHglqIjHBidKocJxcGHqFdCqjiytuw",175,0.994318,31,176,1,175,1,1,0,1,1,85,84,91,91,87
"8133",32,"[31]cJHglqIjHBidKocJxcGHqFdCqjiytuw",178,0.994413,31,179,1,178,1,1,0,1,1,96,95,83,83,87
"8134",33,"[31]cJHglqIjHBidKocJxcGHqFdCqjiytuw",177,0.994382,31,178,1,177,1,1,0,1,1,91,90,87,87,87
"8135",34,"[31]cJHglqIjHBidKocJxcGHqFdCqjiytuw",175,0.994318,31,176,1,175,1,1,0,1,1,87,86,89,89,87
"8136",35,"[31]cJHglqIjHBidKocJxcGHqFdCqjiytuw",175,0.994318,31,176,1,175,1,1,0,1,1,85,84,91,91,87
"8137",36,"[31]cJHglqIjHBidKocJxcGHqFdCqjiytuw",177,0.994382,31,178,1,177,1,1,0,1,1,92,91,86,86,87
"8138",37,"[31]cJHglqIjHBidKocJxcGHqFdCqjiytuw",179,0.994444,31,180,1,179,1,1,0,1,1,99,98,81,81,87
"8139",38,"[31]cJHglqIjHBidKocJxcGHqFdCqjiytuw",177,0.994382,31,178,1,177,1,1,0,1,1,92,91,86,86,87
"8140",39,"[31]cJHglqIjHBidKocJxcGHqFdCqjiytuw",173,0.994253,31,174,1,173,1,1,0,1,1,79,78,95,95,87
"8141",40,"[31]cJHglqIjHBidKocJxcGHqFdCqjiytuw",175,0.994318,31,176,1,175,1,1,0,1,1,87,86,89,89,87
"8142",41,"[31]cJHglqIjHBidKocJxcGHqFdCqjiytuw",175,0.994318,31,176,1,175,1,1,0,1,1,85,84,91,91,87
"8143",42,"[31]cJHglqIjHBidKocJxcGHqFdCqjiytuw",175,0.994318,31,176,1,175,1,1,0,1,1,86,85,90,90,87
"8144",43,"[31]cJHglqIjHBidKocJxcGHqFdCqjiytuw",174,0.994286,31,175,1,174,1,1,0,1,1,84,83,91,91,87
"8145",44,"[31]cJHglqIjHBidKocJxcGHqFdCqjiytuw",175,0.994318,31,176,1,175,1,1,0,1,1,87,86,89,89,87
"8146",45,"[31]cJHglqIjHBidKocJxcGHqFdCqjiytuw",175,0.994318,31,176,1,175,1,1,0,1,1,86,85,90,90,87
"8147",46,"[31]cJHglqIjHBidKocJxcGHqFdCqjiytuw",172,0.99422,31,173,1,172,1,1,0,1,1,75,74,98,98,87
"8148",47,"[31]cJHglqIjHBidKocJxcGHqFdCqjiytuw",174,0.994286,31,175,1,174,1,1,0,1,1,83,82,92,92,87
"8149",48,"[31]cJHglqIjHBidKocJxcGHqFdCqjiytuw",173,0.994253,31,174,1,173,1,1,0,1,1,77,76,97,97,87
"8150",49,"[31]cJHglqIjHBidKocJxcGHqFdCqjiytuw",180,0.994475,31,181,1,180,1,1,0,1,1,103,102,78,78,87
"8151",50,"[31]cJHglqIjHBidKocJxcGHqFdCqjiytuw",180,0.994475,31,181,1,180,1,1,0,1,1,103,102,78,78,87
"8152",51,"[31]cJHglqIjHBidKocJxcGHqFdCqjiytuw",174,0.994286,31,175,1,174,1,1,0,1,1,81,80,94,94,87
"8153",52,"[31]cJHglqIjHBidKocJxcGHqFdCqjiytuw",179,0.994444,31,180,1,179,1,1,0,1,1,99,98,81,81,87
"8154",53,"[31]cJHglqIjHBidKocJxcGHqFdCqjiytuw",174,0.994286,31,175,1,174,1,1,0,1,1,83,82,92,92,87
"8155",54,"[31]cJHglqIjHBidKocJxcGHqFdCqjiytuw",175,0.994318,31,176,1,175,1,1,0,1,1,84,83,92,92,87
"8156",55,"[31]cJHglqIjHBidKocJxcGHqFdCqjiytuw",177,0.994382,31,178,1,177,1,1,0,1,1,91,90,87,87,87
"8157",56,"[31]cJHglqIjHBidKocJxcGHqFdCqjiytuw",178,0.994413,31,179,1,178,1,1,0,1,1,97,96,82,82,87
"8158",57,"[31]cJHglqIjHBidKocJxcGHqFdCqjiytuw",171,0.994186,31,172,1,171,1,1,0,1,1,74,73,98,98,87
"8159",58,"[31]cJHglqIjHBidKocJxcGHqFdCqjiytuw",173,0.994253,31,174,1,173,1,1,0,1,1,80,79,94,94,87
"8160",59,"[31]cJHglqIjHBidKocJxcGHqFdCqjiytuw",176,0.99435,31,177,1,176,1,1,0,1,1,90,89,87,87,87
"8161",60,"[31]cJHglqIjHBidKocJxcGHqFdCqjiytuw",174,0.994286,31,175,1,174,1,1,0,1,1,81,80,94,94,87
"8162",61,"[31]cJHglqIjHBidKocJxcGHqFdCqjiytuw",179,0.994444,31,180,1,179,1,1,0,1,1,98,97,82,82,87
"8163",62,"[31]cJHglqIjHBidKocJxcGHqFdCqjiytuw",175,0.994318,31,176,1,175,1,1,0,1,1,85,84,91,91,87
"8164",63,"[31]cJHglqIjHBidKocJxcGHqFdCqjiytuw",176,0.99435,31,177,1,176,1,1,0,1,1,89,88,88,88,87
"8165",64,"[31]cJHglqIjHBidKocJxcGHqFdCqjiytuw",179,0.994444,31,180,1,179,1,1,0,1,1,100,99,80,80,87
"8166",65,"[31]cJHglqIjHBidKocJxcGHqFdCqjiytuw",176,0.99435,31,177,1,176,1,1,0,1,1,90,89,87,87,87
"8167",66,"[31]cJHglqIjHBidKocJxcGHqFdCqjiytuw",173,0.994253,31,174,1,173,1,1,0,1,1,78,77,96,96,87
"8168",67,"[31]cJHglqIjHBidKocJxcGHqFdCqjiytuw",181,0.994505,31,182,1,181,1,1,0,1,1,104,103,78,78,87
"8169",68,"[31]cJHglqIjHBidKocJxcGHqFdCqjiytuw",179,0.994444,31,180,1,179,1,1,0,1,1,98,97,82,82,87
"8170",69,"[31]cJHglqIjHBidKocJxcGHqFdCqjiytuw",173,0.994253,31,174,1,173,1,1,0,1,1,79,78,95,95,87
"8171",70,"[31]cJHglqIjHBidKocJxcGHqFdCqjiytuw",173,0.994253,31,174,1,173,1,1,0,1,1,79,78,95,95,87
"8172",71,"[31]cJHglqIjHBidKocJxcGHqFdCqjiytuw",173,0.994253,31,174,1,173,1,1,0,1,1,79,78,95,95,87
"8173",72,"[31]cJHglqIjHBidKocJxcGHqFdCqjiytuw",179,0.994444,31,180,1,179,1,1,0,1,1,94,93,86,86,87
"8174",73,"[31]cJHglqIjHBidKocJxcGHqFdCqjiytuw",175,0.994318,31,176,1,175,1,1,0,1,1,83,82,93,93,87
"8175",74,"[31]cJHglqIjHBidKocJxcGHqFdCqjiytuw",175,0.994318,31,176,1,175,1,1,0,1,1,85,84,91,91,87
"8176",75,"[31]cJHglqIjHBidKocJxcGHqFdCqjiytuw",179,0.994444,31,180,1,179,1,1,0,1,1,99,98,81,81,87
"8177",76,"[31]cJHglqIjHBidKocJxcGHqFdCqjiytuw",177,0.994382,31,178,1,177,1,1,0,1,1,93,92,85,85,87
"8178",77,"[31]cJHglqIjHBidKocJxcGHqFdCqjiytuw",179,0.994444,31,180,1,179,1,1,0,1,1,101,100,79,79,87
"8179",78,"[31]cJHglqIjHBidKocJxcGHqFdCqjiytuw",178,0.994413,31,179,1,178,1,1,0,1,1,96,95,83,83,87
"8180",79,"[31]cJHglqIjHBidKocJxcGHqFdCqjiytuw",176,0.99435,31,177,1,176,1,1,0,1,1,88,87,89,89,87
"8181",80,"[31]cJHglqIjHBidKocJxcGHqFdCqjiytuw",173,0.994253,31,174,1,173,1,1,0,1,1,80,79,94,94,87
"8182",81,"[31]cJHglqIjHBidKocJxcGHqFdCqjiytuw",178,0.994413,31,179,1,178,1,1,0,1,1,94,93,85,85,87
"8183",82,"[31]cJHglqIjHBidKocJxcGHqFdCqjiytuw",174,0.994286,31,175,1,174,1,1,0,1,1,83,82,92,92,87
"8184",83,"[31]cJHglqIjHBidKocJxcGHqFdCqjiytuw",178,0.994413,31,179,1,178,1,1,0,1,1,96,95,83,83,87
"8185",84,"[31]cJHglqIjHBidKocJxcGHqFdCqjiytuw",178,0.994413,31,179,1,178,1,1,0,1,1,94,93,85,85,87
"8186",85,"[31]cJHglqIjHBidKocJxcGHqFdCqjiytuw",174,0.994286,31,175,1,174,1,1,0,1,1,82,81,93,93,87
"8187",86,"[31]cJHglqIjHBidKocJxcGHqFdCqjiytuw",177,0.994382,31,178,1,177,1,1,0,1,1,90,89,88,88,87
"8188",87,"[31]cJHglqIjHBidKocJxcGHqFdCqjiytuw",173,0.994253,31,174,1,173,1,1,0,1,1,81,80,93,93,87
"8189",88,"[31]cJHglqIjHBidKocJxcGHqFdCqjiytuw",179,0.994444,31,180,1,179,1,1,0,1,1,100,99,80,80,87
"8190",89,"[31]cJHglqIjHBidKocJxcGHqFdCqjiytuw",176,0.99435,31,177,1,176,1,1,0,1,1,90,89,87,87,87
"8191",90,"[31]cJHglqIjHBidKocJxcGHqFdCqjiytuw",176,0.99435,31,177,1,176,1,1,0,1,1,89,88,88,88,87
"8192",91,"[31]cJHglqIjHBidKocJxcGHqFdCqjiytuw",176,0.99435,31,177,1,176,1,1,0,1,1,89,88,88,88,87
"8193",92,"[31]cJHglqIjHBidKocJxcGHqFdCqjiytuw",178,0.994413,31,179,1,178,1,1,0,1,1,97,96,82,82,87
"8194",93,"[31]cJHglqIjHBidKocJxcGHqFdCqjiytuw",176,0.99435,31,177,1,176,1,1,0,1,1,89,88,88,88,87
"8195",94,"[31]cJHglqIjHBidKocJxcGHqFdCqjiytuw",176,0.99435,31,177,1,176,1,1,0,1,1,89,88,88,88,87
"8196",95,"[31]cJHglqIjHBidKocJxcGHqFdCqjiytuw",179,0.994444,31,180,1,179,1,1,0,1,1,98,97,82,82,87
"8197",96,"[31]cJHglqIjHBidKocJxcGHqFdCqjiytuw",178,0.994413,31,179,1,178,1,1,0,1,1,97,96,82,82,87
"8198",97,"[31]cJHglqIjHBidKocJxcGHqFdCqjiytuw",175,0.994318,31,176,1,175,1,1,0,1,1,86,85,90,90,87
"8199",98,"[31]cJHglqIjHBidKocJxcGHqFdCqjiytuw",173,0.994253,31,174,1,173,1,1,0,1,1,79,78,95,95,87
"8200",99,"[31]cJHglqIjHBidKocJxcGHqFdCqjiytuw",172,0.99422,31,173,1,172,1,1,0,1,1,77,76,96,96,87
"8201",0,"[26]tJHggqIHcdKocJvcGHqxdCgzKq",168,0.994083,26,169,1,168,1,1,0,1,1,86,85,83,83,88
"8202",1,"[26]tJHggqIHcdKocJvcGHqxdCgzKq",171,0.994186,26,172,1,171,1,1,0,1,1,96,95,76,76,88
"8203",2,"[26]tJHggqIHcdKocJvcGHqxdCgzKq",164,0.993939,26,165,1,164,1,1,0,1,1,76,75,89,89,88
"8204",3,"[26]tJHggqIHcdKocJvcGHqxdCgzKq",170,0.994152,26,171,1,170,1,1,0,1,1,93,92,78,78,88
"8205",4,"[26]tJHggqIHcdKocJvcGHqxdCgzKq",166,0.994012,26,167,1,166,1,1,0,1,1,83,82,84,84,88
"8206",5,"[26]tJHggqIHcdKocJvcGHqxdCgzKq",167,0.994048,26,168,1,167,1,1,0,1,1,86,85,82,82,88
"8207",6,"[26]tJHggqIHcdKocJvcGHqxdCgzKq",168,0.994083,26,169,1,168,1,1,0,1,1,86,85,83,83,88
"8208",7,"[26]tJHggqIHcdKocJvcGHqxdCgzKq",168,0.994083,26,169,1,168,1,1,0,1,1,86,85,83,83,88
"8209",8,"[26]tJHggqIHcdKocJvcGHqxdCgzKq",166,0.994012,26,167,1,166,1,1,0,1,1,81,80,86,86,88
"8210",9,"[26]tJHggqIHcdKocJvcGHqxdCgzKq",169,0.994118,26,170,1,169,1,1,0,1,1,89,88,81,81,88
"8211",10,"[26]tJHggqIHcdKocJvcGHqxdCgzKq",169,0.994118,26,170,1,169,1,1,0,1,1,90,89,80,80,88
"8212",11,"[26]tJHggqIHcdKocJvcGHqxdCgzKq",169,0.994118,26,170,1,169,1,1,0,1,1,89,88,81,81,88
"8213",12,"[26]tJHggqIHcdKocJvcGHqxdCgzKq",169,0.994118,26,170,1,169,1,1,0,1,1,91,90,79,79,88
"8214",13,"[26]tJHggqIHcdKocJvcGHqxdCgzKq",170,0.994152,26,171,1,170,1,1,0,1,1,94,93,77,77,88
"8215",14,"[26]tJHggqIHcdKocJvcGHqxdCgzKq",165,0.993976,26,166,1,165,1,1,0,1,1,80,79,86,86,88
"8216",15,"[26]tJHggqIHcdKocJvcGHqxdCgzKq",168,0.994083,26,169,1,168,1,1,0,1,1,88,87,81,81,88
"8217",16,"[26]tJHggqIHcdKocJvcGHqxdCgzKq",167,0.994048,26,168,1,167,1,1,0,1,1,83,82,85,85,88
"8218",17,"[26]tJHggqIHcdKocJvcGHqxdCgzKq",169,0.994118,26,170,1,169,1,1,0,1,1,88,87,82,82,88
"8219",18,"[26]tJHggqIHcdKocJvcGHqxdCgzKq",165,0.993976,26,166,1,165,1,1,0,1,1,80,79,86,86,88
"8220",19,"[26]tJHggqIHcdKocJvcGHqxdCgzKq",165,0.993976,26,166,1,165,1,1,0,1,1,79,78,87,87,88
"8221",20,"[26]tJHggqIHcdKocJvcGHqxdCgzKq",172,0.99422,26,173,1,172,1,1,0,1,1,98,97,75,75,88
"8222",21,"[26]tJHggqIHcdKocJvcGHqxdCgzKq",171,0.994186,26,172,1,171,1,1,0,1,1,92,91,80,80,88
"8223",22,"[26]tJHggqIHcdKocJvcGHqxdCgzKq",171,0.994186,26,172,1,171,1,1,0,1,1,96,95,76,76,88
"8224",23,"[26]tJHggqIHcdKocJvcGHqxdCgzKq",173,0.994253,26,174,1,173,1,1,0,1,1,100,99,74,74,88
"8225",24,"[26]tJHggqIHcdKocJvcGHqxdCgzKq",168,0.994083,26,169,1,168,1,1,0,1,1,88,87,81,81,88
"8226",25,"[26]tJHggqIHcdKocJvcGHqxdCgzKq",164,0.993939,26,165,1,164,1,1,0,1,1,76,75,89,89,88
"8227",26,"[26]tJHggqIHcdKocJvcGHqxdCgzKq",163,0.993902,26,164,1,163,1,1,0,1,1,74,73,90,90,88
"8228",27,"[26]tJHggqIHcdKocJvcGHqxdCgzKq",171,0.994186,26,172,1,171,1,1,0,1,1,95,94,77,77,88
"8229",28,"[26]tJHggqIHcdKocJvcGHqxdCgzKq",161,0.993827,26,162,1,161,1,1,0,1,1,68,67,94,94,88
"8230",29,"[26]tJHggqIHcdKocJvcGHqxdCgzKq",164,0.993939,26,165,1,164,1,1,0,1,1,77,76,88,88,88
"8231",30,"[26]tJHggqIHcdKocJvcGHqxdCgzKq",161,0.993827,26,162,1,161,1,1,0,1,1,69,68,93,93,88
"8232",31,"[26]tJHggqIHcdKocJvcGHqxdCgzKq",166,0.994012,26,167,1,166,1,1,0,1,1,82,81,85,85,88
"8233",32,"[26]tJHggqIHcdKocJvcGHqxdCgzKq",169,0.994118,26,170,1,169,1,1,0,1,1,90,89,80,80,88
"8234",33,"[26]tJHggqIHcdKocJvcGHqxdCgzKq",164,0.993939,26,165,1,164,1,1,0,1,1,77,76,88,88,88
"8235",34,"[26]tJHggqIHcdKocJvcGHqxdCgzKq",167,0.994048,26,168,1,167,1,1,0,1,1,86,85,82,82,88
"8236",35,"[26]tJHggqIHcdKocJvcGHqxdCgzKq",165,0.993976,26,166,1,165,1,1,0,1,1,80,79,86,86,88
"8237",36,"[26]tJHggqIHcdKocJvcGHqxdCgzKq",166,0.994012,26,167,1,166,1,1,0,1,1,82,81,85,85,88
"8238",37,"[26]tJHggqIHcdKocJvcGHqxdCgzKq",165,0.993976,26,166,1,165,1,1,0,1,1,80,79,86,86,88
"8239",38,"[26]tJHggqIHcdKocJvcGHqxdCgzKq",163,0.993902,26,164,1,163,1,1,0,1,1,74,73,90,90,88
"8240",39,"[26]tJHggqIHcdKocJvcGHqxdCgzKq",167,0.994048,26,168,1,167,1,1,0,1,1,86,85,82,82,88
"8241",40,"[26]tJHggqIHcdKocJvcGHqxdCgzKq",172,0.99422,26,173,1,172,1,1,0,1,1,98,97,75,75,88
"8242",41,"[26]tJHggqIHcdKocJvcGHqxdCgzKq",168,0.994083,26,169,1,168,1,1,0,1,1,88,87,81,81,88
"8243",42,"[26]tJHggqIHcdKocJvcGHqxdCgzKq",167,0.994048,26,168,1,167,1,1,0,1,1,85,84,83,83,88
"8244",43,"[26]tJHggqIHcdKocJvcGHqxdCgzKq",171,0.994186,26,172,1,171,1,1,0,1,1,95,94,77,77,88
"8245",44,"[26]tJHggqIHcdKocJvcGHqxdCgzKq",169,0.994118,26,170,1,169,1,1,0,1,1,91,90,79,79,88
"8246",45,"[26]tJHggqIHcdKocJvcGHqxdCgzKq",162,0.993865,26,163,1,162,1,1,0,1,1,72,71,91,91,88
"8247",46,"[26]tJHggqIHcdKocJvcGHqxdCgzKq",167,0.994048,26,168,1,167,1,1,0,1,1,84,83,84,84,88
"8248",47,"[26]tJHggqIHcdKocJvcGHqxdCgzKq",163,0.993902,26,164,1,163,1,1,0,1,1,74,73,90,90,88
"8249",48,"[26]tJHggqIHcdKocJvcGHqxdCgzKq",168,0.994083,26,169,1,168,1,1,0,1,1,88,87,81,81,88
"8250",49,"[26]tJHggqIHcdKocJvcGHqxdCgzKq",167,0.994048,26,168,1,167,1,1,0,1,1,86,85,82,82,88
"8251",50,"[26]tJHggqIHcdKocJvcGHqxdCgzKq",169,0.994118,26,170,1,169,1,1,0,1,1,91,90,79,79,88
"8252",51,"[26]tJHggqIHcdKocJvcGHqxdCgzKq",167,0.994048,26,168,1,167,1,1,0,1,1,84,83,84,84,88
"8253",52,"[26]tJHggqIHcdKocJvcGHqxdCgzKq",169,0.994118,26,170,1,169,1,1,0,1,1,91,90,79,79,88
"8254",53,"[26]tJHggqIHcdKocJvcGHqxdCgzKq",164,0.993939,26,165,1,164,1,1,0,1,1,77,76,88,88,88
"8255",54,"[26]tJHggqIHcdKocJvcGHqxdCgzKq",171,0.994186,26,172,1,171,1,1,0,1,1,96,95,76,76,88
"8256",55,"[26]tJHggqIHcdKocJvcGHqxdCgzKq",171,0.994186,26,172,1,171,1,1,0,1,1,95,94,77,77,88
"8257",56,"[26]tJHggqIHcdKocJvcGHqxdCgzKq",163,0.993902,26,164,1,163,1,1,0,1,1,75,74,89,89,88
"8258",57,"[26]tJHggqIHcdKocJvcGHqxdCgzKq",169,0.994118,26,170,1,169,1,1,0,1,1,90,89,80,80,88
"8259",58,"[26]tJHggqIHcdKocJvcGHqxdCgzKq",171,0.994186,26,172,1,171,1,1,0,1,1,96,95,76,76,88
"8260",59,"[26]tJHggqIHcdKocJvcGHqxdCgzKq",167,0.994048,26,168,1,167,1,1,0,1,1,84,83,84,84,88
"8261",60,"[26]tJHggqIHcdKocJvcGHqxdCgzKq",169,0.994118,26,170,1,169,1,1,0,1,1,89,88,81,81,88
"8262",61,"[26]tJHggqIHcdKocJvcGHqxdCgzKq",170,0.994152,26,171,1,170,1,1,0,1,1,93,92,78,78,88
"8263",62,"[26]tJHggqIHcdKocJvcGHqxdCgzKq",166,0.994012,26,167,1,166,1,1,0,1,1,83,82,84,84,88
"8264",63,"[26]tJHggqIHcdKocJvcGHqxdCgzKq",171,0.994186,26,172,1,171,1,1,0,1,1,97,96,75,75,88
"8265",64,"[26]tJHggqIHcdKocJvcGHqxdCgzKq",172,0.99422,26,173,1,172,1,1,0,1,1,97,96,76,76,88
"8266",65,"[26]tJHggqIHcdKocJvcGHqxdCgzKq",170,0.994152,26,171,1,170,1,1,0,1,1,93,92,78,78,88
"8267",66,"[26]tJHggqIHcdKocJvcGHqxdCgzKq",167,0.994048,26,168,1,167,1,1,0,1,1,84,83,84,84,88
"8268",67,"[26]tJHggqIHcdKocJvcGHqxdCgzKq",170,0.994152,26,171,1,170,1,1,0,1,1,92,91,79,79,88
"8269",68,"[26]tJHggqIHcdKocJvcGHqxdCgzKq",166,0.994012,26,167,1,166,1,1,0,1,1,81,80,86,86,88
"8270",69,"[26]tJHggqIHcdKocJvcGHqxdCgzKq",169,0.994118,26,170,1,169,1,1,0,1,1,90,89,80,80,88
"8271",70,"[26]tJHggqIHcdKocJvcGHqxdCgzKq",169,0.994118,26,170,1,169,1,1,0,1,1,91,90,79,79,88
"8272",71,"[26]tJHggqIHcdKocJvcGHqxdCgzKq",168,0.994083,26,169,1,168,1,1,0,1,1,88,87,81,81,88
"8273",72,"[26]tJHggqIHcdKocJvcGHqxdCgzKq",160,0.993789,26,161,1,160,1,1,0,1,1,66,65,95,95,88
"8274",73,"[26]tJHggqIHcdKocJvcGHqxdCgzKq",167,0.994048,26,168,1,167,1,1,0,1,1,84,83,84,84,88
"8275",74,"[26]tJHggqIHcdKocJvcGHqxdCgzKq",164,0.993939,26,165,1,164,1,1,0,1,1,77,76,88,88,88
"8276",75,"[26]tJHggqIHcdKocJvcGHqxdCgzKq",163,0.993902,26,164,1,163,1,1,0,1,1,74,73,90,90,88
"8277",76,"[26]tJHggqIHcdKocJvcGHqxdCgzKq",170,0.994152,26,171,1,170,1,1,0,1,1,93,92,78,78,88
"8278",77,"[26]tJHggqIHcdKocJvcGHqxdCgzKq",168,0.994083,26,169,1,168,1,1,0,1,1,87,86,82,82,88
"8279",78,"[26]tJHggqIHcdKocJvcGHqxdCgzKq",161,0.993827,26,162,1,161,1,1,0,1,1,68,67,94,94,88
"8280",79,"[26]tJHggqIHcdKocJvcGHqxdCgzKq",166,0.994012,26,167,1,166,1,1,0,1,1,82,81,85,85,88
"8281",80,"[26]tJHggqIHcdKocJvcGHqxdCgzKq",171,0.994186,26,172,1,171,1,1,0,1,1,95,94,77,77,88
"8282",81,"[26]tJHggqIHcdKocJvcGHqxdCgzKq",171,0.994186,26,172,1,171,1,1,0,1,1,95,94,77,77,88
"8283",82,"[26]tJHggqIHcdKocJvcGHqxdCgzKq",161,0.993827,26,162,1,161,1,1,0,1,1,69,68,93,93,88
"8284",83,"[26]tJHggqIHcdKocJvcGHqxdCgzKq",173,0.994253,26,174,1,173,1,1,0,1,1,100,99,74,74,88
"8285",84,"[26]tJHggqIHcdKocJvcGHqxdCgzKq",163,0.993902,26,164,1,163,1,1,0,1,1,73,72,91,91,88
"8286",85,"[26]tJHggqIHcdKocJvcGHqxdCgzKq",171,0.994186,26,172,1,171,1,1,0,1,1,97,96,75,75,88
"8287",86,"[26]tJHggqIHcdKocJvcGHqxdCgzKq",169,0.994118,26,170,1,169,1,1,0,1,1,91,90,79,79,88
"8288",87,"[26]tJHggqIHcdKocJvcGHqxdCgzKq",171,0.994186,26,172,1,171,1,1,0,1,1,96,95,76,76,88
"8289",88,"[26]tJHggqIHcdKocJvcGHqxdCgzKq",169,0.994118,26,170,1,169,1,1,0,1,1,91,90,79,79,88
"8290",89,"[26]tJHggqIHcdKocJvcGHqxdCgzKq",162,0.993865,26,163,1,162,1,1,0,1,1,70,69,93,93,88
"8291",90,"[26]tJHggqIHcdKocJvcGHqxdCgzKq",169,0.994118,26,170,1,169,1,1,0,1,1,90,89,80,80,88
"8292",91,"[26]tJHggqIHcdKocJvcGHqxdCgzKq",166,0.994012,26,167,1,166,1,1,0,1,1,80,79,87,87,88
"8293",92,"[26]tJHggqIHcdKocJvcGHqxdCgzKq",170,0.994152,26,171,1,170,1,1,0,1,1,91,90,80,80,88
"8294",93,"[26]tJHggqIHcdKocJvcGHqxdCgzKq",165,0.993976,26,166,1,165,1,1,0,1,1,79,78,87,87,88
"8295",94,"[26]tJHggqIHcdKocJvcGHqxdCgzKq",169,0.994118,26,170,1,169,1,1,0,1,1,90,89,80,80,88
"8296",95,"[26]tJHggqIHcdKocJvcGHqxdCgzKq",168,0.994083,26,169,1,168,1,1,0,1,1,88,87,81,81,88
"8297",96,"[26]tJHggqIHcdKocJvcGHqxdCgzKq",164,0.993939,26,165,1,164,1,1,0,1,1,75,74,90,90,88
"8298",97,"[26]tJHggqIHcdKocJvcGHqxdCgzKq",165,0.993976,26,166,1,165,1,1,0,1,1,80,79,86,86,88
"8299",98,"[26]tJHggqIHcdKocJvcGHqxdCgzKq",165,0.993976,26,166,1,165,1,1,0,1,1,78,77,88,88,88
"8300",99,"[26]tJHggqIHcdKocJvcGHqxdCgzKq",168,0.994083,26,169,1,168,1,1,0,1,1,88,87,81,81,88
"8301",0,"[28]xJHggqIHcDdKocJvcGHqwdClFojG",170,0.994152,28,171,1,170,1,1,0,1,1,94,93,77,77,89
"8302",1,"[28]xJHggqIHcDdKocJvcGHqwdClFojG",170,0.994152,28,171,1,170,1,1,0,1,1,93,92,78,78,89
"8303",2,"[28]xJHggqIHcDdKocJvcGHqwdClFojG",170,0.994152,28,171,1,170,1,1,0,1,1,91,90,80,80,89
"8304",3,"[28]xJHggqIHcDdKocJvcGHqwdClFojG",166,0.994012,28,167,1,166,1,1,0,1,1,82,81,85,85,89
"8305",4,"[28]xJHggqIHcDdKocJvcGHqwdClFojG",166,0.994012,28,167,1,166,1,1,0,1,1,82,81,85,85,89
"8306",5,"[28]xJHggqIHcDdKocJvcGHqwdClFojG",168,0.994083,28,169,1,168,1,1,0,1,1,87,86,82,82,89
"8307",6,"[28]xJHggqIHcDdKocJvcGHqwdClFojG",166,0.994012,28,167,1,166,1,1,0,1,1,83,82,84,84,89
"8308",7,"[28]xJHggqIHcDdKocJvcGHqwdClFojG",164,0.993939,28,165,1,164,1,1,0,1,1,77,76,88,88,89
"8309",8,"[28]xJHggqIHcDdKocJvcGHqwdClFojG",163,0.993902,28,164,1,163,1,1,0,1,1,74,73,90,90,89
"8310",9,"[28]xJHggqIHcDdKocJvcGHqwdClFojG",166,0.994012,28,167,1,166,1,1,0,1,1,81,80,86,86,89
"8311",10,"[28]xJHggqIHcDdKocJvcGHqwdClFojG",169,0.994118,28,170,1,169,1,1,0,1,1,89,88,81,81,89
"8312",11,"[28]xJHggqIHcDdKocJvcGHqwdClFojG",163,0.993902,28,164,1,163,1,1,0,1,1,74,73,90,90,89
"8313",12,"[28]xJHggqIHcDdKocJvcGHqwdClFojG",166,0.994012,28,167,1,166,1,1,0,1,1,83,82,84,84,89
"8314",13,"[28]xJHggqIHcDdKocJvcGHqwdClFojG",169,0.994118,28,170,1,169,1,1,0,1,1,89,88,81,81,89
"8315",14,"[28]xJHggqIHcDdKocJvcGHqwdClFojG",167,0.994048,28,168,1,167,1,1,0,1,1,86,85,82,82,89
"8316",15,"[28]xJHggqIHcDdKocJvcGHqwdClFojG",161,0.993827,28,162,1,161,1,1,0,1,1,69,68,93,93,89
"8317",16,"[28]xJHggqIHcDdKocJvcGHqwdClFojG",168,0.994083,28,169,1,168,1,1,0,1,1,89,88,80,80,89
"8318",17,"[28]xJHggqIHcDdKocJvcGHqwdClFojG",167,0.994048,28,168,1,167,1,1,0,1,1,84,83,84,84,89
"8319",18,"[28]xJHggqIHcDdKocJvcGHqwdClFojG",162,0.993865,28,163,1,162,1,1,0,1,1,72,71,91,91,89
"8320",19,"[28]xJHggqIHcDdKocJvcGHqwdClFojG",168,0.994083,28,169,1,168,1,1,0,1,1,87,86,82,82,89
"8321",20,"[28]xJHggqIHcDdKocJvcGHqwdClFojG",167,0.994048,28,168,1,167,1,1,0,1,1,86,85,82,82,89
"8322",21,"[28]xJHggqIHcDdKocJvcGHqwdClFojG",166,0.994012,28,167,1,166,1,1,0,1,1,83,82,84,84,89
"8323",22,"[28]xJHggqIHcDdKocJvcGHqwdClFojG",166,0.994012,28,167,1,166,1,1,0,1,1,81,80,86,86,89
"8324",23,"[28]xJHggqIHcDdKocJvcGHqwdClFojG",169,0.994118,28,170,1,169,1,1,0,1,1,90,89,80,80,89
"8325",24,"[28]xJHggqIHcDdKocJvcGHqwdClFojG",164,0.993939,28,165,1,164,1,1,0,1,1,77,76,88,88,89
"8326",25,"[28]xJHggqIHcDdKocJvcGHqwdClFojG",167,0.994048,28,168,1,167,1,1,0,1,1,86,85,82,82,89
"8327",26,"[28]xJHggqIHcDdKocJvcGHqwdClFojG",164,0.993939,28,165,1,164,1,1,0,1,1,76,75,89,89,89
"8328",27,"[28]xJHggqIHcDdKocJvcGHqwdClFojG",171,0.994186,28,172,1,171,1,1,0,1,1,95,94,77,77,89
"8329",28,"[28]xJHggqIHcDdKocJvcGHqwdClFojG",165,0.993976,28,166,1,165,1,1,0,1,1,80,79,86,86,89
"8330",29,"[28]xJHggqIHcDdKocJvcGHqwdClFojG",167,0.994048,28,168,1,167,1,1,0,1,1,85,84,83,83,89
"8331",30,"[28]xJHggqIHcDdKocJvcGHqwdClFojG",166,0.994012,28,167,1,166,1,1,0,1,1,83,82,84,84,89
"8332",31,"[28]xJHggqIHcDdKocJvcGHqwdClFojG",173,0.994253,28,174,1,173,1,1,0,1,1,101,100,73,73,89
"8333",32,"[28]xJHggqIHcDdKocJvcGHqwdClFojG",167,0.994048,28,168,1,167,1,1,0,1,1,84,83,84,84,89
"8334",33,"[28]xJHggqIHcDdKocJvcGHqwdClFojG",169,0.994118,28,170,1,169,1,1,0,1,1,91,90,79,79,89
"8335",34,"[28]xJHggqIHcDdKocJvcGHqwdClFojG",173,0.994253,28,174,1,173,1,1,0,1,1,100,99,74,74,89
"8336",35,"[28]xJHggqIHcDdKocJvcGHqwdClFojG",163,0.993902,28,164,1,163,1,1,0,1,1,73,72,91,91,89
"8337",36,"[28]xJHggqIHcDdKocJvcGHqwdClFojG",167,0.994048,28,168,1,167,1,1,0,1,1,84,83,84,84,89
"8338",37,"[28]xJHggqIHcDdKocJvcGHqwdClFojG",165,0.993976,28,166,1,165,1,1,0,1,1,79,78,87,87,89
"8339",38,"[28]xJHggqIHcDdKocJvcGHqwdClFojG",168,0.994083,28,169,1,168,1,1,0,1,1,87,86,82,82,89
"8340",39,"[28]xJHggqIHcDdKocJvcGHqwdClFojG",164,0.993939,28,165,1,164,1,1,0,1,1,74,73,91,91,89
"8341",40,"[28]xJHggqIHcDdKocJvcGHqwdClFojG",167,0.994048,28,168,1,167,1,1,0,1,1,84,83,84,84,89
"8342",41,"[28]xJHggqIHcDdKocJvcGHqwdClFojG",162,0.993865,28,163,1,162,1,1,0,1,1,71,70,92,92,89
"8343",42,"[28]xJHggqIHcDdKocJvcGHqwdClFojG",164,0.993939,28,165,1,164,1,1,0,1,1,78,77,87,87,89
"8344",43,"[28]xJHggqIHcDdKocJvcGHqwdClFojG",166,0.994012,28,167,1,166,1,1,0,1,1,83,82,84,84,89
"8345",44,"[28]xJHggqIHcDdKocJvcGHqwdClFojG",165,0.993976,28,166,1,165,1,1,0,1,1,79,78,87,87,89
"8346",45,"[28]xJHggqIHcDdKocJvcGHqwdClFojG",166,0.994012,28,167,1,166,1,1,0,1,1,83,82,84,84,89
"8347",46,"[28]xJHggqIHcDdKocJvcGHqwdClFojG",164,0.993939,28,165,1,164,1,1,0,1,1,77,76,88,88,89
"8348",47,"[28]xJHggqIHcDdKocJvcGHqwdClFojG",169,0.994118,28,170,1,169,1,1,0,1,1,90,89,80,80,89
"8349",48,"[28]xJHggqIHcDdKocJvcGHqwdClFojG",168,0.994083,28,169,1,168,1,1,0,1,1,89,88,80,80,89
"8350",49,"[28]xJHggqIHcDdKocJvcGHqwdClFojG",164,0.993939,28,165,1,164,1,1,0,1,1,77,76,88,88,89
"8351",50,"[28]xJHggqIHcDdKocJvcGHqwdClFojG",168,0.994083,28,169,1,168,1,1,0,1,1,87,86,82,82,89
"8352",51,"[28]xJHggqIHcDdKocJvcGHqwdClFojG",166,0.994012,28,167,1,166,1,1,0,1,1,81,80,86,86,89
"8353",52,"[28]xJHggqIHcDdKocJvcGHqwdClFojG",173,0.994253,28,174,1,173,1,1,0,1,1,102,101,72,72,89
"8354",53,"[28]xJHggqIHcDdKocJvcGHqwdClFojG",168,0.994083,28,169,1,168,1,1,0,1,1,86,85,83,83,89
"8355",54,"[28]xJHggqIHcDdKocJvcGHqwdClFojG",171,0.994186,28,172,1,171,1,1,0,1,1,94,93,78,78,89
"8356",55,"[28]xJHggqIHcDdKocJvcGHqwdClFojG",166,0.994012,28,167,1,166,1,1,0,1,1,81,80,86,86,89
"8357",56,"[28]xJHggqIHcDdKocJvcGHqwdClFojG",166,0.994012,28,167,1,166,1,1,0,1,1,81,80,86,86,89
"8358",57,"[28]xJHggqIHcDdKocJvcGHqwdClFojG",169,0.994118,28,170,1,169,1,1,0,1,1,87,86,83,83,89
"8359",58,"[28]xJHggqIHcDdKocJvcGHqwdClFojG",163,0.993902,28,164,1,163,1,1,0,1,1,74,73,90,90,89
"8360",59,"[28]xJHggqIHcDdKocJvcGHqwdClFojG",168,0.994083,28,169,1,168,1,1,0,1,1,89,88,80,80,89
"8361",60,"[28]xJHggqIHcDdKocJvcGHqwdClFojG",163,0.993902,28,164,1,163,1,1,0,1,1,73,72,91,91,89
"8362",61,"[28]xJHggqIHcDdKocJvcGHqwdClFojG",172,0.99422,28,173,1,172,1,1,0,1,1,99,98,74,74,89
"8363",62,"[28]xJHggqIHcDdKocJvcGHqwdClFojG",174,0.994286,28,175,1,174,1,1,0,1,1,104,103,71,71,89
"8364",63,"[28]xJHggqIHcDdKocJvcGHqwdClFojG",164,0.993939,28,165,1,164,1,1,0,1,1,76,75,89,89,89
"8365",64,"[28]xJHggqIHcDdKocJvcGHqwdClFojG",166,0.994012,28,167,1,166,1,1,0,1,1,81,80,86,86,89
"8366",65,"[28]xJHggqIHcDdKocJvcGHqwdClFojG",172,0.99422,28,173,1,172,1,1,0,1,1,99,98,74,74,89
"8367",66,"[28]xJHggqIHcDdKocJvcGHqwdClFojG",167,0.994048,28,168,1,167,1,1,0,1,1,86,85,82,82,89
"8368",67,"[28]xJHggqIHcDdKocJvcGHqwdClFojG",165,0.993976,28,166,1,165,1,1,0,1,1,80,79,86,86,89
"8369",68,"[28]xJHggqIHcDdKocJvcGHqwdClFojG",165,0.993976,28,166,1,165,1,1,0,1,1,80,79,86,86,89
"8370",69,"[28]xJHggqIHcDdKocJvcGHqwdClFojG",166,0.994012,28,167,1,166,1,1,0,1,1,82,81,85,85,89
"8371",70,"[28]xJHggqIHcDdKocJvcGHqwdClFojG",166,0.994012,28,167,1,166,1,1,0,1,1,83,82,84,84,89
"8372",71,"[28]xJHggqIHcDdKocJvcGHqwdClFojG",167,0.994048,28,168,1,167,1,1,0,1,1,83,82,85,85,89
"8373",72,"[28]xJHggqIHcDdKocJvcGHqwdClFojG",166,0.994012,28,167,1,166,1,1,0,1,1,83,82,84,84,89
"8374",73,"[28]xJHggqIHcDdKocJvcGHqwdClFojG",167,0.994048,28,168,1,167,1,1,0,1,1,85,84,83,83,89
"8375",74,"[28]xJHggqIHcDdKocJvcGHqwdClFojG",168,0.994083,28,169,1,168,1,1,0,1,1,89,88,80,80,89
"8376",75,"[28]xJHggqIHcDdKocJvcGHqwdClFojG",164,0.993939,28,165,1,164,1,1,0,1,1,77,76,88,88,89
"8377",76,"[28]xJHggqIHcDdKocJvcGHqwdClFojG",165,0.993976,28,166,1,165,1,1,0,1,1,79,78,87,87,89
"8378",77,"[28]xJHggqIHcDdKocJvcGHqwdClFojG",169,0.994118,28,170,1,169,1,1,0,1,1,90,89,80,80,89
"8379",78,"[28]xJHggqIHcDdKocJvcGHqwdClFojG",170,0.994152,28,171,1,170,1,1,0,1,1,93,92,78,78,89
"8380",79,"[28]xJHggqIHcDdKocJvcGHqwdClFojG",160,0.993789,28,161,1,160,1,1,0,1,1,66,65,95,95,89
"8381",80,"[28]xJHggqIHcDdKocJvcGHqwdClFojG",162,0.993865,28,163,1,162,1,1,0,1,1,72,71,91,91,89
"8382",81,"[28]xJHggqIHcDdKocJvcGHqwdClFojG",166,0.994012,28,167,1,166,1,1,0,1,1,82,81,85,85,89
"8383",82,"[28]xJHggqIHcDdKocJvcGHqwdClFojG",167,0.994048,28,168,1,167,1,1,0,1,1,84,83,84,84,89
"8384",83,"[28]xJHggqIHcDdKocJvcGHqwdClFojG",168,0.994083,28,169,1,168,1,1,0,1,1,88,87,81,81,89
"8385",84,"[28]xJHggqIHcDdKocJvcGHqwdClFojG",172,0.99422,28,173,1,172,1,1,0,1,1,100,99,73,73,89
"8386",85,"[28]xJHggqIHcDdKocJvcGHqwdClFojG",164,0.993939,28,165,1,164,1,1,0,1,1,78,77,87,87,89
"8387",86,"[28]xJHggqIHcDdKocJvcGHqwdClFojG",166,0.994012,28,167,1,166,1,1,0,1,1,81,80,86,86,89
"8388",87,"[28]xJHggqIHcDdKocJvcGHqwdClFojG",171,0.994186,28,172,1,171,1,1,0,1,1,95,94,77,77,89
"8389",88,"[28]xJHggqIHcDdKocJvcGHqwdClFojG",168,0.994083,28,169,1,168,1,1,0,1,1,88,87,81,81,89
"8390",89,"[28]xJHggqIHcDdKocJvcGHqwdClFojG",164,0.993939,28,165,1,164,1,1,0,1,1,77,76,88,88,89
"8391",90,"[28]xJHggqIHcDdKocJvcGHqwdClFojG",168,0.994083,28,169,1,168,1,1,0,1,1,87,86,82,82,89
"8392",91,"[28]xJHggqIHcDdKocJvcGHqwdClFojG",168,0.994083,28,169,1,168,1,1,0,1,1,89,88,80,80,89
"8393",92,"[28]xJHggqIHcDdKocJvcGHqwdClFojG",165,0.993976,28,166,1,165,1,1,0,1,1,80,79,86,86,89
"8394",93,"[28]xJHggqIHcDdKocJvcGHqwdClFojG",165,0.993976,28,166,1,165,1,1,0,1,1,80,79,86,86,89
"8395",94,"[28]xJHggqIHcDdKocJvcGHqwdClFojG",169,0.994118,28,170,1,169,1,1,0,1,1,90,89,80,80,89
"8396",95,"[28]xJHggqIHcDdKocJvcGHqwdClFojG",170,0.994152,28,171,1,170,1,1,0,1,1,91,90,80,80,89
"8397",96,"[28]xJHggqIHcDdKocJvcGHqwdClFojG",169,0.994118,28,170,1,169,1,1,0,1,1,90,89,80,80,89
"8398",97,"[28]xJHggqIHcDdKocJvcGHqwdClFojG",170,0.994152,28,171,1,170,1,1,0,1,1,94,93,77,77,89
"8399",98,"[28]xJHggqIHcDdKocJvcGHqwdClFojG",164,0.993939,28,165,1,164,1,1,0,1,1,78,77,87,87,89
"8400",99,"[28]xJHggqIHcDdKocJvcGHqwdClFojG",169,0.994118,28,170,1,169,1,1,0,1,1,90,89,80,80,89
"8401",0,"[31]nJHggqEIHBidGKpcJxcHqFdCuEgdsEC",186,0.994652,31,187,1,186,1,1,0,1,1,92,91,95,95,90
"8402",1,"[31]nJHggqEIHBidGKpcJxcHqFdCuEgdsEC",188,0.994709,31,189,1,188,1,1,0,1,1,100,99,89,89,90
"8403",2,"[31]nJHggqEIHBidGKpcJxcHqFdCuEgdsEC",187,0.994681,31,188,1,187,1,1,0,1,1,94,93,94,94,90
"8404",3,"[31]nJHggqEIHBidGKpcJxcHqFdCuEgdsEC",192,0.994819,31,193,1,192,1,1,0,1,1,107,106,86,86,90
"8405",4,"[31]nJHggqEIHBidGKpcJxcHqFdCuEgdsEC",184,0.994595,31,185,1,184,1,1,0,1,1,89,88,96,96,90
"8406",5,"[31]nJHggqEIHBidGKpcJxcHqFdCuEgdsEC",188,0.994709,31,189,1,188,1,1,0,1,1,96,95,93,93,90
"8407",6,"[31]nJHggqEIHBidGKpcJxcHqFdCuEgdsEC",192,0.994819,31,193,1,192,1,1,0,1,1,106,105,87,87,90
"8408",7,"[31]nJHggqEIHBidGKpcJxcHqFdCuEgdsEC",186,0.994652,31,187,1,186,1,1,0,1,1,94,93,93,93,90
"8409",8,"[31]nJHggqEIHBidGKpcJxcHqFdCuEgdsEC",184,0.994595,31,185,1,184,1,1,0,1,1,90,89,95,95,90
"8410",9,"[31]nJHggqEIHBidGKpcJxcHqFdCuEgdsEC",187,0.994681,31,188,1,187,1,1,0,1,1,95,94,93,93,90
"8411",10,"[31]nJHggqEIHBidGKpcJxcHqFdCuEgdsEC",190,0.994764,31,191,1,190,1,1,0,1,1,101,100,90,90,90
"8412",11,"[31]nJHggqEIHBidGKpcJxcHqFdCuEgdsEC",188,0.994709,31,189,1,188,1,1,0,1,1,99,98,90,90,90
"8413",12,"[31]nJHggqEIHBidGKpcJxcHqFdCuEgdsEC",184,0.994595,31,185,1,184,1,1,0,1,1,88,87,97,97,90
"8414",13,"[31]nJHggqEIHBidGKpcJxcHqFdCuEgdsEC",193,0.994845,31,194,1,193,1,1,0,1,1,111,110,83,83,90
"8415",14,"[31]nJHggqEIHBidGKpcJxcHqFdCuEgdsEC",187,0.994681,31,188,1,187,1,1,0,1,1,97,96,91,91,90
"8416",15,"[31]nJHggqEIHBidGKpcJxcHqFdCuEgdsEC",189,0.994737,31,190,1,189,1,1,0,1,1,99,98,91,91,90
"8417",16,"[31]nJHggqEIHBidGKpcJxcHqFdCuEgdsEC",188,0.994709,31,189,1,188,1,1,0,1,1,98,97,91,91,90
"8418",17,"[31]nJHggqEIHBidGKpcJxcHqFdCuEgdsEC",190,0.994764,31,191,1,190,1,1,0,1,1,105,104,86,86,90
"8419",18,"[31]nJHggqEIHBidGKpcJxcHqFdCuEgdsEC",189,0.994737,31,190,1,189,1,1,0,1,1,99,98,91,91,90
"8420",19,"[31]nJHggqEIHBidGKpcJxcHqFdCuEgdsEC",185,0.994624,31,186,1,185,1,1,0,1,1,91,90,95,95,90
"8421",20,"[31]nJHggqEIHBidGKpcJxcHqFdCuEgdsEC",190,0.994764,31,191,1,190,1,1,0,1,1,104,103,87,87,90
"8422",21,"[31]nJHggqEIHBidGKpcJxcHqFdCuEgdsEC",192,0.994819,31,193,1,192,1,1,0,1,1,109,108,84,84,90
"8423",22,"[31]nJHggqEIHBidGKpcJxcHqFdCuEgdsEC",184,0.994595,31,185,1,184,1,1,0,1,1,88,87,97,97,90
"8424",23,"[31]nJHggqEIHBidGKpcJxcHqFdCuEgdsEC",189,0.994737,31,190,1,189,1,1,0,1,1,98,97,92,92,90
"8425",24,"[31]nJHggqEIHBidGKpcJxcHqFdCuEgdsEC",185,0.994624,31,186,1,185,1,1,0,1,1,91,90,95,95,90
"8426",25,"[31]nJHggqEIHBidGKpcJxcHqFdCuEgdsEC",192,0.994819,31,193,1,192,1,1,0,1,1,108,107,85,85,90
"8427",26,"[31]nJHggqEIHBidGKpcJxcHqFdCuEgdsEC",185,0.994624,31,186,1,185,1,1,0,1,1,90,89,96,96,90
"8428",27,"[31]nJHggqEIHBidGKpcJxcHqFdCuEgdsEC",187,0.994681,31,188,1,187,1,1,0,1,1,96,95,92,92,90
"8429",28,"[31]nJHggqEIHBidGKpcJxcHqFdCuEgdsEC",188,0.994709,31,189,1,188,1,1,0,1,1,99,98,90,90,90
"8430",29,"[31]nJHggqEIHBidGKpcJxcHqFdCuEgdsEC",190,0.994764,31,191,1,190,1,1,0,1,1,101,100,90,90,90
"8431",30,"[31]nJHggqEIHBidGKpcJxcHqFdCuEgdsEC",187,0.994681,31,188,1,187,1,1,0,1,1,96,95,92,92,90
"8432",31,"[31]nJHggqEIHBidGKpcJxcHqFdCuEgdsEC",191,0.994792,31,192,1,191,1,1,0,1,1,106,105,86,86,90
"8433",32,"[31]nJHggqEIHBidGKpcJxcHqFdCuEgdsEC",186,0.994652,31,187,1,186,1,1,0,1,1,94,93,93,93,90
"8434",33,"[31]nJHggqEIHBidGKpcJxcHqFdCuEgdsEC",183,0.994565,31,184,1,183,1,1,0,1,1,86,85,98,98,90
"8435",34,"[31]nJHggqEIHBidGKpcJxcHqFdCuEgdsEC",185,0.994624,31,186,1,185,1,1,0,1,1,92,91,94,94,90
"8436",35,"[31]nJHggqEIHBidGKpcJxcHqFdCuEgdsEC",187,0.994681,31,188,1,187,1,1,0,1,1,96,95,92,92,90
"8437",36,"[31]nJHggqEIHBidGKpcJxcHqFdCuEgdsEC",189,0.994737,31,190,1,189,1,1,0,1,1,102,101,88,88,90
"8438",37,"[31]nJHggqEIHBidGKpcJxcHqFdCuEgdsEC",186,0.994652,31,187,1,186,1,1,0,1,1,94,93,93,93,90
"8439",38,"[31]nJHggqEIHBidGKpcJxcHqFdCuEgdsEC",190,0.994764,31,191,1,190,1,1,0,1,1,103,102,88,88,90
"8440",39,"[31]nJHggqEIHBidGKpcJxcHqFdCuEgdsEC",188,0.994709,31,189,1,188,1,1,0,1,1,96,95,93,93,90
"8441",40,"[31]nJHggqEIHBidGKpcJxcHqFdCuEgdsEC",190,0.994764,31,191,1,190,1,1,0,1,1,100,99,91,91,90
"8442",41,"[31]nJHggqEIHBidGKpcJxcHqFdCuEgdsEC",190,0.994764,31,191,1,190,1,1,0,1,1,103,102,88,88,90
"8443",42,"[31]nJHggqEIHBidGKpcJxcHqFdCuEgdsEC",183,0.994565,31,184,1,183,1,1,0,1,1,86,85,98,98,90
"8444",43,"[31]nJHggqEIHBidGKpcJxcHqFdCuEgdsEC",193,0.994845,31,194,1,193,1,1,0,1,1,106,105,88,88,90
"8445",44,"[31]nJHggqEIHBidGKpcJxcHqFdCuEgdsEC",186,0.994652,31,187,1,186,1,1,0,1,1,89,88,98,98,90
"8446",45,"[31]nJHggqEIHBidGKpcJxcHqFdCuEgdsEC",190,0.994764,31,191,1,190,1,1,0,1,1,105,104,86,86,90
"8447",46,"[31]nJHggqEIHBidGKpcJxcHqFdCuEgdsEC",187,0.994681,31,188,1,187,1,1,0,1,1,96,95,92,92,90
"8448",47,"[31]nJHggqEIHBidGKpcJxcHqFdCuEgdsEC",189,0.994737,31,190,1,189,1,1,0,1,1,99,98,91,91,90
"8449",48,"[31]nJHggqEIHBidGKpcJxcHqFdCuEgdsEC",184,0.994595,31,185,1,184,1,1,0,1,1,89,88,96,96,90
"8450",49,"[31]nJHggqEIHBidGKpcJxcHqFdCuEgdsEC",190,0.994764,31,191,1,190,1,1,0,1,1,102,101,89,89,90
"8451",50,"[31]nJHggqEIHBidGKpcJxcHqFdCuEgdsEC",183,0.994565,31,184,1,183,1,1,0,1,1,87,86,97,97,90
"8452",51,"[31]nJHggqEIHBidGKpcJxcHqFdCuEgdsEC",192,0.994819,31,193,1,192,1,1,0,1,1,106,105,87,87,90
"8453",52,"[31]nJHggqEIHBidGKpcJxcHqFdCuEgdsEC",195,0.994898,31,196,1,195,1,1,0,1,1,103,102,93,93,90
"8454",53,"[31]nJHggqEIHBidGKpcJxcHqFdCuEgdsEC",182,0.994536,31,183,1,182,1,1,0,1,1,83,82,100,100,90
"8455",54,"[31]nJHggqEIHBidGKpcJxcHqFdCuEgdsEC",188,0.994709,31,189,1,188,1,1,0,1,1,98,97,91,91,90
"8456",55,"[31]nJHggqEIHBidGKpcJxcHqFdCuEgdsEC",184,0.994595,31,185,1,184,1,1,0,1,1,89,88,96,96,90
"8457",56,"[31]nJHggqEIHBidGKpcJxcHqFdCuEgdsEC",190,0.994764,31,191,1,190,1,1,0,1,1,101,100,90,90,90
"8458",57,"[31]nJHggqEIHBidGKpcJxcHqFdCuEgdsEC",189,0.994737,31,190,1,189,1,1,0,1,1,102,101,88,88,90
"8459",58,"[31]nJHggqEIHBidGKpcJxcHqFdCuEgdsEC",187,0.994681,31,188,1,187,1,1,0,1,1,97,96,91,91,90
"8460",59,"[31]nJHggqEIHBidGKpcJxcHqFdCuEgdsEC",190,0.994764,31,191,1,190,1,1,0,1,1,104,103,87,87,90
"8461",60,"[31]nJHggqEIHBidGKpcJxcHqFdCuEgdsEC",191,0.994792,31,192,1,191,1,1,0,1,1,104,103,88,88,90
"8462",61,"[31]nJHggqEIHBidGKpcJxcHqFdCuEgdsEC",183,0.994565,31,184,1,183,1,1,0,1,1,87,86,97,97,90
"8463",62,"[31]nJHggqEIHBidGKpcJxcHqFdCuEgdsEC",184,0.994595,31,185,1,184,1,1,0,1,1,90,89,95,95,90
"8464",63,"[31]nJHggqEIHBidGKpcJxcHqFdCuEgdsEC",182,0.994536,31,183,1,182,1,1,0,1,1,83,82,100,100,90
"8465",64,"[31]nJHggqEIHBidGKpcJxcHqFdCuEgdsEC",189,0.994737,31,190,1,189,1,1,0,1,1,97,96,93,93,90
"8466",65,"[31]nJHggqEIHBidGKpcJxcHqFdCuEgdsEC",190,0.994764,31,191,1,190,1,1,0,1,1,104,103,87,87,90
"8467",66,"[31]nJHggqEIHBidGKpcJxcHqFdCuEgdsEC",185,0.994624,31,186,1,185,1,1,0,1,1,91,90,95,95,90
"8468",67,"[31]nJHggqEIHBidGKpcJxcHqFdCuEgdsEC",182,0.994536,31,183,1,182,1,1,0,1,1,85,84,98,98,90
"8469",68,"[31]nJHggqEIHBidGKpcJxcHqFdCuEgdsEC",186,0.994652,31,187,1,186,1,1,0,1,1,95,94,92,92,90
"8470",69,"[31]nJHggqEIHBidGKpcJxcHqFdCuEgdsEC",190,0.994764,31,191,1,190,1,1,0,1,1,105,104,86,86,90
"8471",70,"[31]nJHggqEIHBidGKpcJxcHqFdCuEgdsEC",186,0.994652,31,187,1,186,1,1,0,1,1,93,92,94,94,90
"8472",71,"[31]nJHggqEIHBidGKpcJxcHqFdCuEgdsEC",185,0.994624,31,186,1,185,1,1,0,1,1,91,90,95,95,90
"8473",72,"[31]nJHggqEIHBidGKpcJxcHqFdCuEgdsEC",187,0.994681,31,188,1,187,1,1,0,1,1,89,88,99,99,90
"8474",73,"[31]nJHggqEIHBidGKpcJxcHqFdCuEgdsEC",185,0.994624,31,186,1,185,1,1,0,1,1,89,88,97,97,90
"8475",74,"[31]nJHggqEIHBidGKpcJxcHqFdCuEgdsEC",185,0.994624,31,186,1,185,1,1,0,1,1,91,90,95,95,90
"8476",75,"[31]nJHggqEIHBidGKpcJxcHqFdCuEgdsEC",191,0.994792,31,192,1,191,1,1,0,1,1,105,104,87,87,90
"8477",76,"[31]nJHggqEIHBidGKpcJxcHqFdCuEgdsEC",188,0.994709,31,189,1,188,1,1,0,1,1,98,97,91,91,90
"8478",77,"[31]nJHggqEIHBidGKpcJxcHqFdCuEgdsEC",190,0.994764,31,191,1,190,1,1,0,1,1,103,102,88,88,90
"8479",78,"[31]nJHggqEIHBidGKpcJxcHqFdCuEgdsEC",190,0.994764,31,191,1,190,1,1,0,1,1,104,103,87,87,90
"8480",79,"[31]nJHggqEIHBidGKpcJxcHqFdCuEgdsEC",189,0.994737,31,190,1,189,1,1,0,1,1,98,97,92,92,90
"8481",80,"[31]nJHggqEIHBidGKpcJxcHqFdCuEgdsEC",189,0.994737,31,190,1,189,1,1,0,1,1,100,99,90,90,90
"8482",81,"[31]nJHggqEIHBidGKpcJxcHqFdCuEgdsEC",182,0.994536,31,183,1,182,1,1,0,1,1,84,83,99,99,90
"8483",82,"[31]nJHggqEIHBidGKpcJxcHqFdCuEgdsEC",189,0.994737,31,190,1,189,1,1,0,1,1,99,98,91,91,90
"8484",83,"[31]nJHggqEIHBidGKpcJxcHqFdCuEgdsEC",188,0.994709,31,189,1,188,1,1,0,1,1,96,95,93,93,90
"8485",84,"[31]nJHggqEIHBidGKpcJxcHqFdCuEgdsEC",186,0.994652,31,187,1,186,1,1,0,1,1,90,89,97,97,90
"8486",85,"[31]nJHggqEIHBidGKpcJxcHqFdCuEgdsEC",190,0.994764,31,191,1,190,1,1,0,1,1,102,101,89,89,90
"8487",86,"[31]nJHggqEIHBidGKpcJxcHqFdCuEgdsEC",186,0.994652,31,187,1,186,1,1,0,1,1,91,90,96,96,90
"8488",87,"[31]nJHggqEIHBidGKpcJxcHqFdCuEgdsEC",192,0.994819,31,193,1,192,1,1,0,1,1,102,101,91,91,90
"8489",88,"[31]nJHggqEIHBidGKpcJxcHqFdCuEgdsEC",191,0.994792,31,192,1,191,1,1,0,1,1,104,103,88,88,90
"8490",89,"[31]nJHggqEIHBidGKpcJxcHqFdCuEgdsEC",185,0.994624,31,186,1,185,1,1,0,1,1,90,89,96,96,90
"8491",90,"[31]nJHggqEIHBidGKpcJxcHqFdCuEgdsEC",188,0.994709,31,189,1,188,1,1,0,1,1,100,99,89,89,90
"8492",91,"[31]nJHggqEIHBidGKpcJxcHqFdCuEgdsEC",179,0.994444,31,180,1,179,1,1,0,1,1,76,75,104,104,90
"8493",92,"[31]nJHggqEIHBidGKpcJxcHqFdCuEgdsEC",188,0.994709,31,189,1,188,1,1,0,1,1,98,97,91,91,90
"8494",93,"[31]nJHggqEIHBidGKpcJxcHqFdCuEgdsEC",188,0.994709,31,189,1,188,1,1,0,1,1,98,97,91,91,90
"8495",94,"[31]nJHggqEIHBidGKpcJxcHqFdCuEgdsEC",186,0.994652,31,187,1,186,1,1,0,1,1,91,90,96,96,90
"8496",95,"[31]nJHggqEIHBidGKpcJxcHqFdCuEgdsEC",193,0.994845,31,194,1,193,1,1,0,1,1,108,107,86,86,90
"8497",96,"[31]nJHggqEIHBidGKpcJxcHqFdCuEgdsEC",183,0.994565,31,184,1,183,1,1,0,1,1,84,83,100,100,90
"8498",97,"[31]nJHggqEIHBidGKpcJxcHqFdCuEgdsEC",192,0.994819,31,193,1,192,1,1,0,1,1,106,105,87,87,90
"8499",98,"[31]nJHggqEIHBidGKpcJxcHqFdCuEgdsEC",190,0.994764,31,191,1,190,1,1,0,1,1,103,102,88,88,90
"8500",99,"[31]nJHggqEIHBidGKpcJxcHqFdCuEgdsEC",180,0.994475,31,181,1,180,1,1,0,1,1,77,76,104,104,90
"8501",0,"[28]CJHglqgIHcidKocJvcGHqFdCEics",175,0.994318,28,176,1,175,1,1,0,1,1,83,82,93,93,91
"8502",1,"[28]CJHglqgIHcidKocJvcGHqFdCEics",177,0.994382,28,178,1,177,1,1,0,1,1,92,91,86,86,91
"8503",2,"[28]CJHglqgIHcidKocJvcGHqFdCEics",175,0.994318,28,176,1,175,1,1,0,1,1,84,83,92,92,91
"8504",3,"[28]CJHglqgIHcidKocJvcGHqFdCEics",178,0.994413,28,179,1,178,1,1,0,1,1,93,92,86,86,91
"8505",4,"[28]CJHglqgIHcidKocJvcGHqFdCEics",175,0.994318,28,176,1,175,1,1,0,1,1,84,83,92,92,91
"8506",5,"[28]CJHglqgIHcidKocJvcGHqFdCEics",176,0.99435,28,177,1,176,1,1,0,1,1,89,88,88,88,91
"8507",6,"[28]CJHglqgIHcidKocJvcGHqFdCEics",173,0.994253,28,174,1,173,1,1,0,1,1,81,80,93,93,91
"8508",7,"[28]CJHglqgIHcidKocJvcGHqFdCEics",176,0.99435,28,177,1,176,1,1,0,1,1,87,86,90,90,91
"8509",8,"[28]CJHglqgIHcidKocJvcGHqFdCEics",177,0.994382,28,178,1,177,1,1,0,1,1,90,89,88,88,91
"8510",9,"[28]CJHglqgIHcidKocJvcGHqFdCEics",176,0.99435,28,177,1,176,1,1,0,1,1,90,89,87,87,91
"8511",10,"[28]CJHglqgIHcidKocJvcGHqFdCEics",177,0.994382,28,178,1,177,1,1,0,1,1,94,93,84,84,91
"8512",11,"[28]CJHglqgIHcidKocJvcGHqFdCEics",175,0.994318,28,176,1,175,1,1,0,1,1,85,84,91,91,91
"8513",12,"[28]CJHglqgIHcidKocJvcGHqFdCEics",176,0.99435,28,177,1,176,1,1,0,1,1,90,89,87,87,91
"8514",13,"[28]CJHglqgIHcidKocJvcGHqFdCEics",177,0.994382,28,178,1,177,1,1,0,1,1,93,92,85,85,91
"8515",14,"[28]CJHglqgIHcidKocJvcGHqFdCEics",178,0.994413,28,179,1,178,1,1,0,1,1,95,94,84,84,91
"8516",15,"[28]CJHglqgIHcidKocJvcGHqFdCEics",178,0.994413,28,179,1,178,1,1,0,1,1,94,93,85,85,91
"8517",16,"[28]CJHglqgIHcidKocJvcGHqFdCEics",177,0.994382,28,178,1,177,1,1,0,1,1,93,92,85,85,91
"8518",17,"[28]CJHglqgIHcidKocJvcGHqFdCEics",173,0.994253,28,174,1,173,1,1,0,1,1,78,77,96,96,91
"8519",18,"[28]CJHglqgIHcidKocJvcGHqFdCEics",175,0.994318,28,176,1,175,1,1,0,1,1,85,84,91,91,91
"8520",19,"[28]CJHglqgIHcidKocJvcGHqFdCEics",177,0.994382,28,178,1,177,1,1,0,1,1,91,90,87,87,91
"8521",20,"[28]CJHglqgIHcidKocJvcGHqFdCEics",179,0.994444,28,180,1,179,1,1,0,1,1,97,96,83,83,91
"8522",21,"[28]CJHglqgIHcidKocJvcGHqFdCEics",180,0.994475,28,181,1,180,1,1,0,1,1,98,97,83,83,91
"8523",22,"[28]CJHglqgIHcidKocJvcGHqFdCEics",174,0.994286,28,175,1,174,1,1,0,1,1,83,82,92,92,91
"8524",23,"[28]CJHglqgIHcidKocJvcGHqFdCEics",179,0.994444,28,180,1,179,1,1,0,1,1,98,97,82,82,91
"8525",24,"[28]CJHglqgIHcidKocJvcGHqFdCEics",177,0.994382,28,178,1,177,1,1,0,1,1,92,91,86,86,91
"8526",25,"[28]CJHglqgIHcidKocJvcGHqFdCEics",172,0.99422,28,173,1,172,1,1,0,1,1,76,75,97,97,91
"8527",26,"[28]CJHglqgIHcidKocJvcGHqFdCEics",176,0.99435,28,177,1,176,1,1,0,1,1,88,87,89,89,91
"8528",27,"[28]CJHglqgIHcidKocJvcGHqFdCEics",173,0.994253,28,174,1,173,1,1,0,1,1,81,80,93,93,91
"8529",28,"[28]CJHglqgIHcidKocJvcGHqFdCEics",175,0.994318,28,176,1,175,1,1,0,1,1,86,85,90,90,91
"8530",29,"[28]CJHglqgIHcidKocJvcGHqFdCEics",174,0.994286,28,175,1,174,1,1,0,1,1,84,83,91,91,91
"8531",30,"[28]CJHglqgIHcidKocJvcGHqFdCEics",178,0.994413,28,179,1,178,1,1,0,1,1,97,96,82,82,91
"8532",31,"[28]CJHglqgIHcidKocJvcGHqFdCEics",180,0.994475,28,181,1,180,1,1,0,1,1,102,101,79,79,91
"8533",32,"[28]CJHglqgIHcidKocJvcGHqFdCEics",176,0.99435,28,177,1,176,1,1,0,1,1,89,88,88,88,91
"8534",33,"[28]CJHglqgIHcidKocJvcGHqFdCEics",170,0.994152,28,171,1,170,1,1,0,1,1,69,68,102,102,91
"8535",34,"[28]CJHglqgIHcidKocJvcGHqFdCEics",174,0.994286,28,175,1,174,1,1,0,1,1,79,78,96,96,91
"8536",35,"[28]CJHglqgIHcidKocJvcGHqFdCEics",177,0.994382,28,178,1,177,1,1,0,1,1,94,93,84,84,91
"8537",36,"[28]CJHglqgIHcidKocJvcGHqFdCEics",175,0.994318,28,176,1,175,1,1,0,1,1,86,85,90,90,91
"8538",37,"[28]CJHglqgIHcidKocJvcGHqFdCEics",176,0.99435,28,177,1,176,1,1,0,1,1,88,87,89,89,91
"8539",38,"[28]CJHglqgIHcidKocJvcGHqFdCEics",181,0.994505,28,182,1,181,1,1,0,1,1,104,103,78,78,91
"8540",39,"[28]CJHglqgIHcidKocJvcGHqFdCEics",176,0.99435,28,177,1,176,1,1,0,1,1,90,89,87,87,91
"8541",40,"[28]CJHglqgIHcidKocJvcGHqFdCEics",180,0.994475,28,181,1,180,1,1,0,1,1,101,100,80,80,91
"8542",41,"[28]CJHglqgIHcidKocJvcGHqFdCEics",176,0.99435,28,177,1,176,1,1,0,1,1,90,89,87,87,91
"8543",42,"[28]CJHglqgIHcidKocJvcGHqFdCEics",171,0.994186,28,172,1,171,1,1,0,1,1,72,71,100,100,91
"8544",43,"[28]CJHglqgIHcidKocJvcGHqFdCEics",177,0.994382,28,178,1,177,1,1,0,1,1,94,93,84,84,91
"8545",44,"[28]CJHglqgIHcidKocJvcGHqFdCEics",176,0.99435,28,177,1,176,1,1,0,1,1,89,88,88,88,91
"8546",45,"[28]CJHglqgIHcidKocJvcGHqFdCEics",179,0.994444,28,180,1,179,1,1,0,1,1,100,99,80,80,91
"8547",46,"[28]CJHglqgIHcidKocJvcGHqFdCEics",177,0.994382,28,178,1,177,1,1,0,1,1,93,92,85,85,91
"8548",47,"[28]CJHglqgIHcidKocJvcGHqFdCEics",177,0.994382,28,178,1,177,1,1,0,1,1,93,92,85,85,91
"8549",48,"[28]CJHglqgIHcidKocJvcGHqFdCEics",175,0.994318,28,176,1,175,1,1,0,1,1,85,84,91,91,91
"8550",49,"[28]CJHglqgIHcidKocJvcGHqFdCEics",180,0.994475,28,181,1,180,1,1,0,1,1,99,98,82,82,91
"8551",50,"[28]CJHglqgIHcidKocJvcGHqFdCEics",179,0.994444,28,180,1,179,1,1,0,1,1,99,98,81,81,91
"8552",51,"[28]CJHglqgIHcidKocJvcGHqFdCEics",181,0.994505,28,182,1,181,1,1,0,1,1,106,105,76,76,91
"8553",52,"[28]CJHglqgIHcidKocJvcGHqFdCEics",177,0.994382,28,178,1,177,1,1,0,1,1,92,91,86,86,91
"8554",53,"[28]CJHglqgIHcidKocJvcGHqFdCEics",177,0.994382,28,178,1,177,1,1,0,1,1,93,92,85,85,91
"8555",54,"[28]CJHglqgIHcidKocJvcGHqFdCEics",171,0.994186,28,172,1,171,1,1,0,1,1,74,73,98,98,91
"8556",55,"[28]CJHglqgIHcidKocJvcGHqFdCEics",179,0.994444,28,180,1,179,1,1,0,1,1,100,99,80,80,91
"8557",56,"[28]CJHglqgIHcidKocJvcGHqFdCEics",172,0.99422,28,173,1,172,1,1,0,1,1,75,74,98,98,91
"8558",57,"[28]CJHglqgIHcidKocJvcGHqFdCEics",175,0.994318,28,176,1,175,1,1,0,1,1,86,85,90,90,91
"8559",58,"[28]CJHglqgIHcidKocJvcGHqFdCEics",175,0.994318,28,176,1,175,1,1,0,1,1,86,85,90,90,91
"8560",59,"[28]CJHglqgIHcidKocJvcGHqFdCEics",177,0.994382,28,178,1,177,1,1,0,1,1,92,91,86,86,91
"8561",60,"[28]CJHglqgIHcidKocJvcGHqFdCEics",178,0.994413,28,179,1,178,1,1,0,1,1,97,96,82,82,91
"8562",61,"[28]CJHglqgIHcidKocJvcGHqFdCEics",177,0.994382,28,178,1,177,1,1,0,1,1,92,91,86,86,91
"8563",62,"[28]CJHglqgIHcidKocJvcGHqFdCEics",173,0.994253,28,174,1,173,1,1,0,1,1,79,78,95,95,91
"8564",63,"[28]CJHglqgIHcidKocJvcGHqFdCEics",173,0.994253,28,174,1,173,1,1,0,1,1,81,80,93,93,91
"8565",64,"[28]CJHglqgIHcidKocJvcGHqFdCEics",178,0.994413,28,179,1,178,1,1,0,1,1,96,95,83,83,91
"8566",65,"[28]CJHglqgIHcidKocJvcGHqFdCEics",174,0.994286,28,175,1,174,1,1,0,1,1,81,80,94,94,91
"8567",66,"[28]CJHglqgIHcidKocJvcGHqFdCEics",175,0.994318,28,176,1,175,1,1,0,1,1,86,85,90,90,91
"8568",67,"[28]CJHglqgIHcidKocJvcGHqFdCEics",178,0.994413,28,179,1,178,1,1,0,1,1,95,94,84,84,91
"8569",68,"[28]CJHglqgIHcidKocJvcGHqFdCEics",175,0.994318,28,176,1,175,1,1,0,1,1,85,84,91,91,91
"8570",69,"[28]CJHglqgIHcidKocJvcGHqFdCEics",175,0.994318,28,176,1,175,1,1,0,1,1,86,85,90,90,91
"8571",70,"[28]CJHglqgIHcidKocJvcGHqFdCEics",175,0.994318,28,176,1,175,1,1,0,1,1,85,84,91,91,91
"8572",71,"[28]CJHglqgIHcidKocJvcGHqFdCEics",176,0.99435,28,177,1,176,1,1,0,1,1,90,89,87,87,91
"8573",72,"[28]CJHglqgIHcidKocJvcGHqFdCEics",174,0.994286,28,175,1,174,1,1,0,1,1,83,82,92,92,91
"8574",73,"[28]CJHglqgIHcidKocJvcGHqFdCEics",175,0.994318,28,176,1,175,1,1,0,1,1,87,86,89,89,91
"8575",74,"[28]CJHglqgIHcidKocJvcGHqFdCEics",176,0.99435,28,177,1,176,1,1,0,1,1,87,86,90,90,91
"8576",75,"[28]CJHglqgIHcidKocJvcGHqFdCEics",174,0.994286,28,175,1,174,1,1,0,1,1,83,82,92,92,91
"8577",76,"[28]CJHglqgIHcidKocJvcGHqFdCEics",176,0.99435,28,177,1,176,1,1,0,1,1,89,88,88,88,91
"8578",77,"[28]CJHglqgIHcidKocJvcGHqFdCEics",176,0.99435,28,177,1,176,1,1,0,1,1,88,87,89,89,91
"8579",78,"[28]CJHglqgIHcidKocJvcGHqFdCEics",178,0.994413,28,179,1,178,1,1,0,1,1,94,93,85,85,91
"8580",79,"[28]CJHglqgIHcidKocJvcGHqFdCEics",176,0.99435,28,177,1,176,1,1,0,1,1,89,88,88,88,91
"8581",80,"[28]CJHglqgIHcidKocJvcGHqFdCEics",177,0.994382,28,178,1,177,1,1,0,1,1,91,90,87,87,91
"8582",81,"[28]CJHglqgIHcidKocJvcGHqFdCEics",175,0.994318,28,176,1,175,1,1,0,1,1,85,84,91,91,91
"8583",82,"[28]CJHglqgIHcidKocJvcGHqFdCEics",175,0.994318,28,176,1,175,1,1,0,1,1,86,85,90,90,91
"8584",83,"[28]CJHglqgIHcidKocJvcGHqFdCEics",173,0.994253,28,174,1,173,1,1,0,1,1,81,80,93,93,91
"8585",84,"[28]CJHglqgIHcidKocJvcGHqFdCEics",179,0.994444,28,180,1,179,1,1,0,1,1,98,97,82,82,91
"8586",85,"[28]CJHglqgIHcidKocJvcGHqFdCEics",176,0.99435,28,177,1,176,1,1,0,1,1,89,88,88,88,91
"8587",86,"[28]CJHglqgIHcidKocJvcGHqFdCEics",179,0.994444,28,180,1,179,1,1,0,1,1,98,97,82,82,91
"8588",87,"[28]CJHglqgIHcidKocJvcGHqFdCEics",177,0.994382,28,178,1,177,1,1,0,1,1,91,90,87,87,91
"8589",88,"[28]CJHglqgIHcidKocJvcGHqFdCEics",178,0.994413,28,179,1,178,1,1,0,1,1,94,93,85,85,91
"8590",89,"[28]CJHglqgIHcidKocJvcGHqFdCEics",175,0.994318,28,176,1,175,1,1,0,1,1,86,85,90,90,91
"8591",90,"[28]CJHglqgIHcidKocJvcGHqFdCEics",175,0.994318,28,176,1,175,1,1,0,1,1,85,84,91,91,91
"8592",91,"[28]CJHglqgIHcidKocJvcGHqFdCEics",175,0.994318,28,176,1,175,1,1,0,1,1,86,85,90,90,91
"8593",92,"[28]CJHglqgIHcidKocJvcGHqFdCEics",181,0.994505,28,182,1,181,1,1,0,1,1,105,104,77,77,91
"8594",93,"[28]CJHglqgIHcidKocJvcGHqFdCEics",174,0.994286,28,175,1,174,1,1,0,1,1,82,81,93,93,91
"8595",94,"[28]CJHglqgIHcidKocJvcGHqFdCEics",178,0.994413,28,179,1,178,1,1,0,1,1,96,95,83,83,91
"8596",95,"[28]CJHglqgIHcidKocJvcGHqFdCEics",176,0.99435,28,177,1,176,1,1,0,1,1,89,88,88,88,91
"8597",96,"[28]CJHglqgIHcidKocJvcGHqFdCEics",181,0.994505,28,182,1,181,1,1,0,1,1,106,105,76,76,91
"8598",97,"[28]CJHglqgIHcidKocJvcGHqFdCEics",176,0.99435,28,177,1,176,1,1,0,1,1,89,88,88,88,91
"8599",98,"[28]CJHglqgIHcidKocJvcGHqFdCEics",173,0.994253,28,174,1,173,1,1,0,1,1,78,77,96,96,91
"8600",99,"[28]CJHglqgIHcidKocJvcGHqFdCEics",177,0.994382,28,178,1,177,1,1,0,1,1,94,93,84,84,91
"8601",0,"[27]cJHggqIHcdKocJvcGHqwdCCzAAG",168,0.994083,27,169,1,168,1,1,0,1,1,88,87,81,81,92
"8602",1,"[27]cJHggqIHcdKocJvcGHqwdCCzAAG",166,0.994012,27,167,1,166,1,1,0,1,1,82,81,85,85,92
"8603",2,"[27]cJHggqIHcdKocJvcGHqwdCCzAAG",165,0.993976,27,166,1,165,1,1,0,1,1,78,77,88,88,92
"8604",3,"[27]cJHggqIHcdKocJvcGHqwdCCzAAG",165,0.993976,27,166,1,165,1,1,0,1,1,80,79,86,86,92
"8605",4,"[27]cJHggqIHcdKocJvcGHqwdCCzAAG",161,0.993827,27,162,1,161,1,1,0,1,1,69,68,93,93,92
"8606",5,"[27]cJHggqIHcdKocJvcGHqwdCCzAAG",169,0.994118,27,170,1,169,1,1,0,1,1,89,88,81,81,92
"8607",6,"[27]cJHggqIHcdKocJvcGHqwdCCzAAG",165,0.993976,27,166,1,165,1,1,0,1,1,79,78,87,87,92
"8608",7,"[27]cJHggqIHcdKocJvcGHqwdCCzAAG",166,0.994012,27,167,1,166,1,1,0,1,1,82,81,85,85,92
"8609",8,"[27]cJHggqIHcdKocJvcGHqwdCCzAAG",166,0.994012,27,167,1,166,1,1,0,1,1,82,81,85,85,92
"8610",9,"[27]cJHggqIHcdKocJvcGHqwdCCzAAG",166,0.994012,27,167,1,166,1,1,0,1,1,82,81,85,85,92
"8611",10,"[27]cJHggqIHcdKocJvcGHqwdCCzAAG",165,0.993976,27,166,1,165,1,1,0,1,1,79,78,87,87,92
"8612",11,"[27]cJHggqIHcdKocJvcGHqwdCCzAAG",171,0.994186,27,172,1,171,1,1,0,1,1,92,91,80,80,92
"8613",12,"[27]cJHggqIHcdKocJvcGHqwdCCzAAG",166,0.994012,27,167,1,166,1,1,0,1,1,83,82,84,84,92
"8614",13,"[27]cJHggqIHcdKocJvcGHqwdCCzAAG",164,0.993939,27,165,1,164,1,1,0,1,1,77,76,88,88,92
"8615",14,"[27]cJHggqIHcdKocJvcGHqwdCCzAAG",171,0.994186,27,172,1,171,1,1,0,1,1,96,95,76,76,92
"8616",15,"[27]cJHggqIHcdKocJvcGHqwdCCzAAG",168,0.994083,27,169,1,168,1,1,0,1,1,88,87,81,81,92
"8617",16,"[27]cJHggqIHcdKocJvcGHqwdCCzAAG",169,0.994118,27,170,1,169,1,1,0,1,1,89,88,81,81,92
"8618",17,"[27]cJHggqIHcdKocJvcGHqwdCCzAAG",166,0.994012,27,167,1,166,1,1,0,1,1,82,81,85,85,92
"8619",18,"[27]cJHggqIHcdKocJvcGHqwdCCzAAG",164,0.993939,27,165,1,164,1,1,0,1,1,76,75,89,89,92
"8620",19,"[27]cJHggqIHcdKocJvcGHqwdCCzAAG",167,0.994048,27,168,1,167,1,1,0,1,1,85,84,83,83,92
"8621",20,"[27]cJHggqIHcdKocJvcGHqwdCCzAAG",166,0.994012,27,167,1,166,1,1,0,1,1,83,82,84,84,92
"8622",21,"[27]cJHggqIHcdKocJvcGHqwdCCzAAG",165,0.993976,27,166,1,165,1,1,0,1,1,80,79,86,86,92
"8623",22,"[27]cJHggqIHcdKocJvcGHqwdCCzAAG",171,0.994186,27,172,1,171,1,1,0,1,1,96,95,76,76,92
"8624",23,"[27]cJHggqIHcdKocJvcGHqwdCCzAAG",171,0.994186,27,172,1,171,1,1,0,1,1,96,95,76,76,92
"8625",24,"[27]cJHggqIHcdKocJvcGHqwdCCzAAG",164,0.993939,27,165,1,164,1,1,0,1,1,77,76,88,88,92
"8626",25,"[27]cJHggqIHcdKocJvcGHqwdCCzAAG",168,0.994083,27,169,1,168,1,1,0,1,1,87,86,82,82,92
"8627",26,"[27]cJHggqIHcdKocJvcGHqwdCCzAAG",166,0.994012,27,167,1,166,1,1,0,1,1,82,81,85,85,92
"8628",27,"[27]cJHggqIHcdKocJvcGHqwdCCzAAG",164,0.993939,27,165,1,164,1,1,0,1,1,76,75,89,89,92
"8629",28,"[27]cJHggqIHcdKocJvcGHqwdCCzAAG",169,0.994118,27,170,1,169,1,1,0,1,1,90,89,80,80,92
"8630",29,"[27]cJHggqIHcdKocJvcGHqwdCCzAAG",171,0.994186,27,172,1,171,1,1,0,1,1,96,95,76,76,92
"8631",30,"[27]cJHggqIHcdKocJvcGHqwdCCzAAG",167,0.994048,27,168,1,167,1,1,0,1,1,84,83,84,84,92
"8632",31,"[27]cJHggqIHcdKocJvcGHqwdCCzAAG",163,0.993902,27,164,1,163,1,1,0,1,1,75,74,89,89,92
"8633",32,"[27]cJHggqIHcdKocJvcGHqwdCCzAAG",163,0.993902,27,164,1,163,1,1,0,1,1,74,73,90,90,92
"8634",33,"[27]cJHggqIHcdKocJvcGHqwdCCzAAG",165,0.993976,27,166,1,165,1,1,0,1,1,79,78,87,87,92
"8635",34,"[27]cJHggqIHcdKocJvcGHqwdCCzAAG",167,0.994048,27,168,1,167,1,1,0,1,1,84,83,84,84,92
"8636",35,"[27]cJHggqIHcdKocJvcGHqwdCCzAAG",165,0.993976,27,166,1,165,1,1,0,1,1,80,79,86,86,92
"8637",36,"[27]cJHggqIHcdKocJvcGHqwdCCzAAG",166,0.994012,27,167,1,166,1,1,0,1,1,82,81,85,85,92
"8638",37,"[27]cJHggqIHcdKocJvcGHqwdCCzAAG",167,0.994048,27,168,1,167,1,1,0,1,1,84,83,84,84,92
"8639",38,"[27]cJHggqIHcdKocJvcGHqwdCCzAAG",169,0.994118,27,170,1,169,1,1,0,1,1,89,88,81,81,92
"8640",39,"[27]cJHggqIHcdKocJvcGHqwdCCzAAG",170,0.994152,27,171,1,170,1,1,0,1,1,93,92,78,78,92
"8641",40,"[27]cJHggqIHcdKocJvcGHqwdCCzAAG",164,0.993939,27,165,1,164,1,1,0,1,1,77,76,88,88,92
"8642",41,"[27]cJHggqIHcdKocJvcGHqwdCCzAAG",169,0.994118,27,170,1,169,1,1,0,1,1,90,89,80,80,92
"8643",42,"[27]cJHggqIHcdKocJvcGHqwdCCzAAG",162,0.993865,27,163,1,162,1,1,0,1,1,72,71,91,91,92
"8644",43,"[27]cJHggqIHcdKocJvcGHqwdCCzAAG",167,0.994048,27,168,1,167,1,1,0,1,1,84,83,84,84,92
"8645",44,"[27]cJHggqIHcdKocJvcGHqwdCCzAAG",162,0.993865,27,163,1,162,1,1,0,1,1,72,71,91,91,92
"8646",45,"[27]cJHggqIHcdKocJvcGHqwdCCzAAG",165,0.993976,27,166,1,165,1,1,0,1,1,79,78,87,87,92
"8647",46,"[27]cJHggqIHcdKocJvcGHqwdCCzAAG",165,0.993976,27,166,1,165,1,1,0,1,1,79,78,87,87,92
"8648",47,"[27]cJHggqIHcdKocJvcGHqwdCCzAAG",168,0.994083,27,169,1,168,1,1,0,1,1,87,86,82,82,92
"8649",48,"[27]cJHggqIHcdKocJvcGHqwdCCzAAG",167,0.994048,27,168,1,167,1,1,0,1,1,86,85,82,82,92
"8650",49,"[27]cJHggqIHcdKocJvcGHqwdCCzAAG",172,0.99422,27,173,1,172,1,1,0,1,1,98,97,75,75,92
"8651",50,"[27]cJHggqIHcdKocJvcGHqwdCCzAAG",166,0.994012,27,167,1,166,1,1,0,1,1,83,82,84,84,92
"8652",51,"[27]cJHggqIHcdKocJvcGHqwdCCzAAG",168,0.994083,27,169,1,168,1,1,0,1,1,87,86,82,82,92
"8653",52,"[27]cJHggqIHcdKocJvcGHqwdCCzAAG",168,0.994083,27,169,1,168,1,1,0,1,1,86,85,83,83,92
"8654",53,"[27]cJHggqIHcdKocJvcGHqwdCCzAAG",163,0.993902,27,164,1,163,1,1,0,1,1,75,74,89,89,92
"8655",54,"[27]cJHggqIHcdKocJvcGHqwdCCzAAG",165,0.993976,27,166,1,165,1,1,0,1,1,79,78,87,87,92
"8656",55,"[27]cJHggqIHcdKocJvcGHqwdCCzAAG",166,0.994012,27,167,1,166,1,1,0,1,1,82,81,85,85,92
"8657",56,"[27]cJHggqIHcdKocJvcGHqwdCCzAAG",166,0.994012,27,167,1,166,1,1,0,1,1,81,80,86,86,92
"8658",57,"[27]cJHggqIHcdKocJvcGHqwdCCzAAG",165,0.993976,27,166,1,165,1,1,0,1,1,80,79,86,86,92
"8659",58,"[27]cJHggqIHcdKocJvcGHqwdCCzAAG",168,0.994083,27,169,1,168,1,1,0,1,1,88,87,81,81,92
"8660",59,"[27]cJHggqIHcdKocJvcGHqwdCCzAAG",165,0.993976,27,166,1,165,1,1,0,1,1,80,79,86,86,92
"8661",60,"[27]cJHggqIHcdKocJvcGHqwdCCzAAG",165,0.993976,27,166,1,165,1,1,0,1,1,79,78,87,87,92
"8662",61,"[27]cJHggqIHcdKocJvcGHqwdCCzAAG",171,0.994186,27,172,1,171,1,1,0,1,1,95,94,77,77,92
"8663",62,"[27]cJHggqIHcdKocJvcGHqwdCCzAAG",169,0.994118,27,170,1,169,1,1,0,1,1,91,90,79,79,92
"8664",63,"[27]cJHggqIHcdKocJvcGHqwdCCzAAG",169,0.994118,27,170,1,169,1,1,0,1,1,91,90,79,79,92
"8665",64,"[27]cJHggqIHcdKocJvcGHqwdCCzAAG",166,0.994012,27,167,1,166,1,1,0,1,1,83,82,84,84,92
"8666",65,"[27]cJHggqIHcdKocJvcGHqwdCCzAAG",170,0.994152,27,171,1,170,1,1,0,1,1,92,91,79,79,92
"8667",66,"[27]cJHggqIHcdKocJvcGHqwdCCzAAG",173,0.994253,27,174,1,173,1,1,0,1,1,101,100,73,73,92
"8668",67,"[27]cJHggqIHcdKocJvcGHqwdCCzAAG",168,0.994083,27,169,1,168,1,1,0,1,1,87,86,82,82,92
"8669",68,"[27]cJHggqIHcdKocJvcGHqwdCCzAAG",168,0.994083,27,169,1,168,1,1,0,1,1,88,87,81,81,92
"8670",69,"[27]cJHggqIHcdKocJvcGHqwdCCzAAG",169,0.994118,27,170,1,169,1,1,0,1,1,90,89,80,80,92
"8671",70,"[27]cJHggqIHcdKocJvcGHqwdCCzAAG",164,0.993939,27,165,1,164,1,1,0,1,1,77,76,88,88,92
"8672",71,"[27]cJHggqIHcdKocJvcGHqwdCCzAAG",169,0.994118,27,170,1,169,1,1,0,1,1,89,88,81,81,92
"8673",72,"[27]cJHggqIHcdKocJvcGHqwdCCzAAG",166,0.994012,27,167,1,166,1,1,0,1,1,81,80,86,86,92
"8674",73,"[27]cJHggqIHcdKocJvcGHqwdCCzAAG",166,0.994012,27,167,1,166,1,1,0,1,1,82,81,85,85,92
"8675",74,"[27]cJHggqIHcdKocJvcGHqwdCCzAAG",165,0.993976,27,166,1,165,1,1,0,1,1,79,78,87,87,92
"8676",75,"[27]cJHggqIHcdKocJvcGHqwdCCzAAG",167,0.994048,27,168,1,167,1,1,0,1,1,84,83,84,84,92
"8677",76,"[27]cJHggqIHcdKocJvcGHqwdCCzAAG",168,0.994083,27,169,1,168,1,1,0,1,1,88,87,81,81,92
"8678",77,"[27]cJHggqIHcdKocJvcGHqwdCCzAAG",169,0.994118,27,170,1,169,1,1,0,1,1,90,89,80,80,92
"8679",78,"[27]cJHggqIHcdKocJvcGHqwdCCzAAG",164,0.993939,27,165,1,164,1,1,0,1,1,76,75,89,89,92
"8680",79,"[27]cJHggqIHcdKocJvcGHqwdCCzAAG",168,0.994083,27,169,1,168,1,1,0,1,1,88,87,81,81,92
"8681",80,"[27]cJHggqIHcdKocJvcGHqwdCCzAAG",164,0.993939,27,165,1,164,1,1,0,1,1,77,76,88,88,92
"8682",81,"[27]cJHggqIHcdKocJvcGHqwdCCzAAG",169,0.994118,27,170,1,169,1,1,0,1,1,90,89,80,80,92
"8683",82,"[27]cJHggqIHcdKocJvcGHqwdCCzAAG",164,0.993939,27,165,1,164,1,1,0,1,1,75,74,90,90,92
"8684",83,"[27]cJHggqIHcdKocJvcGHqwdCCzAAG",168,0.994083,27,169,1,168,1,1,0,1,1,88,87,81,81,92
"8685",84,"[27]cJHggqIHcdKocJvcGHqwdCCzAAG",166,0.994012,27,167,1,166,1,1,0,1,1,80,79,87,87,92
"8686",85,"[27]cJHggqIHcdKocJvcGHqwdCCzAAG",163,0.993902,27,164,1,163,1,1,0,1,1,74,73,90,90,92
"8687",86,"[27]cJHggqIHcdKocJvcGHqwdCCzAAG",166,0.994012,27,167,1,166,1,1,0,1,1,82,81,85,85,92
"8688",87,"[27]cJHggqIHcdKocJvcGHqwdCCzAAG",163,0.993902,27,164,1,163,1,1,0,1,1,73,72,91,91,92
"8689",88,"[27]cJHggqIHcdKocJvcGHqwdCCzAAG",168,0.994083,27,169,1,168,1,1,0,1,1,86,85,83,83,92
"8690",89,"[27]cJHggqIHcdKocJvcGHqwdCCzAAG",169,0.994118,27,170,1,169,1,1,0,1,1,91,90,79,79,92
"8691",90,"[27]cJHggqIHcdKocJvcGHqwdCCzAAG",173,0.994253,27,174,1,173,1,1,0,1,1,101,100,73,73,92
"8692",91,"[27]cJHggqIHcdKocJvcGHqwdCCzAAG",166,0.994012,27,167,1,166,1,1,0,1,1,82,81,85,85,92
"8693",92,"[27]cJHggqIHcdKocJvcGHqwdCCzAAG",167,0.994048,27,168,1,167,1,1,0,1,1,84,83,84,84,92
"8694",93,"[27]cJHggqIHcdKocJvcGHqwdCCzAAG",166,0.994012,27,167,1,166,1,1,0,1,1,80,79,87,87,92
"8695",94,"[27]cJHggqIHcdKocJvcGHqwdCCzAAG",167,0.994048,27,168,1,167,1,1,0,1,1,84,83,84,84,92
"8696",95,"[27]cJHggqIHcdKocJvcGHqwdCCzAAG",167,0.994048,27,168,1,167,1,1,0,1,1,86,85,82,82,92
"8697",96,"[27]cJHggqIHcdKocJvcGHqwdCCzAAG",173,0.994253,27,174,1,173,1,1,0,1,1,100,99,74,74,92
"8698",97,"[27]cJHggqIHcdKocJvcGHqwdCCzAAG",161,0.993827,27,162,1,161,1,1,0,1,1,68,67,94,94,92
"8699",98,"[27]cJHggqIHcdKocJvcGHqwdCCzAAG",167,0.994048,27,168,1,167,1,1,0,1,1,84,83,84,84,92
"8700",99,"[27]cJHggqIHcdKocJvcGHqwdCCzAAG",165,0.993976,27,166,1,165,1,1,0,1,1,76,75,90,90,92
"8701",0,"[25]oJHggqIHcdKocJvcGHqxdCBiK",168,0.994083,25,169,1,168,1,1,0,1,1,84,83,85,85,93
"8702",1,"[25]oJHggqIHcdKocJvcGHqxdCBiK",161,0.993827,25,162,1,161,1,1,0,1,1,68,67,94,94,93
"8703",2,"[25]oJHggqIHcdKocJvcGHqxdCBiK",166,0.994012,25,167,1,166,1,1,0,1,1,82,81,85,85,93
"8704",3,"[25]oJHggqIHcdKocJvcGHqxdCBiK",165,0.993976,25,166,1,165,1,1,0,1,1,80,79,86,86,93
"8705",4,"[25]oJHggqIHcdKocJvcGHqxdCBiK",164,0.993939,25,165,1,164,1,1,0,1,1,77,76,88,88,93
"8706",5,"[25]oJHggqIHcdKocJvcGHqxdCBiK",167,0.994048,25,168,1,167,1,1,0,1,1,86,85,82,82,93
"8707",6,"[25]oJHggqIHcdKocJvcGHqxdCBiK",167,0.994048,25,168,1,167,1,1,0,1,1,84,83,84,84,93
"8708",7,"[25]oJHggqIHcdKocJvcGHqxdCBiK",168,0.994083,25,169,1,168,1,1,0,1,1,86,85,83,83,93
"8709",8,"[25]oJHggqIHcdKocJvcGHqxdCBiK",166,0.994012,25,167,1,166,1,1,0,1,1,81,80,86,86,93
"8710",9,"[25]oJHggqIHcdKocJvcGHqxdCBiK",164,0.993939,25,165,1,164,1,1,0,1,1,77,76,88,88,93
"8711",10,"[25]oJHggqIHcdKocJvcGHqxdCBiK",165,0.993976,25,166,1,165,1,1,0,1,1,80,79,86,86,93
"8712",11,"[25]oJHggqIHcdKocJvcGHqxdCBiK",171,0.994186,25,172,1,171,1,1,0,1,1,94,93,78,78,93
"8713",12,"[25]oJHggqIHcdKocJvcGHqxdCBiK",169,0.994118,25,170,1,169,1,1,0,1,1,90,89,80,80,93
"8714",13,"[25]oJHggqIHcdKocJvcGHqxdCBiK",166,0.994012,25,167,1,166,1,1,0,1,1,83,82,84,84,93
"8715",14,"[25]oJHggqIHcdKocJvcGHqxdCBiK",169,0.994118,25,170,1,169,1,1,0,1,1,90,89,80,80,93
"8716",15,"[25]oJHggqIHcdKocJvcGHqxdCBiK",167,0.994048,25,168,1,167,1,1,0,1,1,83,82,85,85,93
"8717",16,"[25]oJHggqIHcdKocJvcGHqxdCBiK",165,0.993976,25,166,1,165,1,1,0,1,1,76,75,90,90,93
"8718",17,"[25]oJHggqIHcdKocJvcGHqxdCBiK",168,0.994083,25,169,1,168,1,1,0,1,1,88,87,81,81,93
"8719",18,"[25]oJHggqIHcdKocJvcGHqxdCBiK",168,0.994083,25,169,1,168,1,1,0,1,1,88,87,81,81,93
"8720",19,"[25]oJHggqIHcdKocJvcGHqxdCBiK",167,0.994048,25,168,1,167,1,1,0,1,1,85,84,83,83,93
"8721",20,"[25]oJHggqIHcdKocJvcGHqxdCBiK",162,0.993865,25,163,1,162,1,1,0,1,1,71,70,92,92,93
"8722",21,"[25]oJHggqIHcdKocJvcGHqxdCBiK",168,0.994083,25,169,1,168,1,1,0,1,1,87,86,82,82,93
"8723",22,"[25]oJHggqIHcdKocJvcGHqxdCBiK",171,0.994186,25,172,1,171,1,1,0,1,1,97,96,75,75,93
"8724",23,"[25]oJHggqIHcdKocJvcGHqxdCBiK",173,0.994253,25,174,1,173,1,1,0,1,1,100,99,74,74,93
"8725",24,"[25]oJHggqIHcdKocJvcGHqxdCBiK",167,0.994048,25,168,1,167,1,1,0,1,1,84,83,84,84,93
"8726",25,"[25]oJHggqIHcdKocJvcGHqxdCBiK",165,0.993976,25,166,1,165,1,1,0,1,1,77,76,89,89,93
"8727",26,"[25]oJHggqIHcdKocJvcGHqxdCBiK",170,0.994152,25,171,1,170,1,1,0,1,1,92,91,79,79,93
"8728",27,"[25]oJHggqIHcdKocJvcGHqxdCBiK",170,0.994152,25,171,1,170,1,1,0,1,1,93,92,78,78,93
"8729",28,"[25]oJHggqIHcdKocJvcGHqxdCBiK",167,0.994048,25,168,1,167,1,1,0,1,1,84,83,84,84,93
"8730",29,"[25]oJHggqIHcdKocJvcGHqxdCBiK",166,0.994012,25,167,1,166,1,1,0,1,1,83,82,84,84,93
"8731",30,"[25]oJHggqIHcdKocJvcGHqxdCBiK",168,0.994083,25,169,1,168,1,1,0,1,1,88,87,81,81,93
"8732",31,"[25]oJHggqIHcdKocJvcGHqxdCBiK",169,0.994118,25,170,1,169,1,1,0,1,1,91,90,79,79,93
"8733",32,"[25]oJHggqIHcdKocJvcGHqxdCBiK",168,0.994083,25,169,1,168,1,1,0,1,1,86,85,83,83,93
"8734",33,"[25]oJHggqIHcdKocJvcGHqxdCBiK",171,0.994186,25,172,1,171,1,1,0,1,1,97,96,75,75,93
"8735",34,"[25]oJHggqIHcdKocJvcGHqxdCBiK",161,0.993827,25,162,1,161,1,1,0,1,1,69,68,93,93,93
"8736",35,"[25]oJHggqIHcdKocJvcGHqxdCBiK",164,0.993939,25,165,1,164,1,1,0,1,1,77,76,88,88,93
"8737",36,"[25]oJHggqIHcdKocJvcGHqxdCBiK",166,0.994012,25,167,1,166,1,1,0,1,1,81,80,86,86,93
"8738",37,"[25]oJHggqIHcdKocJvcGHqxdCBiK",162,0.993865,25,163,1,162,1,1,0,1,1,71,70,92,92,93
"8739",38,"[25]oJHggqIHcdKocJvcGHqxdCBiK",165,0.993976,25,166,1,165,1,1,0,1,1,78,77,88,88,93
"8740",39,"[25]oJHggqIHcdKocJvcGHqxdCBiK",171,0.994186,25,172,1,171,1,1,0,1,1,95,94,77,77,93
"8741",40,"[25]oJHggqIHcdKocJvcGHqxdCBiK",164,0.993939,25,165,1,164,1,1,0,1,1,77,76,88,88,93
"8742",41,"[25]oJHggqIHcdKocJvcGHqxdCBiK",166,0.994012,25,167,1,166,1,1,0,1,1,82,81,85,85,93
"8743",42,"[25]oJHggqIHcdKocJvcGHqxdCBiK",166,0.994012,25,167,1,166,1,1,0,1,1,83,82,84,84,93
"8744",43,"[25]oJHggqIHcdKocJvcGHqxdCBiK",167,0.994048,25,168,1,167,1,1,0,1,1,85,84,83,83,93
"8745",44,"[25]oJHggqIHcdKocJvcGHqxdCBiK",172,0.99422,25,173,1,172,1,1,0,1,1,97,96,76,76,93
"8746",45,"[25]oJHggqIHcdKocJvcGHqxdCBiK",167,0.994048,25,168,1,167,1,1,0,1,1,83,82,85,85,93
"8747",46,"[25]oJHggqIHcdKocJvcGHqxdCBiK",166,0.994012,25,167,1,166,1,1,0,1,1,81,80,86,86,93
"8748",47,"[25]oJHggqIHcdKocJvcGHqxdCBiK",164,0.993939,25,165,1,164,1,1,0,1,1,75,74,90,90,93
"8749",48,"[25]oJHggqIHcdKocJvcGHqxdCBiK",170,0.994152,25,171,1,170,1,1,0,1,1,92,91,79,79,93
"8750",49,"[25]oJHggqIHcdKocJvcGHqxdCBiK",166,0.994012,25,167,1,166,1,1,0,1,1,80,79,87,87,93
"8751",50,"[25]oJHggqIHcdKocJvcGHqxdCBiK",167,0.994048,25,168,1,167,1,1,0,1,1,84,83,84,84,93
"8752",51,"[25]oJHggqIHcdKocJvcGHqxdCBiK",165,0.993976,25,166,1,165,1,1,0,1,1,79,78,87,87,93
"8753",52,"[25]oJHggqIHcdKocJvcGHqxdCBiK",169,0.994118,25,170,1,169,1,1,0,1,1,91,90,79,79,93
"8754",53,"[25]oJHggqIHcdKocJvcGHqxdCBiK",166,0.994012,25,167,1,166,1,1,0,1,1,81,80,86,86,93
"8755",54,"[25]oJHggqIHcdKocJvcGHqxdCBiK",163,0.993902,25,164,1,163,1,1,0,1,1,75,74,89,89,93
"8756",55,"[25]oJHggqIHcdKocJvcGHqxdCBiK",163,0.993902,25,164,1,163,1,1,0,1,1,73,72,91,91,93
"8757",56,"[25]oJHggqIHcdKocJvcGHqxdCBiK",163,0.993902,25,164,1,163,1,1,0,1,1,74,73,90,90,93
"8758",57,"[25]oJHggqIHcdKocJvcGHqxdCBiK",166,0.994012,25,167,1,166,1,1,0,1,1,81,80,86,86,93
"8759",58,"[25]oJHggqIHcdKocJvcGHqxdCBiK",162,0.993865,25,163,1,162,1,1,0,1,1,72,71,91,91,93
"8760",59,"[25]oJHggqIHcdKocJvcGHqxdCBiK",170,0.994152,25,171,1,170,1,1,0,1,1,92,91,79,79,93
"8761",60,"[25]oJHggqIHcdKocJvcGHqxdCBiK",164,0.993939,25,165,1,164,1,1,0,1,1,76,75,89,89,93
"8762",61,"[25]oJHggqIHcdKocJvcGHqxdCBiK",171,0.994186,25,172,1,171,1,1,0,1,1,94,93,78,78,93
"8763",62,"[25]oJHggqIHcdKocJvcGHqxdCBiK",168,0.994083,25,169,1,168,1,1,0,1,1,86,85,83,83,93
"8764",63,"[25]oJHggqIHcdKocJvcGHqxdCBiK",167,0.994048,25,168,1,167,1,1,0,1,1,85,84,83,83,93
"8765",64,"[25]oJHggqIHcdKocJvcGHqxdCBiK",161,0.993827,25,162,1,161,1,1,0,1,1,67,66,95,95,93
"8766",65,"[25]oJHggqIHcdKocJvcGHqxdCBiK",165,0.993976,25,166,1,165,1,1,0,1,1,79,78,87,87,93
"8767",66,"[25]oJHggqIHcdKocJvcGHqxdCBiK",167,0.994048,25,168,1,167,1,1,0,1,1,85,84,83,83,93
"8768",67,"[25]oJHggqIHcdKocJvcGHqxdCBiK",169,0.994118,25,170,1,169,1,1,0,1,1,91,90,79,79,93
"8769",68,"[25]oJHggqIHcdKocJvcGHqxdCBiK",169,0.994118,25,170,1,169,1,1,0,1,1,91,90,79,79,93
"8770",69,"[25]oJHggqIHcdKocJvcGHqxdCBiK",166,0.994012,25,167,1,166,1,1,0,1,1,81,80,86,86,93
"8771",70,"[25]oJHggqIHcdKocJvcGHqxdCBiK",168,0.994083,25,169,1,168,1,1,0,1,1,87,86,82,82,93
"8772",71,"[25]oJHggqIHcdKocJvcGHqxdCBiK",169,0.994118,25,170,1,169,1,1,0,1,1,91,90,79,79,93
"8773",72,"[25]oJHggqIHcdKocJvcGHqxdCBiK",160,0.993789,25,161,1,160,1,1,0,1,1,65,64,96,96,93
"8774",73,"[25]oJHggqIHcdKocJvcGHqxdCBiK",164,0.993939,25,165,1,164,1,1,0,1,1,77,76,88,88,93
"8775",74,"[25]oJHggqIHcdKocJvcGHqxdCBiK",170,0.994152,25,171,1,170,1,1,0,1,1,93,92,78,78,93
"8776",75,"[25]oJHggqIHcdKocJvcGHqxdCBiK",171,0.994186,25,172,1,171,1,1,0,1,1,94,93,78,78,93
"8777",76,"[25]oJHggqIHcdKocJvcGHqxdCBiK",165,0.993976,25,166,1,165,1,1,0,1,1,80,79,86,86,93
"8778",77,"[25]oJHggqIHcdKocJvcGHqxdCBiK",169,0.994118,25,170,1,169,1,1,0,1,1,89,88,81,81,93
"8779",78,"[25]oJHggqIHcdKocJvcGHqxdCBiK",164,0.993939,25,165,1,164,1,1,0,1,1,77,76,88,88,93
"8780",79,"[25]oJHggqIHcdKocJvcGHqxdCBiK",165,0.993976,25,166,1,165,1,1,0,1,1,79,78,87,87,93
"8781",80,"[25]oJHggqIHcdKocJvcGHqxdCBiK",167,0.994048,25,168,1,167,1,1,0,1,1,84,83,84,84,93
"8782",81,"[25]oJHggqIHcdKocJvcGHqxdCBiK",173,0.994253,25,174,1,173,1,1,0,1,1,102,101,72,72,93
"8783",82,"[25]oJHggqIHcdKocJvcGHqxdCBiK",169,0.994118,25,170,1,169,1,1,0,1,1,90,89,80,80,93
"8784",83,"[25]oJHggqIHcdKocJvcGHqxdCBiK",163,0.993902,25,164,1,163,1,1,0,1,1,74,73,90,90,93
"8785",84,"[25]oJHggqIHcdKocJvcGHqxdCBiK",166,0.994012,25,167,1,166,1,1,0,1,1,82,81,85,85,93
"8786",85,"[25]oJHggqIHcdKocJvcGHqxdCBiK",166,0.994012,25,167,1,166,1,1,0,1,1,82,81,85,85,93
"8787",86,"[25]oJHggqIHcdKocJvcGHqxdCBiK",170,0.994152,25,171,1,170,1,1,0,1,1,90,89,81,81,93
"8788",87,"[25]oJHggqIHcdKocJvcGHqxdCBiK",166,0.994012,25,167,1,166,1,1,0,1,1,83,82,84,84,93
"8789",88,"[25]oJHggqIHcdKocJvcGHqxdCBiK",165,0.993976,25,166,1,165,1,1,0,1,1,80,79,86,86,93
"8790",89,"[25]oJHggqIHcdKocJvcGHqxdCBiK",165,0.993976,25,166,1,165,1,1,0,1,1,80,79,86,86,93
"8791",90,"[25]oJHggqIHcdKocJvcGHqxdCBiK",165,0.993976,25,166,1,165,1,1,0,1,1,78,77,88,88,93
"8792",91,"[25]oJHggqIHcdKocJvcGHqxdCBiK",165,0.993976,25,166,1,165,1,1,0,1,1,79,78,87,87,93
"8793",92,"[25]oJHggqIHcdKocJvcGHqxdCBiK",161,0.993827,25,162,1,161,1,1,0,1,1,67,66,95,95,93
"8794",93,"[25]oJHggqIHcdKocJvcGHqxdCBiK",171,0.994186,25,172,1,171,1,1,0,1,1,96,95,76,76,93
"8795",94,"[25]oJHggqIHcdKocJvcGHqxdCBiK",166,0.994012,25,167,1,166,1,1,0,1,1,83,82,84,84,93
"8796",95,"[25]oJHggqIHcdKocJvcGHqxdCBiK",169,0.994118,25,170,1,169,1,1,0,1,1,90,89,80,80,93
"8797",96,"[25]oJHggqIHcdKocJvcGHqxdCBiK",166,0.994012,25,167,1,166,1,1,0,1,1,81,80,86,86,93
"8798",97,"[25]oJHggqIHcdKocJvcGHqxdCBiK",168,0.994083,25,169,1,168,1,1,0,1,1,88,87,81,81,93
"8799",98,"[25]oJHggqIHcdKocJvcGHqxdCBiK",171,0.994186,25,172,1,171,1,1,0,1,1,96,95,76,76,93
"8800",99,"[25]oJHggqIHcdKocJvcGHqxdCBiK",166,0.994012,25,167,1,166,1,1,0,1,1,82,81,85,85,93
"8801",0,"[28]tJHggqIHcndKocJvcHqwdGCaAJgt",179,0.994444,28,180,1,179,1,1,0,1,1,93,92,87,87,95
"8802",1,"[28]tJHggqIHcndKocJvcHqwdGCaAJgt",175,0.994318,28,176,1,175,1,1,0,1,1,85,84,91,91,95
"8803",2,"[28]tJHggqIHcndKocJvcHqwdGCaAJgt",172,0.99422,28,173,1,172,1,1,0,1,1,80,79,93,93,95
"8804",3,"[28]tJHggqIHcndKocJvcHqwdGCaAJgt",175,0.994318,28,176,1,175,1,1,0,1,1,86,85,90,90,95
"8805",4,"[28]tJHggqIHcndKocJvcHqwdGCaAJgt",176,0.99435,28,177,1,176,1,1,0,1,1,88,87,89,89,95
"8806",5,"[28]tJHggqIHcndKocJvcHqwdGCaAJgt",182,0.994536,28,183,1,182,1,1,0,1,1,97,96,86,86,95
"8807",6,"[28]tJHggqIHcndKocJvcHqwdGCaAJgt",178,0.994413,28,179,1,178,1,1,0,1,1,92,91,87,87,95
"8808",7,"[28]tJHggqIHcndKocJvcHqwdGCaAJgt",184,0.994595,28,185,1,184,1,1,0,1,1,103,102,82,82,95
"8809",8,"[28]tJHggqIHcndKocJvcHqwdGCaAJgt",173,0.994253,28,174,1,173,1,1,0,1,1,81,80,93,93,95
"8810",9,"[28]tJHggqIHcndKocJvcHqwdGCaAJgt",181,0.994505,28,182,1,181,1,1,0,1,1,97,96,85,85,95
"8811",10,"[28]tJHggqIHcndKocJvcHqwdGCaAJgt",177,0.994382,28,178,1,177,1,1,0,1,1,91,90,87,87,95
"8812",11,"[28]tJHggqIHcndKocJvcHqwdGCaAJgt",175,0.994318,28,176,1,175,1,1,0,1,1,82,81,94,94,95
"8813",12,"[28]tJHggqIHcndKocJvcHqwdGCaAJgt",171,0.994186,28,172,1,171,1,1,0,1,1,77,76,95,95,95
"8814",13,"[28]tJHggqIHcndKocJvcHqwdGCaAJgt",191,0.994792,28,192,1,191,1,1,0,1,1,120,119,72,72,95
"8815",14,"[28]tJHggqIHcndKocJvcHqwdGCaAJgt",174,0.994286,28,175,1,174,1,1,0,1,1,83,82,92,92,95
"8816",15,"[28]tJHggqIHcndKocJvcHqwdGCaAJgt",174,0.994286,28,175,1,174,1,1,0,1,1,85,84,90,90,95
"8817",16,"[28]tJHggqIHcndKocJvcHqwdGCaAJgt",178,0.994413,28,179,1,178,1,1,0,1,1,94,93,85,85,95
"8818",17,"[28]tJHggqIHcndKocJvcHqwdGCaAJgt",175,0.994318,28,176,1,175,1,1,0,1,1,84,83,92,92,95
"8819",18,"[28]tJHggqIHcndKocJvcHqwdGCaAJgt",180,0.994475,28,181,1,180,1,1,0,1,1,98,97,83,83,95
"8820",19,"[28]tJHggqIHcndKocJvcHqwdGCaAJgt",174,0.994286,28,175,1,174,1,1,0,1,1,85,84,90,90,95
"8821",20,"[28]tJHggqIHcndKocJvcHqwdGCaAJgt",181,0.994505,28,182,1,181,1,1,0,1,1,98,97,84,84,95
"8822",21,"[28]tJHggqIHcndKocJvcHqwdGCaAJgt",179,0.994444,28,180,1,179,1,1,0,1,1,92,91,88,88,95
"8823",22,"[28]tJHggqIHcndKocJvcHqwdGCaAJgt",175,0.994318,28,176,1,175,1,1,0,1,1,87,86,89,89,95
"8824",23,"[28]tJHggqIHcndKocJvcHqwdGCaAJgt",179,0.994444,28,180,1,179,1,1,0,1,1,96,95,84,84,95
"8825",24,"[28]tJHggqIHcndKocJvcHqwdGCaAJgt",173,0.994253,28,174,1,173,1,1,0,1,1,83,82,91,91,95
"8826",25,"[28]tJHggqIHcndKocJvcHqwdGCaAJgt",172,0.99422,28,173,1,172,1,1,0,1,1,80,79,93,93,95
"8827",26,"[28]tJHggqIHcndKocJvcHqwdGCaAJgt",167,0.994048,28,168,1,167,1,1,0,1,1,69,68,99,99,95
"8828",27,"[28]tJHggqIHcndKocJvcHqwdGCaAJgt",180,0.994475,28,181,1,180,1,1,0,1,1,95,94,86,86,95
"8829",28,"[28]tJHggqIHcndKocJvcHqwdGCaAJgt",176,0.99435,28,177,1,176,1,1,0,1,1,89,88,88,88,95
"8830",29,"[28]tJHggqIHcndKocJvcHqwdGCaAJgt",171,0.994186,28,172,1,171,1,1,0,1,1,78,77,94,94,95
"8831",30,"[28]tJHggqIHcndKocJvcHqwdGCaAJgt",179,0.994444,28,180,1,179,1,1,0,1,1,95,94,85,85,95
"8832",31,"[28]tJHggqIHcndKocJvcHqwdGCaAJgt",177,0.994382,28,178,1,177,1,1,0,1,1,90,89,88,88,95
"8833",32,"[28]tJHggqIHcndKocJvcHqwdGCaAJgt",175,0.994318,28,176,1,175,1,1,0,1,1,87,86,89,89,95
"8834",33,"[28]tJHggqIHcndKocJvcHqwdGCaAJgt",173,0.994253,28,174,1,173,1,1,0,1,1,83,82,91,91,95
"8835",34,"[28]tJHggqIHcndKocJvcHqwdGCaAJgt",179,0.994444,28,180,1,179,1,1,0,1,1,92,91,88,88,95
"8836",35,"[28]tJHggqIHcndKocJvcHqwdGCaAJgt",173,0.994253,28,174,1,173,1,1,0,1,1,83,82,91,91,95
"8837",36,"[28]tJHggqIHcndKocJvcHqwdGCaAJgt",183,0.994565,28,184,1,183,1,1,0,1,1,103,102,81,81,95
"8838",37,"[28]tJHggqIHcndKocJvcHqwdGCaAJgt",179,0.994444,28,180,1,179,1,1,0,1,1,91,90,89,89,95
"8839",38,"[28]tJHggqIHcndKocJvcHqwdGCaAJgt",171,0.994186,28,172,1,171,1,1,0,1,1,78,77,94,94,95
"8840",39,"[28]tJHggqIHcndKocJvcHqwdGCaAJgt",183,0.994565,28,184,1,183,1,1,0,1,1,103,102,81,81,95
"8841",40,"[28]tJHggqIHcndKocJvcHqwdGCaAJgt",185,0.994624,28,186,1,185,1,1,0,1,1,104,103,82,82,95
"8842",41,"[28]tJHggqIHcndKocJvcHqwdGCaAJgt",177,0.994382,28,178,1,177,1,1,0,1,1,89,88,89,89,95
"8843",42,"[28]tJHggqIHcndKocJvcHqwdGCaAJgt",181,0.994505,28,182,1,181,1,1,0,1,1,99,98,83,83,95
"8844",43,"[28]tJHggqIHcndKocJvcHqwdGCaAJgt",182,0.994536,28,183,1,182,1,1,0,1,1,98,97,85,85,95
"8845",44,"[28]tJHggqIHcndKocJvcHqwdGCaAJgt",182,0.994536,28,183,1,182,1,1,0,1,1,101,100,82,82,95
"8846",45,"[28]tJHggqIHcndKocJvcHqwdGCaAJgt",182,0.994536,28,183,1,182,1,1,0,1,1,101,100,82,82,95
"8847",46,"[28]tJHggqIHcndKocJvcHqwdGCaAJgt",175,0.994318,28,176,1,175,1,1,0,1,1,83,82,93,93,95
"8848",47,"[28]tJHggqIHcndKocJvcHqwdGCaAJgt",173,0.994253,28,174,1,173,1,1,0,1,1,81,80,93,93,95
"8849",48,"[28]tJHggqIHcndKocJvcHqwdGCaAJgt",175,0.994318,28,176,1,175,1,1,0,1,1,87,86,89,89,95
"8850",49,"[28]tJHggqIHcndKocJvcHqwdGCaAJgt",179,0.994444,28,180,1,179,1,1,0,1,1,96,95,84,84,95
"8851",50,"[28]tJHggqIHcndKocJvcHqwdGCaAJgt",171,0.994186,28,172,1,171,1,1,0,1,1,78,77,94,94,95
"8852",51,"[28]tJHggqIHcndKocJvcHqwdGCaAJgt",175,0.994318,28,176,1,175,1,1,0,1,1,87,86,89,89,95
"8853",52,"[28]tJHggqIHcndKocJvcHqwdGCaAJgt",178,0.994413,28,179,1,178,1,1,0,1,1,91,90,88,88,95
"8854",53,"[28]tJHggqIHcndKocJvcHqwdGCaAJgt",169,0.994118,28,170,1,169,1,1,0,1,1,73,72,97,97,95
"8855",54,"[28]tJHggqIHcndKocJvcHqwdGCaAJgt",170,0.994152,28,171,1,170,1,1,0,1,1,74,73,97,97,95
"8856",55,"[28]tJHggqIHcndKocJvcHqwdGCaAJgt",173,0.994253,28,174,1,173,1,1,0,1,1,82,81,92,92,95
"8857",56,"[28]tJHggqIHcndKocJvcHqwdGCaAJgt",172,0.99422,28,173,1,172,1,1,0,1,1,80,79,93,93,95
"8858",57,"[28]tJHggqIHcndKocJvcHqwdGCaAJgt",179,0.994444,28,180,1,179,1,1,0,1,1,93,92,87,87,95
"8859",58,"[28]tJHggqIHcndKocJvcHqwdGCaAJgt",177,0.994382,28,178,1,177,1,1,0,1,1,91,90,87,87,95
"8860",59,"[28]tJHggqIHcndKocJvcHqwdGCaAJgt",179,0.994444,28,180,1,179,1,1,0,1,1,94,93,86,86,95
"8861",60,"[28]tJHggqIHcndKocJvcHqwdGCaAJgt",179,0.994444,28,180,1,179,1,1,0,1,1,94,93,86,86,95
"8862",61,"[28]tJHggqIHcndKocJvcHqwdGCaAJgt",172,0.99422,28,173,1,172,1,1,0,1,1,80,79,93,93,95
"8863",62,"[28]tJHggqIHcndKocJvcHqwdGCaAJgt",173,0.994253,28,174,1,173,1,1,0,1,1,82,81,92,92,95
"8864",63,"[28]tJHggqIHcndKocJvcHqwdGCaAJgt",177,0.994382,28,178,1,177,1,1,0,1,1,89,88,89,89,95
"8865",64,"[28]tJHggqIHcndKocJvcHqwdGCaAJgt",177,0.994382,28,178,1,177,1,1,0,1,1,90,89,88,88,95
"8866",65,"[28]tJHggqIHcndKocJvcHqwdGCaAJgt",181,0.994505,28,182,1,181,1,1,0,1,1,97,96,85,85,95
"8867",66,"[28]tJHggqIHcndKocJvcHqwdGCaAJgt",180,0.994475,28,181,1,180,1,1,0,1,1,97,96,84,84,95
"8868",67,"[28]tJHggqIHcndKocJvcHqwdGCaAJgt",178,0.994413,28,179,1,178,1,1,0,1,1,93,92,86,86,95
"8869",68,"[28]tJHggqIHcndKocJvcHqwdGCaAJgt",177,0.994382,28,178,1,177,1,1,0,1,1,86,85,92,92,95
"8870",69,"[28]tJHggqIHcndKocJvcHqwdGCaAJgt",178,0.994413,28,179,1,178,1,1,0,1,1,93,92,86,86,95
"8871",70,"[28]tJHggqIHcndKocJvcHqwdGCaAJgt",177,0.994382,28,178,1,177,1,1,0,1,1,86,85,92,92,95
"8872",71,"[28]tJHggqIHcndKocJvcHqwdGCaAJgt",179,0.994444,28,180,1,179,1,1,0,1,1,94,93,86,86,95
"8873",72,"[28]tJHggqIHcndKocJvcHqwdGCaAJgt",180,0.994475,28,181,1,180,1,1,0,1,1,96,95,85,85,95
"8874",73,"[28]tJHggqIHcndKocJvcHqwdGCaAJgt",178,0.994413,28,179,1,178,1,1,0,1,1,92,91,87,87,95
"8875",74,"[28]tJHggqIHcndKocJvcHqwdGCaAJgt",183,0.994565,28,184,1,183,1,1,0,1,1,104,103,80,80,95
"8876",75,"[28]tJHggqIHcndKocJvcHqwdGCaAJgt",179,0.994444,28,180,1,179,1,1,0,1,1,95,94,85,85,95
"8877",76,"[28]tJHggqIHcndKocJvcHqwdGCaAJgt",169,0.994118,28,170,1,169,1,1,0,1,1,73,72,97,97,95
"8878",77,"[28]tJHggqIHcndKocJvcHqwdGCaAJgt",180,0.994475,28,181,1,180,1,1,0,1,1,94,93,87,87,95
"8879",78,"[28]tJHggqIHcndKocJvcHqwdGCaAJgt",178,0.994413,28,179,1,178,1,1,0,1,1,94,93,85,85,95
"8880",79,"[28]tJHggqIHcndKocJvcHqwdGCaAJgt",175,0.994318,28,176,1,175,1,1,0,1,1,85,84,91,91,95
"8881",80,"[28]tJHggqIHcndKocJvcHqwdGCaAJgt",178,0.994413,28,179,1,178,1,1,0,1,1,92,91,87,87,95
"8882",81,"[28]tJHggqIHcndKocJvcHqwdGCaAJgt",178,0.994413,28,179,1,178,1,1,0,1,1,92,91,87,87,95
"8883",82,"[28]tJHggqIHcndKocJvcHqwdGCaAJgt",176,0.99435,28,177,1,176,1,1,0,1,1,88,87,89,89,95
"8884",83,"[28]tJHggqIHcndKocJvcHqwdGCaAJgt",179,0.994444,28,180,1,179,1,1,0,1,1,93,92,87,87,95
"8885",84,"[28]tJHggqIHcndKocJvcHqwdGCaAJgt",173,0.994253,28,174,1,173,1,1,0,1,1,77,76,97,97,95
"8886",85,"[28]tJHggqIHcndKocJvcHqwdGCaAJgt",186,0.994652,28,187,1,186,1,1,0,1,1,111,110,76,76,95
"8887",86,"[28]tJHggqIHcndKocJvcHqwdGCaAJgt",176,0.99435,28,177,1,176,1,1,0,1,1,89,88,88,88,95
"8888",87,"[28]tJHggqIHcndKocJvcHqwdGCaAJgt",187,0.994681,28,188,1,187,1,1,0,1,1,108,107,80,80,95
"8889",88,"[28]tJHggqIHcndKocJvcHqwdGCaAJgt",173,0.994253,28,174,1,173,1,1,0,1,1,81,80,93,93,95
"8890",89,"[28]tJHggqIHcndKocJvcHqwdGCaAJgt",178,0.994413,28,179,1,178,1,1,0,1,1,92,91,87,87,95
"8891",90,"[28]tJHggqIHcndKocJvcHqwdGCaAJgt",168,0.994083,28,169,1,168,1,1,0,1,1,72,71,97,97,95
"8892",91,"[28]tJHggqIHcndKocJvcHqwdGCaAJgt",172,0.99422,28,173,1,172,1,1,0,1,1,79,78,94,94,95
"8893",92,"[28]tJHggqIHcndKocJvcHqwdGCaAJgt",169,0.994118,28,170,1,169,1,1,0,1,1,72,71,98,98,95
"8894",93,"[28]tJHggqIHcndKocJvcHqwdGCaAJgt",176,0.99435,28,177,1,176,1,1,0,1,1,88,87,89,89,95
"8895",94,"[28]tJHggqIHcndKocJvcHqwdGCaAJgt",174,0.994286,28,175,1,174,1,1,0,1,1,85,84,90,90,95
"8896",95,"[28]tJHggqIHcndKocJvcHqwdGCaAJgt",175,0.994318,28,176,1,175,1,1,0,1,1,86,85,90,90,95
"8897",96,"[28]tJHggqIHcndKocJvcHqwdGCaAJgt",171,0.994186,28,172,1,171,1,1,0,1,1,77,76,95,95,95
"8898",97,"[28]tJHggqIHcndKocJvcHqwdGCaAJgt",175,0.994318,28,176,1,175,1,1,0,1,1,86,85,90,90,95
"8899",98,"[28]tJHggqIHcndKocJvcHqwdGCaAJgt",176,0.99435,28,177,1,176,1,1,0,1,1,88,87,89,89,95
"8900",99,"[28]tJHggqIHcndKocJvcHqwdGCaAJgt",180,0.994475,28,181,1,180,1,1,0,1,1,97,96,84,84,95
"8901",0,"[27]sJHggqIHcdKocJvcGHqwdCskDHr",170,0.994152,27,171,1,170,1,1,0,1,1,92,91,79,79,97
"8902",1,"[27]sJHggqIHcdKocJvcGHqwdCskDHr",169,0.994118,27,170,1,169,1,1,0,1,1,88,87,82,82,97
"8903",2,"[27]sJHggqIHcdKocJvcGHqwdCskDHr",165,0.993976,27,166,1,165,1,1,0,1,1,79,78,87,87,97
"8904",3,"[27]sJHggqIHcdKocJvcGHqwdCskDHr",168,0.994083,27,169,1,168,1,1,0,1,1,86,85,83,83,97
"8905",4,"[27]sJHggqIHcdKocJvcGHqwdCskDHr",167,0.994048,27,168,1,167,1,1,0,1,1,86,85,82,82,97
"8906",5,"[27]sJHggqIHcdKocJvcGHqwdCskDHr",166,0.994012,27,167,1,166,1,1,0,1,1,81,80,86,86,97
"8907",6,"[27]sJHggqIHcdKocJvcGHqwdCskDHr",165,0.993976,27,166,1,165,1,1,0,1,1,80,79,86,86,97
"8908",7,"[27]sJHggqIHcdKocJvcGHqwdCskDHr",165,0.993976,27,166,1,165,1,1,0,1,1,80,79,86,86,97
"8909",8,"[27]sJHggqIHcdKocJvcGHqwdCskDHr",170,0.994152,27,171,1,170,1,1,0,1,1,91,90,80,80,97
"8910",9,"[27]sJHggqIHcdKocJvcGHqwdCskDHr",167,0.994048,27,168,1,167,1,1,0,1,1,84,83,84,84,97
"8911",10,"[27]sJHggqIHcdKocJvcGHqwdCskDHr",170,0.994152,27,171,1,170,1,1,0,1,1,92,91,79,79,97
"8912",11,"[27]sJHggqIHcdKocJvcGHqwdCskDHr",164,0.993939,27,165,1,164,1,1,0,1,1,77,76,88,88,97
"8913",12,"[27]sJHggqIHcdKocJvcGHqwdCskDHr",166,0.994012,27,167,1,166,1,1,0,1,1,81,80,86,86,97
"8914",13,"[27]sJHggqIHcdKocJvcGHqwdCskDHr",169,0.994118,27,170,1,169,1,1,0,1,1,89,88,81,81,97
"8915",14,"[27]sJHggqIHcdKocJvcGHqwdCskDHr",165,0.993976,27,166,1,165,1,1,0,1,1,80,79,86,86,97
"8916",15,"[27]sJHggqIHcdKocJvcGHqwdCskDHr",170,0.994152,27,171,1,170,1,1,0,1,1,92,91,79,79,97
"8917",16,"[27]sJHggqIHcdKocJvcGHqwdCskDHr",163,0.993902,27,164,1,163,1,1,0,1,1,74,73,90,90,97
"8918",17,"[27]sJHggqIHcdKocJvcGHqwdCskDHr",165,0.993976,27,166,1,165,1,1,0,1,1,79,78,87,87,97
"8919",18,"[27]sJHggqIHcdKocJvcGHqwdCskDHr",167,0.994048,27,168,1,167,1,1,0,1,1,86,85,82,82,97
"8920",19,"[27]sJHggqIHcdKocJvcGHqwdCskDHr",163,0.993902,27,164,1,163,1,1,0,1,1,74,73,90,90,97
"8921",20,"[27]sJHggqIHcdKocJvcGHqwdCskDHr",173,0.994253,27,174,1,173,1,1,0,1,1,100,99,74,74,97
"8922",21,"[27]sJHggqIHcdKocJvcGHqwdCskDHr",166,0.994012,27,167,1,166,1,1,0,1,1,81,80,86,86,97
"8923",22,"[27]sJHggqIHcdKocJvcGHqwdCskDHr",172,0.99422,27,173,1,172,1,1,0,1,1,99,98,74,74,97
"8924",23,"[27]sJHggqIHcdKocJvcGHqwdCskDHr",166,0.994012,27,167,1,166,1,1,0,1,1,81,80,86,86,97
"8925",24,"[27]sJHggqIHcdKocJvcGHqwdCskDHr",164,0.993939,27,165,1,164,1,1,0,1,1,77,76,88,88,97
"8926",25,"[27]sJHggqIHcdKocJvcGHqwdCskDHr",166,0.994012,27,167,1,166,1,1,0,1,1,83,82,84,84,97
"8927",26,"[27]sJHggqIHcdKocJvcGHqwdCskDHr",166,0.994012,27,167,1,166,1,1,0,1,1,83,82,84,84,97
"8928",27,"[27]sJHggqIHcdKocJvcGHqwdCskDHr",169,0.994118,27,170,1,169,1,1,0,1,1,90,89,80,80,97
"8929",28,"[27]sJHggqIHcdKocJvcGHqwdCskDHr",174,0.994286,27,175,1,174,1,1,0,1,1,104,103,71,71,97
"8930",29,"[27]sJHggqIHcdKocJvcGHqwdCskDHr",165,0.993976,27,166,1,165,1,1,0,1,1,80,79,86,86,97
"8931",30,"[27]sJHggqIHcdKocJvcGHqwdCskDHr",165,0.993976,27,166,1,165,1,1,0,1,1,80,79,86,86,97
"8932",31,"[27]sJHggqIHcdKocJvcGHqwdCskDHr",171,0.994186,27,172,1,171,1,1,0,1,1,94,93,78,78,97
"8933",32,"[27]sJHggqIHcdKocJvcGHqwdCskDHr",168,0.994083,27,169,1,168,1,1,0,1,1,87,86,82,82,97
"8934",33,"[27]sJHggqIHcdKocJvcGHqwdCskDHr",164,0.993939,27,165,1,164,1,1,0,1,1,76,75,89,89,97
"8935",34,"[27]sJHggqIHcdKocJvcGHqwdCskDHr",169,0.994118,27,170,1,169,1,1,0,1,1,90,89,80,80,97
"8936",35,"[27]sJHggqIHcdKocJvcGHqwdCskDHr",167,0.994048,27,168,1,167,1,1,0,1,1,84,83,84,84,97
"8937",36,"[27]sJHggqIHcdKocJvcGHqwdCskDHr",164,0.993939,27,165,1,164,1,1,0,1,1,77,76,88,88,97
"8938",37,"[27]sJHggqIHcdKocJvcGHqwdCskDHr",161,0.993827,27,162,1,161,1,1,0,1,1,68,67,94,94,97
"8939",38,"[27]sJHggqIHcdKocJvcGHqwdCskDHr",168,0.994083,27,169,1,168,1,1,0,1,1,88,87,81,81,97
"8940",39,"[27]sJHggqIHcdKocJvcGHqwdCskDHr",169,0.994118,27,170,1,169,1,1,0,1,1,89,88,81,81,97
"8941",40,"[27]sJHggqIHcdKocJvcGHqwdCskDHr",170,0.994152,27,171,1,170,1,1,0,1,1,93,92,78,78,97
"8942",41,"[27]sJHggqIHcdKocJvcGHqwdCskDHr",170,0.994152,27,171,1,170,1,1,0,1,1,92,91,79,79,97
"8943",42,"[27]sJHggqIHcdKocJvcGHqwdCskDHr",162,0.993865,27,163,1,162,1,1,0,1,1,71,70,92,92,97
"8944",43,"[27]sJHggqIHcdKocJvcGHqwdCskDHr",171,0.994186,27,172,1,171,1,1,0,1,1,94,93,78,78,97
"8945",44,"[27]sJHggqIHcdKocJvcGHqwdCskDHr",170,0.994152,27,171,1,170,1,1,0,1,1,93,92,78,78,97
"8946",45,"[27]sJHggqIHcdKocJvcGHqwdCskDHr",165,0.993976,27,166,1,165,1,1,0,1,1,80,79,86,86,97
"8947",46,"[27]sJHggqIHcdKocJvcGHqwdCskDHr",162,0.993865,27,163,1,162,1,1,0,1,1,70,69,93,93,97
"8948",47,"[27]sJHggqIHcdKocJvcGHqwdCskDHr",167,0.994048,27,168,1,167,1,1,0,1,1,84,83,84,84,97
"8949",48,"[27]sJHggqIHcdKocJvcGHqwdCskDHr",164,0.993939,27,165,1,164,1,1,0,1,1,76,75,89,89,97
"8950",49,"[27]sJHggqIHcdKocJvcGHqwdCskDHr",173,0.994253,27,174,1,173,1,1,0,1,1,97,96,77,77,97
"8951",50,"[27]sJHggqIHcdKocJvcGHqwdCskDHr",166,0.994012,27,167,1,166,1,1,0,1,1,82,81,85,85,97
"8952",51,"[27]sJHggqIHcdKocJvcGHqwdCskDHr",165,0.993976,27,166,1,165,1,1,0,1,1,78,77,88,88,97
"8953",52,"[27]sJHggqIHcdKocJvcGHqwdCskDHr",168,0.994083,27,169,1,168,1,1,0,1,1,88,87,81,81,97
"8954",53,"[27]sJHggqIHcdKocJvcGHqwdCskDHr",166,0.994012,27,167,1,166,1,1,0,1,1,83,82,84,84,97
"8955",54,"[27]sJHggqIHcdKocJvcGHqwdCskDHr",160,0.993789,27,161,1,160,1,1,0,1,1,65,64,96,96,97
"8956",55,"[27]sJHggqIHcdKocJvcGHqwdCskDHr",163,0.993902,27,164,1,163,1,1,0,1,1,74,73,90,90,97
"8957",56,"[27]sJHggqIHcdKocJvcGHqwdCskDHr",165,0.993976,27,166,1,165,1,1,0,1,1,77,76,89,89,97
"8958",57,"[27]sJHggqIHcdKocJvcGHqwdCskDHr",165,0.993976,27,166,1,165,1,1,0,1,1,80,79,86,86,97
"8959",58,"[27]sJHggqIHcdKocJvcGHqwdCskDHr",167,0.994048,27,168,1,167,1,1,0,1,1,85,84,83,83,97
"8960",59,"[27]sJHggqIHcdKocJvcGHqwdCskDHr",166,0.994012,27,167,1,166,1,1,0,1,1,82,81,85,85,97
"8961",60,"[27]sJHggqIHcdKocJvcGHqwdCskDHr",171,0.994186,27,172,1,171,1,1,0,1,1,97,96,75,75,97
"8962",61,"[27]sJHggqIHcdKocJvcGHqwdCskDHr",168,0.994083,27,169,1,168,1,1,0,1,1,88,87,81,81,97
"8963",62,"[27]sJHggqIHcdKocJvcGHqwdCskDHr",172,0.99422,27,173,1,172,1,1,0,1,1,99,98,74,74,97
"8964",63,"[27]sJHggqIHcdKocJvcGHqwdCskDHr",171,0.994186,27,172,1,171,1,1,0,1,1,95,94,77,77,97
"8965",64,"[27]sJHggqIHcdKocJvcGHqwdCskDHr",167,0.994048,27,168,1,167,1,1,0,1,1,85,84,83,83,97
"8966",65,"[27]sJHggqIHcdKocJvcGHqwdCskDHr",167,0.994048,27,168,1,167,1,1,0,1,1,85,84,83,83,97
"8967",66,"[27]sJHggqIHcdKocJvcGHqwdCskDHr",164,0.993939,27,165,1,164,1,1,0,1,1,76,75,89,89,97
"8968",67,"[27]sJHggqIHcdKocJvcGHqwdCskDHr",167,0.994048,27,168,1,167,1,1,0,1,1,84,83,84,84,97
"8969",68,"[27]sJHggqIHcdKocJvcGHqwdCskDHr",172,0.99422,27,173,1,172,1,1,0,1,1,97,96,76,76,97
"8970",69,"[27]sJHggqIHcdKocJvcGHqwdCskDHr",162,0.993865,27,163,1,162,1,1,0,1,1,70,69,93,93,97
"8971",70,"[27]sJHggqIHcdKocJvcGHqwdCskDHr",167,0.994048,27,168,1,167,1,1,0,1,1,85,84,83,83,97
"8972",71,"[27]sJHggqIHcdKocJvcGHqwdCskDHr",165,0.993976,27,166,1,165,1,1,0,1,1,80,79,86,86,97
"8973",72,"[27]sJHggqIHcdKocJvcGHqwdCskDHr",167,0.994048,27,168,1,167,1,1,0,1,1,86,85,82,82,97
"8974",73,"[27]sJHggqIHcdKocJvcGHqwdCskDHr",167,0.994048,27,168,1,167,1,1,0,1,1,84,83,84,84,97
"8975",74,"[27]sJHggqIHcdKocJvcGHqwdCskDHr",173,0.994253,27,174,1,173,1,1,0,1,1,102,101,72,72,97
"8976",75,"[27]sJHggqIHcdKocJvcGHqwdCskDHr",169,0.994118,27,170,1,169,1,1,0,1,1,90,89,80,80,97
"8977",76,"[27]sJHggqIHcdKocJvcGHqwdCskDHr",167,0.994048,27,168,1,167,1,1,0,1,1,86,85,82,82,97
"8978",77,"[27]sJHggqIHcdKocJvcGHqwdCskDHr",162,0.993865,27,163,1,162,1,1,0,1,1,72,71,91,91,97
"8979",78,"[27]sJHggqIHcdKocJvcGHqwdCskDHr",167,0.994048,27,168,1,167,1,1,0,1,1,85,84,83,83,97
"8980",79,"[27]sJHggqIHcdKocJvcGHqwdCskDHr",169,0.994118,27,170,1,169,1,1,0,1,1,91,90,79,79,97
"8981",80,"[27]sJHggqIHcdKocJvcGHqwdCskDHr",170,0.994152,27,171,1,170,1,1,0,1,1,92,91,79,79,97
"8982",81,"[27]sJHggqIHcdKocJvcGHqwdCskDHr",167,0.994048,27,168,1,167,1,1,0,1,1,85,84,83,83,97
"8983",82,"[27]sJHggqIHcdKocJvcGHqwdCskDHr",165,0.993976,27,166,1,165,1,1,0,1,1,78,77,88,88,97
"8984",83,"[27]sJHggqIHcdKocJvcGHqwdCskDHr",167,0.994048,27,168,1,167,1,1,0,1,1,85,84,83,83,97
"8985",84,"[27]sJHggqIHcdKocJvcGHqwdCskDHr",167,0.994048,27,168,1,167,1,1,0,1,1,85,84,83,83,97
"8986",85,"[27]sJHggqIHcdKocJvcGHqwdCskDHr",163,0.993902,27,164,1,163,1,1,0,1,1,75,74,89,89,97
"8987",86,"[27]sJHggqIHcdKocJvcGHqwdCskDHr",167,0.994048,27,168,1,167,1,1,0,1,1,86,85,82,82,97
"8988",87,"[27]sJHggqIHcdKocJvcGHqwdCskDHr",170,0.994152,27,171,1,170,1,1,0,1,1,93,92,78,78,97
"8989",88,"[27]sJHggqIHcdKocJvcGHqwdCskDHr",164,0.993939,27,165,1,164,1,1,0,1,1,76,75,89,89,97
"8990",89,"[27]sJHggqIHcdKocJvcGHqwdCskDHr",163,0.993902,27,164,1,163,1,1,0,1,1,75,74,89,89,97
"8991",90,"[27]sJHggqIHcdKocJvcGHqwdCskDHr",172,0.99422,27,173,1,172,1,1,0,1,1,96,95,77,77,97
"8992",91,"[27]sJHggqIHcdKocJvcGHqwdCskDHr",170,0.994152,27,171,1,170,1,1,0,1,1,93,92,78,78,97
"8993",92,"[27]sJHggqIHcdKocJvcGHqwdCskDHr",165,0.993976,27,166,1,165,1,1,0,1,1,78,77,88,88,97
"8994",93,"[27]sJHggqIHcdKocJvcGHqwdCskDHr",166,0.994012,27,167,1,166,1,1,0,1,1,81,80,86,86,97
"8995",94,"[27]sJHggqIHcdKocJvcGHqwdCskDHr",168,0.994083,27,169,1,168,1,1,0,1,1,86,85,83,83,97
"8996",95,"[27]sJHggqIHcdKocJvcGHqwdCskDHr",166,0.994012,27,167,1,166,1,1,0,1,1,83,82,84,84,97
"8997",96,"[27]sJHggqIHcdKocJvcGHqwdCskDHr",162,0.993865,27,163,1,162,1,1,0,1,1,71,70,92,92,97
"8998",97,"[27]sJHggqIHcdKocJvcGHqwdCskDHr",163,0.993902,27,164,1,163,1,1,0,1,1,72,71,92,92,97
"8999",98,"[27]sJHggqIHcdKocJvcGHqwdCskDHr",167,0.994048,27,168,1,167,1,1,0,1,1,84,83,84,84,97
"9000",99,"[27]sJHggqIHcdKocJvcGHqwdCskDHr",163,0.993902,27,164,1,163,1,1,0,1,1,72,71,92,92,97
"9001",0,"[35]tJHiqHIxHcdKpcJvcGHqxdCjBKlrHmyFgHr",170,0.994152,35,171,1,170,1,1,0,1,1,92,91,79,79,98
"9002",1,"[35]tJHiqHIxHcdKpcJvcGHqxdCjBKlrHmyFgHr",167,0.994048,35,168,1,167,1,1,0,1,1,85,84,83,83,98
"9003",2,"[35]tJHiqHIxHcdKpcJvcGHqxdCjBKlrHmyFgHr",165,0.993976,35,166,1,165,1,1,0,1,1,79,78,87,87,98
"9004",3,"[35]tJHiqHIxHcdKpcJvcGHqxdCjBKlrHmyFgHr",167,0.994048,35,168,1,167,1,1,0,1,1,84,83,84,84,98
"9005",4,"[35]tJHiqHIxHcdKpcJvcGHqxdCjBKlrHmyFgHr",167,0.994048,35,168,1,167,1,1,0,1,1,84,83,84,84,98
"9006",5,"[35]tJHiqHIxHcdKpcJvcGHqxdCjBKlrHmyFgHr",169,0.994118,35,170,1,169,1,1,0,1,1,90,89,80,80,98
"9007",6,"[35]tJHiqHIxHcdKpcJvcGHqxdCjBKlrHmyFgHr",170,0.994152,35,171,1,170,1,1,0,1,1,94,93,77,77,98
"9008",7,"[35]tJHiqHIxHcdKpcJvcGHqxdCjBKlrHmyFgHr",172,0.99422,35,173,1,172,1,1,0,1,1,98,97,75,75,98
"9009",8,"[35]tJHiqHIxHcdKpcJvcGHqxdCjBKlrHmyFgHr",167,0.994048,35,168,1,167,1,1,0,1,1,84,83,84,84,98
"9010",9,"[35]tJHiqHIxHcdKpcJvcGHqxdCjBKlrHmyFgHr",170,0.994152,35,171,1,170,1,1,0,1,1,89,88,82,82,98
"9011",10,"[35]tJHiqHIxHcdKpcJvcGHqxdCjBKlrHmyFgHr",167,0.994048,35,168,1,167,1,1,0,1,1,83,82,85,85,98
"9012",11,"[35]tJHiqHIxHcdKpcJvcGHqxdCjBKlrHmyFgHr",165,0.993976,35,166,1,165,1,1,0,1,1,80,79,86,86,98
"9013",12,"[35]tJHiqHIxHcdKpcJvcGHqxdCjBKlrHmyFgHr",166,0.994012,35,167,1,166,1,1,0,1,1,82,81,85,85,98
"9014",13,"[35]tJHiqHIxHcdKpcJvcGHqxdCjBKlrHmyFgHr",168,0.994083,35,169,1,168,1,1,0,1,1,88,87,81,81,98
"9015",14,"[35]tJHiqHIxHcdKpcJvcGHqxdCjBKlrHmyFgHr",168,0.994083,35,169,1,168,1,1,0,1,1,89,88,80,80,98
"9016",15,"[35]tJHiqHIxHcdKpcJvcGHqxdCjBKlrHmyFgHr",167,0.994048,35,168,1,167,1,1,0,1,1,86,85,82,82,98
"9017",16,"[35]tJHiqHIxHcdKpcJvcGHqxdCjBKlrHmyFgHr",171,0.994186,35,172,1,171,1,1,0,1,1,94,93,78,78,98
"9018",17,"[35]tJHiqHIxHcdKpcJvcGHqxdCjBKlrHmyFgHr",170,0.994152,35,171,1,170,1,1,0,1,1,93,92,78,78,98
"9019",18,"[35]tJHiqHIxHcdKpcJvcGHqxdCjBKlrHmyFgHr",165,0.993976,35,166,1,165,1,1,0,1,1,80,79,86,86,98
"9020",19,"[35]tJHiqHIxHcdKpcJvcGHqxdCjBKlrHmyFgHr",167,0.994048,35,168,1,167,1,1,0,1,1,84,83,84,84,98
"9021",20,"[35]tJHiqHIxHcdKpcJvcGHqxdCjBKlrHmyFgHr",173,0.994253,35,174,1,173,1,1,0,1,1,96,95,78,78,98
"9022",21,"[35]tJHiqHIxHcdKpcJvcGHqxdCjBKlrHmyFgHr",171,0.994186,35,172,1,171,1,1,0,1,1,96,95,76,76,98
"9023",22,"[35]tJHiqHIxHcdKpcJvcGHqxdCjBKlrHmyFgHr",167,0.994048,35,168,1,167,1,1,0,1,1,84,83,84,84,98
"9024",23,"[35]tJHiqHIxHcdKpcJvcGHqxdCjBKlrHmyFgHr",164,0.993939,35,165,1,164,1,1,0,1,1,77,76,88,88,98
"9025",24,"[35]tJHiqHIxHcdKpcJvcGHqxdCjBKlrHmyFgHr",169,0.994118,35,170,1,169,1,1,0,1,1,89,88,81,81,98
"9026",25,"[35]tJHiqHIxHcdKpcJvcGHqxdCjBKlrHmyFgHr",166,0.994012,35,167,1,166,1,1,0,1,1,81,80,86,86,98
"9027",26,"[35]tJHiqHIxHcdKpcJvcGHqxdCjBKlrHmyFgHr",167,0.994048,35,168,1,167,1,1,0,1,1,85,84,83,83,98
"9028",27,"[35]tJHiqHIxHcdKpcJvcGHqxdCjBKlrHmyFgHr",168,0.994083,35,169,1,168,1,1,0,1,1,87,86,82,82,98
"9029",28,"[35]tJHiqHIxHcdKpcJvcGHqxdCjBKlrHmyFgHr",163,0.993902,35,164,1,163,1,1,0,1,1,74,73,90,90,98
"9030",29,"[35]tJHiqHIxHcdKpcJvcGHqxdCjBKlrHmyFgHr",169,0.994118,35,170,1,169,1,1,0,1,1,90,89,80,80,98
"9031",30,"[35]tJHiqHIxHcdKpcJvcGHqxdCjBKlrHmyFgHr",167,0.994048,35,168,1,167,1,1,0,1,1,86,85,82,82,98
"9032",31,"[35]tJHiqHIxHcdKpcJvcGHqxdCjBKlrHmyFgHr",162,0.993865,35,163,1,162,1,1,0,1,1,70,69,93,93,98
"9033",32,"[35]tJHiqHIxHcdKpcJvcGHqxdCjBKlrHmyFgHr",168,0.994083,35,169,1,168,1,1,0,1,1,89,88,80,80,98
"9034",33,"[35]tJHiqHIxHcdKpcJvcGHqxdCjBKlrHmyFgHr",166,0.994012,35,167,1,166,1,1,0,1,1,81,80,86,86,98
"9035",34,"[35]tJHiqHIxHcdKpcJvcGHqxdCjBKlrHmyFgHr",164,0.993939,35,165,1,164,1,1,0,1,1,76,75,89,89,98
"9036",35,"[35]tJHiqHIxHcdKpcJvcGHqxdCjBKlrHmyFgHr",168,0.994083,35,169,1,168,1,1,0,1,1,88,87,81,81,98
"9037",36,"[35]tJHiqHIxHcdKpcJvcGHqxdCjBKlrHmyFgHr",163,0.993902,35,164,1,163,1,1,0,1,1,75,74,89,89,98
"9038",37,"[35]tJHiqHIxHcdKpcJvcGHqxdCjBKlrHmyFgHr",167,0.994048,35,168,1,167,1,1,0,1,1,85,84,83,83,98
"9039",38,"[35]tJHiqHIxHcdKpcJvcGHqxdCjBKlrHmyFgHr",167,0.994048,35,168,1,167,1,1,0,1,1,85,84,83,83,98
"9040",39,"[35]tJHiqHIxHcdKpcJvcGHqxdCjBKlrHmyFgHr",172,0.99422,35,173,1,172,1,1,0,1,1,100,99,73,73,98
"9041",40,"[35]tJHiqHIxHcdKpcJvcGHqxdCjBKlrHmyFgHr",166,0.994012,35,167,1,166,1,1,0,1,1,83,82,84,84,98
"9042",41,"[35]tJHiqHIxHcdKpcJvcGHqxdCjBKlrHmyFgHr",164,0.993939,35,165,1,164,1,1,0,1,1,78,77,87,87,98
"9043",42,"[35]tJHiqHIxHcdKpcJvcGHqxdCjBKlrHmyFgHr",168,0.994083,35,169,1,168,1,1,0,1,1,87,86,82,82,98
"9044",43,"[35]tJHiqHIxHcdKpcJvcGHqxdCjBKlrHmyFgHr",169,0.994118,35,170,1,169,1,1,0,1,1,90,89,80,80,98
"9045",44,"[35]tJHiqHIxHcdKpcJvcGHqxdCjBKlrHmyFgHr",170,0.994152,35,171,1,170,1,1,0,1,1,93,92,78,78,98
"9046",45,"[35]tJHiqHIxHcdKpcJvcGHqxdCjBKlrHmyFgHr",161,0.993827,35,162,1,161,1,1,0,1,1,67,66,95,95,98
"9047",46,"[35]tJHiqHIxHcdKpcJvcGHqxdCjBKlrHmyFgHr",164,0.993939,35,165,1,164,1,1,0,1,1,77,76,88,88,98
"9048",47,"[35]tJHiqHIxHcdKpcJvcGHqxdCjBKlrHmyFgHr",168,0.994083,35,169,1,168,1,1,0,1,1,88,87,81,81,98
"9049",48,"[35]tJHiqHIxHcdKpcJvcGHqxdCjBKlrHmyFgHr",167,0.994048,35,168,1,167,1,1,0,1,1,84,83,84,84,98
"9050",49,"[35]tJHiqHIxHcdKpcJvcGHqxdCjBKlrHmyFgHr",168,0.994083,35,169,1,168,1,1,0,1,1,88,87,81,81,98
"9051",50,"[35]tJHiqHIxHcdKpcJvcGHqxdCjBKlrHmyFgHr",166,0.994012,35,167,1,166,1,1,0,1,1,82,81,85,85,98
"9052",51,"[35]tJHiqHIxHcdKpcJvcGHqxdCjBKlrHmyFgHr",166,0.994012,35,167,1,166,1,1,0,1,1,82,81,85,85,98
"9053",52,"[35]tJHiqHIxHcdKpcJvcGHqxdCjBKlrHmyFgHr",168,0.994083,35,169,1,168,1,1,0,1,1,86,85,83,83,98
"9054",53,"[35]tJHiqHIxHcdKpcJvcGHqxdCjBKlrHmyFgHr",170,0.994152,35,171,1,170,1,1,0,1,1,93,92,78,78,98
"9055",54,"[35]tJHiqHIxHcdKpcJvcGHqxdCjBKlrHmyFgHr",163,0.993902,35,164,1,163,1,1,0,1,1,71,70,93,93,98
"9056",55,"[35]tJHiqHIxHcdKpcJvcGHqxdCjBKlrHmyFgHr",163,0.993902,35,164,1,163,1,1,0,1,1,73,72,91,91,98
"9057",56,"[35]tJHiqHIxHcdKpcJvcGHqxdCjBKlrHmyFgHr",169,0.994118,35,170,1,169,1,1,0,1,1,89,88,81,81,98
"9058",57,"[35]tJHiqHIxHcdKpcJvcGHqxdCjBKlrHmyFgHr",165,0.993976,35,166,1,165,1,1,0,1,1,78,77,88,88,98
"9059",58,"[35]tJHiqHIxHcdKpcJvcGHqxdCjBKlrHmyFgHr",169,0.994118,35,170,1,169,1,1,0,1,1,86,85,84,84,98
"9060",59,"[35]tJHiqHIxHcdKpcJvcGHqxdCjBKlrHmyFgHr",168,0.994083,35,169,1,168,1,1,0,1,1,87,86,82,82,98
"9061",60,"[35]tJHiqHIxHcdKpcJvcGHqxdCjBKlrHmyFgHr",167,0.994048,35,168,1,167,1,1,0,1,1,83,82,85,85,98
"9062",61,"[35]tJHiqHIxHcdKpcJvcGHqxdCjBKlrHmyFgHr",164,0.993939,35,165,1,164,1,1,0,1,1,76,75,89,89,98
"9063",62,"[35]tJHiqHIxHcdKpcJvcGHqxdCjBKlrHmyFgHr",168,0.994083,35,169,1,168,1,1,0,1,1,89,88,80,80,98
"9064",63,"[35]tJHiqHIxHcdKpcJvcGHqxdCjBKlrHmyFgHr",166,0.994012,35,167,1,166,1,1,0,1,1,82,81,85,85,98
"9065",64,"[35]tJHiqHIxHcdKpcJvcGHqxdCjBKlrHmyFgHr",165,0.993976,35,166,1,165,1,1,0,1,1,78,77,88,88,98
"9066",65,"[35]tJHiqHIxHcdKpcJvcGHqxdCjBKlrHmyFgHr",167,0.994048,35,168,1,167,1,1,0,1,1,85,84,83,83,98
"9067",66,"[35]tJHiqHIxHcdKpcJvcGHqxdCjBKlrHmyFgHr",163,0.993902,35,164,1,163,1,1,0,1,1,75,74,89,89,98
"9068",67,"[35]tJHiqHIxHcdKpcJvcGHqxdCjBKlrHmyFgHr",169,0.994118,35,170,1,169,1,1,0,1,1,90,89,80,80,98
"9069",68,"[35]tJHiqHIxHcdKpcJvcGHqxdCjBKlrHmyFgHr",171,0.994186,35,172,1,171,1,1,0,1,1,96,95,76,76,98
"9070",69,"[35]tJHiqHIxHcdKpcJvcGHqxdCjBKlrHmyFgHr",168,0.994083,35,169,1,168,1,1,0,1,1,85,84,84,84,98
"9071",70,"[35]tJHiqHIxHcdKpcJvcGHqxdCjBKlrHmyFgHr",159,0.99375,35,160,1,159,1,1,0,1,1,63,62,97,97,98
"9072",71,"[35]tJHiqHIxHcdKpcJvcGHqxdCjBKlrHmyFgHr",167,0.994048,35,168,1,167,1,1,0,1,1,84,83,84,84,98
"9073",72,"[35]tJHiqHIxHcdKpcJvcGHqxdCjBKlrHmyFgHr",162,0.993865,35,163,1,162,1,1,0,1,1,70,69,93,93,98
"9074",73,"[35]tJHiqHIxHcdKpcJvcGHqxdCjBKlrHmyFgHr",164,0.993939,35,165,1,164,1,1,0,1,1,78,77,87,87,98
"9075",74,"[35]tJHiqHIxHcdKpcJvcGHqxdCjBKlrHmyFgHr",171,0.994186,35,172,1,171,1,1,0,1,1,96,95,76,76,98
"9076",75,"[35]tJHiqHIxHcdKpcJvcGHqxdCjBKlrHmyFgHr",161,0.993827,35,162,1,161,1,1,0,1,1,68,67,94,94,98
"9077",76,"[35]tJHiqHIxHcdKpcJvcGHqxdCjBKlrHmyFgHr",166,0.994012,35,167,1,166,1,1,0,1,1,81,80,86,86,98
"9078",77,"[35]tJHiqHIxHcdKpcJvcGHqxdCjBKlrHmyFgHr",169,0.994118,35,170,1,169,1,1,0,1,1,90,89,80,80,98
"9079",78,"[35]tJHiqHIxHcdKpcJvcGHqxdCjBKlrHmyFgHr",167,0.994048,35,168,1,167,1,1,0,1,1,83,82,85,85,98
"9080",79,"[35]tJHiqHIxHcdKpcJvcGHqxdCjBKlrHmyFgHr",164,0.993939,35,165,1,164,1,1,0,1,1,76,75,89,89,98
"9081",80,"[35]tJHiqHIxHcdKpcJvcGHqxdCjBKlrHmyFgHr",162,0.993865,35,163,1,162,1,1,0,1,1,71,70,92,92,98
"9082",81,"[35]tJHiqHIxHcdKpcJvcGHqxdCjBKlrHmyFgHr",166,0.994012,35,167,1,166,1,1,0,1,1,83,82,84,84,98
"9083",82,"[35]tJHiqHIxHcdKpcJvcGHqxdCjBKlrHmyFgHr",167,0.994048,35,168,1,167,1,1,0,1,1,84,83,84,84,98
"9084",83,"[35]tJHiqHIxHcdKpcJvcGHqxdCjBKlrHmyFgHr",171,0.994186,35,172,1,171,1,1,0,1,1,97,96,75,75,98
"9085",84,"[35]tJHiqHIxHcdKpcJvcGHqxdCjBKlrHmyFgHr",165,0.993976,35,166,1,165,1,1,0,1,1,79,78,87,87,98
"9086",85,"[35]tJHiqHIxHcdKpcJvcGHqxdCjBKlrHmyFgHr",171,0.994186,35,172,1,171,1,1,0,1,1,96,95,76,76,98
"9087",86,"[35]tJHiqHIxHcdKpcJvcGHqxdCjBKlrHmyFgHr",169,0.994118,35,170,1,169,1,1,0,1,1,91,90,79,79,98
"9088",87,"[35]tJHiqHIxHcdKpcJvcGHqxdCjBKlrHmyFgHr",167,0.994048,35,168,1,167,1,1,0,1,1,84,83,84,84,98
"9089",88,"[35]tJHiqHIxHcdKpcJvcGHqxdCjBKlrHmyFgHr",167,0.994048,35,168,1,167,1,1,0,1,1,85,84,83,83,98
"9090",89,"[35]tJHiqHIxHcdKpcJvcGHqxdCjBKlrHmyFgHr",168,0.994083,35,169,1,168,1,1,0,1,1,87,86,82,82,98
"9091",90,"[35]tJHiqHIxHcdKpcJvcGHqxdCjBKlrHmyFgHr",166,0.994012,35,167,1,166,1,1,0,1,1,82,81,85,85,98
"9092",91,"[35]tJHiqHIxHcdKpcJvcGHqxdCjBKlrHmyFgHr",169,0.994118,35,170,1,169,1,1,0,1,1,89,88,81,81,98
"9093",92,"[35]tJHiqHIxHcdKpcJvcGHqxdCjBKlrHmyFgHr",167,0.994048,35,168,1,167,1,1,0,1,1,86,85,82,82,98
"9094",93,"[35]tJHiqHIxHcdKpcJvcGHqxdCjBKlrHmyFgHr",165,0.993976,35,166,1,165,1,1,0,1,1,76,75,90,90,98
"9095",94,"[35]tJHiqHIxHcdKpcJvcGHqxdCjBKlrHmyFgHr",167,0.994048,35,168,1,167,1,1,0,1,1,84,83,84,84,98
"9096",95,"[35]tJHiqHIxHcdKpcJvcGHqxdCjBKlrHmyFgHr",166,0.994012,35,167,1,166,1,1,0,1,1,82,81,85,85,98
"9097",96,"[35]tJHiqHIxHcdKpcJvcGHqxdCjBKlrHmyFgHr",168,0.994083,35,169,1,168,1,1,0,1,1,88,87,81,81,98
"9098",97,"[35]tJHiqHIxHcdKpcJvcGHqxdCjBKlrHmyFgHr",171,0.994186,35,172,1,171,1,1,0,1,1,95,94,77,77,98
"9099",98,"[35]tJHiqHIxHcdKpcJvcGHqxdCjBKlrHmyFgHr",166,0.994012,35,167,1,166,1,1,0,1,1,83,82,84,84,98
"9100",99,"[35]tJHiqHIxHcdKpcJvcGHqxdCjBKlrHmyFgHr",165,0.993976,35,166,1,165,1,1,0,1,1,79,78,87,87,98
"9101",0,"[29]xJHggqIHcdKocJvcGHqvdCqcxbgDF",173,0.994253,29,174,1,173,1,1,0,1,1,101,100,73,73,99
"9102",1,"[29]xJHggqIHcdKocJvcGHqvdCqcxbgDF",165,0.993976,29,166,1,165,1,1,0,1,1,79,78,87,87,99
"9103",2,"[29]xJHggqIHcdKocJvcGHqvdCqcxbgDF",162,0.993865,29,163,1,162,1,1,0,1,1,71,70,92,92,99
"9104",3,"[29]xJHggqIHcdKocJvcGHqvdCqcxbgDF",168,0.994083,29,169,1,168,1,1,0,1,1,88,87,81,81,99
"9105",4,"[29]xJHggqIHcdKocJvcGHqvdCqcxbgDF",168,0.994083,29,169,1,168,1,1,0,1,1,87,86,82,82,99
"9106",5,"[29]xJHggqIHcdKocJvcGHqvdCqcxbgDF",167,0.994048,29,168,1,167,1,1,0,1,1,84,83,84,84,99
"9107",6,"[29]xJHggqIHcdKocJvcGHqvdCqcxbgDF",167,0.994048,29,168,1,167,1,1,0,1,1,84,83,84,84,99
"9108",7,"[29]xJHggqIHcdKocJvcGHqvdCqcxbgDF",165,0.993976,29,166,1,165,1,1,0,1,1,79,78,87,87,99
"9109",8,"[29]xJHggqIHcdKocJvcGHqvdCqcxbgDF",173,0.994253,29,174,1,173,1,1,0,1,1,101,100,73,73,99
"9110",9,"[29]xJHggqIHcdKocJvcGHqvdCqcxbgDF",169,0.994118,29,170,1,169,1,1,0,1,1,90,89,80,80,99
"9111",10,"[29]xJHggqIHcdKocJvcGHqvdCqcxbgDF",166,0.994012,29,167,1,166,1,1,0,1,1,82,81,85,85,99
"9112",11,"[29]xJHggqIHcdKocJvcGHqvdCqcxbgDF",168,0.994083,29,169,1,168,1,1,0,1,1,87,86,82,82,99
"9113",12,"[29]xJHggqIHcdKocJvcGHqvdCqcxbgDF",171,0.994186,29,172,1,171,1,1,0,1,1,95,94,77,77,99
"9114",13,"[29]xJHggqIHcdKocJvcGHqvdCqcxbgDF",167,0.994048,29,168,1,167,1,1,0,1,1,86,85,82,82,99
"9115",14,"[29]xJHggqIHcdKocJvcGHqvdCqcxbgDF",167,0.994048,29,168,1,167,1,1,0,1,1,85,84,83,83,99
"9116",15,"[29]xJHggqIHcdKocJvcGHqvdCqcxbgDF",168,0.994083,29,169,1,168,1,1,0,1,1,88,87,81,81,99
"9117",16,"[29]xJHggqIHcdKocJvcGHqvdCqcxbgDF",168,0.994083,29,169,1,168,1,1,0,1,1,88,87,81,81,99
"9118",17,"[29]xJHggqIHcdKocJvcGHqvdCqcxbgDF",168,0.994083,29,169,1,168,1,1,0,1,1,88,87,81,81,99
"9119",18,"[29]xJHggqIHcdKocJvcGHqvdCqcxbgDF",166,0.994012,29,167,1,166,1,1,0,1,1,81,80,86,86,99
"9120",19,"[29]xJHggqIHcdKocJvcGHqvdCqcxbgDF",168,0.994083,29,169,1,168,1,1,0,1,1,87,86,82,82,99
"9121",20,"[29]xJHggqIHcdKocJvcGHqvdCqcxbgDF",169,0.994118,29,170,1,169,1,1,0,1,1,91,90,79,79,99
"9122",21,"[29]xJHggqIHcdKocJvcGHqvdCqcxbgDF",165,0.993976,29,166,1,165,1,1,0,1,1,79,78,87,87,99
"9123",22,"[29]xJHggqIHcdKocJvcGHqvdCqcxbgDF",167,0.994048,29,168,1,167,1,1,0,1,1,86,85,82,82,99
"9124",23,"[29]xJHggqIHcdKocJvcGHqvdCqcxbgDF",169,0.994118,29,170,1,169,1,1,0,1,1,91,90,79,79,99
"9125",24,"[29]xJHggqIHcdKocJvcGHqvdCqcxbgDF",168,0.994083,29,169,1,168,1,1,0,1,1,86,85,83,83,99
"9126",25,"[29]xJHggqIHcdKocJvcGHqvdCqcxbgDF",172,0.99422,29,173,1,172,1,1,0,1,1,99,98,74,74,99
"9127",26,"[29]xJHggqIHcdKocJvcGHqvdCqcxbgDF",168,0.994083,29,169,1,168,1,1,0,1,1,88,87,81,81,99
"9128",27,"[29]xJHggqIHcdKocJvcGHqvdCqcxbgDF",164,0.993939,29,165,1,164,1,1,0,1,1,76,75,89,89,99
"9129",28,"[29]xJHggqIHcdKocJvcGHqvdCqcxbgDF",167,0.994048,29,168,1,167,1,1,0,1,1,86,85,82,82,99
"9130",29,"[29]xJHggqIHcdKocJvcGHqvdCqcxbgDF",164,0.993939,29,165,1,164,1,1,0,1,1,76,75,89,89,99
"9131",30,"[29]xJHggqIHcdKocJvcGHqvdCqcxbgDF",167,0.994048,29,168,1,167,1,1,0,1,1,84,83,84,84,99
"9132",31,"[29]xJHggqIHcdKocJvcGHqvdCqcxbgDF",170,0.994152,29,171,1,170,1,1,0,1,1,94,93,77,77,99
"9133",32,"[29]xJHggqIHcdKocJvcGHqvdCqcxbgDF",169,0.994118,29,170,1,169,1,1,0,1,1,91,90,79,79,99
"9134",33,"[29]xJHggqIHcdKocJvcGHqvdCqcxbgDF",164,0.993939,29,165,1,164,1,1,0,1,1,77,76,88,88,99
"9135",34,"[29]xJHggqIHcdKocJvcGHqvdCqcxbgDF",167,0.994048,29,168,1,167,1,1,0,1,1,84,83,84,84,99
"9136",35,"[29]xJHggqIHcdKocJvcGHqvdCqcxbgDF",168,0.994083,29,169,1,168,1,1,0,1,1,88,87,81,81,99
"9137",36,"[29]xJHggqIHcdKocJvcGHqvdCqcxbgDF",166,0.994012,29,167,1,166,1,1,0,1,1,81,80,86,86,99
"9138",37,"[29]xJHggqIHcdKocJvcGHqvdCqcxbgDF",166,0.994012,29,167,1,166,1,1,0,1,1,81,80,86,86,99
"9139",38,"[29]xJHggqIHcdKocJvcGHqvdCqcxbgDF",165,0.993976,29,166,1,165,1,1,0,1,1,80,79,86,86,99
"9140",39,"[29]xJHggqIHcdKocJvcGHqvdCqcxbgDF",165,0.993976,29,166,1,165,1,1,0,1,1,79,78,87,87,99
"9141",40,"[29]xJHggqIHcdKocJvcGHqvdCqcxbgDF",159,0.99375,29,160,1,159,1,1,0,1,1,64,63,96,96,99
"9142",41,"[29]xJHggqIHcdKocJvcGHqvdCqcxbgDF",170,0.994152,29,171,1,170,1,1,0,1,1,91,90,80,80,99
"9143",42,"[29]xJHggqIHcdKocJvcGHqvdCqcxbgDF",169,0.994118,29,170,1,169,1,1,0,1,1,90,89,80,80,99
"9144",43,"[29]xJHggqIHcdKocJvcGHqvdCqcxbgDF",166,0.994012,29,167,1,166,1,1,0,1,1,82,81,85,85,99
"9145",44,"[29]xJHggqIHcdKocJvcGHqvdCqcxbgDF",165,0.993976,29,166,1,165,1,1,0,1,1,79,78,87,87,99
"9146",45,"[29]xJHggqIHcdKocJvcGHqvdCqcxbgDF",166,0.994012,29,167,1,166,1,1,0,1,1,81,80,86,86,99
"9147",46,"[29]xJHggqIHcdKocJvcGHqvdCqcxbgDF",170,0.994152,29,171,1,170,1,1,0,1,1,92,91,79,79,99
"9148",47,"[29]xJHggqIHcdKocJvcGHqvdCqcxbgDF",175,0.994318,29,176,1,175,1,1,0,1,1,107,106,69,69,99
"9149",48,"[29]xJHggqIHcdKocJvcGHqvdCqcxbgDF",169,0.994118,29,170,1,169,1,1,0,1,1,89,88,81,81,99
"9150",49,"[29]xJHggqIHcdKocJvcGHqvdCqcxbgDF",166,0.994012,29,167,1,166,1,1,0,1,1,82,81,85,85,99
"9151",50,"[29]xJHggqIHcdKocJvcGHqvdCqcxbgDF",165,0.993976,29,166,1,165,1,1,0,1,1,79,78,87,87,99
"9152",51,"[29]xJHggqIHcdKocJvcGHqvdCqcxbgDF",170,0.994152,29,171,1,170,1,1,0,1,1,93,92,78,78,99
"9153",52,"[29]xJHggqIHcdKocJvcGHqvdCqcxbgDF",165,0.993976,29,166,1,165,1,1,0,1,1,77,76,89,89,99
"9154",53,"[29]xJHggqIHcdKocJvcGHqvdCqcxbgDF",169,0.994118,29,170,1,169,1,1,0,1,1,89,88,81,81,99
"9155",54,"[29]xJHggqIHcdKocJvcGHqvdCqcxbgDF",166,0.994012,29,167,1,166,1,1,0,1,1,83,82,84,84,99
"9156",55,"[29]xJHggqIHcdKocJvcGHqvdCqcxbgDF",166,0.994012,29,167,1,166,1,1,0,1,1,83,82,84,84,99
"9157",56,"[29]xJHggqIHcdKocJvcGHqvdCqcxbgDF",167,0.994048,29,168,1,167,1,1,0,1,1,85,84,83,83,99
"9158",57,"[29]xJHggqIHcdKocJvcGHqvdCqcxbgDF",168,0.994083,29,169,1,168,1,1,0,1,1,86,85,83,83,99
"9159",58,"[29]xJHggqIHcdKocJvcGHqvdCqcxbgDF",169,0.994118,29,170,1,169,1,1,0,1,1,90,89,80,80,99
"9160",59,"[29]xJHggqIHcdKocJvcGHqvdCqcxbgDF",166,0.994012,29,167,1,166,1,1,0,1,1,80,79,87,87,99
"9161",60,"[29]xJHggqIHcdKocJvcGHqvdCqcxbgDF",165,0.993976,29,166,1,165,1,1,0,1,1,78,77,88,88,99
"9162",61,"[29]xJHggqIHcdKocJvcGHqvdCqcxbgDF",170,0.994152,29,171,1,170,1,1,0,1,1,93,92,78,78,99
"9163",62,"[29]xJHggqIHcdKocJvcGHqvdCqcxbgDF",171,0.994186,29,172,1,171,1,1,0,1,1,95,94,77,77,99
"9164",63,"[29]xJHggqIHcdKocJvcGHqvdCqcxbgDF",169,0.994118,29,170,1,169,1,1,0,1,1,91,90,79,79,99
"9165",64,"[29]xJHggqIHcdKocJvcGHqvdCqcxbgDF",168,0.994083,29,169,1,168,1,1,0,1,1,88,87,81,81,99
"9166",65,"[29]xJHggqIHcdKocJvcGHqvdCqcxbgDF",165,0.993976,29,166,1,165,1,1,0,1,1,80,79,86,86,99
"9167",66,"[29]xJHggqIHcdKocJvcGHqvdCqcxbgDF",169,0.994118,29,170,1,169,1,1,0,1,1,89,88,81,81,99
"9168",67,"[29]xJHggqIHcdKocJvcGHqvdCqcxbgDF",168,0.994083,29,169,1,168,1,1,0,1,1,88,87,81,81,99
"9169",68,"[29]xJHggqIHcdKocJvcGHqvdCqcxbgDF",171,0.994186,29,172,1,171,1,1,0,1,1,95,94,77,77,99
"9170",69,"[29]xJHggqIHcdKocJvcGHqvdCqcxbgDF",169,0.994118,29,170,1,169,1,1,0,1,1,89,88,81,81,99
"9171",70,"[29]xJHggqIHcdKocJvcGHqvdCqcxbgDF",166,0.994012,29,167,1,166,1,1,0,1,1,81,80,86,86,99
"9172",71,"[29]xJHggqIHcdKocJvcGHqvdCqcxbgDF",173,0.994253,29,174,1,173,1,1,0,1,1,99,98,75,75,99
"9173",72,"[29]xJHggqIHcdKocJvcGHqvdCqcxbgDF",165,0.993976,29,166,1,165,1,1,0,1,1,80,79,86,86,99
"9174",73,"[29]xJHggqIHcdKocJvcGHqvdCqcxbgDF",172,0.99422,29,173,1,172,1,1,0,1,1,98,97,75,75,99
"9175",74,"[29]xJHggqIHcdKocJvcGHqvdCqcxbgDF",168,0.994083,29,169,1,168,1,1,0,1,1,85,84,84,84,99
"9176",75,"[29]xJHggqIHcdKocJvcGHqvdCqcxbgDF",168,0.994083,29,169,1,168,1,1,0,1,1,88,87,81,81,99
"9177",76,"[29]xJHggqIHcdKocJvcGHqvdCqcxbgDF",166,0.994012,29,167,1,166,1,1,0,1,1,82,81,85,85,99
"9178",77,"[29]xJHggqIHcdKocJvcGHqvdCqcxbgDF",165,0.993976,29,166,1,165,1,1,0,1,1,80,79,86,86,99
"9179",78,"[29]xJHggqIHcdKocJvcGHqvdCqcxbgDF",168,0.994083,29,169,1,168,1,1,0,1,1,86,85,83,83,99
"9180",79,"[29]xJHggqIHcdKocJvcGHqvdCqcxbgDF",167,0.994048,29,168,1,167,1,1,0,1,1,86,85,82,82,99
"9181",80,"[29]xJHggqIHcdKocJvcGHqvdCqcxbgDF",168,0.994083,29,169,1,168,1,1,0,1,1,87,86,82,82,99
"9182",81,"[29]xJHggqIHcdKocJvcGHqvdCqcxbgDF",167,0.994048,29,168,1,167,1,1,0,1,1,84,83,84,84,99
"9183",82,"[29]xJHggqIHcdKocJvcGHqvdCqcxbgDF",166,0.994012,29,167,1,166,1,1,0,1,1,82,81,85,85,99
"9184",83,"[29]xJHggqIHcdKocJvcGHqvdCqcxbgDF",161,0.993827,29,162,1,161,1,1,0,1,1,66,65,96,96,99
"9185",84,"[29]xJHggqIHcdKocJvcGHqvdCqcxbgDF",163,0.993902,29,164,1,163,1,1,0,1,1,72,71,92,92,99
"9186",85,"[29]xJHggqIHcdKocJvcGHqvdCqcxbgDF",166,0.994012,29,167,1,166,1,1,0,1,1,82,81,85,85,99
"9187",86,"[29]xJHggqIHcdKocJvcGHqvdCqcxbgDF",168,0.994083,29,169,1,168,1,1,0,1,1,88,87,81,81,99
"9188",87,"[29]xJHggqIHcdKocJvcGHqvdCqcxbgDF",166,0.994012,29,167,1,166,1,1,0,1,1,81,80,86,86,99
"9189",88,"[29]xJHggqIHcdKocJvcGHqvdCqcxbgDF",168,0.994083,29,169,1,168,1,1,0,1,1,88,87,81,81,99
"9190",89,"[29]xJHggqIHcdKocJvcGHqvdCqcxbgDF",168,0.994083,29,169,1,168,1,1,0,1,1,88,87,81,81,99
"9191",90,"[29]xJHggqIHcdKocJvcGHqvdCqcxbgDF",167,0.994048,29,168,1,167,1,1,0,1,1,86,85,82,82,99
"9192",91,"[29]xJHggqIHcdKocJvcGHqvdCqcxbgDF",170,0.994152,29,171,1,170,1,1,0,1,1,93,92,78,78,99
"9193",92,"[29]xJHggqIHcdKocJvcGHqvdCqcxbgDF",165,0.993976,29,166,1,165,1,1,0,1,1,80,79,86,86,99
"9194",93,"[29]xJHggqIHcdKocJvcGHqvdCqcxbgDF",165,0.993976,29,166,1,165,1,1,0,1,1,80,79,86,86,99
"9195",94,"[29]xJHggqIHcdKocJvcGHqvdCqcxbgDF",170,0.994152,29,171,1,170,1,1,0,1,1,92,91,79,79,99
"9196",95,"[29]xJHggqIHcdKocJvcGHqvdCqcxbgDF",170,0.994152,29,171,1,170,1,1,0,1,1,94,93,77,77,99
"9197",96,"[29]xJHggqIHcdKocJvcGHqvdCqcxbgDF",166,0.994012,29,167,1,166,1,1,0,1,1,83,82,84,84,99
"9198",97,"[29]xJHggqIHcdKocJvcGHqvdCqcxbgDF",171,0.994186,29,172,1,171,1,1,0,1,1,96,95,76,76,99
"9199",98,"[29]xJHggqIHcdKocJvcGHqvdCqcxbgDF",171,0.994186,29,172,1,171,1,1,0,1,1,96,95,76,76,99
"9200",99,"[29]xJHggqIHcdKocJvcGHqvdCqcxbgDF",165,0.993976,29,166,1,165,1,1,0,1,1,78,77,88,88,99
"9201",0,"[35]GJHglqIHyBidKocJvcGHqFdCpGiKcoFynBn",180,0.994475,35,181,1,180,1,1,0,1,1,101,100,80,80,100
"9202",1,"[35]GJHglqIHyBidKocJvcGHqFdCpGiKcoFynBn",174,0.994286,35,175,1,174,1,1,0,1,1,84,83,91,91,100
"9203",2,"[35]GJHglqIHyBidKocJvcGHqFdCpGiKcoFynBn",175,0.994318,35,176,1,175,1,1,0,1,1,85,84,91,91,100
"9204",3,"[35]GJHglqIHyBidKocJvcGHqFdCpGiKcoFynBn",174,0.994286,35,175,1,174,1,1,0,1,1,84,83,91,91,100
"9205",4,"[35]GJHglqIHyBidKocJvcGHqFdCpGiKcoFynBn",178,0.994413,35,179,1,178,1,1,0,1,1,97,96,82,82,100
"9206",5,"[35]GJHglqIHyBidKocJvcGHqFdCpGiKcoFynBn",176,0.99435,35,177,1,176,1,1,0,1,1,91,90,86,86,100
"9207",6,"[35]GJHglqIHyBidKocJvcGHqFdCpGiKcoFynBn",175,0.994318,35,176,1,175,1,1,0,1,1,86,85,90,90,100
"9208",7,"[35]GJHglqIHyBidKocJvcGHqFdCpGiKcoFynBn",174,0.994286,35,175,1,174,1,1,0,1,1,84,83,91,91,100
"9209",8,"[35]GJHglqIHyBidKocJvcGHqFdCpGiKcoFynBn",177,0.994382,35,178,1,177,1,1,0,1,1,91,90,87,87,100
"9210",9,"[35]GJHglqIHyBidKocJvcGHqFdCpGiKcoFynBn",178,0.994413,35,179,1,178,1,1,0,1,1,95,94,84,84,100
"9211",10,"[35]GJHglqIHyBidKocJvcGHqFdCpGiKcoFynBn",176,0.99435,35,177,1,176,1,1,0,1,1,89,88,88,88,100
"9212",11,"[35]GJHglqIHyBidKocJvcGHqFdCpGiKcoFynBn",177,0.994382,35,178,1,177,1,1,0,1,1,93,92,85,85,100
"9213",12,"[35]GJHglqIHyBidKocJvcGHqFdCpGiKcoFynBn",180,0.994475,35,181,1,180,1,1,0,1,1,102,101,79,79,100
"9214",13,"[35]GJHglqIHyBidKocJvcGHqFdCpGiKcoFynBn",178,0.994413,35,179,1,178,1,1,0,1,1,95,94,84,84,100
"9215",14,"[35]GJHglqIHyBidKocJvcGHqFdCpGiKcoFynBn",175,0.994318,35,176,1,175,1,1,0,1,1,87,86,89,89,100
"9216",15,"[35]GJHglqIHyBidKocJvcGHqFdCpGiKcoFynBn",178,0.994413,35,179,1,178,1,1,0,1,1,96,95,83,83,100
"9217",16,"[35]GJHglqIHyBidKocJvcGHqFdCpGiKcoFynBn",174,0.994286,35,175,1,174,1,1,0,1,1,84,83,91,91,100
"9218",17,"[35]GJHglqIHyBidKocJvcGHqFdCpGiKcoFynBn",180,0.994475,35,181,1,180,1,1,0,1,1,98,97,83,83,100
"9219",18,"[35]GJHglqIHyBidKocJvcGHqFdCpGiKcoFynBn",174,0.994286,35,175,1,174,1,1,0,1,1,82,81,93,93,100
"9220",19,"[35]GJHglqIHyBidKocJvcGHqFdCpGiKcoFynBn",175,0.994318,35,176,1,175,1,1,0,1,1,85,84,91,91,100
"9221",20,"[35]GJHglqIHyBidKocJvcGHqFdCpGiKcoFynBn",175,0.994318,35,176,1,175,1,1,0,1,1,87,86,89,89,100
"9222",21,"[35]GJHglqIHyBidKocJvcGHqFdCpGiKcoFynBn",174,0.994286,35,175,1,174,1,1,0,1,1,83,82,92,92,100
"9223",22,"[35]GJHglqIHyBidKocJvcGHqFdCpGiKcoFynBn",177,0.994382,35,178,1,177,1,1,0,1,1,94,93,84,84,100
"9224",23,"[35]GJHglqIHyBidKocJvcGHqFdCpGiKcoFynBn",175,0.994318,35,176,1,175,1,1,0,1,1,87,86,89,89,100
"9225",24,"[35]GJHglqIHyBidKocJvcGHqFdCpGiKcoFynBn",180,0.994475,35,181,1,180,1,1,0,1,1,101,100,80,80,100
"9226",25,"[35]GJHglqIHyBidKocJvcGHqFdCpGiKcoFynBn",178,0.994413,35,179,1,178,1,1,0,1,1,96,95,83,83,100
"9227",26,"[35]GJHglqIHyBidKocJvcGHqFdCpGiKcoFynBn",177,0.994382,35,178,1,177,1,1,0,1,1,92,91,86,86,100
"9228",27,"[35]GJHglqIHyBidKocJvcGHqFdCpGiKcoFynBn",176,0.99435,35,177,1,176,1,1,0,1,1,90,89,87,87,100
"9229",28,"[35]GJHglqIHyBidKocJvcGHqFdCpGiKcoFynBn",176,0.99435,35,177,1,176,1,1,0,1,1,89,88,88,88,100
"9230",29,"[35]GJHglqIHyBidKocJvcGHqFdCpGiKcoFynBn",174,0.994286,35,175,1,174,1,1,0,1,1,83,82,92,92,100
"9231",30,"[35]GJHglqIHyBidKocJvcGHqFdCpGiKcoFynBn",179,0.994444,35,180,1,179,1,1,0,1,1,98,97,82,82,100
"9232",31,"[35]GJHglqIHyBidKocJvcGHqFdCpGiKcoFynBn",171,0.994186,35,172,1,171,1,1,0,1,1,73,72,99,99,100
"9233",32,"[35]GJHglqIHyBidKocJvcGHqFdCpGiKcoFynBn",177,0.994382,35,178,1,177,1,1,0,1,1,90,89,88,88,100
"9234",33,"[35]GJHglqIHyBidKocJvcGHqFdCpGiKcoFynBn",177,0.994382,35,178,1,177,1,1,0,1,1,93,92,85,85,100
"9235",34,"[35]GJHglqIHyBidKocJvcGHqFdCpGiKcoFynBn",176,0.99435,35,177,1,176,1,1,0,1,1,89,88,88,88,100
"9236",35,"[35]GJHglqIHyBidKocJvcGHqFdCpGiKcoFynBn",175,0.994318,35,176,1,175,1,1,0,1,1,86,85,90,90,100
"9237",36,"[35]GJHglqIHyBidKocJvcGHqFdCpGiKcoFynBn",177,0.994382,35,178,1,177,1,1,0,1,1,92,91,86,86,100
"9238",37,"[35]GJHglqIHyBidKocJvcGHqFdCpGiKcoFynBn",175,0.994318,35,176,1,175,1,1,0,1,1,85,84,91,91,100
"9239",38,"[35]GJHglqIHyBidKocJvcGHqFdCpGiKcoFynBn",174,0.994286,35,175,1,174,1,1,0,1,1,83,82,92,92,100
"9240",39,"[35]GJHglqIHyBidKocJvcGHqFdCpGiKcoFynBn",177,0.994382,35,178,1,177,1,1,0,1,1,94,93,84,84,100
"9241",40,"[35]GJHglqIHyBidKocJvcGHqFdCpGiKcoFynBn",175,0.994318,35,176,1,175,1,1,0,1,1,85,84,91,91,100
"9242",41,"[35]GJHglqIHyBidKocJvcGHqFdCpGiKcoFynBn",175,0.994318,35,176,1,175,1,1,0,1,1,87,86,89,89,100
"9243",42,"[35]GJHglqIHyBidKocJvcGHqFdCpGiKcoFynBn",181,0.994505,35,182,1,181,1,1,0,1,1,104,103,78,78,100
"9244",43,"[35]GJHglqIHyBidKocJvcGHqFdCpGiKcoFynBn",177,0.994382,35,178,1,177,1,1,0,1,1,93,92,85,85,100
"9245",44,"[35]GJHglqIHyBidKocJvcGHqFdCpGiKcoFynBn",177,0.994382,35,178,1,177,1,1,0,1,1,91,90,87,87,100
"9246",45,"[35]GJHglqIHyBidKocJvcGHqFdCpGiKcoFynBn",179,0.994444,35,180,1,179,1,1,0,1,1,99,98,81,81,100
"9247",46,"[35]GJHglqIHyBidKocJvcGHqFdCpGiKcoFynBn",175,0.994318,35,176,1,175,1,1,0,1,1,87,86,89,89,100
"9248",47,"[35]GJHglqIHyBidKocJvcGHqFdCpGiKcoFynBn",178,0.994413,35,179,1,178,1,1,0,1,1,93,92,86,86,100
"9249",48,"[35]GJHglqIHyBidKocJvcGHqFdCpGiKcoFynBn",179,0.994444,35,180,1,179,1,1,0,1,1,98,97,82,82,100
"9250",49,"[35]GJHglqIHyBidKocJvcGHqFdCpGiKcoFynBn",178,0.994413,35,179,1,178,1,1,0,1,1,95,94,84,84,100
"9251",50,"[35]GJHglqIHyBidKocJvcGHqFdCpGiKcoFynBn",176,0.99435,35,177,1,176,1,1,0,1,1,88,87,89,89,100
"9252",51,"[35]GJHglqIHyBidKocJvcGHqFdCpGiKcoFynBn",184,0.994595,35,185,1,184,1,1,0,1,1,115,114,70,70,100
"9253",52,"[35]GJHglqIHyBidKocJvcGHqFdCpGiKcoFynBn",171,0.994186,35,172,1,171,1,1,0,1,1,73,72,99,99,100
"9254",53,"[35]GJHglqIHyBidKocJvcGHqFdCpGiKcoFynBn",178,0.994413,35,179,1,178,1,1,0,1,1,96,95,83,83,100
"9255",54,"[35]GJHglqIHyBidKocJvcGHqFdCpGiKcoFynBn",177,0.994382,35,178,1,177,1,1,0,1,1,92,91,86,86,100
"9256",55,"[35]GJHglqIHyBidKocJvcGHqFdCpGiKcoFynBn",173,0.994253,35,174,1,173,1,1,0,1,1,81,80,93,93,100
"9257",56,"[35]GJHglqIHyBidKocJvcGHqFdCpGiKcoFynBn",177,0.994382,35,178,1,177,1,1,0,1,1,92,91,86,86,100
"9258",57,"[35]GJHglqIHyBidKocJvcGHqFdCpGiKcoFynBn",172,0.99422,35,173,1,172,1,1,0,1,1,76,75,97,97,100
"9259",58,"[35]GJHglqIHyBidKocJvcGHqFdCpGiKcoFynBn",178,0.994413,35,179,1,178,1,1,0,1,1,92,91,87,87,100
"9260",59,"[35]GJHglqIHyBidKocJvcGHqFdCpGiKcoFynBn",174,0.994286,35,175,1,174,1,1,0,1,1,82,81,93,93,100
"9261",60,"[35]GJHglqIHyBidKocJvcGHqFdCpGiKcoFynBn",173,0.994253,35,174,1,173,1,1,0,1,1,79,78,95,95,100
"9262",61,"[35]GJHglqIHyBidKocJvcGHqFdCpGiKcoFynBn",176,0.99435,35,177,1,176,1,1,0,1,1,89,88,88,88,100
"9263",62,"[35]GJHglqIHyBidKocJvcGHqFdCpGiKcoFynBn",176,0.99435,35,177,1,176,1,1,0,1,1,88,87,89,89,100
"9264",63,"[35]GJHglqIHyBidKocJvcGHqFdCpGiKcoFynBn",175,0.994318,35,176,1,175,1,1,0,1,1,85,84,91,91,100
"9265",64,"[35]GJHglqIHyBidKocJvcGHqFdCpGiKcoFynBn",174,0.994286,35,175,1,174,1,1,0,1,1,83,82,92,92,100
"9266",65,"[35]GJHglqIHyBidKocJvcGHqFdCpGiKcoFynBn",175,0.994318,35,176,1,175,1,1,0,1,1,86,85,90,90,100
"9267",66,"[35]GJHglqIHyBidKocJvcGHqFdCpGiKcoFynBn",174,0.994286,35,175,1,174,1,1,0,1,1,83,82,92,92,100
"9268",67,"[35]GJHglqIHyBidKocJvcGHqFdCpGiKcoFynBn",179,0.994444,35,180,1,179,1,1,0,1,1,99,98,81,81,100
"9269",68,"[35]GJHglqIHyBidKocJvcGHqFdCpGiKcoFynBn",177,0.994382,35,178,1,177,1,1,0,1,1,91,90,87,87,100
"9270",69,"[35]GJHglqIHyBidKocJvcGHqFdCpGiKcoFynBn",177,0.994382,35,178,1,177,1,1,0,1,1,91,90,87,87,100
"9271",70,"[35]GJHglqIHyBidKocJvcGHqFdCpGiKcoFynBn",171,0.994186,35,172,1,171,1,1,0,1,1,74,73,98,98,100
"9272",71,"[35]GJHglqIHyBidKocJvcGHqFdCpGiKcoFynBn",176,0.99435,35,177,1,176,1,1,0,1,1,88,87,89,89,100
"9273",72,"[35]GJHglqIHyBidKocJvcGHqFdCpGiKcoFynBn",176,0.99435,35,177,1,176,1,1,0,1,1,89,88,88,88,100
"9274",73,"[35]GJHglqIHyBidKocJvcGHqFdCpGiKcoFynBn",174,0.994286,35,175,1,174,1,1,0,1,1,82,81,93,93,100
"9275",74,"[35]GJHglqIHyBidKocJvcGHqFdCpGiKcoFynBn",181,0.994505,35,182,1,181,1,1,0,1,1,104,103,78,78,100
"9276",75,"[35]GJHglqIHyBidKocJvcGHqFdCpGiKcoFynBn",171,0.994186,35,172,1,171,1,1,0,1,1,73,72,99,99,100
"9277",76,"[35]GJHglqIHyBidKocJvcGHqFdCpGiKcoFynBn",180,0.994475,35,181,1,180,1,1,0,1,1,101,100,80,80,100
"9278",77,"[35]GJHglqIHyBidKocJvcGHqFdCpGiKcoFynBn",179,0.994444,35,180,1,179,1,1,0,1,1,99,98,81,81,100
"9279",78,"[35]GJHglqIHyBidKocJvcGHqFdCpGiKcoFynBn",173,0.994253,35,174,1,173,1,1,0,1,1,80,79,94,94,100
"9280",79,"[35]GJHglqIHyBidKocJvcGHqFdCpGiKcoFynBn",176,0.99435,35,177,1,176,1,1,0,1,1,89,88,88,88,100
"9281",80,"[35]GJHglqIHyBidKocJvcGHqFdCpGiKcoFynBn",175,0.994318,35,176,1,175,1,1,0,1,1,87,86,89,89,100
"9282",81,"[35]GJHglqIHyBidKocJvcGHqFdCpGiKcoFynBn",178,0.994413,35,179,1,178,1,1,0,1,1,97,96,82,82,100
"9283",82,"[35]GJHglqIHyBidKocJvcGHqFdCpGiKcoFynBn",176,0.99435,35,177,1,176,1,1,0,1,1,91,90,86,86,100
"9284",83,"[35]GJHglqIHyBidKocJvcGHqFdCpGiKcoFynBn",174,0.994286,35,175,1,174,1,1,0,1,1,82,81,93,93,100
"9285",84,"[35]GJHglqIHyBidKocJvcGHqFdCpGiKcoFynBn",173,0.994253,35,174,1,173,1,1,0,1,1,81,80,93,93,100
"9286",85,"[35]GJHglqIHyBidKocJvcGHqFdCpGiKcoFynBn",174,0.994286,35,175,1,174,1,1,0,1,1,83,82,92,92,100
"9287",86,"[35]GJHglqIHyBidKocJvcGHqFdCpGiKcoFynBn",180,0.994475,35,181,1,180,1,1,0,1,1,100,99,81,81,100
"9288",87,"[35]GJHglqIHyBidKocJvcGHqFdCpGiKcoFynBn",178,0.994413,35,179,1,178,1,1,0,1,1,96,95,83,83,100
"9289",88,"[35]GJHglqIHyBidKocJvcGHqFdCpGiKcoFynBn",175,0.994318,35,176,1,175,1,1,0,1,1,85,84,91,91,100
"9290",89,"[35]GJHglqIHyBidKocJvcGHqFdCpGiKcoFynBn",175,0.994318,35,176,1,175,1,1,0,1,1,87,86,89,89,100
"9291",90,"[35]GJHglqIHyBidKocJvcGHqFdCpGiKcoFynBn",178,0.994413,35,179,1,178,1,1,0,1,1,96,95,83,83,100
"9292",91,"[35]GJHglqIHyBidKocJvcGHqFdCpGiKcoFynBn",175,0.994318,35,176,1,175,1,1,0,1,1,86,85,90,90,100
"9293",92,"[35]GJHglqIHyBidKocJvcGHqFdCpGiKcoFynBn",180,0.994475,35,181,1,180,1,1,0,1,1,102,101,79,79,100
"9294",93,"[35]GJHglqIHyBidKocJvcGHqFdCpGiKcoFynBn",176,0.99435,35,177,1,176,1,1,0,1,1,89,88,88,88,100
"9295",94,"[35]GJHglqIHyBidKocJvcGHqFdCpGiKcoFynBn",181,0.994505,35,182,1,181,1,1,0,1,1,105,104,77,77,100
"9296",95,"[35]GJHglqIHyBidKocJvcGHqFdCpGiKcoFynBn",179,0.994444,35,180,1,179,1,1,0,1,1,98,97,82,82,100
"9297",96,"[35]GJHglqIHyBidKocJvcGHqFdCpGiKcoFynBn",176,0.99435,35,177,1,176,1,1,0,1,1,90,89,87,87,100
"9298",97,"[35]GJHglqIHyBidKocJvcGHqFdCpGiKcoFynBn",172,0.99422,35,173,1,172,1,1,0,1,1,76,75,97,97,100
"9299",98,"[35]GJHglqIHyBidKocJvcGHqFdCpGiKcoFynBn",176,0.99435,35,177,1,176,1,1,0,1,1,89,88,88,88,100
"9300",99,"[35]GJHglqIHyBidKocJvcGHqFdCpGiKcoFynBn",176,0.99435,35,177,1,176,1,1,0,1,1,87,86,90,90,100
