"","trial_number","genome","merit","accuracy","genome_length","door_rooms","exit_rooms","correct_doors","incorrect_doors","correct_exits","incorrect_exits","doors_taken_0","doors_correct_0","doors_taken_1","doors_correct_1","doors_taken_2","doors_correct_2","seed"
"1",0,"[29]EwvHnKqGocIHcJCEzEIsEJsplAGhp",230,0.995671,29,231,1,230,1,1,0,1,1,115,115,116,115,1
"2",1,"[29]EwvHnKqGocIHcJCEzEIsEJsplAGhp",238,0.995816,29,239,1,238,1,1,0,1,1,108,108,131,130,1
"3",2,"[29]EwvHnKqGocIHcJCEzEIsEJsplAGhp",221,0.995495,29,222,1,221,1,1,0,1,1,122,122,100,99,1
"4",3,"[29]EwvHnKqGocIHcJCEzEIsEJsplAGhp",239,0.995833,29,240,1,239,1,1,0,1,1,108,108,132,131,1
"5",4,"[29]EwvHnKqGocIHcJCEzEIsEJsplAGhp",221,0.995495,29,222,1,221,1,1,0,1,1,121,121,101,100,1
"6",5,"[29]EwvHnKqGocIHcJCEzEIsEJsplAGhp",231,0.99569,29,232,1,231,1,1,0,1,1,114,114,118,117,1
"7",6,"[29]EwvHnKqGocIHcJCEzEIsEJsplAGhp",235,0.995763,29,236,1,235,1,1,0,1,1,111,111,125,124,1
"8",7,"[29]EwvHnKqGocIHcJCEzEIsEJsplAGhp",236,0.995781,29,237,1,236,1,1,0,1,1,110,110,127,126,1
"9",8,"[29]EwvHnKqGocIHcJCEzEIsEJsplAGhp",224,0.995556,29,225,1,224,1,1,0,1,1,120,120,105,104,1
"10",9,"[29]EwvHnKqGocIHcJCEzEIsEJsplAGhp",231,0.99569,29,232,1,231,1,1,0,1,1,114,114,118,117,1
"11",10,"[29]EwvHnKqGocIHcJCEzEIsEJsplAGhp",243,0.995902,29,244,1,243,1,1,0,1,1,104,104,140,139,1
"12",11,"[29]EwvHnKqGocIHcJCEzEIsEJsplAGhp",226,0.995595,29,227,1,226,1,1,0,1,1,121,121,106,105,1
"13",12,"[29]EwvHnKqGocIHcJCEzEIsEJsplAGhp",231,0.99569,29,232,1,231,1,1,0,1,1,113,113,119,118,1
"14",13,"[29]EwvHnKqGocIHcJCEzEIsEJsplAGhp",233,0.995726,29,234,1,233,1,1,0,1,1,113,113,121,120,1
"15",14,"[29]EwvHnKqGocIHcJCEzEIsEJsplAGhp",234,0.995745,29,235,1,234,1,1,0,1,1,111,111,124,123,1
"16",15,"[29]EwvHnKqGocIHcJCEzEIsEJsplAGhp",223,0.995536,29,224,1,223,1,1,0,1,1,120,120,104,103,1
"17",16,"[29]EwvHnKqGocIHcJCEzEIsEJsplAGhp",234,0.995745,29,235,1,234,1,1,0,1,1,113,113,122,121,1
"18",17,"[29]EwvHnKqGocIHcJCEzEIsEJsplAGhp",226,0.995595,29,227,1,226,1,1,0,1,1,118,118,109,108,1
"19",18,"[29]EwvHnKqGocIHcJCEzEIsEJsplAGhp",233,0.995726,29,234,1,233,1,1,0,1,1,112,112,122,121,1
"20",19,"[29]EwvHnKqGocIHcJCEzEIsEJsplAGhp",220,0.995475,29,221,1,220,1,1,0,1,1,122,122,99,98,1
"21",20,"[29]EwvHnKqGocIHcJCEzEIsEJsplAGhp",225,0.995575,29,226,1,225,1,1,0,1,1,118,118,108,107,1
"22",21,"[29]EwvHnKqGocIHcJCEzEIsEJsplAGhp",229,0.995652,29,230,1,229,1,1,0,1,1,117,117,113,112,1
"23",22,"[29]EwvHnKqGocIHcJCEzEIsEJsplAGhp",228,0.995633,29,229,1,228,1,1,0,1,1,116,116,113,112,1
"24",23,"[29]EwvHnKqGocIHcJCEzEIsEJsplAGhp",231,0.99569,29,232,1,231,1,1,0,1,1,115,115,117,116,1
"25",24,"[29]EwvHnKqGocIHcJCEzEIsEJsplAGhp",233,0.995726,29,234,1,233,1,1,0,1,1,112,112,122,121,1
"26",25,"[29]EwvHnKqGocIHcJCEzEIsEJsplAGhp",227,0.995614,29,228,1,227,1,1,0,1,1,118,118,110,109,1
"27",26,"[29]EwvHnKqGocIHcJCEzEIsEJsplAGhp",238,0.995816,29,239,1,238,1,1,0,1,1,109,109,130,129,1
"28",27,"[29]EwvHnKqGocIHcJCEzEIsEJsplAGhp",229,0.995652,29,230,1,229,1,1,0,1,1,117,117,113,112,1
"29",28,"[29]EwvHnKqGocIHcJCEzEIsEJsplAGhp",236,0.995781,29,237,1,236,1,1,0,1,1,111,111,126,125,1
"30",29,"[29]EwvHnKqGocIHcJCEzEIsEJsplAGhp",230,0.995671,29,231,1,230,1,1,0,1,1,114,114,117,116,1
"31",30,"[29]EwvHnKqGocIHcJCEzEIsEJsplAGhp",223,0.995536,29,224,1,223,1,1,0,1,1,120,120,104,103,1
"32",31,"[29]EwvHnKqGocIHcJCEzEIsEJsplAGhp",229,0.995652,29,230,1,229,1,1,0,1,1,116,116,114,113,1
"33",32,"[29]EwvHnKqGocIHcJCEzEIsEJsplAGhp",213,0.995327,29,214,1,213,1,1,0,1,1,128,128,86,85,1
"34",33,"[29]EwvHnKqGocIHcJCEzEIsEJsplAGhp",233,0.995726,29,234,1,233,1,1,0,1,1,113,113,121,120,1
"35",34,"[29]EwvHnKqGocIHcJCEzEIsEJsplAGhp",228,0.995633,29,229,1,228,1,1,0,1,1,117,117,112,111,1
"36",35,"[29]EwvHnKqGocIHcJCEzEIsEJsplAGhp",228,0.995633,29,229,1,228,1,1,0,1,1,116,116,113,112,1
"37",36,"[29]EwvHnKqGocIHcJCEzEIsEJsplAGhp",232,0.995708,29,233,1,232,1,1,0,1,1,113,113,120,119,1
"38",37,"[29]EwvHnKqGocIHcJCEzEIsEJsplAGhp",229,0.995652,29,230,1,229,1,1,0,1,1,117,117,113,112,1
"39",38,"[29]EwvHnKqGocIHcJCEzEIsEJsplAGhp",239,0.995833,29,240,1,239,1,1,0,1,1,110,110,130,129,1
"40",39,"[29]EwvHnKqGocIHcJCEzEIsEJsplAGhp",234,0.995745,29,235,1,234,1,1,0,1,1,111,111,124,123,1
"41",40,"[29]EwvHnKqGocIHcJCEzEIsEJsplAGhp",228,0.995633,29,229,1,228,1,1,0,1,1,118,118,111,110,1
"42",41,"[29]EwvHnKqGocIHcJCEzEIsEJsplAGhp",245,0.995935,29,246,1,245,1,1,0,1,1,105,105,141,140,1
"43",42,"[29]EwvHnKqGocIHcJCEzEIsEJsplAGhp",245,0.995935,29,246,1,245,1,1,0,1,1,107,107,139,138,1
"44",43,"[29]EwvHnKqGocIHcJCEzEIsEJsplAGhp",234,0.995745,29,235,1,234,1,1,0,1,1,111,111,124,123,1
"45",44,"[29]EwvHnKqGocIHcJCEzEIsEJsplAGhp",230,0.995671,29,231,1,230,1,1,0,1,1,115,115,116,115,1
"46",45,"[29]EwvHnKqGocIHcJCEzEIsEJsplAGhp",228,0.995633,29,229,1,228,1,1,0,1,1,117,117,112,111,1
"47",46,"[29]EwvHnKqGocIHcJCEzEIsEJsplAGhp",231,0.99569,29,232,1,231,1,1,0,1,1,114,114,118,117,1
"48",47,"[29]EwvHnKqGocIHcJCEzEIsEJsplAGhp",233,0.995726,29,234,1,233,1,1,0,1,1,114,114,120,119,1
"49",48,"[29]EwvHnKqGocIHcJCEzEIsEJsplAGhp",226,0.995595,29,227,1,226,1,1,0,1,1,117,117,110,109,1
"50",49,"[29]EwvHnKqGocIHcJCEzEIsEJsplAGhp",238,0.995816,29,239,1,238,1,1,0,1,1,108,108,131,130,1
"51",50,"[29]EwvHnKqGocIHcJCEzEIsEJsplAGhp",222,0.995516,29,223,1,222,1,1,0,1,1,124,124,99,98,1
"52",51,"[29]EwvHnKqGocIHcJCEzEIsEJsplAGhp",226,0.995595,29,227,1,226,1,1,0,1,1,117,117,110,109,1
"53",52,"[29]EwvHnKqGocIHcJCEzEIsEJsplAGhp",234,0.995745,29,235,1,234,1,1,0,1,1,112,112,123,122,1
"54",53,"[29]EwvHnKqGocIHcJCEzEIsEJsplAGhp",227,0.995614,29,228,1,227,1,1,0,1,1,117,117,111,110,1
"55",54,"[29]EwvHnKqGocIHcJCEzEIsEJsplAGhp",231,0.99569,29,232,1,231,1,1,0,1,1,115,115,117,116,1
"56",55,"[29]EwvHnKqGocIHcJCEzEIsEJsplAGhp",238,0.995816,29,239,1,238,1,1,0,1,1,108,108,131,130,1
"57",56,"[29]EwvHnKqGocIHcJCEzEIsEJsplAGhp",236,0.995781,29,237,1,236,1,1,0,1,1,110,110,127,126,1
"58",57,"[29]EwvHnKqGocIHcJCEzEIsEJsplAGhp",238,0.995816,29,239,1,238,1,1,0,1,1,109,109,130,129,1
"59",58,"[29]EwvHnKqGocIHcJCEzEIsEJsplAGhp",229,0.995652,29,230,1,229,1,1,0,1,1,116,116,114,113,1
"60",59,"[29]EwvHnKqGocIHcJCEzEIsEJsplAGhp",226,0.995595,29,227,1,226,1,1,0,1,1,117,117,110,109,1
"61",60,"[29]EwvHnKqGocIHcJCEzEIsEJsplAGhp",228,0.995633,29,229,1,228,1,1,0,1,1,117,117,112,111,1
"62",61,"[29]EwvHnKqGocIHcJCEzEIsEJsplAGhp",232,0.995708,29,233,1,232,1,1,0,1,1,114,114,119,118,1
"63",62,"[29]EwvHnKqGocIHcJCEzEIsEJsplAGhp",223,0.995536,29,224,1,223,1,1,0,1,1,120,120,104,103,1
"64",63,"[29]EwvHnKqGocIHcJCEzEIsEJsplAGhp",225,0.995575,29,226,1,225,1,1,0,1,1,118,118,108,107,1
"65",64,"[29]EwvHnKqGocIHcJCEzEIsEJsplAGhp",232,0.995708,29,233,1,232,1,1,0,1,1,114,114,119,118,1
"66",65,"[29]EwvHnKqGocIHcJCEzEIsEJsplAGhp",220,0.995475,29,221,1,220,1,1,0,1,1,122,122,99,98,1
"67",66,"[29]EwvHnKqGocIHcJCEzEIsEJsplAGhp",224,0.995556,29,225,1,224,1,1,0,1,1,121,121,104,103,1
"68",67,"[29]EwvHnKqGocIHcJCEzEIsEJsplAGhp",241,0.995868,29,242,1,241,1,1,0,1,1,106,106,136,135,1
"69",68,"[29]EwvHnKqGocIHcJCEzEIsEJsplAGhp",230,0.995671,29,231,1,230,1,1,0,1,1,116,116,115,114,1
"70",69,"[29]EwvHnKqGocIHcJCEzEIsEJsplAGhp",246,0.995951,29,247,1,246,1,1,0,1,1,104,104,143,142,1
"71",70,"[29]EwvHnKqGocIHcJCEzEIsEJsplAGhp",227,0.995614,29,228,1,227,1,1,0,1,1,117,117,111,110,1
"72",71,"[29]EwvHnKqGocIHcJCEzEIsEJsplAGhp",241,0.995868,29,242,1,241,1,1,0,1,1,105,105,137,136,1
"73",72,"[29]EwvHnKqGocIHcJCEzEIsEJsplAGhp",230,0.995671,29,231,1,230,1,1,0,1,1,115,115,116,115,1
"74",73,"[29]EwvHnKqGocIHcJCEzEIsEJsplAGhp",225,0.995575,29,226,1,225,1,1,0,1,1,119,119,107,106,1
"75",74,"[29]EwvHnKqGocIHcJCEzEIsEJsplAGhp",237,0.995798,29,238,1,237,1,1,0,1,1,109,109,129,128,1
"76",75,"[29]EwvHnKqGocIHcJCEzEIsEJsplAGhp",230,0.995671,29,231,1,230,1,1,0,1,1,117,117,114,113,1
"77",76,"[29]EwvHnKqGocIHcJCEzEIsEJsplAGhp",227,0.995614,29,228,1,227,1,1,0,1,1,117,117,111,110,1
"78",77,"[29]EwvHnKqGocIHcJCEzEIsEJsplAGhp",236,0.995781,29,237,1,236,1,1,0,1,1,109,109,128,127,1
"79",78,"[29]EwvHnKqGocIHcJCEzEIsEJsplAGhp",240,0.995851,29,241,1,240,1,1,0,1,1,106,106,135,134,1
"80",79,"[29]EwvHnKqGocIHcJCEzEIsEJsplAGhp",226,0.995595,29,227,1,226,1,1,0,1,1,118,118,109,108,1
"81",80,"[29]EwvHnKqGocIHcJCEzEIsEJsplAGhp",223,0.995536,29,224,1,223,1,1,0,1,1,120,120,104,103,1
"82",81,"[29]EwvHnKqGocIHcJCEzEIsEJsplAGhp",227,0.995614,29,228,1,227,1,1,0,1,1,119,119,109,108,1
"83",82,"[29]EwvHnKqGocIHcJCEzEIsEJsplAGhp",230,0.995671,29,231,1,230,1,1,0,1,1,114,114,117,116,1
"84",83,"[29]EwvHnKqGocIHcJCEzEIsEJsplAGhp",243,0.995902,29,244,1,243,1,1,0,1,1,106,106,138,137,1
"85",84,"[29]EwvHnKqGocIHcJCEzEIsEJsplAGhp",226,0.995595,29,227,1,226,1,1,0,1,1,118,118,109,108,1
"86",85,"[29]EwvHnKqGocIHcJCEzEIsEJsplAGhp",225,0.995575,29,226,1,225,1,1,0,1,1,118,118,108,107,1
"87",86,"[29]EwvHnKqGocIHcJCEzEIsEJsplAGhp",236,0.995781,29,237,1,236,1,1,0,1,1,109,109,128,127,1
"88",87,"[29]EwvHnKqGocIHcJCEzEIsEJsplAGhp",236,0.995781,29,237,1,236,1,1,0,1,1,110,110,127,126,1
"89",88,"[29]EwvHnKqGocIHcJCEzEIsEJsplAGhp",219,0.995455,29,220,1,219,1,1,0,1,1,123,123,97,96,1
"90",89,"[29]EwvHnKqGocIHcJCEzEIsEJsplAGhp",228,0.995633,29,229,1,228,1,1,0,1,1,116,116,113,112,1
"91",90,"[29]EwvHnKqGocIHcJCEzEIsEJsplAGhp",225,0.995575,29,226,1,225,1,1,0,1,1,120,120,106,105,1
"92",91,"[29]EwvHnKqGocIHcJCEzEIsEJsplAGhp",224,0.995556,29,225,1,224,1,1,0,1,1,119,119,106,105,1
"93",92,"[29]EwvHnKqGocIHcJCEzEIsEJsplAGhp",244,0.995918,29,245,1,244,1,1,0,1,1,106,106,139,138,1
"94",93,"[29]EwvHnKqGocIHcJCEzEIsEJsplAGhp",224,0.995556,29,225,1,224,1,1,0,1,1,120,120,105,104,1
"95",94,"[29]EwvHnKqGocIHcJCEzEIsEJsplAGhp",223,0.995536,29,224,1,223,1,1,0,1,1,120,120,104,103,1
"96",95,"[29]EwvHnKqGocIHcJCEzEIsEJsplAGhp",226,0.995595,29,227,1,226,1,1,0,1,1,117,117,110,109,1
"97",96,"[29]EwvHnKqGocIHcJCEzEIsEJsplAGhp",234,0.995745,29,235,1,234,1,1,0,1,1,113,113,122,121,1
"98",97,"[29]EwvHnKqGocIHcJCEzEIsEJsplAGhp",230,0.995671,29,231,1,230,1,1,0,1,1,115,115,116,115,1
"99",98,"[29]EwvHnKqGocIHcJCEzEIsEJsplAGhp",222,0.995516,29,223,1,222,1,1,0,1,1,121,121,102,101,1
"100",99,"[29]EwvHnKqGocIHcJCEzEIsEJsplAGhp",230,0.995671,29,231,1,230,1,1,0,1,1,114,114,117,116,1
"101",0,"[22]EixbtHnKqGocIHcJCInujE",230,0.995671,22,231,1,230,1,1,0,1,1,115,115,116,115,2
"102",1,"[22]EixbtHnKqGocIHcJCInujE",238,0.995816,22,239,1,238,1,1,0,1,1,108,108,131,130,2
"103",2,"[22]EixbtHnKqGocIHcJCInujE",223,0.995536,22,224,1,223,1,1,0,1,1,119,119,105,104,2
"104",3,"[22]EixbtHnKqGocIHcJCInujE",230,0.995671,22,231,1,230,1,1,0,1,1,114,114,117,116,2
"105",4,"[22]EixbtHnKqGocIHcJCInujE",223,0.995536,22,224,1,223,1,1,0,1,1,120,120,104,103,2
"106",5,"[22]EixbtHnKqGocIHcJCInujE",230,0.995671,22,231,1,230,1,1,0,1,1,114,114,117,116,2
"107",6,"[22]EixbtHnKqGocIHcJCInujE",235,0.995763,22,236,1,235,1,1,0,1,1,113,113,123,122,2
"108",7,"[22]EixbtHnKqGocIHcJCInujE",228,0.995633,22,229,1,228,1,1,0,1,1,117,117,112,111,2
"109",8,"[22]EixbtHnKqGocIHcJCInujE",238,0.995816,22,239,1,238,1,1,0,1,1,108,108,131,130,2
"110",9,"[22]EixbtHnKqGocIHcJCInujE",227,0.995614,22,228,1,227,1,1,0,1,1,116,116,112,111,2
"111",10,"[22]EixbtHnKqGocIHcJCInujE",240,0.995851,22,241,1,240,1,1,0,1,1,107,107,134,133,2
"112",11,"[22]EixbtHnKqGocIHcJCInujE",226,0.995595,22,227,1,226,1,1,0,1,1,117,117,110,109,2
"113",12,"[22]EixbtHnKqGocIHcJCInujE",233,0.995726,22,234,1,233,1,1,0,1,1,112,112,122,121,2
"114",13,"[22]EixbtHnKqGocIHcJCInujE",223,0.995536,22,224,1,223,1,1,0,1,1,119,119,105,104,2
"115",14,"[22]EixbtHnKqGocIHcJCInujE",219,0.995455,22,220,1,219,1,1,0,1,1,123,123,97,96,2
"116",15,"[22]EixbtHnKqGocIHcJCInujE",226,0.995595,22,227,1,226,1,1,0,1,1,117,117,110,109,2
"117",16,"[22]EixbtHnKqGocIHcJCInujE",238,0.995816,22,239,1,238,1,1,0,1,1,108,108,131,130,2
"118",17,"[22]EixbtHnKqGocIHcJCInujE",228,0.995633,22,229,1,228,1,1,0,1,1,117,117,112,111,2
"119",18,"[22]EixbtHnKqGocIHcJCInujE",236,0.995781,22,237,1,236,1,1,0,1,1,110,110,127,126,2
"120",19,"[22]EixbtHnKqGocIHcJCInujE",230,0.995671,22,231,1,230,1,1,0,1,1,115,115,116,115,2
"121",20,"[22]EixbtHnKqGocIHcJCInujE",233,0.995726,22,234,1,233,1,1,0,1,1,114,114,120,119,2
"122",21,"[22]EixbtHnKqGocIHcJCInujE",222,0.995516,22,223,1,222,1,1,0,1,1,121,121,102,101,2
"123",22,"[22]EixbtHnKqGocIHcJCInujE",230,0.995671,22,231,1,230,1,1,0,1,1,115,115,116,115,2
"124",23,"[22]EixbtHnKqGocIHcJCInujE",227,0.995614,22,228,1,227,1,1,0,1,1,117,117,111,110,2
"125",24,"[22]EixbtHnKqGocIHcJCInujE",236,0.995781,22,237,1,236,1,1,0,1,1,111,111,126,125,2
"126",25,"[22]EixbtHnKqGocIHcJCInujE",242,0.995885,22,243,1,242,1,1,0,1,1,104,104,139,138,2
"127",26,"[22]EixbtHnKqGocIHcJCInujE",228,0.995633,22,229,1,228,1,1,0,1,1,116,116,113,112,2
"128",27,"[22]EixbtHnKqGocIHcJCInujE",236,0.995781,22,237,1,236,1,1,0,1,1,110,110,127,126,2
"129",28,"[22]EixbtHnKqGocIHcJCInujE",238,0.995816,22,239,1,238,1,1,0,1,1,109,109,130,129,2
"130",29,"[22]EixbtHnKqGocIHcJCInujE",228,0.995633,22,229,1,228,1,1,0,1,1,116,116,113,112,2
"131",30,"[22]EixbtHnKqGocIHcJCInujE",228,0.995633,22,229,1,228,1,1,0,1,1,116,116,113,112,2
"132",31,"[22]EixbtHnKqGocIHcJCInujE",241,0.995868,22,242,1,241,1,1,0,1,1,106,106,136,135,2
"133",32,"[22]EixbtHnKqGocIHcJCInujE",236,0.995781,22,237,1,236,1,1,0,1,1,109,109,128,127,2
"134",33,"[22]EixbtHnKqGocIHcJCInujE",229,0.995652,22,230,1,229,1,1,0,1,1,115,115,115,114,2
"135",34,"[22]EixbtHnKqGocIHcJCInujE",225,0.995575,22,226,1,225,1,1,0,1,1,119,119,107,106,2
"136",35,"[22]EixbtHnKqGocIHcJCInujE",217,0.995413,22,218,1,217,1,1,0,1,1,124,124,94,93,2
"137",36,"[22]EixbtHnKqGocIHcJCInujE",232,0.995708,22,233,1,232,1,1,0,1,1,118,118,115,114,2
"138",37,"[22]EixbtHnKqGocIHcJCInujE",229,0.995652,22,230,1,229,1,1,0,1,1,117,117,113,112,2
"139",38,"[22]EixbtHnKqGocIHcJCInujE",226,0.995595,22,227,1,226,1,1,0,1,1,120,120,107,106,2
"140",39,"[22]EixbtHnKqGocIHcJCInujE",223,0.995536,22,224,1,223,1,1,0,1,1,121,121,103,102,2
"141",40,"[22]EixbtHnKqGocIHcJCInujE",234,0.995745,22,235,1,234,1,1,0,1,1,111,111,124,123,2
"142",41,"[22]EixbtHnKqGocIHcJCInujE",228,0.995633,22,229,1,228,1,1,0,1,1,121,121,108,107,2
"143",42,"[22]EixbtHnKqGocIHcJCInujE",232,0.995708,22,233,1,232,1,1,0,1,1,115,115,118,117,2
"144",43,"[22]EixbtHnKqGocIHcJCInujE",232,0.995708,22,233,1,232,1,1,0,1,1,112,112,121,120,2
"145",44,"[22]EixbtHnKqGocIHcJCInujE",225,0.995575,22,226,1,225,1,1,0,1,1,119,119,107,106,2
"146",45,"[22]EixbtHnKqGocIHcJCInujE",222,0.995516,22,223,1,222,1,1,0,1,1,121,121,102,101,2
"147",46,"[22]EixbtHnKqGocIHcJCInujE",218,0.995434,22,219,1,218,1,1,0,1,1,123,123,96,95,2
"148",47,"[22]EixbtHnKqGocIHcJCInujE",236,0.995781,22,237,1,236,1,1,0,1,1,111,111,126,125,2
"149",48,"[22]EixbtHnKqGocIHcJCInujE",234,0.995745,22,235,1,234,1,1,0,1,1,111,111,124,123,2
"150",49,"[22]EixbtHnKqGocIHcJCInujE",230,0.995671,22,231,1,230,1,1,0,1,1,115,115,116,115,2
"151",50,"[22]EixbtHnKqGocIHcJCInujE",227,0.995614,22,228,1,227,1,1,0,1,1,116,116,112,111,2
"152",51,"[22]EixbtHnKqGocIHcJCInujE",226,0.995595,22,227,1,226,1,1,0,1,1,118,118,109,108,2
"153",52,"[22]EixbtHnKqGocIHcJCInujE",235,0.995763,22,236,1,235,1,1,0,1,1,111,111,125,124,2
"154",53,"[22]EixbtHnKqGocIHcJCInujE",232,0.995708,22,233,1,232,1,1,0,1,1,114,114,119,118,2
"155",54,"[22]EixbtHnKqGocIHcJCInujE",233,0.995726,22,234,1,233,1,1,0,1,1,111,111,123,122,2
"156",55,"[22]EixbtHnKqGocIHcJCInujE",233,0.995726,22,234,1,233,1,1,0,1,1,113,113,121,120,2
"157",56,"[22]EixbtHnKqGocIHcJCInujE",230,0.995671,22,231,1,230,1,1,0,1,1,115,115,116,115,2
"158",57,"[22]EixbtHnKqGocIHcJCInujE",232,0.995708,22,233,1,232,1,1,0,1,1,112,112,121,120,2
"159",58,"[22]EixbtHnKqGocIHcJCInujE",236,0.995781,22,237,1,236,1,1,0,1,1,110,110,127,126,2
"160",59,"[22]EixbtHnKqGocIHcJCInujE",229,0.995652,22,230,1,229,1,1,0,1,1,116,116,114,113,2
"161",60,"[22]EixbtHnKqGocIHcJCInujE",218,0.995434,22,219,1,218,1,1,0,1,1,126,126,93,92,2
"162",61,"[22]EixbtHnKqGocIHcJCInujE",231,0.99569,22,232,1,231,1,1,0,1,1,113,113,119,118,2
"163",62,"[22]EixbtHnKqGocIHcJCInujE",241,0.995868,22,242,1,241,1,1,0,1,1,107,107,135,134,2
"164",63,"[22]EixbtHnKqGocIHcJCInujE",227,0.995614,22,228,1,227,1,1,0,1,1,117,117,111,110,2
"165",64,"[22]EixbtHnKqGocIHcJCInujE",235,0.995763,22,236,1,235,1,1,0,1,1,111,111,125,124,2
"166",65,"[22]EixbtHnKqGocIHcJCInujE",240,0.995851,22,241,1,240,1,1,0,1,1,106,106,135,134,2
"167",66,"[22]EixbtHnKqGocIHcJCInujE",236,0.995781,22,237,1,236,1,1,0,1,1,113,113,124,123,2
"168",67,"[22]EixbtHnKqGocIHcJCInujE",229,0.995652,22,230,1,229,1,1,0,1,1,115,115,115,114,2
"169",68,"[22]EixbtHnKqGocIHcJCInujE",230,0.995671,22,231,1,230,1,1,0,1,1,117,117,114,113,2
"170",69,"[22]EixbtHnKqGocIHcJCInujE",233,0.995726,22,234,1,233,1,1,0,1,1,113,113,121,120,2
"171",70,"[22]EixbtHnKqGocIHcJCInujE",231,0.99569,22,232,1,231,1,1,0,1,1,115,115,117,116,2
"172",71,"[22]EixbtHnKqGocIHcJCInujE",233,0.995726,22,234,1,233,1,1,0,1,1,113,113,121,120,2
"173",72,"[22]EixbtHnKqGocIHcJCInujE",227,0.995614,22,228,1,227,1,1,0,1,1,116,116,112,111,2
"174",73,"[22]EixbtHnKqGocIHcJCInujE",220,0.995475,22,221,1,220,1,1,0,1,1,122,122,99,98,2
"175",74,"[22]EixbtHnKqGocIHcJCInujE",225,0.995575,22,226,1,225,1,1,0,1,1,118,118,108,107,2
"176",75,"[22]EixbtHnKqGocIHcJCInujE",238,0.995816,22,239,1,238,1,1,0,1,1,109,109,130,129,2
"177",76,"[22]EixbtHnKqGocIHcJCInujE",223,0.995536,22,224,1,223,1,1,0,1,1,119,119,105,104,2
"178",77,"[22]EixbtHnKqGocIHcJCInujE",240,0.995851,22,241,1,240,1,1,0,1,1,107,107,134,133,2
"179",78,"[22]EixbtHnKqGocIHcJCInujE",230,0.995671,22,231,1,230,1,1,0,1,1,116,116,115,114,2
"180",79,"[22]EixbtHnKqGocIHcJCInujE",221,0.995495,22,222,1,221,1,1,0,1,1,122,122,100,99,2
"181",80,"[22]EixbtHnKqGocIHcJCInujE",234,0.995745,22,235,1,234,1,1,0,1,1,111,111,124,123,2
"182",81,"[22]EixbtHnKqGocIHcJCInujE",223,0.995536,22,224,1,223,1,1,0,1,1,120,120,104,103,2
"183",82,"[22]EixbtHnKqGocIHcJCInujE",237,0.995798,22,238,1,237,1,1,0,1,1,109,109,129,128,2
"184",83,"[22]EixbtHnKqGocIHcJCInujE",232,0.995708,22,233,1,232,1,1,0,1,1,113,113,120,119,2
"185",84,"[22]EixbtHnKqGocIHcJCInujE",225,0.995575,22,226,1,225,1,1,0,1,1,118,118,108,107,2
"186",85,"[22]EixbtHnKqGocIHcJCInujE",232,0.995708,22,233,1,232,1,1,0,1,1,113,113,120,119,2
"187",86,"[22]EixbtHnKqGocIHcJCInujE",229,0.995652,22,230,1,229,1,1,0,1,1,119,119,111,110,2
"188",87,"[22]EixbtHnKqGocIHcJCInujE",227,0.995614,22,228,1,227,1,1,0,1,1,116,116,112,111,2
"189",88,"[22]EixbtHnKqGocIHcJCInujE",227,0.995614,22,228,1,227,1,1,0,1,1,117,117,111,110,2
"190",89,"[22]EixbtHnKqGocIHcJCInujE",225,0.995575,22,226,1,225,1,1,0,1,1,118,118,108,107,2
"191",90,"[22]EixbtHnKqGocIHcJCInujE",239,0.995833,22,240,1,239,1,1,0,1,1,108,108,132,131,2
"192",91,"[22]EixbtHnKqGocIHcJCInujE",235,0.995763,22,236,1,235,1,1,0,1,1,112,112,124,123,2
"193",92,"[22]EixbtHnKqGocIHcJCInujE",232,0.995708,22,233,1,232,1,1,0,1,1,113,113,120,119,2
"194",93,"[22]EixbtHnKqGocIHcJCInujE",226,0.995595,22,227,1,226,1,1,0,1,1,117,117,110,109,2
"195",94,"[22]EixbtHnKqGocIHcJCInujE",226,0.995595,22,227,1,226,1,1,0,1,1,121,121,106,105,2
"196",95,"[22]EixbtHnKqGocIHcJCInujE",219,0.995455,22,220,1,219,1,1,0,1,1,124,124,96,95,2
"197",96,"[22]EixbtHnKqGocIHcJCInujE",235,0.995763,22,236,1,235,1,1,0,1,1,111,111,125,124,2
"198",97,"[22]EixbtHnKqGocIHcJCInujE",220,0.995475,22,221,1,220,1,1,0,1,1,122,122,99,98,2
"199",98,"[22]EixbtHnKqGocIHcJCInujE",224,0.995556,22,225,1,224,1,1,0,1,1,119,119,106,105,2
"200",99,"[22]EixbtHnKqGocIHcJCInujE",230,0.995671,22,231,1,230,1,1,0,1,1,114,114,117,116,2
"201",0,"[30]EHhyvHnKqGocIHcJCHnKrsImnFeteG",220,0.995475,30,221,1,220,1,1,0,1,1,123,123,98,97,3
"202",1,"[30]EHhyvHnKqGocIHcJCHnKrsImnFeteG",219,0.995455,30,220,1,219,1,1,0,1,1,123,123,97,96,3
"203",2,"[30]EHhyvHnKqGocIHcJCHnKrsImnFeteG",230,0.995671,30,231,1,230,1,1,0,1,1,117,117,114,113,3
"204",3,"[30]EHhyvHnKqGocIHcJCHnKrsImnFeteG",222,0.995516,30,223,1,222,1,1,0,1,1,121,121,102,101,3
"205",4,"[30]EHhyvHnKqGocIHcJCHnKrsImnFeteG",231,0.99569,30,232,1,231,1,1,0,1,1,113,113,119,118,3
"206",5,"[30]EHhyvHnKqGocIHcJCHnKrsImnFeteG",228,0.995633,30,229,1,228,1,1,0,1,1,115,115,114,113,3
"207",6,"[30]EHhyvHnKqGocIHcJCHnKrsImnFeteG",236,0.995781,30,237,1,236,1,1,0,1,1,110,110,127,126,3
"208",7,"[30]EHhyvHnKqGocIHcJCHnKrsImnFeteG",241,0.995868,30,242,1,241,1,1,0,1,1,107,107,135,134,3
"209",8,"[30]EHhyvHnKqGocIHcJCHnKrsImnFeteG",234,0.995745,30,235,1,234,1,1,0,1,1,111,111,124,123,3
"210",9,"[30]EHhyvHnKqGocIHcJCHnKrsImnFeteG",223,0.995536,30,224,1,223,1,1,0,1,1,123,123,101,100,3
"211",10,"[30]EHhyvHnKqGocIHcJCHnKrsImnFeteG",239,0.995833,30,240,1,239,1,1,0,1,1,108,108,132,131,3
"212",11,"[30]EHhyvHnKqGocIHcJCHnKrsImnFeteG",229,0.995652,30,230,1,229,1,1,0,1,1,116,116,114,113,3
"213",12,"[30]EHhyvHnKqGocIHcJCHnKrsImnFeteG",236,0.995781,30,237,1,236,1,1,0,1,1,110,110,127,126,3
"214",13,"[30]EHhyvHnKqGocIHcJCHnKrsImnFeteG",241,0.995868,30,242,1,241,1,1,0,1,1,106,106,136,135,3
"215",14,"[30]EHhyvHnKqGocIHcJCHnKrsImnFeteG",233,0.995726,30,234,1,233,1,1,0,1,1,112,112,122,121,3
"216",15,"[30]EHhyvHnKqGocIHcJCHnKrsImnFeteG",240,0.995851,30,241,1,240,1,1,0,1,1,107,107,134,133,3
"217",16,"[30]EHhyvHnKqGocIHcJCHnKrsImnFeteG",237,0.995798,30,238,1,237,1,1,0,1,1,110,110,128,127,3
"218",17,"[30]EHhyvHnKqGocIHcJCHnKrsImnFeteG",227,0.995614,30,228,1,227,1,1,0,1,1,116,116,112,111,3
"219",18,"[30]EHhyvHnKqGocIHcJCHnKrsImnFeteG",228,0.995633,30,229,1,228,1,1,0,1,1,116,116,113,112,3
"220",19,"[30]EHhyvHnKqGocIHcJCHnKrsImnFeteG",233,0.995726,30,234,1,233,1,1,0,1,1,112,112,122,121,3
"221",20,"[30]EHhyvHnKqGocIHcJCHnKrsImnFeteG",232,0.995708,30,233,1,232,1,1,0,1,1,115,115,118,117,3
"222",21,"[30]EHhyvHnKqGocIHcJCHnKrsImnFeteG",237,0.995798,30,238,1,237,1,1,0,1,1,108,108,130,129,3
"223",22,"[30]EHhyvHnKqGocIHcJCHnKrsImnFeteG",221,0.995495,30,222,1,221,1,1,0,1,1,121,121,101,100,3
"224",23,"[30]EHhyvHnKqGocIHcJCHnKrsImnFeteG",231,0.99569,30,232,1,231,1,1,0,1,1,114,114,118,117,3
"225",24,"[30]EHhyvHnKqGocIHcJCHnKrsImnFeteG",232,0.995708,30,233,1,232,1,1,0,1,1,113,113,120,119,3
"226",25,"[30]EHhyvHnKqGocIHcJCHnKrsImnFeteG",238,0.995816,30,239,1,238,1,1,0,1,1,108,108,131,130,3
"227",26,"[30]EHhyvHnKqGocIHcJCHnKrsImnFeteG",227,0.995614,30,228,1,227,1,1,0,1,1,116,116,112,111,3
"228",27,"[30]EHhyvHnKqGocIHcJCHnKrsImnFeteG",227,0.995614,30,228,1,227,1,1,0,1,1,116,116,112,111,3
"229",28,"[30]EHhyvHnKqGocIHcJCHnKrsImnFeteG",229,0.995652,30,230,1,229,1,1,0,1,1,120,120,110,109,3
"230",29,"[30]EHhyvHnKqGocIHcJCHnKrsImnFeteG",232,0.995708,30,233,1,232,1,1,0,1,1,115,115,118,117,3
"231",30,"[30]EHhyvHnKqGocIHcJCHnKrsImnFeteG",231,0.99569,30,232,1,231,1,1,0,1,1,114,114,118,117,3
"232",31,"[30]EHhyvHnKqGocIHcJCHnKrsImnFeteG",230,0.995671,30,231,1,230,1,1,0,1,1,115,115,116,115,3
"233",32,"[30]EHhyvHnKqGocIHcJCHnKrsImnFeteG",231,0.99569,30,232,1,231,1,1,0,1,1,113,113,119,118,3
"234",33,"[30]EHhyvHnKqGocIHcJCHnKrsImnFeteG",224,0.995556,30,225,1,224,1,1,0,1,1,119,119,106,105,3
"235",34,"[30]EHhyvHnKqGocIHcJCHnKrsImnFeteG",227,0.995614,30,228,1,227,1,1,0,1,1,116,116,112,111,3
"236",35,"[30]EHhyvHnKqGocIHcJCHnKrsImnFeteG",227,0.995614,30,228,1,227,1,1,0,1,1,117,117,111,110,3
"237",36,"[30]EHhyvHnKqGocIHcJCHnKrsImnFeteG",233,0.995726,30,234,1,233,1,1,0,1,1,117,117,117,116,3
"238",37,"[30]EHhyvHnKqGocIHcJCHnKrsImnFeteG",229,0.995652,30,230,1,229,1,1,0,1,1,116,116,114,113,3
"239",38,"[30]EHhyvHnKqGocIHcJCHnKrsImnFeteG",233,0.995726,30,234,1,233,1,1,0,1,1,113,113,121,120,3
"240",39,"[30]EHhyvHnKqGocIHcJCHnKrsImnFeteG",226,0.995595,30,227,1,226,1,1,0,1,1,119,119,108,107,3
"241",40,"[30]EHhyvHnKqGocIHcJCHnKrsImnFeteG",237,0.995798,30,238,1,237,1,1,0,1,1,108,108,130,129,3
"242",41,"[30]EHhyvHnKqGocIHcJCHnKrsImnFeteG",232,0.995708,30,233,1,232,1,1,0,1,1,114,114,119,118,3
"243",42,"[30]EHhyvHnKqGocIHcJCHnKrsImnFeteG",223,0.995536,30,224,1,223,1,1,0,1,1,120,120,104,103,3
"244",43,"[30]EHhyvHnKqGocIHcJCHnKrsImnFeteG",228,0.995633,30,229,1,228,1,1,0,1,1,116,116,113,112,3
"245",44,"[30]EHhyvHnKqGocIHcJCHnKrsImnFeteG",232,0.995708,30,233,1,232,1,1,0,1,1,112,112,121,120,3
"246",45,"[30]EHhyvHnKqGocIHcJCHnKrsImnFeteG",225,0.995575,30,226,1,225,1,1,0,1,1,119,119,107,106,3
"247",46,"[30]EHhyvHnKqGocIHcJCHnKrsImnFeteG",233,0.995726,30,234,1,233,1,1,0,1,1,112,112,122,121,3
"248",47,"[30]EHhyvHnKqGocIHcJCHnKrsImnFeteG",234,0.995745,30,235,1,234,1,1,0,1,1,111,111,124,123,3
"249",48,"[30]EHhyvHnKqGocIHcJCHnKrsImnFeteG",230,0.995671,30,231,1,230,1,1,0,1,1,114,114,117,116,3
"250",49,"[30]EHhyvHnKqGocIHcJCHnKrsImnFeteG",223,0.995536,30,224,1,223,1,1,0,1,1,120,120,104,103,3
"251",50,"[30]EHhyvHnKqGocIHcJCHnKrsImnFeteG",223,0.995536,30,224,1,223,1,1,0,1,1,119,119,105,104,3
"252",51,"[30]EHhyvHnKqGocIHcJCHnKrsImnFeteG",229,0.995652,30,230,1,229,1,1,0,1,1,115,115,115,114,3
"253",52,"[30]EHhyvHnKqGocIHcJCHnKrsImnFeteG",225,0.995575,30,226,1,225,1,1,0,1,1,119,119,107,106,3
"254",53,"[30]EHhyvHnKqGocIHcJCHnKrsImnFeteG",235,0.995763,30,236,1,235,1,1,0,1,1,111,111,125,124,3
"255",54,"[30]EHhyvHnKqGocIHcJCHnKrsImnFeteG",223,0.995536,30,224,1,223,1,1,0,1,1,119,119,105,104,3
"256",55,"[30]EHhyvHnKqGocIHcJCHnKrsImnFeteG",236,0.995781,30,237,1,236,1,1,0,1,1,110,110,127,126,3
"257",56,"[30]EHhyvHnKqGocIHcJCHnKrsImnFeteG",237,0.995798,30,238,1,237,1,1,0,1,1,109,109,129,128,3
"258",57,"[30]EHhyvHnKqGocIHcJCHnKrsImnFeteG",240,0.995851,30,241,1,240,1,1,0,1,1,106,106,135,134,3
"259",58,"[30]EHhyvHnKqGocIHcJCHnKrsImnFeteG",224,0.995556,30,225,1,224,1,1,0,1,1,119,119,106,105,3
"260",59,"[30]EHhyvHnKqGocIHcJCHnKrsImnFeteG",245,0.995935,30,246,1,245,1,1,0,1,1,104,104,142,141,3
"261",60,"[30]EHhyvHnKqGocIHcJCHnKrsImnFeteG",227,0.995614,30,228,1,227,1,1,0,1,1,116,116,112,111,3
"262",61,"[30]EHhyvHnKqGocIHcJCHnKrsImnFeteG",222,0.995516,30,223,1,222,1,1,0,1,1,120,120,103,102,3
"263",62,"[30]EHhyvHnKqGocIHcJCHnKrsImnFeteG",232,0.995708,30,233,1,232,1,1,0,1,1,114,114,119,118,3
"264",63,"[30]EHhyvHnKqGocIHcJCHnKrsImnFeteG",235,0.995763,30,236,1,235,1,1,0,1,1,111,111,125,124,3
"265",64,"[30]EHhyvHnKqGocIHcJCHnKrsImnFeteG",221,0.995495,30,222,1,221,1,1,0,1,1,125,125,97,96,3
"266",65,"[30]EHhyvHnKqGocIHcJCHnKrsImnFeteG",232,0.995708,30,233,1,232,1,1,0,1,1,112,112,121,120,3
"267",66,"[30]EHhyvHnKqGocIHcJCHnKrsImnFeteG",230,0.995671,30,231,1,230,1,1,0,1,1,114,114,117,116,3
"268",67,"[30]EHhyvHnKqGocIHcJCHnKrsImnFeteG",237,0.995798,30,238,1,237,1,1,0,1,1,109,109,129,128,3
"269",68,"[30]EHhyvHnKqGocIHcJCHnKrsImnFeteG",237,0.995798,30,238,1,237,1,1,0,1,1,109,109,129,128,3
"270",69,"[30]EHhyvHnKqGocIHcJCHnKrsImnFeteG",234,0.995745,30,235,1,234,1,1,0,1,1,113,113,122,121,3
"271",70,"[30]EHhyvHnKqGocIHcJCHnKrsImnFeteG",223,0.995536,30,224,1,223,1,1,0,1,1,119,119,105,104,3
"272",71,"[30]EHhyvHnKqGocIHcJCHnKrsImnFeteG",226,0.995595,30,227,1,226,1,1,0,1,1,119,119,108,107,3
"273",72,"[30]EHhyvHnKqGocIHcJCHnKrsImnFeteG",231,0.99569,30,232,1,231,1,1,0,1,1,114,114,118,117,3
"274",73,"[30]EHhyvHnKqGocIHcJCHnKrsImnFeteG",222,0.995516,30,223,1,222,1,1,0,1,1,120,120,103,102,3
"275",74,"[30]EHhyvHnKqGocIHcJCHnKrsImnFeteG",239,0.995833,30,240,1,239,1,1,0,1,1,107,107,133,132,3
"276",75,"[30]EHhyvHnKqGocIHcJCHnKrsImnFeteG",236,0.995781,30,237,1,236,1,1,0,1,1,110,110,127,126,3
"277",76,"[30]EHhyvHnKqGocIHcJCHnKrsImnFeteG",222,0.995516,30,223,1,222,1,1,0,1,1,121,121,102,101,3
"278",77,"[30]EHhyvHnKqGocIHcJCHnKrsImnFeteG",233,0.995726,30,234,1,233,1,1,0,1,1,111,111,123,122,3
"279",78,"[30]EHhyvHnKqGocIHcJCHnKrsImnFeteG",236,0.995781,30,237,1,236,1,1,0,1,1,110,110,127,126,3
"280",79,"[30]EHhyvHnKqGocIHcJCHnKrsImnFeteG",242,0.995885,30,243,1,242,1,1,0,1,1,105,105,138,137,3
"281",80,"[30]EHhyvHnKqGocIHcJCHnKrsImnFeteG",227,0.995614,30,228,1,227,1,1,0,1,1,116,116,112,111,3
"282",81,"[30]EHhyvHnKqGocIHcJCHnKrsImnFeteG",235,0.995763,30,236,1,235,1,1,0,1,1,111,111,125,124,3
"283",82,"[30]EHhyvHnKqGocIHcJCHnKrsImnFeteG",231,0.99569,30,232,1,231,1,1,0,1,1,114,114,118,117,3
"284",83,"[30]EHhyvHnKqGocIHcJCHnKrsImnFeteG",229,0.995652,30,230,1,229,1,1,0,1,1,117,117,113,112,3
"285",84,"[30]EHhyvHnKqGocIHcJCHnKrsImnFeteG",238,0.995816,30,239,1,238,1,1,0,1,1,113,113,126,125,3
"286",85,"[30]EHhyvHnKqGocIHcJCHnKrsImnFeteG",224,0.995556,30,225,1,224,1,1,0,1,1,121,121,104,103,3
"287",86,"[30]EHhyvHnKqGocIHcJCHnKrsImnFeteG",236,0.995781,30,237,1,236,1,1,0,1,1,110,110,127,126,3
"288",87,"[30]EHhyvHnKqGocIHcJCHnKrsImnFeteG",231,0.99569,30,232,1,231,1,1,0,1,1,113,113,119,118,3
"289",88,"[30]EHhyvHnKqGocIHcJCHnKrsImnFeteG",243,0.995902,30,244,1,243,1,1,0,1,1,104,104,140,139,3
"290",89,"[30]EHhyvHnKqGocIHcJCHnKrsImnFeteG",234,0.995745,30,235,1,234,1,1,0,1,1,111,111,124,123,3
"291",90,"[30]EHhyvHnKqGocIHcJCHnKrsImnFeteG",229,0.995652,30,230,1,229,1,1,0,1,1,115,115,115,114,3
"292",91,"[30]EHhyvHnKqGocIHcJCHnKrsImnFeteG",221,0.995495,30,222,1,221,1,1,0,1,1,121,121,101,100,3
"293",92,"[30]EHhyvHnKqGocIHcJCHnKrsImnFeteG",222,0.995516,30,223,1,222,1,1,0,1,1,120,120,103,102,3
"294",93,"[30]EHhyvHnKqGocIHcJCHnKrsImnFeteG",234,0.995745,30,235,1,234,1,1,0,1,1,112,112,123,122,3
"295",94,"[30]EHhyvHnKqGocIHcJCHnKrsImnFeteG",224,0.995556,30,225,1,224,1,1,0,1,1,121,121,104,103,3
"296",95,"[30]EHhyvHnKqGocIHcJCHnKrsImnFeteG",217,0.995413,30,218,1,217,1,1,0,1,1,125,125,93,92,3
"297",96,"[30]EHhyvHnKqGocIHcJCHnKrsImnFeteG",221,0.995495,30,222,1,221,1,1,0,1,1,121,121,101,100,3
"298",97,"[30]EHhyvHnKqGocIHcJCHnKrsImnFeteG",229,0.995652,30,230,1,229,1,1,0,1,1,115,115,115,114,3
"299",98,"[30]EHhyvHnKqGocIHcJCHnKrsImnFeteG",226,0.995595,30,227,1,226,1,1,0,1,1,117,117,110,109,3
"300",99,"[30]EHhyvHnKqGocIHcJCHnKrsImnFeteG",224,0.995556,30,225,1,224,1,1,0,1,1,119,119,106,105,3
"301",0,"[26]EufmwywHnKqGocIHcJCkvadikp",227,0.995614,26,228,1,227,1,1,0,1,1,117,117,111,110,4
"302",1,"[26]EufmwywHnKqGocIHcJCkvadikp",225,0.995575,26,226,1,225,1,1,0,1,1,119,119,107,106,4
"303",2,"[26]EufmwywHnKqGocIHcJCkvadikp",219,0.995455,26,220,1,219,1,1,0,1,1,124,124,96,95,4
"304",3,"[26]EufmwywHnKqGocIHcJCkvadikp",231,0.99569,26,232,1,231,1,1,0,1,1,113,113,119,118,4
"305",4,"[26]EufmwywHnKqGocIHcJCkvadikp",229,0.995652,26,230,1,229,1,1,0,1,1,116,116,114,113,4
"306",5,"[26]EufmwywHnKqGocIHcJCkvadikp",225,0.995575,26,226,1,225,1,1,0,1,1,117,117,109,108,4
"307",6,"[26]EufmwywHnKqGocIHcJCkvadikp",231,0.99569,26,232,1,231,1,1,0,1,1,113,113,119,118,4
"308",7,"[26]EufmwywHnKqGocIHcJCkvadikp",233,0.995726,26,234,1,233,1,1,0,1,1,111,111,123,122,4
"309",8,"[26]EufmwywHnKqGocIHcJCkvadikp",234,0.995745,26,235,1,234,1,1,0,1,1,111,111,124,123,4
"310",9,"[26]EufmwywHnKqGocIHcJCkvadikp",228,0.995633,26,229,1,228,1,1,0,1,1,115,115,114,113,4
"311",10,"[26]EufmwywHnKqGocIHcJCkvadikp",231,0.99569,26,232,1,231,1,1,0,1,1,115,115,117,116,4
"312",11,"[26]EufmwywHnKqGocIHcJCkvadikp",219,0.995455,26,220,1,219,1,1,0,1,1,122,122,98,97,4
"313",12,"[26]EufmwywHnKqGocIHcJCkvadikp",227,0.995614,26,228,1,227,1,1,0,1,1,117,117,111,110,4
"314",13,"[26]EufmwywHnKqGocIHcJCkvadikp",225,0.995575,26,226,1,225,1,1,0,1,1,117,117,109,108,4
"315",14,"[26]EufmwywHnKqGocIHcJCkvadikp",229,0.995652,26,230,1,229,1,1,0,1,1,114,114,116,115,4
"316",15,"[26]EufmwywHnKqGocIHcJCkvadikp",228,0.995633,26,229,1,228,1,1,0,1,1,115,115,114,113,4
"317",16,"[26]EufmwywHnKqGocIHcJCkvadikp",226,0.995595,26,227,1,226,1,1,0,1,1,117,117,110,109,4
"318",17,"[26]EufmwywHnKqGocIHcJCkvadikp",222,0.995516,26,223,1,222,1,1,0,1,1,123,123,100,99,4
"319",18,"[26]EufmwywHnKqGocIHcJCkvadikp",230,0.995671,26,231,1,230,1,1,0,1,1,113,113,118,117,4
"320",19,"[26]EufmwywHnKqGocIHcJCkvadikp",234,0.995745,26,235,1,234,1,1,0,1,1,111,111,124,123,4
"321",20,"[26]EufmwywHnKqGocIHcJCkvadikp",221,0.995495,26,222,1,221,1,1,0,1,1,122,122,100,99,4
"322",21,"[26]EufmwywHnKqGocIHcJCkvadikp",242,0.995885,26,243,1,242,1,1,0,1,1,105,105,138,137,4
"323",22,"[26]EufmwywHnKqGocIHcJCkvadikp",222,0.995516,26,223,1,222,1,1,0,1,1,120,120,103,102,4
"324",23,"[26]EufmwywHnKqGocIHcJCkvadikp",221,0.995495,26,222,1,221,1,1,0,1,1,124,124,98,97,4
"325",24,"[26]EufmwywHnKqGocIHcJCkvadikp",236,0.995781,26,237,1,236,1,1,0,1,1,109,109,128,127,4
"326",25,"[26]EufmwywHnKqGocIHcJCkvadikp",217,0.995413,26,218,1,217,1,1,0,1,1,124,124,94,93,4
"327",26,"[26]EufmwywHnKqGocIHcJCkvadikp",224,0.995556,26,225,1,224,1,1,0,1,1,118,118,107,106,4
"328",27,"[26]EufmwywHnKqGocIHcJCkvadikp",248,0.995984,26,249,1,248,1,1,0,1,1,100,100,149,148,4
"329",28,"[26]EufmwywHnKqGocIHcJCkvadikp",221,0.995495,26,222,1,221,1,1,0,1,1,123,123,99,98,4
"330",29,"[26]EufmwywHnKqGocIHcJCkvadikp",223,0.995536,26,224,1,223,1,1,0,1,1,120,120,104,103,4
"331",30,"[26]EufmwywHnKqGocIHcJCkvadikp",230,0.995671,26,231,1,230,1,1,0,1,1,113,113,118,117,4
"332",31,"[26]EufmwywHnKqGocIHcJCkvadikp",231,0.99569,26,232,1,231,1,1,0,1,1,114,114,118,117,4
"333",32,"[26]EufmwywHnKqGocIHcJCkvadikp",232,0.995708,26,233,1,232,1,1,0,1,1,114,114,119,118,4
"334",33,"[26]EufmwywHnKqGocIHcJCkvadikp",226,0.995595,26,227,1,226,1,1,0,1,1,117,117,110,109,4
"335",34,"[26]EufmwywHnKqGocIHcJCkvadikp",228,0.995633,26,229,1,228,1,1,0,1,1,115,115,114,113,4
"336",35,"[26]EufmwywHnKqGocIHcJCkvadikp",231,0.99569,26,232,1,231,1,1,0,1,1,115,115,117,116,4
"337",36,"[26]EufmwywHnKqGocIHcJCkvadikp",233,0.995726,26,234,1,233,1,1,0,1,1,115,115,119,118,4
"338",37,"[26]EufmwywHnKqGocIHcJCkvadikp",233,0.995726,26,234,1,233,1,1,0,1,1,113,113,121,120,4
"339",38,"[26]EufmwywHnKqGocIHcJCkvadikp",229,0.995652,26,230,1,229,1,1,0,1,1,115,115,115,114,4
"340",39,"[26]EufmwywHnKqGocIHcJCkvadikp",229,0.995652,26,230,1,229,1,1,0,1,1,116,116,114,113,4
"341",40,"[26]EufmwywHnKqGocIHcJCkvadikp",239,0.995833,26,240,1,239,1,1,0,1,1,107,107,133,132,4
"342",41,"[26]EufmwywHnKqGocIHcJCkvadikp",232,0.995708,26,233,1,232,1,1,0,1,1,112,112,121,120,4
"343",42,"[26]EufmwywHnKqGocIHcJCkvadikp",230,0.995671,26,231,1,230,1,1,0,1,1,113,113,118,117,4
"344",43,"[26]EufmwywHnKqGocIHcJCkvadikp",241,0.995868,26,242,1,241,1,1,0,1,1,107,107,135,134,4
"345",44,"[26]EufmwywHnKqGocIHcJCkvadikp",229,0.995652,26,230,1,229,1,1,0,1,1,114,114,116,115,4
"346",45,"[26]EufmwywHnKqGocIHcJCkvadikp",226,0.995595,26,227,1,226,1,1,0,1,1,117,117,110,109,4
"347",46,"[26]EufmwywHnKqGocIHcJCkvadikp",240,0.995851,26,241,1,240,1,1,0,1,1,105,105,136,135,4
"348",47,"[26]EufmwywHnKqGocIHcJCkvadikp",237,0.995798,26,238,1,237,1,1,0,1,1,109,109,129,128,4
"349",48,"[26]EufmwywHnKqGocIHcJCkvadikp",228,0.995633,26,229,1,228,1,1,0,1,1,115,115,114,113,4
"350",49,"[26]EufmwywHnKqGocIHcJCkvadikp",223,0.995536,26,224,1,223,1,1,0,1,1,120,120,104,103,4
"351",50,"[26]EufmwywHnKqGocIHcJCkvadikp",234,0.995745,26,235,1,234,1,1,0,1,1,113,113,122,121,4
"352",51,"[26]EufmwywHnKqGocIHcJCkvadikp",224,0.995556,26,225,1,224,1,1,0,1,1,118,118,107,106,4
"353",52,"[26]EufmwywHnKqGocIHcJCkvadikp",235,0.995763,26,236,1,235,1,1,0,1,1,112,112,124,123,4
"354",53,"[26]EufmwywHnKqGocIHcJCkvadikp",231,0.99569,26,232,1,231,1,1,0,1,1,113,113,119,118,4
"355",54,"[26]EufmwywHnKqGocIHcJCkvadikp",228,0.995633,26,229,1,228,1,1,0,1,1,116,116,113,112,4
"356",55,"[26]EufmwywHnKqGocIHcJCkvadikp",219,0.995455,26,220,1,219,1,1,0,1,1,122,122,98,97,4
"357",56,"[26]EufmwywHnKqGocIHcJCkvadikp",232,0.995708,26,233,1,232,1,1,0,1,1,113,113,120,119,4
"358",57,"[26]EufmwywHnKqGocIHcJCkvadikp",229,0.995652,26,230,1,229,1,1,0,1,1,116,116,114,113,4
"359",58,"[26]EufmwywHnKqGocIHcJCkvadikp",227,0.995614,26,228,1,227,1,1,0,1,1,116,116,112,111,4
"360",59,"[26]EufmwywHnKqGocIHcJCkvadikp",225,0.995575,26,226,1,225,1,1,0,1,1,118,118,108,107,4
"361",60,"[26]EufmwywHnKqGocIHcJCkvadikp",224,0.995556,26,225,1,224,1,1,0,1,1,118,118,107,106,4
"362",61,"[26]EufmwywHnKqGocIHcJCkvadikp",230,0.995671,26,231,1,230,1,1,0,1,1,113,113,118,117,4
"363",62,"[26]EufmwywHnKqGocIHcJCkvadikp",223,0.995536,26,224,1,223,1,1,0,1,1,119,119,105,104,4
"364",63,"[26]EufmwywHnKqGocIHcJCkvadikp",232,0.995708,26,233,1,232,1,1,0,1,1,112,112,121,120,4
"365",64,"[26]EufmwywHnKqGocIHcJCkvadikp",241,0.995868,26,242,1,241,1,1,0,1,1,107,107,135,134,4
"366",65,"[26]EufmwywHnKqGocIHcJCkvadikp",232,0.995708,26,233,1,232,1,1,0,1,1,114,114,119,118,4
"367",66,"[26]EufmwywHnKqGocIHcJCkvadikp",227,0.995614,26,228,1,227,1,1,0,1,1,118,118,110,109,4
"368",67,"[26]EufmwywHnKqGocIHcJCkvadikp",229,0.995652,26,230,1,229,1,1,0,1,1,121,121,109,108,4
"369",68,"[26]EufmwywHnKqGocIHcJCkvadikp",237,0.995798,26,238,1,237,1,1,0,1,1,108,108,130,129,4
"370",69,"[26]EufmwywHnKqGocIHcJCkvadikp",235,0.995763,26,236,1,235,1,1,0,1,1,109,109,127,126,4
"371",70,"[26]EufmwywHnKqGocIHcJCkvadikp",219,0.995455,26,220,1,219,1,1,0,1,1,122,122,98,97,4
"372",71,"[26]EufmwywHnKqGocIHcJCkvadikp",222,0.995516,26,223,1,222,1,1,0,1,1,120,120,103,102,4
"373",72,"[26]EufmwywHnKqGocIHcJCkvadikp",234,0.995745,26,235,1,234,1,1,0,1,1,112,112,123,122,4
"374",73,"[26]EufmwywHnKqGocIHcJCkvadikp",216,0.995392,26,217,1,216,1,1,0,1,1,125,125,92,91,4
"375",74,"[26]EufmwywHnKqGocIHcJCkvadikp",230,0.995671,26,231,1,230,1,1,0,1,1,114,114,117,116,4
"376",75,"[26]EufmwywHnKqGocIHcJCkvadikp",230,0.995671,26,231,1,230,1,1,0,1,1,113,113,118,117,4
"377",76,"[26]EufmwywHnKqGocIHcJCkvadikp",228,0.995633,26,229,1,228,1,1,0,1,1,116,116,113,112,4
"378",77,"[26]EufmwywHnKqGocIHcJCkvadikp",238,0.995816,26,239,1,238,1,1,0,1,1,107,107,132,131,4
"379",78,"[26]EufmwywHnKqGocIHcJCkvadikp",227,0.995614,26,228,1,227,1,1,0,1,1,116,116,112,111,4
"380",79,"[26]EufmwywHnKqGocIHcJCkvadikp",232,0.995708,26,233,1,232,1,1,0,1,1,115,115,118,117,4
"381",80,"[26]EufmwywHnKqGocIHcJCkvadikp",229,0.995652,26,230,1,229,1,1,0,1,1,115,115,115,114,4
"382",81,"[26]EufmwywHnKqGocIHcJCkvadikp",224,0.995556,26,225,1,224,1,1,0,1,1,118,118,107,106,4
"383",82,"[26]EufmwywHnKqGocIHcJCkvadikp",214,0.995349,26,215,1,214,1,1,0,1,1,128,128,87,86,4
"384",83,"[26]EufmwywHnKqGocIHcJCkvadikp",221,0.995495,26,222,1,221,1,1,0,1,1,121,121,101,100,4
"385",84,"[26]EufmwywHnKqGocIHcJCkvadikp",219,0.995455,26,220,1,219,1,1,0,1,1,125,125,95,94,4
"386",85,"[26]EufmwywHnKqGocIHcJCkvadikp",240,0.995851,26,241,1,240,1,1,0,1,1,106,106,135,134,4
"387",86,"[26]EufmwywHnKqGocIHcJCkvadikp",235,0.995763,26,236,1,235,1,1,0,1,1,111,111,125,124,4
"388",87,"[26]EufmwywHnKqGocIHcJCkvadikp",230,0.995671,26,231,1,230,1,1,0,1,1,113,113,118,117,4
"389",88,"[26]EufmwywHnKqGocIHcJCkvadikp",214,0.995349,26,215,1,214,1,1,0,1,1,127,127,88,87,4
"390",89,"[26]EufmwywHnKqGocIHcJCkvadikp",227,0.995614,26,228,1,227,1,1,0,1,1,117,117,111,110,4
"391",90,"[26]EufmwywHnKqGocIHcJCkvadikp",226,0.995595,26,227,1,226,1,1,0,1,1,117,117,110,109,4
"392",91,"[26]EufmwywHnKqGocIHcJCkvadikp",225,0.995575,26,226,1,225,1,1,0,1,1,117,117,109,108,4
"393",92,"[26]EufmwywHnKqGocIHcJCkvadikp",238,0.995816,26,239,1,238,1,1,0,1,1,108,108,131,130,4
"394",93,"[26]EufmwywHnKqGocIHcJCkvadikp",217,0.995413,26,218,1,217,1,1,0,1,1,124,124,94,93,4
"395",94,"[26]EufmwywHnKqGocIHcJCkvadikp",228,0.995633,26,229,1,228,1,1,0,1,1,116,116,113,112,4
"396",95,"[26]EufmwywHnKqGocIHcJCkvadikp",227,0.995614,26,228,1,227,1,1,0,1,1,116,116,112,111,4
"397",96,"[26]EufmwywHnKqGocIHcJCkvadikp",224,0.995556,26,225,1,224,1,1,0,1,1,119,119,106,105,4
"398",97,"[26]EufmwywHnKqGocIHcJCkvadikp",218,0.995434,26,219,1,218,1,1,0,1,1,123,123,96,95,4
"399",98,"[26]EufmwywHnKqGocIHcJCkvadikp",230,0.995671,26,231,1,230,1,1,0,1,1,113,113,118,117,4
"400",99,"[26]EufmwywHnKqGocIHcJCkvadikp",237,0.995798,26,238,1,237,1,1,0,1,1,112,112,126,125,4
"401",0,"[27]EuDvvHnKqGocIHcJCzenxyqujdi",222,0.995516,27,223,1,222,1,1,0,1,1,121,121,102,101,5
"402",1,"[27]EuDvvHnKqGocIHcJCzenxyqujdi",236,0.995781,27,237,1,236,1,1,0,1,1,109,109,128,127,5
"403",2,"[27]EuDvvHnKqGocIHcJCzenxyqujdi",232,0.995708,27,233,1,232,1,1,0,1,1,116,116,117,116,5
"404",3,"[27]EuDvvHnKqGocIHcJCzenxyqujdi",229,0.995652,27,230,1,229,1,1,0,1,1,115,115,115,114,5
"405",4,"[27]EuDvvHnKqGocIHcJCzenxyqujdi",221,0.995495,27,222,1,221,1,1,0,1,1,121,121,101,100,5
"406",5,"[27]EuDvvHnKqGocIHcJCzenxyqujdi",231,0.99569,27,232,1,231,1,1,0,1,1,116,116,116,115,5
"407",6,"[27]EuDvvHnKqGocIHcJCzenxyqujdi",230,0.995671,27,231,1,230,1,1,0,1,1,114,114,117,116,5
"408",7,"[27]EuDvvHnKqGocIHcJCzenxyqujdi",239,0.995833,27,240,1,239,1,1,0,1,1,108,108,132,131,5
"409",8,"[27]EuDvvHnKqGocIHcJCzenxyqujdi",229,0.995652,27,230,1,229,1,1,0,1,1,115,115,115,114,5
"410",9,"[27]EuDvvHnKqGocIHcJCzenxyqujdi",232,0.995708,27,233,1,232,1,1,0,1,1,115,115,118,117,5
"411",10,"[27]EuDvvHnKqGocIHcJCzenxyqujdi",232,0.995708,27,233,1,232,1,1,0,1,1,112,112,121,120,5
"412",11,"[27]EuDvvHnKqGocIHcJCzenxyqujdi",242,0.995885,27,243,1,242,1,1,0,1,1,106,106,137,136,5
"413",12,"[27]EuDvvHnKqGocIHcJCzenxyqujdi",231,0.99569,27,232,1,231,1,1,0,1,1,114,114,118,117,5
"414",13,"[27]EuDvvHnKqGocIHcJCzenxyqujdi",232,0.995708,27,233,1,232,1,1,0,1,1,114,114,119,118,5
"415",14,"[27]EuDvvHnKqGocIHcJCzenxyqujdi",217,0.995413,27,218,1,217,1,1,0,1,1,127,127,91,90,5
"416",15,"[27]EuDvvHnKqGocIHcJCzenxyqujdi",237,0.995798,27,238,1,237,1,1,0,1,1,112,112,126,125,5
"417",16,"[27]EuDvvHnKqGocIHcJCzenxyqujdi",221,0.995495,27,222,1,221,1,1,0,1,1,121,121,101,100,5
"418",17,"[27]EuDvvHnKqGocIHcJCzenxyqujdi",233,0.995726,27,234,1,233,1,1,0,1,1,112,112,122,121,5
"419",18,"[27]EuDvvHnKqGocIHcJCzenxyqujdi",225,0.995575,27,226,1,225,1,1,0,1,1,119,119,107,106,5
"420",19,"[27]EuDvvHnKqGocIHcJCzenxyqujdi",226,0.995595,27,227,1,226,1,1,0,1,1,120,120,107,106,5
"421",20,"[27]EuDvvHnKqGocIHcJCzenxyqujdi",233,0.995726,27,234,1,233,1,1,0,1,1,114,114,120,119,5
"422",21,"[27]EuDvvHnKqGocIHcJCzenxyqujdi",230,0.995671,27,231,1,230,1,1,0,1,1,114,114,117,116,5
"423",22,"[27]EuDvvHnKqGocIHcJCzenxyqujdi",228,0.995633,27,229,1,228,1,1,0,1,1,117,117,112,111,5
"424",23,"[27]EuDvvHnKqGocIHcJCzenxyqujdi",226,0.995595,27,227,1,226,1,1,0,1,1,118,118,109,108,5
"425",24,"[27]EuDvvHnKqGocIHcJCzenxyqujdi",231,0.99569,27,232,1,231,1,1,0,1,1,113,113,119,118,5
"426",25,"[27]EuDvvHnKqGocIHcJCzenxyqujdi",221,0.995495,27,222,1,221,1,1,0,1,1,124,124,98,97,5
"427",26,"[27]EuDvvHnKqGocIHcJCzenxyqujdi",224,0.995556,27,225,1,224,1,1,0,1,1,120,120,105,104,5
"428",27,"[27]EuDvvHnKqGocIHcJCzenxyqujdi",222,0.995516,27,223,1,222,1,1,0,1,1,122,122,101,100,5
"429",28,"[27]EuDvvHnKqGocIHcJCzenxyqujdi",230,0.995671,27,231,1,230,1,1,0,1,1,114,114,117,116,5
"430",29,"[27]EuDvvHnKqGocIHcJCzenxyqujdi",223,0.995536,27,224,1,223,1,1,0,1,1,120,120,104,103,5
"431",30,"[27]EuDvvHnKqGocIHcJCzenxyqujdi",236,0.995781,27,237,1,236,1,1,0,1,1,111,111,126,125,5
"432",31,"[27]EuDvvHnKqGocIHcJCzenxyqujdi",237,0.995798,27,238,1,237,1,1,0,1,1,110,110,128,127,5
"433",32,"[27]EuDvvHnKqGocIHcJCzenxyqujdi",234,0.995745,27,235,1,234,1,1,0,1,1,111,111,124,123,5
"434",33,"[27]EuDvvHnKqGocIHcJCzenxyqujdi",236,0.995781,27,237,1,236,1,1,0,1,1,109,109,128,127,5
"435",34,"[27]EuDvvHnKqGocIHcJCzenxyqujdi",229,0.995652,27,230,1,229,1,1,0,1,1,115,115,115,114,5
"436",35,"[27]EuDvvHnKqGocIHcJCzenxyqujdi",231,0.99569,27,232,1,231,1,1,0,1,1,117,117,115,114,5
"437",36,"[27]EuDvvHnKqGocIHcJCzenxyqujdi",226,0.995595,27,227,1,226,1,1,0,1,1,117,117,110,109,5
"438",37,"[27]EuDvvHnKqGocIHcJCzenxyqujdi",227,0.995614,27,228,1,227,1,1,0,1,1,116,116,112,111,5
"439",38,"[27]EuDvvHnKqGocIHcJCzenxyqujdi",224,0.995556,27,225,1,224,1,1,0,1,1,120,120,105,104,5
"440",39,"[27]EuDvvHnKqGocIHcJCzenxyqujdi",229,0.995652,27,230,1,229,1,1,0,1,1,115,115,115,114,5
"441",40,"[27]EuDvvHnKqGocIHcJCzenxyqujdi",217,0.995413,27,218,1,217,1,1,0,1,1,125,125,93,92,5
"442",41,"[27]EuDvvHnKqGocIHcJCzenxyqujdi",228,0.995633,27,229,1,228,1,1,0,1,1,117,117,112,111,5
"443",42,"[27]EuDvvHnKqGocIHcJCzenxyqujdi",231,0.99569,27,232,1,231,1,1,0,1,1,113,113,119,118,5
"444",43,"[27]EuDvvHnKqGocIHcJCzenxyqujdi",224,0.995556,27,225,1,224,1,1,0,1,1,121,121,104,103,5
"445",44,"[27]EuDvvHnKqGocIHcJCzenxyqujdi",231,0.99569,27,232,1,231,1,1,0,1,1,114,114,118,117,5
"446",45,"[27]EuDvvHnKqGocIHcJCzenxyqujdi",230,0.995671,27,231,1,230,1,1,0,1,1,115,115,116,115,5
"447",46,"[27]EuDvvHnKqGocIHcJCzenxyqujdi",240,0.995851,27,241,1,240,1,1,0,1,1,106,106,135,134,5
"448",47,"[27]EuDvvHnKqGocIHcJCzenxyqujdi",224,0.995556,27,225,1,224,1,1,0,1,1,120,120,105,104,5
"449",48,"[27]EuDvvHnKqGocIHcJCzenxyqujdi",232,0.995708,27,233,1,232,1,1,0,1,1,113,113,120,119,5
"450",49,"[27]EuDvvHnKqGocIHcJCzenxyqujdi",236,0.995781,27,237,1,236,1,1,0,1,1,110,110,127,126,5
"451",50,"[27]EuDvvHnKqGocIHcJCzenxyqujdi",229,0.995652,27,230,1,229,1,1,0,1,1,116,116,114,113,5
"452",51,"[27]EuDvvHnKqGocIHcJCzenxyqujdi",235,0.995763,27,236,1,235,1,1,0,1,1,112,112,124,123,5
"453",52,"[27]EuDvvHnKqGocIHcJCzenxyqujdi",223,0.995536,27,224,1,223,1,1,0,1,1,120,120,104,103,5
"454",53,"[27]EuDvvHnKqGocIHcJCzenxyqujdi",232,0.995708,27,233,1,232,1,1,0,1,1,114,114,119,118,5
"455",54,"[27]EuDvvHnKqGocIHcJCzenxyqujdi",238,0.995816,27,239,1,238,1,1,0,1,1,111,111,128,127,5
"456",55,"[27]EuDvvHnKqGocIHcJCzenxyqujdi",226,0.995595,27,227,1,226,1,1,0,1,1,118,118,109,108,5
"457",56,"[27]EuDvvHnKqGocIHcJCzenxyqujdi",235,0.995763,27,236,1,235,1,1,0,1,1,111,111,125,124,5
"458",57,"[27]EuDvvHnKqGocIHcJCzenxyqujdi",222,0.995516,27,223,1,222,1,1,0,1,1,121,121,102,101,5
"459",58,"[27]EuDvvHnKqGocIHcJCzenxyqujdi",230,0.995671,27,231,1,230,1,1,0,1,1,115,115,116,115,5
"460",59,"[27]EuDvvHnKqGocIHcJCzenxyqujdi",241,0.995868,27,242,1,241,1,1,0,1,1,106,106,136,135,5
"461",60,"[27]EuDvvHnKqGocIHcJCzenxyqujdi",238,0.995816,27,239,1,238,1,1,0,1,1,108,108,131,130,5
"462",61,"[27]EuDvvHnKqGocIHcJCzenxyqujdi",225,0.995575,27,226,1,225,1,1,0,1,1,118,118,108,107,5
"463",62,"[27]EuDvvHnKqGocIHcJCzenxyqujdi",230,0.995671,27,231,1,230,1,1,0,1,1,114,114,117,116,5
"464",63,"[27]EuDvvHnKqGocIHcJCzenxyqujdi",227,0.995614,27,228,1,227,1,1,0,1,1,118,118,110,109,5
"465",64,"[27]EuDvvHnKqGocIHcJCzenxyqujdi",230,0.995671,27,231,1,230,1,1,0,1,1,114,114,117,116,5
"466",65,"[27]EuDvvHnKqGocIHcJCzenxyqujdi",231,0.99569,27,232,1,231,1,1,0,1,1,115,115,117,116,5
"467",66,"[27]EuDvvHnKqGocIHcJCzenxyqujdi",226,0.995595,27,227,1,226,1,1,0,1,1,118,118,109,108,5
"468",67,"[27]EuDvvHnKqGocIHcJCzenxyqujdi",234,0.995745,27,235,1,234,1,1,0,1,1,113,113,122,121,5
"469",68,"[27]EuDvvHnKqGocIHcJCzenxyqujdi",232,0.995708,27,233,1,232,1,1,0,1,1,114,114,119,118,5
"470",69,"[27]EuDvvHnKqGocIHcJCzenxyqujdi",224,0.995556,27,225,1,224,1,1,0,1,1,119,119,106,105,5
"471",70,"[27]EuDvvHnKqGocIHcJCzenxyqujdi",233,0.995726,27,234,1,233,1,1,0,1,1,112,112,122,121,5
"472",71,"[27]EuDvvHnKqGocIHcJCzenxyqujdi",228,0.995633,27,229,1,228,1,1,0,1,1,118,118,111,110,5
"473",72,"[27]EuDvvHnKqGocIHcJCzenxyqujdi",245,0.995935,27,246,1,245,1,1,0,1,1,103,103,143,142,5
"474",73,"[27]EuDvvHnKqGocIHcJCzenxyqujdi",227,0.995614,27,228,1,227,1,1,0,1,1,119,119,109,108,5
"475",74,"[27]EuDvvHnKqGocIHcJCzenxyqujdi",227,0.995614,27,228,1,227,1,1,0,1,1,116,116,112,111,5
"476",75,"[27]EuDvvHnKqGocIHcJCzenxyqujdi",220,0.995475,27,221,1,220,1,1,0,1,1,123,123,98,97,5
"477",76,"[27]EuDvvHnKqGocIHcJCzenxyqujdi",228,0.995633,27,229,1,228,1,1,0,1,1,117,117,112,111,5
"478",77,"[27]EuDvvHnKqGocIHcJCzenxyqujdi",224,0.995556,27,225,1,224,1,1,0,1,1,120,120,105,104,5
"479",78,"[27]EuDvvHnKqGocIHcJCzenxyqujdi",225,0.995575,27,226,1,225,1,1,0,1,1,118,118,108,107,5
"480",79,"[27]EuDvvHnKqGocIHcJCzenxyqujdi",230,0.995671,27,231,1,230,1,1,0,1,1,115,115,116,115,5
"481",80,"[27]EuDvvHnKqGocIHcJCzenxyqujdi",227,0.995614,27,228,1,227,1,1,0,1,1,116,116,112,111,5
"482",81,"[27]EuDvvHnKqGocIHcJCzenxyqujdi",231,0.99569,27,232,1,231,1,1,0,1,1,113,113,119,118,5
"483",82,"[27]EuDvvHnKqGocIHcJCzenxyqujdi",233,0.995726,27,234,1,233,1,1,0,1,1,112,112,122,121,5
"484",83,"[27]EuDvvHnKqGocIHcJCzenxyqujdi",238,0.995816,27,239,1,238,1,1,0,1,1,109,109,130,129,5
"485",84,"[27]EuDvvHnKqGocIHcJCzenxyqujdi",237,0.995798,27,238,1,237,1,1,0,1,1,113,113,125,124,5
"486",85,"[27]EuDvvHnKqGocIHcJCzenxyqujdi",228,0.995633,27,229,1,228,1,1,0,1,1,116,116,113,112,5
"487",86,"[27]EuDvvHnKqGocIHcJCzenxyqujdi",226,0.995595,27,227,1,226,1,1,0,1,1,118,118,109,108,5
"488",87,"[27]EuDvvHnKqGocIHcJCzenxyqujdi",234,0.995745,27,235,1,234,1,1,0,1,1,111,111,124,123,5
"489",88,"[27]EuDvvHnKqGocIHcJCzenxyqujdi",231,0.99569,27,232,1,231,1,1,0,1,1,116,116,116,115,5
"490",89,"[27]EuDvvHnKqGocIHcJCzenxyqujdi",234,0.995745,27,235,1,234,1,1,0,1,1,113,113,122,121,5
"491",90,"[27]EuDvvHnKqGocIHcJCzenxyqujdi",224,0.995556,27,225,1,224,1,1,0,1,1,120,120,105,104,5
"492",91,"[27]EuDvvHnKqGocIHcJCzenxyqujdi",233,0.995726,27,234,1,233,1,1,0,1,1,112,112,122,121,5
"493",92,"[27]EuDvvHnKqGocIHcJCzenxyqujdi",238,0.995816,27,239,1,238,1,1,0,1,1,109,109,130,129,5
"494",93,"[27]EuDvvHnKqGocIHcJCzenxyqujdi",227,0.995614,27,228,1,227,1,1,0,1,1,117,117,111,110,5
"495",94,"[27]EuDvvHnKqGocIHcJCzenxyqujdi",235,0.995763,27,236,1,235,1,1,0,1,1,112,112,124,123,5
"496",95,"[27]EuDvvHnKqGocIHcJCzenxyqujdi",216,0.995392,27,217,1,216,1,1,0,1,1,125,125,92,91,5
"497",96,"[27]EuDvvHnKqGocIHcJCzenxyqujdi",228,0.995633,27,229,1,228,1,1,0,1,1,117,117,112,111,5
"498",97,"[27]EuDvvHnKqGocIHcJCzenxyqujdi",232,0.995708,27,233,1,232,1,1,0,1,1,114,114,119,118,5
"499",98,"[27]EuDvvHnKqGocIHcJCzenxyqujdi",234,0.995745,27,235,1,234,1,1,0,1,1,111,111,124,123,5
"500",99,"[27]EuDvvHnKqGocIHcJCzenxyqujdi",241,0.995868,27,242,1,241,1,1,0,1,1,105,105,137,136,5
"501",0,"[34]EDmGiuuHnKqGocIHcJCwhvtwIbtnvkeevn",223,0.995536,34,224,1,223,1,1,0,1,1,122,122,102,101,6
"502",1,"[34]EDmGiuuHnKqGocIHcJCwhvtwIbtnvkeevn",241,0.995868,34,242,1,241,1,1,0,1,1,105,105,137,136,6
"503",2,"[34]EDmGiuuHnKqGocIHcJCwhvtwIbtnvkeevn",228,0.995633,34,229,1,228,1,1,0,1,1,116,116,113,112,6
"504",3,"[34]EDmGiuuHnKqGocIHcJCwhvtwIbtnvkeevn",238,0.995816,34,239,1,238,1,1,0,1,1,109,109,130,129,6
"505",4,"[34]EDmGiuuHnKqGocIHcJCwhvtwIbtnvkeevn",230,0.995671,34,231,1,230,1,1,0,1,1,114,114,117,116,6
"506",5,"[34]EDmGiuuHnKqGocIHcJCwhvtwIbtnvkeevn",231,0.99569,34,232,1,231,1,1,0,1,1,114,114,118,117,6
"507",6,"[34]EDmGiuuHnKqGocIHcJCwhvtwIbtnvkeevn",226,0.995595,34,227,1,226,1,1,0,1,1,119,119,108,107,6
"508",7,"[34]EDmGiuuHnKqGocIHcJCwhvtwIbtnvkeevn",235,0.995763,34,236,1,235,1,1,0,1,1,111,111,125,124,6
"509",8,"[34]EDmGiuuHnKqGocIHcJCwhvtwIbtnvkeevn",234,0.995745,34,235,1,234,1,1,0,1,1,111,111,124,123,6
"510",9,"[34]EDmGiuuHnKqGocIHcJCwhvtwIbtnvkeevn",224,0.995556,34,225,1,224,1,1,0,1,1,118,118,107,106,6
"511",10,"[34]EDmGiuuHnKqGocIHcJCwhvtwIbtnvkeevn",231,0.99569,34,232,1,231,1,1,0,1,1,114,114,118,117,6
"512",11,"[34]EDmGiuuHnKqGocIHcJCwhvtwIbtnvkeevn",224,0.995556,34,225,1,224,1,1,0,1,1,118,118,107,106,6
"513",12,"[34]EDmGiuuHnKqGocIHcJCwhvtwIbtnvkeevn",231,0.99569,34,232,1,231,1,1,0,1,1,114,114,118,117,6
"514",13,"[34]EDmGiuuHnKqGocIHcJCwhvtwIbtnvkeevn",224,0.995556,34,225,1,224,1,1,0,1,1,120,120,105,104,6
"515",14,"[34]EDmGiuuHnKqGocIHcJCwhvtwIbtnvkeevn",238,0.995816,34,239,1,238,1,1,0,1,1,108,108,131,130,6
"516",15,"[34]EDmGiuuHnKqGocIHcJCwhvtwIbtnvkeevn",230,0.995671,34,231,1,230,1,1,0,1,1,114,114,117,116,6
"517",16,"[34]EDmGiuuHnKqGocIHcJCwhvtwIbtnvkeevn",231,0.99569,34,232,1,231,1,1,0,1,1,114,114,118,117,6
"518",17,"[34]EDmGiuuHnKqGocIHcJCwhvtwIbtnvkeevn",234,0.995745,34,235,1,234,1,1,0,1,1,110,110,125,124,6
"519",18,"[34]EDmGiuuHnKqGocIHcJCwhvtwIbtnvkeevn",235,0.995763,34,236,1,235,1,1,0,1,1,112,112,124,123,6
"520",19,"[34]EDmGiuuHnKqGocIHcJCwhvtwIbtnvkeevn",216,0.995392,34,217,1,216,1,1,0,1,1,126,126,91,90,6
"521",20,"[34]EDmGiuuHnKqGocIHcJCwhvtwIbtnvkeevn",232,0.995708,34,233,1,232,1,1,0,1,1,115,115,118,117,6
"522",21,"[34]EDmGiuuHnKqGocIHcJCwhvtwIbtnvkeevn",225,0.995575,34,226,1,225,1,1,0,1,1,118,118,108,107,6
"523",22,"[34]EDmGiuuHnKqGocIHcJCwhvtwIbtnvkeevn",223,0.995536,34,224,1,223,1,1,0,1,1,121,121,103,102,6
"524",23,"[34]EDmGiuuHnKqGocIHcJCwhvtwIbtnvkeevn",228,0.995633,34,229,1,228,1,1,0,1,1,116,116,113,112,6
"525",24,"[34]EDmGiuuHnKqGocIHcJCwhvtwIbtnvkeevn",237,0.995798,34,238,1,237,1,1,0,1,1,108,108,130,129,6
"526",25,"[34]EDmGiuuHnKqGocIHcJCwhvtwIbtnvkeevn",244,0.995918,34,245,1,244,1,1,0,1,1,105,105,140,139,6
"527",26,"[34]EDmGiuuHnKqGocIHcJCwhvtwIbtnvkeevn",223,0.995536,34,224,1,223,1,1,0,1,1,119,119,105,104,6
"528",27,"[34]EDmGiuuHnKqGocIHcJCwhvtwIbtnvkeevn",224,0.995556,34,225,1,224,1,1,0,1,1,119,119,106,105,6
"529",28,"[34]EDmGiuuHnKqGocIHcJCwhvtwIbtnvkeevn",231,0.99569,34,232,1,231,1,1,0,1,1,113,113,119,118,6
"530",29,"[34]EDmGiuuHnKqGocIHcJCwhvtwIbtnvkeevn",226,0.995595,34,227,1,226,1,1,0,1,1,118,118,109,108,6
"531",30,"[34]EDmGiuuHnKqGocIHcJCwhvtwIbtnvkeevn",248,0.995984,34,249,1,248,1,1,0,1,1,103,103,146,145,6
"532",31,"[34]EDmGiuuHnKqGocIHcJCwhvtwIbtnvkeevn",234,0.995745,34,235,1,234,1,1,0,1,1,110,110,125,124,6
"533",32,"[34]EDmGiuuHnKqGocIHcJCwhvtwIbtnvkeevn",226,0.995595,34,227,1,226,1,1,0,1,1,118,118,109,108,6
"534",33,"[34]EDmGiuuHnKqGocIHcJCwhvtwIbtnvkeevn",226,0.995595,34,227,1,226,1,1,0,1,1,118,118,109,108,6
"535",34,"[34]EDmGiuuHnKqGocIHcJCwhvtwIbtnvkeevn",232,0.995708,34,233,1,232,1,1,0,1,1,113,113,120,119,6
"536",35,"[34]EDmGiuuHnKqGocIHcJCwhvtwIbtnvkeevn",227,0.995614,34,228,1,227,1,1,0,1,1,116,116,112,111,6
"537",36,"[34]EDmGiuuHnKqGocIHcJCwhvtwIbtnvkeevn",231,0.99569,34,232,1,231,1,1,0,1,1,114,114,118,117,6
"538",37,"[34]EDmGiuuHnKqGocIHcJCwhvtwIbtnvkeevn",228,0.995633,34,229,1,228,1,1,0,1,1,118,118,111,110,6
"539",38,"[34]EDmGiuuHnKqGocIHcJCwhvtwIbtnvkeevn",228,0.995633,34,229,1,228,1,1,0,1,1,115,115,114,113,6
"540",39,"[34]EDmGiuuHnKqGocIHcJCwhvtwIbtnvkeevn",230,0.995671,34,231,1,230,1,1,0,1,1,114,114,117,116,6
"541",40,"[34]EDmGiuuHnKqGocIHcJCwhvtwIbtnvkeevn",227,0.995614,34,228,1,227,1,1,0,1,1,117,117,111,110,6
"542",41,"[34]EDmGiuuHnKqGocIHcJCwhvtwIbtnvkeevn",237,0.995798,34,238,1,237,1,1,0,1,1,112,112,126,125,6
"543",42,"[34]EDmGiuuHnKqGocIHcJCwhvtwIbtnvkeevn",222,0.995516,34,223,1,222,1,1,0,1,1,122,122,101,100,6
"544",43,"[34]EDmGiuuHnKqGocIHcJCwhvtwIbtnvkeevn",230,0.995671,34,231,1,230,1,1,0,1,1,117,117,114,113,6
"545",44,"[34]EDmGiuuHnKqGocIHcJCwhvtwIbtnvkeevn",232,0.995708,34,233,1,232,1,1,0,1,1,114,114,119,118,6
"546",45,"[34]EDmGiuuHnKqGocIHcJCwhvtwIbtnvkeevn",226,0.995595,34,227,1,226,1,1,0,1,1,117,117,110,109,6
"547",46,"[34]EDmGiuuHnKqGocIHcJCwhvtwIbtnvkeevn",228,0.995633,34,229,1,228,1,1,0,1,1,116,116,113,112,6
"548",47,"[34]EDmGiuuHnKqGocIHcJCwhvtwIbtnvkeevn",233,0.995726,34,234,1,233,1,1,0,1,1,111,111,123,122,6
"549",48,"[34]EDmGiuuHnKqGocIHcJCwhvtwIbtnvkeevn",220,0.995475,34,221,1,220,1,1,0,1,1,122,122,99,98,6
"550",49,"[34]EDmGiuuHnKqGocIHcJCwhvtwIbtnvkeevn",236,0.995781,34,237,1,236,1,1,0,1,1,110,110,127,126,6
"551",50,"[34]EDmGiuuHnKqGocIHcJCwhvtwIbtnvkeevn",227,0.995614,34,228,1,227,1,1,0,1,1,116,116,112,111,6
"552",51,"[34]EDmGiuuHnKqGocIHcJCwhvtwIbtnvkeevn",228,0.995633,34,229,1,228,1,1,0,1,1,117,117,112,111,6
"553",52,"[34]EDmGiuuHnKqGocIHcJCwhvtwIbtnvkeevn",237,0.995798,34,238,1,237,1,1,0,1,1,108,108,130,129,6
"554",53,"[34]EDmGiuuHnKqGocIHcJCwhvtwIbtnvkeevn",222,0.995516,34,223,1,222,1,1,0,1,1,121,121,102,101,6
"555",54,"[34]EDmGiuuHnKqGocIHcJCwhvtwIbtnvkeevn",220,0.995475,34,221,1,220,1,1,0,1,1,122,122,99,98,6
"556",55,"[34]EDmGiuuHnKqGocIHcJCwhvtwIbtnvkeevn",236,0.995781,34,237,1,236,1,1,0,1,1,112,112,125,124,6
"557",56,"[34]EDmGiuuHnKqGocIHcJCwhvtwIbtnvkeevn",227,0.995614,34,228,1,227,1,1,0,1,1,116,116,112,111,6
"558",57,"[34]EDmGiuuHnKqGocIHcJCwhvtwIbtnvkeevn",223,0.995536,34,224,1,223,1,1,0,1,1,120,120,104,103,6
"559",58,"[34]EDmGiuuHnKqGocIHcJCwhvtwIbtnvkeevn",219,0.995455,34,220,1,219,1,1,0,1,1,124,124,96,95,6
"560",59,"[34]EDmGiuuHnKqGocIHcJCwhvtwIbtnvkeevn",229,0.995652,34,230,1,229,1,1,0,1,1,115,115,115,114,6
"561",60,"[34]EDmGiuuHnKqGocIHcJCwhvtwIbtnvkeevn",239,0.995833,34,240,1,239,1,1,0,1,1,106,106,134,133,6
"562",61,"[34]EDmGiuuHnKqGocIHcJCwhvtwIbtnvkeevn",228,0.995633,34,229,1,228,1,1,0,1,1,116,116,113,112,6
"563",62,"[34]EDmGiuuHnKqGocIHcJCwhvtwIbtnvkeevn",222,0.995516,34,223,1,222,1,1,0,1,1,120,120,103,102,6
"564",63,"[34]EDmGiuuHnKqGocIHcJCwhvtwIbtnvkeevn",227,0.995614,34,228,1,227,1,1,0,1,1,116,116,112,111,6
"565",64,"[34]EDmGiuuHnKqGocIHcJCwhvtwIbtnvkeevn",229,0.995652,34,230,1,229,1,1,0,1,1,116,116,114,113,6
"566",65,"[34]EDmGiuuHnKqGocIHcJCwhvtwIbtnvkeevn",228,0.995633,34,229,1,228,1,1,0,1,1,116,116,113,112,6
"567",66,"[34]EDmGiuuHnKqGocIHcJCwhvtwIbtnvkeevn",221,0.995495,34,222,1,221,1,1,0,1,1,121,121,101,100,6
"568",67,"[34]EDmGiuuHnKqGocIHcJCwhvtwIbtnvkeevn",237,0.995798,34,238,1,237,1,1,0,1,1,108,108,130,129,6
"569",68,"[34]EDmGiuuHnKqGocIHcJCwhvtwIbtnvkeevn",227,0.995614,34,228,1,227,1,1,0,1,1,116,116,112,111,6
"570",69,"[34]EDmGiuuHnKqGocIHcJCwhvtwIbtnvkeevn",244,0.995918,34,245,1,244,1,1,0,1,1,102,102,143,142,6
"571",70,"[34]EDmGiuuHnKqGocIHcJCwhvtwIbtnvkeevn",230,0.995671,34,231,1,230,1,1,0,1,1,115,115,116,115,6
"572",71,"[34]EDmGiuuHnKqGocIHcJCwhvtwIbtnvkeevn",232,0.995708,34,233,1,232,1,1,0,1,1,115,115,118,117,6
"573",72,"[34]EDmGiuuHnKqGocIHcJCwhvtwIbtnvkeevn",218,0.995434,34,219,1,218,1,1,0,1,1,124,124,95,94,6
"574",73,"[34]EDmGiuuHnKqGocIHcJCwhvtwIbtnvkeevn",223,0.995536,34,224,1,223,1,1,0,1,1,120,120,104,103,6
"575",74,"[34]EDmGiuuHnKqGocIHcJCwhvtwIbtnvkeevn",225,0.995575,34,226,1,225,1,1,0,1,1,118,118,108,107,6
"576",75,"[34]EDmGiuuHnKqGocIHcJCwhvtwIbtnvkeevn",241,0.995868,34,242,1,241,1,1,0,1,1,106,106,136,135,6
"577",76,"[34]EDmGiuuHnKqGocIHcJCwhvtwIbtnvkeevn",227,0.995614,34,228,1,227,1,1,0,1,1,117,117,111,110,6
"578",77,"[34]EDmGiuuHnKqGocIHcJCwhvtwIbtnvkeevn",233,0.995726,34,234,1,233,1,1,0,1,1,111,111,123,122,6
"579",78,"[34]EDmGiuuHnKqGocIHcJCwhvtwIbtnvkeevn",237,0.995798,34,238,1,237,1,1,0,1,1,112,112,126,125,6
"580",79,"[34]EDmGiuuHnKqGocIHcJCwhvtwIbtnvkeevn",233,0.995726,34,234,1,233,1,1,0,1,1,111,111,123,122,6
"581",80,"[34]EDmGiuuHnKqGocIHcJCwhvtwIbtnvkeevn",221,0.995495,34,222,1,221,1,1,0,1,1,121,121,101,100,6
"582",81,"[34]EDmGiuuHnKqGocIHcJCwhvtwIbtnvkeevn",231,0.99569,34,232,1,231,1,1,0,1,1,114,114,118,117,6
"583",82,"[34]EDmGiuuHnKqGocIHcJCwhvtwIbtnvkeevn",227,0.995614,34,228,1,227,1,1,0,1,1,117,117,111,110,6
"584",83,"[34]EDmGiuuHnKqGocIHcJCwhvtwIbtnvkeevn",226,0.995595,34,227,1,226,1,1,0,1,1,117,117,110,109,6
"585",84,"[34]EDmGiuuHnKqGocIHcJCwhvtwIbtnvkeevn",238,0.995816,34,239,1,238,1,1,0,1,1,107,107,132,131,6
"586",85,"[34]EDmGiuuHnKqGocIHcJCwhvtwIbtnvkeevn",229,0.995652,34,230,1,229,1,1,0,1,1,115,115,115,114,6
"587",86,"[34]EDmGiuuHnKqGocIHcJCwhvtwIbtnvkeevn",228,0.995633,34,229,1,228,1,1,0,1,1,116,116,113,112,6
"588",87,"[34]EDmGiuuHnKqGocIHcJCwhvtwIbtnvkeevn",229,0.995652,34,230,1,229,1,1,0,1,1,115,115,115,114,6
"589",88,"[34]EDmGiuuHnKqGocIHcJCwhvtwIbtnvkeevn",221,0.995495,34,222,1,221,1,1,0,1,1,123,123,99,98,6
"590",89,"[34]EDmGiuuHnKqGocIHcJCwhvtwIbtnvkeevn",225,0.995575,34,226,1,225,1,1,0,1,1,119,119,107,106,6
"591",90,"[34]EDmGiuuHnKqGocIHcJCwhvtwIbtnvkeevn",227,0.995614,34,228,1,227,1,1,0,1,1,119,119,109,108,6
"592",91,"[34]EDmGiuuHnKqGocIHcJCwhvtwIbtnvkeevn",221,0.995495,34,222,1,221,1,1,0,1,1,121,121,101,100,6
"593",92,"[34]EDmGiuuHnKqGocIHcJCwhvtwIbtnvkeevn",232,0.995708,34,233,1,232,1,1,0,1,1,112,112,121,120,6
"594",93,"[34]EDmGiuuHnKqGocIHcJCwhvtwIbtnvkeevn",237,0.995798,34,238,1,237,1,1,0,1,1,109,109,129,128,6
"595",94,"[34]EDmGiuuHnKqGocIHcJCwhvtwIbtnvkeevn",231,0.99569,34,232,1,231,1,1,0,1,1,114,114,118,117,6
"596",95,"[34]EDmGiuuHnKqGocIHcJCwhvtwIbtnvkeevn",225,0.995575,34,226,1,225,1,1,0,1,1,118,118,108,107,6
"597",96,"[34]EDmGiuuHnKqGocIHcJCwhvtwIbtnvkeevn",220,0.995475,34,221,1,220,1,1,0,1,1,122,122,99,98,6
"598",97,"[34]EDmGiuuHnKqGocIHcJCwhvtwIbtnvkeevn",234,0.995745,34,235,1,234,1,1,0,1,1,112,112,123,122,6
"599",98,"[34]EDmGiuuHnKqGocIHcJCwhvtwIbtnvkeevn",214,0.995349,34,215,1,214,1,1,0,1,1,128,128,87,86,6
"600",99,"[34]EDmGiuuHnKqGocIHcJCwhvtwIbtnvkeevn",228,0.995633,34,229,1,228,1,1,0,1,1,115,115,114,113,6
"601",0,"[29]EaFtHnKqGocIHcJCAxEgIwtxlfAxe",223,0.995536,29,224,1,223,1,1,0,1,1,121,121,103,102,7
"602",1,"[29]EaFtHnKqGocIHcJCAxEgIwtxlfAxe",228,0.995633,29,229,1,228,1,1,0,1,1,116,116,113,112,7
"603",2,"[29]EaFtHnKqGocIHcJCAxEgIwtxlfAxe",231,0.99569,29,232,1,231,1,1,0,1,1,115,115,117,116,7
"604",3,"[29]EaFtHnKqGocIHcJCAxEgIwtxlfAxe",225,0.995575,29,226,1,225,1,1,0,1,1,119,119,107,106,7
"605",4,"[29]EaFtHnKqGocIHcJCAxEgIwtxlfAxe",240,0.995851,29,241,1,240,1,1,0,1,1,107,107,134,133,7
"606",5,"[29]EaFtHnKqGocIHcJCAxEgIwtxlfAxe",223,0.995536,29,224,1,223,1,1,0,1,1,120,120,104,103,7
"607",6,"[29]EaFtHnKqGocIHcJCAxEgIwtxlfAxe",222,0.995516,29,223,1,222,1,1,0,1,1,122,122,101,100,7
"608",7,"[29]EaFtHnKqGocIHcJCAxEgIwtxlfAxe",222,0.995516,29,223,1,222,1,1,0,1,1,122,122,101,100,7
"609",8,"[29]EaFtHnKqGocIHcJCAxEgIwtxlfAxe",238,0.995816,29,239,1,238,1,1,0,1,1,108,108,131,130,7
"610",9,"[29]EaFtHnKqGocIHcJCAxEgIwtxlfAxe",240,0.995851,29,241,1,240,1,1,0,1,1,112,112,129,128,7
"611",10,"[29]EaFtHnKqGocIHcJCAxEgIwtxlfAxe",225,0.995575,29,226,1,225,1,1,0,1,1,118,118,108,107,7
"612",11,"[29]EaFtHnKqGocIHcJCAxEgIwtxlfAxe",230,0.995671,29,231,1,230,1,1,0,1,1,115,115,116,115,7
"613",12,"[29]EaFtHnKqGocIHcJCAxEgIwtxlfAxe",226,0.995595,29,227,1,226,1,1,0,1,1,117,117,110,109,7
"614",13,"[29]EaFtHnKqGocIHcJCAxEgIwtxlfAxe",231,0.99569,29,232,1,231,1,1,0,1,1,114,114,118,117,7
"615",14,"[29]EaFtHnKqGocIHcJCAxEgIwtxlfAxe",225,0.995575,29,226,1,225,1,1,0,1,1,118,118,108,107,7
"616",15,"[29]EaFtHnKqGocIHcJCAxEgIwtxlfAxe",221,0.995495,29,222,1,221,1,1,0,1,1,122,122,100,99,7
"617",16,"[29]EaFtHnKqGocIHcJCAxEgIwtxlfAxe",234,0.995745,29,235,1,234,1,1,0,1,1,112,112,123,122,7
"618",17,"[29]EaFtHnKqGocIHcJCAxEgIwtxlfAxe",225,0.995575,29,226,1,225,1,1,0,1,1,118,118,108,107,7
"619",18,"[29]EaFtHnKqGocIHcJCAxEgIwtxlfAxe",234,0.995745,29,235,1,234,1,1,0,1,1,112,112,123,122,7
"620",19,"[29]EaFtHnKqGocIHcJCAxEgIwtxlfAxe",225,0.995575,29,226,1,225,1,1,0,1,1,119,119,107,106,7
"621",20,"[29]EaFtHnKqGocIHcJCAxEgIwtxlfAxe",227,0.995614,29,228,1,227,1,1,0,1,1,119,119,109,108,7
"622",21,"[29]EaFtHnKqGocIHcJCAxEgIwtxlfAxe",229,0.995652,29,230,1,229,1,1,0,1,1,116,116,114,113,7
"623",22,"[29]EaFtHnKqGocIHcJCAxEgIwtxlfAxe",220,0.995475,29,221,1,220,1,1,0,1,1,123,123,98,97,7
"624",23,"[29]EaFtHnKqGocIHcJCAxEgIwtxlfAxe",241,0.995868,29,242,1,241,1,1,0,1,1,106,106,136,135,7
"625",24,"[29]EaFtHnKqGocIHcJCAxEgIwtxlfAxe",231,0.99569,29,232,1,231,1,1,0,1,1,114,114,118,117,7
"626",25,"[29]EaFtHnKqGocIHcJCAxEgIwtxlfAxe",240,0.995851,29,241,1,240,1,1,0,1,1,107,107,134,133,7
"627",26,"[29]EaFtHnKqGocIHcJCAxEgIwtxlfAxe",236,0.995781,29,237,1,236,1,1,0,1,1,110,110,127,126,7
"628",27,"[29]EaFtHnKqGocIHcJCAxEgIwtxlfAxe",223,0.995536,29,224,1,223,1,1,0,1,1,121,121,103,102,7
"629",28,"[29]EaFtHnKqGocIHcJCAxEgIwtxlfAxe",232,0.995708,29,233,1,232,1,1,0,1,1,114,114,119,118,7
"630",29,"[29]EaFtHnKqGocIHcJCAxEgIwtxlfAxe",238,0.995816,29,239,1,238,1,1,0,1,1,108,108,131,130,7
"631",30,"[29]EaFtHnKqGocIHcJCAxEgIwtxlfAxe",235,0.995763,29,236,1,235,1,1,0,1,1,110,110,126,125,7
"632",31,"[29]EaFtHnKqGocIHcJCAxEgIwtxlfAxe",219,0.995455,29,220,1,219,1,1,0,1,1,124,124,96,95,7
"633",32,"[29]EaFtHnKqGocIHcJCAxEgIwtxlfAxe",234,0.995745,29,235,1,234,1,1,0,1,1,112,112,123,122,7
"634",33,"[29]EaFtHnKqGocIHcJCAxEgIwtxlfAxe",231,0.99569,29,232,1,231,1,1,0,1,1,113,113,119,118,7
"635",34,"[29]EaFtHnKqGocIHcJCAxEgIwtxlfAxe",245,0.995935,29,246,1,245,1,1,0,1,1,105,105,141,140,7
"636",35,"[29]EaFtHnKqGocIHcJCAxEgIwtxlfAxe",234,0.995745,29,235,1,234,1,1,0,1,1,112,112,123,122,7
"637",36,"[29]EaFtHnKqGocIHcJCAxEgIwtxlfAxe",229,0.995652,29,230,1,229,1,1,0,1,1,115,115,115,114,7
"638",37,"[29]EaFtHnKqGocIHcJCAxEgIwtxlfAxe",239,0.995833,29,240,1,239,1,1,0,1,1,108,108,132,131,7
"639",38,"[29]EaFtHnKqGocIHcJCAxEgIwtxlfAxe",234,0.995745,29,235,1,234,1,1,0,1,1,111,111,124,123,7
"640",39,"[29]EaFtHnKqGocIHcJCAxEgIwtxlfAxe",241,0.995868,29,242,1,241,1,1,0,1,1,106,106,136,135,7
"641",40,"[29]EaFtHnKqGocIHcJCAxEgIwtxlfAxe",228,0.995633,29,229,1,228,1,1,0,1,1,116,116,113,112,7
"642",41,"[29]EaFtHnKqGocIHcJCAxEgIwtxlfAxe",230,0.995671,29,231,1,230,1,1,0,1,1,116,116,115,114,7
"643",42,"[29]EaFtHnKqGocIHcJCAxEgIwtxlfAxe",240,0.995851,29,241,1,240,1,1,0,1,1,106,106,135,134,7
"644",43,"[29]EaFtHnKqGocIHcJCAxEgIwtxlfAxe",224,0.995556,29,225,1,224,1,1,0,1,1,120,120,105,104,7
"645",44,"[29]EaFtHnKqGocIHcJCAxEgIwtxlfAxe",234,0.995745,29,235,1,234,1,1,0,1,1,112,112,123,122,7
"646",45,"[29]EaFtHnKqGocIHcJCAxEgIwtxlfAxe",235,0.995763,29,236,1,235,1,1,0,1,1,111,111,125,124,7
"647",46,"[29]EaFtHnKqGocIHcJCAxEgIwtxlfAxe",225,0.995575,29,226,1,225,1,1,0,1,1,118,118,108,107,7
"648",47,"[29]EaFtHnKqGocIHcJCAxEgIwtxlfAxe",234,0.995745,29,235,1,234,1,1,0,1,1,112,112,123,122,7
"649",48,"[29]EaFtHnKqGocIHcJCAxEgIwtxlfAxe",231,0.99569,29,232,1,231,1,1,0,1,1,114,114,118,117,7
"650",49,"[29]EaFtHnKqGocIHcJCAxEgIwtxlfAxe",226,0.995595,29,227,1,226,1,1,0,1,1,117,117,110,109,7
"651",50,"[29]EaFtHnKqGocIHcJCAxEgIwtxlfAxe",228,0.995633,29,229,1,228,1,1,0,1,1,116,116,113,112,7
"652",51,"[29]EaFtHnKqGocIHcJCAxEgIwtxlfAxe",224,0.995556,29,225,1,224,1,1,0,1,1,119,119,106,105,7
"653",52,"[29]EaFtHnKqGocIHcJCAxEgIwtxlfAxe",234,0.995745,29,235,1,234,1,1,0,1,1,113,113,122,121,7
"654",53,"[29]EaFtHnKqGocIHcJCAxEgIwtxlfAxe",230,0.995671,29,231,1,230,1,1,0,1,1,116,116,115,114,7
"655",54,"[29]EaFtHnKqGocIHcJCAxEgIwtxlfAxe",229,0.995652,29,230,1,229,1,1,0,1,1,118,118,112,111,7
"656",55,"[29]EaFtHnKqGocIHcJCAxEgIwtxlfAxe",235,0.995763,29,236,1,235,1,1,0,1,1,113,113,123,122,7
"657",56,"[29]EaFtHnKqGocIHcJCAxEgIwtxlfAxe",229,0.995652,29,230,1,229,1,1,0,1,1,116,116,114,113,7
"658",57,"[29]EaFtHnKqGocIHcJCAxEgIwtxlfAxe",234,0.995745,29,235,1,234,1,1,0,1,1,111,111,124,123,7
"659",58,"[29]EaFtHnKqGocIHcJCAxEgIwtxlfAxe",223,0.995536,29,224,1,223,1,1,0,1,1,120,120,104,103,7
"660",59,"[29]EaFtHnKqGocIHcJCAxEgIwtxlfAxe",217,0.995413,29,218,1,217,1,1,0,1,1,124,124,94,93,7
"661",60,"[29]EaFtHnKqGocIHcJCAxEgIwtxlfAxe",229,0.995652,29,230,1,229,1,1,0,1,1,116,116,114,113,7
"662",61,"[29]EaFtHnKqGocIHcJCAxEgIwtxlfAxe",225,0.995575,29,226,1,225,1,1,0,1,1,118,118,108,107,7
"663",62,"[29]EaFtHnKqGocIHcJCAxEgIwtxlfAxe",240,0.995851,29,241,1,240,1,1,0,1,1,110,110,131,130,7
"664",63,"[29]EaFtHnKqGocIHcJCAxEgIwtxlfAxe",234,0.995745,29,235,1,234,1,1,0,1,1,111,111,124,123,7
"665",64,"[29]EaFtHnKqGocIHcJCAxEgIwtxlfAxe",224,0.995556,29,225,1,224,1,1,0,1,1,119,119,106,105,7
"666",65,"[29]EaFtHnKqGocIHcJCAxEgIwtxlfAxe",233,0.995726,29,234,1,233,1,1,0,1,1,115,115,119,118,7
"667",66,"[29]EaFtHnKqGocIHcJCAxEgIwtxlfAxe",231,0.99569,29,232,1,231,1,1,0,1,1,115,115,117,116,7
"668",67,"[29]EaFtHnKqGocIHcJCAxEgIwtxlfAxe",226,0.995595,29,227,1,226,1,1,0,1,1,117,117,110,109,7
"669",68,"[29]EaFtHnKqGocIHcJCAxEgIwtxlfAxe",229,0.995652,29,230,1,229,1,1,0,1,1,119,119,111,110,7
"670",69,"[29]EaFtHnKqGocIHcJCAxEgIwtxlfAxe",231,0.99569,29,232,1,231,1,1,0,1,1,114,114,118,117,7
"671",70,"[29]EaFtHnKqGocIHcJCAxEgIwtxlfAxe",229,0.995652,29,230,1,229,1,1,0,1,1,116,116,114,113,7
"672",71,"[29]EaFtHnKqGocIHcJCAxEgIwtxlfAxe",240,0.995851,29,241,1,240,1,1,0,1,1,107,107,134,133,7
"673",72,"[29]EaFtHnKqGocIHcJCAxEgIwtxlfAxe",226,0.995595,29,227,1,226,1,1,0,1,1,117,117,110,109,7
"674",73,"[29]EaFtHnKqGocIHcJCAxEgIwtxlfAxe",235,0.995763,29,236,1,235,1,1,0,1,1,112,112,124,123,7
"675",74,"[29]EaFtHnKqGocIHcJCAxEgIwtxlfAxe",233,0.995726,29,234,1,233,1,1,0,1,1,112,112,122,121,7
"676",75,"[29]EaFtHnKqGocIHcJCAxEgIwtxlfAxe",231,0.99569,29,232,1,231,1,1,0,1,1,115,115,117,116,7
"677",76,"[29]EaFtHnKqGocIHcJCAxEgIwtxlfAxe",232,0.995708,29,233,1,232,1,1,0,1,1,113,113,120,119,7
"678",77,"[29]EaFtHnKqGocIHcJCAxEgIwtxlfAxe",229,0.995652,29,230,1,229,1,1,0,1,1,116,116,114,113,7
"679",78,"[29]EaFtHnKqGocIHcJCAxEgIwtxlfAxe",237,0.995798,29,238,1,237,1,1,0,1,1,111,111,127,126,7
"680",79,"[29]EaFtHnKqGocIHcJCAxEgIwtxlfAxe",229,0.995652,29,230,1,229,1,1,0,1,1,115,115,115,114,7
"681",80,"[29]EaFtHnKqGocIHcJCAxEgIwtxlfAxe",239,0.995833,29,240,1,239,1,1,0,1,1,109,109,131,130,7
"682",81,"[29]EaFtHnKqGocIHcJCAxEgIwtxlfAxe",229,0.995652,29,230,1,229,1,1,0,1,1,117,117,113,112,7
"683",82,"[29]EaFtHnKqGocIHcJCAxEgIwtxlfAxe",245,0.995935,29,246,1,245,1,1,0,1,1,103,103,143,142,7
"684",83,"[29]EaFtHnKqGocIHcJCAxEgIwtxlfAxe",225,0.995575,29,226,1,225,1,1,0,1,1,118,118,108,107,7
"685",84,"[29]EaFtHnKqGocIHcJCAxEgIwtxlfAxe",231,0.99569,29,232,1,231,1,1,0,1,1,114,114,118,117,7
"686",85,"[29]EaFtHnKqGocIHcJCAxEgIwtxlfAxe",232,0.995708,29,233,1,232,1,1,0,1,1,115,115,118,117,7
"687",86,"[29]EaFtHnKqGocIHcJCAxEgIwtxlfAxe",233,0.995726,29,234,1,233,1,1,0,1,1,114,114,120,119,7
"688",87,"[29]EaFtHnKqGocIHcJCAxEgIwtxlfAxe",233,0.995726,29,234,1,233,1,1,0,1,1,112,112,122,121,7
"689",88,"[29]EaFtHnKqGocIHcJCAxEgIwtxlfAxe",226,0.995595,29,227,1,226,1,1,0,1,1,118,118,109,108,7
"690",89,"[29]EaFtHnKqGocIHcJCAxEgIwtxlfAxe",221,0.995495,29,222,1,221,1,1,0,1,1,123,123,99,98,7
"691",90,"[29]EaFtHnKqGocIHcJCAxEgIwtxlfAxe",229,0.995652,29,230,1,229,1,1,0,1,1,116,116,114,113,7
"692",91,"[29]EaFtHnKqGocIHcJCAxEgIwtxlfAxe",226,0.995595,29,227,1,226,1,1,0,1,1,117,117,110,109,7
"693",92,"[29]EaFtHnKqGocIHcJCAxEgIwtxlfAxe",232,0.995708,29,233,1,232,1,1,0,1,1,114,114,119,118,7
"694",93,"[29]EaFtHnKqGocIHcJCAxEgIwtxlfAxe",228,0.995633,29,229,1,228,1,1,0,1,1,117,117,112,111,7
"695",94,"[29]EaFtHnKqGocIHcJCAxEgIwtxlfAxe",231,0.99569,29,232,1,231,1,1,0,1,1,113,113,119,118,7
"696",95,"[29]EaFtHnKqGocIHcJCAxEgIwtxlfAxe",231,0.99569,29,232,1,231,1,1,0,1,1,116,116,116,115,7
"697",96,"[29]EaFtHnKqGocIHcJCAxEgIwtxlfAxe",240,0.995851,29,241,1,240,1,1,0,1,1,106,106,135,134,7
"698",97,"[29]EaFtHnKqGocIHcJCAxEgIwtxlfAxe",240,0.995851,29,241,1,240,1,1,0,1,1,107,107,134,133,7
"699",98,"[29]EaFtHnKqGocIHcJCAxEgIwtxlfAxe",232,0.995708,29,233,1,232,1,1,0,1,1,112,112,121,120,7
"700",99,"[29]EaFtHnKqGocIHcJCAxEgIwtxlfAxe",217,0.995413,29,218,1,217,1,1,0,1,1,124,124,94,93,7
"701",0,"[30]EwndxHnKqGocIHcJCqrguuHelIozKp",231,0.99569,30,232,1,231,1,1,0,1,1,113,113,119,118,8
"702",1,"[30]EwndxHnKqGocIHcJCqrguuHelIozKp",235,0.995763,30,236,1,235,1,1,0,1,1,112,112,124,123,8
"703",2,"[30]EwndxHnKqGocIHcJCqrguuHelIozKp",237,0.995798,30,238,1,237,1,1,0,1,1,108,108,130,129,8
"704",3,"[30]EwndxHnKqGocIHcJCqrguuHelIozKp",238,0.995816,30,239,1,238,1,1,0,1,1,108,108,131,130,8
"705",4,"[30]EwndxHnKqGocIHcJCqrguuHelIozKp",227,0.995614,30,228,1,227,1,1,0,1,1,118,118,110,109,8
"706",5,"[30]EwndxHnKqGocIHcJCqrguuHelIozKp",225,0.995575,30,226,1,225,1,1,0,1,1,121,121,105,104,8
"707",6,"[30]EwndxHnKqGocIHcJCqrguuHelIozKp",220,0.995475,30,221,1,220,1,1,0,1,1,123,123,98,97,8
"708",7,"[30]EwndxHnKqGocIHcJCqrguuHelIozKp",227,0.995614,30,228,1,227,1,1,0,1,1,118,118,110,109,8
"709",8,"[30]EwndxHnKqGocIHcJCqrguuHelIozKp",228,0.995633,30,229,1,228,1,1,0,1,1,116,116,113,112,8
"710",9,"[30]EwndxHnKqGocIHcJCqrguuHelIozKp",224,0.995556,30,225,1,224,1,1,0,1,1,119,119,106,105,8
"711",10,"[30]EwndxHnKqGocIHcJCqrguuHelIozKp",228,0.995633,30,229,1,228,1,1,0,1,1,117,117,112,111,8
"712",11,"[30]EwndxHnKqGocIHcJCqrguuHelIozKp",233,0.995726,30,234,1,233,1,1,0,1,1,114,114,120,119,8
"713",12,"[30]EwndxHnKqGocIHcJCqrguuHelIozKp",231,0.99569,30,232,1,231,1,1,0,1,1,115,115,117,116,8
"714",13,"[30]EwndxHnKqGocIHcJCqrguuHelIozKp",244,0.995918,30,245,1,244,1,1,0,1,1,103,103,142,141,8
"715",14,"[30]EwndxHnKqGocIHcJCqrguuHelIozKp",233,0.995726,30,234,1,233,1,1,0,1,1,113,113,121,120,8
"716",15,"[30]EwndxHnKqGocIHcJCqrguuHelIozKp",224,0.995556,30,225,1,224,1,1,0,1,1,120,120,105,104,8
"717",16,"[30]EwndxHnKqGocIHcJCqrguuHelIozKp",241,0.995868,30,242,1,241,1,1,0,1,1,106,106,136,135,8
"718",17,"[30]EwndxHnKqGocIHcJCqrguuHelIozKp",232,0.995708,30,233,1,232,1,1,0,1,1,113,113,120,119,8
"719",18,"[30]EwndxHnKqGocIHcJCqrguuHelIozKp",240,0.995851,30,241,1,240,1,1,0,1,1,107,107,134,133,8
"720",19,"[30]EwndxHnKqGocIHcJCqrguuHelIozKp",230,0.995671,30,231,1,230,1,1,0,1,1,116,116,115,114,8
"721",20,"[30]EwndxHnKqGocIHcJCqrguuHelIozKp",224,0.995556,30,225,1,224,1,1,0,1,1,119,119,106,105,8
"722",21,"[30]EwndxHnKqGocIHcJCqrguuHelIozKp",231,0.99569,30,232,1,231,1,1,0,1,1,114,114,118,117,8
"723",22,"[30]EwndxHnKqGocIHcJCqrguuHelIozKp",235,0.995763,30,236,1,235,1,1,0,1,1,112,112,124,123,8
"724",23,"[30]EwndxHnKqGocIHcJCqrguuHelIozKp",218,0.995434,30,219,1,218,1,1,0,1,1,124,124,95,94,8
"725",24,"[30]EwndxHnKqGocIHcJCqrguuHelIozKp",223,0.995536,30,224,1,223,1,1,0,1,1,120,120,104,103,8
"726",25,"[30]EwndxHnKqGocIHcJCqrguuHelIozKp",244,0.995918,30,245,1,244,1,1,0,1,1,103,103,142,141,8
"727",26,"[30]EwndxHnKqGocIHcJCqrguuHelIozKp",236,0.995781,30,237,1,236,1,1,0,1,1,116,116,121,120,8
"728",27,"[30]EwndxHnKqGocIHcJCqrguuHelIozKp",226,0.995595,30,227,1,226,1,1,0,1,1,118,118,109,108,8
"729",28,"[30]EwndxHnKqGocIHcJCqrguuHelIozKp",217,0.995413,30,218,1,217,1,1,0,1,1,125,125,93,92,8
"730",29,"[30]EwndxHnKqGocIHcJCqrguuHelIozKp",224,0.995556,30,225,1,224,1,1,0,1,1,120,120,105,104,8
"731",30,"[30]EwndxHnKqGocIHcJCqrguuHelIozKp",232,0.995708,30,233,1,232,1,1,0,1,1,113,113,120,119,8
"732",31,"[30]EwndxHnKqGocIHcJCqrguuHelIozKp",230,0.995671,30,231,1,230,1,1,0,1,1,116,116,115,114,8
"733",32,"[30]EwndxHnKqGocIHcJCqrguuHelIozKp",222,0.995516,30,223,1,222,1,1,0,1,1,120,120,103,102,8
"734",33,"[30]EwndxHnKqGocIHcJCqrguuHelIozKp",236,0.995781,30,237,1,236,1,1,0,1,1,114,114,123,122,8
"735",34,"[30]EwndxHnKqGocIHcJCqrguuHelIozKp",236,0.995781,30,237,1,236,1,1,0,1,1,110,110,127,126,8
"736",35,"[30]EwndxHnKqGocIHcJCqrguuHelIozKp",222,0.995516,30,223,1,222,1,1,0,1,1,120,120,103,102,8
"737",36,"[30]EwndxHnKqGocIHcJCqrguuHelIozKp",227,0.995614,30,228,1,227,1,1,0,1,1,117,117,111,110,8
"738",37,"[30]EwndxHnKqGocIHcJCqrguuHelIozKp",228,0.995633,30,229,1,228,1,1,0,1,1,116,116,113,112,8
"739",38,"[30]EwndxHnKqGocIHcJCqrguuHelIozKp",238,0.995816,30,239,1,238,1,1,0,1,1,108,108,131,130,8
"740",39,"[30]EwndxHnKqGocIHcJCqrguuHelIozKp",230,0.995671,30,231,1,230,1,1,0,1,1,114,114,117,116,8
"741",40,"[30]EwndxHnKqGocIHcJCqrguuHelIozKp",228,0.995633,30,229,1,228,1,1,0,1,1,117,117,112,111,8
"742",41,"[30]EwndxHnKqGocIHcJCqrguuHelIozKp",230,0.995671,30,231,1,230,1,1,0,1,1,115,115,116,115,8
"743",42,"[30]EwndxHnKqGocIHcJCqrguuHelIozKp",223,0.995536,30,224,1,223,1,1,0,1,1,121,121,103,102,8
"744",43,"[30]EwndxHnKqGocIHcJCqrguuHelIozKp",231,0.99569,30,232,1,231,1,1,0,1,1,114,114,118,117,8
"745",44,"[30]EwndxHnKqGocIHcJCqrguuHelIozKp",232,0.995708,30,233,1,232,1,1,0,1,1,114,114,119,118,8
"746",45,"[30]EwndxHnKqGocIHcJCqrguuHelIozKp",231,0.99569,30,232,1,231,1,1,0,1,1,115,115,117,116,8
"747",46,"[30]EwndxHnKqGocIHcJCqrguuHelIozKp",232,0.995708,30,233,1,232,1,1,0,1,1,113,113,120,119,8
"748",47,"[30]EwndxHnKqGocIHcJCqrguuHelIozKp",231,0.99569,30,232,1,231,1,1,0,1,1,113,113,119,118,8
"749",48,"[30]EwndxHnKqGocIHcJCqrguuHelIozKp",231,0.99569,30,232,1,231,1,1,0,1,1,113,113,119,118,8
"750",49,"[30]EwndxHnKqGocIHcJCqrguuHelIozKp",225,0.995575,30,226,1,225,1,1,0,1,1,119,119,107,106,8
"751",50,"[30]EwndxHnKqGocIHcJCqrguuHelIozKp",229,0.995652,30,230,1,229,1,1,0,1,1,116,116,114,113,8
"752",51,"[30]EwndxHnKqGocIHcJCqrguuHelIozKp",226,0.995595,30,227,1,226,1,1,0,1,1,119,119,108,107,8
"753",52,"[30]EwndxHnKqGocIHcJCqrguuHelIozKp",224,0.995556,30,225,1,224,1,1,0,1,1,119,119,106,105,8
"754",53,"[30]EwndxHnKqGocIHcJCqrguuHelIozKp",241,0.995868,30,242,1,241,1,1,0,1,1,105,105,137,136,8
"755",54,"[30]EwndxHnKqGocIHcJCqrguuHelIozKp",229,0.995652,30,230,1,229,1,1,0,1,1,115,115,115,114,8
"756",55,"[30]EwndxHnKqGocIHcJCqrguuHelIozKp",227,0.995614,30,228,1,227,1,1,0,1,1,116,116,112,111,8
"757",56,"[30]EwndxHnKqGocIHcJCqrguuHelIozKp",222,0.995516,30,223,1,222,1,1,0,1,1,122,122,101,100,8
"758",57,"[30]EwndxHnKqGocIHcJCqrguuHelIozKp",228,0.995633,30,229,1,228,1,1,0,1,1,117,117,112,111,8
"759",58,"[30]EwndxHnKqGocIHcJCqrguuHelIozKp",229,0.995652,30,230,1,229,1,1,0,1,1,115,115,115,114,8
"760",59,"[30]EwndxHnKqGocIHcJCqrguuHelIozKp",236,0.995781,30,237,1,236,1,1,0,1,1,110,110,127,126,8
"761",60,"[30]EwndxHnKqGocIHcJCqrguuHelIozKp",226,0.995595,30,227,1,226,1,1,0,1,1,117,117,110,109,8
"762",61,"[30]EwndxHnKqGocIHcJCqrguuHelIozKp",232,0.995708,30,233,1,232,1,1,0,1,1,112,112,121,120,8
"763",62,"[30]EwndxHnKqGocIHcJCqrguuHelIozKp",233,0.995726,30,234,1,233,1,1,0,1,1,112,112,122,121,8
"764",63,"[30]EwndxHnKqGocIHcJCqrguuHelIozKp",229,0.995652,30,230,1,229,1,1,0,1,1,117,117,113,112,8
"765",64,"[30]EwndxHnKqGocIHcJCqrguuHelIozKp",231,0.99569,30,232,1,231,1,1,0,1,1,114,114,118,117,8
"766",65,"[30]EwndxHnKqGocIHcJCqrguuHelIozKp",224,0.995556,30,225,1,224,1,1,0,1,1,125,125,100,99,8
"767",66,"[30]EwndxHnKqGocIHcJCqrguuHelIozKp",230,0.995671,30,231,1,230,1,1,0,1,1,115,115,116,115,8
"768",67,"[30]EwndxHnKqGocIHcJCqrguuHelIozKp",242,0.995885,30,243,1,242,1,1,0,1,1,112,112,131,130,8
"769",68,"[30]EwndxHnKqGocIHcJCqrguuHelIozKp",222,0.995516,30,223,1,222,1,1,0,1,1,120,120,103,102,8
"770",69,"[30]EwndxHnKqGocIHcJCqrguuHelIozKp",230,0.995671,30,231,1,230,1,1,0,1,1,114,114,117,116,8
"771",70,"[30]EwndxHnKqGocIHcJCqrguuHelIozKp",227,0.995614,30,228,1,227,1,1,0,1,1,125,125,103,102,8
"772",71,"[30]EwndxHnKqGocIHcJCqrguuHelIozKp",220,0.995475,30,221,1,220,1,1,0,1,1,122,122,99,98,8
"773",72,"[30]EwndxHnKqGocIHcJCqrguuHelIozKp",244,0.995918,30,245,1,244,1,1,0,1,1,104,104,141,140,8
"774",73,"[30]EwndxHnKqGocIHcJCqrguuHelIozKp",241,0.995868,30,242,1,241,1,1,0,1,1,105,105,137,136,8
"775",74,"[30]EwndxHnKqGocIHcJCqrguuHelIozKp",234,0.995745,30,235,1,234,1,1,0,1,1,112,112,123,122,8
"776",75,"[30]EwndxHnKqGocIHcJCqrguuHelIozKp",235,0.995763,30,236,1,235,1,1,0,1,1,110,110,126,125,8
"777",76,"[30]EwndxHnKqGocIHcJCqrguuHelIozKp",228,0.995633,30,229,1,228,1,1,0,1,1,117,117,112,111,8
"778",77,"[30]EwndxHnKqGocIHcJCqrguuHelIozKp",233,0.995726,30,234,1,233,1,1,0,1,1,114,114,120,119,8
"779",78,"[30]EwndxHnKqGocIHcJCqrguuHelIozKp",229,0.995652,30,230,1,229,1,1,0,1,1,117,117,113,112,8
"780",79,"[30]EwndxHnKqGocIHcJCqrguuHelIozKp",234,0.995745,30,235,1,234,1,1,0,1,1,112,112,123,122,8
"781",80,"[30]EwndxHnKqGocIHcJCqrguuHelIozKp",235,0.995763,30,236,1,235,1,1,0,1,1,110,110,126,125,8
"782",81,"[30]EwndxHnKqGocIHcJCqrguuHelIozKp",239,0.995833,30,240,1,239,1,1,0,1,1,110,110,130,129,8
"783",82,"[30]EwndxHnKqGocIHcJCqrguuHelIozKp",233,0.995726,30,234,1,233,1,1,0,1,1,113,113,121,120,8
"784",83,"[30]EwndxHnKqGocIHcJCqrguuHelIozKp",227,0.995614,30,228,1,227,1,1,0,1,1,117,117,111,110,8
"785",84,"[30]EwndxHnKqGocIHcJCqrguuHelIozKp",230,0.995671,30,231,1,230,1,1,0,1,1,116,116,115,114,8
"786",85,"[30]EwndxHnKqGocIHcJCqrguuHelIozKp",231,0.99569,30,232,1,231,1,1,0,1,1,113,113,119,118,8
"787",86,"[30]EwndxHnKqGocIHcJCqrguuHelIozKp",233,0.995726,30,234,1,233,1,1,0,1,1,112,112,122,121,8
"788",87,"[30]EwndxHnKqGocIHcJCqrguuHelIozKp",230,0.995671,30,231,1,230,1,1,0,1,1,114,114,117,116,8
"789",88,"[30]EwndxHnKqGocIHcJCqrguuHelIozKp",228,0.995633,30,229,1,228,1,1,0,1,1,118,118,111,110,8
"790",89,"[30]EwndxHnKqGocIHcJCqrguuHelIozKp",236,0.995781,30,237,1,236,1,1,0,1,1,110,110,127,126,8
"791",90,"[30]EwndxHnKqGocIHcJCqrguuHelIozKp",240,0.995851,30,241,1,240,1,1,0,1,1,107,107,134,133,8
"792",91,"[30]EwndxHnKqGocIHcJCqrguuHelIozKp",236,0.995781,30,237,1,236,1,1,0,1,1,110,110,127,126,8
"793",92,"[30]EwndxHnKqGocIHcJCqrguuHelIozKp",240,0.995851,30,241,1,240,1,1,0,1,1,109,109,132,131,8
"794",93,"[30]EwndxHnKqGocIHcJCqrguuHelIozKp",224,0.995556,30,225,1,224,1,1,0,1,1,120,120,105,104,8
"795",94,"[30]EwndxHnKqGocIHcJCqrguuHelIozKp",236,0.995781,30,237,1,236,1,1,0,1,1,109,109,128,127,8
"796",95,"[30]EwndxHnKqGocIHcJCqrguuHelIozKp",227,0.995614,30,228,1,227,1,1,0,1,1,119,119,109,108,8
"797",96,"[30]EwndxHnKqGocIHcJCqrguuHelIozKp",232,0.995708,30,233,1,232,1,1,0,1,1,112,112,121,120,8
"798",97,"[30]EwndxHnKqGocIHcJCqrguuHelIozKp",222,0.995516,30,223,1,222,1,1,0,1,1,120,120,103,102,8
"799",98,"[30]EwndxHnKqGocIHcJCqrguuHelIozKp",233,0.995726,30,234,1,233,1,1,0,1,1,116,116,118,117,8
"800",99,"[30]EwndxHnKqGocIHcJCqrguuHelIozKp",227,0.995614,30,228,1,227,1,1,0,1,1,117,117,111,110,8
"801",0,"[24]EjxxHnKqGocIHcJCaqtKiAhG",228,0.995633,24,229,1,228,1,1,0,1,1,116,116,113,112,9
"802",1,"[24]EjxxHnKqGocIHcJCaqtKiAhG",235,0.995763,24,236,1,235,1,1,0,1,1,113,113,123,122,9
"803",2,"[24]EjxxHnKqGocIHcJCaqtKiAhG",230,0.995671,24,231,1,230,1,1,0,1,1,119,119,112,111,9
"804",3,"[24]EjxxHnKqGocIHcJCaqtKiAhG",232,0.995708,24,233,1,232,1,1,0,1,1,115,115,118,117,9
"805",4,"[24]EjxxHnKqGocIHcJCaqtKiAhG",235,0.995763,24,236,1,235,1,1,0,1,1,112,112,124,123,9
"806",5,"[24]EjxxHnKqGocIHcJCaqtKiAhG",241,0.995868,24,242,1,241,1,1,0,1,1,107,107,135,134,9
"807",6,"[24]EjxxHnKqGocIHcJCaqtKiAhG",227,0.995614,24,228,1,227,1,1,0,1,1,116,116,112,111,9
"808",7,"[24]EjxxHnKqGocIHcJCaqtKiAhG",234,0.995745,24,235,1,234,1,1,0,1,1,112,112,123,122,9
"809",8,"[24]EjxxHnKqGocIHcJCaqtKiAhG",233,0.995726,24,234,1,233,1,1,0,1,1,118,118,116,115,9
"810",9,"[24]EjxxHnKqGocIHcJCaqtKiAhG",217,0.995413,24,218,1,217,1,1,0,1,1,124,124,94,93,9
"811",10,"[24]EjxxHnKqGocIHcJCaqtKiAhG",229,0.995652,24,230,1,229,1,1,0,1,1,115,115,115,114,9
"812",11,"[24]EjxxHnKqGocIHcJCaqtKiAhG",232,0.995708,24,233,1,232,1,1,0,1,1,115,115,118,117,9
"813",12,"[24]EjxxHnKqGocIHcJCaqtKiAhG",239,0.995833,24,240,1,239,1,1,0,1,1,107,107,133,132,9
"814",13,"[24]EjxxHnKqGocIHcJCaqtKiAhG",221,0.995495,24,222,1,221,1,1,0,1,1,121,121,101,100,9
"815",14,"[24]EjxxHnKqGocIHcJCaqtKiAhG",230,0.995671,24,231,1,230,1,1,0,1,1,119,119,112,111,9
"816",15,"[24]EjxxHnKqGocIHcJCaqtKiAhG",237,0.995798,24,238,1,237,1,1,0,1,1,109,109,129,128,9
"817",16,"[24]EjxxHnKqGocIHcJCaqtKiAhG",231,0.99569,24,232,1,231,1,1,0,1,1,115,115,117,116,9
"818",17,"[24]EjxxHnKqGocIHcJCaqtKiAhG",232,0.995708,24,233,1,232,1,1,0,1,1,112,112,121,120,9
"819",18,"[24]EjxxHnKqGocIHcJCaqtKiAhG",238,0.995816,24,239,1,238,1,1,0,1,1,112,112,127,126,9
"820",19,"[24]EjxxHnKqGocIHcJCaqtKiAhG",231,0.99569,24,232,1,231,1,1,0,1,1,113,113,119,118,9
"821",20,"[24]EjxxHnKqGocIHcJCaqtKiAhG",231,0.99569,24,232,1,231,1,1,0,1,1,115,115,117,116,9
"822",21,"[24]EjxxHnKqGocIHcJCaqtKiAhG",235,0.995763,24,236,1,235,1,1,0,1,1,113,113,123,122,9
"823",22,"[24]EjxxHnKqGocIHcJCaqtKiAhG",230,0.995671,24,231,1,230,1,1,0,1,1,114,114,117,116,9
"824",23,"[24]EjxxHnKqGocIHcJCaqtKiAhG",225,0.995575,24,226,1,225,1,1,0,1,1,119,119,107,106,9
"825",24,"[24]EjxxHnKqGocIHcJCaqtKiAhG",225,0.995575,24,226,1,225,1,1,0,1,1,118,118,108,107,9
"826",25,"[24]EjxxHnKqGocIHcJCaqtKiAhG",236,0.995781,24,237,1,236,1,1,0,1,1,110,110,127,126,9
"827",26,"[24]EjxxHnKqGocIHcJCaqtKiAhG",221,0.995495,24,222,1,221,1,1,0,1,1,121,121,101,100,9
"828",27,"[24]EjxxHnKqGocIHcJCaqtKiAhG",217,0.995413,24,218,1,217,1,1,0,1,1,125,125,93,92,9
"829",28,"[24]EjxxHnKqGocIHcJCaqtKiAhG",234,0.995745,24,235,1,234,1,1,0,1,1,111,111,124,123,9
"830",29,"[24]EjxxHnKqGocIHcJCaqtKiAhG",223,0.995536,24,224,1,223,1,1,0,1,1,120,120,104,103,9
"831",30,"[24]EjxxHnKqGocIHcJCaqtKiAhG",230,0.995671,24,231,1,230,1,1,0,1,1,114,114,117,116,9
"832",31,"[24]EjxxHnKqGocIHcJCaqtKiAhG",235,0.995763,24,236,1,235,1,1,0,1,1,111,111,125,124,9
"833",32,"[24]EjxxHnKqGocIHcJCaqtKiAhG",220,0.995475,24,221,1,220,1,1,0,1,1,122,122,99,98,9
"834",33,"[24]EjxxHnKqGocIHcJCaqtKiAhG",228,0.995633,24,229,1,228,1,1,0,1,1,117,117,112,111,9
"835",34,"[24]EjxxHnKqGocIHcJCaqtKiAhG",220,0.995475,24,221,1,220,1,1,0,1,1,122,122,99,98,9
"836",35,"[24]EjxxHnKqGocIHcJCaqtKiAhG",231,0.99569,24,232,1,231,1,1,0,1,1,114,114,118,117,9
"837",36,"[24]EjxxHnKqGocIHcJCaqtKiAhG",236,0.995781,24,237,1,236,1,1,0,1,1,109,109,128,127,9
"838",37,"[24]EjxxHnKqGocIHcJCaqtKiAhG",221,0.995495,24,222,1,221,1,1,0,1,1,121,121,101,100,9
"839",38,"[24]EjxxHnKqGocIHcJCaqtKiAhG",229,0.995652,24,230,1,229,1,1,0,1,1,117,117,113,112,9
"840",39,"[24]EjxxHnKqGocIHcJCaqtKiAhG",227,0.995614,24,228,1,227,1,1,0,1,1,116,116,112,111,9
"841",40,"[24]EjxxHnKqGocIHcJCaqtKiAhG",233,0.995726,24,234,1,233,1,1,0,1,1,112,112,122,121,9
"842",41,"[24]EjxxHnKqGocIHcJCaqtKiAhG",231,0.99569,24,232,1,231,1,1,0,1,1,114,114,118,117,9
"843",42,"[24]EjxxHnKqGocIHcJCaqtKiAhG",237,0.995798,24,238,1,237,1,1,0,1,1,111,111,127,126,9
"844",43,"[24]EjxxHnKqGocIHcJCaqtKiAhG",226,0.995595,24,227,1,226,1,1,0,1,1,118,118,109,108,9
"845",44,"[24]EjxxHnKqGocIHcJCaqtKiAhG",235,0.995763,24,236,1,235,1,1,0,1,1,112,112,124,123,9
"846",45,"[24]EjxxHnKqGocIHcJCaqtKiAhG",232,0.995708,24,233,1,232,1,1,0,1,1,112,112,121,120,9
"847",46,"[24]EjxxHnKqGocIHcJCaqtKiAhG",227,0.995614,24,228,1,227,1,1,0,1,1,117,117,111,110,9
"848",47,"[24]EjxxHnKqGocIHcJCaqtKiAhG",242,0.995885,24,243,1,242,1,1,0,1,1,106,106,137,136,9
"849",48,"[24]EjxxHnKqGocIHcJCaqtKiAhG",226,0.995595,24,227,1,226,1,1,0,1,1,118,118,109,108,9
"850",49,"[24]EjxxHnKqGocIHcJCaqtKiAhG",228,0.995633,24,229,1,228,1,1,0,1,1,116,116,113,112,9
"851",50,"[24]EjxxHnKqGocIHcJCaqtKiAhG",224,0.995556,24,225,1,224,1,1,0,1,1,122,122,103,102,9
"852",51,"[24]EjxxHnKqGocIHcJCaqtKiAhG",234,0.995745,24,235,1,234,1,1,0,1,1,111,111,124,123,9
"853",52,"[24]EjxxHnKqGocIHcJCaqtKiAhG",218,0.995434,24,219,1,218,1,1,0,1,1,124,124,95,94,9
"854",53,"[24]EjxxHnKqGocIHcJCaqtKiAhG",240,0.995851,24,241,1,240,1,1,0,1,1,107,107,134,133,9
"855",54,"[24]EjxxHnKqGocIHcJCaqtKiAhG",223,0.995536,24,224,1,223,1,1,0,1,1,121,121,103,102,9
"856",55,"[24]EjxxHnKqGocIHcJCaqtKiAhG",234,0.995745,24,235,1,234,1,1,0,1,1,112,112,123,122,9
"857",56,"[24]EjxxHnKqGocIHcJCaqtKiAhG",226,0.995595,24,227,1,226,1,1,0,1,1,119,119,108,107,9
"858",57,"[24]EjxxHnKqGocIHcJCaqtKiAhG",231,0.99569,24,232,1,231,1,1,0,1,1,113,113,119,118,9
"859",58,"[24]EjxxHnKqGocIHcJCaqtKiAhG",224,0.995556,24,225,1,224,1,1,0,1,1,119,119,106,105,9
"860",59,"[24]EjxxHnKqGocIHcJCaqtKiAhG",231,0.99569,24,232,1,231,1,1,0,1,1,113,113,119,118,9
"861",60,"[24]EjxxHnKqGocIHcJCaqtKiAhG",217,0.995413,24,218,1,217,1,1,0,1,1,125,125,93,92,9
"862",61,"[24]EjxxHnKqGocIHcJCaqtKiAhG",229,0.995652,24,230,1,229,1,1,0,1,1,115,115,115,114,9
"863",62,"[24]EjxxHnKqGocIHcJCaqtKiAhG",232,0.995708,24,233,1,232,1,1,0,1,1,112,112,121,120,9
"864",63,"[24]EjxxHnKqGocIHcJCaqtKiAhG",213,0.995327,24,214,1,213,1,1,0,1,1,128,128,86,85,9
"865",64,"[24]EjxxHnKqGocIHcJCaqtKiAhG",237,0.995798,24,238,1,237,1,1,0,1,1,110,110,128,127,9
"866",65,"[24]EjxxHnKqGocIHcJCaqtKiAhG",231,0.99569,24,232,1,231,1,1,0,1,1,113,113,119,118,9
"867",66,"[24]EjxxHnKqGocIHcJCaqtKiAhG",229,0.995652,24,230,1,229,1,1,0,1,1,119,119,111,110,9
"868",67,"[24]EjxxHnKqGocIHcJCaqtKiAhG",233,0.995726,24,234,1,233,1,1,0,1,1,112,112,122,121,9
"869",68,"[24]EjxxHnKqGocIHcJCaqtKiAhG",236,0.995781,24,237,1,236,1,1,0,1,1,110,110,127,126,9
"870",69,"[24]EjxxHnKqGocIHcJCaqtKiAhG",226,0.995595,24,227,1,226,1,1,0,1,1,117,117,110,109,9
"871",70,"[24]EjxxHnKqGocIHcJCaqtKiAhG",231,0.99569,24,232,1,231,1,1,0,1,1,117,117,115,114,9
"872",71,"[24]EjxxHnKqGocIHcJCaqtKiAhG",227,0.995614,24,228,1,227,1,1,0,1,1,116,116,112,111,9
"873",72,"[24]EjxxHnKqGocIHcJCaqtKiAhG",230,0.995671,24,231,1,230,1,1,0,1,1,116,116,115,114,9
"874",73,"[24]EjxxHnKqGocIHcJCaqtKiAhG",238,0.995816,24,239,1,238,1,1,0,1,1,108,108,131,130,9
"875",74,"[24]EjxxHnKqGocIHcJCaqtKiAhG",231,0.99569,24,232,1,231,1,1,0,1,1,114,114,118,117,9
"876",75,"[24]EjxxHnKqGocIHcJCaqtKiAhG",237,0.995798,24,238,1,237,1,1,0,1,1,108,108,130,129,9
"877",76,"[24]EjxxHnKqGocIHcJCaqtKiAhG",235,0.995763,24,236,1,235,1,1,0,1,1,115,115,121,120,9
"878",77,"[24]EjxxHnKqGocIHcJCaqtKiAhG",223,0.995536,24,224,1,223,1,1,0,1,1,122,122,102,101,9
"879",78,"[24]EjxxHnKqGocIHcJCaqtKiAhG",237,0.995798,24,238,1,237,1,1,0,1,1,109,109,129,128,9
"880",79,"[24]EjxxHnKqGocIHcJCaqtKiAhG",239,0.995833,24,240,1,239,1,1,0,1,1,107,107,133,132,9
"881",80,"[24]EjxxHnKqGocIHcJCaqtKiAhG",226,0.995595,24,227,1,226,1,1,0,1,1,118,118,109,108,9
"882",81,"[24]EjxxHnKqGocIHcJCaqtKiAhG",223,0.995536,24,224,1,223,1,1,0,1,1,120,120,104,103,9
"883",82,"[24]EjxxHnKqGocIHcJCaqtKiAhG",232,0.995708,24,233,1,232,1,1,0,1,1,113,113,120,119,9
"884",83,"[24]EjxxHnKqGocIHcJCaqtKiAhG",221,0.995495,24,222,1,221,1,1,0,1,1,121,121,101,100,9
"885",84,"[24]EjxxHnKqGocIHcJCaqtKiAhG",234,0.995745,24,235,1,234,1,1,0,1,1,112,112,123,122,9
"886",85,"[24]EjxxHnKqGocIHcJCaqtKiAhG",237,0.995798,24,238,1,237,1,1,0,1,1,108,108,130,129,9
"887",86,"[24]EjxxHnKqGocIHcJCaqtKiAhG",222,0.995516,24,223,1,222,1,1,0,1,1,122,122,101,100,9
"888",87,"[24]EjxxHnKqGocIHcJCaqtKiAhG",224,0.995556,24,225,1,224,1,1,0,1,1,119,119,106,105,9
"889",88,"[24]EjxxHnKqGocIHcJCaqtKiAhG",232,0.995708,24,233,1,232,1,1,0,1,1,116,116,117,116,9
"890",89,"[24]EjxxHnKqGocIHcJCaqtKiAhG",226,0.995595,24,227,1,226,1,1,0,1,1,118,118,109,108,9
"891",90,"[24]EjxxHnKqGocIHcJCaqtKiAhG",230,0.995671,24,231,1,230,1,1,0,1,1,117,117,114,113,9
"892",91,"[24]EjxxHnKqGocIHcJCaqtKiAhG",222,0.995516,24,223,1,222,1,1,0,1,1,120,120,103,102,9
"893",92,"[24]EjxxHnKqGocIHcJCaqtKiAhG",226,0.995595,24,227,1,226,1,1,0,1,1,117,117,110,109,9
"894",93,"[24]EjxxHnKqGocIHcJCaqtKiAhG",233,0.995726,24,234,1,233,1,1,0,1,1,114,114,120,119,9
"895",94,"[24]EjxxHnKqGocIHcJCaqtKiAhG",232,0.995708,24,233,1,232,1,1,0,1,1,112,112,121,120,9
"896",95,"[24]EjxxHnKqGocIHcJCaqtKiAhG",229,0.995652,24,230,1,229,1,1,0,1,1,117,117,113,112,9
"897",96,"[24]EjxxHnKqGocIHcJCaqtKiAhG",230,0.995671,24,231,1,230,1,1,0,1,1,115,115,116,115,9
"898",97,"[24]EjxxHnKqGocIHcJCaqtKiAhG",234,0.995745,24,235,1,234,1,1,0,1,1,111,111,124,123,9
"899",98,"[24]EjxxHnKqGocIHcJCaqtKiAhG",230,0.995671,24,231,1,230,1,1,0,1,1,117,117,114,113,9
"900",99,"[24]EjxxHnKqGocIHcJCaqtKiAhG",236,0.995781,24,237,1,236,1,1,0,1,1,111,111,126,125,9
"901",0,"[30]EeysHnKqGocIHcJCtbwwHlxEeaxfsD",235,0.995763,30,236,1,235,1,1,0,1,1,111,111,125,124,10
"902",1,"[30]EeysHnKqGocIHcJCtbwwHlxEeaxfsD",238,0.995816,30,239,1,238,1,1,0,1,1,109,109,130,129,10
"903",2,"[30]EeysHnKqGocIHcJCtbwwHlxEeaxfsD",230,0.995671,30,231,1,230,1,1,0,1,1,115,115,116,115,10
"904",3,"[30]EeysHnKqGocIHcJCtbwwHlxEeaxfsD",252,0.996047,30,253,1,252,1,1,0,1,1,106,106,147,146,10
"905",4,"[30]EeysHnKqGocIHcJCtbwwHlxEeaxfsD",239,0.995833,30,240,1,239,1,1,0,1,1,107,107,133,132,10
"906",5,"[30]EeysHnKqGocIHcJCtbwwHlxEeaxfsD",236,0.995781,30,237,1,236,1,1,0,1,1,110,110,127,126,10
"907",6,"[30]EeysHnKqGocIHcJCtbwwHlxEeaxfsD",225,0.995575,30,226,1,225,1,1,0,1,1,118,118,108,107,10
"908",7,"[30]EeysHnKqGocIHcJCtbwwHlxEeaxfsD",229,0.995652,30,230,1,229,1,1,0,1,1,116,116,114,113,10
"909",8,"[30]EeysHnKqGocIHcJCtbwwHlxEeaxfsD",231,0.99569,30,232,1,231,1,1,0,1,1,114,114,118,117,10
"910",9,"[30]EeysHnKqGocIHcJCtbwwHlxEeaxfsD",226,0.995595,30,227,1,226,1,1,0,1,1,118,118,109,108,10
"911",10,"[30]EeysHnKqGocIHcJCtbwwHlxEeaxfsD",233,0.995726,30,234,1,233,1,1,0,1,1,112,112,122,121,10
"912",11,"[30]EeysHnKqGocIHcJCtbwwHlxEeaxfsD",237,0.995798,30,238,1,237,1,1,0,1,1,108,108,130,129,10
"913",12,"[30]EeysHnKqGocIHcJCtbwwHlxEeaxfsD",231,0.99569,30,232,1,231,1,1,0,1,1,114,114,118,117,10
"914",13,"[30]EeysHnKqGocIHcJCtbwwHlxEeaxfsD",232,0.995708,30,233,1,232,1,1,0,1,1,114,114,119,118,10
"915",14,"[30]EeysHnKqGocIHcJCtbwwHlxEeaxfsD",221,0.995495,30,222,1,221,1,1,0,1,1,122,122,100,99,10
"916",15,"[30]EeysHnKqGocIHcJCtbwwHlxEeaxfsD",226,0.995595,30,227,1,226,1,1,0,1,1,120,120,107,106,10
"917",16,"[30]EeysHnKqGocIHcJCtbwwHlxEeaxfsD",235,0.995763,30,236,1,235,1,1,0,1,1,111,111,125,124,10
"918",17,"[30]EeysHnKqGocIHcJCtbwwHlxEeaxfsD",226,0.995595,30,227,1,226,1,1,0,1,1,117,117,110,109,10
"919",18,"[30]EeysHnKqGocIHcJCtbwwHlxEeaxfsD",232,0.995708,30,233,1,232,1,1,0,1,1,114,114,119,118,10
"920",19,"[30]EeysHnKqGocIHcJCtbwwHlxEeaxfsD",230,0.995671,30,231,1,230,1,1,0,1,1,114,114,117,116,10
"921",20,"[30]EeysHnKqGocIHcJCtbwwHlxEeaxfsD",228,0.995633,30,229,1,228,1,1,0,1,1,116,116,113,112,10
"922",21,"[30]EeysHnKqGocIHcJCtbwwHlxEeaxfsD",238,0.995816,30,239,1,238,1,1,0,1,1,109,109,130,129,10
"923",22,"[30]EeysHnKqGocIHcJCtbwwHlxEeaxfsD",236,0.995781,30,237,1,236,1,1,0,1,1,111,111,126,125,10
"924",23,"[30]EeysHnKqGocIHcJCtbwwHlxEeaxfsD",238,0.995816,30,239,1,238,1,1,0,1,1,108,108,131,130,10
"925",24,"[30]EeysHnKqGocIHcJCtbwwHlxEeaxfsD",236,0.995781,30,237,1,236,1,1,0,1,1,114,114,123,122,10
"926",25,"[30]EeysHnKqGocIHcJCtbwwHlxEeaxfsD",223,0.995536,30,224,1,223,1,1,0,1,1,120,120,104,103,10
"927",26,"[30]EeysHnKqGocIHcJCtbwwHlxEeaxfsD",218,0.995434,30,219,1,218,1,1,0,1,1,125,125,94,93,10
"928",27,"[30]EeysHnKqGocIHcJCtbwwHlxEeaxfsD",229,0.995652,30,230,1,229,1,1,0,1,1,116,116,114,113,10
"929",28,"[30]EeysHnKqGocIHcJCtbwwHlxEeaxfsD",236,0.995781,30,237,1,236,1,1,0,1,1,110,110,127,126,10
"930",29,"[30]EeysHnKqGocIHcJCtbwwHlxEeaxfsD",237,0.995798,30,238,1,237,1,1,0,1,1,113,113,125,124,10
"931",30,"[30]EeysHnKqGocIHcJCtbwwHlxEeaxfsD",235,0.995763,30,236,1,235,1,1,0,1,1,110,110,126,125,10
"932",31,"[30]EeysHnKqGocIHcJCtbwwHlxEeaxfsD",231,0.99569,30,232,1,231,1,1,0,1,1,115,115,117,116,10
"933",32,"[30]EeysHnKqGocIHcJCtbwwHlxEeaxfsD",226,0.995595,30,227,1,226,1,1,0,1,1,117,117,110,109,10
"934",33,"[30]EeysHnKqGocIHcJCtbwwHlxEeaxfsD",234,0.995745,30,235,1,234,1,1,0,1,1,112,112,123,122,10
"935",34,"[30]EeysHnKqGocIHcJCtbwwHlxEeaxfsD",219,0.995455,30,220,1,219,1,1,0,1,1,124,124,96,95,10
"936",35,"[30]EeysHnKqGocIHcJCtbwwHlxEeaxfsD",236,0.995781,30,237,1,236,1,1,0,1,1,110,110,127,126,10
"937",36,"[30]EeysHnKqGocIHcJCtbwwHlxEeaxfsD",240,0.995851,30,241,1,240,1,1,0,1,1,108,108,133,132,10
"938",37,"[30]EeysHnKqGocIHcJCtbwwHlxEeaxfsD",231,0.99569,30,232,1,231,1,1,0,1,1,115,115,117,116,10
"939",38,"[30]EeysHnKqGocIHcJCtbwwHlxEeaxfsD",227,0.995614,30,228,1,227,1,1,0,1,1,119,119,109,108,10
"940",39,"[30]EeysHnKqGocIHcJCtbwwHlxEeaxfsD",232,0.995708,30,233,1,232,1,1,0,1,1,113,113,120,119,10
"941",40,"[30]EeysHnKqGocIHcJCtbwwHlxEeaxfsD",228,0.995633,30,229,1,228,1,1,0,1,1,116,116,113,112,10
"942",41,"[30]EeysHnKqGocIHcJCtbwwHlxEeaxfsD",216,0.995392,30,217,1,216,1,1,0,1,1,125,125,92,91,10
"943",42,"[30]EeysHnKqGocIHcJCtbwwHlxEeaxfsD",230,0.995671,30,231,1,230,1,1,0,1,1,114,114,117,116,10
"944",43,"[30]EeysHnKqGocIHcJCtbwwHlxEeaxfsD",229,0.995652,30,230,1,229,1,1,0,1,1,115,115,115,114,10
"945",44,"[30]EeysHnKqGocIHcJCtbwwHlxEeaxfsD",239,0.995833,30,240,1,239,1,1,0,1,1,111,111,129,128,10
"946",45,"[30]EeysHnKqGocIHcJCtbwwHlxEeaxfsD",224,0.995556,30,225,1,224,1,1,0,1,1,119,119,106,105,10
"947",46,"[30]EeysHnKqGocIHcJCtbwwHlxEeaxfsD",232,0.995708,30,233,1,232,1,1,0,1,1,114,114,119,118,10
"948",47,"[30]EeysHnKqGocIHcJCtbwwHlxEeaxfsD",237,0.995798,30,238,1,237,1,1,0,1,1,109,109,129,128,10
"949",48,"[30]EeysHnKqGocIHcJCtbwwHlxEeaxfsD",224,0.995556,30,225,1,224,1,1,0,1,1,122,122,103,102,10
"950",49,"[30]EeysHnKqGocIHcJCtbwwHlxEeaxfsD",230,0.995671,30,231,1,230,1,1,0,1,1,114,114,117,116,10
"951",50,"[30]EeysHnKqGocIHcJCtbwwHlxEeaxfsD",224,0.995556,30,225,1,224,1,1,0,1,1,120,120,105,104,10
"952",51,"[30]EeysHnKqGocIHcJCtbwwHlxEeaxfsD",232,0.995708,30,233,1,232,1,1,0,1,1,112,112,121,120,10
"953",52,"[30]EeysHnKqGocIHcJCtbwwHlxEeaxfsD",230,0.995671,30,231,1,230,1,1,0,1,1,119,119,112,111,10
"954",53,"[30]EeysHnKqGocIHcJCtbwwHlxEeaxfsD",233,0.995726,30,234,1,233,1,1,0,1,1,115,115,119,118,10
"955",54,"[30]EeysHnKqGocIHcJCtbwwHlxEeaxfsD",221,0.995495,30,222,1,221,1,1,0,1,1,122,122,100,99,10
"956",55,"[30]EeysHnKqGocIHcJCtbwwHlxEeaxfsD",232,0.995708,30,233,1,232,1,1,0,1,1,112,112,121,120,10
"957",56,"[30]EeysHnKqGocIHcJCtbwwHlxEeaxfsD",230,0.995671,30,231,1,230,1,1,0,1,1,115,115,116,115,10
"958",57,"[30]EeysHnKqGocIHcJCtbwwHlxEeaxfsD",236,0.995781,30,237,1,236,1,1,0,1,1,109,109,128,127,10
"959",58,"[30]EeysHnKqGocIHcJCtbwwHlxEeaxfsD",232,0.995708,30,233,1,232,1,1,0,1,1,112,112,121,120,10
"960",59,"[30]EeysHnKqGocIHcJCtbwwHlxEeaxfsD",233,0.995726,30,234,1,233,1,1,0,1,1,112,112,122,121,10
"961",60,"[30]EeysHnKqGocIHcJCtbwwHlxEeaxfsD",236,0.995781,30,237,1,236,1,1,0,1,1,111,111,126,125,10
"962",61,"[30]EeysHnKqGocIHcJCtbwwHlxEeaxfsD",240,0.995851,30,241,1,240,1,1,0,1,1,108,108,133,132,10
"963",62,"[30]EeysHnKqGocIHcJCtbwwHlxEeaxfsD",225,0.995575,30,226,1,225,1,1,0,1,1,119,119,107,106,10
"964",63,"[30]EeysHnKqGocIHcJCtbwwHlxEeaxfsD",236,0.995781,30,237,1,236,1,1,0,1,1,110,110,127,126,10
"965",64,"[30]EeysHnKqGocIHcJCtbwwHlxEeaxfsD",234,0.995745,30,235,1,234,1,1,0,1,1,112,112,123,122,10
"966",65,"[30]EeysHnKqGocIHcJCtbwwHlxEeaxfsD",231,0.99569,30,232,1,231,1,1,0,1,1,113,113,119,118,10
"967",66,"[30]EeysHnKqGocIHcJCtbwwHlxEeaxfsD",225,0.995575,30,226,1,225,1,1,0,1,1,119,119,107,106,10
"968",67,"[30]EeysHnKqGocIHcJCtbwwHlxEeaxfsD",222,0.995516,30,223,1,222,1,1,0,1,1,122,122,101,100,10
"969",68,"[30]EeysHnKqGocIHcJCtbwwHlxEeaxfsD",225,0.995575,30,226,1,225,1,1,0,1,1,119,119,107,106,10
"970",69,"[30]EeysHnKqGocIHcJCtbwwHlxEeaxfsD",237,0.995798,30,238,1,237,1,1,0,1,1,109,109,129,128,10
"971",70,"[30]EeysHnKqGocIHcJCtbwwHlxEeaxfsD",229,0.995652,30,230,1,229,1,1,0,1,1,116,116,114,113,10
"972",71,"[30]EeysHnKqGocIHcJCtbwwHlxEeaxfsD",234,0.995745,30,235,1,234,1,1,0,1,1,113,113,122,121,10
"973",72,"[30]EeysHnKqGocIHcJCtbwwHlxEeaxfsD",231,0.99569,30,232,1,231,1,1,0,1,1,113,113,119,118,10
"974",73,"[30]EeysHnKqGocIHcJCtbwwHlxEeaxfsD",233,0.995726,30,234,1,233,1,1,0,1,1,112,112,122,121,10
"975",74,"[30]EeysHnKqGocIHcJCtbwwHlxEeaxfsD",228,0.995633,30,229,1,228,1,1,0,1,1,116,116,113,112,10
"976",75,"[30]EeysHnKqGocIHcJCtbwwHlxEeaxfsD",227,0.995614,30,228,1,227,1,1,0,1,1,117,117,111,110,10
"977",76,"[30]EeysHnKqGocIHcJCtbwwHlxEeaxfsD",231,0.99569,30,232,1,231,1,1,0,1,1,113,113,119,118,10
"978",77,"[30]EeysHnKqGocIHcJCtbwwHlxEeaxfsD",235,0.995763,30,236,1,235,1,1,0,1,1,113,113,123,122,10
"979",78,"[30]EeysHnKqGocIHcJCtbwwHlxEeaxfsD",227,0.995614,30,228,1,227,1,1,0,1,1,117,117,111,110,10
"980",79,"[30]EeysHnKqGocIHcJCtbwwHlxEeaxfsD",221,0.995495,30,222,1,221,1,1,0,1,1,122,122,100,99,10
"981",80,"[30]EeysHnKqGocIHcJCtbwwHlxEeaxfsD",230,0.995671,30,231,1,230,1,1,0,1,1,114,114,117,116,10
"982",81,"[30]EeysHnKqGocIHcJCtbwwHlxEeaxfsD",231,0.99569,30,232,1,231,1,1,0,1,1,115,115,117,116,10
"983",82,"[30]EeysHnKqGocIHcJCtbwwHlxEeaxfsD",230,0.995671,30,231,1,230,1,1,0,1,1,116,116,115,114,10
"984",83,"[30]EeysHnKqGocIHcJCtbwwHlxEeaxfsD",237,0.995798,30,238,1,237,1,1,0,1,1,110,110,128,127,10
"985",84,"[30]EeysHnKqGocIHcJCtbwwHlxEeaxfsD",230,0.995671,30,231,1,230,1,1,0,1,1,115,115,116,115,10
"986",85,"[30]EeysHnKqGocIHcJCtbwwHlxEeaxfsD",238,0.995816,30,239,1,238,1,1,0,1,1,108,108,131,130,10
"987",86,"[30]EeysHnKqGocIHcJCtbwwHlxEeaxfsD",233,0.995726,30,234,1,233,1,1,0,1,1,117,117,117,116,10
"988",87,"[30]EeysHnKqGocIHcJCtbwwHlxEeaxfsD",231,0.99569,30,232,1,231,1,1,0,1,1,117,117,115,114,10
"989",88,"[30]EeysHnKqGocIHcJCtbwwHlxEeaxfsD",225,0.995575,30,226,1,225,1,1,0,1,1,118,118,108,107,10
"990",89,"[30]EeysHnKqGocIHcJCtbwwHlxEeaxfsD",221,0.995495,30,222,1,221,1,1,0,1,1,124,124,98,97,10
"991",90,"[30]EeysHnKqGocIHcJCtbwwHlxEeaxfsD",236,0.995781,30,237,1,236,1,1,0,1,1,109,109,128,127,10
"992",91,"[30]EeysHnKqGocIHcJCtbwwHlxEeaxfsD",222,0.995516,30,223,1,222,1,1,0,1,1,120,120,103,102,10
"993",92,"[30]EeysHnKqGocIHcJCtbwwHlxEeaxfsD",232,0.995708,30,233,1,232,1,1,0,1,1,112,112,121,120,10
"994",93,"[30]EeysHnKqGocIHcJCtbwwHlxEeaxfsD",239,0.995833,30,240,1,239,1,1,0,1,1,107,107,133,132,10
"995",94,"[30]EeysHnKqGocIHcJCtbwwHlxEeaxfsD",231,0.99569,30,232,1,231,1,1,0,1,1,113,113,119,118,10
"996",95,"[30]EeysHnKqGocIHcJCtbwwHlxEeaxfsD",237,0.995798,30,238,1,237,1,1,0,1,1,109,109,129,128,10
"997",96,"[30]EeysHnKqGocIHcJCtbwwHlxEeaxfsD",236,0.995781,30,237,1,236,1,1,0,1,1,111,111,126,125,10
"998",97,"[30]EeysHnKqGocIHcJCtbwwHlxEeaxfsD",208,0.995215,30,209,1,208,1,1,0,1,1,132,132,77,76,10
"999",98,"[30]EeysHnKqGocIHcJCtbwwHlxEeaxfsD",220,0.995475,30,221,1,220,1,1,0,1,1,125,125,96,95,10
"1000",99,"[30]EeysHnKqGocIHcJCtbwwHlxEeaxfsD",235,0.995763,30,236,1,235,1,1,0,1,1,111,111,125,124,10
"1001",0,"[29]EtKHwtHnKqGocIHcJCiAyAmuaBzoG",234,0.995745,29,235,1,234,1,1,0,1,1,111,111,124,123,11
"1002",1,"[29]EtKHwtHnKqGocIHcJCiAyAmuaBzoG",223,0.995536,29,224,1,223,1,1,0,1,1,123,123,101,100,11
"1003",2,"[29]EtKHwtHnKqGocIHcJCiAyAmuaBzoG",219,0.995455,29,220,1,219,1,1,0,1,1,124,124,96,95,11
"1004",3,"[29]EtKHwtHnKqGocIHcJCiAyAmuaBzoG",220,0.995475,29,221,1,220,1,1,0,1,1,123,123,98,97,11
"1005",4,"[29]EtKHwtHnKqGocIHcJCiAyAmuaBzoG",235,0.995763,29,236,1,235,1,1,0,1,1,111,111,125,124,11
"1006",5,"[29]EtKHwtHnKqGocIHcJCiAyAmuaBzoG",229,0.995652,29,230,1,229,1,1,0,1,1,115,115,115,114,11
"1007",6,"[29]EtKHwtHnKqGocIHcJCiAyAmuaBzoG",237,0.995798,29,238,1,237,1,1,0,1,1,111,111,127,126,11
"1008",7,"[29]EtKHwtHnKqGocIHcJCiAyAmuaBzoG",232,0.995708,29,233,1,232,1,1,0,1,1,115,115,118,117,11
"1009",8,"[29]EtKHwtHnKqGocIHcJCiAyAmuaBzoG",228,0.995633,29,229,1,228,1,1,0,1,1,117,117,112,111,11
"1010",9,"[29]EtKHwtHnKqGocIHcJCiAyAmuaBzoG",230,0.995671,29,231,1,230,1,1,0,1,1,114,114,117,116,11
"1011",10,"[29]EtKHwtHnKqGocIHcJCiAyAmuaBzoG",235,0.995763,29,236,1,235,1,1,0,1,1,110,110,126,125,11
"1012",11,"[29]EtKHwtHnKqGocIHcJCiAyAmuaBzoG",225,0.995575,29,226,1,225,1,1,0,1,1,121,121,105,104,11
"1013",12,"[29]EtKHwtHnKqGocIHcJCiAyAmuaBzoG",239,0.995833,29,240,1,239,1,1,0,1,1,107,107,133,132,11
"1014",13,"[29]EtKHwtHnKqGocIHcJCiAyAmuaBzoG",228,0.995633,29,229,1,228,1,1,0,1,1,118,118,111,110,11
"1015",14,"[29]EtKHwtHnKqGocIHcJCiAyAmuaBzoG",239,0.995833,29,240,1,239,1,1,0,1,1,114,114,126,125,11
"1016",15,"[29]EtKHwtHnKqGocIHcJCiAyAmuaBzoG",231,0.99569,29,232,1,231,1,1,0,1,1,114,114,118,117,11
"1017",16,"[29]EtKHwtHnKqGocIHcJCiAyAmuaBzoG",226,0.995595,29,227,1,226,1,1,0,1,1,118,118,109,108,11
"1018",17,"[29]EtKHwtHnKqGocIHcJCiAyAmuaBzoG",231,0.99569,29,232,1,231,1,1,0,1,1,114,114,118,117,11
"1019",18,"[29]EtKHwtHnKqGocIHcJCiAyAmuaBzoG",231,0.99569,29,232,1,231,1,1,0,1,1,116,116,116,115,11
"1020",19,"[29]EtKHwtHnKqGocIHcJCiAyAmuaBzoG",237,0.995798,29,238,1,237,1,1,0,1,1,110,110,128,127,11
"1021",20,"[29]EtKHwtHnKqGocIHcJCiAyAmuaBzoG",230,0.995671,29,231,1,230,1,1,0,1,1,115,115,116,115,11
"1022",21,"[29]EtKHwtHnKqGocIHcJCiAyAmuaBzoG",233,0.995726,29,234,1,233,1,1,0,1,1,113,113,121,120,11
"1023",22,"[29]EtKHwtHnKqGocIHcJCiAyAmuaBzoG",221,0.995495,29,222,1,221,1,1,0,1,1,123,123,99,98,11
"1024",23,"[29]EtKHwtHnKqGocIHcJCiAyAmuaBzoG",238,0.995816,29,239,1,238,1,1,0,1,1,116,116,123,122,11
"1025",24,"[29]EtKHwtHnKqGocIHcJCiAyAmuaBzoG",236,0.995781,29,237,1,236,1,1,0,1,1,111,111,126,125,11
"1026",25,"[29]EtKHwtHnKqGocIHcJCiAyAmuaBzoG",241,0.995868,29,242,1,241,1,1,0,1,1,106,106,136,135,11
"1027",26,"[29]EtKHwtHnKqGocIHcJCiAyAmuaBzoG",231,0.99569,29,232,1,231,1,1,0,1,1,115,115,117,116,11
"1028",27,"[29]EtKHwtHnKqGocIHcJCiAyAmuaBzoG",221,0.995495,29,222,1,221,1,1,0,1,1,126,126,96,95,11
"1029",28,"[29]EtKHwtHnKqGocIHcJCiAyAmuaBzoG",225,0.995575,29,226,1,225,1,1,0,1,1,119,119,107,106,11
"1030",29,"[29]EtKHwtHnKqGocIHcJCiAyAmuaBzoG",233,0.995726,29,234,1,233,1,1,0,1,1,115,115,119,118,11
"1031",30,"[29]EtKHwtHnKqGocIHcJCiAyAmuaBzoG",230,0.995671,29,231,1,230,1,1,0,1,1,114,114,117,116,11
"1032",31,"[29]EtKHwtHnKqGocIHcJCiAyAmuaBzoG",244,0.995918,29,245,1,244,1,1,0,1,1,103,103,142,141,11
"1033",32,"[29]EtKHwtHnKqGocIHcJCiAyAmuaBzoG",231,0.99569,29,232,1,231,1,1,0,1,1,115,115,117,116,11
"1034",33,"[29]EtKHwtHnKqGocIHcJCiAyAmuaBzoG",235,0.995763,29,236,1,235,1,1,0,1,1,111,111,125,124,11
"1035",34,"[29]EtKHwtHnKqGocIHcJCiAyAmuaBzoG",233,0.995726,29,234,1,233,1,1,0,1,1,114,114,120,119,11
"1036",35,"[29]EtKHwtHnKqGocIHcJCiAyAmuaBzoG",226,0.995595,29,227,1,226,1,1,0,1,1,118,118,109,108,11
"1037",36,"[29]EtKHwtHnKqGocIHcJCiAyAmuaBzoG",230,0.995671,29,231,1,230,1,1,0,1,1,114,114,117,116,11
"1038",37,"[29]EtKHwtHnKqGocIHcJCiAyAmuaBzoG",224,0.995556,29,225,1,224,1,1,0,1,1,120,120,105,104,11
"1039",38,"[29]EtKHwtHnKqGocIHcJCiAyAmuaBzoG",230,0.995671,29,231,1,230,1,1,0,1,1,115,115,116,115,11
"1040",39,"[29]EtKHwtHnKqGocIHcJCiAyAmuaBzoG",228,0.995633,29,229,1,228,1,1,0,1,1,118,118,111,110,11
"1041",40,"[29]EtKHwtHnKqGocIHcJCiAyAmuaBzoG",233,0.995726,29,234,1,233,1,1,0,1,1,113,113,121,120,11
"1042",41,"[29]EtKHwtHnKqGocIHcJCiAyAmuaBzoG",229,0.995652,29,230,1,229,1,1,0,1,1,115,115,115,114,11
"1043",42,"[29]EtKHwtHnKqGocIHcJCiAyAmuaBzoG",220,0.995475,29,221,1,220,1,1,0,1,1,125,125,96,95,11
"1044",43,"[29]EtKHwtHnKqGocIHcJCiAyAmuaBzoG",228,0.995633,29,229,1,228,1,1,0,1,1,116,116,113,112,11
"1045",44,"[29]EtKHwtHnKqGocIHcJCiAyAmuaBzoG",218,0.995434,29,219,1,218,1,1,0,1,1,125,125,94,93,11
"1046",45,"[29]EtKHwtHnKqGocIHcJCiAyAmuaBzoG",230,0.995671,29,231,1,230,1,1,0,1,1,116,116,115,114,11
"1047",46,"[29]EtKHwtHnKqGocIHcJCiAyAmuaBzoG",223,0.995536,29,224,1,223,1,1,0,1,1,120,120,104,103,11
"1048",47,"[29]EtKHwtHnKqGocIHcJCiAyAmuaBzoG",226,0.995595,29,227,1,226,1,1,0,1,1,119,119,108,107,11
"1049",48,"[29]EtKHwtHnKqGocIHcJCiAyAmuaBzoG",228,0.995633,29,229,1,228,1,1,0,1,1,116,116,113,112,11
"1050",49,"[29]EtKHwtHnKqGocIHcJCiAyAmuaBzoG",228,0.995633,29,229,1,228,1,1,0,1,1,119,119,110,109,11
"1051",50,"[29]EtKHwtHnKqGocIHcJCiAyAmuaBzoG",228,0.995633,29,229,1,228,1,1,0,1,1,116,116,113,112,11
"1052",51,"[29]EtKHwtHnKqGocIHcJCiAyAmuaBzoG",236,0.995781,29,237,1,236,1,1,0,1,1,110,110,127,126,11
"1053",52,"[29]EtKHwtHnKqGocIHcJCiAyAmuaBzoG",230,0.995671,29,231,1,230,1,1,0,1,1,115,115,116,115,11
"1054",53,"[29]EtKHwtHnKqGocIHcJCiAyAmuaBzoG",225,0.995575,29,226,1,225,1,1,0,1,1,118,118,108,107,11
"1055",54,"[29]EtKHwtHnKqGocIHcJCiAyAmuaBzoG",217,0.995413,29,218,1,217,1,1,0,1,1,125,125,93,92,11
"1056",55,"[29]EtKHwtHnKqGocIHcJCiAyAmuaBzoG",229,0.995652,29,230,1,229,1,1,0,1,1,117,117,113,112,11
"1057",56,"[29]EtKHwtHnKqGocIHcJCiAyAmuaBzoG",225,0.995575,29,226,1,225,1,1,0,1,1,121,121,105,104,11
"1058",57,"[29]EtKHwtHnKqGocIHcJCiAyAmuaBzoG",229,0.995652,29,230,1,229,1,1,0,1,1,117,117,113,112,11
"1059",58,"[29]EtKHwtHnKqGocIHcJCiAyAmuaBzoG",229,0.995652,29,230,1,229,1,1,0,1,1,116,116,114,113,11
"1060",59,"[29]EtKHwtHnKqGocIHcJCiAyAmuaBzoG",240,0.995851,29,241,1,240,1,1,0,1,1,107,107,134,133,11
"1061",60,"[29]EtKHwtHnKqGocIHcJCiAyAmuaBzoG",232,0.995708,29,233,1,232,1,1,0,1,1,114,114,119,118,11
"1062",61,"[29]EtKHwtHnKqGocIHcJCiAyAmuaBzoG",233,0.995726,29,234,1,233,1,1,0,1,1,112,112,122,121,11
"1063",62,"[29]EtKHwtHnKqGocIHcJCiAyAmuaBzoG",223,0.995536,29,224,1,223,1,1,0,1,1,120,120,104,103,11
"1064",63,"[29]EtKHwtHnKqGocIHcJCiAyAmuaBzoG",236,0.995781,29,237,1,236,1,1,0,1,1,112,112,125,124,11
"1065",64,"[29]EtKHwtHnKqGocIHcJCiAyAmuaBzoG",234,0.995745,29,235,1,234,1,1,0,1,1,111,111,124,123,11
"1066",65,"[29]EtKHwtHnKqGocIHcJCiAyAmuaBzoG",225,0.995575,29,226,1,225,1,1,0,1,1,121,121,105,104,11
"1067",66,"[29]EtKHwtHnKqGocIHcJCiAyAmuaBzoG",234,0.995745,29,235,1,234,1,1,0,1,1,112,112,123,122,11
"1068",67,"[29]EtKHwtHnKqGocIHcJCiAyAmuaBzoG",229,0.995652,29,230,1,229,1,1,0,1,1,115,115,115,114,11
"1069",68,"[29]EtKHwtHnKqGocIHcJCiAyAmuaBzoG",232,0.995708,29,233,1,232,1,1,0,1,1,114,114,119,118,11
"1070",69,"[29]EtKHwtHnKqGocIHcJCiAyAmuaBzoG",229,0.995652,29,230,1,229,1,1,0,1,1,118,118,112,111,11
"1071",70,"[29]EtKHwtHnKqGocIHcJCiAyAmuaBzoG",235,0.995763,29,236,1,235,1,1,0,1,1,110,110,126,125,11
"1072",71,"[29]EtKHwtHnKqGocIHcJCiAyAmuaBzoG",229,0.995652,29,230,1,229,1,1,0,1,1,115,115,115,114,11
"1073",72,"[29]EtKHwtHnKqGocIHcJCiAyAmuaBzoG",220,0.995475,29,221,1,220,1,1,0,1,1,122,122,99,98,11
"1074",73,"[29]EtKHwtHnKqGocIHcJCiAyAmuaBzoG",233,0.995726,29,234,1,233,1,1,0,1,1,114,114,120,119,11
"1075",74,"[29]EtKHwtHnKqGocIHcJCiAyAmuaBzoG",228,0.995633,29,229,1,228,1,1,0,1,1,118,118,111,110,11
"1076",75,"[29]EtKHwtHnKqGocIHcJCiAyAmuaBzoG",226,0.995595,29,227,1,226,1,1,0,1,1,118,118,109,108,11
"1077",76,"[29]EtKHwtHnKqGocIHcJCiAyAmuaBzoG",225,0.995575,29,226,1,225,1,1,0,1,1,118,118,108,107,11
"1078",77,"[29]EtKHwtHnKqGocIHcJCiAyAmuaBzoG",234,0.995745,29,235,1,234,1,1,0,1,1,111,111,124,123,11
"1079",78,"[29]EtKHwtHnKqGocIHcJCiAyAmuaBzoG",234,0.995745,29,235,1,234,1,1,0,1,1,111,111,124,123,11
"1080",79,"[29]EtKHwtHnKqGocIHcJCiAyAmuaBzoG",225,0.995575,29,226,1,225,1,1,0,1,1,119,119,107,106,11
"1081",80,"[29]EtKHwtHnKqGocIHcJCiAyAmuaBzoG",234,0.995745,29,235,1,234,1,1,0,1,1,112,112,123,122,11
"1082",81,"[29]EtKHwtHnKqGocIHcJCiAyAmuaBzoG",221,0.995495,29,222,1,221,1,1,0,1,1,124,124,98,97,11
"1083",82,"[29]EtKHwtHnKqGocIHcJCiAyAmuaBzoG",233,0.995726,29,234,1,233,1,1,0,1,1,112,112,122,121,11
"1084",83,"[29]EtKHwtHnKqGocIHcJCiAyAmuaBzoG",217,0.995413,29,218,1,217,1,1,0,1,1,125,125,93,92,11
"1085",84,"[29]EtKHwtHnKqGocIHcJCiAyAmuaBzoG",230,0.995671,29,231,1,230,1,1,0,1,1,115,115,116,115,11
"1086",85,"[29]EtKHwtHnKqGocIHcJCiAyAmuaBzoG",232,0.995708,29,233,1,232,1,1,0,1,1,114,114,119,118,11
"1087",86,"[29]EtKHwtHnKqGocIHcJCiAyAmuaBzoG",249,0.996,29,250,1,249,1,1,0,1,1,99,99,151,150,11
"1088",87,"[29]EtKHwtHnKqGocIHcJCiAyAmuaBzoG",228,0.995633,29,229,1,228,1,1,0,1,1,116,116,113,112,11
"1089",88,"[29]EtKHwtHnKqGocIHcJCiAyAmuaBzoG",227,0.995614,29,228,1,227,1,1,0,1,1,117,117,111,110,11
"1090",89,"[29]EtKHwtHnKqGocIHcJCiAyAmuaBzoG",239,0.995833,29,240,1,239,1,1,0,1,1,116,116,124,123,11
"1091",90,"[29]EtKHwtHnKqGocIHcJCiAyAmuaBzoG",229,0.995652,29,230,1,229,1,1,0,1,1,120,120,110,109,11
"1092",91,"[29]EtKHwtHnKqGocIHcJCiAyAmuaBzoG",237,0.995798,29,238,1,237,1,1,0,1,1,111,111,127,126,11
"1093",92,"[29]EtKHwtHnKqGocIHcJCiAyAmuaBzoG",233,0.995726,29,234,1,233,1,1,0,1,1,112,112,122,121,11
"1094",93,"[29]EtKHwtHnKqGocIHcJCiAyAmuaBzoG",235,0.995763,29,236,1,235,1,1,0,1,1,111,111,125,124,11
"1095",94,"[29]EtKHwtHnKqGocIHcJCiAyAmuaBzoG",235,0.995763,29,236,1,235,1,1,0,1,1,113,113,123,122,11
"1096",95,"[29]EtKHwtHnKqGocIHcJCiAyAmuaBzoG",228,0.995633,29,229,1,228,1,1,0,1,1,117,117,112,111,11
"1097",96,"[29]EtKHwtHnKqGocIHcJCiAyAmuaBzoG",229,0.995652,29,230,1,229,1,1,0,1,1,116,116,114,113,11
"1098",97,"[29]EtKHwtHnKqGocIHcJCiAyAmuaBzoG",238,0.995816,29,239,1,238,1,1,0,1,1,108,108,131,130,11
"1099",98,"[29]EtKHwtHnKqGocIHcJCiAyAmuaBzoG",227,0.995614,29,228,1,227,1,1,0,1,1,117,117,111,110,11
"1100",99,"[29]EtKHwtHnKqGocIHcJCiAyAmuaBzoG",238,0.995816,29,239,1,238,1,1,0,1,1,109,109,130,129,11
"1101",0,"[28]EvioDtHnKqGocIHBJCvlHEaHnGsr",234,0.995745,28,235,1,234,1,1,0,1,1,115,115,120,119,12
"1102",1,"[28]EvioDtHnKqGocIHBJCvlHEaHnGsr",227,0.995614,28,228,1,227,1,1,0,1,1,117,117,111,110,12
"1103",2,"[28]EvioDtHnKqGocIHBJCvlHEaHnGsr",223,0.995536,28,224,1,223,1,1,0,1,1,119,119,105,104,12
"1104",3,"[28]EvioDtHnKqGocIHBJCvlHEaHnGsr",230,0.995671,28,231,1,230,1,1,0,1,1,117,117,114,113,12
"1105",4,"[28]EvioDtHnKqGocIHBJCvlHEaHnGsr",222,0.995516,28,223,1,222,1,1,0,1,1,120,120,103,102,12
"1106",5,"[28]EvioDtHnKqGocIHBJCvlHEaHnGsr",236,0.995781,28,237,1,236,1,1,0,1,1,109,109,128,127,12
"1107",6,"[28]EvioDtHnKqGocIHBJCvlHEaHnGsr",236,0.995781,28,237,1,236,1,1,0,1,1,111,111,126,125,12
"1108",7,"[28]EvioDtHnKqGocIHBJCvlHEaHnGsr",223,0.995536,28,224,1,223,1,1,0,1,1,119,119,105,104,12
"1109",8,"[28]EvioDtHnKqGocIHBJCvlHEaHnGsr",246,0.995951,28,247,1,246,1,1,0,1,1,104,104,143,142,12
"1110",9,"[28]EvioDtHnKqGocIHBJCvlHEaHnGsr",220,0.995475,28,221,1,220,1,1,0,1,1,122,122,99,98,12
"1111",10,"[28]EvioDtHnKqGocIHBJCvlHEaHnGsr",246,0.995951,28,247,1,246,1,1,0,1,1,102,102,145,144,12
"1112",11,"[28]EvioDtHnKqGocIHBJCvlHEaHnGsr",224,0.995556,28,225,1,224,1,1,0,1,1,121,121,104,103,12
"1113",12,"[28]EvioDtHnKqGocIHBJCvlHEaHnGsr",220,0.995475,28,221,1,220,1,1,0,1,1,123,123,98,97,12
"1114",13,"[28]EvioDtHnKqGocIHBJCvlHEaHnGsr",234,0.995745,28,235,1,234,1,1,0,1,1,113,113,122,121,12
"1115",14,"[28]EvioDtHnKqGocIHBJCvlHEaHnGsr",227,0.995614,28,228,1,227,1,1,0,1,1,118,118,110,109,12
"1116",15,"[28]EvioDtHnKqGocIHBJCvlHEaHnGsr",220,0.995475,28,221,1,220,1,1,0,1,1,123,123,98,97,12
"1117",16,"[28]EvioDtHnKqGocIHBJCvlHEaHnGsr",236,0.995781,28,237,1,236,1,1,0,1,1,109,109,128,127,12
"1118",17,"[28]EvioDtHnKqGocIHBJCvlHEaHnGsr",232,0.995708,28,233,1,232,1,1,0,1,1,114,114,119,118,12
"1119",18,"[28]EvioDtHnKqGocIHBJCvlHEaHnGsr",227,0.995614,28,228,1,227,1,1,0,1,1,117,117,111,110,12
"1120",19,"[28]EvioDtHnKqGocIHBJCvlHEaHnGsr",232,0.995708,28,233,1,232,1,1,0,1,1,115,115,118,117,12
"1121",20,"[28]EvioDtHnKqGocIHBJCvlHEaHnGsr",231,0.99569,28,232,1,231,1,1,0,1,1,113,113,119,118,12
"1122",21,"[28]EvioDtHnKqGocIHBJCvlHEaHnGsr",231,0.99569,28,232,1,231,1,1,0,1,1,114,114,118,117,12
"1123",22,"[28]EvioDtHnKqGocIHBJCvlHEaHnGsr",235,0.995763,28,236,1,235,1,1,0,1,1,111,111,125,124,12
"1124",23,"[28]EvioDtHnKqGocIHBJCvlHEaHnGsr",233,0.995726,28,234,1,233,1,1,0,1,1,112,112,122,121,12
"1125",24,"[28]EvioDtHnKqGocIHBJCvlHEaHnGsr",233,0.995726,28,234,1,233,1,1,0,1,1,112,112,122,121,12
"1126",25,"[28]EvioDtHnKqGocIHBJCvlHEaHnGsr",240,0.995851,28,241,1,240,1,1,0,1,1,106,106,135,134,12
"1127",26,"[28]EvioDtHnKqGocIHBJCvlHEaHnGsr",234,0.995745,28,235,1,234,1,1,0,1,1,111,111,124,123,12
"1128",27,"[28]EvioDtHnKqGocIHBJCvlHEaHnGsr",233,0.995726,28,234,1,233,1,1,0,1,1,115,115,119,118,12
"1129",28,"[28]EvioDtHnKqGocIHBJCvlHEaHnGsr",232,0.995708,28,233,1,232,1,1,0,1,1,114,114,119,118,12
"1130",29,"[28]EvioDtHnKqGocIHBJCvlHEaHnGsr",225,0.995575,28,226,1,225,1,1,0,1,1,119,119,107,106,12
"1131",30,"[28]EvioDtHnKqGocIHBJCvlHEaHnGsr",221,0.995495,28,222,1,221,1,1,0,1,1,122,122,100,99,12
"1132",31,"[28]EvioDtHnKqGocIHBJCvlHEaHnGsr",223,0.995536,28,224,1,223,1,1,0,1,1,123,123,101,100,12
"1133",32,"[28]EvioDtHnKqGocIHBJCvlHEaHnGsr",234,0.995745,28,235,1,234,1,1,0,1,1,112,112,123,122,12
"1134",33,"[28]EvioDtHnKqGocIHBJCvlHEaHnGsr",223,0.995536,28,224,1,223,1,1,0,1,1,121,121,103,102,12
"1135",34,"[28]EvioDtHnKqGocIHBJCvlHEaHnGsr",234,0.995745,28,235,1,234,1,1,0,1,1,111,111,124,123,12
"1136",35,"[28]EvioDtHnKqGocIHBJCvlHEaHnGsr",230,0.995671,28,231,1,230,1,1,0,1,1,115,115,116,115,12
"1137",36,"[28]EvioDtHnKqGocIHBJCvlHEaHnGsr",231,0.99569,28,232,1,231,1,1,0,1,1,115,115,117,116,12
"1138",37,"[28]EvioDtHnKqGocIHBJCvlHEaHnGsr",220,0.995475,28,221,1,220,1,1,0,1,1,123,123,98,97,12
"1139",38,"[28]EvioDtHnKqGocIHBJCvlHEaHnGsr",234,0.995745,28,235,1,234,1,1,0,1,1,111,111,124,123,12
"1140",39,"[28]EvioDtHnKqGocIHBJCvlHEaHnGsr",224,0.995556,28,225,1,224,1,1,0,1,1,119,119,106,105,12
"1141",40,"[28]EvioDtHnKqGocIHBJCvlHEaHnGsr",243,0.995902,28,244,1,243,1,1,0,1,1,104,104,140,139,12
"1142",41,"[28]EvioDtHnKqGocIHBJCvlHEaHnGsr",238,0.995816,28,239,1,238,1,1,0,1,1,107,107,132,131,12
"1143",42,"[28]EvioDtHnKqGocIHBJCvlHEaHnGsr",241,0.995868,28,242,1,241,1,1,0,1,1,108,108,134,133,12
"1144",43,"[28]EvioDtHnKqGocIHBJCvlHEaHnGsr",239,0.995833,28,240,1,239,1,1,0,1,1,114,114,126,125,12
"1145",44,"[28]EvioDtHnKqGocIHBJCvlHEaHnGsr",230,0.995671,28,231,1,230,1,1,0,1,1,115,115,116,115,12
"1146",45,"[28]EvioDtHnKqGocIHBJCvlHEaHnGsr",228,0.995633,28,229,1,228,1,1,0,1,1,116,116,113,112,12
"1147",46,"[28]EvioDtHnKqGocIHBJCvlHEaHnGsr",231,0.99569,28,232,1,231,1,1,0,1,1,114,114,118,117,12
"1148",47,"[28]EvioDtHnKqGocIHBJCvlHEaHnGsr",223,0.995536,28,224,1,223,1,1,0,1,1,120,120,104,103,12
"1149",48,"[28]EvioDtHnKqGocIHBJCvlHEaHnGsr",231,0.99569,28,232,1,231,1,1,0,1,1,113,113,119,118,12
"1150",49,"[28]EvioDtHnKqGocIHBJCvlHEaHnGsr",238,0.995816,28,239,1,238,1,1,0,1,1,107,107,132,131,12
"1151",50,"[28]EvioDtHnKqGocIHBJCvlHEaHnGsr",222,0.995516,28,223,1,222,1,1,0,1,1,120,120,103,102,12
"1152",51,"[28]EvioDtHnKqGocIHBJCvlHEaHnGsr",229,0.995652,28,230,1,229,1,1,0,1,1,116,116,114,113,12
"1153",52,"[28]EvioDtHnKqGocIHBJCvlHEaHnGsr",226,0.995595,28,227,1,226,1,1,0,1,1,118,118,109,108,12
"1154",53,"[28]EvioDtHnKqGocIHBJCvlHEaHnGsr",233,0.995726,28,234,1,233,1,1,0,1,1,113,113,121,120,12
"1155",54,"[28]EvioDtHnKqGocIHBJCvlHEaHnGsr",239,0.995833,28,240,1,239,1,1,0,1,1,107,107,133,132,12
"1156",55,"[28]EvioDtHnKqGocIHBJCvlHEaHnGsr",230,0.995671,28,231,1,230,1,1,0,1,1,115,115,116,115,12
"1157",56,"[28]EvioDtHnKqGocIHBJCvlHEaHnGsr",237,0.995798,28,238,1,237,1,1,0,1,1,109,109,129,128,12
"1158",57,"[28]EvioDtHnKqGocIHBJCvlHEaHnGsr",257,0.996124,28,258,1,257,1,1,0,1,1,98,98,160,159,12
"1159",58,"[28]EvioDtHnKqGocIHBJCvlHEaHnGsr",230,0.995671,28,231,1,230,1,1,0,1,1,115,115,116,115,12
"1160",59,"[28]EvioDtHnKqGocIHBJCvlHEaHnGsr",231,0.99569,28,232,1,231,1,1,0,1,1,114,114,118,117,12
"1161",60,"[28]EvioDtHnKqGocIHBJCvlHEaHnGsr",230,0.995671,28,231,1,230,1,1,0,1,1,114,114,117,116,12
"1162",61,"[28]EvioDtHnKqGocIHBJCvlHEaHnGsr",227,0.995614,28,228,1,227,1,1,0,1,1,116,116,112,111,12
"1163",62,"[28]EvioDtHnKqGocIHBJCvlHEaHnGsr",233,0.995726,28,234,1,233,1,1,0,1,1,111,111,123,122,12
"1164",63,"[28]EvioDtHnKqGocIHBJCvlHEaHnGsr",223,0.995536,28,224,1,223,1,1,0,1,1,121,121,103,102,12
"1165",64,"[28]EvioDtHnKqGocIHBJCvlHEaHnGsr",219,0.995455,28,220,1,219,1,1,0,1,1,123,123,97,96,12
"1166",65,"[28]EvioDtHnKqGocIHBJCvlHEaHnGsr",224,0.995556,28,225,1,224,1,1,0,1,1,120,120,105,104,12
"1167",66,"[28]EvioDtHnKqGocIHBJCvlHEaHnGsr",225,0.995575,28,226,1,225,1,1,0,1,1,118,118,108,107,12
"1168",67,"[28]EvioDtHnKqGocIHBJCvlHEaHnGsr",229,0.995652,28,230,1,229,1,1,0,1,1,117,117,113,112,12
"1169",68,"[28]EvioDtHnKqGocIHBJCvlHEaHnGsr",237,0.995798,28,238,1,237,1,1,0,1,1,108,108,130,129,12
"1170",69,"[28]EvioDtHnKqGocIHBJCvlHEaHnGsr",239,0.995833,28,240,1,239,1,1,0,1,1,108,108,132,131,12
"1171",70,"[28]EvioDtHnKqGocIHBJCvlHEaHnGsr",223,0.995536,28,224,1,223,1,1,0,1,1,120,120,104,103,12
"1172",71,"[28]EvioDtHnKqGocIHBJCvlHEaHnGsr",226,0.995595,28,227,1,226,1,1,0,1,1,118,118,109,108,12
"1173",72,"[28]EvioDtHnKqGocIHBJCvlHEaHnGsr",236,0.995781,28,237,1,236,1,1,0,1,1,109,109,128,127,12
"1174",73,"[28]EvioDtHnKqGocIHBJCvlHEaHnGsr",220,0.995475,28,221,1,220,1,1,0,1,1,123,123,98,97,12
"1175",74,"[28]EvioDtHnKqGocIHBJCvlHEaHnGsr",226,0.995595,28,227,1,226,1,1,0,1,1,117,117,110,109,12
"1176",75,"[28]EvioDtHnKqGocIHBJCvlHEaHnGsr",231,0.99569,28,232,1,231,1,1,0,1,1,116,116,116,115,12
"1177",76,"[28]EvioDtHnKqGocIHBJCvlHEaHnGsr",238,0.995816,28,239,1,238,1,1,0,1,1,109,109,130,129,12
"1178",77,"[28]EvioDtHnKqGocIHBJCvlHEaHnGsr",221,0.995495,28,222,1,221,1,1,0,1,1,123,123,99,98,12
"1179",78,"[28]EvioDtHnKqGocIHBJCvlHEaHnGsr",233,0.995726,28,234,1,233,1,1,0,1,1,112,112,122,121,12
"1180",79,"[28]EvioDtHnKqGocIHBJCvlHEaHnGsr",226,0.995595,28,227,1,226,1,1,0,1,1,119,119,108,107,12
"1181",80,"[28]EvioDtHnKqGocIHBJCvlHEaHnGsr",226,0.995595,28,227,1,226,1,1,0,1,1,117,117,110,109,12
"1182",81,"[28]EvioDtHnKqGocIHBJCvlHEaHnGsr",231,0.99569,28,232,1,231,1,1,0,1,1,113,113,119,118,12
"1183",82,"[28]EvioDtHnKqGocIHBJCvlHEaHnGsr",233,0.995726,28,234,1,233,1,1,0,1,1,113,113,121,120,12
"1184",83,"[28]EvioDtHnKqGocIHBJCvlHEaHnGsr",236,0.995781,28,237,1,236,1,1,0,1,1,109,109,128,127,12
"1185",84,"[28]EvioDtHnKqGocIHBJCvlHEaHnGsr",228,0.995633,28,229,1,228,1,1,0,1,1,116,116,113,112,12
"1186",85,"[28]EvioDtHnKqGocIHBJCvlHEaHnGsr",227,0.995614,28,228,1,227,1,1,0,1,1,116,116,112,111,12
"1187",86,"[28]EvioDtHnKqGocIHBJCvlHEaHnGsr",228,0.995633,28,229,1,228,1,1,0,1,1,116,116,113,112,12
"1188",87,"[28]EvioDtHnKqGocIHBJCvlHEaHnGsr",220,0.995475,28,221,1,220,1,1,0,1,1,122,122,99,98,12
"1189",88,"[28]EvioDtHnKqGocIHBJCvlHEaHnGsr",234,0.995745,28,235,1,234,1,1,0,1,1,111,111,124,123,12
"1190",89,"[28]EvioDtHnKqGocIHBJCvlHEaHnGsr",224,0.995556,28,225,1,224,1,1,0,1,1,119,119,106,105,12
"1191",90,"[28]EvioDtHnKqGocIHBJCvlHEaHnGsr",230,0.995671,28,231,1,230,1,1,0,1,1,114,114,117,116,12
"1192",91,"[28]EvioDtHnKqGocIHBJCvlHEaHnGsr",227,0.995614,28,228,1,227,1,1,0,1,1,118,118,110,109,12
"1193",92,"[28]EvioDtHnKqGocIHBJCvlHEaHnGsr",225,0.995575,28,226,1,225,1,1,0,1,1,119,119,107,106,12
"1194",93,"[28]EvioDtHnKqGocIHBJCvlHEaHnGsr",244,0.995918,28,245,1,244,1,1,0,1,1,103,103,142,141,12
"1195",94,"[28]EvioDtHnKqGocIHBJCvlHEaHnGsr",221,0.995495,28,222,1,221,1,1,0,1,1,121,121,101,100,12
"1196",95,"[28]EvioDtHnKqGocIHBJCvlHEaHnGsr",228,0.995633,28,229,1,228,1,1,0,1,1,116,116,113,112,12
"1197",96,"[28]EvioDtHnKqGocIHBJCvlHEaHnGsr",226,0.995595,28,227,1,226,1,1,0,1,1,117,117,110,109,12
"1198",97,"[28]EvioDtHnKqGocIHBJCvlHEaHnGsr",234,0.995745,28,235,1,234,1,1,0,1,1,112,112,123,122,12
"1199",98,"[28]EvioDtHnKqGocIHBJCvlHEaHnGsr",231,0.99569,28,232,1,231,1,1,0,1,1,113,113,119,118,12
"1200",99,"[28]EvioDtHnKqGocIHBJCvlHEaHnGsr",228,0.995633,28,229,1,228,1,1,0,1,1,117,117,112,111,12
"1201",0,"[35]EDKGofafjutnKHqocIHcJHqJGHCeuypqssA",311,0.996795,35,312,1,311,1,1,0,1,1,149,149,163,162,13
"1202",1,"[35]EDKGofafjutnKHqocIHcJHqJGHCeuypqssA",312,0.996805,35,313,1,312,1,1,0,1,1,164,164,149,148,13
"1203",2,"[35]EDKGofafjutnKHqocIHcJHqJGHCeuypqssA",309,0.996774,35,310,1,309,1,1,0,1,1,154,154,156,155,13
"1204",3,"[35]EDKGofafjutnKHqocIHcJHqJGHCeuypqssA",310,0.996785,35,311,1,310,1,1,0,1,1,149,149,162,161,13
"1205",4,"[35]EDKGofafjutnKHqocIHcJHqJGHCeuypqssA",312,0.996805,35,313,1,312,1,1,0,1,1,154,154,159,158,13
"1206",5,"[35]EDKGofafjutnKHqocIHcJHqJGHCeuypqssA",306,0.996743,35,307,1,306,1,1,0,1,1,157,157,150,149,13
"1207",6,"[35]EDKGofafjutnKHqocIHcJHqJGHCeuypqssA",310,0.996785,35,311,1,310,1,1,0,1,1,153,153,158,157,13
"1208",7,"[35]EDKGofafjutnKHqocIHcJHqJGHCeuypqssA",305,0.996732,35,306,1,305,1,1,0,1,1,152,152,154,153,13
"1209",8,"[35]EDKGofafjutnKHqocIHcJHqJGHCeuypqssA",325,0.996933,35,326,1,325,1,1,0,1,1,151,151,175,174,13
"1210",9,"[35]EDKGofafjutnKHqocIHcJHqJGHCeuypqssA",311,0.996795,35,312,1,311,1,1,0,1,1,137,137,175,174,13
"1211",10,"[35]EDKGofafjutnKHqocIHcJHqJGHCeuypqssA",305,0.996732,35,306,1,305,1,1,0,1,1,152,152,154,153,13
"1212",11,"[35]EDKGofafjutnKHqocIHcJHqJGHCeuypqssA",323,0.996914,35,324,1,323,1,1,0,1,1,155,155,169,168,13
"1213",12,"[35]EDKGofafjutnKHqocIHcJHqJGHCeuypqssA",313,0.996815,35,314,1,313,1,1,0,1,1,158,158,156,155,13
"1214",13,"[35]EDKGofafjutnKHqocIHcJHqJGHCeuypqssA",309,0.996774,35,310,1,309,1,1,0,1,1,149,149,161,160,13
"1215",14,"[35]EDKGofafjutnKHqocIHcJHqJGHCeuypqssA",310,0.996785,35,311,1,310,1,1,0,1,1,150,150,161,160,13
"1216",15,"[35]EDKGofafjutnKHqocIHcJHqJGHCeuypqssA",311,0.996795,35,312,1,311,1,1,0,1,1,152,152,160,159,13
"1217",16,"[35]EDKGofafjutnKHqocIHcJHqJGHCeuypqssA",314,0.996825,35,315,1,314,1,1,0,1,1,144,144,171,170,13
"1218",17,"[35]EDKGofafjutnKHqocIHcJHqJGHCeuypqssA",304,0.996721,35,305,1,304,1,1,0,1,1,164,164,141,140,13
"1219",18,"[35]EDKGofafjutnKHqocIHcJHqJGHCeuypqssA",307,0.996753,35,308,1,307,1,1,0,1,1,155,155,153,152,13
"1220",19,"[35]EDKGofafjutnKHqocIHcJHqJGHCeuypqssA",313,0.996815,35,314,1,313,1,1,0,1,1,165,165,149,148,13
"1221",20,"[35]EDKGofafjutnKHqocIHcJHqJGHCeuypqssA",305,0.996732,35,306,1,305,1,1,0,1,1,153,153,153,152,13
"1222",21,"[35]EDKGofafjutnKHqocIHcJHqJGHCeuypqssA",303,0.996711,35,304,1,303,1,1,0,1,1,150,150,154,153,13
"1223",22,"[35]EDKGofafjutnKHqocIHcJHqJGHCeuypqssA",305,0.996732,35,306,1,305,1,1,0,1,1,155,155,151,150,13
"1224",23,"[35]EDKGofafjutnKHqocIHcJHqJGHCeuypqssA",318,0.996865,35,319,1,318,1,1,0,1,1,150,150,169,168,13
"1225",24,"[35]EDKGofafjutnKHqocIHcJHqJGHCeuypqssA",309,0.996774,35,310,1,309,1,1,0,1,1,152,152,158,157,13
"1226",25,"[35]EDKGofafjutnKHqocIHcJHqJGHCeuypqssA",306,0.996743,35,307,1,306,1,1,0,1,1,153,153,154,153,13
"1227",26,"[35]EDKGofafjutnKHqocIHcJHqJGHCeuypqssA",306,0.996743,35,307,1,306,1,1,0,1,1,160,160,147,146,13
"1228",27,"[35]EDKGofafjutnKHqocIHcJHqJGHCeuypqssA",315,0.996835,35,316,1,315,1,1,0,1,1,143,143,173,172,13
"1229",28,"[35]EDKGofafjutnKHqocIHcJHqJGHCeuypqssA",308,0.996764,35,309,1,308,1,1,0,1,1,159,159,150,149,13
"1230",29,"[35]EDKGofafjutnKHqocIHcJHqJGHCeuypqssA",305,0.996732,35,306,1,305,1,1,0,1,1,163,163,143,142,13
"1231",30,"[35]EDKGofafjutnKHqocIHcJHqJGHCeuypqssA",321,0.996894,35,322,1,321,1,1,0,1,1,152,152,170,169,13
"1232",31,"[35]EDKGofafjutnKHqocIHcJHqJGHCeuypqssA",298,0.996656,35,299,1,298,1,1,0,1,1,163,163,136,135,13
"1233",32,"[35]EDKGofafjutnKHqocIHcJHqJGHCeuypqssA",318,0.996865,35,319,1,318,1,1,0,1,1,154,154,165,164,13
"1234",33,"[35]EDKGofafjutnKHqocIHcJHqJGHCeuypqssA",325,0.996933,35,326,1,325,1,1,0,1,1,153,153,173,172,13
"1235",34,"[35]EDKGofafjutnKHqocIHcJHqJGHCeuypqssA",300,0.996678,35,301,1,300,1,1,0,1,1,163,163,138,137,13
"1236",35,"[35]EDKGofafjutnKHqocIHcJHqJGHCeuypqssA",301,0.996689,35,302,1,301,1,1,0,1,1,169,169,133,132,13
"1237",36,"[35]EDKGofafjutnKHqocIHcJHqJGHCeuypqssA",296,0.996633,35,297,1,296,1,1,0,1,1,168,168,129,128,13
"1238",37,"[35]EDKGofafjutnKHqocIHcJHqJGHCeuypqssA",315,0.996835,35,316,1,315,1,1,0,1,1,143,143,173,172,13
"1239",38,"[35]EDKGofafjutnKHqocIHcJHqJGHCeuypqssA",320,0.996885,35,321,1,320,1,1,0,1,1,141,141,180,179,13
"1240",39,"[35]EDKGofafjutnKHqocIHcJHqJGHCeuypqssA",313,0.996815,35,314,1,313,1,1,0,1,1,150,150,164,163,13
"1241",40,"[35]EDKGofafjutnKHqocIHcJHqJGHCeuypqssA",311,0.996795,35,312,1,311,1,1,0,1,1,167,167,145,144,13
"1242",41,"[35]EDKGofafjutnKHqocIHcJHqJGHCeuypqssA",317,0.996855,35,318,1,317,1,1,0,1,1,151,151,167,166,13
"1243",42,"[35]EDKGofafjutnKHqocIHcJHqJGHCeuypqssA",305,0.996732,35,306,1,305,1,1,0,1,1,159,159,147,146,13
"1244",43,"[35]EDKGofafjutnKHqocIHcJHqJGHCeuypqssA",306,0.996743,35,307,1,306,1,1,0,1,1,147,147,160,159,13
"1245",44,"[35]EDKGofafjutnKHqocIHcJHqJGHCeuypqssA",300,0.996678,35,301,1,300,1,1,0,1,1,156,156,145,144,13
"1246",45,"[35]EDKGofafjutnKHqocIHcJHqJGHCeuypqssA",297,0.996644,35,298,1,297,1,1,0,1,1,160,160,138,137,13
"1247",46,"[35]EDKGofafjutnKHqocIHcJHqJGHCeuypqssA",297,0.996644,35,298,1,297,1,1,0,1,1,166,166,132,131,13
"1248",47,"[35]EDKGofafjutnKHqocIHcJHqJGHCeuypqssA",308,0.996764,35,309,1,308,1,1,0,1,1,151,151,158,157,13
"1249",48,"[35]EDKGofafjutnKHqocIHcJHqJGHCeuypqssA",308,0.996764,35,309,1,308,1,1,0,1,1,151,151,158,157,13
"1250",49,"[35]EDKGofafjutnKHqocIHcJHqJGHCeuypqssA",309,0.996774,35,310,1,309,1,1,0,1,1,157,157,153,152,13
"1251",50,"[35]EDKGofafjutnKHqocIHcJHqJGHCeuypqssA",309,0.996774,35,310,1,309,1,1,0,1,1,147,147,163,162,13
"1252",51,"[35]EDKGofafjutnKHqocIHcJHqJGHCeuypqssA",312,0.996805,35,313,1,312,1,1,0,1,1,139,139,174,173,13
"1253",52,"[35]EDKGofafjutnKHqocIHcJHqJGHCeuypqssA",313,0.996815,35,314,1,313,1,1,0,1,1,160,160,154,153,13
"1254",53,"[35]EDKGofafjutnKHqocIHcJHqJGHCeuypqssA",307,0.996753,35,308,1,307,1,1,0,1,1,153,153,155,154,13
"1255",54,"[35]EDKGofafjutnKHqocIHcJHqJGHCeuypqssA",297,0.996644,35,298,1,297,1,1,0,1,1,162,162,136,135,13
"1256",55,"[35]EDKGofafjutnKHqocIHcJHqJGHCeuypqssA",313,0.996815,35,314,1,313,1,1,0,1,1,145,145,169,168,13
"1257",56,"[35]EDKGofafjutnKHqocIHcJHqJGHCeuypqssA",300,0.996678,35,301,1,300,1,1,0,1,1,159,159,142,141,13
"1258",57,"[35]EDKGofafjutnKHqocIHcJHqJGHCeuypqssA",314,0.996825,35,315,1,314,1,1,0,1,1,154,154,161,160,13
"1259",58,"[35]EDKGofafjutnKHqocIHcJHqJGHCeuypqssA",297,0.996644,35,298,1,297,1,1,0,1,1,162,162,136,135,13
"1260",59,"[35]EDKGofafjutnKHqocIHcJHqJGHCeuypqssA",309,0.996774,35,310,1,309,1,1,0,1,1,155,155,155,154,13
"1261",60,"[35]EDKGofafjutnKHqocIHcJHqJGHCeuypqssA",300,0.996678,35,301,1,300,1,1,0,1,1,160,160,141,140,13
"1262",61,"[35]EDKGofafjutnKHqocIHcJHqJGHCeuypqssA",303,0.996711,35,304,1,303,1,1,0,1,1,160,160,144,143,13
"1263",62,"[35]EDKGofafjutnKHqocIHcJHqJGHCeuypqssA",322,0.996904,35,323,1,322,1,1,0,1,1,147,147,176,175,13
"1264",63,"[35]EDKGofafjutnKHqocIHcJHqJGHCeuypqssA",308,0.996764,35,309,1,308,1,1,0,1,1,147,147,162,161,13
"1265",64,"[35]EDKGofafjutnKHqocIHcJHqJGHCeuypqssA",309,0.996774,35,310,1,309,1,1,0,1,1,144,144,166,165,13
"1266",65,"[35]EDKGofafjutnKHqocIHcJHqJGHCeuypqssA",313,0.996815,35,314,1,313,1,1,0,1,1,145,145,169,168,13
"1267",66,"[35]EDKGofafjutnKHqocIHcJHqJGHCeuypqssA",310,0.996785,35,311,1,310,1,1,0,1,1,153,153,158,157,13
"1268",67,"[35]EDKGofafjutnKHqocIHcJHqJGHCeuypqssA",312,0.996805,35,313,1,312,1,1,0,1,1,146,146,167,166,13
"1269",68,"[35]EDKGofafjutnKHqocIHcJHqJGHCeuypqssA",310,0.996785,35,311,1,310,1,1,0,1,1,152,152,159,158,13
"1270",69,"[35]EDKGofafjutnKHqocIHcJHqJGHCeuypqssA",305,0.996732,35,306,1,305,1,1,0,1,1,148,148,158,157,13
"1271",70,"[35]EDKGofafjutnKHqocIHcJHqJGHCeuypqssA",309,0.996774,35,310,1,309,1,1,0,1,1,164,164,146,145,13
"1272",71,"[35]EDKGofafjutnKHqocIHcJHqJGHCeuypqssA",310,0.996785,35,311,1,310,1,1,0,1,1,155,155,156,155,13
"1273",72,"[35]EDKGofafjutnKHqocIHcJHqJGHCeuypqssA",302,0.9967,35,303,1,302,1,1,0,1,1,164,164,139,138,13
"1274",73,"[35]EDKGofafjutnKHqocIHcJHqJGHCeuypqssA",301,0.996689,35,302,1,301,1,1,0,1,1,157,157,145,144,13
"1275",74,"[35]EDKGofafjutnKHqocIHcJHqJGHCeuypqssA",304,0.996721,35,305,1,304,1,1,0,1,1,154,154,151,150,13
"1276",75,"[35]EDKGofafjutnKHqocIHcJHqJGHCeuypqssA",303,0.996711,35,304,1,303,1,1,0,1,1,160,160,144,143,13
"1277",76,"[35]EDKGofafjutnKHqocIHcJHqJGHCeuypqssA",305,0.996732,35,306,1,305,1,1,0,1,1,154,154,152,151,13
"1278",77,"[35]EDKGofafjutnKHqocIHcJHqJGHCeuypqssA",306,0.996743,35,307,1,306,1,1,0,1,1,155,155,152,151,13
"1279",78,"[35]EDKGofafjutnKHqocIHcJHqJGHCeuypqssA",316,0.996845,35,317,1,316,1,1,0,1,1,141,141,176,175,13
"1280",79,"[35]EDKGofafjutnKHqocIHcJHqJGHCeuypqssA",312,0.996805,35,313,1,312,1,1,0,1,1,145,145,168,167,13
"1281",80,"[35]EDKGofafjutnKHqocIHcJHqJGHCeuypqssA",309,0.996774,35,310,1,309,1,1,0,1,1,150,150,160,159,13
"1282",81,"[35]EDKGofafjutnKHqocIHcJHqJGHCeuypqssA",318,0.996865,35,319,1,318,1,1,0,1,1,156,156,163,162,13
"1283",82,"[35]EDKGofafjutnKHqocIHcJHqJGHCeuypqssA",314,0.996825,35,315,1,314,1,1,0,1,1,141,141,174,173,13
"1284",83,"[35]EDKGofafjutnKHqocIHcJHqJGHCeuypqssA",316,0.996845,35,317,1,316,1,1,0,1,1,160,160,157,156,13
"1285",84,"[35]EDKGofafjutnKHqocIHcJHqJGHCeuypqssA",329,0.99697,35,330,1,329,1,1,0,1,1,153,153,177,176,13
"1286",85,"[35]EDKGofafjutnKHqocIHcJHqJGHCeuypqssA",309,0.996774,35,310,1,309,1,1,0,1,1,163,163,147,146,13
"1287",86,"[35]EDKGofafjutnKHqocIHcJHqJGHCeuypqssA",310,0.996785,35,311,1,310,1,1,0,1,1,146,146,165,164,13
"1288",87,"[35]EDKGofafjutnKHqocIHcJHqJGHCeuypqssA",308,0.996764,35,309,1,308,1,1,0,1,1,153,153,156,155,13
"1289",88,"[35]EDKGofafjutnKHqocIHcJHqJGHCeuypqssA",310,0.996785,35,311,1,310,1,1,0,1,1,155,155,156,155,13
"1290",89,"[35]EDKGofafjutnKHqocIHcJHqJGHCeuypqssA",310,0.996785,35,311,1,310,1,1,0,1,1,173,173,138,137,13
"1291",90,"[35]EDKGofafjutnKHqocIHcJHqJGHCeuypqssA",315,0.996835,35,316,1,315,1,1,0,1,1,148,148,168,167,13
"1292",91,"[35]EDKGofafjutnKHqocIHcJHqJGHCeuypqssA",310,0.996785,35,311,1,310,1,1,0,1,1,150,150,161,160,13
"1293",92,"[35]EDKGofafjutnKHqocIHcJHqJGHCeuypqssA",314,0.996825,35,315,1,314,1,1,0,1,1,152,152,163,162,13
"1294",93,"[35]EDKGofafjutnKHqocIHcJHqJGHCeuypqssA",304,0.996721,35,305,1,304,1,1,0,1,1,162,162,143,142,13
"1295",94,"[35]EDKGofafjutnKHqocIHcJHqJGHCeuypqssA",312,0.996805,35,313,1,312,1,1,0,1,1,152,152,161,160,13
"1296",95,"[35]EDKGofafjutnKHqocIHcJHqJGHCeuypqssA",304,0.996721,35,305,1,304,1,1,0,1,1,156,156,149,148,13
"1297",96,"[35]EDKGofafjutnKHqocIHcJHqJGHCeuypqssA",309,0.996774,35,310,1,309,1,1,0,1,1,149,149,161,160,13
"1298",97,"[35]EDKGofafjutnKHqocIHcJHqJGHCeuypqssA",309,0.996774,35,310,1,309,1,1,0,1,1,150,150,160,159,13
"1299",98,"[35]EDKGofafjutnKHqocIHcJHqJGHCeuypqssA",307,0.996753,35,308,1,307,1,1,0,1,1,144,144,164,163,13
"1300",99,"[35]EDKGofafjutnKHqocIHcJHqJGHCeuypqssA",302,0.9967,35,303,1,302,1,1,0,1,1,160,160,143,142,13
"1301",0,"[24]EDetHnKqGocIHcJHqJCHFrEC",269,0.996296,24,270,1,269,1,1,0,1,1,126,126,144,143,14
"1302",1,"[24]EDetHnKqGocIHcJHqJCHFrEC",263,0.996212,24,264,1,263,1,1,0,1,1,140,140,124,123,14
"1303",2,"[24]EDetHnKqGocIHcJHqJCHFrEC",263,0.996212,24,264,1,263,1,1,0,1,1,128,128,136,135,14
"1304",3,"[24]EDetHnKqGocIHcJHqJCHFrEC",260,0.996169,24,261,1,260,1,1,0,1,1,125,125,136,135,14
"1305",4,"[24]EDetHnKqGocIHcJHqJCHFrEC",264,0.996226,24,265,1,264,1,1,0,1,1,133,133,132,131,14
"1306",5,"[24]EDetHnKqGocIHcJHqJCHFrEC",273,0.99635,24,274,1,273,1,1,0,1,1,129,129,145,144,14
"1307",6,"[24]EDetHnKqGocIHcJHqJCHFrEC",269,0.996296,24,270,1,269,1,1,0,1,1,128,128,142,141,14
"1308",7,"[24]EDetHnKqGocIHcJHqJCHFrEC",259,0.996154,24,260,1,259,1,1,0,1,1,132,132,128,127,14
"1309",8,"[24]EDetHnKqGocIHcJHqJCHFrEC",260,0.996169,24,261,1,260,1,1,0,1,1,129,129,132,131,14
"1310",9,"[24]EDetHnKqGocIHcJHqJCHFrEC",271,0.996324,24,272,1,271,1,1,0,1,1,136,136,136,135,14
"1311",10,"[24]EDetHnKqGocIHcJHqJCHFrEC",266,0.996255,24,267,1,266,1,1,0,1,1,127,127,140,139,14
"1312",11,"[24]EDetHnKqGocIHcJHqJCHFrEC",261,0.996183,24,262,1,261,1,1,0,1,1,131,131,131,130,14
"1313",12,"[24]EDetHnKqGocIHcJHqJCHFrEC",266,0.996255,24,267,1,266,1,1,0,1,1,138,138,129,128,14
"1314",13,"[24]EDetHnKqGocIHcJHqJCHFrEC",270,0.99631,24,271,1,270,1,1,0,1,1,132,132,139,138,14
"1315",14,"[24]EDetHnKqGocIHcJHqJCHFrEC",266,0.996255,24,267,1,266,1,1,0,1,1,142,142,125,124,14
"1316",15,"[24]EDetHnKqGocIHcJHqJCHFrEC",257,0.996124,24,258,1,257,1,1,0,1,1,136,136,122,121,14
"1317",16,"[24]EDetHnKqGocIHcJHqJCHFrEC",260,0.996169,24,261,1,260,1,1,0,1,1,131,131,130,129,14
"1318",17,"[24]EDetHnKqGocIHcJHqJCHFrEC",275,0.996377,24,276,1,275,1,1,0,1,1,131,131,145,144,14
"1319",18,"[24]EDetHnKqGocIHcJHqJCHFrEC",263,0.996212,24,264,1,263,1,1,0,1,1,142,142,122,121,14
"1320",19,"[24]EDetHnKqGocIHcJHqJCHFrEC",260,0.996169,24,261,1,260,1,1,0,1,1,128,128,133,132,14
"1321",20,"[24]EDetHnKqGocIHcJHqJCHFrEC",266,0.996255,24,267,1,266,1,1,0,1,1,132,132,135,134,14
"1322",21,"[24]EDetHnKqGocIHcJHqJCHFrEC",263,0.996212,24,264,1,263,1,1,0,1,1,129,129,135,134,14
"1323",22,"[24]EDetHnKqGocIHcJHqJCHFrEC",272,0.996337,24,273,1,272,1,1,0,1,1,133,133,140,139,14
"1324",23,"[24]EDetHnKqGocIHcJHqJCHFrEC",270,0.99631,24,271,1,270,1,1,0,1,1,129,129,142,141,14
"1325",24,"[24]EDetHnKqGocIHcJHqJCHFrEC",260,0.996169,24,261,1,260,1,1,0,1,1,132,132,129,128,14
"1326",25,"[24]EDetHnKqGocIHcJHqJCHFrEC",266,0.996255,24,267,1,266,1,1,0,1,1,122,122,145,144,14
"1327",26,"[24]EDetHnKqGocIHcJHqJCHFrEC",266,0.996255,24,267,1,266,1,1,0,1,1,124,124,143,142,14
"1328",27,"[24]EDetHnKqGocIHcJHqJCHFrEC",265,0.996241,24,266,1,265,1,1,0,1,1,131,131,135,134,14
"1329",28,"[24]EDetHnKqGocIHcJHqJCHFrEC",262,0.996198,24,263,1,262,1,1,0,1,1,121,121,142,141,14
"1330",29,"[24]EDetHnKqGocIHcJHqJCHFrEC",266,0.996255,24,267,1,266,1,1,0,1,1,130,130,137,136,14
"1331",30,"[24]EDetHnKqGocIHcJHqJCHFrEC",270,0.99631,24,271,1,270,1,1,0,1,1,131,131,140,139,14
"1332",31,"[24]EDetHnKqGocIHcJHqJCHFrEC",265,0.996241,24,266,1,265,1,1,0,1,1,134,134,132,131,14
"1333",32,"[24]EDetHnKqGocIHcJHqJCHFrEC",264,0.996226,24,265,1,264,1,1,0,1,1,127,127,138,137,14
"1334",33,"[24]EDetHnKqGocIHcJHqJCHFrEC",278,0.996416,24,279,1,278,1,1,0,1,1,130,130,149,148,14
"1335",34,"[24]EDetHnKqGocIHcJHqJCHFrEC",271,0.996324,24,272,1,271,1,1,0,1,1,134,134,138,137,14
"1336",35,"[24]EDetHnKqGocIHcJHqJCHFrEC",268,0.996283,24,269,1,268,1,1,0,1,1,126,126,143,142,14
"1337",36,"[24]EDetHnKqGocIHcJHqJCHFrEC",266,0.996255,24,267,1,266,1,1,0,1,1,150,150,117,116,14
"1338",37,"[24]EDetHnKqGocIHcJHqJCHFrEC",259,0.996154,24,260,1,259,1,1,0,1,1,135,135,125,124,14
"1339",38,"[24]EDetHnKqGocIHcJHqJCHFrEC",269,0.996296,24,270,1,269,1,1,0,1,1,137,137,133,132,14
"1340",39,"[24]EDetHnKqGocIHcJHqJCHFrEC",268,0.996283,24,269,1,268,1,1,0,1,1,145,145,124,123,14
"1341",40,"[24]EDetHnKqGocIHcJHqJCHFrEC",262,0.996198,24,263,1,262,1,1,0,1,1,127,127,136,135,14
"1342",41,"[24]EDetHnKqGocIHcJHqJCHFrEC",264,0.996226,24,265,1,264,1,1,0,1,1,136,136,129,128,14
"1343",42,"[24]EDetHnKqGocIHcJHqJCHFrEC",268,0.996283,24,269,1,268,1,1,0,1,1,126,126,143,142,14
"1344",43,"[24]EDetHnKqGocIHcJHqJCHFrEC",273,0.99635,24,274,1,273,1,1,0,1,1,118,118,156,155,14
"1345",44,"[24]EDetHnKqGocIHcJHqJCHFrEC",263,0.996212,24,264,1,263,1,1,0,1,1,138,138,126,125,14
"1346",45,"[24]EDetHnKqGocIHcJHqJCHFrEC",267,0.996269,24,268,1,267,1,1,0,1,1,132,132,136,135,14
"1347",46,"[24]EDetHnKqGocIHcJHqJCHFrEC",265,0.996241,24,266,1,265,1,1,0,1,1,137,137,129,128,14
"1348",47,"[24]EDetHnKqGocIHcJHqJCHFrEC",257,0.996124,24,258,1,257,1,1,0,1,1,137,137,121,120,14
"1349",48,"[24]EDetHnKqGocIHcJHqJCHFrEC",270,0.99631,24,271,1,270,1,1,0,1,1,138,138,133,132,14
"1350",49,"[24]EDetHnKqGocIHcJHqJCHFrEC",262,0.996198,24,263,1,262,1,1,0,1,1,137,137,126,125,14
"1351",50,"[24]EDetHnKqGocIHcJHqJCHFrEC",258,0.996139,24,259,1,258,1,1,0,1,1,133,133,126,125,14
"1352",51,"[24]EDetHnKqGocIHcJHqJCHFrEC",271,0.996324,24,272,1,271,1,1,0,1,1,125,125,147,146,14
"1353",52,"[24]EDetHnKqGocIHcJHqJCHFrEC",267,0.996269,24,268,1,267,1,1,0,1,1,122,122,146,145,14
"1354",53,"[24]EDetHnKqGocIHcJHqJCHFrEC",266,0.996255,24,267,1,266,1,1,0,1,1,133,133,134,133,14
"1355",54,"[24]EDetHnKqGocIHcJHqJCHFrEC",267,0.996269,24,268,1,267,1,1,0,1,1,136,136,132,131,14
"1356",55,"[24]EDetHnKqGocIHcJHqJCHFrEC",264,0.996226,24,265,1,264,1,1,0,1,1,122,122,143,142,14
"1357",56,"[24]EDetHnKqGocIHcJHqJCHFrEC",265,0.996241,24,266,1,265,1,1,0,1,1,128,128,138,137,14
"1358",57,"[24]EDetHnKqGocIHcJHqJCHFrEC",260,0.996169,24,261,1,260,1,1,0,1,1,125,125,136,135,14
"1359",58,"[24]EDetHnKqGocIHcJHqJCHFrEC",268,0.996283,24,269,1,268,1,1,0,1,1,123,123,146,145,14
"1360",59,"[24]EDetHnKqGocIHcJHqJCHFrEC",263,0.996212,24,264,1,263,1,1,0,1,1,141,141,123,122,14
"1361",60,"[24]EDetHnKqGocIHcJHqJCHFrEC",263,0.996212,24,264,1,263,1,1,0,1,1,132,132,132,131,14
"1362",61,"[24]EDetHnKqGocIHcJHqJCHFrEC",271,0.996324,24,272,1,271,1,1,0,1,1,133,133,139,138,14
"1363",62,"[24]EDetHnKqGocIHcJHqJCHFrEC",269,0.996296,24,270,1,269,1,1,0,1,1,130,130,140,139,14
"1364",63,"[24]EDetHnKqGocIHcJHqJCHFrEC",262,0.996198,24,263,1,262,1,1,0,1,1,141,141,122,121,14
"1365",64,"[24]EDetHnKqGocIHcJHqJCHFrEC",271,0.996324,24,272,1,271,1,1,0,1,1,122,122,150,149,14
"1366",65,"[24]EDetHnKqGocIHcJHqJCHFrEC",264,0.996226,24,265,1,264,1,1,0,1,1,135,135,130,129,14
"1367",66,"[24]EDetHnKqGocIHcJHqJCHFrEC",265,0.996241,24,266,1,265,1,1,0,1,1,135,135,131,130,14
"1368",67,"[24]EDetHnKqGocIHcJHqJCHFrEC",269,0.996296,24,270,1,269,1,1,0,1,1,117,117,153,152,14
"1369",68,"[24]EDetHnKqGocIHcJHqJCHFrEC",266,0.996255,24,267,1,266,1,1,0,1,1,139,139,128,127,14
"1370",69,"[24]EDetHnKqGocIHcJHqJCHFrEC",269,0.996296,24,270,1,269,1,1,0,1,1,133,133,137,136,14
"1371",70,"[24]EDetHnKqGocIHcJHqJCHFrEC",261,0.996183,24,262,1,261,1,1,0,1,1,135,135,127,126,14
"1372",71,"[24]EDetHnKqGocIHcJHqJCHFrEC",262,0.996198,24,263,1,262,1,1,0,1,1,130,130,133,132,14
"1373",72,"[24]EDetHnKqGocIHcJHqJCHFrEC",272,0.996337,24,273,1,272,1,1,0,1,1,129,129,144,143,14
"1374",73,"[24]EDetHnKqGocIHcJHqJCHFrEC",271,0.996324,24,272,1,271,1,1,0,1,1,132,132,140,139,14
"1375",74,"[24]EDetHnKqGocIHcJHqJCHFrEC",267,0.996269,24,268,1,267,1,1,0,1,1,120,120,148,147,14
"1376",75,"[24]EDetHnKqGocIHcJHqJCHFrEC",266,0.996255,24,267,1,266,1,1,0,1,1,139,139,128,127,14
"1377",76,"[24]EDetHnKqGocIHcJHqJCHFrEC",265,0.996241,24,266,1,265,1,1,0,1,1,134,134,132,131,14
"1378",77,"[24]EDetHnKqGocIHcJHqJCHFrEC",268,0.996283,24,269,1,268,1,1,0,1,1,126,126,143,142,14
"1379",78,"[24]EDetHnKqGocIHcJHqJCHFrEC",270,0.99631,24,271,1,270,1,1,0,1,1,123,123,148,147,14
"1380",79,"[24]EDetHnKqGocIHcJHqJCHFrEC",261,0.996183,24,262,1,261,1,1,0,1,1,129,129,133,132,14
"1381",80,"[24]EDetHnKqGocIHcJHqJCHFrEC",259,0.996154,24,260,1,259,1,1,0,1,1,128,128,132,131,14
"1382",81,"[24]EDetHnKqGocIHcJHqJCHFrEC",267,0.996269,24,268,1,267,1,1,0,1,1,123,123,145,144,14
"1383",82,"[24]EDetHnKqGocIHcJHqJCHFrEC",265,0.996241,24,266,1,265,1,1,0,1,1,128,128,138,137,14
"1384",83,"[24]EDetHnKqGocIHcJHqJCHFrEC",270,0.99631,24,271,1,270,1,1,0,1,1,142,142,129,128,14
"1385",84,"[24]EDetHnKqGocIHcJHqJCHFrEC",266,0.996255,24,267,1,266,1,1,0,1,1,125,125,142,141,14
"1386",85,"[24]EDetHnKqGocIHcJHqJCHFrEC",255,0.996094,24,256,1,255,1,1,0,1,1,125,125,131,130,14
"1387",86,"[24]EDetHnKqGocIHcJHqJCHFrEC",259,0.996154,24,260,1,259,1,1,0,1,1,133,133,127,126,14
"1388",87,"[24]EDetHnKqGocIHcJHqJCHFrEC",265,0.996241,24,266,1,265,1,1,0,1,1,124,124,142,141,14
"1389",88,"[24]EDetHnKqGocIHcJHqJCHFrEC",269,0.996296,24,270,1,269,1,1,0,1,1,134,134,136,135,14
"1390",89,"[24]EDetHnKqGocIHcJHqJCHFrEC",267,0.996269,24,268,1,267,1,1,0,1,1,133,133,135,134,14
"1391",90,"[24]EDetHnKqGocIHcJHqJCHFrEC",267,0.996269,24,268,1,267,1,1,0,1,1,124,124,144,143,14
"1392",91,"[24]EDetHnKqGocIHcJHqJCHFrEC",265,0.996241,24,266,1,265,1,1,0,1,1,144,144,122,121,14
"1393",92,"[24]EDetHnKqGocIHcJHqJCHFrEC",260,0.996169,24,261,1,260,1,1,0,1,1,145,145,116,115,14
"1394",93,"[24]EDetHnKqGocIHcJHqJCHFrEC",258,0.996139,24,259,1,258,1,1,0,1,1,133,133,126,125,14
"1395",94,"[24]EDetHnKqGocIHcJHqJCHFrEC",258,0.996139,24,259,1,258,1,1,0,1,1,125,125,134,133,14
"1396",95,"[24]EDetHnKqGocIHcJHqJCHFrEC",268,0.996283,24,269,1,268,1,1,0,1,1,133,133,136,135,14
"1397",96,"[24]EDetHnKqGocIHcJHqJCHFrEC",263,0.996212,24,264,1,263,1,1,0,1,1,136,136,128,127,14
"1398",97,"[24]EDetHnKqGocIHcJHqJCHFrEC",270,0.99631,24,271,1,270,1,1,0,1,1,134,134,137,136,14
"1399",98,"[24]EDetHnKqGocIHcJHqJCHFrEC",261,0.996183,24,262,1,261,1,1,0,1,1,141,141,121,120,14
"1400",99,"[24]EDetHnKqGocIHcJHqJCHFrEC",272,0.996337,24,273,1,272,1,1,0,1,1,124,124,149,148,14
"1401",0,"[26]EoHsHnKqGocIHBJCIvyyrCdJIv",240,0.995851,26,241,1,240,1,1,0,1,1,106,106,135,134,15
"1402",1,"[26]EoHsHnKqGocIHBJCIvyyrCdJIv",228,0.995633,26,229,1,228,1,1,0,1,1,118,118,111,110,15
"1403",2,"[26]EoHsHnKqGocIHBJCIvyyrCdJIv",233,0.995726,26,234,1,233,1,1,0,1,1,112,112,122,121,15
"1404",3,"[26]EoHsHnKqGocIHBJCIvyyrCdJIv",218,0.995434,26,219,1,218,1,1,0,1,1,124,124,95,94,15
"1405",4,"[26]EoHsHnKqGocIHBJCIvyyrCdJIv",233,0.995726,26,234,1,233,1,1,0,1,1,113,113,121,120,15
"1406",5,"[26]EoHsHnKqGocIHBJCIvyyrCdJIv",230,0.995671,26,231,1,230,1,1,0,1,1,114,114,117,116,15
"1407",6,"[26]EoHsHnKqGocIHBJCIvyyrCdJIv",229,0.995652,26,230,1,229,1,1,0,1,1,117,117,113,112,15
"1408",7,"[26]EoHsHnKqGocIHBJCIvyyrCdJIv",228,0.995633,26,229,1,228,1,1,0,1,1,117,117,112,111,15
"1409",8,"[26]EoHsHnKqGocIHBJCIvyyrCdJIv",230,0.995671,26,231,1,230,1,1,0,1,1,117,117,114,113,15
"1410",9,"[26]EoHsHnKqGocIHBJCIvyyrCdJIv",231,0.99569,26,232,1,231,1,1,0,1,1,115,115,117,116,15
"1411",10,"[26]EoHsHnKqGocIHBJCIvyyrCdJIv",228,0.995633,26,229,1,228,1,1,0,1,1,117,117,112,111,15
"1412",11,"[26]EoHsHnKqGocIHBJCIvyyrCdJIv",233,0.995726,26,234,1,233,1,1,0,1,1,112,112,122,121,15
"1413",12,"[26]EoHsHnKqGocIHBJCIvyyrCdJIv",234,0.995745,26,235,1,234,1,1,0,1,1,112,112,123,122,15
"1414",13,"[26]EoHsHnKqGocIHBJCIvyyrCdJIv",227,0.995614,26,228,1,227,1,1,0,1,1,117,117,111,110,15
"1415",14,"[26]EoHsHnKqGocIHBJCIvyyrCdJIv",231,0.99569,26,232,1,231,1,1,0,1,1,113,113,119,118,15
"1416",15,"[26]EoHsHnKqGocIHBJCIvyyrCdJIv",230,0.995671,26,231,1,230,1,1,0,1,1,117,117,114,113,15
"1417",16,"[26]EoHsHnKqGocIHBJCIvyyrCdJIv",236,0.995781,26,237,1,236,1,1,0,1,1,110,110,127,126,15
"1418",17,"[26]EoHsHnKqGocIHBJCIvyyrCdJIv",225,0.995575,26,226,1,225,1,1,0,1,1,119,119,107,106,15
"1419",18,"[26]EoHsHnKqGocIHBJCIvyyrCdJIv",230,0.995671,26,231,1,230,1,1,0,1,1,115,115,116,115,15
"1420",19,"[26]EoHsHnKqGocIHBJCIvyyrCdJIv",230,0.995671,26,231,1,230,1,1,0,1,1,114,114,117,116,15
"1421",20,"[26]EoHsHnKqGocIHBJCIvyyrCdJIv",233,0.995726,26,234,1,233,1,1,0,1,1,114,114,120,119,15
"1422",21,"[26]EoHsHnKqGocIHBJCIvyyrCdJIv",230,0.995671,26,231,1,230,1,1,0,1,1,114,114,117,116,15
"1423",22,"[26]EoHsHnKqGocIHBJCIvyyrCdJIv",230,0.995671,26,231,1,230,1,1,0,1,1,115,115,116,115,15
"1424",23,"[26]EoHsHnKqGocIHBJCIvyyrCdJIv",230,0.995671,26,231,1,230,1,1,0,1,1,118,118,113,112,15
"1425",24,"[26]EoHsHnKqGocIHBJCIvyyrCdJIv",231,0.99569,26,232,1,231,1,1,0,1,1,115,115,117,116,15
"1426",25,"[26]EoHsHnKqGocIHBJCIvyyrCdJIv",234,0.995745,26,235,1,234,1,1,0,1,1,112,112,123,122,15
"1427",26,"[26]EoHsHnKqGocIHBJCIvyyrCdJIv",233,0.995726,26,234,1,233,1,1,0,1,1,113,113,121,120,15
"1428",27,"[26]EoHsHnKqGocIHBJCIvyyrCdJIv",233,0.995726,26,234,1,233,1,1,0,1,1,113,113,121,120,15
"1429",28,"[26]EoHsHnKqGocIHBJCIvyyrCdJIv",231,0.99569,26,232,1,231,1,1,0,1,1,114,114,118,117,15
"1430",29,"[26]EoHsHnKqGocIHBJCIvyyrCdJIv",220,0.995475,26,221,1,220,1,1,0,1,1,124,124,97,96,15
"1431",30,"[26]EoHsHnKqGocIHBJCIvyyrCdJIv",233,0.995726,26,234,1,233,1,1,0,1,1,114,114,120,119,15
"1432",31,"[26]EoHsHnKqGocIHBJCIvyyrCdJIv",236,0.995781,26,237,1,236,1,1,0,1,1,112,112,125,124,15
"1433",32,"[26]EoHsHnKqGocIHBJCIvyyrCdJIv",224,0.995556,26,225,1,224,1,1,0,1,1,120,120,105,104,15
"1434",33,"[26]EoHsHnKqGocIHBJCIvyyrCdJIv",225,0.995575,26,226,1,225,1,1,0,1,1,119,119,107,106,15
"1435",34,"[26]EoHsHnKqGocIHBJCIvyyrCdJIv",239,0.995833,26,240,1,239,1,1,0,1,1,109,109,131,130,15
"1436",35,"[26]EoHsHnKqGocIHBJCIvyyrCdJIv",230,0.995671,26,231,1,230,1,1,0,1,1,114,114,117,116,15
"1437",36,"[26]EoHsHnKqGocIHBJCIvyyrCdJIv",225,0.995575,26,226,1,225,1,1,0,1,1,120,120,106,105,15
"1438",37,"[26]EoHsHnKqGocIHBJCIvyyrCdJIv",222,0.995516,26,223,1,222,1,1,0,1,1,121,121,102,101,15
"1439",38,"[26]EoHsHnKqGocIHBJCIvyyrCdJIv",232,0.995708,26,233,1,232,1,1,0,1,1,114,114,119,118,15
"1440",39,"[26]EoHsHnKqGocIHBJCIvyyrCdJIv",229,0.995652,26,230,1,229,1,1,0,1,1,115,115,115,114,15
"1441",40,"[26]EoHsHnKqGocIHBJCIvyyrCdJIv",241,0.995868,26,242,1,241,1,1,0,1,1,109,109,133,132,15
"1442",41,"[26]EoHsHnKqGocIHBJCIvyyrCdJIv",234,0.995745,26,235,1,234,1,1,0,1,1,113,113,122,121,15
"1443",42,"[26]EoHsHnKqGocIHBJCIvyyrCdJIv",234,0.995745,26,235,1,234,1,1,0,1,1,113,113,122,121,15
"1444",43,"[26]EoHsHnKqGocIHBJCIvyyrCdJIv",238,0.995816,26,239,1,238,1,1,0,1,1,111,111,128,127,15
"1445",44,"[26]EoHsHnKqGocIHBJCIvyyrCdJIv",222,0.995516,26,223,1,222,1,1,0,1,1,121,121,102,101,15
"1446",45,"[26]EoHsHnKqGocIHBJCIvyyrCdJIv",228,0.995633,26,229,1,228,1,1,0,1,1,116,116,113,112,15
"1447",46,"[26]EoHsHnKqGocIHBJCIvyyrCdJIv",219,0.995455,26,220,1,219,1,1,0,1,1,123,123,97,96,15
"1448",47,"[26]EoHsHnKqGocIHBJCIvyyrCdJIv",226,0.995595,26,227,1,226,1,1,0,1,1,117,117,110,109,15
"1449",48,"[26]EoHsHnKqGocIHBJCIvyyrCdJIv",230,0.995671,26,231,1,230,1,1,0,1,1,117,117,114,113,15
"1450",49,"[26]EoHsHnKqGocIHBJCIvyyrCdJIv",226,0.995595,26,227,1,226,1,1,0,1,1,118,118,109,108,15
"1451",50,"[26]EoHsHnKqGocIHBJCIvyyrCdJIv",223,0.995536,26,224,1,223,1,1,0,1,1,120,120,104,103,15
"1452",51,"[26]EoHsHnKqGocIHBJCIvyyrCdJIv",230,0.995671,26,231,1,230,1,1,0,1,1,116,116,115,114,15
"1453",52,"[26]EoHsHnKqGocIHBJCIvyyrCdJIv",230,0.995671,26,231,1,230,1,1,0,1,1,117,117,114,113,15
"1454",53,"[26]EoHsHnKqGocIHBJCIvyyrCdJIv",225,0.995575,26,226,1,225,1,1,0,1,1,119,119,107,106,15
"1455",54,"[26]EoHsHnKqGocIHBJCIvyyrCdJIv",229,0.995652,26,230,1,229,1,1,0,1,1,116,116,114,113,15
"1456",55,"[26]EoHsHnKqGocIHBJCIvyyrCdJIv",228,0.995633,26,229,1,228,1,1,0,1,1,118,118,111,110,15
"1457",56,"[26]EoHsHnKqGocIHBJCIvyyrCdJIv",232,0.995708,26,233,1,232,1,1,0,1,1,115,115,118,117,15
"1458",57,"[26]EoHsHnKqGocIHBJCIvyyrCdJIv",232,0.995708,26,233,1,232,1,1,0,1,1,113,113,120,119,15
"1459",58,"[26]EoHsHnKqGocIHBJCIvyyrCdJIv",233,0.995726,26,234,1,233,1,1,0,1,1,113,113,121,120,15
"1460",59,"[26]EoHsHnKqGocIHBJCIvyyrCdJIv",226,0.995595,26,227,1,226,1,1,0,1,1,118,118,109,108,15
"1461",60,"[26]EoHsHnKqGocIHBJCIvyyrCdJIv",225,0.995575,26,226,1,225,1,1,0,1,1,119,119,107,106,15
"1462",61,"[26]EoHsHnKqGocIHBJCIvyyrCdJIv",232,0.995708,26,233,1,232,1,1,0,1,1,114,114,119,118,15
"1463",62,"[26]EoHsHnKqGocIHBJCIvyyrCdJIv",237,0.995798,26,238,1,237,1,1,0,1,1,109,109,129,128,15
"1464",63,"[26]EoHsHnKqGocIHBJCIvyyrCdJIv",228,0.995633,26,229,1,228,1,1,0,1,1,117,117,112,111,15
"1465",64,"[26]EoHsHnKqGocIHBJCIvyyrCdJIv",226,0.995595,26,227,1,226,1,1,0,1,1,119,119,108,107,15
"1466",65,"[26]EoHsHnKqGocIHBJCIvyyrCdJIv",227,0.995614,26,228,1,227,1,1,0,1,1,118,118,110,109,15
"1467",66,"[26]EoHsHnKqGocIHBJCIvyyrCdJIv",234,0.995745,26,235,1,234,1,1,0,1,1,111,111,124,123,15
"1468",67,"[26]EoHsHnKqGocIHBJCIvyyrCdJIv",240,0.995851,26,241,1,240,1,1,0,1,1,112,112,129,128,15
"1469",68,"[26]EoHsHnKqGocIHBJCIvyyrCdJIv",235,0.995763,26,236,1,235,1,1,0,1,1,113,113,123,122,15
"1470",69,"[26]EoHsHnKqGocIHBJCIvyyrCdJIv",238,0.995816,26,239,1,238,1,1,0,1,1,108,108,131,130,15
"1471",70,"[26]EoHsHnKqGocIHBJCIvyyrCdJIv",229,0.995652,26,230,1,229,1,1,0,1,1,117,117,113,112,15
"1472",71,"[26]EoHsHnKqGocIHBJCIvyyrCdJIv",226,0.995595,26,227,1,226,1,1,0,1,1,120,120,107,106,15
"1473",72,"[26]EoHsHnKqGocIHBJCIvyyrCdJIv",238,0.995816,26,239,1,238,1,1,0,1,1,108,108,131,130,15
"1474",73,"[26]EoHsHnKqGocIHBJCIvyyrCdJIv",216,0.995392,26,217,1,216,1,1,0,1,1,126,126,91,90,15
"1475",74,"[26]EoHsHnKqGocIHBJCIvyyrCdJIv",225,0.995575,26,226,1,225,1,1,0,1,1,118,118,108,107,15
"1476",75,"[26]EoHsHnKqGocIHBJCIvyyrCdJIv",235,0.995763,26,236,1,235,1,1,0,1,1,111,111,125,124,15
"1477",76,"[26]EoHsHnKqGocIHBJCIvyyrCdJIv",239,0.995833,26,240,1,239,1,1,0,1,1,109,109,131,130,15
"1478",77,"[26]EoHsHnKqGocIHBJCIvyyrCdJIv",226,0.995595,26,227,1,226,1,1,0,1,1,119,119,108,107,15
"1479",78,"[26]EoHsHnKqGocIHBJCIvyyrCdJIv",236,0.995781,26,237,1,236,1,1,0,1,1,109,109,128,127,15
"1480",79,"[26]EoHsHnKqGocIHBJCIvyyrCdJIv",236,0.995781,26,237,1,236,1,1,0,1,1,109,109,128,127,15
"1481",80,"[26]EoHsHnKqGocIHBJCIvyyrCdJIv",243,0.995902,26,244,1,243,1,1,0,1,1,105,105,139,138,15
"1482",81,"[26]EoHsHnKqGocIHBJCIvyyrCdJIv",236,0.995781,26,237,1,236,1,1,0,1,1,110,110,127,126,15
"1483",82,"[26]EoHsHnKqGocIHBJCIvyyrCdJIv",244,0.995918,26,245,1,244,1,1,0,1,1,104,104,141,140,15
"1484",83,"[26]EoHsHnKqGocIHBJCIvyyrCdJIv",225,0.995575,26,226,1,225,1,1,0,1,1,119,119,107,106,15
"1485",84,"[26]EoHsHnKqGocIHBJCIvyyrCdJIv",221,0.995495,26,222,1,221,1,1,0,1,1,123,123,99,98,15
"1486",85,"[26]EoHsHnKqGocIHBJCIvyyrCdJIv",219,0.995455,26,220,1,219,1,1,0,1,1,123,123,97,96,15
"1487",86,"[26]EoHsHnKqGocIHBJCIvyyrCdJIv",223,0.995536,26,224,1,223,1,1,0,1,1,121,121,103,102,15
"1488",87,"[26]EoHsHnKqGocIHBJCIvyyrCdJIv",230,0.995671,26,231,1,230,1,1,0,1,1,115,115,116,115,15
"1489",88,"[26]EoHsHnKqGocIHBJCIvyyrCdJIv",229,0.995652,26,230,1,229,1,1,0,1,1,115,115,115,114,15
"1490",89,"[26]EoHsHnKqGocIHBJCIvyyrCdJIv",212,0.995305,26,213,1,212,1,1,0,1,1,129,129,84,83,15
"1491",90,"[26]EoHsHnKqGocIHBJCIvyyrCdJIv",222,0.995516,26,223,1,222,1,1,0,1,1,121,121,102,101,15
"1492",91,"[26]EoHsHnKqGocIHBJCIvyyrCdJIv",239,0.995833,26,240,1,239,1,1,0,1,1,109,109,131,130,15
"1493",92,"[26]EoHsHnKqGocIHBJCIvyyrCdJIv",234,0.995745,26,235,1,234,1,1,0,1,1,111,111,124,123,15
"1494",93,"[26]EoHsHnKqGocIHBJCIvyyrCdJIv",236,0.995781,26,237,1,236,1,1,0,1,1,111,111,126,125,15
"1495",94,"[26]EoHsHnKqGocIHBJCIvyyrCdJIv",229,0.995652,26,230,1,229,1,1,0,1,1,115,115,115,114,15
"1496",95,"[26]EoHsHnKqGocIHBJCIvyyrCdJIv",225,0.995575,26,226,1,225,1,1,0,1,1,118,118,108,107,15
"1497",96,"[26]EoHsHnKqGocIHBJCIvyyrCdJIv",236,0.995781,26,237,1,236,1,1,0,1,1,110,110,127,126,15
"1498",97,"[26]EoHsHnKqGocIHBJCIvyyrCdJIv",222,0.995516,26,223,1,222,1,1,0,1,1,121,121,102,101,15
"1499",98,"[26]EoHsHnKqGocIHBJCIvyyrCdJIv",241,0.995868,26,242,1,241,1,1,0,1,1,107,107,135,134,15
"1500",99,"[26]EoHsHnKqGocIHBJCIvyyrCdJIv",240,0.995851,26,241,1,240,1,1,0,1,1,113,113,128,127,15
"1501",0,"[25]EegsHnKqGocIHBJCIqAxHrHlG",240,0.995851,25,241,1,240,1,1,0,1,1,106,106,135,134,16
"1502",1,"[25]EegsHnKqGocIHBJCIqAxHrHlG",242,0.995885,25,243,1,242,1,1,0,1,1,108,108,135,134,16
"1503",2,"[25]EegsHnKqGocIHBJCIqAxHrHlG",228,0.995633,25,229,1,228,1,1,0,1,1,119,119,110,109,16
"1504",3,"[25]EegsHnKqGocIHBJCIqAxHrHlG",234,0.995745,25,235,1,234,1,1,0,1,1,112,112,123,122,16
"1505",4,"[25]EegsHnKqGocIHBJCIqAxHrHlG",230,0.995671,25,231,1,230,1,1,0,1,1,114,114,117,116,16
"1506",5,"[25]EegsHnKqGocIHBJCIqAxHrHlG",233,0.995726,25,234,1,233,1,1,0,1,1,114,114,120,119,16
"1507",6,"[25]EegsHnKqGocIHBJCIqAxHrHlG",225,0.995575,25,226,1,225,1,1,0,1,1,119,119,107,106,16
"1508",7,"[25]EegsHnKqGocIHBJCIqAxHrHlG",228,0.995633,25,229,1,228,1,1,0,1,1,116,116,113,112,16
"1509",8,"[25]EegsHnKqGocIHBJCIqAxHrHlG",226,0.995595,25,227,1,226,1,1,0,1,1,119,119,108,107,16
"1510",9,"[25]EegsHnKqGocIHBJCIqAxHrHlG",230,0.995671,25,231,1,230,1,1,0,1,1,116,116,115,114,16
"1511",10,"[25]EegsHnKqGocIHBJCIqAxHrHlG",227,0.995614,25,228,1,227,1,1,0,1,1,117,117,111,110,16
"1512",11,"[25]EegsHnKqGocIHBJCIqAxHrHlG",230,0.995671,25,231,1,230,1,1,0,1,1,116,116,115,114,16
"1513",12,"[25]EegsHnKqGocIHBJCIqAxHrHlG",222,0.995516,25,223,1,222,1,1,0,1,1,120,120,103,102,16
"1514",13,"[25]EegsHnKqGocIHBJCIqAxHrHlG",233,0.995726,25,234,1,233,1,1,0,1,1,115,115,119,118,16
"1515",14,"[25]EegsHnKqGocIHBJCIqAxHrHlG",238,0.995816,25,239,1,238,1,1,0,1,1,109,109,130,129,16
"1516",15,"[25]EegsHnKqGocIHBJCIqAxHrHlG",235,0.995763,25,236,1,235,1,1,0,1,1,110,110,126,125,16
"1517",16,"[25]EegsHnKqGocIHBJCIqAxHrHlG",234,0.995745,25,235,1,234,1,1,0,1,1,112,112,123,122,16
"1518",17,"[25]EegsHnKqGocIHBJCIqAxHrHlG",230,0.995671,25,231,1,230,1,1,0,1,1,114,114,117,116,16
"1519",18,"[25]EegsHnKqGocIHBJCIqAxHrHlG",222,0.995516,25,223,1,222,1,1,0,1,1,121,121,102,101,16
"1520",19,"[25]EegsHnKqGocIHBJCIqAxHrHlG",238,0.995816,25,239,1,238,1,1,0,1,1,108,108,131,130,16
"1521",20,"[25]EegsHnKqGocIHBJCIqAxHrHlG",232,0.995708,25,233,1,232,1,1,0,1,1,112,112,121,120,16
"1522",21,"[25]EegsHnKqGocIHBJCIqAxHrHlG",221,0.995495,25,222,1,221,1,1,0,1,1,122,122,100,99,16
"1523",22,"[25]EegsHnKqGocIHBJCIqAxHrHlG",219,0.995455,25,220,1,219,1,1,0,1,1,123,123,97,96,16
"1524",23,"[25]EegsHnKqGocIHBJCIqAxHrHlG",229,0.995652,25,230,1,229,1,1,0,1,1,117,117,113,112,16
"1525",24,"[25]EegsHnKqGocIHBJCIqAxHrHlG",231,0.99569,25,232,1,231,1,1,0,1,1,113,113,119,118,16
"1526",25,"[25]EegsHnKqGocIHBJCIqAxHrHlG",227,0.995614,25,228,1,227,1,1,0,1,1,116,116,112,111,16
"1527",26,"[25]EegsHnKqGocIHBJCIqAxHrHlG",240,0.995851,25,241,1,240,1,1,0,1,1,110,110,131,130,16
"1528",27,"[25]EegsHnKqGocIHBJCIqAxHrHlG",231,0.99569,25,232,1,231,1,1,0,1,1,114,114,118,117,16
"1529",28,"[25]EegsHnKqGocIHBJCIqAxHrHlG",222,0.995516,25,223,1,222,1,1,0,1,1,121,121,102,101,16
"1530",29,"[25]EegsHnKqGocIHBJCIqAxHrHlG",237,0.995798,25,238,1,237,1,1,0,1,1,112,112,126,125,16
"1531",30,"[25]EegsHnKqGocIHBJCIqAxHrHlG",235,0.995763,25,236,1,235,1,1,0,1,1,112,112,124,123,16
"1532",31,"[25]EegsHnKqGocIHBJCIqAxHrHlG",234,0.995745,25,235,1,234,1,1,0,1,1,112,112,123,122,16
"1533",32,"[25]EegsHnKqGocIHBJCIqAxHrHlG",229,0.995652,25,230,1,229,1,1,0,1,1,117,117,113,112,16
"1534",33,"[25]EegsHnKqGocIHBJCIqAxHrHlG",228,0.995633,25,229,1,228,1,1,0,1,1,116,116,113,112,16
"1535",34,"[25]EegsHnKqGocIHBJCIqAxHrHlG",224,0.995556,25,225,1,224,1,1,0,1,1,120,120,105,104,16
"1536",35,"[25]EegsHnKqGocIHBJCIqAxHrHlG",233,0.995726,25,234,1,233,1,1,0,1,1,116,116,118,117,16
"1537",36,"[25]EegsHnKqGocIHBJCIqAxHrHlG",231,0.99569,25,232,1,231,1,1,0,1,1,114,114,118,117,16
"1538",37,"[25]EegsHnKqGocIHBJCIqAxHrHlG",231,0.99569,25,232,1,231,1,1,0,1,1,115,115,117,116,16
"1539",38,"[25]EegsHnKqGocIHBJCIqAxHrHlG",217,0.995413,25,218,1,217,1,1,0,1,1,126,126,92,91,16
"1540",39,"[25]EegsHnKqGocIHBJCIqAxHrHlG",218,0.995434,25,219,1,218,1,1,0,1,1,127,127,92,91,16
"1541",40,"[25]EegsHnKqGocIHBJCIqAxHrHlG",232,0.995708,25,233,1,232,1,1,0,1,1,112,112,121,120,16
"1542",41,"[25]EegsHnKqGocIHBJCIqAxHrHlG",232,0.995708,25,233,1,232,1,1,0,1,1,112,112,121,120,16
"1543",42,"[25]EegsHnKqGocIHBJCIqAxHrHlG",237,0.995798,25,238,1,237,1,1,0,1,1,110,110,128,127,16
"1544",43,"[25]EegsHnKqGocIHBJCIqAxHrHlG",234,0.995745,25,235,1,234,1,1,0,1,1,111,111,124,123,16
"1545",44,"[25]EegsHnKqGocIHBJCIqAxHrHlG",239,0.995833,25,240,1,239,1,1,0,1,1,108,108,132,131,16
"1546",45,"[25]EegsHnKqGocIHBJCIqAxHrHlG",235,0.995763,25,236,1,235,1,1,0,1,1,112,112,124,123,16
"1547",46,"[25]EegsHnKqGocIHBJCIqAxHrHlG",234,0.995745,25,235,1,234,1,1,0,1,1,111,111,124,123,16
"1548",47,"[25]EegsHnKqGocIHBJCIqAxHrHlG",225,0.995575,25,226,1,225,1,1,0,1,1,119,119,107,106,16
"1549",48,"[25]EegsHnKqGocIHBJCIqAxHrHlG",225,0.995575,25,226,1,225,1,1,0,1,1,119,119,107,106,16
"1550",49,"[25]EegsHnKqGocIHBJCIqAxHrHlG",234,0.995745,25,235,1,234,1,1,0,1,1,111,111,124,123,16
"1551",50,"[25]EegsHnKqGocIHBJCIqAxHrHlG",224,0.995556,25,225,1,224,1,1,0,1,1,119,119,106,105,16
"1552",51,"[25]EegsHnKqGocIHBJCIqAxHrHlG",233,0.995726,25,234,1,233,1,1,0,1,1,113,113,121,120,16
"1553",52,"[25]EegsHnKqGocIHBJCIqAxHrHlG",221,0.995495,25,222,1,221,1,1,0,1,1,122,122,100,99,16
"1554",53,"[25]EegsHnKqGocIHBJCIqAxHrHlG",238,0.995816,25,239,1,238,1,1,0,1,1,108,108,131,130,16
"1555",54,"[25]EegsHnKqGocIHBJCIqAxHrHlG",238,0.995816,25,239,1,238,1,1,0,1,1,110,110,129,128,16
"1556",55,"[25]EegsHnKqGocIHBJCIqAxHrHlG",235,0.995763,25,236,1,235,1,1,0,1,1,113,113,123,122,16
"1557",56,"[25]EegsHnKqGocIHBJCIqAxHrHlG",236,0.995781,25,237,1,236,1,1,0,1,1,112,112,125,124,16
"1558",57,"[25]EegsHnKqGocIHBJCIqAxHrHlG",227,0.995614,25,228,1,227,1,1,0,1,1,117,117,111,110,16
"1559",58,"[25]EegsHnKqGocIHBJCIqAxHrHlG",226,0.995595,25,227,1,226,1,1,0,1,1,120,120,107,106,16
"1560",59,"[25]EegsHnKqGocIHBJCIqAxHrHlG",237,0.995798,25,238,1,237,1,1,0,1,1,110,110,128,127,16
"1561",60,"[25]EegsHnKqGocIHBJCIqAxHrHlG",216,0.995392,25,217,1,216,1,1,0,1,1,126,126,91,90,16
"1562",61,"[25]EegsHnKqGocIHBJCIqAxHrHlG",243,0.995902,25,244,1,243,1,1,0,1,1,106,106,138,137,16
"1563",62,"[25]EegsHnKqGocIHBJCIqAxHrHlG",238,0.995816,25,239,1,238,1,1,0,1,1,108,108,131,130,16
"1564",63,"[25]EegsHnKqGocIHBJCIqAxHrHlG",239,0.995833,25,240,1,239,1,1,0,1,1,112,112,128,127,16
"1565",64,"[25]EegsHnKqGocIHBJCIqAxHrHlG",235,0.995763,25,236,1,235,1,1,0,1,1,110,110,126,125,16
"1566",65,"[25]EegsHnKqGocIHBJCIqAxHrHlG",225,0.995575,25,226,1,225,1,1,0,1,1,118,118,108,107,16
"1567",66,"[25]EegsHnKqGocIHBJCIqAxHrHlG",226,0.995595,25,227,1,226,1,1,0,1,1,119,119,108,107,16
"1568",67,"[25]EegsHnKqGocIHBJCIqAxHrHlG",221,0.995495,25,222,1,221,1,1,0,1,1,122,122,100,99,16
"1569",68,"[25]EegsHnKqGocIHBJCIqAxHrHlG",242,0.995885,25,243,1,242,1,1,0,1,1,108,108,135,134,16
"1570",69,"[25]EegsHnKqGocIHBJCIqAxHrHlG",231,0.99569,25,232,1,231,1,1,0,1,1,113,113,119,118,16
"1571",70,"[25]EegsHnKqGocIHBJCIqAxHrHlG",231,0.99569,25,232,1,231,1,1,0,1,1,114,114,118,117,16
"1572",71,"[25]EegsHnKqGocIHBJCIqAxHrHlG",221,0.995495,25,222,1,221,1,1,0,1,1,122,122,100,99,16
"1573",72,"[25]EegsHnKqGocIHBJCIqAxHrHlG",234,0.995745,25,235,1,234,1,1,0,1,1,111,111,124,123,16
"1574",73,"[25]EegsHnKqGocIHBJCIqAxHrHlG",235,0.995763,25,236,1,235,1,1,0,1,1,110,110,126,125,16
"1575",74,"[25]EegsHnKqGocIHBJCIqAxHrHlG",239,0.995833,25,240,1,239,1,1,0,1,1,109,109,131,130,16
"1576",75,"[25]EegsHnKqGocIHBJCIqAxHrHlG",230,0.995671,25,231,1,230,1,1,0,1,1,115,115,116,115,16
"1577",76,"[25]EegsHnKqGocIHBJCIqAxHrHlG",231,0.99569,25,232,1,231,1,1,0,1,1,113,113,119,118,16
"1578",77,"[25]EegsHnKqGocIHBJCIqAxHrHlG",234,0.995745,25,235,1,234,1,1,0,1,1,112,112,123,122,16
"1579",78,"[25]EegsHnKqGocIHBJCIqAxHrHlG",233,0.995726,25,234,1,233,1,1,0,1,1,112,112,122,121,16
"1580",79,"[25]EegsHnKqGocIHBJCIqAxHrHlG",232,0.995708,25,233,1,232,1,1,0,1,1,113,113,120,119,16
"1581",80,"[25]EegsHnKqGocIHBJCIqAxHrHlG",228,0.995633,25,229,1,228,1,1,0,1,1,116,116,113,112,16
"1582",81,"[25]EegsHnKqGocIHBJCIqAxHrHlG",228,0.995633,25,229,1,228,1,1,0,1,1,116,116,113,112,16
"1583",82,"[25]EegsHnKqGocIHBJCIqAxHrHlG",237,0.995798,25,238,1,237,1,1,0,1,1,109,109,129,128,16
"1584",83,"[25]EegsHnKqGocIHBJCIqAxHrHlG",229,0.995652,25,230,1,229,1,1,0,1,1,116,116,114,113,16
"1585",84,"[25]EegsHnKqGocIHBJCIqAxHrHlG",228,0.995633,25,229,1,228,1,1,0,1,1,119,119,110,109,16
"1586",85,"[25]EegsHnKqGocIHBJCIqAxHrHlG",225,0.995575,25,226,1,225,1,1,0,1,1,119,119,107,106,16
"1587",86,"[25]EegsHnKqGocIHBJCIqAxHrHlG",229,0.995652,25,230,1,229,1,1,0,1,1,115,115,115,114,16
"1588",87,"[25]EegsHnKqGocIHBJCIqAxHrHlG",235,0.995763,25,236,1,235,1,1,0,1,1,113,113,123,122,16
"1589",88,"[25]EegsHnKqGocIHBJCIqAxHrHlG",240,0.995851,25,241,1,240,1,1,0,1,1,108,108,133,132,16
"1590",89,"[25]EegsHnKqGocIHBJCIqAxHrHlG",240,0.995851,25,241,1,240,1,1,0,1,1,107,107,134,133,16
"1591",90,"[25]EegsHnKqGocIHBJCIqAxHrHlG",242,0.995885,25,243,1,242,1,1,0,1,1,104,104,139,138,16
"1592",91,"[25]EegsHnKqGocIHBJCIqAxHrHlG",244,0.995918,25,245,1,244,1,1,0,1,1,105,105,140,139,16
"1593",92,"[25]EegsHnKqGocIHBJCIqAxHrHlG",240,0.995851,25,241,1,240,1,1,0,1,1,106,106,135,134,16
"1594",93,"[25]EegsHnKqGocIHBJCIqAxHrHlG",233,0.995726,25,234,1,233,1,1,0,1,1,113,113,121,120,16
"1595",94,"[25]EegsHnKqGocIHBJCIqAxHrHlG",234,0.995745,25,235,1,234,1,1,0,1,1,112,112,123,122,16
"1596",95,"[25]EegsHnKqGocIHBJCIqAxHrHlG",238,0.995816,25,239,1,238,1,1,0,1,1,109,109,130,129,16
"1597",96,"[25]EegsHnKqGocIHBJCIqAxHrHlG",222,0.995516,25,223,1,222,1,1,0,1,1,120,120,103,102,16
"1598",97,"[25]EegsHnKqGocIHBJCIqAxHrHlG",246,0.995951,25,247,1,246,1,1,0,1,1,104,104,143,142,16
"1599",98,"[25]EegsHnKqGocIHBJCIqAxHrHlG",235,0.995763,25,236,1,235,1,1,0,1,1,111,111,125,124,16
"1600",99,"[25]EegsHnKqGocIHBJCIqAxHrHlG",232,0.995708,25,233,1,232,1,1,0,1,1,112,112,121,120,16
"1601",0,"[24]ElwHnKqGocIHcJCzxeJJbIjg",233,0.995726,24,234,1,233,1,1,0,1,1,114,114,120,119,17
"1602",1,"[24]ElwHnKqGocIHcJCzxeJJbIjg",234,0.995745,24,235,1,234,1,1,0,1,1,111,111,124,123,17
"1603",2,"[24]ElwHnKqGocIHcJCzxeJJbIjg",229,0.995652,24,230,1,229,1,1,0,1,1,115,115,115,114,17
"1604",3,"[24]ElwHnKqGocIHcJCzxeJJbIjg",233,0.995726,24,234,1,233,1,1,0,1,1,113,113,121,120,17
"1605",4,"[24]ElwHnKqGocIHcJCzxeJJbIjg",220,0.995475,24,221,1,220,1,1,0,1,1,122,122,99,98,17
"1606",5,"[24]ElwHnKqGocIHcJCzxeJJbIjg",232,0.995708,24,233,1,232,1,1,0,1,1,114,114,119,118,17
"1607",6,"[24]ElwHnKqGocIHcJCzxeJJbIjg",229,0.995652,24,230,1,229,1,1,0,1,1,116,116,114,113,17
"1608",7,"[24]ElwHnKqGocIHcJCzxeJJbIjg",221,0.995495,24,222,1,221,1,1,0,1,1,121,121,101,100,17
"1609",8,"[24]ElwHnKqGocIHcJCzxeJJbIjg",226,0.995595,24,227,1,226,1,1,0,1,1,117,117,110,109,17
"1610",9,"[24]ElwHnKqGocIHcJCzxeJJbIjg",246,0.995951,24,247,1,246,1,1,0,1,1,103,103,144,143,17
"1611",10,"[24]ElwHnKqGocIHcJCzxeJJbIjg",239,0.995833,24,240,1,239,1,1,0,1,1,111,111,129,128,17
"1612",11,"[24]ElwHnKqGocIHcJCzxeJJbIjg",236,0.995781,24,237,1,236,1,1,0,1,1,113,113,124,123,17
"1613",12,"[24]ElwHnKqGocIHcJCzxeJJbIjg",230,0.995671,24,231,1,230,1,1,0,1,1,115,115,116,115,17
"1614",13,"[24]ElwHnKqGocIHcJCzxeJJbIjg",234,0.995745,24,235,1,234,1,1,0,1,1,112,112,123,122,17
"1615",14,"[24]ElwHnKqGocIHcJCzxeJJbIjg",226,0.995595,24,227,1,226,1,1,0,1,1,117,117,110,109,17
"1616",15,"[24]ElwHnKqGocIHcJCzxeJJbIjg",234,0.995745,24,235,1,234,1,1,0,1,1,112,112,123,122,17
"1617",16,"[24]ElwHnKqGocIHcJCzxeJJbIjg",228,0.995633,24,229,1,228,1,1,0,1,1,116,116,113,112,17
"1618",17,"[24]ElwHnKqGocIHcJCzxeJJbIjg",231,0.99569,24,232,1,231,1,1,0,1,1,113,113,119,118,17
"1619",18,"[24]ElwHnKqGocIHcJCzxeJJbIjg",229,0.995652,24,230,1,229,1,1,0,1,1,115,115,115,114,17
"1620",19,"[24]ElwHnKqGocIHcJCzxeJJbIjg",236,0.995781,24,237,1,236,1,1,0,1,1,112,112,125,124,17
"1621",20,"[24]ElwHnKqGocIHcJCzxeJJbIjg",236,0.995781,24,237,1,236,1,1,0,1,1,110,110,127,126,17
"1622",21,"[24]ElwHnKqGocIHcJCzxeJJbIjg",234,0.995745,24,235,1,234,1,1,0,1,1,112,112,123,122,17
"1623",22,"[24]ElwHnKqGocIHcJCzxeJJbIjg",231,0.99569,24,232,1,231,1,1,0,1,1,113,113,119,118,17
"1624",23,"[24]ElwHnKqGocIHcJCzxeJJbIjg",230,0.995671,24,231,1,230,1,1,0,1,1,116,116,115,114,17
"1625",24,"[24]ElwHnKqGocIHcJCzxeJJbIjg",228,0.995633,24,229,1,228,1,1,0,1,1,116,116,113,112,17
"1626",25,"[24]ElwHnKqGocIHcJCzxeJJbIjg",222,0.995516,24,223,1,222,1,1,0,1,1,121,121,102,101,17
"1627",26,"[24]ElwHnKqGocIHcJCzxeJJbIjg",235,0.995763,24,236,1,235,1,1,0,1,1,113,113,123,122,17
"1628",27,"[24]ElwHnKqGocIHcJCzxeJJbIjg",236,0.995781,24,237,1,236,1,1,0,1,1,111,111,126,125,17
"1629",28,"[24]ElwHnKqGocIHcJCzxeJJbIjg",217,0.995413,24,218,1,217,1,1,0,1,1,125,125,93,92,17
"1630",29,"[24]ElwHnKqGocIHcJCzxeJJbIjg",216,0.995392,24,217,1,216,1,1,0,1,1,126,126,91,90,17
"1631",30,"[24]ElwHnKqGocIHcJCzxeJJbIjg",235,0.995763,24,236,1,235,1,1,0,1,1,111,111,125,124,17
"1632",31,"[24]ElwHnKqGocIHcJCzxeJJbIjg",238,0.995816,24,239,1,238,1,1,0,1,1,108,108,131,130,17
"1633",32,"[24]ElwHnKqGocIHcJCzxeJJbIjg",222,0.995516,24,223,1,222,1,1,0,1,1,121,121,102,101,17
"1634",33,"[24]ElwHnKqGocIHcJCzxeJJbIjg",226,0.995595,24,227,1,226,1,1,0,1,1,118,118,109,108,17
"1635",34,"[24]ElwHnKqGocIHcJCzxeJJbIjg",232,0.995708,24,233,1,232,1,1,0,1,1,113,113,120,119,17
"1636",35,"[24]ElwHnKqGocIHcJCzxeJJbIjg",237,0.995798,24,238,1,237,1,1,0,1,1,111,111,127,126,17
"1637",36,"[24]ElwHnKqGocIHcJCzxeJJbIjg",234,0.995745,24,235,1,234,1,1,0,1,1,114,114,121,120,17
"1638",37,"[24]ElwHnKqGocIHcJCzxeJJbIjg",234,0.995745,24,235,1,234,1,1,0,1,1,111,111,124,123,17
"1639",38,"[24]ElwHnKqGocIHcJCzxeJJbIjg",234,0.995745,24,235,1,234,1,1,0,1,1,111,111,124,123,17
"1640",39,"[24]ElwHnKqGocIHcJCzxeJJbIjg",224,0.995556,24,225,1,224,1,1,0,1,1,120,120,105,104,17
"1641",40,"[24]ElwHnKqGocIHcJCzxeJJbIjg",232,0.995708,24,233,1,232,1,1,0,1,1,113,113,120,119,17
"1642",41,"[24]ElwHnKqGocIHcJCzxeJJbIjg",230,0.995671,24,231,1,230,1,1,0,1,1,115,115,116,115,17
"1643",42,"[24]ElwHnKqGocIHcJCzxeJJbIjg",234,0.995745,24,235,1,234,1,1,0,1,1,113,113,122,121,17
"1644",43,"[24]ElwHnKqGocIHcJCzxeJJbIjg",219,0.995455,24,220,1,219,1,1,0,1,1,123,123,97,96,17
"1645",44,"[24]ElwHnKqGocIHcJCzxeJJbIjg",222,0.995516,24,223,1,222,1,1,0,1,1,121,121,102,101,17
"1646",45,"[24]ElwHnKqGocIHcJCzxeJJbIjg",238,0.995816,24,239,1,238,1,1,0,1,1,109,109,130,129,17
"1647",46,"[24]ElwHnKqGocIHcJCzxeJJbIjg",230,0.995671,24,231,1,230,1,1,0,1,1,115,115,116,115,17
"1648",47,"[24]ElwHnKqGocIHcJCzxeJJbIjg",235,0.995763,24,236,1,235,1,1,0,1,1,111,111,125,124,17
"1649",48,"[24]ElwHnKqGocIHcJCzxeJJbIjg",219,0.995455,24,220,1,219,1,1,0,1,1,123,123,97,96,17
"1650",49,"[24]ElwHnKqGocIHcJCzxeJJbIjg",230,0.995671,24,231,1,230,1,1,0,1,1,114,114,117,116,17
"1651",50,"[24]ElwHnKqGocIHcJCzxeJJbIjg",231,0.99569,24,232,1,231,1,1,0,1,1,113,113,119,118,17
"1652",51,"[24]ElwHnKqGocIHcJCzxeJJbIjg",229,0.995652,24,230,1,229,1,1,0,1,1,116,116,114,113,17
"1653",52,"[24]ElwHnKqGocIHcJCzxeJJbIjg",234,0.995745,24,235,1,234,1,1,0,1,1,112,112,123,122,17
"1654",53,"[24]ElwHnKqGocIHcJCzxeJJbIjg",218,0.995434,24,219,1,218,1,1,0,1,1,124,124,95,94,17
"1655",54,"[24]ElwHnKqGocIHcJCzxeJJbIjg",221,0.995495,24,222,1,221,1,1,0,1,1,123,123,99,98,17
"1656",55,"[24]ElwHnKqGocIHcJCzxeJJbIjg",225,0.995575,24,226,1,225,1,1,0,1,1,119,119,107,106,17
"1657",56,"[24]ElwHnKqGocIHcJCzxeJJbIjg",237,0.995798,24,238,1,237,1,1,0,1,1,110,110,128,127,17
"1658",57,"[24]ElwHnKqGocIHcJCzxeJJbIjg",226,0.995595,24,227,1,226,1,1,0,1,1,117,117,110,109,17
"1659",58,"[24]ElwHnKqGocIHcJCzxeJJbIjg",228,0.995633,24,229,1,228,1,1,0,1,1,117,117,112,111,17
"1660",59,"[24]ElwHnKqGocIHcJCzxeJJbIjg",242,0.995885,24,243,1,242,1,1,0,1,1,105,105,138,137,17
"1661",60,"[24]ElwHnKqGocIHcJCzxeJJbIjg",227,0.995614,24,228,1,227,1,1,0,1,1,119,119,109,108,17
"1662",61,"[24]ElwHnKqGocIHcJCzxeJJbIjg",235,0.995763,24,236,1,235,1,1,0,1,1,114,114,122,121,17
"1663",62,"[24]ElwHnKqGocIHcJCzxeJJbIjg",242,0.995885,24,243,1,242,1,1,0,1,1,105,105,138,137,17
"1664",63,"[24]ElwHnKqGocIHcJCzxeJJbIjg",220,0.995475,24,221,1,220,1,1,0,1,1,122,122,99,98,17
"1665",64,"[24]ElwHnKqGocIHcJCzxeJJbIjg",230,0.995671,24,231,1,230,1,1,0,1,1,115,115,116,115,17
"1666",65,"[24]ElwHnKqGocIHcJCzxeJJbIjg",233,0.995726,24,234,1,233,1,1,0,1,1,114,114,120,119,17
"1667",66,"[24]ElwHnKqGocIHcJCzxeJJbIjg",225,0.995575,24,226,1,225,1,1,0,1,1,120,120,106,105,17
"1668",67,"[24]ElwHnKqGocIHcJCzxeJJbIjg",230,0.995671,24,231,1,230,1,1,0,1,1,115,115,116,115,17
"1669",68,"[24]ElwHnKqGocIHcJCzxeJJbIjg",230,0.995671,24,231,1,230,1,1,0,1,1,116,116,115,114,17
"1670",69,"[24]ElwHnKqGocIHcJCzxeJJbIjg",228,0.995633,24,229,1,228,1,1,0,1,1,117,117,112,111,17
"1671",70,"[24]ElwHnKqGocIHcJCzxeJJbIjg",233,0.995726,24,234,1,233,1,1,0,1,1,113,113,121,120,17
"1672",71,"[24]ElwHnKqGocIHcJCzxeJJbIjg",232,0.995708,24,233,1,232,1,1,0,1,1,113,113,120,119,17
"1673",72,"[24]ElwHnKqGocIHcJCzxeJJbIjg",228,0.995633,24,229,1,228,1,1,0,1,1,116,116,113,112,17
"1674",73,"[24]ElwHnKqGocIHcJCzxeJJbIjg",240,0.995851,24,241,1,240,1,1,0,1,1,107,107,134,133,17
"1675",74,"[24]ElwHnKqGocIHcJCzxeJJbIjg",225,0.995575,24,226,1,225,1,1,0,1,1,118,118,108,107,17
"1676",75,"[24]ElwHnKqGocIHcJCzxeJJbIjg",221,0.995495,24,222,1,221,1,1,0,1,1,123,123,99,98,17
"1677",76,"[24]ElwHnKqGocIHcJCzxeJJbIjg",236,0.995781,24,237,1,236,1,1,0,1,1,114,114,123,122,17
"1678",77,"[24]ElwHnKqGocIHcJCzxeJJbIjg",224,0.995556,24,225,1,224,1,1,0,1,1,119,119,106,105,17
"1679",78,"[24]ElwHnKqGocIHcJCzxeJJbIjg",229,0.995652,24,230,1,229,1,1,0,1,1,116,116,114,113,17
"1680",79,"[24]ElwHnKqGocIHcJCzxeJJbIjg",229,0.995652,24,230,1,229,1,1,0,1,1,116,116,114,113,17
"1681",80,"[24]ElwHnKqGocIHcJCzxeJJbIjg",232,0.995708,24,233,1,232,1,1,0,1,1,117,117,116,115,17
"1682",81,"[24]ElwHnKqGocIHcJCzxeJJbIjg",226,0.995595,24,227,1,226,1,1,0,1,1,117,117,110,109,17
"1683",82,"[24]ElwHnKqGocIHcJCzxeJJbIjg",221,0.995495,24,222,1,221,1,1,0,1,1,123,123,99,98,17
"1684",83,"[24]ElwHnKqGocIHcJCzxeJJbIjg",230,0.995671,24,231,1,230,1,1,0,1,1,116,116,115,114,17
"1685",84,"[24]ElwHnKqGocIHcJCzxeJJbIjg",228,0.995633,24,229,1,228,1,1,0,1,1,116,116,113,112,17
"1686",85,"[24]ElwHnKqGocIHcJCzxeJJbIjg",240,0.995851,24,241,1,240,1,1,0,1,1,112,112,129,128,17
"1687",86,"[24]ElwHnKqGocIHcJCzxeJJbIjg",235,0.995763,24,236,1,235,1,1,0,1,1,110,110,126,125,17
"1688",87,"[24]ElwHnKqGocIHcJCzxeJJbIjg",232,0.995708,24,233,1,232,1,1,0,1,1,114,114,119,118,17
"1689",88,"[24]ElwHnKqGocIHcJCzxeJJbIjg",239,0.995833,24,240,1,239,1,1,0,1,1,107,107,133,132,17
"1690",89,"[24]ElwHnKqGocIHcJCzxeJJbIjg",229,0.995652,24,230,1,229,1,1,0,1,1,115,115,115,114,17
"1691",90,"[24]ElwHnKqGocIHcJCzxeJJbIjg",225,0.995575,24,226,1,225,1,1,0,1,1,118,118,108,107,17
"1692",91,"[24]ElwHnKqGocIHcJCzxeJJbIjg",228,0.995633,24,229,1,228,1,1,0,1,1,120,120,109,108,17
"1693",92,"[24]ElwHnKqGocIHcJCzxeJJbIjg",230,0.995671,24,231,1,230,1,1,0,1,1,117,117,114,113,17
"1694",93,"[24]ElwHnKqGocIHcJCzxeJJbIjg",229,0.995652,24,230,1,229,1,1,0,1,1,116,116,114,113,17
"1695",94,"[24]ElwHnKqGocIHcJCzxeJJbIjg",228,0.995633,24,229,1,228,1,1,0,1,1,117,117,112,111,17
"1696",95,"[24]ElwHnKqGocIHcJCzxeJJbIjg",230,0.995671,24,231,1,230,1,1,0,1,1,115,115,116,115,17
"1697",96,"[24]ElwHnKqGocIHcJCzxeJJbIjg",234,0.995745,24,235,1,234,1,1,0,1,1,112,112,123,122,17
"1698",97,"[24]ElwHnKqGocIHcJCzxeJJbIjg",249,0.996,24,250,1,249,1,1,0,1,1,107,107,143,142,17
"1699",98,"[24]ElwHnKqGocIHcJCzxeJJbIjg",226,0.995595,24,227,1,226,1,1,0,1,1,117,117,110,109,17
"1700",99,"[24]ElwHnKqGocIHcJCzxeJJbIjg",224,0.995556,24,225,1,224,1,1,0,1,1,120,120,105,104,17
"1701",0,"[32]EgbuHnKqGocIHBJCKkkrCCFiAKihdCKf",230,0.995671,32,231,1,230,1,1,0,1,1,114,114,117,116,18
"1702",1,"[32]EgbuHnKqGocIHBJCKkkrCCFiAKihdCKf",224,0.995556,32,225,1,224,1,1,0,1,1,119,119,106,105,18
"1703",2,"[32]EgbuHnKqGocIHBJCKkkrCCFiAKihdCKf",233,0.995726,32,234,1,233,1,1,0,1,1,112,112,122,121,18
"1704",3,"[32]EgbuHnKqGocIHBJCKkkrCCFiAKihdCKf",230,0.995671,32,231,1,230,1,1,0,1,1,115,115,116,115,18
"1705",4,"[32]EgbuHnKqGocIHBJCKkkrCCFiAKihdCKf",225,0.995575,32,226,1,225,1,1,0,1,1,118,118,108,107,18
"1706",5,"[32]EgbuHnKqGocIHBJCKkkrCCFiAKihdCKf",229,0.995652,32,230,1,229,1,1,0,1,1,115,115,115,114,18
"1707",6,"[32]EgbuHnKqGocIHBJCKkkrCCFiAKihdCKf",226,0.995595,32,227,1,226,1,1,0,1,1,117,117,110,109,18
"1708",7,"[32]EgbuHnKqGocIHBJCKkkrCCFiAKihdCKf",232,0.995708,32,233,1,232,1,1,0,1,1,114,114,119,118,18
"1709",8,"[32]EgbuHnKqGocIHBJCKkkrCCFiAKihdCKf",222,0.995516,32,223,1,222,1,1,0,1,1,120,120,103,102,18
"1710",9,"[32]EgbuHnKqGocIHBJCKkkrCCFiAKihdCKf",240,0.995851,32,241,1,240,1,1,0,1,1,107,107,134,133,18
"1711",10,"[32]EgbuHnKqGocIHBJCKkkrCCFiAKihdCKf",225,0.995575,32,226,1,225,1,1,0,1,1,119,119,107,106,18
"1712",11,"[32]EgbuHnKqGocIHBJCKkkrCCFiAKihdCKf",227,0.995614,32,228,1,227,1,1,0,1,1,117,117,111,110,18
"1713",12,"[32]EgbuHnKqGocIHBJCKkkrCCFiAKihdCKf",225,0.995575,32,226,1,225,1,1,0,1,1,118,118,108,107,18
"1714",13,"[32]EgbuHnKqGocIHBJCKkkrCCFiAKihdCKf",232,0.995708,32,233,1,232,1,1,0,1,1,113,113,120,119,18
"1715",14,"[32]EgbuHnKqGocIHBJCKkkrCCFiAKihdCKf",223,0.995536,32,224,1,223,1,1,0,1,1,120,120,104,103,18
"1716",15,"[32]EgbuHnKqGocIHBJCKkkrCCFiAKihdCKf",239,0.995833,32,240,1,239,1,1,0,1,1,108,108,132,131,18
"1717",16,"[32]EgbuHnKqGocIHBJCKkkrCCFiAKihdCKf",224,0.995556,32,225,1,224,1,1,0,1,1,120,120,105,104,18
"1718",17,"[32]EgbuHnKqGocIHBJCKkkrCCFiAKihdCKf",241,0.995868,32,242,1,241,1,1,0,1,1,105,105,137,136,18
"1719",18,"[32]EgbuHnKqGocIHBJCKkkrCCFiAKihdCKf",230,0.995671,32,231,1,230,1,1,0,1,1,115,115,116,115,18
"1720",19,"[32]EgbuHnKqGocIHBJCKkkrCCFiAKihdCKf",222,0.995516,32,223,1,222,1,1,0,1,1,120,120,103,102,18
"1721",20,"[32]EgbuHnKqGocIHBJCKkkrCCFiAKihdCKf",243,0.995902,32,244,1,243,1,1,0,1,1,106,106,138,137,18
"1722",21,"[32]EgbuHnKqGocIHBJCKkkrCCFiAKihdCKf",231,0.99569,32,232,1,231,1,1,0,1,1,117,117,115,114,18
"1723",22,"[32]EgbuHnKqGocIHBJCKkkrCCFiAKihdCKf",217,0.995413,32,218,1,217,1,1,0,1,1,127,127,91,90,18
"1724",23,"[32]EgbuHnKqGocIHBJCKkkrCCFiAKihdCKf",247,0.995968,32,248,1,247,1,1,0,1,1,102,102,146,145,18
"1725",24,"[32]EgbuHnKqGocIHBJCKkkrCCFiAKihdCKf",230,0.995671,32,231,1,230,1,1,0,1,1,114,114,117,116,18
"1726",25,"[32]EgbuHnKqGocIHBJCKkkrCCFiAKihdCKf",235,0.995763,32,236,1,235,1,1,0,1,1,112,112,124,123,18
"1727",26,"[32]EgbuHnKqGocIHBJCKkkrCCFiAKihdCKf",225,0.995575,32,226,1,225,1,1,0,1,1,118,118,108,107,18
"1728",27,"[32]EgbuHnKqGocIHBJCKkkrCCFiAKihdCKf",222,0.995516,32,223,1,222,1,1,0,1,1,120,120,103,102,18
"1729",28,"[32]EgbuHnKqGocIHBJCKkkrCCFiAKihdCKf",232,0.995708,32,233,1,232,1,1,0,1,1,112,112,121,120,18
"1730",29,"[32]EgbuHnKqGocIHBJCKkkrCCFiAKihdCKf",230,0.995671,32,231,1,230,1,1,0,1,1,114,114,117,116,18
"1731",30,"[32]EgbuHnKqGocIHBJCKkkrCCFiAKihdCKf",230,0.995671,32,231,1,230,1,1,0,1,1,115,115,116,115,18
"1732",31,"[32]EgbuHnKqGocIHBJCKkkrCCFiAKihdCKf",226,0.995595,32,227,1,226,1,1,0,1,1,117,117,110,109,18
"1733",32,"[32]EgbuHnKqGocIHBJCKkkrCCFiAKihdCKf",242,0.995885,32,243,1,242,1,1,0,1,1,105,105,138,137,18
"1734",33,"[32]EgbuHnKqGocIHBJCKkkrCCFiAKihdCKf",230,0.995671,32,231,1,230,1,1,0,1,1,114,114,117,116,18
"1735",34,"[32]EgbuHnKqGocIHBJCKkkrCCFiAKihdCKf",224,0.995556,32,225,1,224,1,1,0,1,1,120,120,105,104,18
"1736",35,"[32]EgbuHnKqGocIHBJCKkkrCCFiAKihdCKf",231,0.99569,32,232,1,231,1,1,0,1,1,113,113,119,118,18
"1737",36,"[32]EgbuHnKqGocIHBJCKkkrCCFiAKihdCKf",216,0.995392,32,217,1,216,1,1,0,1,1,125,125,92,91,18
"1738",37,"[32]EgbuHnKqGocIHBJCKkkrCCFiAKihdCKf",235,0.995763,32,236,1,235,1,1,0,1,1,110,110,126,125,18
"1739",38,"[32]EgbuHnKqGocIHBJCKkkrCCFiAKihdCKf",229,0.995652,32,230,1,229,1,1,0,1,1,116,116,114,113,18
"1740",39,"[32]EgbuHnKqGocIHBJCKkkrCCFiAKihdCKf",227,0.995614,32,228,1,227,1,1,0,1,1,121,121,107,106,18
"1741",40,"[32]EgbuHnKqGocIHBJCKkkrCCFiAKihdCKf",233,0.995726,32,234,1,233,1,1,0,1,1,117,117,117,116,18
"1742",41,"[32]EgbuHnKqGocIHBJCKkkrCCFiAKihdCKf",229,0.995652,32,230,1,229,1,1,0,1,1,116,116,114,113,18
"1743",42,"[32]EgbuHnKqGocIHBJCKkkrCCFiAKihdCKf",237,0.995798,32,238,1,237,1,1,0,1,1,113,113,125,124,18
"1744",43,"[32]EgbuHnKqGocIHBJCKkkrCCFiAKihdCKf",222,0.995516,32,223,1,222,1,1,0,1,1,120,120,103,102,18
"1745",44,"[32]EgbuHnKqGocIHBJCKkkrCCFiAKihdCKf",229,0.995652,32,230,1,229,1,1,0,1,1,115,115,115,114,18
"1746",45,"[32]EgbuHnKqGocIHBJCKkkrCCFiAKihdCKf",240,0.995851,32,241,1,240,1,1,0,1,1,107,107,134,133,18
"1747",46,"[32]EgbuHnKqGocIHBJCKkkrCCFiAKihdCKf",226,0.995595,32,227,1,226,1,1,0,1,1,119,119,108,107,18
"1748",47,"[32]EgbuHnKqGocIHBJCKkkrCCFiAKihdCKf",232,0.995708,32,233,1,232,1,1,0,1,1,113,113,120,119,18
"1749",48,"[32]EgbuHnKqGocIHBJCKkkrCCFiAKihdCKf",231,0.99569,32,232,1,231,1,1,0,1,1,116,116,116,115,18
"1750",49,"[32]EgbuHnKqGocIHBJCKkkrCCFiAKihdCKf",228,0.995633,32,229,1,228,1,1,0,1,1,116,116,113,112,18
"1751",50,"[32]EgbuHnKqGocIHBJCKkkrCCFiAKihdCKf",224,0.995556,32,225,1,224,1,1,0,1,1,119,119,106,105,18
"1752",51,"[32]EgbuHnKqGocIHBJCKkkrCCFiAKihdCKf",230,0.995671,32,231,1,230,1,1,0,1,1,115,115,116,115,18
"1753",52,"[32]EgbuHnKqGocIHBJCKkkrCCFiAKihdCKf",227,0.995614,32,228,1,227,1,1,0,1,1,116,116,112,111,18
"1754",53,"[32]EgbuHnKqGocIHBJCKkkrCCFiAKihdCKf",226,0.995595,32,227,1,226,1,1,0,1,1,118,118,109,108,18
"1755",54,"[32]EgbuHnKqGocIHBJCKkkrCCFiAKihdCKf",222,0.995516,32,223,1,222,1,1,0,1,1,121,121,102,101,18
"1756",55,"[32]EgbuHnKqGocIHBJCKkkrCCFiAKihdCKf",222,0.995516,32,223,1,222,1,1,0,1,1,121,121,102,101,18
"1757",56,"[32]EgbuHnKqGocIHBJCKkkrCCFiAKihdCKf",231,0.99569,32,232,1,231,1,1,0,1,1,113,113,119,118,18
"1758",57,"[32]EgbuHnKqGocIHBJCKkkrCCFiAKihdCKf",225,0.995575,32,226,1,225,1,1,0,1,1,120,120,106,105,18
"1759",58,"[32]EgbuHnKqGocIHBJCKkkrCCFiAKihdCKf",234,0.995745,32,235,1,234,1,1,0,1,1,112,112,123,122,18
"1760",59,"[32]EgbuHnKqGocIHBJCKkkrCCFiAKihdCKf",229,0.995652,32,230,1,229,1,1,0,1,1,116,116,114,113,18
"1761",60,"[32]EgbuHnKqGocIHBJCKkkrCCFiAKihdCKf",227,0.995614,32,228,1,227,1,1,0,1,1,118,118,110,109,18
"1762",61,"[32]EgbuHnKqGocIHBJCKkkrCCFiAKihdCKf",237,0.995798,32,238,1,237,1,1,0,1,1,110,110,128,127,18
"1763",62,"[32]EgbuHnKqGocIHBJCKkkrCCFiAKihdCKf",231,0.99569,32,232,1,231,1,1,0,1,1,114,114,118,117,18
"1764",63,"[32]EgbuHnKqGocIHBJCKkkrCCFiAKihdCKf",226,0.995595,32,227,1,226,1,1,0,1,1,118,118,109,108,18
"1765",64,"[32]EgbuHnKqGocIHBJCKkkrCCFiAKihdCKf",234,0.995745,32,235,1,234,1,1,0,1,1,115,115,120,119,18
"1766",65,"[32]EgbuHnKqGocIHBJCKkkrCCFiAKihdCKf",231,0.99569,32,232,1,231,1,1,0,1,1,113,113,119,118,18
"1767",66,"[32]EgbuHnKqGocIHBJCKkkrCCFiAKihdCKf",232,0.995708,32,233,1,232,1,1,0,1,1,113,113,120,119,18
"1768",67,"[32]EgbuHnKqGocIHBJCKkkrCCFiAKihdCKf",232,0.995708,32,233,1,232,1,1,0,1,1,115,115,118,117,18
"1769",68,"[32]EgbuHnKqGocIHBJCKkkrCCFiAKihdCKf",230,0.995671,32,231,1,230,1,1,0,1,1,115,115,116,115,18
"1770",69,"[32]EgbuHnKqGocIHBJCKkkrCCFiAKihdCKf",222,0.995516,32,223,1,222,1,1,0,1,1,120,120,103,102,18
"1771",70,"[32]EgbuHnKqGocIHBJCKkkrCCFiAKihdCKf",244,0.995918,32,245,1,244,1,1,0,1,1,105,105,140,139,18
"1772",71,"[32]EgbuHnKqGocIHBJCKkkrCCFiAKihdCKf",229,0.995652,32,230,1,229,1,1,0,1,1,115,115,115,114,18
"1773",72,"[32]EgbuHnKqGocIHBJCKkkrCCFiAKihdCKf",236,0.995781,32,237,1,236,1,1,0,1,1,109,109,128,127,18
"1774",73,"[32]EgbuHnKqGocIHBJCKkkrCCFiAKihdCKf",247,0.995968,32,248,1,247,1,1,0,1,1,103,103,145,144,18
"1775",74,"[32]EgbuHnKqGocIHBJCKkkrCCFiAKihdCKf",229,0.995652,32,230,1,229,1,1,0,1,1,115,115,115,114,18
"1776",75,"[32]EgbuHnKqGocIHBJCKkkrCCFiAKihdCKf",231,0.99569,32,232,1,231,1,1,0,1,1,113,113,119,118,18
"1777",76,"[32]EgbuHnKqGocIHBJCKkkrCCFiAKihdCKf",237,0.995798,32,238,1,237,1,1,0,1,1,110,110,128,127,18
"1778",77,"[32]EgbuHnKqGocIHBJCKkkrCCFiAKihdCKf",232,0.995708,32,233,1,232,1,1,0,1,1,113,113,120,119,18
"1779",78,"[32]EgbuHnKqGocIHBJCKkkrCCFiAKihdCKf",226,0.995595,32,227,1,226,1,1,0,1,1,118,118,109,108,18
"1780",79,"[32]EgbuHnKqGocIHBJCKkkrCCFiAKihdCKf",221,0.995495,32,222,1,221,1,1,0,1,1,121,121,101,100,18
"1781",80,"[32]EgbuHnKqGocIHBJCKkkrCCFiAKihdCKf",227,0.995614,32,228,1,227,1,1,0,1,1,118,118,110,109,18
"1782",81,"[32]EgbuHnKqGocIHBJCKkkrCCFiAKihdCKf",236,0.995781,32,237,1,236,1,1,0,1,1,112,112,125,124,18
"1783",82,"[32]EgbuHnKqGocIHBJCKkkrCCFiAKihdCKf",231,0.99569,32,232,1,231,1,1,0,1,1,115,115,117,116,18
"1784",83,"[32]EgbuHnKqGocIHBJCKkkrCCFiAKihdCKf",222,0.995516,32,223,1,222,1,1,0,1,1,121,121,102,101,18
"1785",84,"[32]EgbuHnKqGocIHBJCKkkrCCFiAKihdCKf",224,0.995556,32,225,1,224,1,1,0,1,1,120,120,105,104,18
"1786",85,"[32]EgbuHnKqGocIHBJCKkkrCCFiAKihdCKf",229,0.995652,32,230,1,229,1,1,0,1,1,115,115,115,114,18
"1787",86,"[32]EgbuHnKqGocIHBJCKkkrCCFiAKihdCKf",227,0.995614,32,228,1,227,1,1,0,1,1,117,117,111,110,18
"1788",87,"[32]EgbuHnKqGocIHBJCKkkrCCFiAKihdCKf",240,0.995851,32,241,1,240,1,1,0,1,1,107,107,134,133,18
"1789",88,"[32]EgbuHnKqGocIHBJCKkkrCCFiAKihdCKf",226,0.995595,32,227,1,226,1,1,0,1,1,118,118,109,108,18
"1790",89,"[32]EgbuHnKqGocIHBJCKkkrCCFiAKihdCKf",229,0.995652,32,230,1,229,1,1,0,1,1,116,116,114,113,18
"1791",90,"[32]EgbuHnKqGocIHBJCKkkrCCFiAKihdCKf",225,0.995575,32,226,1,225,1,1,0,1,1,119,119,107,106,18
"1792",91,"[32]EgbuHnKqGocIHBJCKkkrCCFiAKihdCKf",230,0.995671,32,231,1,230,1,1,0,1,1,116,116,115,114,18
"1793",92,"[32]EgbuHnKqGocIHBJCKkkrCCFiAKihdCKf",238,0.995816,32,239,1,238,1,1,0,1,1,108,108,131,130,18
"1794",93,"[32]EgbuHnKqGocIHBJCKkkrCCFiAKihdCKf",236,0.995781,32,237,1,236,1,1,0,1,1,109,109,128,127,18
"1795",94,"[32]EgbuHnKqGocIHBJCKkkrCCFiAKihdCKf",236,0.995781,32,237,1,236,1,1,0,1,1,111,111,126,125,18
"1796",95,"[32]EgbuHnKqGocIHBJCKkkrCCFiAKihdCKf",219,0.995455,32,220,1,219,1,1,0,1,1,124,124,96,95,18
"1797",96,"[32]EgbuHnKqGocIHBJCKkkrCCFiAKihdCKf",237,0.995798,32,238,1,237,1,1,0,1,1,111,111,127,126,18
"1798",97,"[32]EgbuHnKqGocIHBJCKkkrCCFiAKihdCKf",222,0.995516,32,223,1,222,1,1,0,1,1,120,120,103,102,18
"1799",98,"[32]EgbuHnKqGocIHBJCKkkrCCFiAKihdCKf",240,0.995851,32,241,1,240,1,1,0,1,1,107,107,134,133,18
"1800",99,"[32]EgbuHnKqGocIHBJCKkkrCCFiAKihdCKf",229,0.995652,32,230,1,229,1,1,0,1,1,115,115,115,114,18
"1801",0,"[23]EzwvHnKqGocIHcJCmGBEukl",235,0.995763,23,236,1,235,1,1,0,1,1,112,112,124,123,19
"1802",1,"[23]EzwvHnKqGocIHcJCmGBEukl",226,0.995595,23,227,1,226,1,1,0,1,1,119,119,108,107,19
"1803",2,"[23]EzwvHnKqGocIHcJCmGBEukl",229,0.995652,23,230,1,229,1,1,0,1,1,115,115,115,114,19
"1804",3,"[23]EzwvHnKqGocIHcJCmGBEukl",235,0.995763,23,236,1,235,1,1,0,1,1,110,110,126,125,19
"1805",4,"[23]EzwvHnKqGocIHcJCmGBEukl",236,0.995781,23,237,1,236,1,1,0,1,1,109,109,128,127,19
"1806",5,"[23]EzwvHnKqGocIHcJCmGBEukl",223,0.995536,23,224,1,223,1,1,0,1,1,123,123,101,100,19
"1807",6,"[23]EzwvHnKqGocIHcJCmGBEukl",239,0.995833,23,240,1,239,1,1,0,1,1,108,108,132,131,19
"1808",7,"[23]EzwvHnKqGocIHcJCmGBEukl",228,0.995633,23,229,1,228,1,1,0,1,1,116,116,113,112,19
"1809",8,"[23]EzwvHnKqGocIHcJCmGBEukl",231,0.99569,23,232,1,231,1,1,0,1,1,114,114,118,117,19
"1810",9,"[23]EzwvHnKqGocIHcJCmGBEukl",235,0.995763,23,236,1,235,1,1,0,1,1,110,110,126,125,19
"1811",10,"[23]EzwvHnKqGocIHcJCmGBEukl",227,0.995614,23,228,1,227,1,1,0,1,1,116,116,112,111,19
"1812",11,"[23]EzwvHnKqGocIHcJCmGBEukl",238,0.995816,23,239,1,238,1,1,0,1,1,108,108,131,130,19
"1813",12,"[23]EzwvHnKqGocIHcJCmGBEukl",231,0.99569,23,232,1,231,1,1,0,1,1,114,114,118,117,19
"1814",13,"[23]EzwvHnKqGocIHcJCmGBEukl",232,0.995708,23,233,1,232,1,1,0,1,1,112,112,121,120,19
"1815",14,"[23]EzwvHnKqGocIHcJCmGBEukl",238,0.995816,23,239,1,238,1,1,0,1,1,109,109,130,129,19
"1816",15,"[23]EzwvHnKqGocIHcJCmGBEukl",230,0.995671,23,231,1,230,1,1,0,1,1,116,116,115,114,19
"1817",16,"[23]EzwvHnKqGocIHcJCmGBEukl",238,0.995816,23,239,1,238,1,1,0,1,1,108,108,131,130,19
"1818",17,"[23]EzwvHnKqGocIHcJCmGBEukl",220,0.995475,23,221,1,220,1,1,0,1,1,123,123,98,97,19
"1819",18,"[23]EzwvHnKqGocIHcJCmGBEukl",231,0.99569,23,232,1,231,1,1,0,1,1,115,115,117,116,19
"1820",19,"[23]EzwvHnKqGocIHcJCmGBEukl",226,0.995595,23,227,1,226,1,1,0,1,1,120,120,107,106,19
"1821",20,"[23]EzwvHnKqGocIHcJCmGBEukl",233,0.995726,23,234,1,233,1,1,0,1,1,113,113,121,120,19
"1822",21,"[23]EzwvHnKqGocIHcJCmGBEukl",227,0.995614,23,228,1,227,1,1,0,1,1,119,119,109,108,19
"1823",22,"[23]EzwvHnKqGocIHcJCmGBEukl",230,0.995671,23,231,1,230,1,1,0,1,1,115,115,116,115,19
"1824",23,"[23]EzwvHnKqGocIHcJCmGBEukl",227,0.995614,23,228,1,227,1,1,0,1,1,116,116,112,111,19
"1825",24,"[23]EzwvHnKqGocIHcJCmGBEukl",239,0.995833,23,240,1,239,1,1,0,1,1,107,107,133,132,19
"1826",25,"[23]EzwvHnKqGocIHcJCmGBEukl",229,0.995652,23,230,1,229,1,1,0,1,1,116,116,114,113,19
"1827",26,"[23]EzwvHnKqGocIHcJCmGBEukl",219,0.995455,23,220,1,219,1,1,0,1,1,123,123,97,96,19
"1828",27,"[23]EzwvHnKqGocIHcJCmGBEukl",228,0.995633,23,229,1,228,1,1,0,1,1,117,117,112,111,19
"1829",28,"[23]EzwvHnKqGocIHcJCmGBEukl",222,0.995516,23,223,1,222,1,1,0,1,1,122,122,101,100,19
"1830",29,"[23]EzwvHnKqGocIHcJCmGBEukl",230,0.995671,23,231,1,230,1,1,0,1,1,116,116,115,114,19
"1831",30,"[23]EzwvHnKqGocIHcJCmGBEukl",229,0.995652,23,230,1,229,1,1,0,1,1,117,117,113,112,19
"1832",31,"[23]EzwvHnKqGocIHcJCmGBEukl",226,0.995595,23,227,1,226,1,1,0,1,1,121,121,106,105,19
"1833",32,"[23]EzwvHnKqGocIHcJCmGBEukl",226,0.995595,23,227,1,226,1,1,0,1,1,120,120,107,106,19
"1834",33,"[23]EzwvHnKqGocIHcJCmGBEukl",240,0.995851,23,241,1,240,1,1,0,1,1,106,106,135,134,19
"1835",34,"[23]EzwvHnKqGocIHcJCmGBEukl",236,0.995781,23,237,1,236,1,1,0,1,1,109,109,128,127,19
"1836",35,"[23]EzwvHnKqGocIHcJCmGBEukl",231,0.99569,23,232,1,231,1,1,0,1,1,115,115,117,116,19
"1837",36,"[23]EzwvHnKqGocIHcJCmGBEukl",226,0.995595,23,227,1,226,1,1,0,1,1,118,118,109,108,19
"1838",37,"[23]EzwvHnKqGocIHcJCmGBEukl",227,0.995614,23,228,1,227,1,1,0,1,1,118,118,110,109,19
"1839",38,"[23]EzwvHnKqGocIHcJCmGBEukl",229,0.995652,23,230,1,229,1,1,0,1,1,116,116,114,113,19
"1840",39,"[23]EzwvHnKqGocIHcJCmGBEukl",237,0.995798,23,238,1,237,1,1,0,1,1,109,109,129,128,19
"1841",40,"[23]EzwvHnKqGocIHcJCmGBEukl",220,0.995475,23,221,1,220,1,1,0,1,1,123,123,98,97,19
"1842",41,"[23]EzwvHnKqGocIHcJCmGBEukl",230,0.995671,23,231,1,230,1,1,0,1,1,114,114,117,116,19
"1843",42,"[23]EzwvHnKqGocIHcJCmGBEukl",222,0.995516,23,223,1,222,1,1,0,1,1,121,121,102,101,19
"1844",43,"[23]EzwvHnKqGocIHcJCmGBEukl",228,0.995633,23,229,1,228,1,1,0,1,1,119,119,110,109,19
"1845",44,"[23]EzwvHnKqGocIHcJCmGBEukl",233,0.995726,23,234,1,233,1,1,0,1,1,114,114,120,119,19
"1846",45,"[23]EzwvHnKqGocIHcJCmGBEukl",224,0.995556,23,225,1,224,1,1,0,1,1,119,119,106,105,19
"1847",46,"[23]EzwvHnKqGocIHcJCmGBEukl",244,0.995918,23,245,1,244,1,1,0,1,1,104,104,141,140,19
"1848",47,"[23]EzwvHnKqGocIHcJCmGBEukl",227,0.995614,23,228,1,227,1,1,0,1,1,117,117,111,110,19
"1849",48,"[23]EzwvHnKqGocIHcJCmGBEukl",215,0.99537,23,216,1,215,1,1,0,1,1,128,128,88,87,19
"1850",49,"[23]EzwvHnKqGocIHcJCmGBEukl",232,0.995708,23,233,1,232,1,1,0,1,1,112,112,121,120,19
"1851",50,"[23]EzwvHnKqGocIHcJCmGBEukl",229,0.995652,23,230,1,229,1,1,0,1,1,119,119,111,110,19
"1852",51,"[23]EzwvHnKqGocIHcJCmGBEukl",232,0.995708,23,233,1,232,1,1,0,1,1,112,112,121,120,19
"1853",52,"[23]EzwvHnKqGocIHcJCmGBEukl",237,0.995798,23,238,1,237,1,1,0,1,1,110,110,128,127,19
"1854",53,"[23]EzwvHnKqGocIHcJCmGBEukl",229,0.995652,23,230,1,229,1,1,0,1,1,116,116,114,113,19
"1855",54,"[23]EzwvHnKqGocIHcJCmGBEukl",233,0.995726,23,234,1,233,1,1,0,1,1,113,113,121,120,19
"1856",55,"[23]EzwvHnKqGocIHcJCmGBEukl",231,0.99569,23,232,1,231,1,1,0,1,1,113,113,119,118,19
"1857",56,"[23]EzwvHnKqGocIHcJCmGBEukl",231,0.99569,23,232,1,231,1,1,0,1,1,114,114,118,117,19
"1858",57,"[23]EzwvHnKqGocIHcJCmGBEukl",235,0.995763,23,236,1,235,1,1,0,1,1,110,110,126,125,19
"1859",58,"[23]EzwvHnKqGocIHcJCmGBEukl",238,0.995816,23,239,1,238,1,1,0,1,1,108,108,131,130,19
"1860",59,"[23]EzwvHnKqGocIHcJCmGBEukl",227,0.995614,23,228,1,227,1,1,0,1,1,116,116,112,111,19
"1861",60,"[23]EzwvHnKqGocIHcJCmGBEukl",221,0.995495,23,222,1,221,1,1,0,1,1,121,121,101,100,19
"1862",61,"[23]EzwvHnKqGocIHcJCmGBEukl",229,0.995652,23,230,1,229,1,1,0,1,1,115,115,115,114,19
"1863",62,"[23]EzwvHnKqGocIHcJCmGBEukl",233,0.995726,23,234,1,233,1,1,0,1,1,113,113,121,120,19
"1864",63,"[23]EzwvHnKqGocIHcJCmGBEukl",225,0.995575,23,226,1,225,1,1,0,1,1,118,118,108,107,19
"1865",64,"[23]EzwvHnKqGocIHcJCmGBEukl",226,0.995595,23,227,1,226,1,1,0,1,1,118,118,109,108,19
"1866",65,"[23]EzwvHnKqGocIHcJCmGBEukl",218,0.995434,23,219,1,218,1,1,0,1,1,124,124,95,94,19
"1867",66,"[23]EzwvHnKqGocIHcJCmGBEukl",238,0.995816,23,239,1,238,1,1,0,1,1,110,110,129,128,19
"1868",67,"[23]EzwvHnKqGocIHcJCmGBEukl",233,0.995726,23,234,1,233,1,1,0,1,1,113,113,121,120,19
"1869",68,"[23]EzwvHnKqGocIHcJCmGBEukl",233,0.995726,23,234,1,233,1,1,0,1,1,112,112,122,121,19
"1870",69,"[23]EzwvHnKqGocIHcJCmGBEukl",228,0.995633,23,229,1,228,1,1,0,1,1,118,118,111,110,19
"1871",70,"[23]EzwvHnKqGocIHcJCmGBEukl",231,0.99569,23,232,1,231,1,1,0,1,1,113,113,119,118,19
"1872",71,"[23]EzwvHnKqGocIHcJCmGBEukl",234,0.995745,23,235,1,234,1,1,0,1,1,113,113,122,121,19
"1873",72,"[23]EzwvHnKqGocIHcJCmGBEukl",224,0.995556,23,225,1,224,1,1,0,1,1,122,122,103,102,19
"1874",73,"[23]EzwvHnKqGocIHcJCmGBEukl",236,0.995781,23,237,1,236,1,1,0,1,1,110,110,127,126,19
"1875",74,"[23]EzwvHnKqGocIHcJCmGBEukl",225,0.995575,23,226,1,225,1,1,0,1,1,119,119,107,106,19
"1876",75,"[23]EzwvHnKqGocIHcJCmGBEukl",235,0.995763,23,236,1,235,1,1,0,1,1,111,111,125,124,19
"1877",76,"[23]EzwvHnKqGocIHcJCmGBEukl",242,0.995885,23,243,1,242,1,1,0,1,1,109,109,134,133,19
"1878",77,"[23]EzwvHnKqGocIHcJCmGBEukl",234,0.995745,23,235,1,234,1,1,0,1,1,112,112,123,122,19
"1879",78,"[23]EzwvHnKqGocIHcJCmGBEukl",230,0.995671,23,231,1,230,1,1,0,1,1,116,116,115,114,19
"1880",79,"[23]EzwvHnKqGocIHcJCmGBEukl",214,0.995349,23,215,1,214,1,1,0,1,1,127,127,88,87,19
"1881",80,"[23]EzwvHnKqGocIHcJCmGBEukl",240,0.995851,23,241,1,240,1,1,0,1,1,108,108,133,132,19
"1882",81,"[23]EzwvHnKqGocIHcJCmGBEukl",238,0.995816,23,239,1,238,1,1,0,1,1,108,108,131,130,19
"1883",82,"[23]EzwvHnKqGocIHcJCmGBEukl",231,0.99569,23,232,1,231,1,1,0,1,1,116,116,116,115,19
"1884",83,"[23]EzwvHnKqGocIHcJCmGBEukl",232,0.995708,23,233,1,232,1,1,0,1,1,114,114,119,118,19
"1885",84,"[23]EzwvHnKqGocIHcJCmGBEukl",246,0.995951,23,247,1,246,1,1,0,1,1,101,101,146,145,19
"1886",85,"[23]EzwvHnKqGocIHcJCmGBEukl",231,0.99569,23,232,1,231,1,1,0,1,1,113,113,119,118,19
"1887",86,"[23]EzwvHnKqGocIHcJCmGBEukl",227,0.995614,23,228,1,227,1,1,0,1,1,117,117,111,110,19
"1888",87,"[23]EzwvHnKqGocIHcJCmGBEukl",225,0.995575,23,226,1,225,1,1,0,1,1,118,118,108,107,19
"1889",88,"[23]EzwvHnKqGocIHcJCmGBEukl",225,0.995575,23,226,1,225,1,1,0,1,1,120,120,106,105,19
"1890",89,"[23]EzwvHnKqGocIHcJCmGBEukl",230,0.995671,23,231,1,230,1,1,0,1,1,116,116,115,114,19
"1891",90,"[23]EzwvHnKqGocIHcJCmGBEukl",234,0.995745,23,235,1,234,1,1,0,1,1,111,111,124,123,19
"1892",91,"[23]EzwvHnKqGocIHcJCmGBEukl",237,0.995798,23,238,1,237,1,1,0,1,1,109,109,129,128,19
"1893",92,"[23]EzwvHnKqGocIHcJCmGBEukl",235,0.995763,23,236,1,235,1,1,0,1,1,112,112,124,123,19
"1894",93,"[23]EzwvHnKqGocIHcJCmGBEukl",245,0.995935,23,246,1,245,1,1,0,1,1,105,105,141,140,19
"1895",94,"[23]EzwvHnKqGocIHcJCmGBEukl",232,0.995708,23,233,1,232,1,1,0,1,1,113,113,120,119,19
"1896",95,"[23]EzwvHnKqGocIHcJCmGBEukl",215,0.99537,23,216,1,215,1,1,0,1,1,126,126,90,89,19
"1897",96,"[23]EzwvHnKqGocIHcJCmGBEukl",240,0.995851,23,241,1,240,1,1,0,1,1,106,106,135,134,19
"1898",97,"[23]EzwvHnKqGocIHcJCmGBEukl",228,0.995633,23,229,1,228,1,1,0,1,1,116,116,113,112,19
"1899",98,"[23]EzwvHnKqGocIHcJCmGBEukl",229,0.995652,23,230,1,229,1,1,0,1,1,116,116,114,113,19
"1900",99,"[23]EzwvHnKqGocIHcJCmGBEukl",235,0.995763,23,236,1,235,1,1,0,1,1,112,112,124,123,19
"1901",0,"[37]EDaxHnKqGocIHBJCowszAojmxcIdujbpuoFig",238,0.995816,37,239,1,238,1,1,0,1,1,108,108,131,130,20
"1902",1,"[37]EDaxHnKqGocIHBJCowszAojmxcIdujbpuoFig",228,0.995633,37,229,1,228,1,1,0,1,1,116,116,113,112,20
"1903",2,"[37]EDaxHnKqGocIHBJCowszAojmxcIdujbpuoFig",231,0.99569,37,232,1,231,1,1,0,1,1,113,113,119,118,20
"1904",3,"[37]EDaxHnKqGocIHBJCowszAojmxcIdujbpuoFig",228,0.995633,37,229,1,228,1,1,0,1,1,117,117,112,111,20
"1905",4,"[37]EDaxHnKqGocIHBJCowszAojmxcIdujbpuoFig",230,0.995671,37,231,1,230,1,1,0,1,1,114,114,117,116,20
"1906",5,"[37]EDaxHnKqGocIHBJCowszAojmxcIdujbpuoFig",228,0.995633,37,229,1,228,1,1,0,1,1,116,116,113,112,20
"1907",6,"[37]EDaxHnKqGocIHBJCowszAojmxcIdujbpuoFig",235,0.995763,37,236,1,235,1,1,0,1,1,110,110,126,125,20
"1908",7,"[37]EDaxHnKqGocIHBJCowszAojmxcIdujbpuoFig",229,0.995652,37,230,1,229,1,1,0,1,1,116,116,114,113,20
"1909",8,"[37]EDaxHnKqGocIHBJCowszAojmxcIdujbpuoFig",229,0.995652,37,230,1,229,1,1,0,1,1,117,117,113,112,20
"1910",9,"[37]EDaxHnKqGocIHBJCowszAojmxcIdujbpuoFig",228,0.995633,37,229,1,228,1,1,0,1,1,116,116,113,112,20
"1911",10,"[37]EDaxHnKqGocIHBJCowszAojmxcIdujbpuoFig",229,0.995652,37,230,1,229,1,1,0,1,1,115,115,115,114,20
"1912",11,"[37]EDaxHnKqGocIHBJCowszAojmxcIdujbpuoFig",226,0.995595,37,227,1,226,1,1,0,1,1,118,118,109,108,20
"1913",12,"[37]EDaxHnKqGocIHBJCowszAojmxcIdujbpuoFig",233,0.995726,37,234,1,233,1,1,0,1,1,113,113,121,120,20
"1914",13,"[37]EDaxHnKqGocIHBJCowszAojmxcIdujbpuoFig",215,0.99537,37,216,1,215,1,1,0,1,1,126,126,90,89,20
"1915",14,"[37]EDaxHnKqGocIHBJCowszAojmxcIdujbpuoFig",226,0.995595,37,227,1,226,1,1,0,1,1,118,118,109,108,20
"1916",15,"[37]EDaxHnKqGocIHBJCowszAojmxcIdujbpuoFig",234,0.995745,37,235,1,234,1,1,0,1,1,115,115,120,119,20
"1917",16,"[37]EDaxHnKqGocIHBJCowszAojmxcIdujbpuoFig",233,0.995726,37,234,1,233,1,1,0,1,1,113,113,121,120,20
"1918",17,"[37]EDaxHnKqGocIHBJCowszAojmxcIdujbpuoFig",228,0.995633,37,229,1,228,1,1,0,1,1,118,118,111,110,20
"1919",18,"[37]EDaxHnKqGocIHBJCowszAojmxcIdujbpuoFig",235,0.995763,37,236,1,235,1,1,0,1,1,111,111,125,124,20
"1920",19,"[37]EDaxHnKqGocIHBJCowszAojmxcIdujbpuoFig",241,0.995868,37,242,1,241,1,1,0,1,1,106,106,136,135,20
"1921",20,"[37]EDaxHnKqGocIHBJCowszAojmxcIdujbpuoFig",237,0.995798,37,238,1,237,1,1,0,1,1,109,109,129,128,20
"1922",21,"[37]EDaxHnKqGocIHBJCowszAojmxcIdujbpuoFig",235,0.995763,37,236,1,235,1,1,0,1,1,111,111,125,124,20
"1923",22,"[37]EDaxHnKqGocIHBJCowszAojmxcIdujbpuoFig",239,0.995833,37,240,1,239,1,1,0,1,1,107,107,133,132,20
"1924",23,"[37]EDaxHnKqGocIHBJCowszAojmxcIdujbpuoFig",234,0.995745,37,235,1,234,1,1,0,1,1,112,112,123,122,20
"1925",24,"[37]EDaxHnKqGocIHBJCowszAojmxcIdujbpuoFig",218,0.995434,37,219,1,218,1,1,0,1,1,125,125,94,93,20
"1926",25,"[37]EDaxHnKqGocIHBJCowszAojmxcIdujbpuoFig",236,0.995781,37,237,1,236,1,1,0,1,1,110,110,127,126,20
"1927",26,"[37]EDaxHnKqGocIHBJCowszAojmxcIdujbpuoFig",224,0.995556,37,225,1,224,1,1,0,1,1,121,121,104,103,20
"1928",27,"[37]EDaxHnKqGocIHBJCowszAojmxcIdujbpuoFig",230,0.995671,37,231,1,230,1,1,0,1,1,115,115,116,115,20
"1929",28,"[37]EDaxHnKqGocIHBJCowszAojmxcIdujbpuoFig",231,0.99569,37,232,1,231,1,1,0,1,1,113,113,119,118,20
"1930",29,"[37]EDaxHnKqGocIHBJCowszAojmxcIdujbpuoFig",230,0.995671,37,231,1,230,1,1,0,1,1,115,115,116,115,20
"1931",30,"[37]EDaxHnKqGocIHBJCowszAojmxcIdujbpuoFig",228,0.995633,37,229,1,228,1,1,0,1,1,116,116,113,112,20
"1932",31,"[37]EDaxHnKqGocIHBJCowszAojmxcIdujbpuoFig",234,0.995745,37,235,1,234,1,1,0,1,1,113,113,122,121,20
"1933",32,"[37]EDaxHnKqGocIHBJCowszAojmxcIdujbpuoFig",228,0.995633,37,229,1,228,1,1,0,1,1,116,116,113,112,20
"1934",33,"[37]EDaxHnKqGocIHBJCowszAojmxcIdujbpuoFig",226,0.995595,37,227,1,226,1,1,0,1,1,118,118,109,108,20
"1935",34,"[37]EDaxHnKqGocIHBJCowszAojmxcIdujbpuoFig",215,0.99537,37,216,1,215,1,1,0,1,1,126,126,90,89,20
"1936",35,"[37]EDaxHnKqGocIHBJCowszAojmxcIdujbpuoFig",231,0.99569,37,232,1,231,1,1,0,1,1,115,115,117,116,20
"1937",36,"[37]EDaxHnKqGocIHBJCowszAojmxcIdujbpuoFig",228,0.995633,37,229,1,228,1,1,0,1,1,116,116,113,112,20
"1938",37,"[37]EDaxHnKqGocIHBJCowszAojmxcIdujbpuoFig",235,0.995763,37,236,1,235,1,1,0,1,1,111,111,125,124,20
"1939",38,"[37]EDaxHnKqGocIHBJCowszAojmxcIdujbpuoFig",232,0.995708,37,233,1,232,1,1,0,1,1,113,113,120,119,20
"1940",39,"[37]EDaxHnKqGocIHBJCowszAojmxcIdujbpuoFig",242,0.995885,37,243,1,242,1,1,0,1,1,109,109,134,133,20
"1941",40,"[37]EDaxHnKqGocIHBJCowszAojmxcIdujbpuoFig",220,0.995475,37,221,1,220,1,1,0,1,1,122,122,99,98,20
"1942",41,"[37]EDaxHnKqGocIHBJCowszAojmxcIdujbpuoFig",242,0.995885,37,243,1,242,1,1,0,1,1,106,106,137,136,20
"1943",42,"[37]EDaxHnKqGocIHBJCowszAojmxcIdujbpuoFig",219,0.995455,37,220,1,219,1,1,0,1,1,124,124,96,95,20
"1944",43,"[37]EDaxHnKqGocIHBJCowszAojmxcIdujbpuoFig",228,0.995633,37,229,1,228,1,1,0,1,1,117,117,112,111,20
"1945",44,"[37]EDaxHnKqGocIHBJCowszAojmxcIdujbpuoFig",223,0.995536,37,224,1,223,1,1,0,1,1,121,121,103,102,20
"1946",45,"[37]EDaxHnKqGocIHBJCowszAojmxcIdujbpuoFig",225,0.995575,37,226,1,225,1,1,0,1,1,121,121,105,104,20
"1947",46,"[37]EDaxHnKqGocIHBJCowszAojmxcIdujbpuoFig",241,0.995868,37,242,1,241,1,1,0,1,1,105,105,137,136,20
"1948",47,"[37]EDaxHnKqGocIHBJCowszAojmxcIdujbpuoFig",232,0.995708,37,233,1,232,1,1,0,1,1,113,113,120,119,20
"1949",48,"[37]EDaxHnKqGocIHBJCowszAojmxcIdujbpuoFig",240,0.995851,37,241,1,240,1,1,0,1,1,106,106,135,134,20
"1950",49,"[37]EDaxHnKqGocIHBJCowszAojmxcIdujbpuoFig",230,0.995671,37,231,1,230,1,1,0,1,1,116,116,115,114,20
"1951",50,"[37]EDaxHnKqGocIHBJCowszAojmxcIdujbpuoFig",228,0.995633,37,229,1,228,1,1,0,1,1,116,116,113,112,20
"1952",51,"[37]EDaxHnKqGocIHBJCowszAojmxcIdujbpuoFig",220,0.995475,37,221,1,220,1,1,0,1,1,123,123,98,97,20
"1953",52,"[37]EDaxHnKqGocIHBJCowszAojmxcIdujbpuoFig",238,0.995816,37,239,1,238,1,1,0,1,1,111,111,128,127,20
"1954",53,"[37]EDaxHnKqGocIHBJCowszAojmxcIdujbpuoFig",236,0.995781,37,237,1,236,1,1,0,1,1,110,110,127,126,20
"1955",54,"[37]EDaxHnKqGocIHBJCowszAojmxcIdujbpuoFig",226,0.995595,37,227,1,226,1,1,0,1,1,117,117,110,109,20
"1956",55,"[37]EDaxHnKqGocIHBJCowszAojmxcIdujbpuoFig",236,0.995781,37,237,1,236,1,1,0,1,1,111,111,126,125,20
"1957",56,"[37]EDaxHnKqGocIHBJCowszAojmxcIdujbpuoFig",235,0.995763,37,236,1,235,1,1,0,1,1,112,112,124,123,20
"1958",57,"[37]EDaxHnKqGocIHBJCowszAojmxcIdujbpuoFig",230,0.995671,37,231,1,230,1,1,0,1,1,116,116,115,114,20
"1959",58,"[37]EDaxHnKqGocIHBJCowszAojmxcIdujbpuoFig",234,0.995745,37,235,1,234,1,1,0,1,1,112,112,123,122,20
"1960",59,"[37]EDaxHnKqGocIHBJCowszAojmxcIdujbpuoFig",235,0.995763,37,236,1,235,1,1,0,1,1,111,111,125,124,20
"1961",60,"[37]EDaxHnKqGocIHBJCowszAojmxcIdujbpuoFig",218,0.995434,37,219,1,218,1,1,0,1,1,125,125,94,93,20
"1962",61,"[37]EDaxHnKqGocIHBJCowszAojmxcIdujbpuoFig",224,0.995556,37,225,1,224,1,1,0,1,1,120,120,105,104,20
"1963",62,"[37]EDaxHnKqGocIHBJCowszAojmxcIdujbpuoFig",227,0.995614,37,228,1,227,1,1,0,1,1,117,117,111,110,20
"1964",63,"[37]EDaxHnKqGocIHBJCowszAojmxcIdujbpuoFig",232,0.995708,37,233,1,232,1,1,0,1,1,115,115,118,117,20
"1965",64,"[37]EDaxHnKqGocIHBJCowszAojmxcIdujbpuoFig",230,0.995671,37,231,1,230,1,1,0,1,1,114,114,117,116,20
"1966",65,"[37]EDaxHnKqGocIHBJCowszAojmxcIdujbpuoFig",240,0.995851,37,241,1,240,1,1,0,1,1,109,109,132,131,20
"1967",66,"[37]EDaxHnKqGocIHBJCowszAojmxcIdujbpuoFig",244,0.995918,37,245,1,244,1,1,0,1,1,105,105,140,139,20
"1968",67,"[37]EDaxHnKqGocIHBJCowszAojmxcIdujbpuoFig",224,0.995556,37,225,1,224,1,1,0,1,1,119,119,106,105,20
"1969",68,"[37]EDaxHnKqGocIHBJCowszAojmxcIdujbpuoFig",235,0.995763,37,236,1,235,1,1,0,1,1,113,113,123,122,20
"1970",69,"[37]EDaxHnKqGocIHBJCowszAojmxcIdujbpuoFig",237,0.995798,37,238,1,237,1,1,0,1,1,110,110,128,127,20
"1971",70,"[37]EDaxHnKqGocIHBJCowszAojmxcIdujbpuoFig",229,0.995652,37,230,1,229,1,1,0,1,1,115,115,115,114,20
"1972",71,"[37]EDaxHnKqGocIHBJCowszAojmxcIdujbpuoFig",225,0.995575,37,226,1,225,1,1,0,1,1,119,119,107,106,20
"1973",72,"[37]EDaxHnKqGocIHBJCowszAojmxcIdujbpuoFig",227,0.995614,37,228,1,227,1,1,0,1,1,117,117,111,110,20
"1974",73,"[37]EDaxHnKqGocIHBJCowszAojmxcIdujbpuoFig",231,0.99569,37,232,1,231,1,1,0,1,1,116,116,116,115,20
"1975",74,"[37]EDaxHnKqGocIHBJCowszAojmxcIdujbpuoFig",230,0.995671,37,231,1,230,1,1,0,1,1,116,116,115,114,20
"1976",75,"[37]EDaxHnKqGocIHBJCowszAojmxcIdujbpuoFig",226,0.995595,37,227,1,226,1,1,0,1,1,118,118,109,108,20
"1977",76,"[37]EDaxHnKqGocIHBJCowszAojmxcIdujbpuoFig",238,0.995816,37,239,1,238,1,1,0,1,1,109,109,130,129,20
"1978",77,"[37]EDaxHnKqGocIHBJCowszAojmxcIdujbpuoFig",234,0.995745,37,235,1,234,1,1,0,1,1,111,111,124,123,20
"1979",78,"[37]EDaxHnKqGocIHBJCowszAojmxcIdujbpuoFig",227,0.995614,37,228,1,227,1,1,0,1,1,119,119,109,108,20
"1980",79,"[37]EDaxHnKqGocIHBJCowszAojmxcIdujbpuoFig",226,0.995595,37,227,1,226,1,1,0,1,1,117,117,110,109,20
"1981",80,"[37]EDaxHnKqGocIHBJCowszAojmxcIdujbpuoFig",235,0.995763,37,236,1,235,1,1,0,1,1,115,115,121,120,20
"1982",81,"[37]EDaxHnKqGocIHBJCowszAojmxcIdujbpuoFig",230,0.995671,37,231,1,230,1,1,0,1,1,116,116,115,114,20
"1983",82,"[37]EDaxHnKqGocIHBJCowszAojmxcIdujbpuoFig",226,0.995595,37,227,1,226,1,1,0,1,1,118,118,109,108,20
"1984",83,"[37]EDaxHnKqGocIHBJCowszAojmxcIdujbpuoFig",232,0.995708,37,233,1,232,1,1,0,1,1,116,116,117,116,20
"1985",84,"[37]EDaxHnKqGocIHBJCowszAojmxcIdujbpuoFig",230,0.995671,37,231,1,230,1,1,0,1,1,115,115,116,115,20
"1986",85,"[37]EDaxHnKqGocIHBJCowszAojmxcIdujbpuoFig",230,0.995671,37,231,1,230,1,1,0,1,1,114,114,117,116,20
"1987",86,"[37]EDaxHnKqGocIHBJCowszAojmxcIdujbpuoFig",233,0.995726,37,234,1,233,1,1,0,1,1,113,113,121,120,20
"1988",87,"[37]EDaxHnKqGocIHBJCowszAojmxcIdujbpuoFig",231,0.99569,37,232,1,231,1,1,0,1,1,114,114,118,117,20
"1989",88,"[37]EDaxHnKqGocIHBJCowszAojmxcIdujbpuoFig",245,0.995935,37,246,1,245,1,1,0,1,1,110,110,136,135,20
"1990",89,"[37]EDaxHnKqGocIHBJCowszAojmxcIdujbpuoFig",230,0.995671,37,231,1,230,1,1,0,1,1,117,117,114,113,20
"1991",90,"[37]EDaxHnKqGocIHBJCowszAojmxcIdujbpuoFig",232,0.995708,37,233,1,232,1,1,0,1,1,113,113,120,119,20
"1992",91,"[37]EDaxHnKqGocIHBJCowszAojmxcIdujbpuoFig",238,0.995816,37,239,1,238,1,1,0,1,1,109,109,130,129,20
"1993",92,"[37]EDaxHnKqGocIHBJCowszAojmxcIdujbpuoFig",235,0.995763,37,236,1,235,1,1,0,1,1,114,114,122,121,20
"1994",93,"[37]EDaxHnKqGocIHBJCowszAojmxcIdujbpuoFig",229,0.995652,37,230,1,229,1,1,0,1,1,117,117,113,112,20
"1995",94,"[37]EDaxHnKqGocIHBJCowszAojmxcIdujbpuoFig",226,0.995595,37,227,1,226,1,1,0,1,1,117,117,110,109,20
"1996",95,"[37]EDaxHnKqGocIHBJCowszAojmxcIdujbpuoFig",217,0.995413,37,218,1,217,1,1,0,1,1,125,125,93,92,20
"1997",96,"[37]EDaxHnKqGocIHBJCowszAojmxcIdujbpuoFig",235,0.995763,37,236,1,235,1,1,0,1,1,111,111,125,124,20
"1998",97,"[37]EDaxHnKqGocIHBJCowszAojmxcIdujbpuoFig",236,0.995781,37,237,1,236,1,1,0,1,1,110,110,127,126,20
"1999",98,"[37]EDaxHnKqGocIHBJCowszAojmxcIdujbpuoFig",238,0.995816,37,239,1,238,1,1,0,1,1,108,108,131,130,20
"2000",99,"[37]EDaxHnKqGocIHBJCowszAojmxcIdujbpuoFig",231,0.99569,37,232,1,231,1,1,0,1,1,113,113,119,118,20
"2001",0,"[23]EjgwHnKqGocIHcJCGfelFFa",220,0.995475,23,221,1,220,1,1,0,1,1,125,125,96,95,21
"2002",1,"[23]EjgwHnKqGocIHcJCGfelFFa",224,0.995556,23,225,1,224,1,1,0,1,1,119,119,106,105,21
"2003",2,"[23]EjgwHnKqGocIHcJCGfelFFa",233,0.995726,23,234,1,233,1,1,0,1,1,115,115,119,118,21
"2004",3,"[23]EjgwHnKqGocIHcJCGfelFFa",230,0.995671,23,231,1,230,1,1,0,1,1,114,114,117,116,21
"2005",4,"[23]EjgwHnKqGocIHcJCGfelFFa",236,0.995781,23,237,1,236,1,1,0,1,1,109,109,128,127,21
"2006",5,"[23]EjgwHnKqGocIHcJCGfelFFa",231,0.99569,23,232,1,231,1,1,0,1,1,116,116,116,115,21
"2007",6,"[23]EjgwHnKqGocIHcJCGfelFFa",223,0.995536,23,224,1,223,1,1,0,1,1,120,120,104,103,21
"2008",7,"[23]EjgwHnKqGocIHcJCGfelFFa",229,0.995652,23,230,1,229,1,1,0,1,1,115,115,115,114,21
"2009",8,"[23]EjgwHnKqGocIHcJCGfelFFa",226,0.995595,23,227,1,226,1,1,0,1,1,119,119,108,107,21
"2010",9,"[23]EjgwHnKqGocIHcJCGfelFFa",240,0.995851,23,241,1,240,1,1,0,1,1,110,110,131,130,21
"2011",10,"[23]EjgwHnKqGocIHcJCGfelFFa",224,0.995556,23,225,1,224,1,1,0,1,1,119,119,106,105,21
"2012",11,"[23]EjgwHnKqGocIHcJCGfelFFa",227,0.995614,23,228,1,227,1,1,0,1,1,117,117,111,110,21
"2013",12,"[23]EjgwHnKqGocIHcJCGfelFFa",235,0.995763,23,236,1,235,1,1,0,1,1,112,112,124,123,21
"2014",13,"[23]EjgwHnKqGocIHcJCGfelFFa",238,0.995816,23,239,1,238,1,1,0,1,1,111,111,128,127,21
"2015",14,"[23]EjgwHnKqGocIHcJCGfelFFa",236,0.995781,23,237,1,236,1,1,0,1,1,111,111,126,125,21
"2016",15,"[23]EjgwHnKqGocIHcJCGfelFFa",231,0.99569,23,232,1,231,1,1,0,1,1,115,115,117,116,21
"2017",16,"[23]EjgwHnKqGocIHcJCGfelFFa",234,0.995745,23,235,1,234,1,1,0,1,1,111,111,124,123,21
"2018",17,"[23]EjgwHnKqGocIHcJCGfelFFa",225,0.995575,23,226,1,225,1,1,0,1,1,120,120,106,105,21
"2019",18,"[23]EjgwHnKqGocIHcJCGfelFFa",223,0.995536,23,224,1,223,1,1,0,1,1,120,120,104,103,21
"2020",19,"[23]EjgwHnKqGocIHcJCGfelFFa",229,0.995652,23,230,1,229,1,1,0,1,1,118,118,112,111,21
"2021",20,"[23]EjgwHnKqGocIHcJCGfelFFa",221,0.995495,23,222,1,221,1,1,0,1,1,121,121,101,100,21
"2022",21,"[23]EjgwHnKqGocIHcJCGfelFFa",228,0.995633,23,229,1,228,1,1,0,1,1,116,116,113,112,21
"2023",22,"[23]EjgwHnKqGocIHcJCGfelFFa",235,0.995763,23,236,1,235,1,1,0,1,1,111,111,125,124,21
"2024",23,"[23]EjgwHnKqGocIHcJCGfelFFa",237,0.995798,23,238,1,237,1,1,0,1,1,109,109,129,128,21
"2025",24,"[23]EjgwHnKqGocIHcJCGfelFFa",234,0.995745,23,235,1,234,1,1,0,1,1,112,112,123,122,21
"2026",25,"[23]EjgwHnKqGocIHcJCGfelFFa",235,0.995763,23,236,1,235,1,1,0,1,1,113,113,123,122,21
"2027",26,"[23]EjgwHnKqGocIHcJCGfelFFa",226,0.995595,23,227,1,226,1,1,0,1,1,117,117,110,109,21
"2028",27,"[23]EjgwHnKqGocIHcJCGfelFFa",226,0.995595,23,227,1,226,1,1,0,1,1,117,117,110,109,21
"2029",28,"[23]EjgwHnKqGocIHcJCGfelFFa",234,0.995745,23,235,1,234,1,1,0,1,1,111,111,124,123,21
"2030",29,"[23]EjgwHnKqGocIHcJCGfelFFa",238,0.995816,23,239,1,238,1,1,0,1,1,110,110,129,128,21
"2031",30,"[23]EjgwHnKqGocIHcJCGfelFFa",230,0.995671,23,231,1,230,1,1,0,1,1,114,114,117,116,21
"2032",31,"[23]EjgwHnKqGocIHcJCGfelFFa",237,0.995798,23,238,1,237,1,1,0,1,1,109,109,129,128,21
"2033",32,"[23]EjgwHnKqGocIHcJCGfelFFa",236,0.995781,23,237,1,236,1,1,0,1,1,110,110,127,126,21
"2034",33,"[23]EjgwHnKqGocIHcJCGfelFFa",234,0.995745,23,235,1,234,1,1,0,1,1,113,113,122,121,21
"2035",34,"[23]EjgwHnKqGocIHcJCGfelFFa",237,0.995798,23,238,1,237,1,1,0,1,1,111,111,127,126,21
"2036",35,"[23]EjgwHnKqGocIHcJCGfelFFa",241,0.995868,23,242,1,241,1,1,0,1,1,106,106,136,135,21
"2037",36,"[23]EjgwHnKqGocIHcJCGfelFFa",222,0.995516,23,223,1,222,1,1,0,1,1,121,121,102,101,21
"2038",37,"[23]EjgwHnKqGocIHcJCGfelFFa",223,0.995536,23,224,1,223,1,1,0,1,1,120,120,104,103,21
"2039",38,"[23]EjgwHnKqGocIHcJCGfelFFa",234,0.995745,23,235,1,234,1,1,0,1,1,112,112,123,122,21
"2040",39,"[23]EjgwHnKqGocIHcJCGfelFFa",231,0.99569,23,232,1,231,1,1,0,1,1,113,113,119,118,21
"2041",40,"[23]EjgwHnKqGocIHcJCGfelFFa",229,0.995652,23,230,1,229,1,1,0,1,1,115,115,115,114,21
"2042",41,"[23]EjgwHnKqGocIHcJCGfelFFa",225,0.995575,23,226,1,225,1,1,0,1,1,119,119,107,106,21
"2043",42,"[23]EjgwHnKqGocIHcJCGfelFFa",232,0.995708,23,233,1,232,1,1,0,1,1,113,113,120,119,21
"2044",43,"[23]EjgwHnKqGocIHcJCGfelFFa",231,0.99569,23,232,1,231,1,1,0,1,1,118,118,114,113,21
"2045",44,"[23]EjgwHnKqGocIHcJCGfelFFa",225,0.995575,23,226,1,225,1,1,0,1,1,118,118,108,107,21
"2046",45,"[23]EjgwHnKqGocIHcJCGfelFFa",228,0.995633,23,229,1,228,1,1,0,1,1,116,116,113,112,21
"2047",46,"[23]EjgwHnKqGocIHcJCGfelFFa",231,0.99569,23,232,1,231,1,1,0,1,1,113,113,119,118,21
"2048",47,"[23]EjgwHnKqGocIHcJCGfelFFa",225,0.995575,23,226,1,225,1,1,0,1,1,118,118,108,107,21
"2049",48,"[23]EjgwHnKqGocIHcJCGfelFFa",236,0.995781,23,237,1,236,1,1,0,1,1,111,111,126,125,21
"2050",49,"[23]EjgwHnKqGocIHcJCGfelFFa",224,0.995556,23,225,1,224,1,1,0,1,1,120,120,105,104,21
"2051",50,"[23]EjgwHnKqGocIHcJCGfelFFa",227,0.995614,23,228,1,227,1,1,0,1,1,118,118,110,109,21
"2052",51,"[23]EjgwHnKqGocIHcJCGfelFFa",225,0.995575,23,226,1,225,1,1,0,1,1,118,118,108,107,21
"2053",52,"[23]EjgwHnKqGocIHcJCGfelFFa",228,0.995633,23,229,1,228,1,1,0,1,1,116,116,113,112,21
"2054",53,"[23]EjgwHnKqGocIHcJCGfelFFa",231,0.99569,23,232,1,231,1,1,0,1,1,113,113,119,118,21
"2055",54,"[23]EjgwHnKqGocIHcJCGfelFFa",229,0.995652,23,230,1,229,1,1,0,1,1,115,115,115,114,21
"2056",55,"[23]EjgwHnKqGocIHcJCGfelFFa",232,0.995708,23,233,1,232,1,1,0,1,1,112,112,121,120,21
"2057",56,"[23]EjgwHnKqGocIHcJCGfelFFa",221,0.995495,23,222,1,221,1,1,0,1,1,121,121,101,100,21
"2058",57,"[23]EjgwHnKqGocIHcJCGfelFFa",235,0.995763,23,236,1,235,1,1,0,1,1,110,110,126,125,21
"2059",58,"[23]EjgwHnKqGocIHcJCGfelFFa",236,0.995781,23,237,1,236,1,1,0,1,1,109,109,128,127,21
"2060",59,"[23]EjgwHnKqGocIHcJCGfelFFa",235,0.995763,23,236,1,235,1,1,0,1,1,110,110,126,125,21
"2061",60,"[23]EjgwHnKqGocIHcJCGfelFFa",238,0.995816,23,239,1,238,1,1,0,1,1,112,112,127,126,21
"2062",61,"[23]EjgwHnKqGocIHcJCGfelFFa",226,0.995595,23,227,1,226,1,1,0,1,1,117,117,110,109,21
"2063",62,"[23]EjgwHnKqGocIHcJCGfelFFa",224,0.995556,23,225,1,224,1,1,0,1,1,119,119,106,105,21
"2064",63,"[23]EjgwHnKqGocIHcJCGfelFFa",237,0.995798,23,238,1,237,1,1,0,1,1,111,111,127,126,21
"2065",64,"[23]EjgwHnKqGocIHcJCGfelFFa",234,0.995745,23,235,1,234,1,1,0,1,1,112,112,123,122,21
"2066",65,"[23]EjgwHnKqGocIHcJCGfelFFa",231,0.99569,23,232,1,231,1,1,0,1,1,113,113,119,118,21
"2067",66,"[23]EjgwHnKqGocIHcJCGfelFFa",226,0.995595,23,227,1,226,1,1,0,1,1,119,119,108,107,21
"2068",67,"[23]EjgwHnKqGocIHcJCGfelFFa",232,0.995708,23,233,1,232,1,1,0,1,1,113,113,120,119,21
"2069",68,"[23]EjgwHnKqGocIHcJCGfelFFa",233,0.995726,23,234,1,233,1,1,0,1,1,113,113,121,120,21
"2070",69,"[23]EjgwHnKqGocIHcJCGfelFFa",227,0.995614,23,228,1,227,1,1,0,1,1,117,117,111,110,21
"2071",70,"[23]EjgwHnKqGocIHcJCGfelFFa",231,0.99569,23,232,1,231,1,1,0,1,1,115,115,117,116,21
"2072",71,"[23]EjgwHnKqGocIHcJCGfelFFa",245,0.995935,23,246,1,245,1,1,0,1,1,102,102,144,143,21
"2073",72,"[23]EjgwHnKqGocIHcJCGfelFFa",229,0.995652,23,230,1,229,1,1,0,1,1,116,116,114,113,21
"2074",73,"[23]EjgwHnKqGocIHcJCGfelFFa",236,0.995781,23,237,1,236,1,1,0,1,1,110,110,127,126,21
"2075",74,"[23]EjgwHnKqGocIHcJCGfelFFa",228,0.995633,23,229,1,228,1,1,0,1,1,117,117,112,111,21
"2076",75,"[23]EjgwHnKqGocIHcJCGfelFFa",227,0.995614,23,228,1,227,1,1,0,1,1,120,120,108,107,21
"2077",76,"[23]EjgwHnKqGocIHcJCGfelFFa",225,0.995575,23,226,1,225,1,1,0,1,1,118,118,108,107,21
"2078",77,"[23]EjgwHnKqGocIHcJCGfelFFa",239,0.995833,23,240,1,239,1,1,0,1,1,108,108,132,131,21
"2079",78,"[23]EjgwHnKqGocIHcJCGfelFFa",225,0.995575,23,226,1,225,1,1,0,1,1,120,120,106,105,21
"2080",79,"[23]EjgwHnKqGocIHcJCGfelFFa",239,0.995833,23,240,1,239,1,1,0,1,1,108,108,132,131,21
"2081",80,"[23]EjgwHnKqGocIHcJCGfelFFa",231,0.99569,23,232,1,231,1,1,0,1,1,120,120,112,111,21
"2082",81,"[23]EjgwHnKqGocIHcJCGfelFFa",222,0.995516,23,223,1,222,1,1,0,1,1,120,120,103,102,21
"2083",82,"[23]EjgwHnKqGocIHcJCGfelFFa",233,0.995726,23,234,1,233,1,1,0,1,1,112,112,122,121,21
"2084",83,"[23]EjgwHnKqGocIHcJCGfelFFa",232,0.995708,23,233,1,232,1,1,0,1,1,115,115,118,117,21
"2085",84,"[23]EjgwHnKqGocIHcJCGfelFFa",225,0.995575,23,226,1,225,1,1,0,1,1,118,118,108,107,21
"2086",85,"[23]EjgwHnKqGocIHcJCGfelFFa",224,0.995556,23,225,1,224,1,1,0,1,1,120,120,105,104,21
"2087",86,"[23]EjgwHnKqGocIHcJCGfelFFa",234,0.995745,23,235,1,234,1,1,0,1,1,114,114,121,120,21
"2088",87,"[23]EjgwHnKqGocIHcJCGfelFFa",244,0.995918,23,245,1,244,1,1,0,1,1,103,103,142,141,21
"2089",88,"[23]EjgwHnKqGocIHcJCGfelFFa",225,0.995575,23,226,1,225,1,1,0,1,1,119,119,107,106,21
"2090",89,"[23]EjgwHnKqGocIHcJCGfelFFa",230,0.995671,23,231,1,230,1,1,0,1,1,116,116,115,114,21
"2091",90,"[23]EjgwHnKqGocIHcJCGfelFFa",235,0.995763,23,236,1,235,1,1,0,1,1,111,111,125,124,21
"2092",91,"[23]EjgwHnKqGocIHcJCGfelFFa",227,0.995614,23,228,1,227,1,1,0,1,1,116,116,112,111,21
"2093",92,"[23]EjgwHnKqGocIHcJCGfelFFa",242,0.995885,23,243,1,242,1,1,0,1,1,106,106,137,136,21
"2094",93,"[23]EjgwHnKqGocIHcJCGfelFFa",229,0.995652,23,230,1,229,1,1,0,1,1,115,115,115,114,21
"2095",94,"[23]EjgwHnKqGocIHcJCGfelFFa",239,0.995833,23,240,1,239,1,1,0,1,1,107,107,133,132,21
"2096",95,"[23]EjgwHnKqGocIHcJCGfelFFa",227,0.995614,23,228,1,227,1,1,0,1,1,117,117,111,110,21
"2097",96,"[23]EjgwHnKqGocIHcJCGfelFFa",229,0.995652,23,230,1,229,1,1,0,1,1,116,116,114,113,21
"2098",97,"[23]EjgwHnKqGocIHcJCGfelFFa",223,0.995536,23,224,1,223,1,1,0,1,1,121,121,103,102,21
"2099",98,"[23]EjgwHnKqGocIHcJCGfelFFa",233,0.995726,23,234,1,233,1,1,0,1,1,114,114,120,119,21
"2100",99,"[23]EjgwHnKqGocIHcJCGfelFFa",230,0.995671,23,231,1,230,1,1,0,1,1,115,115,116,115,21
"2101",0,"[28]EekxGtHnKqGocIHBJCBbooGqFCxy",235,0.995763,28,236,1,235,1,1,0,1,1,112,112,124,123,22
"2102",1,"[28]EekxGtHnKqGocIHBJCBbooGqFCxy",232,0.995708,28,233,1,232,1,1,0,1,1,112,112,121,120,22
"2103",2,"[28]EekxGtHnKqGocIHBJCBbooGqFCxy",224,0.995556,28,225,1,224,1,1,0,1,1,118,118,107,106,22
"2104",3,"[28]EekxGtHnKqGocIHBJCBbooGqFCxy",222,0.995516,28,223,1,222,1,1,0,1,1,120,120,103,102,22
"2105",4,"[28]EekxGtHnKqGocIHBJCBbooGqFCxy",239,0.995833,28,240,1,239,1,1,0,1,1,107,107,133,132,22
"2106",5,"[28]EekxGtHnKqGocIHBJCBbooGqFCxy",240,0.995851,28,241,1,240,1,1,0,1,1,106,106,135,134,22
"2107",6,"[28]EekxGtHnKqGocIHBJCBbooGqFCxy",226,0.995595,28,227,1,226,1,1,0,1,1,117,117,110,109,22
"2108",7,"[28]EekxGtHnKqGocIHBJCBbooGqFCxy",232,0.995708,28,233,1,232,1,1,0,1,1,112,112,121,120,22
"2109",8,"[28]EekxGtHnKqGocIHBJCBbooGqFCxy",225,0.995575,28,226,1,225,1,1,0,1,1,118,118,108,107,22
"2110",9,"[28]EekxGtHnKqGocIHBJCBbooGqFCxy",234,0.995745,28,235,1,234,1,1,0,1,1,114,114,121,120,22
"2111",10,"[28]EekxGtHnKqGocIHBJCBbooGqFCxy",241,0.995868,28,242,1,241,1,1,0,1,1,106,106,136,135,22
"2112",11,"[28]EekxGtHnKqGocIHBJCBbooGqFCxy",229,0.995652,28,230,1,229,1,1,0,1,1,114,114,116,115,22
"2113",12,"[28]EekxGtHnKqGocIHBJCBbooGqFCxy",224,0.995556,28,225,1,224,1,1,0,1,1,118,118,107,106,22
"2114",13,"[28]EekxGtHnKqGocIHBJCBbooGqFCxy",229,0.995652,28,230,1,229,1,1,0,1,1,115,115,115,114,22
"2115",14,"[28]EekxGtHnKqGocIHBJCBbooGqFCxy",217,0.995413,28,218,1,217,1,1,0,1,1,127,127,91,90,22
"2116",15,"[28]EekxGtHnKqGocIHBJCBbooGqFCxy",233,0.995726,28,234,1,233,1,1,0,1,1,112,112,122,121,22
"2117",16,"[28]EekxGtHnKqGocIHBJCBbooGqFCxy",224,0.995556,28,225,1,224,1,1,0,1,1,118,118,107,106,22
"2118",17,"[28]EekxGtHnKqGocIHBJCBbooGqFCxy",225,0.995575,28,226,1,225,1,1,0,1,1,118,118,108,107,22
"2119",18,"[28]EekxGtHnKqGocIHBJCBbooGqFCxy",222,0.995516,28,223,1,222,1,1,0,1,1,120,120,103,102,22
"2120",19,"[28]EekxGtHnKqGocIHBJCBbooGqFCxy",222,0.995516,28,223,1,222,1,1,0,1,1,121,121,102,101,22
"2121",20,"[28]EekxGtHnKqGocIHBJCBbooGqFCxy",225,0.995575,28,226,1,225,1,1,0,1,1,120,120,106,105,22
"2122",21,"[28]EekxGtHnKqGocIHBJCBbooGqFCxy",222,0.995516,28,223,1,222,1,1,0,1,1,121,121,102,101,22
"2123",22,"[28]EekxGtHnKqGocIHBJCBbooGqFCxy",226,0.995595,28,227,1,226,1,1,0,1,1,118,118,109,108,22
"2124",23,"[28]EekxGtHnKqGocIHBJCBbooGqFCxy",228,0.995633,28,229,1,228,1,1,0,1,1,116,116,113,112,22
"2125",24,"[28]EekxGtHnKqGocIHBJCBbooGqFCxy",232,0.995708,28,233,1,232,1,1,0,1,1,112,112,121,120,22
"2126",25,"[28]EekxGtHnKqGocIHBJCBbooGqFCxy",220,0.995475,28,221,1,220,1,1,0,1,1,123,123,98,97,22
"2127",26,"[28]EekxGtHnKqGocIHBJCBbooGqFCxy",227,0.995614,28,228,1,227,1,1,0,1,1,117,117,111,110,22
"2128",27,"[28]EekxGtHnKqGocIHBJCBbooGqFCxy",223,0.995536,28,224,1,223,1,1,0,1,1,120,120,104,103,22
"2129",28,"[28]EekxGtHnKqGocIHBJCBbooGqFCxy",228,0.995633,28,229,1,228,1,1,0,1,1,116,116,113,112,22
"2130",29,"[28]EekxGtHnKqGocIHBJCBbooGqFCxy",246,0.995951,28,247,1,246,1,1,0,1,1,101,101,146,145,22
"2131",30,"[28]EekxGtHnKqGocIHBJCBbooGqFCxy",236,0.995781,28,237,1,236,1,1,0,1,1,110,110,127,126,22
"2132",31,"[28]EekxGtHnKqGocIHBJCBbooGqFCxy",232,0.995708,28,233,1,232,1,1,0,1,1,112,112,121,120,22
"2133",32,"[28]EekxGtHnKqGocIHBJCBbooGqFCxy",236,0.995781,28,237,1,236,1,1,0,1,1,109,109,128,127,22
"2134",33,"[28]EekxGtHnKqGocIHBJCBbooGqFCxy",239,0.995833,28,240,1,239,1,1,0,1,1,107,107,133,132,22
"2135",34,"[28]EekxGtHnKqGocIHBJCBbooGqFCxy",227,0.995614,28,228,1,227,1,1,0,1,1,116,116,112,111,22
"2136",35,"[28]EekxGtHnKqGocIHBJCBbooGqFCxy",219,0.995455,28,220,1,219,1,1,0,1,1,122,122,98,97,22
"2137",36,"[28]EekxGtHnKqGocIHBJCBbooGqFCxy",228,0.995633,28,229,1,228,1,1,0,1,1,116,116,113,112,22
"2138",37,"[28]EekxGtHnKqGocIHBJCBbooGqFCxy",221,0.995495,28,222,1,221,1,1,0,1,1,121,121,101,100,22
"2139",38,"[28]EekxGtHnKqGocIHBJCBbooGqFCxy",237,0.995798,28,238,1,237,1,1,0,1,1,109,109,129,128,22
"2140",39,"[28]EekxGtHnKqGocIHBJCBbooGqFCxy",226,0.995595,28,227,1,226,1,1,0,1,1,118,118,109,108,22
"2141",40,"[28]EekxGtHnKqGocIHBJCBbooGqFCxy",220,0.995475,28,221,1,220,1,1,0,1,1,124,124,97,96,22
"2142",41,"[28]EekxGtHnKqGocIHBJCBbooGqFCxy",225,0.995575,28,226,1,225,1,1,0,1,1,121,121,105,104,22
"2143",42,"[28]EekxGtHnKqGocIHBJCBbooGqFCxy",231,0.99569,28,232,1,231,1,1,0,1,1,116,116,116,115,22
"2144",43,"[28]EekxGtHnKqGocIHBJCBbooGqFCxy",227,0.995614,28,228,1,227,1,1,0,1,1,117,117,111,110,22
"2145",44,"[28]EekxGtHnKqGocIHBJCBbooGqFCxy",224,0.995556,28,225,1,224,1,1,0,1,1,118,118,107,106,22
"2146",45,"[28]EekxGtHnKqGocIHBJCBbooGqFCxy",224,0.995556,28,225,1,224,1,1,0,1,1,119,119,106,105,22
"2147",46,"[28]EekxGtHnKqGocIHBJCBbooGqFCxy",231,0.99569,28,232,1,231,1,1,0,1,1,113,113,119,118,22
"2148",47,"[28]EekxGtHnKqGocIHBJCBbooGqFCxy",232,0.995708,28,233,1,232,1,1,0,1,1,112,112,121,120,22
"2149",48,"[28]EekxGtHnKqGocIHBJCBbooGqFCxy",228,0.995633,28,229,1,228,1,1,0,1,1,115,115,114,113,22
"2150",49,"[28]EekxGtHnKqGocIHBJCBbooGqFCxy",242,0.995885,28,243,1,242,1,1,0,1,1,110,110,133,132,22
"2151",50,"[28]EekxGtHnKqGocIHBJCBbooGqFCxy",214,0.995349,28,215,1,214,1,1,0,1,1,127,127,88,87,22
"2152",51,"[28]EekxGtHnKqGocIHBJCBbooGqFCxy",222,0.995516,28,223,1,222,1,1,0,1,1,121,121,102,101,22
"2153",52,"[28]EekxGtHnKqGocIHBJCBbooGqFCxy",228,0.995633,28,229,1,228,1,1,0,1,1,115,115,114,113,22
"2154",53,"[28]EekxGtHnKqGocIHBJCBbooGqFCxy",224,0.995556,28,225,1,224,1,1,0,1,1,120,120,105,104,22
"2155",54,"[28]EekxGtHnKqGocIHBJCBbooGqFCxy",226,0.995595,28,227,1,226,1,1,0,1,1,117,117,110,109,22
"2156",55,"[28]EekxGtHnKqGocIHBJCBbooGqFCxy",219,0.995455,28,220,1,219,1,1,0,1,1,122,122,98,97,22
"2157",56,"[28]EekxGtHnKqGocIHBJCBbooGqFCxy",223,0.995536,28,224,1,223,1,1,0,1,1,119,119,105,104,22
"2158",57,"[28]EekxGtHnKqGocIHBJCBbooGqFCxy",231,0.99569,28,232,1,231,1,1,0,1,1,114,114,118,117,22
"2159",58,"[28]EekxGtHnKqGocIHBJCBbooGqFCxy",228,0.995633,28,229,1,228,1,1,0,1,1,115,115,114,113,22
"2160",59,"[28]EekxGtHnKqGocIHBJCBbooGqFCxy",227,0.995614,28,228,1,227,1,1,0,1,1,118,118,110,109,22
"2161",60,"[28]EekxGtHnKqGocIHBJCBbooGqFCxy",238,0.995816,28,239,1,238,1,1,0,1,1,107,107,132,131,22
"2162",61,"[28]EekxGtHnKqGocIHBJCBbooGqFCxy",231,0.99569,28,232,1,231,1,1,0,1,1,113,113,119,118,22
"2163",62,"[28]EekxGtHnKqGocIHBJCBbooGqFCxy",228,0.995633,28,229,1,228,1,1,0,1,1,115,115,114,113,22
"2164",63,"[28]EekxGtHnKqGocIHBJCBbooGqFCxy",226,0.995595,28,227,1,226,1,1,0,1,1,117,117,110,109,22
"2165",64,"[28]EekxGtHnKqGocIHBJCBbooGqFCxy",224,0.995556,28,225,1,224,1,1,0,1,1,118,118,107,106,22
"2166",65,"[28]EekxGtHnKqGocIHBJCBbooGqFCxy",232,0.995708,28,233,1,232,1,1,0,1,1,112,112,121,120,22
"2167",66,"[28]EekxGtHnKqGocIHBJCBbooGqFCxy",235,0.995763,28,236,1,235,1,1,0,1,1,111,111,125,124,22
"2168",67,"[28]EekxGtHnKqGocIHBJCBbooGqFCxy",226,0.995595,28,227,1,226,1,1,0,1,1,117,117,110,109,22
"2169",68,"[28]EekxGtHnKqGocIHBJCBbooGqFCxy",228,0.995633,28,229,1,228,1,1,0,1,1,115,115,114,113,22
"2170",69,"[28]EekxGtHnKqGocIHBJCBbooGqFCxy",244,0.995918,28,245,1,244,1,1,0,1,1,104,104,141,140,22
"2171",70,"[28]EekxGtHnKqGocIHBJCBbooGqFCxy",228,0.995633,28,229,1,228,1,1,0,1,1,115,115,114,113,22
"2172",71,"[28]EekxGtHnKqGocIHBJCBbooGqFCxy",229,0.995652,28,230,1,229,1,1,0,1,1,115,115,115,114,22
"2173",72,"[28]EekxGtHnKqGocIHBJCBbooGqFCxy",230,0.995671,28,231,1,230,1,1,0,1,1,115,115,116,115,22
"2174",73,"[28]EekxGtHnKqGocIHBJCBbooGqFCxy",244,0.995918,28,245,1,244,1,1,0,1,1,105,105,140,139,22
"2175",74,"[28]EekxGtHnKqGocIHBJCBbooGqFCxy",238,0.995816,28,239,1,238,1,1,0,1,1,108,108,131,130,22
"2176",75,"[28]EekxGtHnKqGocIHBJCBbooGqFCxy",237,0.995798,28,238,1,237,1,1,0,1,1,109,109,129,128,22
"2177",76,"[28]EekxGtHnKqGocIHBJCBbooGqFCxy",229,0.995652,28,230,1,229,1,1,0,1,1,115,115,115,114,22
"2178",77,"[28]EekxGtHnKqGocIHBJCBbooGqFCxy",232,0.995708,28,233,1,232,1,1,0,1,1,112,112,121,120,22
"2179",78,"[28]EekxGtHnKqGocIHBJCBbooGqFCxy",225,0.995575,28,226,1,225,1,1,0,1,1,118,118,108,107,22
"2180",79,"[28]EekxGtHnKqGocIHBJCBbooGqFCxy",233,0.995726,28,234,1,233,1,1,0,1,1,114,114,120,119,22
"2181",80,"[28]EekxGtHnKqGocIHBJCBbooGqFCxy",221,0.995495,28,222,1,221,1,1,0,1,1,122,122,100,99,22
"2182",81,"[28]EekxGtHnKqGocIHBJCBbooGqFCxy",232,0.995708,28,233,1,232,1,1,0,1,1,113,113,120,119,22
"2183",82,"[28]EekxGtHnKqGocIHBJCBbooGqFCxy",226,0.995595,28,227,1,226,1,1,0,1,1,118,118,109,108,22
"2184",83,"[28]EekxGtHnKqGocIHBJCBbooGqFCxy",232,0.995708,28,233,1,232,1,1,0,1,1,113,113,120,119,22
"2185",84,"[28]EekxGtHnKqGocIHBJCBbooGqFCxy",227,0.995614,28,228,1,227,1,1,0,1,1,117,117,111,110,22
"2186",85,"[28]EekxGtHnKqGocIHBJCBbooGqFCxy",216,0.995392,28,217,1,216,1,1,0,1,1,125,125,92,91,22
"2187",86,"[28]EekxGtHnKqGocIHBJCBbooGqFCxy",222,0.995516,28,223,1,222,1,1,0,1,1,121,121,102,101,22
"2188",87,"[28]EekxGtHnKqGocIHBJCBbooGqFCxy",242,0.995885,28,243,1,242,1,1,0,1,1,106,106,137,136,22
"2189",88,"[28]EekxGtHnKqGocIHBJCBbooGqFCxy",225,0.995575,28,226,1,225,1,1,0,1,1,118,118,108,107,22
"2190",89,"[28]EekxGtHnKqGocIHBJCBbooGqFCxy",248,0.995984,28,249,1,248,1,1,0,1,1,103,103,146,145,22
"2191",90,"[28]EekxGtHnKqGocIHBJCBbooGqFCxy",223,0.995536,28,224,1,223,1,1,0,1,1,119,119,105,104,22
"2192",91,"[28]EekxGtHnKqGocIHBJCBbooGqFCxy",226,0.995595,28,227,1,226,1,1,0,1,1,117,117,110,109,22
"2193",92,"[28]EekxGtHnKqGocIHBJCBbooGqFCxy",239,0.995833,28,240,1,239,1,1,0,1,1,109,109,131,130,22
"2194",93,"[28]EekxGtHnKqGocIHBJCBbooGqFCxy",224,0.995556,28,225,1,224,1,1,0,1,1,122,122,103,102,22
"2195",94,"[28]EekxGtHnKqGocIHBJCBbooGqFCxy",237,0.995798,28,238,1,237,1,1,0,1,1,108,108,130,129,22
"2196",95,"[28]EekxGtHnKqGocIHBJCBbooGqFCxy",229,0.995652,28,230,1,229,1,1,0,1,1,114,114,116,115,22
"2197",96,"[28]EekxGtHnKqGocIHBJCBbooGqFCxy",229,0.995652,28,230,1,229,1,1,0,1,1,116,116,114,113,22
"2198",97,"[28]EekxGtHnKqGocIHBJCBbooGqFCxy",235,0.995763,28,236,1,235,1,1,0,1,1,115,115,121,120,22
"2199",98,"[28]EekxGtHnKqGocIHBJCBbooGqFCxy",222,0.995516,28,223,1,222,1,1,0,1,1,120,120,103,102,22
"2200",99,"[28]EekxGtHnKqGocIHBJCBbooGqFCxy",236,0.995781,28,237,1,236,1,1,0,1,1,109,109,128,127,22
"2201",0,"[22]EwtHnKqGocIHcJCEsHafbw",228,0.995633,22,229,1,228,1,1,0,1,1,116,116,113,112,23
"2202",1,"[22]EwtHnKqGocIHcJCEsHafbw",241,0.995868,22,242,1,241,1,1,0,1,1,105,105,137,136,23
"2203",2,"[22]EwtHnKqGocIHcJCEsHafbw",236,0.995781,22,237,1,236,1,1,0,1,1,114,114,123,122,23
"2204",3,"[22]EwtHnKqGocIHcJCEsHafbw",229,0.995652,22,230,1,229,1,1,0,1,1,116,116,114,113,23
"2205",4,"[22]EwtHnKqGocIHcJCEsHafbw",232,0.995708,22,233,1,232,1,1,0,1,1,116,116,117,116,23
"2206",5,"[22]EwtHnKqGocIHcJCEsHafbw",238,0.995816,22,239,1,238,1,1,0,1,1,111,111,128,127,23
"2207",6,"[22]EwtHnKqGocIHcJCEsHafbw",238,0.995816,22,239,1,238,1,1,0,1,1,109,109,130,129,23
"2208",7,"[22]EwtHnKqGocIHcJCEsHafbw",227,0.995614,22,228,1,227,1,1,0,1,1,120,120,108,107,23
"2209",8,"[22]EwtHnKqGocIHcJCEsHafbw",231,0.99569,22,232,1,231,1,1,0,1,1,115,115,117,116,23
"2210",9,"[22]EwtHnKqGocIHcJCEsHafbw",230,0.995671,22,231,1,230,1,1,0,1,1,117,117,114,113,23
"2211",10,"[22]EwtHnKqGocIHcJCEsHafbw",220,0.995475,22,221,1,220,1,1,0,1,1,123,123,98,97,23
"2212",11,"[22]EwtHnKqGocIHcJCEsHafbw",223,0.995536,22,224,1,223,1,1,0,1,1,120,120,104,103,23
"2213",12,"[22]EwtHnKqGocIHcJCEsHafbw",235,0.995763,22,236,1,235,1,1,0,1,1,112,112,124,123,23
"2214",13,"[22]EwtHnKqGocIHcJCEsHafbw",232,0.995708,22,233,1,232,1,1,0,1,1,113,113,120,119,23
"2215",14,"[22]EwtHnKqGocIHcJCEsHafbw",237,0.995798,22,238,1,237,1,1,0,1,1,109,109,129,128,23
"2216",15,"[22]EwtHnKqGocIHcJCEsHafbw",228,0.995633,22,229,1,228,1,1,0,1,1,116,116,113,112,23
"2217",16,"[22]EwtHnKqGocIHcJCEsHafbw",224,0.995556,22,225,1,224,1,1,0,1,1,120,120,105,104,23
"2218",17,"[22]EwtHnKqGocIHcJCEsHafbw",229,0.995652,22,230,1,229,1,1,0,1,1,116,116,114,113,23
"2219",18,"[22]EwtHnKqGocIHcJCEsHafbw",238,0.995816,22,239,1,238,1,1,0,1,1,109,109,130,129,23
"2220",19,"[22]EwtHnKqGocIHcJCEsHafbw",227,0.995614,22,228,1,227,1,1,0,1,1,117,117,111,110,23
"2221",20,"[22]EwtHnKqGocIHcJCEsHafbw",229,0.995652,22,230,1,229,1,1,0,1,1,115,115,115,114,23
"2222",21,"[22]EwtHnKqGocIHcJCEsHafbw",241,0.995868,22,242,1,241,1,1,0,1,1,107,107,135,134,23
"2223",22,"[22]EwtHnKqGocIHcJCEsHafbw",236,0.995781,22,237,1,236,1,1,0,1,1,109,109,128,127,23
"2224",23,"[22]EwtHnKqGocIHcJCEsHafbw",225,0.995575,22,226,1,225,1,1,0,1,1,119,119,107,106,23
"2225",24,"[22]EwtHnKqGocIHcJCEsHafbw",234,0.995745,22,235,1,234,1,1,0,1,1,111,111,124,123,23
"2226",25,"[22]EwtHnKqGocIHcJCEsHafbw",227,0.995614,22,228,1,227,1,1,0,1,1,118,118,110,109,23
"2227",26,"[22]EwtHnKqGocIHcJCEsHafbw",233,0.995726,22,234,1,233,1,1,0,1,1,115,115,119,118,23
"2228",27,"[22]EwtHnKqGocIHcJCEsHafbw",234,0.995745,22,235,1,234,1,1,0,1,1,112,112,123,122,23
"2229",28,"[22]EwtHnKqGocIHcJCEsHafbw",227,0.995614,22,228,1,227,1,1,0,1,1,118,118,110,109,23
"2230",29,"[22]EwtHnKqGocIHcJCEsHafbw",229,0.995652,22,230,1,229,1,1,0,1,1,115,115,115,114,23
"2231",30,"[22]EwtHnKqGocIHcJCEsHafbw",236,0.995781,22,237,1,236,1,1,0,1,1,109,109,128,127,23
"2232",31,"[22]EwtHnKqGocIHcJCEsHafbw",234,0.995745,22,235,1,234,1,1,0,1,1,111,111,124,123,23
"2233",32,"[22]EwtHnKqGocIHcJCEsHafbw",238,0.995816,22,239,1,238,1,1,0,1,1,108,108,131,130,23
"2234",33,"[22]EwtHnKqGocIHcJCEsHafbw",240,0.995851,22,241,1,240,1,1,0,1,1,107,107,134,133,23
"2235",34,"[22]EwtHnKqGocIHcJCEsHafbw",235,0.995763,22,236,1,235,1,1,0,1,1,111,111,125,124,23
"2236",35,"[22]EwtHnKqGocIHcJCEsHafbw",236,0.995781,22,237,1,236,1,1,0,1,1,111,111,126,125,23
"2237",36,"[22]EwtHnKqGocIHcJCEsHafbw",229,0.995652,22,230,1,229,1,1,0,1,1,115,115,115,114,23
"2238",37,"[22]EwtHnKqGocIHcJCEsHafbw",226,0.995595,22,227,1,226,1,1,0,1,1,118,118,109,108,23
"2239",38,"[22]EwtHnKqGocIHcJCEsHafbw",228,0.995633,22,229,1,228,1,1,0,1,1,116,116,113,112,23
"2240",39,"[22]EwtHnKqGocIHcJCEsHafbw",232,0.995708,22,233,1,232,1,1,0,1,1,113,113,120,119,23
"2241",40,"[22]EwtHnKqGocIHcJCEsHafbw",234,0.995745,22,235,1,234,1,1,0,1,1,113,113,122,121,23
"2242",41,"[22]EwtHnKqGocIHcJCEsHafbw",238,0.995816,22,239,1,238,1,1,0,1,1,109,109,130,129,23
"2243",42,"[22]EwtHnKqGocIHcJCEsHafbw",237,0.995798,22,238,1,237,1,1,0,1,1,110,110,128,127,23
"2244",43,"[22]EwtHnKqGocIHcJCEsHafbw",231,0.99569,22,232,1,231,1,1,0,1,1,113,113,119,118,23
"2245",44,"[22]EwtHnKqGocIHcJCEsHafbw",232,0.995708,22,233,1,232,1,1,0,1,1,114,114,119,118,23
"2246",45,"[22]EwtHnKqGocIHcJCEsHafbw",231,0.99569,22,232,1,231,1,1,0,1,1,113,113,119,118,23
"2247",46,"[22]EwtHnKqGocIHcJCEsHafbw",229,0.995652,22,230,1,229,1,1,0,1,1,116,116,114,113,23
"2248",47,"[22]EwtHnKqGocIHcJCEsHafbw",232,0.995708,22,233,1,232,1,1,0,1,1,113,113,120,119,23
"2249",48,"[22]EwtHnKqGocIHcJCEsHafbw",229,0.995652,22,230,1,229,1,1,0,1,1,116,116,114,113,23
"2250",49,"[22]EwtHnKqGocIHcJCEsHafbw",229,0.995652,22,230,1,229,1,1,0,1,1,115,115,115,114,23
"2251",50,"[22]EwtHnKqGocIHcJCEsHafbw",229,0.995652,22,230,1,229,1,1,0,1,1,116,116,114,113,23
"2252",51,"[22]EwtHnKqGocIHcJCEsHafbw",235,0.995763,22,236,1,235,1,1,0,1,1,110,110,126,125,23
"2253",52,"[22]EwtHnKqGocIHcJCEsHafbw",234,0.995745,22,235,1,234,1,1,0,1,1,111,111,124,123,23
"2254",53,"[22]EwtHnKqGocIHcJCEsHafbw",234,0.995745,22,235,1,234,1,1,0,1,1,111,111,124,123,23
"2255",54,"[22]EwtHnKqGocIHcJCEsHafbw",232,0.995708,22,233,1,232,1,1,0,1,1,113,113,120,119,23
"2256",55,"[22]EwtHnKqGocIHcJCEsHafbw",226,0.995595,22,227,1,226,1,1,0,1,1,117,117,110,109,23
"2257",56,"[22]EwtHnKqGocIHcJCEsHafbw",233,0.995726,22,234,1,233,1,1,0,1,1,114,114,120,119,23
"2258",57,"[22]EwtHnKqGocIHcJCEsHafbw",223,0.995536,22,224,1,223,1,1,0,1,1,121,121,103,102,23
"2259",58,"[22]EwtHnKqGocIHcJCEsHafbw",225,0.995575,22,226,1,225,1,1,0,1,1,118,118,108,107,23
"2260",59,"[22]EwtHnKqGocIHcJCEsHafbw",219,0.995455,22,220,1,219,1,1,0,1,1,124,124,96,95,23
"2261",60,"[22]EwtHnKqGocIHcJCEsHafbw",237,0.995798,22,238,1,237,1,1,0,1,1,109,109,129,128,23
"2262",61,"[22]EwtHnKqGocIHcJCEsHafbw",232,0.995708,22,233,1,232,1,1,0,1,1,113,113,120,119,23
"2263",62,"[22]EwtHnKqGocIHcJCEsHafbw",234,0.995745,22,235,1,234,1,1,0,1,1,115,115,120,119,23
"2264",63,"[22]EwtHnKqGocIHcJCEsHafbw",229,0.995652,22,230,1,229,1,1,0,1,1,115,115,115,114,23
"2265",64,"[22]EwtHnKqGocIHcJCEsHafbw",225,0.995575,22,226,1,225,1,1,0,1,1,120,120,106,105,23
"2266",65,"[22]EwtHnKqGocIHcJCEsHafbw",236,0.995781,22,237,1,236,1,1,0,1,1,109,109,128,127,23
"2267",66,"[22]EwtHnKqGocIHcJCEsHafbw",227,0.995614,22,228,1,227,1,1,0,1,1,118,118,110,109,23
"2268",67,"[22]EwtHnKqGocIHcJCEsHafbw",234,0.995745,22,235,1,234,1,1,0,1,1,114,114,121,120,23
"2269",68,"[22]EwtHnKqGocIHcJCEsHafbw",232,0.995708,22,233,1,232,1,1,0,1,1,113,113,120,119,23
"2270",69,"[22]EwtHnKqGocIHcJCEsHafbw",221,0.995495,22,222,1,221,1,1,0,1,1,122,122,100,99,23
"2271",70,"[22]EwtHnKqGocIHcJCEsHafbw",232,0.995708,22,233,1,232,1,1,0,1,1,117,117,116,115,23
"2272",71,"[22]EwtHnKqGocIHcJCEsHafbw",224,0.995556,22,225,1,224,1,1,0,1,1,124,124,101,100,23
"2273",72,"[22]EwtHnKqGocIHcJCEsHafbw",236,0.995781,22,237,1,236,1,1,0,1,1,111,111,126,125,23
"2274",73,"[22]EwtHnKqGocIHcJCEsHafbw",242,0.995885,22,243,1,242,1,1,0,1,1,106,106,137,136,23
"2275",74,"[22]EwtHnKqGocIHcJCEsHafbw",225,0.995575,22,226,1,225,1,1,0,1,1,118,118,108,107,23
"2276",75,"[22]EwtHnKqGocIHcJCEsHafbw",230,0.995671,22,231,1,230,1,1,0,1,1,114,114,117,116,23
"2277",76,"[22]EwtHnKqGocIHcJCEsHafbw",230,0.995671,22,231,1,230,1,1,0,1,1,115,115,116,115,23
"2278",77,"[22]EwtHnKqGocIHcJCEsHafbw",240,0.995851,22,241,1,240,1,1,0,1,1,107,107,134,133,23
"2279",78,"[22]EwtHnKqGocIHcJCEsHafbw",245,0.995935,22,246,1,245,1,1,0,1,1,103,103,143,142,23
"2280",79,"[22]EwtHnKqGocIHcJCEsHafbw",218,0.995434,22,219,1,218,1,1,0,1,1,125,125,94,93,23
"2281",80,"[22]EwtHnKqGocIHcJCEsHafbw",233,0.995726,22,234,1,233,1,1,0,1,1,112,112,122,121,23
"2282",81,"[22]EwtHnKqGocIHcJCEsHafbw",224,0.995556,22,225,1,224,1,1,0,1,1,121,121,104,103,23
"2283",82,"[22]EwtHnKqGocIHcJCEsHafbw",230,0.995671,22,231,1,230,1,1,0,1,1,114,114,117,116,23
"2284",83,"[22]EwtHnKqGocIHcJCEsHafbw",223,0.995536,22,224,1,223,1,1,0,1,1,121,121,103,102,23
"2285",84,"[22]EwtHnKqGocIHcJCEsHafbw",232,0.995708,22,233,1,232,1,1,0,1,1,115,115,118,117,23
"2286",85,"[22]EwtHnKqGocIHcJCEsHafbw",234,0.995745,22,235,1,234,1,1,0,1,1,111,111,124,123,23
"2287",86,"[22]EwtHnKqGocIHcJCEsHafbw",234,0.995745,22,235,1,234,1,1,0,1,1,115,115,120,119,23
"2288",87,"[22]EwtHnKqGocIHcJCEsHafbw",230,0.995671,22,231,1,230,1,1,0,1,1,115,115,116,115,23
"2289",88,"[22]EwtHnKqGocIHcJCEsHafbw",223,0.995536,22,224,1,223,1,1,0,1,1,120,120,104,103,23
"2290",89,"[22]EwtHnKqGocIHcJCEsHafbw",236,0.995781,22,237,1,236,1,1,0,1,1,109,109,128,127,23
"2291",90,"[22]EwtHnKqGocIHcJCEsHafbw",229,0.995652,22,230,1,229,1,1,0,1,1,116,116,114,113,23
"2292",91,"[22]EwtHnKqGocIHcJCEsHafbw",225,0.995575,22,226,1,225,1,1,0,1,1,118,118,108,107,23
"2293",92,"[22]EwtHnKqGocIHcJCEsHafbw",236,0.995781,22,237,1,236,1,1,0,1,1,113,113,124,123,23
"2294",93,"[22]EwtHnKqGocIHcJCEsHafbw",230,0.995671,22,231,1,230,1,1,0,1,1,115,115,116,115,23
"2295",94,"[22]EwtHnKqGocIHcJCEsHafbw",229,0.995652,22,230,1,229,1,1,0,1,1,118,118,112,111,23
"2296",95,"[22]EwtHnKqGocIHcJCEsHafbw",228,0.995633,22,229,1,228,1,1,0,1,1,116,116,113,112,23
"2297",96,"[22]EwtHnKqGocIHcJCEsHafbw",218,0.995434,22,219,1,218,1,1,0,1,1,125,125,94,93,23
"2298",97,"[22]EwtHnKqGocIHcJCEsHafbw",239,0.995833,22,240,1,239,1,1,0,1,1,108,108,132,131,23
"2299",98,"[22]EwtHnKqGocIHcJCEsHafbw",243,0.995902,22,244,1,243,1,1,0,1,1,107,107,137,136,23
"2300",99,"[22]EwtHnKqGocIHcJCEsHafbw",234,0.995745,22,235,1,234,1,1,0,1,1,113,113,122,121,23
"2301",0,"[28]ExxHnKqGocIHcJCrcFaFAniHryfl",245,0.995935,28,246,1,245,1,1,0,1,1,102,102,144,143,24
"2302",1,"[28]ExxHnKqGocIHcJCrcFaFAniHryfl",235,0.995763,28,236,1,235,1,1,0,1,1,111,111,125,124,24
"2303",2,"[28]ExxHnKqGocIHcJCrcFaFAniHryfl",224,0.995556,28,225,1,224,1,1,0,1,1,120,120,105,104,24
"2304",3,"[28]ExxHnKqGocIHcJCrcFaFAniHryfl",231,0.99569,28,232,1,231,1,1,0,1,1,114,114,118,117,24
"2305",4,"[28]ExxHnKqGocIHcJCrcFaFAniHryfl",244,0.995918,28,245,1,244,1,1,0,1,1,109,109,136,135,24
"2306",5,"[28]ExxHnKqGocIHcJCrcFaFAniHryfl",237,0.995798,28,238,1,237,1,1,0,1,1,112,112,126,125,24
"2307",6,"[28]ExxHnKqGocIHcJCrcFaFAniHryfl",225,0.995575,28,226,1,225,1,1,0,1,1,119,119,107,106,24
"2308",7,"[28]ExxHnKqGocIHcJCrcFaFAniHryfl",234,0.995745,28,235,1,234,1,1,0,1,1,115,115,120,119,24
"2309",8,"[28]ExxHnKqGocIHcJCrcFaFAniHryfl",227,0.995614,28,228,1,227,1,1,0,1,1,117,117,111,110,24
"2310",9,"[28]ExxHnKqGocIHcJCrcFaFAniHryfl",222,0.995516,28,223,1,222,1,1,0,1,1,121,121,102,101,24
"2311",10,"[28]ExxHnKqGocIHcJCrcFaFAniHryfl",231,0.99569,28,232,1,231,1,1,0,1,1,116,116,116,115,24
"2312",11,"[28]ExxHnKqGocIHcJCrcFaFAniHryfl",226,0.995595,28,227,1,226,1,1,0,1,1,117,117,110,109,24
"2313",12,"[28]ExxHnKqGocIHcJCrcFaFAniHryfl",237,0.995798,28,238,1,237,1,1,0,1,1,109,109,129,128,24
"2314",13,"[28]ExxHnKqGocIHcJCrcFaFAniHryfl",232,0.995708,28,233,1,232,1,1,0,1,1,115,115,118,117,24
"2315",14,"[28]ExxHnKqGocIHcJCrcFaFAniHryfl",236,0.995781,28,237,1,236,1,1,0,1,1,110,110,127,126,24
"2316",15,"[28]ExxHnKqGocIHcJCrcFaFAniHryfl",235,0.995763,28,236,1,235,1,1,0,1,1,111,111,125,124,24
"2317",16,"[28]ExxHnKqGocIHcJCrcFaFAniHryfl",230,0.995671,28,231,1,230,1,1,0,1,1,117,117,114,113,24
"2318",17,"[28]ExxHnKqGocIHcJCrcFaFAniHryfl",216,0.995392,28,217,1,216,1,1,0,1,1,125,125,92,91,24
"2319",18,"[28]ExxHnKqGocIHcJCrcFaFAniHryfl",231,0.99569,28,232,1,231,1,1,0,1,1,116,116,116,115,24
"2320",19,"[28]ExxHnKqGocIHcJCrcFaFAniHryfl",226,0.995595,28,227,1,226,1,1,0,1,1,118,118,109,108,24
"2321",20,"[28]ExxHnKqGocIHcJCrcFaFAniHryfl",228,0.995633,28,229,1,228,1,1,0,1,1,120,120,109,108,24
"2322",21,"[28]ExxHnKqGocIHcJCrcFaFAniHryfl",233,0.995726,28,234,1,233,1,1,0,1,1,115,115,119,118,24
"2323",22,"[28]ExxHnKqGocIHcJCrcFaFAniHryfl",229,0.995652,28,230,1,229,1,1,0,1,1,115,115,115,114,24
"2324",23,"[28]ExxHnKqGocIHcJCrcFaFAniHryfl",230,0.995671,28,231,1,230,1,1,0,1,1,115,115,116,115,24
"2325",24,"[28]ExxHnKqGocIHcJCrcFaFAniHryfl",228,0.995633,28,229,1,228,1,1,0,1,1,117,117,112,111,24
"2326",25,"[28]ExxHnKqGocIHcJCrcFaFAniHryfl",240,0.995851,28,241,1,240,1,1,0,1,1,106,106,135,134,24
"2327",26,"[28]ExxHnKqGocIHcJCrcFaFAniHryfl",221,0.995495,28,222,1,221,1,1,0,1,1,121,121,101,100,24
"2328",27,"[28]ExxHnKqGocIHcJCrcFaFAniHryfl",236,0.995781,28,237,1,236,1,1,0,1,1,109,109,128,127,24
"2329",28,"[28]ExxHnKqGocIHcJCrcFaFAniHryfl",229,0.995652,28,230,1,229,1,1,0,1,1,115,115,115,114,24
"2330",29,"[28]ExxHnKqGocIHcJCrcFaFAniHryfl",236,0.995781,28,237,1,236,1,1,0,1,1,112,112,125,124,24
"2331",30,"[28]ExxHnKqGocIHcJCrcFaFAniHryfl",235,0.995763,28,236,1,235,1,1,0,1,1,112,112,124,123,24
"2332",31,"[28]ExxHnKqGocIHcJCrcFaFAniHryfl",238,0.995816,28,239,1,238,1,1,0,1,1,108,108,131,130,24
"2333",32,"[28]ExxHnKqGocIHcJCrcFaFAniHryfl",228,0.995633,28,229,1,228,1,1,0,1,1,117,117,112,111,24
"2334",33,"[28]ExxHnKqGocIHcJCrcFaFAniHryfl",237,0.995798,28,238,1,237,1,1,0,1,1,109,109,129,128,24
"2335",34,"[28]ExxHnKqGocIHcJCrcFaFAniHryfl",227,0.995614,28,228,1,227,1,1,0,1,1,119,119,109,108,24
"2336",35,"[28]ExxHnKqGocIHcJCrcFaFAniHryfl",230,0.995671,28,231,1,230,1,1,0,1,1,115,115,116,115,24
"2337",36,"[28]ExxHnKqGocIHcJCrcFaFAniHryfl",232,0.995708,28,233,1,232,1,1,0,1,1,114,114,119,118,24
"2338",37,"[28]ExxHnKqGocIHcJCrcFaFAniHryfl",235,0.995763,28,236,1,235,1,1,0,1,1,111,111,125,124,24
"2339",38,"[28]ExxHnKqGocIHcJCrcFaFAniHryfl",236,0.995781,28,237,1,236,1,1,0,1,1,110,110,127,126,24
"2340",39,"[28]ExxHnKqGocIHcJCrcFaFAniHryfl",240,0.995851,28,241,1,240,1,1,0,1,1,107,107,134,133,24
"2341",40,"[28]ExxHnKqGocIHcJCrcFaFAniHryfl",224,0.995556,28,225,1,224,1,1,0,1,1,121,121,104,103,24
"2342",41,"[28]ExxHnKqGocIHcJCrcFaFAniHryfl",223,0.995536,28,224,1,223,1,1,0,1,1,121,121,103,102,24
"2343",42,"[28]ExxHnKqGocIHcJCrcFaFAniHryfl",228,0.995633,28,229,1,228,1,1,0,1,1,116,116,113,112,24
"2344",43,"[28]ExxHnKqGocIHcJCrcFaFAniHryfl",228,0.995633,28,229,1,228,1,1,0,1,1,119,119,110,109,24
"2345",44,"[28]ExxHnKqGocIHcJCrcFaFAniHryfl",232,0.995708,28,233,1,232,1,1,0,1,1,114,114,119,118,24
"2346",45,"[28]ExxHnKqGocIHcJCrcFaFAniHryfl",221,0.995495,28,222,1,221,1,1,0,1,1,121,121,101,100,24
"2347",46,"[28]ExxHnKqGocIHcJCrcFaFAniHryfl",228,0.995633,28,229,1,228,1,1,0,1,1,117,117,112,111,24
"2348",47,"[28]ExxHnKqGocIHcJCrcFaFAniHryfl",241,0.995868,28,242,1,241,1,1,0,1,1,107,107,135,134,24
"2349",48,"[28]ExxHnKqGocIHcJCrcFaFAniHryfl",234,0.995745,28,235,1,234,1,1,0,1,1,112,112,123,122,24
"2350",49,"[28]ExxHnKqGocIHcJCrcFaFAniHryfl",234,0.995745,28,235,1,234,1,1,0,1,1,112,112,123,122,24
"2351",50,"[28]ExxHnKqGocIHcJCrcFaFAniHryfl",216,0.995392,28,217,1,216,1,1,0,1,1,126,126,91,90,24
"2352",51,"[28]ExxHnKqGocIHcJCrcFaFAniHryfl",235,0.995763,28,236,1,235,1,1,0,1,1,111,111,125,124,24
"2353",52,"[28]ExxHnKqGocIHcJCrcFaFAniHryfl",225,0.995575,28,226,1,225,1,1,0,1,1,120,120,106,105,24
"2354",53,"[28]ExxHnKqGocIHcJCrcFaFAniHryfl",226,0.995595,28,227,1,226,1,1,0,1,1,118,118,109,108,24
"2355",54,"[28]ExxHnKqGocIHcJCrcFaFAniHryfl",242,0.995885,28,243,1,242,1,1,0,1,1,107,107,136,135,24
"2356",55,"[28]ExxHnKqGocIHcJCrcFaFAniHryfl",224,0.995556,28,225,1,224,1,1,0,1,1,121,121,104,103,24
"2357",56,"[28]ExxHnKqGocIHcJCrcFaFAniHryfl",230,0.995671,28,231,1,230,1,1,0,1,1,114,114,117,116,24
"2358",57,"[28]ExxHnKqGocIHcJCrcFaFAniHryfl",240,0.995851,28,241,1,240,1,1,0,1,1,107,107,134,133,24
"2359",58,"[28]ExxHnKqGocIHcJCrcFaFAniHryfl",233,0.995726,28,234,1,233,1,1,0,1,1,118,118,116,115,24
"2360",59,"[28]ExxHnKqGocIHcJCrcFaFAniHryfl",229,0.995652,28,230,1,229,1,1,0,1,1,115,115,115,114,24
"2361",60,"[28]ExxHnKqGocIHcJCrcFaFAniHryfl",225,0.995575,28,226,1,225,1,1,0,1,1,119,119,107,106,24
"2362",61,"[28]ExxHnKqGocIHcJCrcFaFAniHryfl",218,0.995434,28,219,1,218,1,1,0,1,1,125,125,94,93,24
"2363",62,"[28]ExxHnKqGocIHcJCrcFaFAniHryfl",219,0.995455,28,220,1,219,1,1,0,1,1,124,124,96,95,24
"2364",63,"[28]ExxHnKqGocIHcJCrcFaFAniHryfl",228,0.995633,28,229,1,228,1,1,0,1,1,117,117,112,111,24
"2365",64,"[28]ExxHnKqGocIHcJCrcFaFAniHryfl",227,0.995614,28,228,1,227,1,1,0,1,1,117,117,111,110,24
"2366",65,"[28]ExxHnKqGocIHcJCrcFaFAniHryfl",227,0.995614,28,228,1,227,1,1,0,1,1,120,120,108,107,24
"2367",66,"[28]ExxHnKqGocIHcJCrcFaFAniHryfl",228,0.995633,28,229,1,228,1,1,0,1,1,116,116,113,112,24
"2368",67,"[28]ExxHnKqGocIHcJCrcFaFAniHryfl",225,0.995575,28,226,1,225,1,1,0,1,1,118,118,108,107,24
"2369",68,"[28]ExxHnKqGocIHcJCrcFaFAniHryfl",243,0.995902,28,244,1,243,1,1,0,1,1,105,105,139,138,24
"2370",69,"[28]ExxHnKqGocIHcJCrcFaFAniHryfl",229,0.995652,28,230,1,229,1,1,0,1,1,116,116,114,113,24
"2371",70,"[28]ExxHnKqGocIHcJCrcFaFAniHryfl",230,0.995671,28,231,1,230,1,1,0,1,1,115,115,116,115,24
"2372",71,"[28]ExxHnKqGocIHcJCrcFaFAniHryfl",236,0.995781,28,237,1,236,1,1,0,1,1,110,110,127,126,24
"2373",72,"[28]ExxHnKqGocIHcJCrcFaFAniHryfl",232,0.995708,28,233,1,232,1,1,0,1,1,113,113,120,119,24
"2374",73,"[28]ExxHnKqGocIHcJCrcFaFAniHryfl",232,0.995708,28,233,1,232,1,1,0,1,1,115,115,118,117,24
"2375",74,"[28]ExxHnKqGocIHcJCrcFaFAniHryfl",230,0.995671,28,231,1,230,1,1,0,1,1,117,117,114,113,24
"2376",75,"[28]ExxHnKqGocIHcJCrcFaFAniHryfl",225,0.995575,28,226,1,225,1,1,0,1,1,119,119,107,106,24
"2377",76,"[28]ExxHnKqGocIHcJCrcFaFAniHryfl",219,0.995455,28,220,1,219,1,1,0,1,1,123,123,97,96,24
"2378",77,"[28]ExxHnKqGocIHcJCrcFaFAniHryfl",223,0.995536,28,224,1,223,1,1,0,1,1,121,121,103,102,24
"2379",78,"[28]ExxHnKqGocIHcJCrcFaFAniHryfl",218,0.995434,28,219,1,218,1,1,0,1,1,124,124,95,94,24
"2380",79,"[28]ExxHnKqGocIHcJCrcFaFAniHryfl",233,0.995726,28,234,1,233,1,1,0,1,1,115,115,119,118,24
"2381",80,"[28]ExxHnKqGocIHcJCrcFaFAniHryfl",226,0.995595,28,227,1,226,1,1,0,1,1,121,121,106,105,24
"2382",81,"[28]ExxHnKqGocIHcJCrcFaFAniHryfl",234,0.995745,28,235,1,234,1,1,0,1,1,111,111,124,123,24
"2383",82,"[28]ExxHnKqGocIHcJCrcFaFAniHryfl",231,0.99569,28,232,1,231,1,1,0,1,1,114,114,118,117,24
"2384",83,"[28]ExxHnKqGocIHcJCrcFaFAniHryfl",233,0.995726,28,234,1,233,1,1,0,1,1,112,112,122,121,24
"2385",84,"[28]ExxHnKqGocIHcJCrcFaFAniHryfl",219,0.995455,28,220,1,219,1,1,0,1,1,125,125,95,94,24
"2386",85,"[28]ExxHnKqGocIHcJCrcFaFAniHryfl",238,0.995816,28,239,1,238,1,1,0,1,1,108,108,131,130,24
"2387",86,"[28]ExxHnKqGocIHcJCrcFaFAniHryfl",226,0.995595,28,227,1,226,1,1,0,1,1,117,117,110,109,24
"2388",87,"[28]ExxHnKqGocIHcJCrcFaFAniHryfl",234,0.995745,28,235,1,234,1,1,0,1,1,113,113,122,121,24
"2389",88,"[28]ExxHnKqGocIHcJCrcFaFAniHryfl",234,0.995745,28,235,1,234,1,1,0,1,1,111,111,124,123,24
"2390",89,"[28]ExxHnKqGocIHcJCrcFaFAniHryfl",230,0.995671,28,231,1,230,1,1,0,1,1,115,115,116,115,24
"2391",90,"[28]ExxHnKqGocIHcJCrcFaFAniHryfl",230,0.995671,28,231,1,230,1,1,0,1,1,115,115,116,115,24
"2392",91,"[28]ExxHnKqGocIHcJCrcFaFAniHryfl",234,0.995745,28,235,1,234,1,1,0,1,1,112,112,123,122,24
"2393",92,"[28]ExxHnKqGocIHcJCrcFaFAniHryfl",232,0.995708,28,233,1,232,1,1,0,1,1,113,113,120,119,24
"2394",93,"[28]ExxHnKqGocIHcJCrcFaFAniHryfl",233,0.995726,28,234,1,233,1,1,0,1,1,114,114,120,119,24
"2395",94,"[28]ExxHnKqGocIHcJCrcFaFAniHryfl",229,0.995652,28,230,1,229,1,1,0,1,1,116,116,114,113,24
"2396",95,"[28]ExxHnKqGocIHcJCrcFaFAniHryfl",220,0.995475,28,221,1,220,1,1,0,1,1,122,122,99,98,24
"2397",96,"[28]ExxHnKqGocIHcJCrcFaFAniHryfl",227,0.995614,28,228,1,227,1,1,0,1,1,120,120,108,107,24
"2398",97,"[28]ExxHnKqGocIHcJCrcFaFAniHryfl",238,0.995816,28,239,1,238,1,1,0,1,1,110,110,129,128,24
"2399",98,"[28]ExxHnKqGocIHcJCrcFaFAniHryfl",219,0.995455,28,220,1,219,1,1,0,1,1,124,124,96,95,24
"2400",99,"[28]ExxHnKqGocIHcJCrcFaFAniHryfl",230,0.995671,28,231,1,230,1,1,0,1,1,116,116,115,114,24
"2401",0,"[26]EulesHnKqGocIHcJCJCBqziJeD",226,0.995595,26,227,1,226,1,1,0,1,1,118,118,109,108,25
"2402",1,"[26]EulesHnKqGocIHcJCJCBqziJeD",222,0.995516,26,223,1,222,1,1,0,1,1,122,122,101,100,25
"2403",2,"[26]EulesHnKqGocIHcJCJCBqziJeD",217,0.995413,26,218,1,217,1,1,0,1,1,124,124,94,93,25
"2404",3,"[26]EulesHnKqGocIHcJCJCBqziJeD",221,0.995495,26,222,1,221,1,1,0,1,1,121,121,101,100,25
"2405",4,"[26]EulesHnKqGocIHcJCJCBqziJeD",227,0.995614,26,228,1,227,1,1,0,1,1,119,119,109,108,25
"2406",5,"[26]EulesHnKqGocIHcJCJCBqziJeD",230,0.995671,26,231,1,230,1,1,0,1,1,115,115,116,115,25
"2407",6,"[26]EulesHnKqGocIHcJCJCBqziJeD",233,0.995726,26,234,1,233,1,1,0,1,1,112,112,122,121,25
"2408",7,"[26]EulesHnKqGocIHcJCJCBqziJeD",226,0.995595,26,227,1,226,1,1,0,1,1,118,118,109,108,25
"2409",8,"[26]EulesHnKqGocIHcJCJCBqziJeD",232,0.995708,26,233,1,232,1,1,0,1,1,113,113,120,119,25
"2410",9,"[26]EulesHnKqGocIHcJCJCBqziJeD",230,0.995671,26,231,1,230,1,1,0,1,1,114,114,117,116,25
"2411",10,"[26]EulesHnKqGocIHcJCJCBqziJeD",227,0.995614,26,228,1,227,1,1,0,1,1,117,117,111,110,25
"2412",11,"[26]EulesHnKqGocIHcJCJCBqziJeD",220,0.995475,26,221,1,220,1,1,0,1,1,123,123,98,97,25
"2413",12,"[26]EulesHnKqGocIHcJCJCBqziJeD",233,0.995726,26,234,1,233,1,1,0,1,1,112,112,122,121,25
"2414",13,"[26]EulesHnKqGocIHcJCJCBqziJeD",232,0.995708,26,233,1,232,1,1,0,1,1,112,112,121,120,25
"2415",14,"[26]EulesHnKqGocIHcJCJCBqziJeD",232,0.995708,26,233,1,232,1,1,0,1,1,112,112,121,120,25
"2416",15,"[26]EulesHnKqGocIHcJCJCBqziJeD",228,0.995633,26,229,1,228,1,1,0,1,1,115,115,114,113,25
"2417",16,"[26]EulesHnKqGocIHcJCJCBqziJeD",236,0.995781,26,237,1,236,1,1,0,1,1,110,110,127,126,25
"2418",17,"[26]EulesHnKqGocIHcJCJCBqziJeD",225,0.995575,26,226,1,225,1,1,0,1,1,118,118,108,107,25
"2419",18,"[26]EulesHnKqGocIHcJCJCBqziJeD",231,0.99569,26,232,1,231,1,1,0,1,1,114,114,118,117,25
"2420",19,"[26]EulesHnKqGocIHcJCJCBqziJeD",226,0.995595,26,227,1,226,1,1,0,1,1,117,117,110,109,25
"2421",20,"[26]EulesHnKqGocIHcJCJCBqziJeD",233,0.995726,26,234,1,233,1,1,0,1,1,115,115,119,118,25
"2422",21,"[26]EulesHnKqGocIHcJCJCBqziJeD",239,0.995833,26,240,1,239,1,1,0,1,1,107,107,133,132,25
"2423",22,"[26]EulesHnKqGocIHcJCJCBqziJeD",227,0.995614,26,228,1,227,1,1,0,1,1,118,118,110,109,25
"2424",23,"[26]EulesHnKqGocIHcJCJCBqziJeD",237,0.995798,26,238,1,237,1,1,0,1,1,108,108,130,129,25
"2425",24,"[26]EulesHnKqGocIHcJCJCBqziJeD",232,0.995708,26,233,1,232,1,1,0,1,1,113,113,120,119,25
"2426",25,"[26]EulesHnKqGocIHcJCJCBqziJeD",234,0.995745,26,235,1,234,1,1,0,1,1,111,111,124,123,25
"2427",26,"[26]EulesHnKqGocIHcJCJCBqziJeD",234,0.995745,26,235,1,234,1,1,0,1,1,111,111,124,123,25
"2428",27,"[26]EulesHnKqGocIHcJCJCBqziJeD",234,0.995745,26,235,1,234,1,1,0,1,1,111,111,124,123,25
"2429",28,"[26]EulesHnKqGocIHcJCJCBqziJeD",239,0.995833,26,240,1,239,1,1,0,1,1,107,107,133,132,25
"2430",29,"[26]EulesHnKqGocIHcJCJCBqziJeD",235,0.995763,26,236,1,235,1,1,0,1,1,110,110,126,125,25
"2431",30,"[26]EulesHnKqGocIHcJCJCBqziJeD",246,0.995951,26,247,1,246,1,1,0,1,1,102,102,145,144,25
"2432",31,"[26]EulesHnKqGocIHcJCJCBqziJeD",226,0.995595,26,227,1,226,1,1,0,1,1,119,119,108,107,25
"2433",32,"[26]EulesHnKqGocIHcJCJCBqziJeD",229,0.995652,26,230,1,229,1,1,0,1,1,115,115,115,114,25
"2434",33,"[26]EulesHnKqGocIHcJCJCBqziJeD",231,0.99569,26,232,1,231,1,1,0,1,1,114,114,118,117,25
"2435",34,"[26]EulesHnKqGocIHcJCJCBqziJeD",232,0.995708,26,233,1,232,1,1,0,1,1,112,112,121,120,25
"2436",35,"[26]EulesHnKqGocIHcJCJCBqziJeD",227,0.995614,26,228,1,227,1,1,0,1,1,118,118,110,109,25
"2437",36,"[26]EulesHnKqGocIHcJCJCBqziJeD",232,0.995708,26,233,1,232,1,1,0,1,1,113,113,120,119,25
"2438",37,"[26]EulesHnKqGocIHcJCJCBqziJeD",231,0.99569,26,232,1,231,1,1,0,1,1,113,113,119,118,25
"2439",38,"[26]EulesHnKqGocIHcJCJCBqziJeD",240,0.995851,26,241,1,240,1,1,0,1,1,106,106,135,134,25
"2440",39,"[26]EulesHnKqGocIHcJCJCBqziJeD",222,0.995516,26,223,1,222,1,1,0,1,1,121,121,102,101,25
"2441",40,"[26]EulesHnKqGocIHcJCJCBqziJeD",233,0.995726,26,234,1,233,1,1,0,1,1,112,112,122,121,25
"2442",41,"[26]EulesHnKqGocIHcJCJCBqziJeD",232,0.995708,26,233,1,232,1,1,0,1,1,112,112,121,120,25
"2443",42,"[26]EulesHnKqGocIHcJCJCBqziJeD",243,0.995902,26,244,1,243,1,1,0,1,1,107,107,137,136,25
"2444",43,"[26]EulesHnKqGocIHcJCJCBqziJeD",238,0.995816,26,239,1,238,1,1,0,1,1,107,107,132,131,25
"2445",44,"[26]EulesHnKqGocIHcJCJCBqziJeD",232,0.995708,26,233,1,232,1,1,0,1,1,114,114,119,118,25
"2446",45,"[26]EulesHnKqGocIHcJCJCBqziJeD",234,0.995745,26,235,1,234,1,1,0,1,1,115,115,120,119,25
"2447",46,"[26]EulesHnKqGocIHcJCJCBqziJeD",228,0.995633,26,229,1,228,1,1,0,1,1,115,115,114,113,25
"2448",47,"[26]EulesHnKqGocIHcJCJCBqziJeD",236,0.995781,26,237,1,236,1,1,0,1,1,110,110,127,126,25
"2449",48,"[26]EulesHnKqGocIHcJCJCBqziJeD",242,0.995885,26,243,1,242,1,1,0,1,1,108,108,135,134,25
"2450",49,"[26]EulesHnKqGocIHcJCJCBqziJeD",225,0.995575,26,226,1,225,1,1,0,1,1,121,121,105,104,25
"2451",50,"[26]EulesHnKqGocIHcJCJCBqziJeD",231,0.99569,26,232,1,231,1,1,0,1,1,113,113,119,118,25
"2452",51,"[26]EulesHnKqGocIHcJCJCBqziJeD",231,0.99569,26,232,1,231,1,1,0,1,1,114,114,118,117,25
"2453",52,"[26]EulesHnKqGocIHcJCJCBqziJeD",226,0.995595,26,227,1,226,1,1,0,1,1,118,118,109,108,25
"2454",53,"[26]EulesHnKqGocIHcJCJCBqziJeD",227,0.995614,26,228,1,227,1,1,0,1,1,117,117,111,110,25
"2455",54,"[26]EulesHnKqGocIHcJCJCBqziJeD",228,0.995633,26,229,1,228,1,1,0,1,1,115,115,114,113,25
"2456",55,"[26]EulesHnKqGocIHcJCJCBqziJeD",229,0.995652,26,230,1,229,1,1,0,1,1,115,115,115,114,25
"2457",56,"[26]EulesHnKqGocIHcJCJCBqziJeD",224,0.995556,26,225,1,224,1,1,0,1,1,119,119,106,105,25
"2458",57,"[26]EulesHnKqGocIHcJCJCBqziJeD",232,0.995708,26,233,1,232,1,1,0,1,1,113,113,120,119,25
"2459",58,"[26]EulesHnKqGocIHcJCJCBqziJeD",235,0.995763,26,236,1,235,1,1,0,1,1,112,112,124,123,25
"2460",59,"[26]EulesHnKqGocIHcJCJCBqziJeD",219,0.995455,26,220,1,219,1,1,0,1,1,123,123,97,96,25
"2461",60,"[26]EulesHnKqGocIHcJCJCBqziJeD",239,0.995833,26,240,1,239,1,1,0,1,1,107,107,133,132,25
"2462",61,"[26]EulesHnKqGocIHcJCJCBqziJeD",229,0.995652,26,230,1,229,1,1,0,1,1,115,115,115,114,25
"2463",62,"[26]EulesHnKqGocIHcJCJCBqziJeD",234,0.995745,26,235,1,234,1,1,0,1,1,111,111,124,123,25
"2464",63,"[26]EulesHnKqGocIHcJCJCBqziJeD",235,0.995763,26,236,1,235,1,1,0,1,1,114,114,122,121,25
"2465",64,"[26]EulesHnKqGocIHcJCJCBqziJeD",239,0.995833,26,240,1,239,1,1,0,1,1,108,108,132,131,25
"2466",65,"[26]EulesHnKqGocIHcJCJCBqziJeD",232,0.995708,26,233,1,232,1,1,0,1,1,112,112,121,120,25
"2467",66,"[26]EulesHnKqGocIHcJCJCBqziJeD",224,0.995556,26,225,1,224,1,1,0,1,1,119,119,106,105,25
"2468",67,"[26]EulesHnKqGocIHcJCJCBqziJeD",229,0.995652,26,230,1,229,1,1,0,1,1,115,115,115,114,25
"2469",68,"[26]EulesHnKqGocIHcJCJCBqziJeD",233,0.995726,26,234,1,233,1,1,0,1,1,111,111,123,122,25
"2470",69,"[26]EulesHnKqGocIHcJCJCBqziJeD",237,0.995798,26,238,1,237,1,1,0,1,1,109,109,129,128,25
"2471",70,"[26]EulesHnKqGocIHcJCJCBqziJeD",225,0.995575,26,226,1,225,1,1,0,1,1,118,118,108,107,25
"2472",71,"[26]EulesHnKqGocIHcJCJCBqziJeD",228,0.995633,26,229,1,228,1,1,0,1,1,115,115,114,113,25
"2473",72,"[26]EulesHnKqGocIHcJCJCBqziJeD",223,0.995536,26,224,1,223,1,1,0,1,1,119,119,105,104,25
"2474",73,"[26]EulesHnKqGocIHcJCJCBqziJeD",232,0.995708,26,233,1,232,1,1,0,1,1,115,115,118,117,25
"2475",74,"[26]EulesHnKqGocIHcJCJCBqziJeD",238,0.995816,26,239,1,238,1,1,0,1,1,108,108,131,130,25
"2476",75,"[26]EulesHnKqGocIHcJCJCBqziJeD",226,0.995595,26,227,1,226,1,1,0,1,1,117,117,110,109,25
"2477",76,"[26]EulesHnKqGocIHcJCJCBqziJeD",221,0.995495,26,222,1,221,1,1,0,1,1,121,121,101,100,25
"2478",77,"[26]EulesHnKqGocIHcJCJCBqziJeD",219,0.995455,26,220,1,219,1,1,0,1,1,125,125,95,94,25
"2479",78,"[26]EulesHnKqGocIHcJCJCBqziJeD",233,0.995726,26,234,1,233,1,1,0,1,1,114,114,120,119,25
"2480",79,"[26]EulesHnKqGocIHcJCJCBqziJeD",225,0.995575,26,226,1,225,1,1,0,1,1,118,118,108,107,25
"2481",80,"[26]EulesHnKqGocIHcJCJCBqziJeD",223,0.995536,26,224,1,223,1,1,0,1,1,120,120,104,103,25
"2482",81,"[26]EulesHnKqGocIHcJCJCBqziJeD",246,0.995951,26,247,1,246,1,1,0,1,1,102,102,145,144,25
"2483",82,"[26]EulesHnKqGocIHcJCJCBqziJeD",241,0.995868,26,242,1,241,1,1,0,1,1,107,107,135,134,25
"2484",83,"[26]EulesHnKqGocIHcJCJCBqziJeD",224,0.995556,26,225,1,224,1,1,0,1,1,120,120,105,104,25
"2485",84,"[26]EulesHnKqGocIHcJCJCBqziJeD",235,0.995763,26,236,1,235,1,1,0,1,1,111,111,125,124,25
"2486",85,"[26]EulesHnKqGocIHcJCJCBqziJeD",226,0.995595,26,227,1,226,1,1,0,1,1,118,118,109,108,25
"2487",86,"[26]EulesHnKqGocIHcJCJCBqziJeD",232,0.995708,26,233,1,232,1,1,0,1,1,115,115,118,117,25
"2488",87,"[26]EulesHnKqGocIHcJCJCBqziJeD",226,0.995595,26,227,1,226,1,1,0,1,1,118,118,109,108,25
"2489",88,"[26]EulesHnKqGocIHcJCJCBqziJeD",239,0.995833,26,240,1,239,1,1,0,1,1,109,109,131,130,25
"2490",89,"[26]EulesHnKqGocIHcJCJCBqziJeD",230,0.995671,26,231,1,230,1,1,0,1,1,115,115,116,115,25
"2491",90,"[26]EulesHnKqGocIHcJCJCBqziJeD",224,0.995556,26,225,1,224,1,1,0,1,1,119,119,106,105,25
"2492",91,"[26]EulesHnKqGocIHcJCJCBqziJeD",241,0.995868,26,242,1,241,1,1,0,1,1,105,105,137,136,25
"2493",92,"[26]EulesHnKqGocIHcJCJCBqziJeD",226,0.995595,26,227,1,226,1,1,0,1,1,117,117,110,109,25
"2494",93,"[26]EulesHnKqGocIHcJCJCBqziJeD",236,0.995781,26,237,1,236,1,1,0,1,1,109,109,128,127,25
"2495",94,"[26]EulesHnKqGocIHcJCJCBqziJeD",215,0.99537,26,216,1,215,1,1,0,1,1,127,127,89,88,25
"2496",95,"[26]EulesHnKqGocIHcJCJCBqziJeD",235,0.995763,26,236,1,235,1,1,0,1,1,111,111,125,124,25
"2497",96,"[26]EulesHnKqGocIHcJCJCBqziJeD",227,0.995614,26,228,1,227,1,1,0,1,1,116,116,112,111,25
"2498",97,"[26]EulesHnKqGocIHcJCJCBqziJeD",231,0.99569,26,232,1,231,1,1,0,1,1,115,115,117,116,25
"2499",98,"[26]EulesHnKqGocIHcJCJCBqziJeD",232,0.995708,26,233,1,232,1,1,0,1,1,114,114,119,118,25
"2500",99,"[26]EulesHnKqGocIHcJCJCBqziJeD",226,0.995595,26,227,1,226,1,1,0,1,1,119,119,108,107,25
"2501",0,"[31]EjmKstHnKqGocIHcJCJzwhveCmdGIxH",231,0.99569,31,232,1,231,1,1,0,1,1,114,114,118,117,26
"2502",1,"[31]EjmKstHnKqGocIHcJCJzwhveCmdGIxH",228,0.995633,31,229,1,228,1,1,0,1,1,117,117,112,111,26
"2503",2,"[31]EjmKstHnKqGocIHcJCJzwhveCmdGIxH",236,0.995781,31,237,1,236,1,1,0,1,1,110,110,127,126,26
"2504",3,"[31]EjmKstHnKqGocIHcJCJzwhveCmdGIxH",239,0.995833,31,240,1,239,1,1,0,1,1,112,112,128,127,26
"2505",4,"[31]EjmKstHnKqGocIHcJCJzwhveCmdGIxH",238,0.995816,31,239,1,238,1,1,0,1,1,109,109,130,129,26
"2506",5,"[31]EjmKstHnKqGocIHcJCJzwhveCmdGIxH",235,0.995763,31,236,1,235,1,1,0,1,1,111,111,125,124,26
"2507",6,"[31]EjmKstHnKqGocIHcJCJzwhveCmdGIxH",238,0.995816,31,239,1,238,1,1,0,1,1,108,108,131,130,26
"2508",7,"[31]EjmKstHnKqGocIHcJCJzwhveCmdGIxH",226,0.995595,31,227,1,226,1,1,0,1,1,118,118,109,108,26
"2509",8,"[31]EjmKstHnKqGocIHcJCJzwhveCmdGIxH",232,0.995708,31,233,1,232,1,1,0,1,1,114,114,119,118,26
"2510",9,"[31]EjmKstHnKqGocIHcJCJzwhveCmdGIxH",227,0.995614,31,228,1,227,1,1,0,1,1,120,120,108,107,26
"2511",10,"[31]EjmKstHnKqGocIHcJCJzwhveCmdGIxH",241,0.995868,31,242,1,241,1,1,0,1,1,106,106,136,135,26
"2512",11,"[31]EjmKstHnKqGocIHcJCJzwhveCmdGIxH",226,0.995595,31,227,1,226,1,1,0,1,1,119,119,108,107,26
"2513",12,"[31]EjmKstHnKqGocIHcJCJzwhveCmdGIxH",225,0.995575,31,226,1,225,1,1,0,1,1,119,119,107,106,26
"2514",13,"[31]EjmKstHnKqGocIHcJCJzwhveCmdGIxH",228,0.995633,31,229,1,228,1,1,0,1,1,116,116,113,112,26
"2515",14,"[31]EjmKstHnKqGocIHcJCJzwhveCmdGIxH",223,0.995536,31,224,1,223,1,1,0,1,1,121,121,103,102,26
"2516",15,"[31]EjmKstHnKqGocIHcJCJzwhveCmdGIxH",233,0.995726,31,234,1,233,1,1,0,1,1,112,112,122,121,26
"2517",16,"[31]EjmKstHnKqGocIHcJCJzwhveCmdGIxH",222,0.995516,31,223,1,222,1,1,0,1,1,122,122,101,100,26
"2518",17,"[31]EjmKstHnKqGocIHcJCJzwhveCmdGIxH",226,0.995595,31,227,1,226,1,1,0,1,1,118,118,109,108,26
"2519",18,"[31]EjmKstHnKqGocIHcJCJzwhveCmdGIxH",231,0.99569,31,232,1,231,1,1,0,1,1,114,114,118,117,26
"2520",19,"[31]EjmKstHnKqGocIHcJCJzwhveCmdGIxH",237,0.995798,31,238,1,237,1,1,0,1,1,113,113,125,124,26
"2521",20,"[31]EjmKstHnKqGocIHcJCJzwhveCmdGIxH",225,0.995575,31,226,1,225,1,1,0,1,1,119,119,107,106,26
"2522",21,"[31]EjmKstHnKqGocIHcJCJzwhveCmdGIxH",232,0.995708,31,233,1,232,1,1,0,1,1,114,114,119,118,26
"2523",22,"[31]EjmKstHnKqGocIHcJCJzwhveCmdGIxH",227,0.995614,31,228,1,227,1,1,0,1,1,118,118,110,109,26
"2524",23,"[31]EjmKstHnKqGocIHcJCJzwhveCmdGIxH",245,0.995935,31,246,1,245,1,1,0,1,1,104,104,142,141,26
"2525",24,"[31]EjmKstHnKqGocIHcJCJzwhveCmdGIxH",224,0.995556,31,225,1,224,1,1,0,1,1,120,120,105,104,26
"2526",25,"[31]EjmKstHnKqGocIHcJCJzwhveCmdGIxH",232,0.995708,31,233,1,232,1,1,0,1,1,114,114,119,118,26
"2527",26,"[31]EjmKstHnKqGocIHcJCJzwhveCmdGIxH",245,0.995935,31,246,1,245,1,1,0,1,1,104,104,142,141,26
"2528",27,"[31]EjmKstHnKqGocIHcJCJzwhveCmdGIxH",221,0.995495,31,222,1,221,1,1,0,1,1,123,123,99,98,26
"2529",28,"[31]EjmKstHnKqGocIHcJCJzwhveCmdGIxH",224,0.995556,31,225,1,224,1,1,0,1,1,119,119,106,105,26
"2530",29,"[31]EjmKstHnKqGocIHcJCJzwhveCmdGIxH",224,0.995556,31,225,1,224,1,1,0,1,1,120,120,105,104,26
"2531",30,"[31]EjmKstHnKqGocIHcJCJzwhveCmdGIxH",227,0.995614,31,228,1,227,1,1,0,1,1,118,118,110,109,26
"2532",31,"[31]EjmKstHnKqGocIHcJCJzwhveCmdGIxH",241,0.995868,31,242,1,241,1,1,0,1,1,106,106,136,135,26
"2533",32,"[31]EjmKstHnKqGocIHcJCJzwhveCmdGIxH",223,0.995536,31,224,1,223,1,1,0,1,1,121,121,103,102,26
"2534",33,"[31]EjmKstHnKqGocIHcJCJzwhveCmdGIxH",224,0.995556,31,225,1,224,1,1,0,1,1,120,120,105,104,26
"2535",34,"[31]EjmKstHnKqGocIHcJCJzwhveCmdGIxH",237,0.995798,31,238,1,237,1,1,0,1,1,112,112,126,125,26
"2536",35,"[31]EjmKstHnKqGocIHcJCJzwhveCmdGIxH",223,0.995536,31,224,1,223,1,1,0,1,1,125,125,99,98,26
"2537",36,"[31]EjmKstHnKqGocIHcJCJzwhveCmdGIxH",225,0.995575,31,226,1,225,1,1,0,1,1,118,118,108,107,26
"2538",37,"[31]EjmKstHnKqGocIHcJCJzwhveCmdGIxH",221,0.995495,31,222,1,221,1,1,0,1,1,122,122,100,99,26
"2539",38,"[31]EjmKstHnKqGocIHcJCJzwhveCmdGIxH",226,0.995595,31,227,1,226,1,1,0,1,1,118,118,109,108,26
"2540",39,"[31]EjmKstHnKqGocIHcJCJzwhveCmdGIxH",224,0.995556,31,225,1,224,1,1,0,1,1,119,119,106,105,26
"2541",40,"[31]EjmKstHnKqGocIHcJCJzwhveCmdGIxH",237,0.995798,31,238,1,237,1,1,0,1,1,113,113,125,124,26
"2542",41,"[31]EjmKstHnKqGocIHcJCJzwhveCmdGIxH",231,0.99569,31,232,1,231,1,1,0,1,1,114,114,118,117,26
"2543",42,"[31]EjmKstHnKqGocIHcJCJzwhveCmdGIxH",232,0.995708,31,233,1,232,1,1,0,1,1,114,114,119,118,26
"2544",43,"[31]EjmKstHnKqGocIHcJCJzwhveCmdGIxH",226,0.995595,31,227,1,226,1,1,0,1,1,119,119,108,107,26
"2545",44,"[31]EjmKstHnKqGocIHcJCJzwhveCmdGIxH",239,0.995833,31,240,1,239,1,1,0,1,1,109,109,131,130,26
"2546",45,"[31]EjmKstHnKqGocIHcJCJzwhveCmdGIxH",229,0.995652,31,230,1,229,1,1,0,1,1,116,116,114,113,26
"2547",46,"[31]EjmKstHnKqGocIHcJCJzwhveCmdGIxH",234,0.995745,31,235,1,234,1,1,0,1,1,114,114,121,120,26
"2548",47,"[31]EjmKstHnKqGocIHcJCJzwhveCmdGIxH",242,0.995885,31,243,1,242,1,1,0,1,1,107,107,136,135,26
"2549",48,"[31]EjmKstHnKqGocIHcJCJzwhveCmdGIxH",242,0.995885,31,243,1,242,1,1,0,1,1,107,107,136,135,26
"2550",49,"[31]EjmKstHnKqGocIHcJCJzwhveCmdGIxH",233,0.995726,31,234,1,233,1,1,0,1,1,114,114,120,119,26
"2551",50,"[31]EjmKstHnKqGocIHcJCJzwhveCmdGIxH",240,0.995851,31,241,1,240,1,1,0,1,1,108,108,133,132,26
"2552",51,"[31]EjmKstHnKqGocIHcJCJzwhveCmdGIxH",229,0.995652,31,230,1,229,1,1,0,1,1,115,115,115,114,26
"2553",52,"[31]EjmKstHnKqGocIHcJCJzwhveCmdGIxH",225,0.995575,31,226,1,225,1,1,0,1,1,120,120,106,105,26
"2554",53,"[31]EjmKstHnKqGocIHcJCJzwhveCmdGIxH",232,0.995708,31,233,1,232,1,1,0,1,1,113,113,120,119,26
"2555",54,"[31]EjmKstHnKqGocIHcJCJzwhveCmdGIxH",237,0.995798,31,238,1,237,1,1,0,1,1,111,111,127,126,26
"2556",55,"[31]EjmKstHnKqGocIHcJCJzwhveCmdGIxH",238,0.995816,31,239,1,238,1,1,0,1,1,109,109,130,129,26
"2557",56,"[31]EjmKstHnKqGocIHcJCJzwhveCmdGIxH",230,0.995671,31,231,1,230,1,1,0,1,1,117,117,114,113,26
"2558",57,"[31]EjmKstHnKqGocIHcJCJzwhveCmdGIxH",230,0.995671,31,231,1,230,1,1,0,1,1,114,114,117,116,26
"2559",58,"[31]EjmKstHnKqGocIHcJCJzwhveCmdGIxH",236,0.995781,31,237,1,236,1,1,0,1,1,111,111,126,125,26
"2560",59,"[31]EjmKstHnKqGocIHcJCJzwhveCmdGIxH",233,0.995726,31,234,1,233,1,1,0,1,1,112,112,122,121,26
"2561",60,"[31]EjmKstHnKqGocIHcJCJzwhveCmdGIxH",226,0.995595,31,227,1,226,1,1,0,1,1,118,118,109,108,26
"2562",61,"[31]EjmKstHnKqGocIHcJCJzwhveCmdGIxH",235,0.995763,31,236,1,235,1,1,0,1,1,111,111,125,124,26
"2563",62,"[31]EjmKstHnKqGocIHcJCJzwhveCmdGIxH",221,0.995495,31,222,1,221,1,1,0,1,1,122,122,100,99,26
"2564",63,"[31]EjmKstHnKqGocIHcJCJzwhveCmdGIxH",238,0.995816,31,239,1,238,1,1,0,1,1,108,108,131,130,26
"2565",64,"[31]EjmKstHnKqGocIHcJCJzwhveCmdGIxH",229,0.995652,31,230,1,229,1,1,0,1,1,116,116,114,113,26
"2566",65,"[31]EjmKstHnKqGocIHcJCJzwhveCmdGIxH",236,0.995781,31,237,1,236,1,1,0,1,1,111,111,126,125,26
"2567",66,"[31]EjmKstHnKqGocIHcJCJzwhveCmdGIxH",235,0.995763,31,236,1,235,1,1,0,1,1,114,114,122,121,26
"2568",67,"[31]EjmKstHnKqGocIHcJCJzwhveCmdGIxH",223,0.995536,31,224,1,223,1,1,0,1,1,120,120,104,103,26
"2569",68,"[31]EjmKstHnKqGocIHcJCJzwhveCmdGIxH",245,0.995935,31,246,1,245,1,1,0,1,1,102,102,144,143,26
"2570",69,"[31]EjmKstHnKqGocIHcJCJzwhveCmdGIxH",236,0.995781,31,237,1,236,1,1,0,1,1,110,110,127,126,26
"2571",70,"[31]EjmKstHnKqGocIHcJCJzwhveCmdGIxH",244,0.995918,31,245,1,244,1,1,0,1,1,105,105,140,139,26
"2572",71,"[31]EjmKstHnKqGocIHcJCJzwhveCmdGIxH",230,0.995671,31,231,1,230,1,1,0,1,1,114,114,117,116,26
"2573",72,"[31]EjmKstHnKqGocIHcJCJzwhveCmdGIxH",233,0.995726,31,234,1,233,1,1,0,1,1,114,114,120,119,26
"2574",73,"[31]EjmKstHnKqGocIHcJCJzwhveCmdGIxH",235,0.995763,31,236,1,235,1,1,0,1,1,111,111,125,124,26
"2575",74,"[31]EjmKstHnKqGocIHcJCJzwhveCmdGIxH",238,0.995816,31,239,1,238,1,1,0,1,1,111,111,128,127,26
"2576",75,"[31]EjmKstHnKqGocIHcJCJzwhveCmdGIxH",228,0.995633,31,229,1,228,1,1,0,1,1,117,117,112,111,26
"2577",76,"[31]EjmKstHnKqGocIHcJCJzwhveCmdGIxH",232,0.995708,31,233,1,232,1,1,0,1,1,113,113,120,119,26
"2578",77,"[31]EjmKstHnKqGocIHcJCJzwhveCmdGIxH",226,0.995595,31,227,1,226,1,1,0,1,1,119,119,108,107,26
"2579",78,"[31]EjmKstHnKqGocIHcJCJzwhveCmdGIxH",232,0.995708,31,233,1,232,1,1,0,1,1,113,113,120,119,26
"2580",79,"[31]EjmKstHnKqGocIHcJCJzwhveCmdGIxH",240,0.995851,31,241,1,240,1,1,0,1,1,106,106,135,134,26
"2581",80,"[31]EjmKstHnKqGocIHcJCJzwhveCmdGIxH",233,0.995726,31,234,1,233,1,1,0,1,1,117,117,117,116,26
"2582",81,"[31]EjmKstHnKqGocIHcJCJzwhveCmdGIxH",232,0.995708,31,233,1,232,1,1,0,1,1,115,115,118,117,26
"2583",82,"[31]EjmKstHnKqGocIHcJCJzwhveCmdGIxH",240,0.995851,31,241,1,240,1,1,0,1,1,107,107,134,133,26
"2584",83,"[31]EjmKstHnKqGocIHcJCJzwhveCmdGIxH",223,0.995536,31,224,1,223,1,1,0,1,1,121,121,103,102,26
"2585",84,"[31]EjmKstHnKqGocIHcJCJzwhveCmdGIxH",229,0.995652,31,230,1,229,1,1,0,1,1,117,117,113,112,26
"2586",85,"[31]EjmKstHnKqGocIHcJCJzwhveCmdGIxH",236,0.995781,31,237,1,236,1,1,0,1,1,112,112,125,124,26
"2587",86,"[31]EjmKstHnKqGocIHcJCJzwhveCmdGIxH",223,0.995536,31,224,1,223,1,1,0,1,1,120,120,104,103,26
"2588",87,"[31]EjmKstHnKqGocIHcJCJzwhveCmdGIxH",229,0.995652,31,230,1,229,1,1,0,1,1,116,116,114,113,26
"2589",88,"[31]EjmKstHnKqGocIHcJCJzwhveCmdGIxH",234,0.995745,31,235,1,234,1,1,0,1,1,113,113,122,121,26
"2590",89,"[31]EjmKstHnKqGocIHcJCJzwhveCmdGIxH",236,0.995781,31,237,1,236,1,1,0,1,1,111,111,126,125,26
"2591",90,"[31]EjmKstHnKqGocIHcJCJzwhveCmdGIxH",229,0.995652,31,230,1,229,1,1,0,1,1,115,115,115,114,26
"2592",91,"[31]EjmKstHnKqGocIHcJCJzwhveCmdGIxH",223,0.995536,31,224,1,223,1,1,0,1,1,120,120,104,103,26
"2593",92,"[31]EjmKstHnKqGocIHcJCJzwhveCmdGIxH",235,0.995763,31,236,1,235,1,1,0,1,1,110,110,126,125,26
"2594",93,"[31]EjmKstHnKqGocIHcJCJzwhveCmdGIxH",229,0.995652,31,230,1,229,1,1,0,1,1,115,115,115,114,26
"2595",94,"[31]EjmKstHnKqGocIHcJCJzwhveCmdGIxH",230,0.995671,31,231,1,230,1,1,0,1,1,114,114,117,116,26
"2596",95,"[31]EjmKstHnKqGocIHcJCJzwhveCmdGIxH",240,0.995851,31,241,1,240,1,1,0,1,1,109,109,132,131,26
"2597",96,"[31]EjmKstHnKqGocIHcJCJzwhveCmdGIxH",237,0.995798,31,238,1,237,1,1,0,1,1,111,111,127,126,26
"2598",97,"[31]EjmKstHnKqGocIHcJCJzwhveCmdGIxH",226,0.995595,31,227,1,226,1,1,0,1,1,119,119,108,107,26
"2599",98,"[31]EjmKstHnKqGocIHcJCJzwhveCmdGIxH",235,0.995763,31,236,1,235,1,1,0,1,1,111,111,125,124,26
"2600",99,"[31]EjmKstHnKqGocIHcJCJzwhveCmdGIxH",228,0.995633,31,229,1,228,1,1,0,1,1,118,118,111,110,26
"2601",0,"[26]EnsHnKqGocIHBJCBAbywscEDgn",232,0.995708,26,233,1,232,1,1,0,1,1,113,113,120,119,27
"2602",1,"[26]EnsHnKqGocIHBJCBAbywscEDgn",223,0.995536,26,224,1,223,1,1,0,1,1,120,120,104,103,27
"2603",2,"[26]EnsHnKqGocIHBJCBAbywscEDgn",233,0.995726,26,234,1,233,1,1,0,1,1,113,113,121,120,27
"2604",3,"[26]EnsHnKqGocIHBJCBAbywscEDgn",232,0.995708,26,233,1,232,1,1,0,1,1,115,115,118,117,27
"2605",4,"[26]EnsHnKqGocIHBJCBAbywscEDgn",228,0.995633,26,229,1,228,1,1,0,1,1,118,118,111,110,27
"2606",5,"[26]EnsHnKqGocIHBJCBAbywscEDgn",225,0.995575,26,226,1,225,1,1,0,1,1,121,121,105,104,27
"2607",6,"[26]EnsHnKqGocIHBJCBAbywscEDgn",231,0.99569,26,232,1,231,1,1,0,1,1,113,113,119,118,27
"2608",7,"[26]EnsHnKqGocIHBJCBAbywscEDgn",223,0.995536,26,224,1,223,1,1,0,1,1,120,120,104,103,27
"2609",8,"[26]EnsHnKqGocIHBJCBAbywscEDgn",226,0.995595,26,227,1,226,1,1,0,1,1,118,118,109,108,27
"2610",9,"[26]EnsHnKqGocIHBJCBAbywscEDgn",235,0.995763,26,236,1,235,1,1,0,1,1,111,111,125,124,27
"2611",10,"[26]EnsHnKqGocIHBJCBAbywscEDgn",224,0.995556,26,225,1,224,1,1,0,1,1,120,120,105,104,27
"2612",11,"[26]EnsHnKqGocIHBJCBAbywscEDgn",232,0.995708,26,233,1,232,1,1,0,1,1,113,113,120,119,27
"2613",12,"[26]EnsHnKqGocIHBJCBAbywscEDgn",227,0.995614,26,228,1,227,1,1,0,1,1,117,117,111,110,27
"2614",13,"[26]EnsHnKqGocIHBJCBAbywscEDgn",223,0.995536,26,224,1,223,1,1,0,1,1,121,121,103,102,27
"2615",14,"[26]EnsHnKqGocIHBJCBAbywscEDgn",231,0.99569,26,232,1,231,1,1,0,1,1,114,114,118,117,27
"2616",15,"[26]EnsHnKqGocIHBJCBAbywscEDgn",228,0.995633,26,229,1,228,1,1,0,1,1,116,116,113,112,27
"2617",16,"[26]EnsHnKqGocIHBJCBAbywscEDgn",241,0.995868,26,242,1,241,1,1,0,1,1,105,105,137,136,27
"2618",17,"[26]EnsHnKqGocIHBJCBAbywscEDgn",235,0.995763,26,236,1,235,1,1,0,1,1,113,113,123,122,27
"2619",18,"[26]EnsHnKqGocIHBJCBAbywscEDgn",227,0.995614,26,228,1,227,1,1,0,1,1,117,117,111,110,27
"2620",19,"[26]EnsHnKqGocIHBJCBAbywscEDgn",225,0.995575,26,226,1,225,1,1,0,1,1,118,118,108,107,27
"2621",20,"[26]EnsHnKqGocIHBJCBAbywscEDgn",231,0.99569,26,232,1,231,1,1,0,1,1,113,113,119,118,27
"2622",21,"[26]EnsHnKqGocIHBJCBAbywscEDgn",233,0.995726,26,234,1,233,1,1,0,1,1,113,113,121,120,27
"2623",22,"[26]EnsHnKqGocIHBJCBAbywscEDgn",230,0.995671,26,231,1,230,1,1,0,1,1,114,114,117,116,27
"2624",23,"[26]EnsHnKqGocIHBJCBAbywscEDgn",233,0.995726,26,234,1,233,1,1,0,1,1,112,112,122,121,27
"2625",24,"[26]EnsHnKqGocIHBJCBAbywscEDgn",233,0.995726,26,234,1,233,1,1,0,1,1,112,112,122,121,27
"2626",25,"[26]EnsHnKqGocIHBJCBAbywscEDgn",226,0.995595,26,227,1,226,1,1,0,1,1,118,118,109,108,27
"2627",26,"[26]EnsHnKqGocIHBJCBAbywscEDgn",220,0.995475,26,221,1,220,1,1,0,1,1,122,122,99,98,27
"2628",27,"[26]EnsHnKqGocIHBJCBAbywscEDgn",230,0.995671,26,231,1,230,1,1,0,1,1,115,115,116,115,27
"2629",28,"[26]EnsHnKqGocIHBJCBAbywscEDgn",226,0.995595,26,227,1,226,1,1,0,1,1,121,121,106,105,27
"2630",29,"[26]EnsHnKqGocIHBJCBAbywscEDgn",233,0.995726,26,234,1,233,1,1,0,1,1,113,113,121,120,27
"2631",30,"[26]EnsHnKqGocIHBJCBAbywscEDgn",228,0.995633,26,229,1,228,1,1,0,1,1,116,116,113,112,27
"2632",31,"[26]EnsHnKqGocIHBJCBAbywscEDgn",228,0.995633,26,229,1,228,1,1,0,1,1,117,117,112,111,27
"2633",32,"[26]EnsHnKqGocIHBJCBAbywscEDgn",229,0.995652,26,230,1,229,1,1,0,1,1,115,115,115,114,27
"2634",33,"[26]EnsHnKqGocIHBJCBAbywscEDgn",226,0.995595,26,227,1,226,1,1,0,1,1,117,117,110,109,27
"2635",34,"[26]EnsHnKqGocIHBJCBAbywscEDgn",235,0.995763,26,236,1,235,1,1,0,1,1,111,111,125,124,27
"2636",35,"[26]EnsHnKqGocIHBJCBAbywscEDgn",235,0.995763,26,236,1,235,1,1,0,1,1,111,111,125,124,27
"2637",36,"[26]EnsHnKqGocIHBJCBAbywscEDgn",222,0.995516,26,223,1,222,1,1,0,1,1,122,122,101,100,27
"2638",37,"[26]EnsHnKqGocIHBJCBAbywscEDgn",231,0.99569,26,232,1,231,1,1,0,1,1,115,115,117,116,27
"2639",38,"[26]EnsHnKqGocIHBJCBAbywscEDgn",223,0.995536,26,224,1,223,1,1,0,1,1,121,121,103,102,27
"2640",39,"[26]EnsHnKqGocIHBJCBAbywscEDgn",223,0.995536,26,224,1,223,1,1,0,1,1,120,120,104,103,27
"2641",40,"[26]EnsHnKqGocIHBJCBAbywscEDgn",232,0.995708,26,233,1,232,1,1,0,1,1,113,113,120,119,27
"2642",41,"[26]EnsHnKqGocIHBJCBAbywscEDgn",233,0.995726,26,234,1,233,1,1,0,1,1,113,113,121,120,27
"2643",42,"[26]EnsHnKqGocIHBJCBAbywscEDgn",223,0.995536,26,224,1,223,1,1,0,1,1,120,120,104,103,27
"2644",43,"[26]EnsHnKqGocIHBJCBAbywscEDgn",233,0.995726,26,234,1,233,1,1,0,1,1,112,112,122,121,27
"2645",44,"[26]EnsHnKqGocIHBJCBAbywscEDgn",225,0.995575,26,226,1,225,1,1,0,1,1,118,118,108,107,27
"2646",45,"[26]EnsHnKqGocIHBJCBAbywscEDgn",223,0.995536,26,224,1,223,1,1,0,1,1,120,120,104,103,27
"2647",46,"[26]EnsHnKqGocIHBJCBAbywscEDgn",222,0.995516,26,223,1,222,1,1,0,1,1,121,121,102,101,27
"2648",47,"[26]EnsHnKqGocIHBJCBAbywscEDgn",232,0.995708,26,233,1,232,1,1,0,1,1,113,113,120,119,27
"2649",48,"[26]EnsHnKqGocIHBJCBAbywscEDgn",241,0.995868,26,242,1,241,1,1,0,1,1,108,108,134,133,27
"2650",49,"[26]EnsHnKqGocIHBJCBAbywscEDgn",230,0.995671,26,231,1,230,1,1,0,1,1,115,115,116,115,27
"2651",50,"[26]EnsHnKqGocIHBJCBAbywscEDgn",220,0.995475,26,221,1,220,1,1,0,1,1,124,124,97,96,27
"2652",51,"[26]EnsHnKqGocIHBJCBAbywscEDgn",229,0.995652,26,230,1,229,1,1,0,1,1,116,116,114,113,27
"2653",52,"[26]EnsHnKqGocIHBJCBAbywscEDgn",226,0.995595,26,227,1,226,1,1,0,1,1,117,117,110,109,27
"2654",53,"[26]EnsHnKqGocIHBJCBAbywscEDgn",224,0.995556,26,225,1,224,1,1,0,1,1,120,120,105,104,27
"2655",54,"[26]EnsHnKqGocIHBJCBAbywscEDgn",235,0.995763,26,236,1,235,1,1,0,1,1,111,111,125,124,27
"2656",55,"[26]EnsHnKqGocIHBJCBAbywscEDgn",227,0.995614,26,228,1,227,1,1,0,1,1,119,119,109,108,27
"2657",56,"[26]EnsHnKqGocIHBJCBAbywscEDgn",236,0.995781,26,237,1,236,1,1,0,1,1,110,110,127,126,27
"2658",57,"[26]EnsHnKqGocIHBJCBAbywscEDgn",219,0.995455,26,220,1,219,1,1,0,1,1,125,125,95,94,27
"2659",58,"[26]EnsHnKqGocIHBJCBAbywscEDgn",223,0.995536,26,224,1,223,1,1,0,1,1,120,120,104,103,27
"2660",59,"[26]EnsHnKqGocIHBJCBAbywscEDgn",228,0.995633,26,229,1,228,1,1,0,1,1,119,119,110,109,27
"2661",60,"[26]EnsHnKqGocIHBJCBAbywscEDgn",227,0.995614,26,228,1,227,1,1,0,1,1,117,117,111,110,27
"2662",61,"[26]EnsHnKqGocIHBJCBAbywscEDgn",233,0.995726,26,234,1,233,1,1,0,1,1,112,112,122,121,27
"2663",62,"[26]EnsHnKqGocIHBJCBAbywscEDgn",229,0.995652,26,230,1,229,1,1,0,1,1,115,115,115,114,27
"2664",63,"[26]EnsHnKqGocIHBJCBAbywscEDgn",230,0.995671,26,231,1,230,1,1,0,1,1,115,115,116,115,27
"2665",64,"[26]EnsHnKqGocIHBJCBAbywscEDgn",230,0.995671,26,231,1,230,1,1,0,1,1,116,116,115,114,27
"2666",65,"[26]EnsHnKqGocIHBJCBAbywscEDgn",227,0.995614,26,228,1,227,1,1,0,1,1,117,117,111,110,27
"2667",66,"[26]EnsHnKqGocIHBJCBAbywscEDgn",232,0.995708,26,233,1,232,1,1,0,1,1,114,114,119,118,27
"2668",67,"[26]EnsHnKqGocIHBJCBAbywscEDgn",226,0.995595,26,227,1,226,1,1,0,1,1,118,118,109,108,27
"2669",68,"[26]EnsHnKqGocIHBJCBAbywscEDgn",224,0.995556,26,225,1,224,1,1,0,1,1,119,119,106,105,27
"2670",69,"[26]EnsHnKqGocIHBJCBAbywscEDgn",223,0.995536,26,224,1,223,1,1,0,1,1,120,120,104,103,27
"2671",70,"[26]EnsHnKqGocIHBJCBAbywscEDgn",227,0.995614,26,228,1,227,1,1,0,1,1,117,117,111,110,27
"2672",71,"[26]EnsHnKqGocIHBJCBAbywscEDgn",234,0.995745,26,235,1,234,1,1,0,1,1,112,112,123,122,27
"2673",72,"[26]EnsHnKqGocIHBJCBAbywscEDgn",225,0.995575,26,226,1,225,1,1,0,1,1,120,120,106,105,27
"2674",73,"[26]EnsHnKqGocIHBJCBAbywscEDgn",230,0.995671,26,231,1,230,1,1,0,1,1,115,115,116,115,27
"2675",74,"[26]EnsHnKqGocIHBJCBAbywscEDgn",233,0.995726,26,234,1,233,1,1,0,1,1,113,113,121,120,27
"2676",75,"[26]EnsHnKqGocIHBJCBAbywscEDgn",232,0.995708,26,233,1,232,1,1,0,1,1,113,113,120,119,27
"2677",76,"[26]EnsHnKqGocIHBJCBAbywscEDgn",244,0.995918,26,245,1,244,1,1,0,1,1,108,108,137,136,27
"2678",77,"[26]EnsHnKqGocIHBJCBAbywscEDgn",240,0.995851,26,241,1,240,1,1,0,1,1,108,108,133,132,27
"2679",78,"[26]EnsHnKqGocIHBJCBAbywscEDgn",231,0.99569,26,232,1,231,1,1,0,1,1,113,113,119,118,27
"2680",79,"[26]EnsHnKqGocIHBJCBAbywscEDgn",231,0.99569,26,232,1,231,1,1,0,1,1,113,113,119,118,27
"2681",80,"[26]EnsHnKqGocIHBJCBAbywscEDgn",228,0.995633,26,229,1,228,1,1,0,1,1,116,116,113,112,27
"2682",81,"[26]EnsHnKqGocIHBJCBAbywscEDgn",228,0.995633,26,229,1,228,1,1,0,1,1,117,117,112,111,27
"2683",82,"[26]EnsHnKqGocIHBJCBAbywscEDgn",236,0.995781,26,237,1,236,1,1,0,1,1,113,113,124,123,27
"2684",83,"[26]EnsHnKqGocIHBJCBAbywscEDgn",230,0.995671,26,231,1,230,1,1,0,1,1,115,115,116,115,27
"2685",84,"[26]EnsHnKqGocIHBJCBAbywscEDgn",220,0.995475,26,221,1,220,1,1,0,1,1,122,122,99,98,27
"2686",85,"[26]EnsHnKqGocIHBJCBAbywscEDgn",238,0.995816,26,239,1,238,1,1,0,1,1,109,109,130,129,27
"2687",86,"[26]EnsHnKqGocIHBJCBAbywscEDgn",237,0.995798,26,238,1,237,1,1,0,1,1,110,110,128,127,27
"2688",87,"[26]EnsHnKqGocIHBJCBAbywscEDgn",222,0.995516,26,223,1,222,1,1,0,1,1,121,121,102,101,27
"2689",88,"[26]EnsHnKqGocIHBJCBAbywscEDgn",232,0.995708,26,233,1,232,1,1,0,1,1,115,115,118,117,27
"2690",89,"[26]EnsHnKqGocIHBJCBAbywscEDgn",230,0.995671,26,231,1,230,1,1,0,1,1,116,116,115,114,27
"2691",90,"[26]EnsHnKqGocIHBJCBAbywscEDgn",231,0.99569,26,232,1,231,1,1,0,1,1,114,114,118,117,27
"2692",91,"[26]EnsHnKqGocIHBJCBAbywscEDgn",235,0.995763,26,236,1,235,1,1,0,1,1,112,112,124,123,27
"2693",92,"[26]EnsHnKqGocIHBJCBAbywscEDgn",234,0.995745,26,235,1,234,1,1,0,1,1,116,116,119,118,27
"2694",93,"[26]EnsHnKqGocIHBJCBAbywscEDgn",228,0.995633,26,229,1,228,1,1,0,1,1,116,116,113,112,27
"2695",94,"[26]EnsHnKqGocIHBJCBAbywscEDgn",232,0.995708,26,233,1,232,1,1,0,1,1,114,114,119,118,27
"2696",95,"[26]EnsHnKqGocIHBJCBAbywscEDgn",224,0.995556,26,225,1,224,1,1,0,1,1,119,119,106,105,27
"2697",96,"[26]EnsHnKqGocIHBJCBAbywscEDgn",228,0.995633,26,229,1,228,1,1,0,1,1,116,116,113,112,27
"2698",97,"[26]EnsHnKqGocIHBJCBAbywscEDgn",228,0.995633,26,229,1,228,1,1,0,1,1,118,118,111,110,27
"2699",98,"[26]EnsHnKqGocIHBJCBAbywscEDgn",232,0.995708,26,233,1,232,1,1,0,1,1,115,115,118,117,27
"2700",99,"[26]EnsHnKqGocIHBJCBAbywscEDgn",230,0.995671,26,231,1,230,1,1,0,1,1,116,116,115,114,27
"2701",0,"[28]EwvHnKqGocIHBJCFAmdtxttHIecz",238,0.995816,28,239,1,238,1,1,0,1,1,109,109,130,129,28
"2702",1,"[28]EwvHnKqGocIHBJCFAmdtxttHIecz",232,0.995708,28,233,1,232,1,1,0,1,1,115,115,118,117,28
"2703",2,"[28]EwvHnKqGocIHBJCFAmdtxttHIecz",231,0.99569,28,232,1,231,1,1,0,1,1,116,116,116,115,28
"2704",3,"[28]EwvHnKqGocIHBJCFAmdtxttHIecz",238,0.995816,28,239,1,238,1,1,0,1,1,111,111,128,127,28
"2705",4,"[28]EwvHnKqGocIHBJCFAmdtxttHIecz",223,0.995536,28,224,1,223,1,1,0,1,1,120,120,104,103,28
"2706",5,"[28]EwvHnKqGocIHBJCFAmdtxttHIecz",230,0.995671,28,231,1,230,1,1,0,1,1,115,115,116,115,28
"2707",6,"[28]EwvHnKqGocIHBJCFAmdtxttHIecz",250,0.996016,28,251,1,250,1,1,0,1,1,99,99,152,151,28
"2708",7,"[28]EwvHnKqGocIHBJCFAmdtxttHIecz",234,0.995745,28,235,1,234,1,1,0,1,1,112,112,123,122,28
"2709",8,"[28]EwvHnKqGocIHBJCFAmdtxttHIecz",225,0.995575,28,226,1,225,1,1,0,1,1,119,119,107,106,28
"2710",9,"[28]EwvHnKqGocIHBJCFAmdtxttHIecz",232,0.995708,28,233,1,232,1,1,0,1,1,113,113,120,119,28
"2711",10,"[28]EwvHnKqGocIHBJCFAmdtxttHIecz",244,0.995918,28,245,1,244,1,1,0,1,1,105,105,140,139,28
"2712",11,"[28]EwvHnKqGocIHBJCFAmdtxttHIecz",229,0.995652,28,230,1,229,1,1,0,1,1,116,116,114,113,28
"2713",12,"[28]EwvHnKqGocIHBJCFAmdtxttHIecz",245,0.995935,28,246,1,245,1,1,0,1,1,103,103,143,142,28
"2714",13,"[28]EwvHnKqGocIHBJCFAmdtxttHIecz",231,0.99569,28,232,1,231,1,1,0,1,1,114,114,118,117,28
"2715",14,"[28]EwvHnKqGocIHBJCFAmdtxttHIecz",233,0.995726,28,234,1,233,1,1,0,1,1,114,114,120,119,28
"2716",15,"[28]EwvHnKqGocIHBJCFAmdtxttHIecz",223,0.995536,28,224,1,223,1,1,0,1,1,121,121,103,102,28
"2717",16,"[28]EwvHnKqGocIHBJCFAmdtxttHIecz",231,0.99569,28,232,1,231,1,1,0,1,1,113,113,119,118,28
"2718",17,"[28]EwvHnKqGocIHBJCFAmdtxttHIecz",229,0.995652,28,230,1,229,1,1,0,1,1,115,115,115,114,28
"2719",18,"[28]EwvHnKqGocIHBJCFAmdtxttHIecz",233,0.995726,28,234,1,233,1,1,0,1,1,112,112,122,121,28
"2720",19,"[28]EwvHnKqGocIHBJCFAmdtxttHIecz",225,0.995575,28,226,1,225,1,1,0,1,1,118,118,108,107,28
"2721",20,"[28]EwvHnKqGocIHBJCFAmdtxttHIecz",232,0.995708,28,233,1,232,1,1,0,1,1,113,113,120,119,28
"2722",21,"[28]EwvHnKqGocIHBJCFAmdtxttHIecz",214,0.995349,28,215,1,214,1,1,0,1,1,127,127,88,87,28
"2723",22,"[28]EwvHnKqGocIHBJCFAmdtxttHIecz",214,0.995349,28,215,1,214,1,1,0,1,1,128,128,87,86,28
"2724",23,"[28]EwvHnKqGocIHBJCFAmdtxttHIecz",231,0.99569,28,232,1,231,1,1,0,1,1,113,113,119,118,28
"2725",24,"[28]EwvHnKqGocIHBJCFAmdtxttHIecz",227,0.995614,28,228,1,227,1,1,0,1,1,118,118,110,109,28
"2726",25,"[28]EwvHnKqGocIHBJCFAmdtxttHIecz",241,0.995868,28,242,1,241,1,1,0,1,1,107,107,135,134,28
"2727",26,"[28]EwvHnKqGocIHBJCFAmdtxttHIecz",230,0.995671,28,231,1,230,1,1,0,1,1,115,115,116,115,28
"2728",27,"[28]EwvHnKqGocIHBJCFAmdtxttHIecz",230,0.995671,28,231,1,230,1,1,0,1,1,115,115,116,115,28
"2729",28,"[28]EwvHnKqGocIHBJCFAmdtxttHIecz",233,0.995726,28,234,1,233,1,1,0,1,1,113,113,121,120,28
"2730",29,"[28]EwvHnKqGocIHBJCFAmdtxttHIecz",226,0.995595,28,227,1,226,1,1,0,1,1,119,119,108,107,28
"2731",30,"[28]EwvHnKqGocIHBJCFAmdtxttHIecz",226,0.995595,28,227,1,226,1,1,0,1,1,117,117,110,109,28
"2732",31,"[28]EwvHnKqGocIHBJCFAmdtxttHIecz",225,0.995575,28,226,1,225,1,1,0,1,1,118,118,108,107,28
"2733",32,"[28]EwvHnKqGocIHBJCFAmdtxttHIecz",229,0.995652,28,230,1,229,1,1,0,1,1,120,120,110,109,28
"2734",33,"[28]EwvHnKqGocIHBJCFAmdtxttHIecz",238,0.995816,28,239,1,238,1,1,0,1,1,109,109,130,129,28
"2735",34,"[28]EwvHnKqGocIHBJCFAmdtxttHIecz",225,0.995575,28,226,1,225,1,1,0,1,1,118,118,108,107,28
"2736",35,"[28]EwvHnKqGocIHBJCFAmdtxttHIecz",228,0.995633,28,229,1,228,1,1,0,1,1,116,116,113,112,28
"2737",36,"[28]EwvHnKqGocIHBJCFAmdtxttHIecz",229,0.995652,28,230,1,229,1,1,0,1,1,115,115,115,114,28
"2738",37,"[28]EwvHnKqGocIHBJCFAmdtxttHIecz",233,0.995726,28,234,1,233,1,1,0,1,1,112,112,122,121,28
"2739",38,"[28]EwvHnKqGocIHBJCFAmdtxttHIecz",225,0.995575,28,226,1,225,1,1,0,1,1,119,119,107,106,28
"2740",39,"[28]EwvHnKqGocIHBJCFAmdtxttHIecz",231,0.99569,28,232,1,231,1,1,0,1,1,118,118,114,113,28
"2741",40,"[28]EwvHnKqGocIHBJCFAmdtxttHIecz",235,0.995763,28,236,1,235,1,1,0,1,1,110,110,126,125,28
"2742",41,"[28]EwvHnKqGocIHBJCFAmdtxttHIecz",231,0.99569,28,232,1,231,1,1,0,1,1,114,114,118,117,28
"2743",42,"[28]EwvHnKqGocIHBJCFAmdtxttHIecz",237,0.995798,28,238,1,237,1,1,0,1,1,109,109,129,128,28
"2744",43,"[28]EwvHnKqGocIHBJCFAmdtxttHIecz",237,0.995798,28,238,1,237,1,1,0,1,1,109,109,129,128,28
"2745",44,"[28]EwvHnKqGocIHBJCFAmdtxttHIecz",219,0.995455,28,220,1,219,1,1,0,1,1,124,124,96,95,28
"2746",45,"[28]EwvHnKqGocIHBJCFAmdtxttHIecz",233,0.995726,28,234,1,233,1,1,0,1,1,114,114,120,119,28
"2747",46,"[28]EwvHnKqGocIHBJCFAmdtxttHIecz",234,0.995745,28,235,1,234,1,1,0,1,1,113,113,122,121,28
"2748",47,"[28]EwvHnKqGocIHBJCFAmdtxttHIecz",235,0.995763,28,236,1,235,1,1,0,1,1,113,113,123,122,28
"2749",48,"[28]EwvHnKqGocIHBJCFAmdtxttHIecz",235,0.995763,28,236,1,235,1,1,0,1,1,112,112,124,123,28
"2750",49,"[28]EwvHnKqGocIHBJCFAmdtxttHIecz",234,0.995745,28,235,1,234,1,1,0,1,1,113,113,122,121,28
"2751",50,"[28]EwvHnKqGocIHBJCFAmdtxttHIecz",230,0.995671,28,231,1,230,1,1,0,1,1,116,116,115,114,28
"2752",51,"[28]EwvHnKqGocIHBJCFAmdtxttHIecz",235,0.995763,28,236,1,235,1,1,0,1,1,111,111,125,124,28
"2753",52,"[28]EwvHnKqGocIHBJCFAmdtxttHIecz",236,0.995781,28,237,1,236,1,1,0,1,1,110,110,127,126,28
"2754",53,"[28]EwvHnKqGocIHBJCFAmdtxttHIecz",230,0.995671,28,231,1,230,1,1,0,1,1,116,116,115,114,28
"2755",54,"[28]EwvHnKqGocIHBJCFAmdtxttHIecz",233,0.995726,28,234,1,233,1,1,0,1,1,112,112,122,121,28
"2756",55,"[28]EwvHnKqGocIHBJCFAmdtxttHIecz",233,0.995726,28,234,1,233,1,1,0,1,1,114,114,120,119,28
"2757",56,"[28]EwvHnKqGocIHBJCFAmdtxttHIecz",232,0.995708,28,233,1,232,1,1,0,1,1,113,113,120,119,28
"2758",57,"[28]EwvHnKqGocIHBJCFAmdtxttHIecz",219,0.995455,28,220,1,219,1,1,0,1,1,123,123,97,96,28
"2759",58,"[28]EwvHnKqGocIHBJCFAmdtxttHIecz",231,0.99569,28,232,1,231,1,1,0,1,1,116,116,116,115,28
"2760",59,"[28]EwvHnKqGocIHBJCFAmdtxttHIecz",234,0.995745,28,235,1,234,1,1,0,1,1,112,112,123,122,28
"2761",60,"[28]EwvHnKqGocIHBJCFAmdtxttHIecz",237,0.995798,28,238,1,237,1,1,0,1,1,109,109,129,128,28
"2762",61,"[28]EwvHnKqGocIHBJCFAmdtxttHIecz",224,0.995556,28,225,1,224,1,1,0,1,1,119,119,106,105,28
"2763",62,"[28]EwvHnKqGocIHBJCFAmdtxttHIecz",231,0.99569,28,232,1,231,1,1,0,1,1,113,113,119,118,28
"2764",63,"[28]EwvHnKqGocIHBJCFAmdtxttHIecz",222,0.995516,28,223,1,222,1,1,0,1,1,121,121,102,101,28
"2765",64,"[28]EwvHnKqGocIHBJCFAmdtxttHIecz",228,0.995633,28,229,1,228,1,1,0,1,1,116,116,113,112,28
"2766",65,"[28]EwvHnKqGocIHBJCFAmdtxttHIecz",230,0.995671,28,231,1,230,1,1,0,1,1,115,115,116,115,28
"2767",66,"[28]EwvHnKqGocIHBJCFAmdtxttHIecz",231,0.99569,28,232,1,231,1,1,0,1,1,115,115,117,116,28
"2768",67,"[28]EwvHnKqGocIHBJCFAmdtxttHIecz",224,0.995556,28,225,1,224,1,1,0,1,1,119,119,106,105,28
"2769",68,"[28]EwvHnKqGocIHBJCFAmdtxttHIecz",233,0.995726,28,234,1,233,1,1,0,1,1,112,112,122,121,28
"2770",69,"[28]EwvHnKqGocIHBJCFAmdtxttHIecz",225,0.995575,28,226,1,225,1,1,0,1,1,118,118,108,107,28
"2771",70,"[28]EwvHnKqGocIHBJCFAmdtxttHIecz",223,0.995536,28,224,1,223,1,1,0,1,1,120,120,104,103,28
"2772",71,"[28]EwvHnKqGocIHBJCFAmdtxttHIecz",236,0.995781,28,237,1,236,1,1,0,1,1,114,114,123,122,28
"2773",72,"[28]EwvHnKqGocIHBJCFAmdtxttHIecz",227,0.995614,28,228,1,227,1,1,0,1,1,118,118,110,109,28
"2774",73,"[28]EwvHnKqGocIHBJCFAmdtxttHIecz",228,0.995633,28,229,1,228,1,1,0,1,1,116,116,113,112,28
"2775",74,"[28]EwvHnKqGocIHBJCFAmdtxttHIecz",238,0.995816,28,239,1,238,1,1,0,1,1,109,109,130,129,28
"2776",75,"[28]EwvHnKqGocIHBJCFAmdtxttHIecz",228,0.995633,28,229,1,228,1,1,0,1,1,116,116,113,112,28
"2777",76,"[28]EwvHnKqGocIHBJCFAmdtxttHIecz",230,0.995671,28,231,1,230,1,1,0,1,1,114,114,117,116,28
"2778",77,"[28]EwvHnKqGocIHBJCFAmdtxttHIecz",235,0.995763,28,236,1,235,1,1,0,1,1,110,110,126,125,28
"2779",78,"[28]EwvHnKqGocIHBJCFAmdtxttHIecz",238,0.995816,28,239,1,238,1,1,0,1,1,109,109,130,129,28
"2780",79,"[28]EwvHnKqGocIHBJCFAmdtxttHIecz",225,0.995575,28,226,1,225,1,1,0,1,1,120,120,106,105,28
"2781",80,"[28]EwvHnKqGocIHBJCFAmdtxttHIecz",228,0.995633,28,229,1,228,1,1,0,1,1,116,116,113,112,28
"2782",81,"[28]EwvHnKqGocIHBJCFAmdtxttHIecz",233,0.995726,28,234,1,233,1,1,0,1,1,112,112,122,121,28
"2783",82,"[28]EwvHnKqGocIHBJCFAmdtxttHIecz",238,0.995816,28,239,1,238,1,1,0,1,1,109,109,130,129,28
"2784",83,"[28]EwvHnKqGocIHBJCFAmdtxttHIecz",231,0.99569,28,232,1,231,1,1,0,1,1,115,115,117,116,28
"2785",84,"[28]EwvHnKqGocIHBJCFAmdtxttHIecz",228,0.995633,28,229,1,228,1,1,0,1,1,117,117,112,111,28
"2786",85,"[28]EwvHnKqGocIHBJCFAmdtxttHIecz",228,0.995633,28,229,1,228,1,1,0,1,1,118,118,111,110,28
"2787",86,"[28]EwvHnKqGocIHBJCFAmdtxttHIecz",248,0.995984,28,249,1,248,1,1,0,1,1,104,104,145,144,28
"2788",87,"[28]EwvHnKqGocIHBJCFAmdtxttHIecz",239,0.995833,28,240,1,239,1,1,0,1,1,112,112,128,127,28
"2789",88,"[28]EwvHnKqGocIHBJCFAmdtxttHIecz",227,0.995614,28,228,1,227,1,1,0,1,1,117,117,111,110,28
"2790",89,"[28]EwvHnKqGocIHBJCFAmdtxttHIecz",224,0.995556,28,225,1,224,1,1,0,1,1,119,119,106,105,28
"2791",90,"[28]EwvHnKqGocIHBJCFAmdtxttHIecz",218,0.995434,28,219,1,218,1,1,0,1,1,124,124,95,94,28
"2792",91,"[28]EwvHnKqGocIHBJCFAmdtxttHIecz",242,0.995885,28,243,1,242,1,1,0,1,1,107,107,136,135,28
"2793",92,"[28]EwvHnKqGocIHBJCFAmdtxttHIecz",236,0.995781,28,237,1,236,1,1,0,1,1,111,111,126,125,28
"2794",93,"[28]EwvHnKqGocIHBJCFAmdtxttHIecz",236,0.995781,28,237,1,236,1,1,0,1,1,110,110,127,126,28
"2795",94,"[28]EwvHnKqGocIHBJCFAmdtxttHIecz",223,0.995536,28,224,1,223,1,1,0,1,1,120,120,104,103,28
"2796",95,"[28]EwvHnKqGocIHBJCFAmdtxttHIecz",229,0.995652,28,230,1,229,1,1,0,1,1,115,115,115,114,28
"2797",96,"[28]EwvHnKqGocIHBJCFAmdtxttHIecz",238,0.995816,28,239,1,238,1,1,0,1,1,108,108,131,130,28
"2798",97,"[28]EwvHnKqGocIHBJCFAmdtxttHIecz",222,0.995516,28,223,1,222,1,1,0,1,1,122,122,101,100,28
"2799",98,"[28]EwvHnKqGocIHBJCFAmdtxttHIecz",237,0.995798,28,238,1,237,1,1,0,1,1,112,112,126,125,28
"2800",99,"[28]EwvHnKqGocIHBJCFAmdtxttHIecz",236,0.995781,28,237,1,236,1,1,0,1,1,109,109,128,127,28
"2801",0,"[29]EwifctHnKqGocIHBJCwgoKoIziqnh",224,0.995556,29,225,1,224,1,1,0,1,1,119,119,106,105,30
"2802",1,"[29]EwifctHnKqGocIHBJCwgoKoIziqnh",230,0.995671,29,231,1,230,1,1,0,1,1,114,114,117,116,30
"2803",2,"[29]EwifctHnKqGocIHBJCwgoKoIziqnh",231,0.99569,29,232,1,231,1,1,0,1,1,115,115,117,116,30
"2804",3,"[29]EwifctHnKqGocIHBJCwgoKoIziqnh",231,0.99569,29,232,1,231,1,1,0,1,1,114,114,118,117,30
"2805",4,"[29]EwifctHnKqGocIHBJCwgoKoIziqnh",237,0.995798,29,238,1,237,1,1,0,1,1,110,110,128,127,30
"2806",5,"[29]EwifctHnKqGocIHBJCwgoKoIziqnh",228,0.995633,29,229,1,228,1,1,0,1,1,118,118,111,110,30
"2807",6,"[29]EwifctHnKqGocIHBJCwgoKoIziqnh",234,0.995745,29,235,1,234,1,1,0,1,1,113,113,122,121,30
"2808",7,"[29]EwifctHnKqGocIHBJCwgoKoIziqnh",231,0.99569,29,232,1,231,1,1,0,1,1,117,117,115,114,30
"2809",8,"[29]EwifctHnKqGocIHBJCwgoKoIziqnh",236,0.995781,29,237,1,236,1,1,0,1,1,109,109,128,127,30
"2810",9,"[29]EwifctHnKqGocIHBJCwgoKoIziqnh",226,0.995595,29,227,1,226,1,1,0,1,1,117,117,110,109,30
"2811",10,"[29]EwifctHnKqGocIHBJCwgoKoIziqnh",235,0.995763,29,236,1,235,1,1,0,1,1,110,110,126,125,30
"2812",11,"[29]EwifctHnKqGocIHBJCwgoKoIziqnh",235,0.995763,29,236,1,235,1,1,0,1,1,110,110,126,125,30
"2813",12,"[29]EwifctHnKqGocIHBJCwgoKoIziqnh",234,0.995745,29,235,1,234,1,1,0,1,1,113,113,122,121,30
"2814",13,"[29]EwifctHnKqGocIHBJCwgoKoIziqnh",242,0.995885,29,243,1,242,1,1,0,1,1,106,106,137,136,30
"2815",14,"[29]EwifctHnKqGocIHBJCwgoKoIziqnh",237,0.995798,29,238,1,237,1,1,0,1,1,109,109,129,128,30
"2816",15,"[29]EwifctHnKqGocIHBJCwgoKoIziqnh",227,0.995614,29,228,1,227,1,1,0,1,1,117,117,111,110,30
"2817",16,"[29]EwifctHnKqGocIHBJCwgoKoIziqnh",227,0.995614,29,228,1,227,1,1,0,1,1,118,118,110,109,30
"2818",17,"[29]EwifctHnKqGocIHBJCwgoKoIziqnh",237,0.995798,29,238,1,237,1,1,0,1,1,109,109,129,128,30
"2819",18,"[29]EwifctHnKqGocIHBJCwgoKoIziqnh",229,0.995652,29,230,1,229,1,1,0,1,1,115,115,115,114,30
"2820",19,"[29]EwifctHnKqGocIHBJCwgoKoIziqnh",225,0.995575,29,226,1,225,1,1,0,1,1,121,121,105,104,30
"2821",20,"[29]EwifctHnKqGocIHBJCwgoKoIziqnh",237,0.995798,29,238,1,237,1,1,0,1,1,109,109,129,128,30
"2822",21,"[29]EwifctHnKqGocIHBJCwgoKoIziqnh",234,0.995745,29,235,1,234,1,1,0,1,1,116,116,119,118,30
"2823",22,"[29]EwifctHnKqGocIHBJCwgoKoIziqnh",233,0.995726,29,234,1,233,1,1,0,1,1,111,111,123,122,30
"2824",23,"[29]EwifctHnKqGocIHBJCwgoKoIziqnh",228,0.995633,29,229,1,228,1,1,0,1,1,115,115,114,113,30
"2825",24,"[29]EwifctHnKqGocIHBJCwgoKoIziqnh",223,0.995536,29,224,1,223,1,1,0,1,1,121,121,103,102,30
"2826",25,"[29]EwifctHnKqGocIHBJCwgoKoIziqnh",228,0.995633,29,229,1,228,1,1,0,1,1,115,115,114,113,30
"2827",26,"[29]EwifctHnKqGocIHBJCwgoKoIziqnh",230,0.995671,29,231,1,230,1,1,0,1,1,114,114,117,116,30
"2828",27,"[29]EwifctHnKqGocIHBJCwgoKoIziqnh",232,0.995708,29,233,1,232,1,1,0,1,1,112,112,121,120,30
"2829",28,"[29]EwifctHnKqGocIHBJCwgoKoIziqnh",233,0.995726,29,234,1,233,1,1,0,1,1,112,112,122,121,30
"2830",29,"[29]EwifctHnKqGocIHBJCwgoKoIziqnh",228,0.995633,29,229,1,228,1,1,0,1,1,115,115,114,113,30
"2831",30,"[29]EwifctHnKqGocIHBJCwgoKoIziqnh",231,0.99569,29,232,1,231,1,1,0,1,1,115,115,117,116,30
"2832",31,"[29]EwifctHnKqGocIHBJCwgoKoIziqnh",234,0.995745,29,235,1,234,1,1,0,1,1,111,111,124,123,30
"2833",32,"[29]EwifctHnKqGocIHBJCwgoKoIziqnh",229,0.995652,29,230,1,229,1,1,0,1,1,114,114,116,115,30
"2834",33,"[29]EwifctHnKqGocIHBJCwgoKoIziqnh",227,0.995614,29,228,1,227,1,1,0,1,1,117,117,111,110,30
"2835",34,"[29]EwifctHnKqGocIHBJCwgoKoIziqnh",237,0.995798,29,238,1,237,1,1,0,1,1,108,108,130,129,30
"2836",35,"[29]EwifctHnKqGocIHBJCwgoKoIziqnh",236,0.995781,29,237,1,236,1,1,0,1,1,110,110,127,126,30
"2837",36,"[29]EwifctHnKqGocIHBJCwgoKoIziqnh",228,0.995633,29,229,1,228,1,1,0,1,1,116,116,113,112,30
"2838",37,"[29]EwifctHnKqGocIHBJCwgoKoIziqnh",234,0.995745,29,235,1,234,1,1,0,1,1,110,110,125,124,30
"2839",38,"[29]EwifctHnKqGocIHBJCwgoKoIziqnh",235,0.995763,29,236,1,235,1,1,0,1,1,114,114,122,121,30
"2840",39,"[29]EwifctHnKqGocIHBJCwgoKoIziqnh",232,0.995708,29,233,1,232,1,1,0,1,1,112,112,121,120,30
"2841",40,"[29]EwifctHnKqGocIHBJCwgoKoIziqnh",228,0.995633,29,229,1,228,1,1,0,1,1,115,115,114,113,30
"2842",41,"[29]EwifctHnKqGocIHBJCwgoKoIziqnh",233,0.995726,29,234,1,233,1,1,0,1,1,115,115,119,118,30
"2843",42,"[29]EwifctHnKqGocIHBJCwgoKoIziqnh",231,0.99569,29,232,1,231,1,1,0,1,1,116,116,116,115,30
"2844",43,"[29]EwifctHnKqGocIHBJCwgoKoIziqnh",232,0.995708,29,233,1,232,1,1,0,1,1,113,113,120,119,30
"2845",44,"[29]EwifctHnKqGocIHBJCwgoKoIziqnh",239,0.995833,29,240,1,239,1,1,0,1,1,107,107,133,132,30
"2846",45,"[29]EwifctHnKqGocIHBJCwgoKoIziqnh",231,0.99569,29,232,1,231,1,1,0,1,1,114,114,118,117,30
"2847",46,"[29]EwifctHnKqGocIHBJCwgoKoIziqnh",230,0.995671,29,231,1,230,1,1,0,1,1,116,116,115,114,30
"2848",47,"[29]EwifctHnKqGocIHBJCwgoKoIziqnh",222,0.995516,29,223,1,222,1,1,0,1,1,121,121,102,101,30
"2849",48,"[29]EwifctHnKqGocIHBJCwgoKoIziqnh",220,0.995475,29,221,1,220,1,1,0,1,1,122,122,99,98,30
"2850",49,"[29]EwifctHnKqGocIHBJCwgoKoIziqnh",232,0.995708,29,233,1,232,1,1,0,1,1,112,112,121,120,30
"2851",50,"[29]EwifctHnKqGocIHBJCwgoKoIziqnh",237,0.995798,29,238,1,237,1,1,0,1,1,110,110,128,127,30
"2852",51,"[29]EwifctHnKqGocIHBJCwgoKoIziqnh",234,0.995745,29,235,1,234,1,1,0,1,1,113,113,122,121,30
"2853",52,"[29]EwifctHnKqGocIHBJCwgoKoIziqnh",240,0.995851,29,241,1,240,1,1,0,1,1,106,106,135,134,30
"2854",53,"[29]EwifctHnKqGocIHBJCwgoKoIziqnh",232,0.995708,29,233,1,232,1,1,0,1,1,112,112,121,120,30
"2855",54,"[29]EwifctHnKqGocIHBJCwgoKoIziqnh",233,0.995726,29,234,1,233,1,1,0,1,1,112,112,122,121,30
"2856",55,"[29]EwifctHnKqGocIHBJCwgoKoIziqnh",228,0.995633,29,229,1,228,1,1,0,1,1,116,116,113,112,30
"2857",56,"[29]EwifctHnKqGocIHBJCwgoKoIziqnh",216,0.995392,29,217,1,216,1,1,0,1,1,127,127,90,89,30
"2858",57,"[29]EwifctHnKqGocIHBJCwgoKoIziqnh",227,0.995614,29,228,1,227,1,1,0,1,1,117,117,111,110,30
"2859",58,"[29]EwifctHnKqGocIHBJCwgoKoIziqnh",228,0.995633,29,229,1,228,1,1,0,1,1,115,115,114,113,30
"2860",59,"[29]EwifctHnKqGocIHBJCwgoKoIziqnh",232,0.995708,29,233,1,232,1,1,0,1,1,116,116,117,116,30
"2861",60,"[29]EwifctHnKqGocIHBJCwgoKoIziqnh",241,0.995868,29,242,1,241,1,1,0,1,1,106,106,136,135,30
"2862",61,"[29]EwifctHnKqGocIHBJCwgoKoIziqnh",225,0.995575,29,226,1,225,1,1,0,1,1,118,118,108,107,30
"2863",62,"[29]EwifctHnKqGocIHBJCwgoKoIziqnh",237,0.995798,29,238,1,237,1,1,0,1,1,110,110,128,127,30
"2864",63,"[29]EwifctHnKqGocIHBJCwgoKoIziqnh",229,0.995652,29,230,1,229,1,1,0,1,1,115,115,115,114,30
"2865",64,"[29]EwifctHnKqGocIHBJCwgoKoIziqnh",234,0.995745,29,235,1,234,1,1,0,1,1,110,110,125,124,30
"2866",65,"[29]EwifctHnKqGocIHBJCwgoKoIziqnh",244,0.995918,29,245,1,244,1,1,0,1,1,106,106,139,138,30
"2867",66,"[29]EwifctHnKqGocIHBJCwgoKoIziqnh",229,0.995652,29,230,1,229,1,1,0,1,1,114,114,116,115,30
"2868",67,"[29]EwifctHnKqGocIHBJCwgoKoIziqnh",235,0.995763,29,236,1,235,1,1,0,1,1,114,114,122,121,30
"2869",68,"[29]EwifctHnKqGocIHBJCwgoKoIziqnh",235,0.995763,29,236,1,235,1,1,0,1,1,119,119,117,116,30
"2870",69,"[29]EwifctHnKqGocIHBJCwgoKoIziqnh",228,0.995633,29,229,1,228,1,1,0,1,1,116,116,113,112,30
"2871",70,"[29]EwifctHnKqGocIHBJCwgoKoIziqnh",242,0.995885,29,243,1,242,1,1,0,1,1,104,104,139,138,30
"2872",71,"[29]EwifctHnKqGocIHBJCwgoKoIziqnh",227,0.995614,29,228,1,227,1,1,0,1,1,118,118,110,109,30
"2873",72,"[29]EwifctHnKqGocIHBJCwgoKoIziqnh",232,0.995708,29,233,1,232,1,1,0,1,1,112,112,121,120,30
"2874",73,"[29]EwifctHnKqGocIHBJCwgoKoIziqnh",226,0.995595,29,227,1,226,1,1,0,1,1,117,117,110,109,30
"2875",74,"[29]EwifctHnKqGocIHBJCwgoKoIziqnh",233,0.995726,29,234,1,233,1,1,0,1,1,113,113,121,120,30
"2876",75,"[29]EwifctHnKqGocIHBJCwgoKoIziqnh",232,0.995708,29,233,1,232,1,1,0,1,1,113,113,120,119,30
"2877",76,"[29]EwifctHnKqGocIHBJCwgoKoIziqnh",223,0.995536,29,224,1,223,1,1,0,1,1,120,120,104,103,30
"2878",77,"[29]EwifctHnKqGocIHBJCwgoKoIziqnh",235,0.995763,29,236,1,235,1,1,0,1,1,111,111,125,124,30
"2879",78,"[29]EwifctHnKqGocIHBJCwgoKoIziqnh",233,0.995726,29,234,1,233,1,1,0,1,1,111,111,123,122,30
"2880",79,"[29]EwifctHnKqGocIHBJCwgoKoIziqnh",228,0.995633,29,229,1,228,1,1,0,1,1,117,117,112,111,30
"2881",80,"[29]EwifctHnKqGocIHBJCwgoKoIziqnh",230,0.995671,29,231,1,230,1,1,0,1,1,115,115,116,115,30
"2882",81,"[29]EwifctHnKqGocIHBJCwgoKoIziqnh",239,0.995833,29,240,1,239,1,1,0,1,1,107,107,133,132,30
"2883",82,"[29]EwifctHnKqGocIHBJCwgoKoIziqnh",228,0.995633,29,229,1,228,1,1,0,1,1,116,116,113,112,30
"2884",83,"[29]EwifctHnKqGocIHBJCwgoKoIziqnh",226,0.995595,29,227,1,226,1,1,0,1,1,119,119,108,107,30
"2885",84,"[29]EwifctHnKqGocIHBJCwgoKoIziqnh",224,0.995556,29,225,1,224,1,1,0,1,1,118,118,107,106,30
"2886",85,"[29]EwifctHnKqGocIHBJCwgoKoIziqnh",220,0.995475,29,221,1,220,1,1,0,1,1,123,123,98,97,30
"2887",86,"[29]EwifctHnKqGocIHBJCwgoKoIziqnh",229,0.995652,29,230,1,229,1,1,0,1,1,114,114,116,115,30
"2888",87,"[29]EwifctHnKqGocIHBJCwgoKoIziqnh",231,0.99569,29,232,1,231,1,1,0,1,1,114,114,118,117,30
"2889",88,"[29]EwifctHnKqGocIHBJCwgoKoIziqnh",234,0.995745,29,235,1,234,1,1,0,1,1,112,112,123,122,30
"2890",89,"[29]EwifctHnKqGocIHBJCwgoKoIziqnh",237,0.995798,29,238,1,237,1,1,0,1,1,112,112,126,125,30
"2891",90,"[29]EwifctHnKqGocIHBJCwgoKoIziqnh",236,0.995781,29,237,1,236,1,1,0,1,1,110,110,127,126,30
"2892",91,"[29]EwifctHnKqGocIHBJCwgoKoIziqnh",241,0.995868,29,242,1,241,1,1,0,1,1,106,106,136,135,30
"2893",92,"[29]EwifctHnKqGocIHBJCwgoKoIziqnh",221,0.995495,29,222,1,221,1,1,0,1,1,122,122,100,99,30
"2894",93,"[29]EwifctHnKqGocIHBJCwgoKoIziqnh",237,0.995798,29,238,1,237,1,1,0,1,1,110,110,128,127,30
"2895",94,"[29]EwifctHnKqGocIHBJCwgoKoIziqnh",232,0.995708,29,233,1,232,1,1,0,1,1,112,112,121,120,30
"2896",95,"[29]EwifctHnKqGocIHBJCwgoKoIziqnh",238,0.995816,29,239,1,238,1,1,0,1,1,107,107,132,131,30
"2897",96,"[29]EwifctHnKqGocIHBJCwgoKoIziqnh",235,0.995763,29,236,1,235,1,1,0,1,1,112,112,124,123,30
"2898",97,"[29]EwifctHnKqGocIHBJCwgoKoIziqnh",241,0.995868,29,242,1,241,1,1,0,1,1,105,105,137,136,30
"2899",98,"[29]EwifctHnKqGocIHBJCwgoKoIziqnh",227,0.995614,29,228,1,227,1,1,0,1,1,116,116,112,111,30
"2900",99,"[29]EwifctHnKqGocIHBJCwgoKoIziqnh",229,0.995652,29,230,1,229,1,1,0,1,1,114,114,116,115,30
"2901",0,"[25]EjAgvwHnKqGocIHcJCeKrGBIE",241,0.995868,25,242,1,241,1,1,0,1,1,106,106,136,135,31
"2902",1,"[25]EjAgvwHnKqGocIHcJCeKrGBIE",221,0.995495,25,222,1,221,1,1,0,1,1,121,121,101,100,31
"2903",2,"[25]EjAgvwHnKqGocIHcJCeKrGBIE",225,0.995575,25,226,1,225,1,1,0,1,1,118,118,108,107,31
"2904",3,"[25]EjAgvwHnKqGocIHcJCeKrGBIE",232,0.995708,25,233,1,232,1,1,0,1,1,113,113,120,119,31
"2905",4,"[25]EjAgvwHnKqGocIHcJCeKrGBIE",238,0.995816,25,239,1,238,1,1,0,1,1,109,109,130,129,31
"2906",5,"[25]EjAgvwHnKqGocIHcJCeKrGBIE",227,0.995614,25,228,1,227,1,1,0,1,1,116,116,112,111,31
"2907",6,"[25]EjAgvwHnKqGocIHcJCeKrGBIE",229,0.995652,25,230,1,229,1,1,0,1,1,114,114,116,115,31
"2908",7,"[25]EjAgvwHnKqGocIHcJCeKrGBIE",221,0.995495,25,222,1,221,1,1,0,1,1,123,123,99,98,31
"2909",8,"[25]EjAgvwHnKqGocIHcJCeKrGBIE",225,0.995575,25,226,1,225,1,1,0,1,1,118,118,108,107,31
"2910",9,"[25]EjAgvwHnKqGocIHcJCeKrGBIE",230,0.995671,25,231,1,230,1,1,0,1,1,115,115,116,115,31
"2911",10,"[25]EjAgvwHnKqGocIHcJCeKrGBIE",228,0.995633,25,229,1,228,1,1,0,1,1,115,115,114,113,31
"2912",11,"[25]EjAgvwHnKqGocIHcJCeKrGBIE",227,0.995614,25,228,1,227,1,1,0,1,1,118,118,110,109,31
"2913",12,"[25]EjAgvwHnKqGocIHcJCeKrGBIE",231,0.99569,25,232,1,231,1,1,0,1,1,119,119,113,112,31
"2914",13,"[25]EjAgvwHnKqGocIHcJCeKrGBIE",236,0.995781,25,237,1,236,1,1,0,1,1,113,113,124,123,31
"2915",14,"[25]EjAgvwHnKqGocIHcJCeKrGBIE",232,0.995708,25,233,1,232,1,1,0,1,1,112,112,121,120,31
"2916",15,"[25]EjAgvwHnKqGocIHcJCeKrGBIE",224,0.995556,25,225,1,224,1,1,0,1,1,118,118,107,106,31
"2917",16,"[25]EjAgvwHnKqGocIHcJCeKrGBIE",224,0.995556,25,225,1,224,1,1,0,1,1,120,120,105,104,31
"2918",17,"[25]EjAgvwHnKqGocIHcJCeKrGBIE",228,0.995633,25,229,1,228,1,1,0,1,1,120,120,109,108,31
"2919",18,"[25]EjAgvwHnKqGocIHcJCeKrGBIE",221,0.995495,25,222,1,221,1,1,0,1,1,123,123,99,98,31
"2920",19,"[25]EjAgvwHnKqGocIHcJCeKrGBIE",244,0.995918,25,245,1,244,1,1,0,1,1,103,103,142,141,31
"2921",20,"[25]EjAgvwHnKqGocIHcJCeKrGBIE",239,0.995833,25,240,1,239,1,1,0,1,1,108,108,132,131,31
"2922",21,"[25]EjAgvwHnKqGocIHcJCeKrGBIE",234,0.995745,25,235,1,234,1,1,0,1,1,111,111,124,123,31
"2923",22,"[25]EjAgvwHnKqGocIHcJCeKrGBIE",236,0.995781,25,237,1,236,1,1,0,1,1,110,110,127,126,31
"2924",23,"[25]EjAgvwHnKqGocIHcJCeKrGBIE",230,0.995671,25,231,1,230,1,1,0,1,1,114,114,117,116,31
"2925",24,"[25]EjAgvwHnKqGocIHcJCeKrGBIE",226,0.995595,25,227,1,226,1,1,0,1,1,118,118,109,108,31
"2926",25,"[25]EjAgvwHnKqGocIHcJCeKrGBIE",241,0.995868,25,242,1,241,1,1,0,1,1,109,109,133,132,31
"2927",26,"[25]EjAgvwHnKqGocIHcJCeKrGBIE",231,0.99569,25,232,1,231,1,1,0,1,1,113,113,119,118,31
"2928",27,"[25]EjAgvwHnKqGocIHcJCeKrGBIE",227,0.995614,25,228,1,227,1,1,0,1,1,117,117,111,110,31
"2929",28,"[25]EjAgvwHnKqGocIHcJCeKrGBIE",229,0.995652,25,230,1,229,1,1,0,1,1,115,115,115,114,31
"2930",29,"[25]EjAgvwHnKqGocIHcJCeKrGBIE",233,0.995726,25,234,1,233,1,1,0,1,1,111,111,123,122,31
"2931",30,"[25]EjAgvwHnKqGocIHcJCeKrGBIE",233,0.995726,25,234,1,233,1,1,0,1,1,112,112,122,121,31
"2932",31,"[25]EjAgvwHnKqGocIHcJCeKrGBIE",231,0.99569,25,232,1,231,1,1,0,1,1,113,113,119,118,31
"2933",32,"[25]EjAgvwHnKqGocIHcJCeKrGBIE",219,0.995455,25,220,1,219,1,1,0,1,1,125,125,95,94,31
"2934",33,"[25]EjAgvwHnKqGocIHcJCeKrGBIE",246,0.995951,25,247,1,246,1,1,0,1,1,102,102,145,144,31
"2935",34,"[25]EjAgvwHnKqGocIHcJCeKrGBIE",241,0.995868,25,242,1,241,1,1,0,1,1,110,110,132,131,31
"2936",35,"[25]EjAgvwHnKqGocIHcJCeKrGBIE",224,0.995556,25,225,1,224,1,1,0,1,1,119,119,106,105,31
"2937",36,"[25]EjAgvwHnKqGocIHcJCeKrGBIE",222,0.995516,25,223,1,222,1,1,0,1,1,121,121,102,101,31
"2938",37,"[25]EjAgvwHnKqGocIHcJCeKrGBIE",234,0.995745,25,235,1,234,1,1,0,1,1,111,111,124,123,31
"2939",38,"[25]EjAgvwHnKqGocIHcJCeKrGBIE",238,0.995816,25,239,1,238,1,1,0,1,1,108,108,131,130,31
"2940",39,"[25]EjAgvwHnKqGocIHcJCeKrGBIE",239,0.995833,25,240,1,239,1,1,0,1,1,106,106,134,133,31
"2941",40,"[25]EjAgvwHnKqGocIHcJCeKrGBIE",229,0.995652,25,230,1,229,1,1,0,1,1,116,116,114,113,31
"2942",41,"[25]EjAgvwHnKqGocIHcJCeKrGBIE",234,0.995745,25,235,1,234,1,1,0,1,1,111,111,124,123,31
"2943",42,"[25]EjAgvwHnKqGocIHcJCeKrGBIE",225,0.995575,25,226,1,225,1,1,0,1,1,118,118,108,107,31
"2944",43,"[25]EjAgvwHnKqGocIHcJCeKrGBIE",234,0.995745,25,235,1,234,1,1,0,1,1,111,111,124,123,31
"2945",44,"[25]EjAgvwHnKqGocIHcJCeKrGBIE",238,0.995816,25,239,1,238,1,1,0,1,1,109,109,130,129,31
"2946",45,"[25]EjAgvwHnKqGocIHcJCeKrGBIE",234,0.995745,25,235,1,234,1,1,0,1,1,111,111,124,123,31
"2947",46,"[25]EjAgvwHnKqGocIHcJCeKrGBIE",237,0.995798,25,238,1,237,1,1,0,1,1,110,110,128,127,31
"2948",47,"[25]EjAgvwHnKqGocIHcJCeKrGBIE",225,0.995575,25,226,1,225,1,1,0,1,1,120,120,106,105,31
"2949",48,"[25]EjAgvwHnKqGocIHcJCeKrGBIE",221,0.995495,25,222,1,221,1,1,0,1,1,122,122,100,99,31
"2950",49,"[25]EjAgvwHnKqGocIHcJCeKrGBIE",225,0.995575,25,226,1,225,1,1,0,1,1,119,119,107,106,31
"2951",50,"[25]EjAgvwHnKqGocIHcJCeKrGBIE",228,0.995633,25,229,1,228,1,1,0,1,1,115,115,114,113,31
"2952",51,"[25]EjAgvwHnKqGocIHcJCeKrGBIE",225,0.995575,25,226,1,225,1,1,0,1,1,122,122,104,103,31
"2953",52,"[25]EjAgvwHnKqGocIHcJCeKrGBIE",234,0.995745,25,235,1,234,1,1,0,1,1,111,111,124,123,31
"2954",53,"[25]EjAgvwHnKqGocIHcJCeKrGBIE",221,0.995495,25,222,1,221,1,1,0,1,1,122,122,100,99,31
"2955",54,"[25]EjAgvwHnKqGocIHcJCeKrGBIE",228,0.995633,25,229,1,228,1,1,0,1,1,115,115,114,113,31
"2956",55,"[25]EjAgvwHnKqGocIHcJCeKrGBIE",224,0.995556,25,225,1,224,1,1,0,1,1,119,119,106,105,31
"2957",56,"[25]EjAgvwHnKqGocIHcJCeKrGBIE",224,0.995556,25,225,1,224,1,1,0,1,1,118,118,107,106,31
"2958",57,"[25]EjAgvwHnKqGocIHcJCeKrGBIE",231,0.99569,25,232,1,231,1,1,0,1,1,114,114,118,117,31
"2959",58,"[25]EjAgvwHnKqGocIHcJCeKrGBIE",228,0.995633,25,229,1,228,1,1,0,1,1,116,116,113,112,31
"2960",59,"[25]EjAgvwHnKqGocIHcJCeKrGBIE",234,0.995745,25,235,1,234,1,1,0,1,1,110,110,125,124,31
"2961",60,"[25]EjAgvwHnKqGocIHcJCeKrGBIE",227,0.995614,25,228,1,227,1,1,0,1,1,117,117,111,110,31
"2962",61,"[25]EjAgvwHnKqGocIHcJCeKrGBIE",237,0.995798,25,238,1,237,1,1,0,1,1,110,110,128,127,31
"2963",62,"[25]EjAgvwHnKqGocIHcJCeKrGBIE",225,0.995575,25,226,1,225,1,1,0,1,1,118,118,108,107,31
"2964",63,"[25]EjAgvwHnKqGocIHcJCeKrGBIE",235,0.995763,25,236,1,235,1,1,0,1,1,112,112,124,123,31
"2965",64,"[25]EjAgvwHnKqGocIHcJCeKrGBIE",228,0.995633,25,229,1,228,1,1,0,1,1,115,115,114,113,31
"2966",65,"[25]EjAgvwHnKqGocIHcJCeKrGBIE",229,0.995652,25,230,1,229,1,1,0,1,1,117,117,113,112,31
"2967",66,"[25]EjAgvwHnKqGocIHcJCeKrGBIE",237,0.995798,25,238,1,237,1,1,0,1,1,111,111,127,126,31
"2968",67,"[25]EjAgvwHnKqGocIHcJCeKrGBIE",236,0.995781,25,237,1,236,1,1,0,1,1,113,113,124,123,31
"2969",68,"[25]EjAgvwHnKqGocIHcJCeKrGBIE",227,0.995614,25,228,1,227,1,1,0,1,1,117,117,111,110,31
"2970",69,"[25]EjAgvwHnKqGocIHcJCeKrGBIE",240,0.995851,25,241,1,240,1,1,0,1,1,107,107,134,133,31
"2971",70,"[25]EjAgvwHnKqGocIHcJCeKrGBIE",228,0.995633,25,229,1,228,1,1,0,1,1,116,116,113,112,31
"2972",71,"[25]EjAgvwHnKqGocIHcJCeKrGBIE",228,0.995633,25,229,1,228,1,1,0,1,1,115,115,114,113,31
"2973",72,"[25]EjAgvwHnKqGocIHcJCeKrGBIE",227,0.995614,25,228,1,227,1,1,0,1,1,117,117,111,110,31
"2974",73,"[25]EjAgvwHnKqGocIHcJCeKrGBIE",224,0.995556,25,225,1,224,1,1,0,1,1,119,119,106,105,31
"2975",74,"[25]EjAgvwHnKqGocIHcJCeKrGBIE",231,0.99569,25,232,1,231,1,1,0,1,1,114,114,118,117,31
"2976",75,"[25]EjAgvwHnKqGocIHcJCeKrGBIE",228,0.995633,25,229,1,228,1,1,0,1,1,115,115,114,113,31
"2977",76,"[25]EjAgvwHnKqGocIHcJCeKrGBIE",234,0.995745,25,235,1,234,1,1,0,1,1,111,111,124,123,31
"2978",77,"[25]EjAgvwHnKqGocIHcJCeKrGBIE",220,0.995475,25,221,1,220,1,1,0,1,1,123,123,98,97,31
"2979",78,"[25]EjAgvwHnKqGocIHcJCeKrGBIE",229,0.995652,25,230,1,229,1,1,0,1,1,115,115,115,114,31
"2980",79,"[25]EjAgvwHnKqGocIHcJCeKrGBIE",230,0.995671,25,231,1,230,1,1,0,1,1,116,116,115,114,31
"2981",80,"[25]EjAgvwHnKqGocIHcJCeKrGBIE",228,0.995633,25,229,1,228,1,1,0,1,1,115,115,114,113,31
"2982",81,"[25]EjAgvwHnKqGocIHcJCeKrGBIE",218,0.995434,25,219,1,218,1,1,0,1,1,123,123,96,95,31
"2983",82,"[25]EjAgvwHnKqGocIHcJCeKrGBIE",228,0.995633,25,229,1,228,1,1,0,1,1,117,117,112,111,31
"2984",83,"[25]EjAgvwHnKqGocIHcJCeKrGBIE",241,0.995868,25,242,1,241,1,1,0,1,1,105,105,137,136,31
"2985",84,"[25]EjAgvwHnKqGocIHcJCeKrGBIE",229,0.995652,25,230,1,229,1,1,0,1,1,118,118,112,111,31
"2986",85,"[25]EjAgvwHnKqGocIHcJCeKrGBIE",226,0.995595,25,227,1,226,1,1,0,1,1,117,117,110,109,31
"2987",86,"[25]EjAgvwHnKqGocIHcJCeKrGBIE",233,0.995726,25,234,1,233,1,1,0,1,1,113,113,121,120,31
"2988",87,"[25]EjAgvwHnKqGocIHcJCeKrGBIE",225,0.995575,25,226,1,225,1,1,0,1,1,120,120,106,105,31
"2989",88,"[25]EjAgvwHnKqGocIHcJCeKrGBIE",226,0.995595,25,227,1,226,1,1,0,1,1,117,117,110,109,31
"2990",89,"[25]EjAgvwHnKqGocIHcJCeKrGBIE",231,0.99569,25,232,1,231,1,1,0,1,1,114,114,118,117,31
"2991",90,"[25]EjAgvwHnKqGocIHcJCeKrGBIE",229,0.995652,25,230,1,229,1,1,0,1,1,117,117,113,112,31
"2992",91,"[25]EjAgvwHnKqGocIHcJCeKrGBIE",224,0.995556,25,225,1,224,1,1,0,1,1,119,119,106,105,31
"2993",92,"[25]EjAgvwHnKqGocIHcJCeKrGBIE",230,0.995671,25,231,1,230,1,1,0,1,1,115,115,116,115,31
"2994",93,"[25]EjAgvwHnKqGocIHcJCeKrGBIE",231,0.99569,25,232,1,231,1,1,0,1,1,114,114,118,117,31
"2995",94,"[25]EjAgvwHnKqGocIHcJCeKrGBIE",224,0.995556,25,225,1,224,1,1,0,1,1,119,119,106,105,31
"2996",95,"[25]EjAgvwHnKqGocIHcJCeKrGBIE",230,0.995671,25,231,1,230,1,1,0,1,1,114,114,117,116,31
"2997",96,"[25]EjAgvwHnKqGocIHcJCeKrGBIE",218,0.995434,25,219,1,218,1,1,0,1,1,123,123,96,95,31
"2998",97,"[25]EjAgvwHnKqGocIHcJCeKrGBIE",229,0.995652,25,230,1,229,1,1,0,1,1,118,118,112,111,31
"2999",98,"[25]EjAgvwHnKqGocIHcJCeKrGBIE",224,0.995556,25,225,1,224,1,1,0,1,1,119,119,106,105,31
"3000",99,"[25]EjAgvwHnKqGocIHcJCeKrGBIE",237,0.995798,25,238,1,237,1,1,0,1,1,109,109,129,128,31
"3001",0,"[18]EFuHnKqGocIHBJCtig",238,0.995816,18,239,1,238,1,1,0,1,1,110,110,129,128,32
"3002",1,"[18]EFuHnKqGocIHBJCtig",233,0.995726,18,234,1,233,1,1,0,1,1,112,112,122,121,32
"3003",2,"[18]EFuHnKqGocIHBJCtig",228,0.995633,18,229,1,228,1,1,0,1,1,117,117,112,111,32
"3004",3,"[18]EFuHnKqGocIHBJCtig",235,0.995763,18,236,1,235,1,1,0,1,1,110,110,126,125,32
"3005",4,"[18]EFuHnKqGocIHBJCtig",223,0.995536,18,224,1,223,1,1,0,1,1,120,120,104,103,32
"3006",5,"[18]EFuHnKqGocIHBJCtig",230,0.995671,18,231,1,230,1,1,0,1,1,114,114,117,116,32
"3007",6,"[18]EFuHnKqGocIHBJCtig",238,0.995816,18,239,1,238,1,1,0,1,1,109,109,130,129,32
"3008",7,"[18]EFuHnKqGocIHBJCtig",227,0.995614,18,228,1,227,1,1,0,1,1,117,117,111,110,32
"3009",8,"[18]EFuHnKqGocIHBJCtig",225,0.995575,18,226,1,225,1,1,0,1,1,121,121,105,104,32
"3010",9,"[18]EFuHnKqGocIHBJCtig",232,0.995708,18,233,1,232,1,1,0,1,1,114,114,119,118,32
"3011",10,"[18]EFuHnKqGocIHBJCtig",239,0.995833,18,240,1,239,1,1,0,1,1,108,108,132,131,32
"3012",11,"[18]EFuHnKqGocIHBJCtig",230,0.995671,18,231,1,230,1,1,0,1,1,115,115,116,115,32
"3013",12,"[18]EFuHnKqGocIHBJCtig",219,0.995455,18,220,1,219,1,1,0,1,1,123,123,97,96,32
"3014",13,"[18]EFuHnKqGocIHBJCtig",220,0.995475,18,221,1,220,1,1,0,1,1,122,122,99,98,32
"3015",14,"[18]EFuHnKqGocIHBJCtig",231,0.99569,18,232,1,231,1,1,0,1,1,117,117,115,114,32
"3016",15,"[18]EFuHnKqGocIHBJCtig",245,0.995935,18,246,1,245,1,1,0,1,1,105,105,141,140,32
"3017",16,"[18]EFuHnKqGocIHBJCtig",229,0.995652,18,230,1,229,1,1,0,1,1,117,117,113,112,32
"3018",17,"[18]EFuHnKqGocIHBJCtig",240,0.995851,18,241,1,240,1,1,0,1,1,107,107,134,133,32
"3019",18,"[18]EFuHnKqGocIHBJCtig",239,0.995833,18,240,1,239,1,1,0,1,1,109,109,131,130,32
"3020",19,"[18]EFuHnKqGocIHBJCtig",227,0.995614,18,228,1,227,1,1,0,1,1,118,118,110,109,32
"3021",20,"[18]EFuHnKqGocIHBJCtig",243,0.995902,18,244,1,243,1,1,0,1,1,104,104,140,139,32
"3022",21,"[18]EFuHnKqGocIHBJCtig",228,0.995633,18,229,1,228,1,1,0,1,1,116,116,113,112,32
"3023",22,"[18]EFuHnKqGocIHBJCtig",234,0.995745,18,235,1,234,1,1,0,1,1,112,112,123,122,32
"3024",23,"[18]EFuHnKqGocIHBJCtig",229,0.995652,18,230,1,229,1,1,0,1,1,117,117,113,112,32
"3025",24,"[18]EFuHnKqGocIHBJCtig",235,0.995763,18,236,1,235,1,1,0,1,1,112,112,124,123,32
"3026",25,"[18]EFuHnKqGocIHBJCtig",226,0.995595,18,227,1,226,1,1,0,1,1,118,118,109,108,32
"3027",26,"[18]EFuHnKqGocIHBJCtig",222,0.995516,18,223,1,222,1,1,0,1,1,121,121,102,101,32
"3028",27,"[18]EFuHnKqGocIHBJCtig",224,0.995556,18,225,1,224,1,1,0,1,1,120,120,105,104,32
"3029",28,"[18]EFuHnKqGocIHBJCtig",231,0.99569,18,232,1,231,1,1,0,1,1,117,117,115,114,32
"3030",29,"[18]EFuHnKqGocIHBJCtig",225,0.995575,18,226,1,225,1,1,0,1,1,119,119,107,106,32
"3031",30,"[18]EFuHnKqGocIHBJCtig",226,0.995595,18,227,1,226,1,1,0,1,1,119,119,108,107,32
"3032",31,"[18]EFuHnKqGocIHBJCtig",224,0.995556,18,225,1,224,1,1,0,1,1,119,119,106,105,32
"3033",32,"[18]EFuHnKqGocIHBJCtig",236,0.995781,18,237,1,236,1,1,0,1,1,111,111,126,125,32
"3034",33,"[18]EFuHnKqGocIHBJCtig",238,0.995816,18,239,1,238,1,1,0,1,1,109,109,130,129,32
"3035",34,"[18]EFuHnKqGocIHBJCtig",239,0.995833,18,240,1,239,1,1,0,1,1,108,108,132,131,32
"3036",35,"[18]EFuHnKqGocIHBJCtig",235,0.995763,18,236,1,235,1,1,0,1,1,110,110,126,125,32
"3037",36,"[18]EFuHnKqGocIHBJCtig",232,0.995708,18,233,1,232,1,1,0,1,1,114,114,119,118,32
"3038",37,"[18]EFuHnKqGocIHBJCtig",214,0.995349,18,215,1,214,1,1,0,1,1,127,127,88,87,32
"3039",38,"[18]EFuHnKqGocIHBJCtig",228,0.995633,18,229,1,228,1,1,0,1,1,118,118,111,110,32
"3040",39,"[18]EFuHnKqGocIHBJCtig",235,0.995763,18,236,1,235,1,1,0,1,1,111,111,125,124,32
"3041",40,"[18]EFuHnKqGocIHBJCtig",236,0.995781,18,237,1,236,1,1,0,1,1,109,109,128,127,32
"3042",41,"[18]EFuHnKqGocIHBJCtig",236,0.995781,18,237,1,236,1,1,0,1,1,110,110,127,126,32
"3043",42,"[18]EFuHnKqGocIHBJCtig",225,0.995575,18,226,1,225,1,1,0,1,1,120,120,106,105,32
"3044",43,"[18]EFuHnKqGocIHBJCtig",234,0.995745,18,235,1,234,1,1,0,1,1,115,115,120,119,32
"3045",44,"[18]EFuHnKqGocIHBJCtig",227,0.995614,18,228,1,227,1,1,0,1,1,117,117,111,110,32
"3046",45,"[18]EFuHnKqGocIHBJCtig",236,0.995781,18,237,1,236,1,1,0,1,1,112,112,125,124,32
"3047",46,"[18]EFuHnKqGocIHBJCtig",241,0.995868,18,242,1,241,1,1,0,1,1,108,108,134,133,32
"3048",47,"[18]EFuHnKqGocIHBJCtig",237,0.995798,18,238,1,237,1,1,0,1,1,111,111,127,126,32
"3049",48,"[18]EFuHnKqGocIHBJCtig",227,0.995614,18,228,1,227,1,1,0,1,1,117,117,111,110,32
"3050",49,"[18]EFuHnKqGocIHBJCtig",229,0.995652,18,230,1,229,1,1,0,1,1,116,116,114,113,32
"3051",50,"[18]EFuHnKqGocIHBJCtig",228,0.995633,18,229,1,228,1,1,0,1,1,116,116,113,112,32
"3052",51,"[18]EFuHnKqGocIHBJCtig",228,0.995633,18,229,1,228,1,1,0,1,1,116,116,113,112,32
"3053",52,"[18]EFuHnKqGocIHBJCtig",238,0.995816,18,239,1,238,1,1,0,1,1,108,108,131,130,32
"3054",53,"[18]EFuHnKqGocIHBJCtig",239,0.995833,18,240,1,239,1,1,0,1,1,110,110,130,129,32
"3055",54,"[18]EFuHnKqGocIHBJCtig",227,0.995614,18,228,1,227,1,1,0,1,1,117,117,111,110,32
"3056",55,"[18]EFuHnKqGocIHBJCtig",228,0.995633,18,229,1,228,1,1,0,1,1,117,117,112,111,32
"3057",56,"[18]EFuHnKqGocIHBJCtig",210,0.995261,18,211,1,210,1,1,0,1,1,131,131,80,79,32
"3058",57,"[18]EFuHnKqGocIHBJCtig",228,0.995633,18,229,1,228,1,1,0,1,1,117,117,112,111,32
"3059",58,"[18]EFuHnKqGocIHBJCtig",233,0.995726,18,234,1,233,1,1,0,1,1,113,113,121,120,32
"3060",59,"[18]EFuHnKqGocIHBJCtig",232,0.995708,18,233,1,232,1,1,0,1,1,114,114,119,118,32
"3061",60,"[18]EFuHnKqGocIHBJCtig",228,0.995633,18,229,1,228,1,1,0,1,1,117,117,112,111,32
"3062",61,"[18]EFuHnKqGocIHBJCtig",229,0.995652,18,230,1,229,1,1,0,1,1,116,116,114,113,32
"3063",62,"[18]EFuHnKqGocIHBJCtig",239,0.995833,18,240,1,239,1,1,0,1,1,108,108,132,131,32
"3064",63,"[18]EFuHnKqGocIHBJCtig",246,0.995951,18,247,1,246,1,1,0,1,1,103,103,144,143,32
"3065",64,"[18]EFuHnKqGocIHBJCtig",224,0.995556,18,225,1,224,1,1,0,1,1,121,121,104,103,32
"3066",65,"[18]EFuHnKqGocIHBJCtig",233,0.995726,18,234,1,233,1,1,0,1,1,114,114,120,119,32
"3067",66,"[18]EFuHnKqGocIHBJCtig",229,0.995652,18,230,1,229,1,1,0,1,1,116,116,114,113,32
"3068",67,"[18]EFuHnKqGocIHBJCtig",233,0.995726,18,234,1,233,1,1,0,1,1,112,112,122,121,32
"3069",68,"[18]EFuHnKqGocIHBJCtig",226,0.995595,18,227,1,226,1,1,0,1,1,117,117,110,109,32
"3070",69,"[18]EFuHnKqGocIHBJCtig",229,0.995652,18,230,1,229,1,1,0,1,1,115,115,115,114,32
"3071",70,"[18]EFuHnKqGocIHBJCtig",228,0.995633,18,229,1,228,1,1,0,1,1,116,116,113,112,32
"3072",71,"[18]EFuHnKqGocIHBJCtig",231,0.99569,18,232,1,231,1,1,0,1,1,115,115,117,116,32
"3073",72,"[18]EFuHnKqGocIHBJCtig",233,0.995726,18,234,1,233,1,1,0,1,1,114,114,120,119,32
"3074",73,"[18]EFuHnKqGocIHBJCtig",227,0.995614,18,228,1,227,1,1,0,1,1,118,118,110,109,32
"3075",74,"[18]EFuHnKqGocIHBJCtig",224,0.995556,18,225,1,224,1,1,0,1,1,119,119,106,105,32
"3076",75,"[18]EFuHnKqGocIHBJCtig",224,0.995556,18,225,1,224,1,1,0,1,1,120,120,105,104,32
"3077",76,"[18]EFuHnKqGocIHBJCtig",230,0.995671,18,231,1,230,1,1,0,1,1,116,116,115,114,32
"3078",77,"[18]EFuHnKqGocIHBJCtig",221,0.995495,18,222,1,221,1,1,0,1,1,123,123,99,98,32
"3079",78,"[18]EFuHnKqGocIHBJCtig",229,0.995652,18,230,1,229,1,1,0,1,1,115,115,115,114,32
"3080",79,"[18]EFuHnKqGocIHBJCtig",224,0.995556,18,225,1,224,1,1,0,1,1,121,121,104,103,32
"3081",80,"[18]EFuHnKqGocIHBJCtig",230,0.995671,18,231,1,230,1,1,0,1,1,116,116,115,114,32
"3082",81,"[18]EFuHnKqGocIHBJCtig",236,0.995781,18,237,1,236,1,1,0,1,1,110,110,127,126,32
"3083",82,"[18]EFuHnKqGocIHBJCtig",224,0.995556,18,225,1,224,1,1,0,1,1,120,120,105,104,32
"3084",83,"[18]EFuHnKqGocIHBJCtig",229,0.995652,18,230,1,229,1,1,0,1,1,115,115,115,114,32
"3085",84,"[18]EFuHnKqGocIHBJCtig",215,0.99537,18,216,1,215,1,1,0,1,1,127,127,89,88,32
"3086",85,"[18]EFuHnKqGocIHBJCtig",227,0.995614,18,228,1,227,1,1,0,1,1,118,118,110,109,32
"3087",86,"[18]EFuHnKqGocIHBJCtig",233,0.995726,18,234,1,233,1,1,0,1,1,114,114,120,119,32
"3088",87,"[18]EFuHnKqGocIHBJCtig",225,0.995575,18,226,1,225,1,1,0,1,1,121,121,105,104,32
"3089",88,"[18]EFuHnKqGocIHBJCtig",230,0.995671,18,231,1,230,1,1,0,1,1,114,114,117,116,32
"3090",89,"[18]EFuHnKqGocIHBJCtig",224,0.995556,18,225,1,224,1,1,0,1,1,120,120,105,104,32
"3091",90,"[18]EFuHnKqGocIHBJCtig",229,0.995652,18,230,1,229,1,1,0,1,1,115,115,115,114,32
"3092",91,"[18]EFuHnKqGocIHBJCtig",234,0.995745,18,235,1,234,1,1,0,1,1,111,111,124,123,32
"3093",92,"[18]EFuHnKqGocIHBJCtig",228,0.995633,18,229,1,228,1,1,0,1,1,116,116,113,112,32
"3094",93,"[18]EFuHnKqGocIHBJCtig",234,0.995745,18,235,1,234,1,1,0,1,1,112,112,123,122,32
"3095",94,"[18]EFuHnKqGocIHBJCtig",231,0.99569,18,232,1,231,1,1,0,1,1,113,113,119,118,32
"3096",95,"[18]EFuHnKqGocIHBJCtig",222,0.995516,18,223,1,222,1,1,0,1,1,121,121,102,101,32
"3097",96,"[18]EFuHnKqGocIHBJCtig",219,0.995455,18,220,1,219,1,1,0,1,1,123,123,97,96,32
"3098",97,"[18]EFuHnKqGocIHBJCtig",225,0.995575,18,226,1,225,1,1,0,1,1,118,118,108,107,32
"3099",98,"[18]EFuHnKqGocIHBJCtig",231,0.99569,18,232,1,231,1,1,0,1,1,113,113,119,118,32
"3100",99,"[18]EFuHnKqGocIHBJCtig",233,0.995726,18,234,1,233,1,1,0,1,1,112,112,122,121,32
"3101",0,"[28]EstdsHnKqGocIHcJCvKGkJbxIycw",234,0.995745,28,235,1,234,1,1,0,1,1,111,111,124,123,35
"3102",1,"[28]EstdsHnKqGocIHcJCvKGkJbxIycw",225,0.995575,28,226,1,225,1,1,0,1,1,119,119,107,106,35
"3103",2,"[28]EstdsHnKqGocIHcJCvKGkJbxIycw",232,0.995708,28,233,1,232,1,1,0,1,1,116,116,117,116,35
"3104",3,"[28]EstdsHnKqGocIHcJCvKGkJbxIycw",234,0.995745,28,235,1,234,1,1,0,1,1,111,111,124,123,35
"3105",4,"[28]EstdsHnKqGocIHcJCvKGkJbxIycw",242,0.995885,28,243,1,242,1,1,0,1,1,106,106,137,136,35
"3106",5,"[28]EstdsHnKqGocIHcJCvKGkJbxIycw",227,0.995614,28,228,1,227,1,1,0,1,1,119,119,109,108,35
"3107",6,"[28]EstdsHnKqGocIHcJCvKGkJbxIycw",233,0.995726,28,234,1,233,1,1,0,1,1,112,112,122,121,35
"3108",7,"[28]EstdsHnKqGocIHcJCvKGkJbxIycw",231,0.99569,28,232,1,231,1,1,0,1,1,114,114,118,117,35
"3109",8,"[28]EstdsHnKqGocIHcJCvKGkJbxIycw",225,0.995575,28,226,1,225,1,1,0,1,1,121,121,105,104,35
"3110",9,"[28]EstdsHnKqGocIHcJCvKGkJbxIycw",230,0.995671,28,231,1,230,1,1,0,1,1,115,115,116,115,35
"3111",10,"[28]EstdsHnKqGocIHcJCvKGkJbxIycw",234,0.995745,28,235,1,234,1,1,0,1,1,112,112,123,122,35
"3112",11,"[28]EstdsHnKqGocIHcJCvKGkJbxIycw",228,0.995633,28,229,1,228,1,1,0,1,1,115,115,114,113,35
"3113",12,"[28]EstdsHnKqGocIHcJCvKGkJbxIycw",228,0.995633,28,229,1,228,1,1,0,1,1,117,117,112,111,35
"3114",13,"[28]EstdsHnKqGocIHcJCvKGkJbxIycw",227,0.995614,28,228,1,227,1,1,0,1,1,118,118,110,109,35
"3115",14,"[28]EstdsHnKqGocIHcJCvKGkJbxIycw",235,0.995763,28,236,1,235,1,1,0,1,1,111,111,125,124,35
"3116",15,"[28]EstdsHnKqGocIHcJCvKGkJbxIycw",228,0.995633,28,229,1,228,1,1,0,1,1,115,115,114,113,35
"3117",16,"[28]EstdsHnKqGocIHcJCvKGkJbxIycw",227,0.995614,28,228,1,227,1,1,0,1,1,119,119,109,108,35
"3118",17,"[28]EstdsHnKqGocIHcJCvKGkJbxIycw",221,0.995495,28,222,1,221,1,1,0,1,1,122,122,100,99,35
"3119",18,"[28]EstdsHnKqGocIHcJCvKGkJbxIycw",246,0.995951,28,247,1,246,1,1,0,1,1,101,101,146,145,35
"3120",19,"[28]EstdsHnKqGocIHcJCvKGkJbxIycw",233,0.995726,28,234,1,233,1,1,0,1,1,111,111,123,122,35
"3121",20,"[28]EstdsHnKqGocIHcJCvKGkJbxIycw",231,0.99569,28,232,1,231,1,1,0,1,1,114,114,118,117,35
"3122",21,"[28]EstdsHnKqGocIHcJCvKGkJbxIycw",226,0.995595,28,227,1,226,1,1,0,1,1,118,118,109,108,35
"3123",22,"[28]EstdsHnKqGocIHcJCvKGkJbxIycw",227,0.995614,28,228,1,227,1,1,0,1,1,118,118,110,109,35
"3124",23,"[28]EstdsHnKqGocIHcJCvKGkJbxIycw",232,0.995708,28,233,1,232,1,1,0,1,1,112,112,121,120,35
"3125",24,"[28]EstdsHnKqGocIHcJCvKGkJbxIycw",231,0.99569,28,232,1,231,1,1,0,1,1,114,114,118,117,35
"3126",25,"[28]EstdsHnKqGocIHcJCvKGkJbxIycw",226,0.995595,28,227,1,226,1,1,0,1,1,120,120,107,106,35
"3127",26,"[28]EstdsHnKqGocIHcJCvKGkJbxIycw",229,0.995652,28,230,1,229,1,1,0,1,1,116,116,114,113,35
"3128",27,"[28]EstdsHnKqGocIHcJCvKGkJbxIycw",230,0.995671,28,231,1,230,1,1,0,1,1,114,114,117,116,35
"3129",28,"[28]EstdsHnKqGocIHcJCvKGkJbxIycw",236,0.995781,28,237,1,236,1,1,0,1,1,109,109,128,127,35
"3130",29,"[28]EstdsHnKqGocIHcJCvKGkJbxIycw",240,0.995851,28,241,1,240,1,1,0,1,1,107,107,134,133,35
"3131",30,"[28]EstdsHnKqGocIHcJCvKGkJbxIycw",241,0.995868,28,242,1,241,1,1,0,1,1,105,105,137,136,35
"3132",31,"[28]EstdsHnKqGocIHcJCvKGkJbxIycw",222,0.995516,28,223,1,222,1,1,0,1,1,120,120,103,102,35
"3133",32,"[28]EstdsHnKqGocIHcJCvKGkJbxIycw",232,0.995708,28,233,1,232,1,1,0,1,1,112,112,121,120,35
"3134",33,"[28]EstdsHnKqGocIHcJCvKGkJbxIycw",222,0.995516,28,223,1,222,1,1,0,1,1,121,121,102,101,35
"3135",34,"[28]EstdsHnKqGocIHcJCvKGkJbxIycw",222,0.995516,28,223,1,222,1,1,0,1,1,120,120,103,102,35
"3136",35,"[28]EstdsHnKqGocIHcJCvKGkJbxIycw",228,0.995633,28,229,1,228,1,1,0,1,1,115,115,114,113,35
"3137",36,"[28]EstdsHnKqGocIHcJCvKGkJbxIycw",226,0.995595,28,227,1,226,1,1,0,1,1,119,119,108,107,35
"3138",37,"[28]EstdsHnKqGocIHcJCvKGkJbxIycw",221,0.995495,28,222,1,221,1,1,0,1,1,121,121,101,100,35
"3139",38,"[28]EstdsHnKqGocIHcJCvKGkJbxIycw",228,0.995633,28,229,1,228,1,1,0,1,1,116,116,113,112,35
"3140",39,"[28]EstdsHnKqGocIHcJCvKGkJbxIycw",232,0.995708,28,233,1,232,1,1,0,1,1,115,115,118,117,35
"3141",40,"[28]EstdsHnKqGocIHcJCvKGkJbxIycw",222,0.995516,28,223,1,222,1,1,0,1,1,120,120,103,102,35
"3142",41,"[28]EstdsHnKqGocIHcJCvKGkJbxIycw",239,0.995833,28,240,1,239,1,1,0,1,1,111,111,129,128,35
"3143",42,"[28]EstdsHnKqGocIHcJCvKGkJbxIycw",238,0.995816,28,239,1,238,1,1,0,1,1,110,110,129,128,35
"3144",43,"[28]EstdsHnKqGocIHcJCvKGkJbxIycw",235,0.995763,28,236,1,235,1,1,0,1,1,113,113,123,122,35
"3145",44,"[28]EstdsHnKqGocIHcJCvKGkJbxIycw",241,0.995868,28,242,1,241,1,1,0,1,1,105,105,137,136,35
"3146",45,"[28]EstdsHnKqGocIHcJCvKGkJbxIycw",235,0.995763,28,236,1,235,1,1,0,1,1,112,112,124,123,35
"3147",46,"[28]EstdsHnKqGocIHcJCvKGkJbxIycw",239,0.995833,28,240,1,239,1,1,0,1,1,112,112,128,127,35
"3148",47,"[28]EstdsHnKqGocIHcJCvKGkJbxIycw",223,0.995536,28,224,1,223,1,1,0,1,1,119,119,105,104,35
"3149",48,"[28]EstdsHnKqGocIHcJCvKGkJbxIycw",229,0.995652,28,230,1,229,1,1,0,1,1,115,115,115,114,35
"3150",49,"[28]EstdsHnKqGocIHcJCvKGkJbxIycw",217,0.995413,28,218,1,217,1,1,0,1,1,124,124,94,93,35
"3151",50,"[28]EstdsHnKqGocIHcJCvKGkJbxIycw",230,0.995671,28,231,1,230,1,1,0,1,1,114,114,117,116,35
"3152",51,"[28]EstdsHnKqGocIHcJCvKGkJbxIycw",229,0.995652,28,230,1,229,1,1,0,1,1,115,115,115,114,35
"3153",52,"[28]EstdsHnKqGocIHcJCvKGkJbxIycw",233,0.995726,28,234,1,233,1,1,0,1,1,111,111,123,122,35
"3154",53,"[28]EstdsHnKqGocIHcJCvKGkJbxIycw",230,0.995671,28,231,1,230,1,1,0,1,1,114,114,117,116,35
"3155",54,"[28]EstdsHnKqGocIHcJCvKGkJbxIycw",225,0.995575,28,226,1,225,1,1,0,1,1,118,118,108,107,35
"3156",55,"[28]EstdsHnKqGocIHcJCvKGkJbxIycw",217,0.995413,28,218,1,217,1,1,0,1,1,125,125,93,92,35
"3157",56,"[28]EstdsHnKqGocIHcJCvKGkJbxIycw",231,0.99569,28,232,1,231,1,1,0,1,1,114,114,118,117,35
"3158",57,"[28]EstdsHnKqGocIHcJCvKGkJbxIycw",232,0.995708,28,233,1,232,1,1,0,1,1,114,114,119,118,35
"3159",58,"[28]EstdsHnKqGocIHcJCvKGkJbxIycw",227,0.995614,28,228,1,227,1,1,0,1,1,118,118,110,109,35
"3160",59,"[28]EstdsHnKqGocIHcJCvKGkJbxIycw",224,0.995556,28,225,1,224,1,1,0,1,1,121,121,104,103,35
"3161",60,"[28]EstdsHnKqGocIHcJCvKGkJbxIycw",234,0.995745,28,235,1,234,1,1,0,1,1,114,114,121,120,35
"3162",61,"[28]EstdsHnKqGocIHcJCvKGkJbxIycw",232,0.995708,28,233,1,232,1,1,0,1,1,116,116,117,116,35
"3163",62,"[28]EstdsHnKqGocIHcJCvKGkJbxIycw",217,0.995413,28,218,1,217,1,1,0,1,1,124,124,94,93,35
"3164",63,"[28]EstdsHnKqGocIHcJCvKGkJbxIycw",229,0.995652,28,230,1,229,1,1,0,1,1,115,115,115,114,35
"3165",64,"[28]EstdsHnKqGocIHcJCvKGkJbxIycw",235,0.995763,28,236,1,235,1,1,0,1,1,110,110,126,125,35
"3166",65,"[28]EstdsHnKqGocIHcJCvKGkJbxIycw",228,0.995633,28,229,1,228,1,1,0,1,1,118,118,111,110,35
"3167",66,"[28]EstdsHnKqGocIHcJCvKGkJbxIycw",228,0.995633,28,229,1,228,1,1,0,1,1,119,119,110,109,35
"3168",67,"[28]EstdsHnKqGocIHcJCvKGkJbxIycw",241,0.995868,28,242,1,241,1,1,0,1,1,105,105,137,136,35
"3169",68,"[28]EstdsHnKqGocIHcJCvKGkJbxIycw",227,0.995614,28,228,1,227,1,1,0,1,1,116,116,112,111,35
"3170",69,"[28]EstdsHnKqGocIHcJCvKGkJbxIycw",236,0.995781,28,237,1,236,1,1,0,1,1,112,112,125,124,35
"3171",70,"[28]EstdsHnKqGocIHcJCvKGkJbxIycw",236,0.995781,28,237,1,236,1,1,0,1,1,112,112,125,124,35
"3172",71,"[28]EstdsHnKqGocIHcJCvKGkJbxIycw",229,0.995652,28,230,1,229,1,1,0,1,1,116,116,114,113,35
"3173",72,"[28]EstdsHnKqGocIHcJCvKGkJbxIycw",222,0.995516,28,223,1,222,1,1,0,1,1,120,120,103,102,35
"3174",73,"[28]EstdsHnKqGocIHcJCvKGkJbxIycw",229,0.995652,28,230,1,229,1,1,0,1,1,116,116,114,113,35
"3175",74,"[28]EstdsHnKqGocIHcJCvKGkJbxIycw",222,0.995516,28,223,1,222,1,1,0,1,1,120,120,103,102,35
"3176",75,"[28]EstdsHnKqGocIHcJCvKGkJbxIycw",234,0.995745,28,235,1,234,1,1,0,1,1,113,113,122,121,35
"3177",76,"[28]EstdsHnKqGocIHcJCvKGkJbxIycw",234,0.995745,28,235,1,234,1,1,0,1,1,116,116,119,118,35
"3178",77,"[28]EstdsHnKqGocIHcJCvKGkJbxIycw",241,0.995868,28,242,1,241,1,1,0,1,1,106,106,136,135,35
"3179",78,"[28]EstdsHnKqGocIHcJCvKGkJbxIycw",228,0.995633,28,229,1,228,1,1,0,1,1,118,118,111,110,35
"3180",79,"[28]EstdsHnKqGocIHcJCvKGkJbxIycw",229,0.995652,28,230,1,229,1,1,0,1,1,116,116,114,113,35
"3181",80,"[28]EstdsHnKqGocIHcJCvKGkJbxIycw",234,0.995745,28,235,1,234,1,1,0,1,1,112,112,123,122,35
"3182",81,"[28]EstdsHnKqGocIHcJCvKGkJbxIycw",227,0.995614,28,228,1,227,1,1,0,1,1,116,116,112,111,35
"3183",82,"[28]EstdsHnKqGocIHcJCvKGkJbxIycw",226,0.995595,28,227,1,226,1,1,0,1,1,117,117,110,109,35
"3184",83,"[28]EstdsHnKqGocIHcJCvKGkJbxIycw",227,0.995614,28,228,1,227,1,1,0,1,1,116,116,112,111,35
"3185",84,"[28]EstdsHnKqGocIHcJCvKGkJbxIycw",230,0.995671,28,231,1,230,1,1,0,1,1,116,116,115,114,35
"3186",85,"[28]EstdsHnKqGocIHcJCvKGkJbxIycw",221,0.995495,28,222,1,221,1,1,0,1,1,121,121,101,100,35
"3187",86,"[28]EstdsHnKqGocIHcJCvKGkJbxIycw",228,0.995633,28,229,1,228,1,1,0,1,1,115,115,114,113,35
"3188",87,"[28]EstdsHnKqGocIHcJCvKGkJbxIycw",236,0.995781,28,237,1,236,1,1,0,1,1,109,109,128,127,35
"3189",88,"[28]EstdsHnKqGocIHcJCvKGkJbxIycw",241,0.995868,28,242,1,241,1,1,0,1,1,107,107,135,134,35
"3190",89,"[28]EstdsHnKqGocIHcJCvKGkJbxIycw",225,0.995575,28,226,1,225,1,1,0,1,1,118,118,108,107,35
"3191",90,"[28]EstdsHnKqGocIHcJCvKGkJbxIycw",233,0.995726,28,234,1,233,1,1,0,1,1,113,113,121,120,35
"3192",91,"[28]EstdsHnKqGocIHcJCvKGkJbxIycw",239,0.995833,28,240,1,239,1,1,0,1,1,107,107,133,132,35
"3193",92,"[28]EstdsHnKqGocIHcJCvKGkJbxIycw",234,0.995745,28,235,1,234,1,1,0,1,1,111,111,124,123,35
"3194",93,"[28]EstdsHnKqGocIHcJCvKGkJbxIycw",221,0.995495,28,222,1,221,1,1,0,1,1,121,121,101,100,35
"3195",94,"[28]EstdsHnKqGocIHcJCvKGkJbxIycw",239,0.995833,28,240,1,239,1,1,0,1,1,107,107,133,132,35
"3196",95,"[28]EstdsHnKqGocIHcJCvKGkJbxIycw",229,0.995652,28,230,1,229,1,1,0,1,1,116,116,114,113,35
"3197",96,"[28]EstdsHnKqGocIHcJCvKGkJbxIycw",221,0.995495,28,222,1,221,1,1,0,1,1,123,123,99,98,35
"3198",97,"[28]EstdsHnKqGocIHcJCvKGkJbxIycw",238,0.995816,28,239,1,238,1,1,0,1,1,110,110,129,128,35
"3199",98,"[28]EstdsHnKqGocIHcJCvKGkJbxIycw",233,0.995726,28,234,1,233,1,1,0,1,1,112,112,122,121,35
"3200",99,"[28]EstdsHnKqGocIHcJCvKGkJbxIycw",220,0.995475,28,221,1,220,1,1,0,1,1,123,123,98,97,35
"3201",0,"[34]EpjHuegvHnKqGocIHBJCqGCyyIlDDzajJk",223,0.995536,34,224,1,223,1,1,0,1,1,121,121,103,102,36
"3202",1,"[34]EpjHuegvHnKqGocIHBJCqGCyyIlDDzajJk",230,0.995671,34,231,1,230,1,1,0,1,1,114,114,117,116,36
"3203",2,"[34]EpjHuegvHnKqGocIHBJCqGCyyIlDDzajJk",221,0.995495,34,222,1,221,1,1,0,1,1,121,121,101,100,36
"3204",3,"[34]EpjHuegvHnKqGocIHBJCqGCyyIlDDzajJk",235,0.995763,34,236,1,235,1,1,0,1,1,110,110,126,125,36
"3205",4,"[34]EpjHuegvHnKqGocIHBJCqGCyyIlDDzajJk",240,0.995851,34,241,1,240,1,1,0,1,1,107,107,134,133,36
"3206",5,"[34]EpjHuegvHnKqGocIHBJCqGCyyIlDDzajJk",238,0.995816,34,239,1,238,1,1,0,1,1,113,113,126,125,36
"3207",6,"[34]EpjHuegvHnKqGocIHBJCqGCyyIlDDzajJk",232,0.995708,34,233,1,232,1,1,0,1,1,113,113,120,119,36
"3208",7,"[34]EpjHuegvHnKqGocIHBJCqGCyyIlDDzajJk",224,0.995556,34,225,1,224,1,1,0,1,1,118,118,107,106,36
"3209",8,"[34]EpjHuegvHnKqGocIHBJCqGCyyIlDDzajJk",236,0.995781,34,237,1,236,1,1,0,1,1,112,112,125,124,36
"3210",9,"[34]EpjHuegvHnKqGocIHBJCqGCyyIlDDzajJk",228,0.995633,34,229,1,228,1,1,0,1,1,118,118,111,110,36
"3211",10,"[34]EpjHuegvHnKqGocIHBJCqGCyyIlDDzajJk",233,0.995726,34,234,1,233,1,1,0,1,1,112,112,122,121,36
"3212",11,"[34]EpjHuegvHnKqGocIHBJCqGCyyIlDDzajJk",226,0.995595,34,227,1,226,1,1,0,1,1,117,117,110,109,36
"3213",12,"[34]EpjHuegvHnKqGocIHBJCqGCyyIlDDzajJk",227,0.995614,34,228,1,227,1,1,0,1,1,118,118,110,109,36
"3214",13,"[34]EpjHuegvHnKqGocIHBJCqGCyyIlDDzajJk",227,0.995614,34,228,1,227,1,1,0,1,1,117,117,111,110,36
"3215",14,"[34]EpjHuegvHnKqGocIHBJCqGCyyIlDDzajJk",229,0.995652,34,230,1,229,1,1,0,1,1,116,116,114,113,36
"3216",15,"[34]EpjHuegvHnKqGocIHBJCqGCyyIlDDzajJk",227,0.995614,34,228,1,227,1,1,0,1,1,119,119,109,108,36
"3217",16,"[34]EpjHuegvHnKqGocIHBJCqGCyyIlDDzajJk",228,0.995633,34,229,1,228,1,1,0,1,1,116,116,113,112,36
"3218",17,"[34]EpjHuegvHnKqGocIHBJCqGCyyIlDDzajJk",228,0.995633,34,229,1,228,1,1,0,1,1,116,116,113,112,36
"3219",18,"[34]EpjHuegvHnKqGocIHBJCqGCyyIlDDzajJk",222,0.995516,34,223,1,222,1,1,0,1,1,121,121,102,101,36
"3220",19,"[34]EpjHuegvHnKqGocIHBJCqGCyyIlDDzajJk",235,0.995763,34,236,1,235,1,1,0,1,1,109,109,127,126,36
"3221",20,"[34]EpjHuegvHnKqGocIHBJCqGCyyIlDDzajJk",236,0.995781,34,237,1,236,1,1,0,1,1,110,110,127,126,36
"3222",21,"[34]EpjHuegvHnKqGocIHBJCqGCyyIlDDzajJk",227,0.995614,34,228,1,227,1,1,0,1,1,116,116,112,111,36
"3223",22,"[34]EpjHuegvHnKqGocIHBJCqGCyyIlDDzajJk",224,0.995556,34,225,1,224,1,1,0,1,1,120,120,105,104,36
"3224",23,"[34]EpjHuegvHnKqGocIHBJCqGCyyIlDDzajJk",224,0.995556,34,225,1,224,1,1,0,1,1,120,120,105,104,36
"3225",24,"[34]EpjHuegvHnKqGocIHBJCqGCyyIlDDzajJk",235,0.995763,34,236,1,235,1,1,0,1,1,110,110,126,125,36
"3226",25,"[34]EpjHuegvHnKqGocIHBJCqGCyyIlDDzajJk",228,0.995633,34,229,1,228,1,1,0,1,1,115,115,114,113,36
"3227",26,"[34]EpjHuegvHnKqGocIHBJCqGCyyIlDDzajJk",227,0.995614,34,228,1,227,1,1,0,1,1,116,116,112,111,36
"3228",27,"[34]EpjHuegvHnKqGocIHBJCqGCyyIlDDzajJk",220,0.995475,34,221,1,220,1,1,0,1,1,123,123,98,97,36
"3229",28,"[34]EpjHuegvHnKqGocIHBJCqGCyyIlDDzajJk",223,0.995536,34,224,1,223,1,1,0,1,1,120,120,104,103,36
"3230",29,"[34]EpjHuegvHnKqGocIHBJCqGCyyIlDDzajJk",240,0.995851,34,241,1,240,1,1,0,1,1,106,106,135,134,36
"3231",30,"[34]EpjHuegvHnKqGocIHBJCqGCyyIlDDzajJk",237,0.995798,34,238,1,237,1,1,0,1,1,108,108,130,129,36
"3232",31,"[34]EpjHuegvHnKqGocIHBJCqGCyyIlDDzajJk",223,0.995536,34,224,1,223,1,1,0,1,1,120,120,104,103,36
"3233",32,"[34]EpjHuegvHnKqGocIHBJCqGCyyIlDDzajJk",227,0.995614,34,228,1,227,1,1,0,1,1,116,116,112,111,36
"3234",33,"[34]EpjHuegvHnKqGocIHBJCqGCyyIlDDzajJk",234,0.995745,34,235,1,234,1,1,0,1,1,112,112,123,122,36
"3235",34,"[34]EpjHuegvHnKqGocIHBJCqGCyyIlDDzajJk",237,0.995798,34,238,1,237,1,1,0,1,1,111,111,127,126,36
"3236",35,"[34]EpjHuegvHnKqGocIHBJCqGCyyIlDDzajJk",226,0.995595,34,227,1,226,1,1,0,1,1,117,117,110,109,36
"3237",36,"[34]EpjHuegvHnKqGocIHBJCqGCyyIlDDzajJk",238,0.995816,34,239,1,238,1,1,0,1,1,108,108,131,130,36
"3238",37,"[34]EpjHuegvHnKqGocIHBJCqGCyyIlDDzajJk",237,0.995798,34,238,1,237,1,1,0,1,1,108,108,130,129,36
"3239",38,"[34]EpjHuegvHnKqGocIHBJCqGCyyIlDDzajJk",225,0.995575,34,226,1,225,1,1,0,1,1,119,119,107,106,36
"3240",39,"[34]EpjHuegvHnKqGocIHBJCqGCyyIlDDzajJk",237,0.995798,34,238,1,237,1,1,0,1,1,108,108,130,129,36
"3241",40,"[34]EpjHuegvHnKqGocIHBJCqGCyyIlDDzajJk",232,0.995708,34,233,1,232,1,1,0,1,1,114,114,119,118,36
"3242",41,"[34]EpjHuegvHnKqGocIHBJCqGCyyIlDDzajJk",243,0.995902,34,244,1,243,1,1,0,1,1,106,106,138,137,36
"3243",42,"[34]EpjHuegvHnKqGocIHBJCqGCyyIlDDzajJk",227,0.995614,34,228,1,227,1,1,0,1,1,116,116,112,111,36
"3244",43,"[34]EpjHuegvHnKqGocIHBJCqGCyyIlDDzajJk",224,0.995556,34,225,1,224,1,1,0,1,1,119,119,106,105,36
"3245",44,"[34]EpjHuegvHnKqGocIHBJCqGCyyIlDDzajJk",224,0.995556,34,225,1,224,1,1,0,1,1,119,119,106,105,36
"3246",45,"[34]EpjHuegvHnKqGocIHBJCqGCyyIlDDzajJk",225,0.995575,34,226,1,225,1,1,0,1,1,117,117,109,108,36
"3247",46,"[34]EpjHuegvHnKqGocIHBJCqGCyyIlDDzajJk",230,0.995671,34,231,1,230,1,1,0,1,1,114,114,117,116,36
"3248",47,"[34]EpjHuegvHnKqGocIHBJCqGCyyIlDDzajJk",235,0.995763,34,236,1,235,1,1,0,1,1,109,109,127,126,36
"3249",48,"[34]EpjHuegvHnKqGocIHBJCqGCyyIlDDzajJk",230,0.995671,34,231,1,230,1,1,0,1,1,115,115,116,115,36
"3250",49,"[34]EpjHuegvHnKqGocIHBJCqGCyyIlDDzajJk",219,0.995455,34,220,1,219,1,1,0,1,1,124,124,96,95,36
"3251",50,"[34]EpjHuegvHnKqGocIHBJCqGCyyIlDDzajJk",230,0.995671,34,231,1,230,1,1,0,1,1,113,113,118,117,36
"3252",51,"[34]EpjHuegvHnKqGocIHBJCqGCyyIlDDzajJk",226,0.995595,34,227,1,226,1,1,0,1,1,119,119,108,107,36
"3253",52,"[34]EpjHuegvHnKqGocIHBJCqGCyyIlDDzajJk",220,0.995475,34,221,1,220,1,1,0,1,1,121,121,100,99,36
"3254",53,"[34]EpjHuegvHnKqGocIHBJCqGCyyIlDDzajJk",229,0.995652,34,230,1,229,1,1,0,1,1,114,114,116,115,36
"3255",54,"[34]EpjHuegvHnKqGocIHBJCqGCyyIlDDzajJk",229,0.995652,34,230,1,229,1,1,0,1,1,115,115,115,114,36
"3256",55,"[34]EpjHuegvHnKqGocIHBJCqGCyyIlDDzajJk",231,0.99569,34,232,1,231,1,1,0,1,1,114,114,118,117,36
"3257",56,"[34]EpjHuegvHnKqGocIHBJCqGCyyIlDDzajJk",218,0.995434,34,219,1,218,1,1,0,1,1,124,124,95,94,36
"3258",57,"[34]EpjHuegvHnKqGocIHBJCqGCyyIlDDzajJk",237,0.995798,34,238,1,237,1,1,0,1,1,109,109,129,128,36
"3259",58,"[34]EpjHuegvHnKqGocIHBJCqGCyyIlDDzajJk",230,0.995671,34,231,1,230,1,1,0,1,1,114,114,117,116,36
"3260",59,"[34]EpjHuegvHnKqGocIHBJCqGCyyIlDDzajJk",235,0.995763,34,236,1,235,1,1,0,1,1,116,116,120,119,36
"3261",60,"[34]EpjHuegvHnKqGocIHBJCqGCyyIlDDzajJk",235,0.995763,34,236,1,235,1,1,0,1,1,111,111,125,124,36
"3262",61,"[34]EpjHuegvHnKqGocIHBJCqGCyyIlDDzajJk",237,0.995798,34,238,1,237,1,1,0,1,1,109,109,129,128,36
"3263",62,"[34]EpjHuegvHnKqGocIHBJCqGCyyIlDDzajJk",231,0.99569,34,232,1,231,1,1,0,1,1,114,114,118,117,36
"3264",63,"[34]EpjHuegvHnKqGocIHBJCqGCyyIlDDzajJk",241,0.995868,34,242,1,241,1,1,0,1,1,107,107,135,134,36
"3265",64,"[34]EpjHuegvHnKqGocIHBJCqGCyyIlDDzajJk",223,0.995536,34,224,1,223,1,1,0,1,1,120,120,104,103,36
"3266",65,"[34]EpjHuegvHnKqGocIHBJCqGCyyIlDDzajJk",235,0.995763,34,236,1,235,1,1,0,1,1,110,110,126,125,36
"3267",66,"[34]EpjHuegvHnKqGocIHBJCqGCyyIlDDzajJk",225,0.995575,34,226,1,225,1,1,0,1,1,117,117,109,108,36
"3268",67,"[34]EpjHuegvHnKqGocIHBJCqGCyyIlDDzajJk",219,0.995455,34,220,1,219,1,1,0,1,1,123,123,97,96,36
"3269",68,"[34]EpjHuegvHnKqGocIHBJCqGCyyIlDDzajJk",224,0.995556,34,225,1,224,1,1,0,1,1,118,118,107,106,36
"3270",69,"[34]EpjHuegvHnKqGocIHBJCqGCyyIlDDzajJk",227,0.995614,34,228,1,227,1,1,0,1,1,116,116,112,111,36
"3271",70,"[34]EpjHuegvHnKqGocIHBJCqGCyyIlDDzajJk",214,0.995349,34,215,1,214,1,1,0,1,1,126,126,89,88,36
"3272",71,"[34]EpjHuegvHnKqGocIHBJCqGCyyIlDDzajJk",225,0.995575,34,226,1,225,1,1,0,1,1,121,121,105,104,36
"3273",72,"[34]EpjHuegvHnKqGocIHBJCqGCyyIlDDzajJk",229,0.995652,34,230,1,229,1,1,0,1,1,115,115,115,114,36
"3274",73,"[34]EpjHuegvHnKqGocIHBJCqGCyyIlDDzajJk",233,0.995726,34,234,1,233,1,1,0,1,1,111,111,123,122,36
"3275",74,"[34]EpjHuegvHnKqGocIHBJCqGCyyIlDDzajJk",225,0.995575,34,226,1,225,1,1,0,1,1,117,117,109,108,36
"3276",75,"[34]EpjHuegvHnKqGocIHBJCqGCyyIlDDzajJk",237,0.995798,34,238,1,237,1,1,0,1,1,112,112,126,125,36
"3277",76,"[34]EpjHuegvHnKqGocIHBJCqGCyyIlDDzajJk",236,0.995781,34,237,1,236,1,1,0,1,1,109,109,128,127,36
"3278",77,"[34]EpjHuegvHnKqGocIHBJCqGCyyIlDDzajJk",225,0.995575,34,226,1,225,1,1,0,1,1,117,117,109,108,36
"3279",78,"[34]EpjHuegvHnKqGocIHBJCqGCyyIlDDzajJk",233,0.995726,34,234,1,233,1,1,0,1,1,112,112,122,121,36
"3280",79,"[34]EpjHuegvHnKqGocIHBJCqGCyyIlDDzajJk",230,0.995671,34,231,1,230,1,1,0,1,1,114,114,117,116,36
"3281",80,"[34]EpjHuegvHnKqGocIHBJCqGCyyIlDDzajJk",233,0.995726,34,234,1,233,1,1,0,1,1,111,111,123,122,36
"3282",81,"[34]EpjHuegvHnKqGocIHBJCqGCyyIlDDzajJk",225,0.995575,34,226,1,225,1,1,0,1,1,118,118,108,107,36
"3283",82,"[34]EpjHuegvHnKqGocIHBJCqGCyyIlDDzajJk",230,0.995671,34,231,1,230,1,1,0,1,1,113,113,118,117,36
"3284",83,"[34]EpjHuegvHnKqGocIHBJCqGCyyIlDDzajJk",228,0.995633,34,229,1,228,1,1,0,1,1,117,117,112,111,36
"3285",84,"[34]EpjHuegvHnKqGocIHBJCqGCyyIlDDzajJk",220,0.995475,34,221,1,220,1,1,0,1,1,123,123,98,97,36
"3286",85,"[34]EpjHuegvHnKqGocIHBJCqGCyyIlDDzajJk",220,0.995475,34,221,1,220,1,1,0,1,1,122,122,99,98,36
"3287",86,"[34]EpjHuegvHnKqGocIHBJCqGCyyIlDDzajJk",229,0.995652,34,230,1,229,1,1,0,1,1,114,114,116,115,36
"3288",87,"[34]EpjHuegvHnKqGocIHBJCqGCyyIlDDzajJk",235,0.995763,34,236,1,235,1,1,0,1,1,109,109,127,126,36
"3289",88,"[34]EpjHuegvHnKqGocIHBJCqGCyyIlDDzajJk",223,0.995536,34,224,1,223,1,1,0,1,1,119,119,105,104,36
"3290",89,"[34]EpjHuegvHnKqGocIHBJCqGCyyIlDDzajJk",227,0.995614,34,228,1,227,1,1,0,1,1,118,118,110,109,36
"3291",90,"[34]EpjHuegvHnKqGocIHBJCqGCyyIlDDzajJk",239,0.995833,34,240,1,239,1,1,0,1,1,107,107,133,132,36
"3292",91,"[34]EpjHuegvHnKqGocIHBJCqGCyyIlDDzajJk",229,0.995652,34,230,1,229,1,1,0,1,1,115,115,115,114,36
"3293",92,"[34]EpjHuegvHnKqGocIHBJCqGCyyIlDDzajJk",225,0.995575,34,226,1,225,1,1,0,1,1,119,119,107,106,36
"3294",93,"[34]EpjHuegvHnKqGocIHBJCqGCyyIlDDzajJk",212,0.995305,34,213,1,212,1,1,0,1,1,129,129,84,83,36
"3295",94,"[34]EpjHuegvHnKqGocIHBJCqGCyyIlDDzajJk",230,0.995671,34,231,1,230,1,1,0,1,1,113,113,118,117,36
"3296",95,"[34]EpjHuegvHnKqGocIHBJCqGCyyIlDDzajJk",233,0.995726,34,234,1,233,1,1,0,1,1,111,111,123,122,36
"3297",96,"[34]EpjHuegvHnKqGocIHBJCqGCyyIlDDzajJk",238,0.995816,34,239,1,238,1,1,0,1,1,109,109,130,129,36
"3298",97,"[34]EpjHuegvHnKqGocIHBJCqGCyyIlDDzajJk",230,0.995671,34,231,1,230,1,1,0,1,1,113,113,118,117,36
"3299",98,"[34]EpjHuegvHnKqGocIHBJCqGCyyIlDDzajJk",229,0.995652,34,230,1,229,1,1,0,1,1,114,114,116,115,36
"3300",99,"[34]EpjHuegvHnKqGocIHBJCqGCyyIlDDzajJk",228,0.995633,34,229,1,228,1,1,0,1,1,117,117,112,111,36
"3301",0,"[29]EiopGxHnKqGocIHBJChCanivmjJgD",236,0.995781,29,237,1,236,1,1,0,1,1,112,112,125,124,37
"3302",1,"[29]EiopGxHnKqGocIHBJChCanivmjJgD",225,0.995575,29,226,1,225,1,1,0,1,1,118,118,108,107,37
"3303",2,"[29]EiopGxHnKqGocIHBJChCanivmjJgD",238,0.995816,29,239,1,238,1,1,0,1,1,108,108,131,130,37
"3304",3,"[29]EiopGxHnKqGocIHBJChCanivmjJgD",221,0.995495,29,222,1,221,1,1,0,1,1,123,123,99,98,37
"3305",4,"[29]EiopGxHnKqGocIHBJChCanivmjJgD",235,0.995763,29,236,1,235,1,1,0,1,1,112,112,124,123,37
"3306",5,"[29]EiopGxHnKqGocIHBJChCanivmjJgD",226,0.995595,29,227,1,226,1,1,0,1,1,117,117,110,109,37
"3307",6,"[29]EiopGxHnKqGocIHBJChCanivmjJgD",231,0.99569,29,232,1,231,1,1,0,1,1,114,114,118,117,37
"3308",7,"[29]EiopGxHnKqGocIHBJChCanivmjJgD",238,0.995816,29,239,1,238,1,1,0,1,1,108,108,131,130,37
"3309",8,"[29]EiopGxHnKqGocIHBJChCanivmjJgD",241,0.995868,29,242,1,241,1,1,0,1,1,105,105,137,136,37
"3310",9,"[29]EiopGxHnKqGocIHBJChCanivmjJgD",240,0.995851,29,241,1,240,1,1,0,1,1,110,110,131,130,37
"3311",10,"[29]EiopGxHnKqGocIHBJChCanivmjJgD",228,0.995633,29,229,1,228,1,1,0,1,1,117,117,112,111,37
"3312",11,"[29]EiopGxHnKqGocIHBJChCanivmjJgD",228,0.995633,29,229,1,228,1,1,0,1,1,116,116,113,112,37
"3313",12,"[29]EiopGxHnKqGocIHBJChCanivmjJgD",225,0.995575,29,226,1,225,1,1,0,1,1,118,118,108,107,37
"3314",13,"[29]EiopGxHnKqGocIHBJChCanivmjJgD",223,0.995536,29,224,1,223,1,1,0,1,1,121,121,103,102,37
"3315",14,"[29]EiopGxHnKqGocIHBJChCanivmjJgD",227,0.995614,29,228,1,227,1,1,0,1,1,116,116,112,111,37
"3316",15,"[29]EiopGxHnKqGocIHBJChCanivmjJgD",227,0.995614,29,228,1,227,1,1,0,1,1,117,117,111,110,37
"3317",16,"[29]EiopGxHnKqGocIHBJChCanivmjJgD",235,0.995763,29,236,1,235,1,1,0,1,1,111,111,125,124,37
"3318",17,"[29]EiopGxHnKqGocIHBJChCanivmjJgD",227,0.995614,29,228,1,227,1,1,0,1,1,116,116,112,111,37
"3319",18,"[29]EiopGxHnKqGocIHBJChCanivmjJgD",233,0.995726,29,234,1,233,1,1,0,1,1,111,111,123,122,37
"3320",19,"[29]EiopGxHnKqGocIHBJChCanivmjJgD",234,0.995745,29,235,1,234,1,1,0,1,1,111,111,124,123,37
"3321",20,"[29]EiopGxHnKqGocIHBJChCanivmjJgD",225,0.995575,29,226,1,225,1,1,0,1,1,121,121,105,104,37
"3322",21,"[29]EiopGxHnKqGocIHBJChCanivmjJgD",230,0.995671,29,231,1,230,1,1,0,1,1,115,115,116,115,37
"3323",22,"[29]EiopGxHnKqGocIHBJChCanivmjJgD",237,0.995798,29,238,1,237,1,1,0,1,1,110,110,128,127,37
"3324",23,"[29]EiopGxHnKqGocIHBJChCanivmjJgD",239,0.995833,29,240,1,239,1,1,0,1,1,108,108,132,131,37
"3325",24,"[29]EiopGxHnKqGocIHBJChCanivmjJgD",231,0.99569,29,232,1,231,1,1,0,1,1,113,113,119,118,37
"3326",25,"[29]EiopGxHnKqGocIHBJChCanivmjJgD",228,0.995633,29,229,1,228,1,1,0,1,1,116,116,113,112,37
"3327",26,"[29]EiopGxHnKqGocIHBJChCanivmjJgD",232,0.995708,29,233,1,232,1,1,0,1,1,113,113,120,119,37
"3328",27,"[29]EiopGxHnKqGocIHBJChCanivmjJgD",228,0.995633,29,229,1,228,1,1,0,1,1,117,117,112,111,37
"3329",28,"[29]EiopGxHnKqGocIHBJChCanivmjJgD",232,0.995708,29,233,1,232,1,1,0,1,1,114,114,119,118,37
"3330",29,"[29]EiopGxHnKqGocIHBJChCanivmjJgD",230,0.995671,29,231,1,230,1,1,0,1,1,114,114,117,116,37
"3331",30,"[29]EiopGxHnKqGocIHBJChCanivmjJgD",215,0.99537,29,216,1,215,1,1,0,1,1,127,127,89,88,37
"3332",31,"[29]EiopGxHnKqGocIHBJChCanivmjJgD",232,0.995708,29,233,1,232,1,1,0,1,1,112,112,121,120,37
"3333",32,"[29]EiopGxHnKqGocIHBJChCanivmjJgD",233,0.995726,29,234,1,233,1,1,0,1,1,112,112,122,121,37
"3334",33,"[29]EiopGxHnKqGocIHBJChCanivmjJgD",231,0.99569,29,232,1,231,1,1,0,1,1,115,115,117,116,37
"3335",34,"[29]EiopGxHnKqGocIHBJChCanivmjJgD",234,0.995745,29,235,1,234,1,1,0,1,1,114,114,121,120,37
"3336",35,"[29]EiopGxHnKqGocIHBJChCanivmjJgD",221,0.995495,29,222,1,221,1,1,0,1,1,121,121,101,100,37
"3337",36,"[29]EiopGxHnKqGocIHBJChCanivmjJgD",236,0.995781,29,237,1,236,1,1,0,1,1,109,109,128,127,37
"3338",37,"[29]EiopGxHnKqGocIHBJChCanivmjJgD",226,0.995595,29,227,1,226,1,1,0,1,1,117,117,110,109,37
"3339",38,"[29]EiopGxHnKqGocIHBJChCanivmjJgD",238,0.995816,29,239,1,238,1,1,0,1,1,108,108,131,130,37
"3340",39,"[29]EiopGxHnKqGocIHBJChCanivmjJgD",236,0.995781,29,237,1,236,1,1,0,1,1,111,111,126,125,37
"3341",40,"[29]EiopGxHnKqGocIHBJChCanivmjJgD",223,0.995536,29,224,1,223,1,1,0,1,1,120,120,104,103,37
"3342",41,"[29]EiopGxHnKqGocIHBJChCanivmjJgD",229,0.995652,29,230,1,229,1,1,0,1,1,115,115,115,114,37
"3343",42,"[29]EiopGxHnKqGocIHBJChCanivmjJgD",234,0.995745,29,235,1,234,1,1,0,1,1,113,113,122,121,37
"3344",43,"[29]EiopGxHnKqGocIHBJChCanivmjJgD",218,0.995434,29,219,1,218,1,1,0,1,1,123,123,96,95,37
"3345",44,"[29]EiopGxHnKqGocIHBJChCanivmjJgD",231,0.99569,29,232,1,231,1,1,0,1,1,119,119,113,112,37
"3346",45,"[29]EiopGxHnKqGocIHBJChCanivmjJgD",232,0.995708,29,233,1,232,1,1,0,1,1,113,113,120,119,37
"3347",46,"[29]EiopGxHnKqGocIHBJChCanivmjJgD",227,0.995614,29,228,1,227,1,1,0,1,1,118,118,110,109,37
"3348",47,"[29]EiopGxHnKqGocIHBJChCanivmjJgD",222,0.995516,29,223,1,222,1,1,0,1,1,121,121,102,101,37
"3349",48,"[29]EiopGxHnKqGocIHBJChCanivmjJgD",227,0.995614,29,228,1,227,1,1,0,1,1,117,117,111,110,37
"3350",49,"[29]EiopGxHnKqGocIHBJChCanivmjJgD",222,0.995516,29,223,1,222,1,1,0,1,1,121,121,102,101,37
"3351",50,"[29]EiopGxHnKqGocIHBJChCanivmjJgD",226,0.995595,29,227,1,226,1,1,0,1,1,118,118,109,108,37
"3352",51,"[29]EiopGxHnKqGocIHBJChCanivmjJgD",236,0.995781,29,237,1,236,1,1,0,1,1,109,109,128,127,37
"3353",52,"[29]EiopGxHnKqGocIHBJChCanivmjJgD",217,0.995413,29,218,1,217,1,1,0,1,1,124,124,94,93,37
"3354",53,"[29]EiopGxHnKqGocIHBJChCanivmjJgD",229,0.995652,29,230,1,229,1,1,0,1,1,115,115,115,114,37
"3355",54,"[29]EiopGxHnKqGocIHBJChCanivmjJgD",230,0.995671,29,231,1,230,1,1,0,1,1,115,115,116,115,37
"3356",55,"[29]EiopGxHnKqGocIHBJChCanivmjJgD",235,0.995763,29,236,1,235,1,1,0,1,1,115,115,121,120,37
"3357",56,"[29]EiopGxHnKqGocIHBJChCanivmjJgD",237,0.995798,29,238,1,237,1,1,0,1,1,109,109,129,128,37
"3358",57,"[29]EiopGxHnKqGocIHBJChCanivmjJgD",239,0.995833,29,240,1,239,1,1,0,1,1,107,107,133,132,37
"3359",58,"[29]EiopGxHnKqGocIHBJChCanivmjJgD",223,0.995536,29,224,1,223,1,1,0,1,1,119,119,105,104,37
"3360",59,"[29]EiopGxHnKqGocIHBJChCanivmjJgD",235,0.995763,29,236,1,235,1,1,0,1,1,112,112,124,123,37
"3361",60,"[29]EiopGxHnKqGocIHBJChCanivmjJgD",229,0.995652,29,230,1,229,1,1,0,1,1,116,116,114,113,37
"3362",61,"[29]EiopGxHnKqGocIHBJChCanivmjJgD",238,0.995816,29,239,1,238,1,1,0,1,1,107,107,132,131,37
"3363",62,"[29]EiopGxHnKqGocIHBJChCanivmjJgD",236,0.995781,29,237,1,236,1,1,0,1,1,109,109,128,127,37
"3364",63,"[29]EiopGxHnKqGocIHBJChCanivmjJgD",229,0.995652,29,230,1,229,1,1,0,1,1,115,115,115,114,37
"3365",64,"[29]EiopGxHnKqGocIHBJChCanivmjJgD",236,0.995781,29,237,1,236,1,1,0,1,1,113,113,124,123,37
"3366",65,"[29]EiopGxHnKqGocIHBJChCanivmjJgD",228,0.995633,29,229,1,228,1,1,0,1,1,115,115,114,113,37
"3367",66,"[29]EiopGxHnKqGocIHBJChCanivmjJgD",226,0.995595,29,227,1,226,1,1,0,1,1,117,117,110,109,37
"3368",67,"[29]EiopGxHnKqGocIHBJChCanivmjJgD",227,0.995614,29,228,1,227,1,1,0,1,1,116,116,112,111,37
"3369",68,"[29]EiopGxHnKqGocIHBJChCanivmjJgD",229,0.995652,29,230,1,229,1,1,0,1,1,116,116,114,113,37
"3370",69,"[29]EiopGxHnKqGocIHBJChCanivmjJgD",228,0.995633,29,229,1,228,1,1,0,1,1,117,117,112,111,37
"3371",70,"[29]EiopGxHnKqGocIHBJChCanivmjJgD",232,0.995708,29,233,1,232,1,1,0,1,1,112,112,121,120,37
"3372",71,"[29]EiopGxHnKqGocIHBJChCanivmjJgD",230,0.995671,29,231,1,230,1,1,0,1,1,114,114,117,116,37
"3373",72,"[29]EiopGxHnKqGocIHBJChCanivmjJgD",229,0.995652,29,230,1,229,1,1,0,1,1,115,115,115,114,37
"3374",73,"[29]EiopGxHnKqGocIHBJChCanivmjJgD",228,0.995633,29,229,1,228,1,1,0,1,1,116,116,113,112,37
"3375",74,"[29]EiopGxHnKqGocIHBJChCanivmjJgD",228,0.995633,29,229,1,228,1,1,0,1,1,115,115,114,113,37
"3376",75,"[29]EiopGxHnKqGocIHBJChCanivmjJgD",242,0.995885,29,243,1,242,1,1,0,1,1,105,105,138,137,37
"3377",76,"[29]EiopGxHnKqGocIHBJChCanivmjJgD",224,0.995556,29,225,1,224,1,1,0,1,1,120,120,105,104,37
"3378",77,"[29]EiopGxHnKqGocIHBJChCanivmjJgD",222,0.995516,29,223,1,222,1,1,0,1,1,122,122,101,100,37
"3379",78,"[29]EiopGxHnKqGocIHBJChCanivmjJgD",238,0.995816,29,239,1,238,1,1,0,1,1,108,108,131,130,37
"3380",79,"[29]EiopGxHnKqGocIHBJChCanivmjJgD",229,0.995652,29,230,1,229,1,1,0,1,1,115,115,115,114,37
"3381",80,"[29]EiopGxHnKqGocIHBJChCanivmjJgD",237,0.995798,29,238,1,237,1,1,0,1,1,109,109,129,128,37
"3382",81,"[29]EiopGxHnKqGocIHBJChCanivmjJgD",228,0.995633,29,229,1,228,1,1,0,1,1,117,117,112,111,37
"3383",82,"[29]EiopGxHnKqGocIHBJChCanivmjJgD",229,0.995652,29,230,1,229,1,1,0,1,1,117,117,113,112,37
"3384",83,"[29]EiopGxHnKqGocIHBJChCanivmjJgD",226,0.995595,29,227,1,226,1,1,0,1,1,118,118,109,108,37
"3385",84,"[29]EiopGxHnKqGocIHBJChCanivmjJgD",240,0.995851,29,241,1,240,1,1,0,1,1,107,107,134,133,37
"3386",85,"[29]EiopGxHnKqGocIHBJChCanivmjJgD",231,0.99569,29,232,1,231,1,1,0,1,1,115,115,117,116,37
"3387",86,"[29]EiopGxHnKqGocIHBJChCanivmjJgD",217,0.995413,29,218,1,217,1,1,0,1,1,126,126,92,91,37
"3388",87,"[29]EiopGxHnKqGocIHBJChCanivmjJgD",224,0.995556,29,225,1,224,1,1,0,1,1,119,119,106,105,37
"3389",88,"[29]EiopGxHnKqGocIHBJChCanivmjJgD",223,0.995536,29,224,1,223,1,1,0,1,1,119,119,105,104,37
"3390",89,"[29]EiopGxHnKqGocIHBJChCanivmjJgD",221,0.995495,29,222,1,221,1,1,0,1,1,126,126,96,95,37
"3391",90,"[29]EiopGxHnKqGocIHBJChCanivmjJgD",233,0.995726,29,234,1,233,1,1,0,1,1,112,112,122,121,37
"3392",91,"[29]EiopGxHnKqGocIHBJChCanivmjJgD",231,0.99569,29,232,1,231,1,1,0,1,1,113,113,119,118,37
"3393",92,"[29]EiopGxHnKqGocIHBJChCanivmjJgD",237,0.995798,29,238,1,237,1,1,0,1,1,110,110,128,127,37
"3394",93,"[29]EiopGxHnKqGocIHBJChCanivmjJgD",240,0.995851,29,241,1,240,1,1,0,1,1,108,108,133,132,37
"3395",94,"[29]EiopGxHnKqGocIHBJChCanivmjJgD",227,0.995614,29,228,1,227,1,1,0,1,1,117,117,111,110,37
"3396",95,"[29]EiopGxHnKqGocIHBJChCanivmjJgD",226,0.995595,29,227,1,226,1,1,0,1,1,118,118,109,108,37
"3397",96,"[29]EiopGxHnKqGocIHBJChCanivmjJgD",239,0.995833,29,240,1,239,1,1,0,1,1,110,110,130,129,37
"3398",97,"[29]EiopGxHnKqGocIHBJChCanivmjJgD",229,0.995652,29,230,1,229,1,1,0,1,1,115,115,115,114,37
"3399",98,"[29]EiopGxHnKqGocIHBJChCanivmjJgD",227,0.995614,29,228,1,227,1,1,0,1,1,116,116,112,111,37
"3400",99,"[29]EiopGxHnKqGocIHBJChCanivmjJgD",231,0.99569,29,232,1,231,1,1,0,1,1,114,114,118,117,37
"3401",0,"[23]EaHxHnKqGocIHcJCqnCAcey",229,0.995652,23,230,1,229,1,1,0,1,1,116,116,114,113,39
"3402",1,"[23]EaHxHnKqGocIHcJCqnCAcey",228,0.995633,23,229,1,228,1,1,0,1,1,117,117,112,111,39
"3403",2,"[23]EaHxHnKqGocIHcJCqnCAcey",230,0.995671,23,231,1,230,1,1,0,1,1,116,116,115,114,39
"3404",3,"[23]EaHxHnKqGocIHcJCqnCAcey",234,0.995745,23,235,1,234,1,1,0,1,1,114,114,121,120,39
"3405",4,"[23]EaHxHnKqGocIHcJCqnCAcey",230,0.995671,23,231,1,230,1,1,0,1,1,115,115,116,115,39
"3406",5,"[23]EaHxHnKqGocIHcJCqnCAcey",220,0.995475,23,221,1,220,1,1,0,1,1,124,124,97,96,39
"3407",6,"[23]EaHxHnKqGocIHcJCqnCAcey",232,0.995708,23,233,1,232,1,1,0,1,1,115,115,118,117,39
"3408",7,"[23]EaHxHnKqGocIHcJCqnCAcey",220,0.995475,23,221,1,220,1,1,0,1,1,123,123,98,97,39
"3409",8,"[23]EaHxHnKqGocIHcJCqnCAcey",224,0.995556,23,225,1,224,1,1,0,1,1,120,120,105,104,39
"3410",9,"[23]EaHxHnKqGocIHcJCqnCAcey",234,0.995745,23,235,1,234,1,1,0,1,1,112,112,123,122,39
"3411",10,"[23]EaHxHnKqGocIHcJCqnCAcey",230,0.995671,23,231,1,230,1,1,0,1,1,115,115,116,115,39
"3412",11,"[23]EaHxHnKqGocIHcJCqnCAcey",229,0.995652,23,230,1,229,1,1,0,1,1,116,116,114,113,39
"3413",12,"[23]EaHxHnKqGocIHcJCqnCAcey",237,0.995798,23,238,1,237,1,1,0,1,1,108,108,130,129,39
"3414",13,"[23]EaHxHnKqGocIHcJCqnCAcey",235,0.995763,23,236,1,235,1,1,0,1,1,112,112,124,123,39
"3415",14,"[23]EaHxHnKqGocIHcJCqnCAcey",229,0.995652,23,230,1,229,1,1,0,1,1,117,117,113,112,39
"3416",15,"[23]EaHxHnKqGocIHcJCqnCAcey",240,0.995851,23,241,1,240,1,1,0,1,1,106,106,135,134,39
"3417",16,"[23]EaHxHnKqGocIHcJCqnCAcey",232,0.995708,23,233,1,232,1,1,0,1,1,113,113,120,119,39
"3418",17,"[23]EaHxHnKqGocIHcJCqnCAcey",235,0.995763,23,236,1,235,1,1,0,1,1,110,110,126,125,39
"3419",18,"[23]EaHxHnKqGocIHcJCqnCAcey",225,0.995575,23,226,1,225,1,1,0,1,1,120,120,106,105,39
"3420",19,"[23]EaHxHnKqGocIHcJCqnCAcey",229,0.995652,23,230,1,229,1,1,0,1,1,120,120,110,109,39
"3421",20,"[23]EaHxHnKqGocIHcJCqnCAcey",225,0.995575,23,226,1,225,1,1,0,1,1,119,119,107,106,39
"3422",21,"[23]EaHxHnKqGocIHcJCqnCAcey",228,0.995633,23,229,1,228,1,1,0,1,1,116,116,113,112,39
"3423",22,"[23]EaHxHnKqGocIHcJCqnCAcey",235,0.995763,23,236,1,235,1,1,0,1,1,117,117,119,118,39
"3424",23,"[23]EaHxHnKqGocIHcJCqnCAcey",232,0.995708,23,233,1,232,1,1,0,1,1,116,116,117,116,39
"3425",24,"[23]EaHxHnKqGocIHcJCqnCAcey",222,0.995516,23,223,1,222,1,1,0,1,1,120,120,103,102,39
"3426",25,"[23]EaHxHnKqGocIHcJCqnCAcey",247,0.995968,23,248,1,247,1,1,0,1,1,100,100,148,147,39
"3427",26,"[23]EaHxHnKqGocIHcJCqnCAcey",233,0.995726,23,234,1,233,1,1,0,1,1,114,114,120,119,39
"3428",27,"[23]EaHxHnKqGocIHcJCqnCAcey",229,0.995652,23,230,1,229,1,1,0,1,1,115,115,115,114,39
"3429",28,"[23]EaHxHnKqGocIHcJCqnCAcey",228,0.995633,23,229,1,228,1,1,0,1,1,116,116,113,112,39
"3430",29,"[23]EaHxHnKqGocIHcJCqnCAcey",231,0.99569,23,232,1,231,1,1,0,1,1,115,115,117,116,39
"3431",30,"[23]EaHxHnKqGocIHcJCqnCAcey",237,0.995798,23,238,1,237,1,1,0,1,1,112,112,126,125,39
"3432",31,"[23]EaHxHnKqGocIHcJCqnCAcey",232,0.995708,23,233,1,232,1,1,0,1,1,113,113,120,119,39
"3433",32,"[23]EaHxHnKqGocIHcJCqnCAcey",220,0.995475,23,221,1,220,1,1,0,1,1,123,123,98,97,39
"3434",33,"[23]EaHxHnKqGocIHcJCqnCAcey",224,0.995556,23,225,1,224,1,1,0,1,1,119,119,106,105,39
"3435",34,"[23]EaHxHnKqGocIHcJCqnCAcey",224,0.995556,23,225,1,224,1,1,0,1,1,120,120,105,104,39
"3436",35,"[23]EaHxHnKqGocIHcJCqnCAcey",221,0.995495,23,222,1,221,1,1,0,1,1,123,123,99,98,39
"3437",36,"[23]EaHxHnKqGocIHcJCqnCAcey",230,0.995671,23,231,1,230,1,1,0,1,1,114,114,117,116,39
"3438",37,"[23]EaHxHnKqGocIHcJCqnCAcey",240,0.995851,23,241,1,240,1,1,0,1,1,107,107,134,133,39
"3439",38,"[23]EaHxHnKqGocIHcJCqnCAcey",232,0.995708,23,233,1,232,1,1,0,1,1,112,112,121,120,39
"3440",39,"[23]EaHxHnKqGocIHcJCqnCAcey",232,0.995708,23,233,1,232,1,1,0,1,1,113,113,120,119,39
"3441",40,"[23]EaHxHnKqGocIHcJCqnCAcey",234,0.995745,23,235,1,234,1,1,0,1,1,112,112,123,122,39
"3442",41,"[23]EaHxHnKqGocIHcJCqnCAcey",233,0.995726,23,234,1,233,1,1,0,1,1,113,113,121,120,39
"3443",42,"[23]EaHxHnKqGocIHcJCqnCAcey",234,0.995745,23,235,1,234,1,1,0,1,1,111,111,124,123,39
"3444",43,"[23]EaHxHnKqGocIHcJCqnCAcey",234,0.995745,23,235,1,234,1,1,0,1,1,112,112,123,122,39
"3445",44,"[23]EaHxHnKqGocIHcJCqnCAcey",232,0.995708,23,233,1,232,1,1,0,1,1,116,116,117,116,39
"3446",45,"[23]EaHxHnKqGocIHcJCqnCAcey",236,0.995781,23,237,1,236,1,1,0,1,1,109,109,128,127,39
"3447",46,"[23]EaHxHnKqGocIHcJCqnCAcey",230,0.995671,23,231,1,230,1,1,0,1,1,114,114,117,116,39
"3448",47,"[23]EaHxHnKqGocIHcJCqnCAcey",228,0.995633,23,229,1,228,1,1,0,1,1,117,117,112,111,39
"3449",48,"[23]EaHxHnKqGocIHcJCqnCAcey",242,0.995885,23,243,1,242,1,1,0,1,1,108,108,135,134,39
"3450",49,"[23]EaHxHnKqGocIHcJCqnCAcey",222,0.995516,23,223,1,222,1,1,0,1,1,120,120,103,102,39
"3451",50,"[23]EaHxHnKqGocIHcJCqnCAcey",228,0.995633,23,229,1,228,1,1,0,1,1,117,117,112,111,39
"3452",51,"[23]EaHxHnKqGocIHcJCqnCAcey",229,0.995652,23,230,1,229,1,1,0,1,1,115,115,115,114,39
"3453",52,"[23]EaHxHnKqGocIHcJCqnCAcey",236,0.995781,23,237,1,236,1,1,0,1,1,110,110,127,126,39
"3454",53,"[23]EaHxHnKqGocIHcJCqnCAcey",233,0.995726,23,234,1,233,1,1,0,1,1,112,112,122,121,39
"3455",54,"[23]EaHxHnKqGocIHcJCqnCAcey",220,0.995475,23,221,1,220,1,1,0,1,1,122,122,99,98,39
"3456",55,"[23]EaHxHnKqGocIHcJCqnCAcey",234,0.995745,23,235,1,234,1,1,0,1,1,111,111,124,123,39
"3457",56,"[23]EaHxHnKqGocIHcJCqnCAcey",246,0.995951,23,247,1,246,1,1,0,1,1,103,103,144,143,39
"3458",57,"[23]EaHxHnKqGocIHcJCqnCAcey",230,0.995671,23,231,1,230,1,1,0,1,1,115,115,116,115,39
"3459",58,"[23]EaHxHnKqGocIHcJCqnCAcey",237,0.995798,23,238,1,237,1,1,0,1,1,108,108,130,129,39
"3460",59,"[23]EaHxHnKqGocIHcJCqnCAcey",231,0.99569,23,232,1,231,1,1,0,1,1,114,114,118,117,39
"3461",60,"[23]EaHxHnKqGocIHcJCqnCAcey",227,0.995614,23,228,1,227,1,1,0,1,1,116,116,112,111,39
"3462",61,"[23]EaHxHnKqGocIHcJCqnCAcey",224,0.995556,23,225,1,224,1,1,0,1,1,120,120,105,104,39
"3463",62,"[23]EaHxHnKqGocIHcJCqnCAcey",227,0.995614,23,228,1,227,1,1,0,1,1,117,117,111,110,39
"3464",63,"[23]EaHxHnKqGocIHcJCqnCAcey",220,0.995475,23,221,1,220,1,1,0,1,1,123,123,98,97,39
"3465",64,"[23]EaHxHnKqGocIHcJCqnCAcey",242,0.995885,23,243,1,242,1,1,0,1,1,109,109,134,133,39
"3466",65,"[23]EaHxHnKqGocIHcJCqnCAcey",230,0.995671,23,231,1,230,1,1,0,1,1,114,114,117,116,39
"3467",66,"[23]EaHxHnKqGocIHcJCqnCAcey",226,0.995595,23,227,1,226,1,1,0,1,1,118,118,109,108,39
"3468",67,"[23]EaHxHnKqGocIHcJCqnCAcey",238,0.995816,23,239,1,238,1,1,0,1,1,109,109,130,129,39
"3469",68,"[23]EaHxHnKqGocIHcJCqnCAcey",223,0.995536,23,224,1,223,1,1,0,1,1,121,121,103,102,39
"3470",69,"[23]EaHxHnKqGocIHcJCqnCAcey",229,0.995652,23,230,1,229,1,1,0,1,1,115,115,115,114,39
"3471",70,"[23]EaHxHnKqGocIHcJCqnCAcey",222,0.995516,23,223,1,222,1,1,0,1,1,121,121,102,101,39
"3472",71,"[23]EaHxHnKqGocIHcJCqnCAcey",219,0.995455,23,220,1,219,1,1,0,1,1,124,124,96,95,39
"3473",72,"[23]EaHxHnKqGocIHcJCqnCAcey",239,0.995833,23,240,1,239,1,1,0,1,1,108,108,132,131,39
"3474",73,"[23]EaHxHnKqGocIHcJCqnCAcey",243,0.995902,23,244,1,243,1,1,0,1,1,104,104,140,139,39
"3475",74,"[23]EaHxHnKqGocIHcJCqnCAcey",228,0.995633,23,229,1,228,1,1,0,1,1,117,117,112,111,39
"3476",75,"[23]EaHxHnKqGocIHcJCqnCAcey",236,0.995781,23,237,1,236,1,1,0,1,1,112,112,125,124,39
"3477",76,"[23]EaHxHnKqGocIHcJCqnCAcey",232,0.995708,23,233,1,232,1,1,0,1,1,112,112,121,120,39
"3478",77,"[23]EaHxHnKqGocIHcJCqnCAcey",229,0.995652,23,230,1,229,1,1,0,1,1,115,115,115,114,39
"3479",78,"[23]EaHxHnKqGocIHcJCqnCAcey",226,0.995595,23,227,1,226,1,1,0,1,1,117,117,110,109,39
"3480",79,"[23]EaHxHnKqGocIHcJCqnCAcey",226,0.995595,23,227,1,226,1,1,0,1,1,122,122,105,104,39
"3481",80,"[23]EaHxHnKqGocIHcJCqnCAcey",227,0.995614,23,228,1,227,1,1,0,1,1,118,118,110,109,39
"3482",81,"[23]EaHxHnKqGocIHcJCqnCAcey",226,0.995595,23,227,1,226,1,1,0,1,1,117,117,110,109,39
"3483",82,"[23]EaHxHnKqGocIHcJCqnCAcey",226,0.995595,23,227,1,226,1,1,0,1,1,118,118,109,108,39
"3484",83,"[23]EaHxHnKqGocIHcJCqnCAcey",237,0.995798,23,238,1,237,1,1,0,1,1,109,109,129,128,39
"3485",84,"[23]EaHxHnKqGocIHcJCqnCAcey",215,0.99537,23,216,1,215,1,1,0,1,1,126,126,90,89,39
"3486",85,"[23]EaHxHnKqGocIHcJCqnCAcey",224,0.995556,23,225,1,224,1,1,0,1,1,119,119,106,105,39
"3487",86,"[23]EaHxHnKqGocIHcJCqnCAcey",223,0.995536,23,224,1,223,1,1,0,1,1,123,123,101,100,39
"3488",87,"[23]EaHxHnKqGocIHcJCqnCAcey",235,0.995763,23,236,1,235,1,1,0,1,1,110,110,126,125,39
"3489",88,"[23]EaHxHnKqGocIHcJCqnCAcey",237,0.995798,23,238,1,237,1,1,0,1,1,109,109,129,128,39
"3490",89,"[23]EaHxHnKqGocIHcJCqnCAcey",234,0.995745,23,235,1,234,1,1,0,1,1,113,113,122,121,39
"3491",90,"[23]EaHxHnKqGocIHcJCqnCAcey",230,0.995671,23,231,1,230,1,1,0,1,1,116,116,115,114,39
"3492",91,"[23]EaHxHnKqGocIHcJCqnCAcey",228,0.995633,23,229,1,228,1,1,0,1,1,117,117,112,111,39
"3493",92,"[23]EaHxHnKqGocIHcJCqnCAcey",232,0.995708,23,233,1,232,1,1,0,1,1,112,112,121,120,39
"3494",93,"[23]EaHxHnKqGocIHcJCqnCAcey",223,0.995536,23,224,1,223,1,1,0,1,1,121,121,103,102,39
"3495",94,"[23]EaHxHnKqGocIHcJCqnCAcey",235,0.995763,23,236,1,235,1,1,0,1,1,110,110,126,125,39
"3496",95,"[23]EaHxHnKqGocIHcJCqnCAcey",224,0.995556,23,225,1,224,1,1,0,1,1,119,119,106,105,39
"3497",96,"[23]EaHxHnKqGocIHcJCqnCAcey",221,0.995495,23,222,1,221,1,1,0,1,1,122,122,100,99,39
"3498",97,"[23]EaHxHnKqGocIHcJCqnCAcey",241,0.995868,23,242,1,241,1,1,0,1,1,106,106,136,135,39
"3499",98,"[23]EaHxHnKqGocIHcJCqnCAcey",234,0.995745,23,235,1,234,1,1,0,1,1,112,112,123,122,39
"3500",99,"[23]EaHxHnKqGocIHcJCqnCAcey",231,0.99569,23,232,1,231,1,1,0,1,1,113,113,119,118,39
"3501",0,"[31]EjfiwHnKqGocIHcJCujDfFBmGtvDgno",225,0.995575,31,226,1,225,1,1,0,1,1,118,118,108,107,40
"3502",1,"[31]EjfiwHnKqGocIHcJCujDfFBmGtvDgno",231,0.99569,31,232,1,231,1,1,0,1,1,114,114,118,117,40
"3503",2,"[31]EjfiwHnKqGocIHcJCujDfFBmGtvDgno",234,0.995745,31,235,1,234,1,1,0,1,1,112,112,123,122,40
"3504",3,"[31]EjfiwHnKqGocIHcJCujDfFBmGtvDgno",227,0.995614,31,228,1,227,1,1,0,1,1,117,117,111,110,40
"3505",4,"[31]EjfiwHnKqGocIHcJCujDfFBmGtvDgno",242,0.995885,31,243,1,242,1,1,0,1,1,106,106,137,136,40
"3506",5,"[31]EjfiwHnKqGocIHcJCujDfFBmGtvDgno",228,0.995633,31,229,1,228,1,1,0,1,1,115,115,114,113,40
"3507",6,"[31]EjfiwHnKqGocIHcJCujDfFBmGtvDgno",231,0.99569,31,232,1,231,1,1,0,1,1,114,114,118,117,40
"3508",7,"[31]EjfiwHnKqGocIHcJCujDfFBmGtvDgno",230,0.995671,31,231,1,230,1,1,0,1,1,114,114,117,116,40
"3509",8,"[31]EjfiwHnKqGocIHcJCujDfFBmGtvDgno",227,0.995614,31,228,1,227,1,1,0,1,1,116,116,112,111,40
"3510",9,"[31]EjfiwHnKqGocIHcJCujDfFBmGtvDgno",233,0.995726,31,234,1,233,1,1,0,1,1,111,111,123,122,40
"3511",10,"[31]EjfiwHnKqGocIHcJCujDfFBmGtvDgno",238,0.995816,31,239,1,238,1,1,0,1,1,108,108,131,130,40
"3512",11,"[31]EjfiwHnKqGocIHcJCujDfFBmGtvDgno",229,0.995652,31,230,1,229,1,1,0,1,1,115,115,115,114,40
"3513",12,"[31]EjfiwHnKqGocIHcJCujDfFBmGtvDgno",225,0.995575,31,226,1,225,1,1,0,1,1,119,119,107,106,40
"3514",13,"[31]EjfiwHnKqGocIHcJCujDfFBmGtvDgno",234,0.995745,31,235,1,234,1,1,0,1,1,112,112,123,122,40
"3515",14,"[31]EjfiwHnKqGocIHcJCujDfFBmGtvDgno",236,0.995781,31,237,1,236,1,1,0,1,1,109,109,128,127,40
"3516",15,"[31]EjfiwHnKqGocIHcJCujDfFBmGtvDgno",218,0.995434,31,219,1,218,1,1,0,1,1,123,123,96,95,40
"3517",16,"[31]EjfiwHnKqGocIHcJCujDfFBmGtvDgno",237,0.995798,31,238,1,237,1,1,0,1,1,108,108,130,129,40
"3518",17,"[31]EjfiwHnKqGocIHcJCujDfFBmGtvDgno",226,0.995595,31,227,1,226,1,1,0,1,1,118,118,109,108,40
"3519",18,"[31]EjfiwHnKqGocIHcJCujDfFBmGtvDgno",236,0.995781,31,237,1,236,1,1,0,1,1,110,110,127,126,40
"3520",19,"[31]EjfiwHnKqGocIHcJCujDfFBmGtvDgno",234,0.995745,31,235,1,234,1,1,0,1,1,112,112,123,122,40
"3521",20,"[31]EjfiwHnKqGocIHcJCujDfFBmGtvDgno",227,0.995614,31,228,1,227,1,1,0,1,1,116,116,112,111,40
"3522",21,"[31]EjfiwHnKqGocIHcJCujDfFBmGtvDgno",230,0.995671,31,231,1,230,1,1,0,1,1,115,115,116,115,40
"3523",22,"[31]EjfiwHnKqGocIHcJCujDfFBmGtvDgno",241,0.995868,31,242,1,241,1,1,0,1,1,108,108,134,133,40
"3524",23,"[31]EjfiwHnKqGocIHcJCujDfFBmGtvDgno",223,0.995536,31,224,1,223,1,1,0,1,1,121,121,103,102,40
"3525",24,"[31]EjfiwHnKqGocIHcJCujDfFBmGtvDgno",236,0.995781,31,237,1,236,1,1,0,1,1,110,110,127,126,40
"3526",25,"[31]EjfiwHnKqGocIHcJCujDfFBmGtvDgno",231,0.99569,31,232,1,231,1,1,0,1,1,113,113,119,118,40
"3527",26,"[31]EjfiwHnKqGocIHcJCujDfFBmGtvDgno",217,0.995413,31,218,1,217,1,1,0,1,1,125,125,93,92,40
"3528",27,"[31]EjfiwHnKqGocIHcJCujDfFBmGtvDgno",226,0.995595,31,227,1,226,1,1,0,1,1,118,118,109,108,40
"3529",28,"[31]EjfiwHnKqGocIHcJCujDfFBmGtvDgno",217,0.995413,31,218,1,217,1,1,0,1,1,124,124,94,93,40
"3530",29,"[31]EjfiwHnKqGocIHcJCujDfFBmGtvDgno",226,0.995595,31,227,1,226,1,1,0,1,1,117,117,110,109,40
"3531",30,"[31]EjfiwHnKqGocIHcJCujDfFBmGtvDgno",220,0.995475,31,221,1,220,1,1,0,1,1,122,122,99,98,40
"3532",31,"[31]EjfiwHnKqGocIHcJCujDfFBmGtvDgno",231,0.99569,31,232,1,231,1,1,0,1,1,118,118,114,113,40
"3533",32,"[31]EjfiwHnKqGocIHcJCujDfFBmGtvDgno",233,0.995726,31,234,1,233,1,1,0,1,1,111,111,123,122,40
"3534",33,"[31]EjfiwHnKqGocIHcJCujDfFBmGtvDgno",226,0.995595,31,227,1,226,1,1,0,1,1,119,119,108,107,40
"3535",34,"[31]EjfiwHnKqGocIHcJCujDfFBmGtvDgno",227,0.995614,31,228,1,227,1,1,0,1,1,118,118,110,109,40
"3536",35,"[31]EjfiwHnKqGocIHcJCujDfFBmGtvDgno",229,0.995652,31,230,1,229,1,1,0,1,1,118,118,112,111,40
"3537",36,"[31]EjfiwHnKqGocIHcJCujDfFBmGtvDgno",231,0.99569,31,232,1,231,1,1,0,1,1,113,113,119,118,40
"3538",37,"[31]EjfiwHnKqGocIHcJCujDfFBmGtvDgno",229,0.995652,31,230,1,229,1,1,0,1,1,117,117,113,112,40
"3539",38,"[31]EjfiwHnKqGocIHcJCujDfFBmGtvDgno",239,0.995833,31,240,1,239,1,1,0,1,1,107,107,133,132,40
"3540",39,"[31]EjfiwHnKqGocIHcJCujDfFBmGtvDgno",232,0.995708,31,233,1,232,1,1,0,1,1,114,114,119,118,40
"3541",40,"[31]EjfiwHnKqGocIHcJCujDfFBmGtvDgno",239,0.995833,31,240,1,239,1,1,0,1,1,110,110,130,129,40
"3542",41,"[31]EjfiwHnKqGocIHcJCujDfFBmGtvDgno",227,0.995614,31,228,1,227,1,1,0,1,1,116,116,112,111,40
"3543",42,"[31]EjfiwHnKqGocIHcJCujDfFBmGtvDgno",231,0.99569,31,232,1,231,1,1,0,1,1,114,114,118,117,40
"3544",43,"[31]EjfiwHnKqGocIHcJCujDfFBmGtvDgno",225,0.995575,31,226,1,225,1,1,0,1,1,119,119,107,106,40
"3545",44,"[31]EjfiwHnKqGocIHcJCujDfFBmGtvDgno",215,0.99537,31,216,1,215,1,1,0,1,1,127,127,89,88,40
"3546",45,"[31]EjfiwHnKqGocIHcJCujDfFBmGtvDgno",229,0.995652,31,230,1,229,1,1,0,1,1,116,116,114,113,40
"3547",46,"[31]EjfiwHnKqGocIHcJCujDfFBmGtvDgno",231,0.99569,31,232,1,231,1,1,0,1,1,117,117,115,114,40
"3548",47,"[31]EjfiwHnKqGocIHcJCujDfFBmGtvDgno",225,0.995575,31,226,1,225,1,1,0,1,1,120,120,106,105,40
"3549",48,"[31]EjfiwHnKqGocIHcJCujDfFBmGtvDgno",223,0.995536,31,224,1,223,1,1,0,1,1,120,120,104,103,40
"3550",49,"[31]EjfiwHnKqGocIHcJCujDfFBmGtvDgno",222,0.995516,31,223,1,222,1,1,0,1,1,121,121,102,101,40
"3551",50,"[31]EjfiwHnKqGocIHcJCujDfFBmGtvDgno",235,0.995763,31,236,1,235,1,1,0,1,1,111,111,125,124,40
"3552",51,"[31]EjfiwHnKqGocIHcJCujDfFBmGtvDgno",230,0.995671,31,231,1,230,1,1,0,1,1,115,115,116,115,40
"3553",52,"[31]EjfiwHnKqGocIHcJCujDfFBmGtvDgno",226,0.995595,31,227,1,226,1,1,0,1,1,118,118,109,108,40
"3554",53,"[31]EjfiwHnKqGocIHcJCujDfFBmGtvDgno",234,0.995745,31,235,1,234,1,1,0,1,1,112,112,123,122,40
"3555",54,"[31]EjfiwHnKqGocIHcJCujDfFBmGtvDgno",225,0.995575,31,226,1,225,1,1,0,1,1,119,119,107,106,40
"3556",55,"[31]EjfiwHnKqGocIHcJCujDfFBmGtvDgno",231,0.99569,31,232,1,231,1,1,0,1,1,113,113,119,118,40
"3557",56,"[31]EjfiwHnKqGocIHcJCujDfFBmGtvDgno",229,0.995652,31,230,1,229,1,1,0,1,1,116,116,114,113,40
"3558",57,"[31]EjfiwHnKqGocIHcJCujDfFBmGtvDgno",223,0.995536,31,224,1,223,1,1,0,1,1,120,120,104,103,40
"3559",58,"[31]EjfiwHnKqGocIHcJCujDfFBmGtvDgno",222,0.995516,31,223,1,222,1,1,0,1,1,121,121,102,101,40
"3560",59,"[31]EjfiwHnKqGocIHcJCujDfFBmGtvDgno",235,0.995763,31,236,1,235,1,1,0,1,1,110,110,126,125,40
"3561",60,"[31]EjfiwHnKqGocIHcJCujDfFBmGtvDgno",228,0.995633,31,229,1,228,1,1,0,1,1,116,116,113,112,40
"3562",61,"[31]EjfiwHnKqGocIHcJCujDfFBmGtvDgno",228,0.995633,31,229,1,228,1,1,0,1,1,117,117,112,111,40
"3563",62,"[31]EjfiwHnKqGocIHcJCujDfFBmGtvDgno",228,0.995633,31,229,1,228,1,1,0,1,1,115,115,114,113,40
"3564",63,"[31]EjfiwHnKqGocIHcJCujDfFBmGtvDgno",223,0.995536,31,224,1,223,1,1,0,1,1,119,119,105,104,40
"3565",64,"[31]EjfiwHnKqGocIHcJCujDfFBmGtvDgno",225,0.995575,31,226,1,225,1,1,0,1,1,119,119,107,106,40
"3566",65,"[31]EjfiwHnKqGocIHcJCujDfFBmGtvDgno",237,0.995798,31,238,1,237,1,1,0,1,1,109,109,129,128,40
"3567",66,"[31]EjfiwHnKqGocIHcJCujDfFBmGtvDgno",222,0.995516,31,223,1,222,1,1,0,1,1,121,121,102,101,40
"3568",67,"[31]EjfiwHnKqGocIHcJCujDfFBmGtvDgno",226,0.995595,31,227,1,226,1,1,0,1,1,117,117,110,109,40
"3569",68,"[31]EjfiwHnKqGocIHcJCujDfFBmGtvDgno",237,0.995798,31,238,1,237,1,1,0,1,1,110,110,128,127,40
"3570",69,"[31]EjfiwHnKqGocIHcJCujDfFBmGtvDgno",231,0.99569,31,232,1,231,1,1,0,1,1,114,114,118,117,40
"3571",70,"[31]EjfiwHnKqGocIHcJCujDfFBmGtvDgno",237,0.995798,31,238,1,237,1,1,0,1,1,110,110,128,127,40
"3572",71,"[31]EjfiwHnKqGocIHcJCujDfFBmGtvDgno",242,0.995885,31,243,1,242,1,1,0,1,1,105,105,138,137,40
"3573",72,"[31]EjfiwHnKqGocIHcJCujDfFBmGtvDgno",232,0.995708,31,233,1,232,1,1,0,1,1,114,114,119,118,40
"3574",73,"[31]EjfiwHnKqGocIHcJCujDfFBmGtvDgno",223,0.995536,31,224,1,223,1,1,0,1,1,119,119,105,104,40
"3575",74,"[31]EjfiwHnKqGocIHcJCujDfFBmGtvDgno",226,0.995595,31,227,1,226,1,1,0,1,1,118,118,109,108,40
"3576",75,"[31]EjfiwHnKqGocIHcJCujDfFBmGtvDgno",237,0.995798,31,238,1,237,1,1,0,1,1,111,111,127,126,40
"3577",76,"[31]EjfiwHnKqGocIHcJCujDfFBmGtvDgno",235,0.995763,31,236,1,235,1,1,0,1,1,110,110,126,125,40
"3578",77,"[31]EjfiwHnKqGocIHcJCujDfFBmGtvDgno",233,0.995726,31,234,1,233,1,1,0,1,1,111,111,123,122,40
"3579",78,"[31]EjfiwHnKqGocIHcJCujDfFBmGtvDgno",238,0.995816,31,239,1,238,1,1,0,1,1,107,107,132,131,40
"3580",79,"[31]EjfiwHnKqGocIHcJCujDfFBmGtvDgno",226,0.995595,31,227,1,226,1,1,0,1,1,117,117,110,109,40
"3581",80,"[31]EjfiwHnKqGocIHcJCujDfFBmGtvDgno",233,0.995726,31,234,1,233,1,1,0,1,1,115,115,119,118,40
"3582",81,"[31]EjfiwHnKqGocIHcJCujDfFBmGtvDgno",236,0.995781,31,237,1,236,1,1,0,1,1,109,109,128,127,40
"3583",82,"[31]EjfiwHnKqGocIHcJCujDfFBmGtvDgno",235,0.995763,31,236,1,235,1,1,0,1,1,111,111,125,124,40
"3584",83,"[31]EjfiwHnKqGocIHcJCujDfFBmGtvDgno",226,0.995595,31,227,1,226,1,1,0,1,1,117,117,110,109,40
"3585",84,"[31]EjfiwHnKqGocIHcJCujDfFBmGtvDgno",226,0.995595,31,227,1,226,1,1,0,1,1,118,118,109,108,40
"3586",85,"[31]EjfiwHnKqGocIHcJCujDfFBmGtvDgno",242,0.995885,31,243,1,242,1,1,0,1,1,104,104,139,138,40
"3587",86,"[31]EjfiwHnKqGocIHcJCujDfFBmGtvDgno",226,0.995595,31,227,1,226,1,1,0,1,1,117,117,110,109,40
"3588",87,"[31]EjfiwHnKqGocIHcJCujDfFBmGtvDgno",238,0.995816,31,239,1,238,1,1,0,1,1,109,109,130,129,40
"3589",88,"[31]EjfiwHnKqGocIHcJCujDfFBmGtvDgno",231,0.99569,31,232,1,231,1,1,0,1,1,113,113,119,118,40
"3590",89,"[31]EjfiwHnKqGocIHcJCujDfFBmGtvDgno",239,0.995833,31,240,1,239,1,1,0,1,1,108,108,132,131,40
"3591",90,"[31]EjfiwHnKqGocIHcJCujDfFBmGtvDgno",233,0.995726,31,234,1,233,1,1,0,1,1,112,112,122,121,40
"3592",91,"[31]EjfiwHnKqGocIHcJCujDfFBmGtvDgno",220,0.995475,31,221,1,220,1,1,0,1,1,122,122,99,98,40
"3593",92,"[31]EjfiwHnKqGocIHcJCujDfFBmGtvDgno",228,0.995633,31,229,1,228,1,1,0,1,1,117,117,112,111,40
"3594",93,"[31]EjfiwHnKqGocIHcJCujDfFBmGtvDgno",230,0.995671,31,231,1,230,1,1,0,1,1,115,115,116,115,40
"3595",94,"[31]EjfiwHnKqGocIHcJCujDfFBmGtvDgno",226,0.995595,31,227,1,226,1,1,0,1,1,117,117,110,109,40
"3596",95,"[31]EjfiwHnKqGocIHcJCujDfFBmGtvDgno",241,0.995868,31,242,1,241,1,1,0,1,1,106,106,136,135,40
"3597",96,"[31]EjfiwHnKqGocIHcJCujDfFBmGtvDgno",236,0.995781,31,237,1,236,1,1,0,1,1,109,109,128,127,40
"3598",97,"[31]EjfiwHnKqGocIHcJCujDfFBmGtvDgno",233,0.995726,31,234,1,233,1,1,0,1,1,111,111,123,122,40
"3599",98,"[31]EjfiwHnKqGocIHcJCujDfFBmGtvDgno",230,0.995671,31,231,1,230,1,1,0,1,1,117,117,114,113,40
"3600",99,"[31]EjfiwHnKqGocIHcJCujDfFBmGtvDgno",240,0.995851,31,241,1,240,1,1,0,1,1,108,108,133,132,40
"3601",0,"[21]EwHnKqGocIHBJCrjylhow",236,0.995781,21,237,1,236,1,1,0,1,1,110,110,127,126,41
"3602",1,"[21]EwHnKqGocIHBJCrjylhow",231,0.99569,21,232,1,231,1,1,0,1,1,114,114,118,117,41
"3603",2,"[21]EwHnKqGocIHBJCrjylhow",222,0.995516,21,223,1,222,1,1,0,1,1,121,121,102,101,41
"3604",3,"[21]EwHnKqGocIHBJCrjylhow",228,0.995633,21,229,1,228,1,1,0,1,1,116,116,113,112,41
"3605",4,"[21]EwHnKqGocIHBJCrjylhow",234,0.995745,21,235,1,234,1,1,0,1,1,111,111,124,123,41
"3606",5,"[21]EwHnKqGocIHBJCrjylhow",228,0.995633,21,229,1,228,1,1,0,1,1,117,117,112,111,41
"3607",6,"[21]EwHnKqGocIHBJCrjylhow",239,0.995833,21,240,1,239,1,1,0,1,1,108,108,132,131,41
"3608",7,"[21]EwHnKqGocIHBJCrjylhow",224,0.995556,21,225,1,224,1,1,0,1,1,119,119,106,105,41
"3609",8,"[21]EwHnKqGocIHBJCrjylhow",233,0.995726,21,234,1,233,1,1,0,1,1,114,114,120,119,41
"3610",9,"[21]EwHnKqGocIHBJCrjylhow",227,0.995614,21,228,1,227,1,1,0,1,1,117,117,111,110,41
"3611",10,"[21]EwHnKqGocIHBJCrjylhow",235,0.995763,21,236,1,235,1,1,0,1,1,113,113,123,122,41
"3612",11,"[21]EwHnKqGocIHBJCrjylhow",231,0.99569,21,232,1,231,1,1,0,1,1,115,115,117,116,41
"3613",12,"[21]EwHnKqGocIHBJCrjylhow",234,0.995745,21,235,1,234,1,1,0,1,1,111,111,124,123,41
"3614",13,"[21]EwHnKqGocIHBJCrjylhow",222,0.995516,21,223,1,222,1,1,0,1,1,122,122,101,100,41
"3615",14,"[21]EwHnKqGocIHBJCrjylhow",232,0.995708,21,233,1,232,1,1,0,1,1,113,113,120,119,41
"3616",15,"[21]EwHnKqGocIHBJCrjylhow",227,0.995614,21,228,1,227,1,1,0,1,1,118,118,110,109,41
"3617",16,"[21]EwHnKqGocIHBJCrjylhow",238,0.995816,21,239,1,238,1,1,0,1,1,108,108,131,130,41
"3618",17,"[21]EwHnKqGocIHBJCrjylhow",229,0.995652,21,230,1,229,1,1,0,1,1,116,116,114,113,41
"3619",18,"[21]EwHnKqGocIHBJCrjylhow",230,0.995671,21,231,1,230,1,1,0,1,1,116,116,115,114,41
"3620",19,"[21]EwHnKqGocIHBJCrjylhow",241,0.995868,21,242,1,241,1,1,0,1,1,106,106,136,135,41
"3621",20,"[21]EwHnKqGocIHBJCrjylhow",231,0.99569,21,232,1,231,1,1,0,1,1,114,114,118,117,41
"3622",21,"[21]EwHnKqGocIHBJCrjylhow",228,0.995633,21,229,1,228,1,1,0,1,1,119,119,110,109,41
"3623",22,"[21]EwHnKqGocIHBJCrjylhow",226,0.995595,21,227,1,226,1,1,0,1,1,118,118,109,108,41
"3624",23,"[21]EwHnKqGocIHBJCrjylhow",225,0.995575,21,226,1,225,1,1,0,1,1,119,119,107,106,41
"3625",24,"[21]EwHnKqGocIHBJCrjylhow",223,0.995536,21,224,1,223,1,1,0,1,1,120,120,104,103,41
"3626",25,"[21]EwHnKqGocIHBJCrjylhow",237,0.995798,21,238,1,237,1,1,0,1,1,110,110,128,127,41
"3627",26,"[21]EwHnKqGocIHBJCrjylhow",225,0.995575,21,226,1,225,1,1,0,1,1,119,119,107,106,41
"3628",27,"[21]EwHnKqGocIHBJCrjylhow",233,0.995726,21,234,1,233,1,1,0,1,1,113,113,121,120,41
"3629",28,"[21]EwHnKqGocIHBJCrjylhow",227,0.995614,21,228,1,227,1,1,0,1,1,117,117,111,110,41
"3630",29,"[21]EwHnKqGocIHBJCrjylhow",235,0.995763,21,236,1,235,1,1,0,1,1,112,112,124,123,41
"3631",30,"[21]EwHnKqGocIHBJCrjylhow",244,0.995918,21,245,1,244,1,1,0,1,1,105,105,140,139,41
"3632",31,"[21]EwHnKqGocIHBJCrjylhow",223,0.995536,21,224,1,223,1,1,0,1,1,121,121,103,102,41
"3633",32,"[21]EwHnKqGocIHBJCrjylhow",227,0.995614,21,228,1,227,1,1,0,1,1,117,117,111,110,41
"3634",33,"[21]EwHnKqGocIHBJCrjylhow",224,0.995556,21,225,1,224,1,1,0,1,1,119,119,106,105,41
"3635",34,"[21]EwHnKqGocIHBJCrjylhow",234,0.995745,21,235,1,234,1,1,0,1,1,112,112,123,122,41
"3636",35,"[21]EwHnKqGocIHBJCrjylhow",230,0.995671,21,231,1,230,1,1,0,1,1,115,115,116,115,41
"3637",36,"[21]EwHnKqGocIHBJCrjylhow",235,0.995763,21,236,1,235,1,1,0,1,1,114,114,122,121,41
"3638",37,"[21]EwHnKqGocIHBJCrjylhow",224,0.995556,21,225,1,224,1,1,0,1,1,122,122,103,102,41
"3639",38,"[21]EwHnKqGocIHBJCrjylhow",233,0.995726,21,234,1,233,1,1,0,1,1,113,113,121,120,41
"3640",39,"[21]EwHnKqGocIHBJCrjylhow",234,0.995745,21,235,1,234,1,1,0,1,1,111,111,124,123,41
"3641",40,"[21]EwHnKqGocIHBJCrjylhow",231,0.99569,21,232,1,231,1,1,0,1,1,114,114,118,117,41
"3642",41,"[21]EwHnKqGocIHBJCrjylhow",226,0.995595,21,227,1,226,1,1,0,1,1,118,118,109,108,41
"3643",42,"[21]EwHnKqGocIHBJCrjylhow",231,0.99569,21,232,1,231,1,1,0,1,1,114,114,118,117,41
"3644",43,"[21]EwHnKqGocIHBJCrjylhow",233,0.995726,21,234,1,233,1,1,0,1,1,113,113,121,120,41
"3645",44,"[21]EwHnKqGocIHBJCrjylhow",231,0.99569,21,232,1,231,1,1,0,1,1,114,114,118,117,41
"3646",45,"[21]EwHnKqGocIHBJCrjylhow",229,0.995652,21,230,1,229,1,1,0,1,1,118,118,112,111,41
"3647",46,"[21]EwHnKqGocIHBJCrjylhow",228,0.995633,21,229,1,228,1,1,0,1,1,118,118,111,110,41
"3648",47,"[21]EwHnKqGocIHBJCrjylhow",245,0.995935,21,246,1,245,1,1,0,1,1,102,102,144,143,41
"3649",48,"[21]EwHnKqGocIHBJCrjylhow",235,0.995763,21,236,1,235,1,1,0,1,1,112,112,124,123,41
"3650",49,"[21]EwHnKqGocIHBJCrjylhow",228,0.995633,21,229,1,228,1,1,0,1,1,117,117,112,111,41
"3651",50,"[21]EwHnKqGocIHBJCrjylhow",231,0.99569,21,232,1,231,1,1,0,1,1,114,114,118,117,41
"3652",51,"[21]EwHnKqGocIHBJCrjylhow",225,0.995575,21,226,1,225,1,1,0,1,1,119,119,107,106,41
"3653",52,"[21]EwHnKqGocIHBJCrjylhow",227,0.995614,21,228,1,227,1,1,0,1,1,119,119,109,108,41
"3654",53,"[21]EwHnKqGocIHBJCrjylhow",225,0.995575,21,226,1,225,1,1,0,1,1,118,118,108,107,41
"3655",54,"[21]EwHnKqGocIHBJCrjylhow",230,0.995671,21,231,1,230,1,1,0,1,1,115,115,116,115,41
"3656",55,"[21]EwHnKqGocIHBJCrjylhow",222,0.995516,21,223,1,222,1,1,0,1,1,122,122,101,100,41
"3657",56,"[21]EwHnKqGocIHBJCrjylhow",230,0.995671,21,231,1,230,1,1,0,1,1,118,118,113,112,41
"3658",57,"[21]EwHnKqGocIHBJCrjylhow",227,0.995614,21,228,1,227,1,1,0,1,1,119,119,109,108,41
"3659",58,"[21]EwHnKqGocIHBJCrjylhow",230,0.995671,21,231,1,230,1,1,0,1,1,115,115,116,115,41
"3660",59,"[21]EwHnKqGocIHBJCrjylhow",233,0.995726,21,234,1,233,1,1,0,1,1,112,112,122,121,41
"3661",60,"[21]EwHnKqGocIHBJCrjylhow",235,0.995763,21,236,1,235,1,1,0,1,1,111,111,125,124,41
"3662",61,"[21]EwHnKqGocIHBJCrjylhow",235,0.995763,21,236,1,235,1,1,0,1,1,111,111,125,124,41
"3663",62,"[21]EwHnKqGocIHBJCrjylhow",227,0.995614,21,228,1,227,1,1,0,1,1,117,117,111,110,41
"3664",63,"[21]EwHnKqGocIHBJCrjylhow",237,0.995798,21,238,1,237,1,1,0,1,1,114,114,124,123,41
"3665",64,"[21]EwHnKqGocIHBJCrjylhow",229,0.995652,21,230,1,229,1,1,0,1,1,116,116,114,113,41
"3666",65,"[21]EwHnKqGocIHBJCrjylhow",235,0.995763,21,236,1,235,1,1,0,1,1,113,113,123,122,41
"3667",66,"[21]EwHnKqGocIHBJCrjylhow",224,0.995556,21,225,1,224,1,1,0,1,1,119,119,106,105,41
"3668",67,"[21]EwHnKqGocIHBJCrjylhow",225,0.995575,21,226,1,225,1,1,0,1,1,119,119,107,106,41
"3669",68,"[21]EwHnKqGocIHBJCrjylhow",221,0.995495,21,222,1,221,1,1,0,1,1,122,122,100,99,41
"3670",69,"[21]EwHnKqGocIHBJCrjylhow",232,0.995708,21,233,1,232,1,1,0,1,1,114,114,119,118,41
"3671",70,"[21]EwHnKqGocIHBJCrjylhow",232,0.995708,21,233,1,232,1,1,0,1,1,113,113,120,119,41
"3672",71,"[21]EwHnKqGocIHBJCrjylhow",223,0.995536,21,224,1,223,1,1,0,1,1,122,122,102,101,41
"3673",72,"[21]EwHnKqGocIHBJCrjylhow",226,0.995595,21,227,1,226,1,1,0,1,1,118,118,109,108,41
"3674",73,"[21]EwHnKqGocIHBJCrjylhow",230,0.995671,21,231,1,230,1,1,0,1,1,115,115,116,115,41
"3675",74,"[21]EwHnKqGocIHBJCrjylhow",244,0.995918,21,245,1,244,1,1,0,1,1,106,106,139,138,41
"3676",75,"[21]EwHnKqGocIHBJCrjylhow",224,0.995556,21,225,1,224,1,1,0,1,1,122,122,103,102,41
"3677",76,"[21]EwHnKqGocIHBJCrjylhow",235,0.995763,21,236,1,235,1,1,0,1,1,114,114,122,121,41
"3678",77,"[21]EwHnKqGocIHBJCrjylhow",239,0.995833,21,240,1,239,1,1,0,1,1,109,109,131,130,41
"3679",78,"[21]EwHnKqGocIHBJCrjylhow",228,0.995633,21,229,1,228,1,1,0,1,1,116,116,113,112,41
"3680",79,"[21]EwHnKqGocIHBJCrjylhow",237,0.995798,21,238,1,237,1,1,0,1,1,109,109,129,128,41
"3681",80,"[21]EwHnKqGocIHBJCrjylhow",228,0.995633,21,229,1,228,1,1,0,1,1,117,117,112,111,41
"3682",81,"[21]EwHnKqGocIHBJCrjylhow",226,0.995595,21,227,1,226,1,1,0,1,1,119,119,108,107,41
"3683",82,"[21]EwHnKqGocIHBJCrjylhow",229,0.995652,21,230,1,229,1,1,0,1,1,116,116,114,113,41
"3684",83,"[21]EwHnKqGocIHBJCrjylhow",238,0.995816,21,239,1,238,1,1,0,1,1,114,114,125,124,41
"3685",84,"[21]EwHnKqGocIHBJCrjylhow",215,0.99537,21,216,1,215,1,1,0,1,1,127,127,89,88,41
"3686",85,"[21]EwHnKqGocIHBJCrjylhow",226,0.995595,21,227,1,226,1,1,0,1,1,118,118,109,108,41
"3687",86,"[21]EwHnKqGocIHBJCrjylhow",240,0.995851,21,241,1,240,1,1,0,1,1,108,108,133,132,41
"3688",87,"[21]EwHnKqGocIHBJCrjylhow",232,0.995708,21,233,1,232,1,1,0,1,1,113,113,120,119,41
"3689",88,"[21]EwHnKqGocIHBJCrjylhow",227,0.995614,21,228,1,227,1,1,0,1,1,117,117,111,110,41
"3690",89,"[21]EwHnKqGocIHBJCrjylhow",224,0.995556,21,225,1,224,1,1,0,1,1,121,121,104,103,41
"3691",90,"[21]EwHnKqGocIHBJCrjylhow",223,0.995536,21,224,1,223,1,1,0,1,1,123,123,101,100,41
"3692",91,"[21]EwHnKqGocIHBJCrjylhow",226,0.995595,21,227,1,226,1,1,0,1,1,118,118,109,108,41
"3693",92,"[21]EwHnKqGocIHBJCrjylhow",227,0.995614,21,228,1,227,1,1,0,1,1,117,117,111,110,41
"3694",93,"[21]EwHnKqGocIHBJCrjylhow",225,0.995575,21,226,1,225,1,1,0,1,1,119,119,107,106,41
"3695",94,"[21]EwHnKqGocIHBJCrjylhow",228,0.995633,21,229,1,228,1,1,0,1,1,116,116,113,112,41
"3696",95,"[21]EwHnKqGocIHBJCrjylhow",219,0.995455,21,220,1,219,1,1,0,1,1,125,125,95,94,41
"3697",96,"[21]EwHnKqGocIHBJCrjylhow",232,0.995708,21,233,1,232,1,1,0,1,1,113,113,120,119,41
"3698",97,"[21]EwHnKqGocIHBJCrjylhow",221,0.995495,21,222,1,221,1,1,0,1,1,124,124,98,97,41
"3699",98,"[21]EwHnKqGocIHBJCrjylhow",233,0.995726,21,234,1,233,1,1,0,1,1,113,113,121,120,41
"3700",99,"[21]EwHnKqGocIHBJCrjylhow",232,0.995708,21,233,1,232,1,1,0,1,1,114,114,119,118,41
"3701",0,"[25]EhAHvHnKqGocIHBJCgdcxegqp",222,0.995516,25,223,1,222,1,1,0,1,1,122,122,101,100,42
"3702",1,"[25]EhAHvHnKqGocIHBJCgdcxegqp",246,0.995951,25,247,1,246,1,1,0,1,1,101,101,146,145,42
"3703",2,"[25]EhAHvHnKqGocIHBJCgdcxegqp",222,0.995516,25,223,1,222,1,1,0,1,1,121,121,102,101,42
"3704",3,"[25]EhAHvHnKqGocIHBJCgdcxegqp",229,0.995652,25,230,1,229,1,1,0,1,1,115,115,115,114,42
"3705",4,"[25]EhAHvHnKqGocIHBJCgdcxegqp",220,0.995475,25,221,1,220,1,1,0,1,1,123,123,98,97,42
"3706",5,"[25]EhAHvHnKqGocIHBJCgdcxegqp",226,0.995595,25,227,1,226,1,1,0,1,1,117,117,110,109,42
"3707",6,"[25]EhAHvHnKqGocIHBJCgdcxegqp",237,0.995798,25,238,1,237,1,1,0,1,1,112,112,126,125,42
"3708",7,"[25]EhAHvHnKqGocIHBJCgdcxegqp",244,0.995918,25,245,1,244,1,1,0,1,1,104,104,141,140,42
"3709",8,"[25]EhAHvHnKqGocIHBJCgdcxegqp",230,0.995671,25,231,1,230,1,1,0,1,1,115,115,116,115,42
"3710",9,"[25]EhAHvHnKqGocIHBJCgdcxegqp",225,0.995575,25,226,1,225,1,1,0,1,1,121,121,105,104,42
"3711",10,"[25]EhAHvHnKqGocIHBJCgdcxegqp",237,0.995798,25,238,1,237,1,1,0,1,1,110,110,128,127,42
"3712",11,"[25]EhAHvHnKqGocIHBJCgdcxegqp",239,0.995833,25,240,1,239,1,1,0,1,1,107,107,133,132,42
"3713",12,"[25]EhAHvHnKqGocIHBJCgdcxegqp",235,0.995763,25,236,1,235,1,1,0,1,1,113,113,123,122,42
"3714",13,"[25]EhAHvHnKqGocIHBJCgdcxegqp",228,0.995633,25,229,1,228,1,1,0,1,1,115,115,114,113,42
"3715",14,"[25]EhAHvHnKqGocIHBJCgdcxegqp",236,0.995781,25,237,1,236,1,1,0,1,1,110,110,127,126,42
"3716",15,"[25]EhAHvHnKqGocIHBJCgdcxegqp",237,0.995798,25,238,1,237,1,1,0,1,1,109,109,129,128,42
"3717",16,"[25]EhAHvHnKqGocIHBJCgdcxegqp",233,0.995726,25,234,1,233,1,1,0,1,1,112,112,122,121,42
"3718",17,"[25]EhAHvHnKqGocIHBJCgdcxegqp",224,0.995556,25,225,1,224,1,1,0,1,1,119,119,106,105,42
"3719",18,"[25]EhAHvHnKqGocIHBJCgdcxegqp",222,0.995516,25,223,1,222,1,1,0,1,1,121,121,102,101,42
"3720",19,"[25]EhAHvHnKqGocIHBJCgdcxegqp",226,0.995595,25,227,1,226,1,1,0,1,1,119,119,108,107,42
"3721",20,"[25]EhAHvHnKqGocIHBJCgdcxegqp",242,0.995885,25,243,1,242,1,1,0,1,1,106,106,137,136,42
"3722",21,"[25]EhAHvHnKqGocIHBJCgdcxegqp",248,0.995984,25,249,1,248,1,1,0,1,1,100,100,149,148,42
"3723",22,"[25]EhAHvHnKqGocIHBJCgdcxegqp",229,0.995652,25,230,1,229,1,1,0,1,1,115,115,115,114,42
"3724",23,"[25]EhAHvHnKqGocIHBJCgdcxegqp",231,0.99569,25,232,1,231,1,1,0,1,1,115,115,117,116,42
"3725",24,"[25]EhAHvHnKqGocIHBJCgdcxegqp",227,0.995614,25,228,1,227,1,1,0,1,1,117,117,111,110,42
"3726",25,"[25]EhAHvHnKqGocIHBJCgdcxegqp",228,0.995633,25,229,1,228,1,1,0,1,1,117,117,112,111,42
"3727",26,"[25]EhAHvHnKqGocIHBJCgdcxegqp",237,0.995798,25,238,1,237,1,1,0,1,1,108,108,130,129,42
"3728",27,"[25]EhAHvHnKqGocIHBJCgdcxegqp",232,0.995708,25,233,1,232,1,1,0,1,1,113,113,120,119,42
"3729",28,"[25]EhAHvHnKqGocIHBJCgdcxegqp",227,0.995614,25,228,1,227,1,1,0,1,1,116,116,112,111,42
"3730",29,"[25]EhAHvHnKqGocIHBJCgdcxegqp",235,0.995763,25,236,1,235,1,1,0,1,1,110,110,126,125,42
"3731",30,"[25]EhAHvHnKqGocIHBJCgdcxegqp",238,0.995816,25,239,1,238,1,1,0,1,1,110,110,129,128,42
"3732",31,"[25]EhAHvHnKqGocIHBJCgdcxegqp",237,0.995798,25,238,1,237,1,1,0,1,1,111,111,127,126,42
"3733",32,"[25]EhAHvHnKqGocIHBJCgdcxegqp",237,0.995798,25,238,1,237,1,1,0,1,1,108,108,130,129,42
"3734",33,"[25]EhAHvHnKqGocIHBJCgdcxegqp",228,0.995633,25,229,1,228,1,1,0,1,1,116,116,113,112,42
"3735",34,"[25]EhAHvHnKqGocIHBJCgdcxegqp",222,0.995516,25,223,1,222,1,1,0,1,1,121,121,102,101,42
"3736",35,"[25]EhAHvHnKqGocIHBJCgdcxegqp",215,0.99537,25,216,1,215,1,1,0,1,1,127,127,89,88,42
"3737",36,"[25]EhAHvHnKqGocIHBJCgdcxegqp",240,0.995851,25,241,1,240,1,1,0,1,1,107,107,134,133,42
"3738",37,"[25]EhAHvHnKqGocIHBJCgdcxegqp",222,0.995516,25,223,1,222,1,1,0,1,1,120,120,103,102,42
"3739",38,"[25]EhAHvHnKqGocIHBJCgdcxegqp",237,0.995798,25,238,1,237,1,1,0,1,1,109,109,129,128,42
"3740",39,"[25]EhAHvHnKqGocIHBJCgdcxegqp",227,0.995614,25,228,1,227,1,1,0,1,1,117,117,111,110,42
"3741",40,"[25]EhAHvHnKqGocIHBJCgdcxegqp",233,0.995726,25,234,1,233,1,1,0,1,1,112,112,122,121,42
"3742",41,"[25]EhAHvHnKqGocIHBJCgdcxegqp",225,0.995575,25,226,1,225,1,1,0,1,1,119,119,107,106,42
"3743",42,"[25]EhAHvHnKqGocIHBJCgdcxegqp",232,0.995708,25,233,1,232,1,1,0,1,1,113,113,120,119,42
"3744",43,"[25]EhAHvHnKqGocIHBJCgdcxegqp",229,0.995652,25,230,1,229,1,1,0,1,1,116,116,114,113,42
"3745",44,"[25]EhAHvHnKqGocIHBJCgdcxegqp",236,0.995781,25,237,1,236,1,1,0,1,1,110,110,127,126,42
"3746",45,"[25]EhAHvHnKqGocIHBJCgdcxegqp",228,0.995633,25,229,1,228,1,1,0,1,1,117,117,112,111,42
"3747",46,"[25]EhAHvHnKqGocIHBJCgdcxegqp",233,0.995726,25,234,1,233,1,1,0,1,1,112,112,122,121,42
"3748",47,"[25]EhAHvHnKqGocIHBJCgdcxegqp",231,0.99569,25,232,1,231,1,1,0,1,1,114,114,118,117,42
"3749",48,"[25]EhAHvHnKqGocIHBJCgdcxegqp",232,0.995708,25,233,1,232,1,1,0,1,1,113,113,120,119,42
"3750",49,"[25]EhAHvHnKqGocIHBJCgdcxegqp",238,0.995816,25,239,1,238,1,1,0,1,1,110,110,129,128,42
"3751",50,"[25]EhAHvHnKqGocIHBJCgdcxegqp",227,0.995614,25,228,1,227,1,1,0,1,1,117,117,111,110,42
"3752",51,"[25]EhAHvHnKqGocIHBJCgdcxegqp",228,0.995633,25,229,1,228,1,1,0,1,1,115,115,114,113,42
"3753",52,"[25]EhAHvHnKqGocIHBJCgdcxegqp",239,0.995833,25,240,1,239,1,1,0,1,1,108,108,132,131,42
"3754",53,"[25]EhAHvHnKqGocIHBJCgdcxegqp",225,0.995575,25,226,1,225,1,1,0,1,1,120,120,106,105,42
"3755",54,"[25]EhAHvHnKqGocIHBJCgdcxegqp",238,0.995816,25,239,1,238,1,1,0,1,1,110,110,129,128,42
"3756",55,"[25]EhAHvHnKqGocIHBJCgdcxegqp",234,0.995745,25,235,1,234,1,1,0,1,1,112,112,123,122,42
"3757",56,"[25]EhAHvHnKqGocIHBJCgdcxegqp",232,0.995708,25,233,1,232,1,1,0,1,1,115,115,118,117,42
"3758",57,"[25]EhAHvHnKqGocIHBJCgdcxegqp",223,0.995536,25,224,1,223,1,1,0,1,1,120,120,104,103,42
"3759",58,"[25]EhAHvHnKqGocIHBJCgdcxegqp",226,0.995595,25,227,1,226,1,1,0,1,1,117,117,110,109,42
"3760",59,"[25]EhAHvHnKqGocIHBJCgdcxegqp",231,0.99569,25,232,1,231,1,1,0,1,1,113,113,119,118,42
"3761",60,"[25]EhAHvHnKqGocIHBJCgdcxegqp",220,0.995475,25,221,1,220,1,1,0,1,1,122,122,99,98,42
"3762",61,"[25]EhAHvHnKqGocIHBJCgdcxegqp",230,0.995671,25,231,1,230,1,1,0,1,1,116,116,115,114,42
"3763",62,"[25]EhAHvHnKqGocIHBJCgdcxegqp",245,0.995935,25,246,1,245,1,1,0,1,1,102,102,144,143,42
"3764",63,"[25]EhAHvHnKqGocIHBJCgdcxegqp",232,0.995708,25,233,1,232,1,1,0,1,1,114,114,119,118,42
"3765",64,"[25]EhAHvHnKqGocIHBJCgdcxegqp",225,0.995575,25,226,1,225,1,1,0,1,1,121,121,105,104,42
"3766",65,"[25]EhAHvHnKqGocIHBJCgdcxegqp",240,0.995851,25,241,1,240,1,1,0,1,1,107,107,134,133,42
"3767",66,"[25]EhAHvHnKqGocIHBJCgdcxegqp",225,0.995575,25,226,1,225,1,1,0,1,1,118,118,108,107,42
"3768",67,"[25]EhAHvHnKqGocIHBJCgdcxegqp",227,0.995614,25,228,1,227,1,1,0,1,1,119,119,109,108,42
"3769",68,"[25]EhAHvHnKqGocIHBJCgdcxegqp",230,0.995671,25,231,1,230,1,1,0,1,1,114,114,117,116,42
"3770",69,"[25]EhAHvHnKqGocIHBJCgdcxegqp",223,0.995536,25,224,1,223,1,1,0,1,1,119,119,105,104,42
"3771",70,"[25]EhAHvHnKqGocIHBJCgdcxegqp",226,0.995595,25,227,1,226,1,1,0,1,1,117,117,110,109,42
"3772",71,"[25]EhAHvHnKqGocIHBJCgdcxegqp",225,0.995575,25,226,1,225,1,1,0,1,1,118,118,108,107,42
"3773",72,"[25]EhAHvHnKqGocIHBJCgdcxegqp",238,0.995816,25,239,1,238,1,1,0,1,1,109,109,130,129,42
"3774",73,"[25]EhAHvHnKqGocIHBJCgdcxegqp",227,0.995614,25,228,1,227,1,1,0,1,1,116,116,112,111,42
"3775",74,"[25]EhAHvHnKqGocIHBJCgdcxegqp",237,0.995798,25,238,1,237,1,1,0,1,1,109,109,129,128,42
"3776",75,"[25]EhAHvHnKqGocIHBJCgdcxegqp",234,0.995745,25,235,1,234,1,1,0,1,1,113,113,122,121,42
"3777",76,"[25]EhAHvHnKqGocIHBJCgdcxegqp",225,0.995575,25,226,1,225,1,1,0,1,1,118,118,108,107,42
"3778",77,"[25]EhAHvHnKqGocIHBJCgdcxegqp",232,0.995708,25,233,1,232,1,1,0,1,1,113,113,120,119,42
"3779",78,"[25]EhAHvHnKqGocIHBJCgdcxegqp",237,0.995798,25,238,1,237,1,1,0,1,1,109,109,129,128,42
"3780",79,"[25]EhAHvHnKqGocIHBJCgdcxegqp",221,0.995495,25,222,1,221,1,1,0,1,1,121,121,101,100,42
"3781",80,"[25]EhAHvHnKqGocIHBJCgdcxegqp",239,0.995833,25,240,1,239,1,1,0,1,1,107,107,133,132,42
"3782",81,"[25]EhAHvHnKqGocIHBJCgdcxegqp",223,0.995536,25,224,1,223,1,1,0,1,1,121,121,103,102,42
"3783",82,"[25]EhAHvHnKqGocIHBJCgdcxegqp",236,0.995781,25,237,1,236,1,1,0,1,1,109,109,128,127,42
"3784",83,"[25]EhAHvHnKqGocIHBJCgdcxegqp",228,0.995633,25,229,1,228,1,1,0,1,1,117,117,112,111,42
"3785",84,"[25]EhAHvHnKqGocIHBJCgdcxegqp",240,0.995851,25,241,1,240,1,1,0,1,1,106,106,135,134,42
"3786",85,"[25]EhAHvHnKqGocIHBJCgdcxegqp",232,0.995708,25,233,1,232,1,1,0,1,1,112,112,121,120,42
"3787",86,"[25]EhAHvHnKqGocIHBJCgdcxegqp",230,0.995671,25,231,1,230,1,1,0,1,1,116,116,115,114,42
"3788",87,"[25]EhAHvHnKqGocIHBJCgdcxegqp",243,0.995902,25,244,1,243,1,1,0,1,1,104,104,140,139,42
"3789",88,"[25]EhAHvHnKqGocIHBJCgdcxegqp",235,0.995763,25,236,1,235,1,1,0,1,1,111,111,125,124,42
"3790",89,"[25]EhAHvHnKqGocIHBJCgdcxegqp",225,0.995575,25,226,1,225,1,1,0,1,1,118,118,108,107,42
"3791",90,"[25]EhAHvHnKqGocIHBJCgdcxegqp",227,0.995614,25,228,1,227,1,1,0,1,1,116,116,112,111,42
"3792",91,"[25]EhAHvHnKqGocIHBJCgdcxegqp",222,0.995516,25,223,1,222,1,1,0,1,1,120,120,103,102,42
"3793",92,"[25]EhAHvHnKqGocIHBJCgdcxegqp",229,0.995652,25,230,1,229,1,1,0,1,1,115,115,115,114,42
"3794",93,"[25]EhAHvHnKqGocIHBJCgdcxegqp",247,0.995968,25,248,1,247,1,1,0,1,1,106,106,142,141,42
"3795",94,"[25]EhAHvHnKqGocIHBJCgdcxegqp",237,0.995798,25,238,1,237,1,1,0,1,1,108,108,130,129,42
"3796",95,"[25]EhAHvHnKqGocIHBJCgdcxegqp",224,0.995556,25,225,1,224,1,1,0,1,1,119,119,106,105,42
"3797",96,"[25]EhAHvHnKqGocIHBJCgdcxegqp",232,0.995708,25,233,1,232,1,1,0,1,1,113,113,120,119,42
"3798",97,"[25]EhAHvHnKqGocIHBJCgdcxegqp",236,0.995781,25,237,1,236,1,1,0,1,1,111,111,126,125,42
"3799",98,"[25]EhAHvHnKqGocIHBJCgdcxegqp",235,0.995763,25,236,1,235,1,1,0,1,1,111,111,125,124,42
"3800",99,"[25]EhAHvHnKqGocIHBJCgdcxegqp",236,0.995781,25,237,1,236,1,1,0,1,1,114,114,123,122,42
"3801",0,"[25]EAwuHnKqGocIHBJCAmlcsnjok",229,0.995652,25,230,1,229,1,1,0,1,1,118,118,112,111,43
"3802",1,"[25]EAwuHnKqGocIHBJCAmlcsnjok",233,0.995726,25,234,1,233,1,1,0,1,1,112,112,122,121,43
"3803",2,"[25]EAwuHnKqGocIHBJCAmlcsnjok",233,0.995726,25,234,1,233,1,1,0,1,1,112,112,122,121,43
"3804",3,"[25]EAwuHnKqGocIHBJCAmlcsnjok",227,0.995614,25,228,1,227,1,1,0,1,1,116,116,112,111,43
"3805",4,"[25]EAwuHnKqGocIHBJCAmlcsnjok",219,0.995455,25,220,1,219,1,1,0,1,1,123,123,97,96,43
"3806",5,"[25]EAwuHnKqGocIHBJCAmlcsnjok",226,0.995595,25,227,1,226,1,1,0,1,1,119,119,108,107,43
"3807",6,"[25]EAwuHnKqGocIHBJCAmlcsnjok",222,0.995516,25,223,1,222,1,1,0,1,1,121,121,102,101,43
"3808",7,"[25]EAwuHnKqGocIHBJCAmlcsnjok",225,0.995575,25,226,1,225,1,1,0,1,1,118,118,108,107,43
"3809",8,"[25]EAwuHnKqGocIHBJCAmlcsnjok",234,0.995745,25,235,1,234,1,1,0,1,1,111,111,124,123,43
"3810",9,"[25]EAwuHnKqGocIHBJCAmlcsnjok",235,0.995763,25,236,1,235,1,1,0,1,1,114,114,122,121,43
"3811",10,"[25]EAwuHnKqGocIHBJCAmlcsnjok",225,0.995575,25,226,1,225,1,1,0,1,1,118,118,108,107,43
"3812",11,"[25]EAwuHnKqGocIHBJCAmlcsnjok",223,0.995536,25,224,1,223,1,1,0,1,1,121,121,103,102,43
"3813",12,"[25]EAwuHnKqGocIHBJCAmlcsnjok",232,0.995708,25,233,1,232,1,1,0,1,1,113,113,120,119,43
"3814",13,"[25]EAwuHnKqGocIHBJCAmlcsnjok",228,0.995633,25,229,1,228,1,1,0,1,1,116,116,113,112,43
"3815",14,"[25]EAwuHnKqGocIHBJCAmlcsnjok",228,0.995633,25,229,1,228,1,1,0,1,1,116,116,113,112,43
"3816",15,"[25]EAwuHnKqGocIHBJCAmlcsnjok",224,0.995556,25,225,1,224,1,1,0,1,1,120,120,105,104,43
"3817",16,"[25]EAwuHnKqGocIHBJCAmlcsnjok",224,0.995556,25,225,1,224,1,1,0,1,1,120,120,105,104,43
"3818",17,"[25]EAwuHnKqGocIHBJCAmlcsnjok",233,0.995726,25,234,1,233,1,1,0,1,1,112,112,122,121,43
"3819",18,"[25]EAwuHnKqGocIHBJCAmlcsnjok",231,0.99569,25,232,1,231,1,1,0,1,1,115,115,117,116,43
"3820",19,"[25]EAwuHnKqGocIHBJCAmlcsnjok",236,0.995781,25,237,1,236,1,1,0,1,1,109,109,128,127,43
"3821",20,"[25]EAwuHnKqGocIHBJCAmlcsnjok",225,0.995575,25,226,1,225,1,1,0,1,1,118,118,108,107,43
"3822",21,"[25]EAwuHnKqGocIHBJCAmlcsnjok",230,0.995671,25,231,1,230,1,1,0,1,1,115,115,116,115,43
"3823",22,"[25]EAwuHnKqGocIHBJCAmlcsnjok",239,0.995833,25,240,1,239,1,1,0,1,1,107,107,133,132,43
"3824",23,"[25]EAwuHnKqGocIHBJCAmlcsnjok",227,0.995614,25,228,1,227,1,1,0,1,1,116,116,112,111,43
"3825",24,"[25]EAwuHnKqGocIHBJCAmlcsnjok",229,0.995652,25,230,1,229,1,1,0,1,1,115,115,115,114,43
"3826",25,"[25]EAwuHnKqGocIHBJCAmlcsnjok",237,0.995798,25,238,1,237,1,1,0,1,1,109,109,129,128,43
"3827",26,"[25]EAwuHnKqGocIHBJCAmlcsnjok",230,0.995671,25,231,1,230,1,1,0,1,1,115,115,116,115,43
"3828",27,"[25]EAwuHnKqGocIHBJCAmlcsnjok",240,0.995851,25,241,1,240,1,1,0,1,1,110,110,131,130,43
"3829",28,"[25]EAwuHnKqGocIHBJCAmlcsnjok",229,0.995652,25,230,1,229,1,1,0,1,1,115,115,115,114,43
"3830",29,"[25]EAwuHnKqGocIHBJCAmlcsnjok",238,0.995816,25,239,1,238,1,1,0,1,1,108,108,131,130,43
"3831",30,"[25]EAwuHnKqGocIHBJCAmlcsnjok",240,0.995851,25,241,1,240,1,1,0,1,1,110,110,131,130,43
"3832",31,"[25]EAwuHnKqGocIHBJCAmlcsnjok",235,0.995763,25,236,1,235,1,1,0,1,1,112,112,124,123,43
"3833",32,"[25]EAwuHnKqGocIHBJCAmlcsnjok",228,0.995633,25,229,1,228,1,1,0,1,1,117,117,112,111,43
"3834",33,"[25]EAwuHnKqGocIHBJCAmlcsnjok",239,0.995833,25,240,1,239,1,1,0,1,1,109,109,131,130,43
"3835",34,"[25]EAwuHnKqGocIHBJCAmlcsnjok",232,0.995708,25,233,1,232,1,1,0,1,1,112,112,121,120,43
"3836",35,"[25]EAwuHnKqGocIHBJCAmlcsnjok",227,0.995614,25,228,1,227,1,1,0,1,1,118,118,110,109,43
"3837",36,"[25]EAwuHnKqGocIHBJCAmlcsnjok",229,0.995652,25,230,1,229,1,1,0,1,1,116,116,114,113,43
"3838",37,"[25]EAwuHnKqGocIHBJCAmlcsnjok",222,0.995516,25,223,1,222,1,1,0,1,1,120,120,103,102,43
"3839",38,"[25]EAwuHnKqGocIHBJCAmlcsnjok",232,0.995708,25,233,1,232,1,1,0,1,1,112,112,121,120,43
"3840",39,"[25]EAwuHnKqGocIHBJCAmlcsnjok",233,0.995726,25,234,1,233,1,1,0,1,1,112,112,122,121,43
"3841",40,"[25]EAwuHnKqGocIHBJCAmlcsnjok",229,0.995652,25,230,1,229,1,1,0,1,1,115,115,115,114,43
"3842",41,"[25]EAwuHnKqGocIHBJCAmlcsnjok",248,0.995984,25,249,1,248,1,1,0,1,1,101,101,148,147,43
"3843",42,"[25]EAwuHnKqGocIHBJCAmlcsnjok",232,0.995708,25,233,1,232,1,1,0,1,1,114,114,119,118,43
"3844",43,"[25]EAwuHnKqGocIHBJCAmlcsnjok",236,0.995781,25,237,1,236,1,1,0,1,1,111,111,126,125,43
"3845",44,"[25]EAwuHnKqGocIHBJCAmlcsnjok",238,0.995816,25,239,1,238,1,1,0,1,1,108,108,131,130,43
"3846",45,"[25]EAwuHnKqGocIHBJCAmlcsnjok",231,0.99569,25,232,1,231,1,1,0,1,1,115,115,117,116,43
"3847",46,"[25]EAwuHnKqGocIHBJCAmlcsnjok",221,0.995495,25,222,1,221,1,1,0,1,1,122,122,100,99,43
"3848",47,"[25]EAwuHnKqGocIHBJCAmlcsnjok",238,0.995816,25,239,1,238,1,1,0,1,1,113,113,126,125,43
"3849",48,"[25]EAwuHnKqGocIHBJCAmlcsnjok",240,0.995851,25,241,1,240,1,1,0,1,1,107,107,134,133,43
"3850",49,"[25]EAwuHnKqGocIHBJCAmlcsnjok",229,0.995652,25,230,1,229,1,1,0,1,1,116,116,114,113,43
"3851",50,"[25]EAwuHnKqGocIHBJCAmlcsnjok",241,0.995868,25,242,1,241,1,1,0,1,1,105,105,137,136,43
"3852",51,"[25]EAwuHnKqGocIHBJCAmlcsnjok",241,0.995868,25,242,1,241,1,1,0,1,1,106,106,136,135,43
"3853",52,"[25]EAwuHnKqGocIHBJCAmlcsnjok",232,0.995708,25,233,1,232,1,1,0,1,1,112,112,121,120,43
"3854",53,"[25]EAwuHnKqGocIHBJCAmlcsnjok",235,0.995763,25,236,1,235,1,1,0,1,1,110,110,126,125,43
"3855",54,"[25]EAwuHnKqGocIHBJCAmlcsnjok",232,0.995708,25,233,1,232,1,1,0,1,1,114,114,119,118,43
"3856",55,"[25]EAwuHnKqGocIHBJCAmlcsnjok",226,0.995595,25,227,1,226,1,1,0,1,1,119,119,108,107,43
"3857",56,"[25]EAwuHnKqGocIHBJCAmlcsnjok",231,0.99569,25,232,1,231,1,1,0,1,1,114,114,118,117,43
"3858",57,"[25]EAwuHnKqGocIHBJCAmlcsnjok",226,0.995595,25,227,1,226,1,1,0,1,1,117,117,110,109,43
"3859",58,"[25]EAwuHnKqGocIHBJCAmlcsnjok",231,0.99569,25,232,1,231,1,1,0,1,1,113,113,119,118,43
"3860",59,"[25]EAwuHnKqGocIHBJCAmlcsnjok",229,0.995652,25,230,1,229,1,1,0,1,1,117,117,113,112,43
"3861",60,"[25]EAwuHnKqGocIHBJCAmlcsnjok",232,0.995708,25,233,1,232,1,1,0,1,1,117,117,116,115,43
"3862",61,"[25]EAwuHnKqGocIHBJCAmlcsnjok",226,0.995595,25,227,1,226,1,1,0,1,1,120,120,107,106,43
"3863",62,"[25]EAwuHnKqGocIHBJCAmlcsnjok",228,0.995633,25,229,1,228,1,1,0,1,1,116,116,113,112,43
"3864",63,"[25]EAwuHnKqGocIHBJCAmlcsnjok",243,0.995902,25,244,1,243,1,1,0,1,1,104,104,140,139,43
"3865",64,"[25]EAwuHnKqGocIHBJCAmlcsnjok",235,0.995763,25,236,1,235,1,1,0,1,1,112,112,124,123,43
"3866",65,"[25]EAwuHnKqGocIHBJCAmlcsnjok",217,0.995413,25,218,1,217,1,1,0,1,1,124,124,94,93,43
"3867",66,"[25]EAwuHnKqGocIHBJCAmlcsnjok",227,0.995614,25,228,1,227,1,1,0,1,1,117,117,111,110,43
"3868",67,"[25]EAwuHnKqGocIHBJCAmlcsnjok",244,0.995918,25,245,1,244,1,1,0,1,1,104,104,141,140,43
"3869",68,"[25]EAwuHnKqGocIHBJCAmlcsnjok",228,0.995633,25,229,1,228,1,1,0,1,1,116,116,113,112,43
"3870",69,"[25]EAwuHnKqGocIHBJCAmlcsnjok",238,0.995816,25,239,1,238,1,1,0,1,1,109,109,130,129,43
"3871",70,"[25]EAwuHnKqGocIHBJCAmlcsnjok",235,0.995763,25,236,1,235,1,1,0,1,1,111,111,125,124,43
"3872",71,"[25]EAwuHnKqGocIHBJCAmlcsnjok",230,0.995671,25,231,1,230,1,1,0,1,1,115,115,116,115,43
"3873",72,"[25]EAwuHnKqGocIHBJCAmlcsnjok",230,0.995671,25,231,1,230,1,1,0,1,1,114,114,117,116,43
"3874",73,"[25]EAwuHnKqGocIHBJCAmlcsnjok",235,0.995763,25,236,1,235,1,1,0,1,1,111,111,125,124,43
"3875",74,"[25]EAwuHnKqGocIHBJCAmlcsnjok",227,0.995614,25,228,1,227,1,1,0,1,1,118,118,110,109,43
"3876",75,"[25]EAwuHnKqGocIHBJCAmlcsnjok",232,0.995708,25,233,1,232,1,1,0,1,1,112,112,121,120,43
"3877",76,"[25]EAwuHnKqGocIHBJCAmlcsnjok",219,0.995455,25,220,1,219,1,1,0,1,1,123,123,97,96,43
"3878",77,"[25]EAwuHnKqGocIHBJCAmlcsnjok",236,0.995781,25,237,1,236,1,1,0,1,1,112,112,125,124,43
"3879",78,"[25]EAwuHnKqGocIHBJCAmlcsnjok",224,0.995556,25,225,1,224,1,1,0,1,1,120,120,105,104,43
"3880",79,"[25]EAwuHnKqGocIHBJCAmlcsnjok",238,0.995816,25,239,1,238,1,1,0,1,1,108,108,131,130,43
"3881",80,"[25]EAwuHnKqGocIHBJCAmlcsnjok",232,0.995708,25,233,1,232,1,1,0,1,1,116,116,117,116,43
"3882",81,"[25]EAwuHnKqGocIHBJCAmlcsnjok",231,0.99569,25,232,1,231,1,1,0,1,1,116,116,116,115,43
"3883",82,"[25]EAwuHnKqGocIHBJCAmlcsnjok",229,0.995652,25,230,1,229,1,1,0,1,1,116,116,114,113,43
"3884",83,"[25]EAwuHnKqGocIHBJCAmlcsnjok",236,0.995781,25,237,1,236,1,1,0,1,1,111,111,126,125,43
"3885",84,"[25]EAwuHnKqGocIHBJCAmlcsnjok",228,0.995633,25,229,1,228,1,1,0,1,1,116,116,113,112,43
"3886",85,"[25]EAwuHnKqGocIHBJCAmlcsnjok",239,0.995833,25,240,1,239,1,1,0,1,1,107,107,133,132,43
"3887",86,"[25]EAwuHnKqGocIHBJCAmlcsnjok",235,0.995763,25,236,1,235,1,1,0,1,1,112,112,124,123,43
"3888",87,"[25]EAwuHnKqGocIHBJCAmlcsnjok",235,0.995763,25,236,1,235,1,1,0,1,1,110,110,126,125,43
"3889",88,"[25]EAwuHnKqGocIHBJCAmlcsnjok",227,0.995614,25,228,1,227,1,1,0,1,1,117,117,111,110,43
"3890",89,"[25]EAwuHnKqGocIHBJCAmlcsnjok",233,0.995726,25,234,1,233,1,1,0,1,1,115,115,119,118,43
"3891",90,"[25]EAwuHnKqGocIHBJCAmlcsnjok",221,0.995495,25,222,1,221,1,1,0,1,1,122,122,100,99,43
"3892",91,"[25]EAwuHnKqGocIHBJCAmlcsnjok",221,0.995495,25,222,1,221,1,1,0,1,1,122,122,100,99,43
"3893",92,"[25]EAwuHnKqGocIHBJCAmlcsnjok",232,0.995708,25,233,1,232,1,1,0,1,1,112,112,121,120,43
"3894",93,"[25]EAwuHnKqGocIHBJCAmlcsnjok",227,0.995614,25,228,1,227,1,1,0,1,1,117,117,111,110,43
"3895",94,"[25]EAwuHnKqGocIHBJCAmlcsnjok",230,0.995671,25,231,1,230,1,1,0,1,1,114,114,117,116,43
"3896",95,"[25]EAwuHnKqGocIHBJCAmlcsnjok",230,0.995671,25,231,1,230,1,1,0,1,1,114,114,117,116,43
"3897",96,"[25]EAwuHnKqGocIHBJCAmlcsnjok",226,0.995595,25,227,1,226,1,1,0,1,1,117,117,110,109,43
"3898",97,"[25]EAwuHnKqGocIHBJCAmlcsnjok",231,0.99569,25,232,1,231,1,1,0,1,1,113,113,119,118,43
"3899",98,"[25]EAwuHnKqGocIHBJCAmlcsnjok",235,0.995763,25,236,1,235,1,1,0,1,1,113,113,123,122,43
"3900",99,"[25]EAwuHnKqGocIHBJCAmlcsnjok",234,0.995745,25,235,1,234,1,1,0,1,1,117,117,118,117,43
"3901",0,"[22]EssHnKqGocIHBJCErgJaHe",238,0.995816,22,239,1,238,1,1,0,1,1,109,109,130,129,46
"3902",1,"[22]EssHnKqGocIHBJCErgJaHe",230,0.995671,22,231,1,230,1,1,0,1,1,116,116,115,114,46
"3903",2,"[22]EssHnKqGocIHBJCErgJaHe",229,0.995652,22,230,1,229,1,1,0,1,1,117,117,113,112,46
"3904",3,"[22]EssHnKqGocIHBJCErgJaHe",245,0.995935,22,246,1,245,1,1,0,1,1,103,103,143,142,46
"3905",4,"[22]EssHnKqGocIHBJCErgJaHe",226,0.995595,22,227,1,226,1,1,0,1,1,117,117,110,109,46
"3906",5,"[22]EssHnKqGocIHBJCErgJaHe",227,0.995614,22,228,1,227,1,1,0,1,1,117,117,111,110,46
"3907",6,"[22]EssHnKqGocIHBJCErgJaHe",220,0.995475,22,221,1,220,1,1,0,1,1,123,123,98,97,46
"3908",7,"[22]EssHnKqGocIHBJCErgJaHe",226,0.995595,22,227,1,226,1,1,0,1,1,117,117,110,109,46
"3909",8,"[22]EssHnKqGocIHBJCErgJaHe",238,0.995816,22,239,1,238,1,1,0,1,1,110,110,129,128,46
"3910",9,"[22]EssHnKqGocIHBJCErgJaHe",221,0.995495,22,222,1,221,1,1,0,1,1,122,122,100,99,46
"3911",10,"[22]EssHnKqGocIHBJCErgJaHe",228,0.995633,22,229,1,228,1,1,0,1,1,121,121,108,107,46
"3912",11,"[22]EssHnKqGocIHBJCErgJaHe",227,0.995614,22,228,1,227,1,1,0,1,1,119,119,109,108,46
"3913",12,"[22]EssHnKqGocIHBJCErgJaHe",226,0.995595,22,227,1,226,1,1,0,1,1,117,117,110,109,46
"3914",13,"[22]EssHnKqGocIHBJCErgJaHe",221,0.995495,22,222,1,221,1,1,0,1,1,122,122,100,99,46
"3915",14,"[22]EssHnKqGocIHBJCErgJaHe",229,0.995652,22,230,1,229,1,1,0,1,1,116,116,114,113,46
"3916",15,"[22]EssHnKqGocIHBJCErgJaHe",229,0.995652,22,230,1,229,1,1,0,1,1,117,117,113,112,46
"3917",16,"[22]EssHnKqGocIHBJCErgJaHe",229,0.995652,22,230,1,229,1,1,0,1,1,121,121,109,108,46
"3918",17,"[22]EssHnKqGocIHBJCErgJaHe",233,0.995726,22,234,1,233,1,1,0,1,1,113,113,121,120,46
"3919",18,"[22]EssHnKqGocIHBJCErgJaHe",235,0.995763,22,236,1,235,1,1,0,1,1,111,111,125,124,46
"3920",19,"[22]EssHnKqGocIHBJCErgJaHe",217,0.995413,22,218,1,217,1,1,0,1,1,125,125,93,92,46
"3921",20,"[22]EssHnKqGocIHBJCErgJaHe",236,0.995781,22,237,1,236,1,1,0,1,1,109,109,128,127,46
"3922",21,"[22]EssHnKqGocIHBJCErgJaHe",246,0.995951,22,247,1,246,1,1,0,1,1,105,105,142,141,46
"3923",22,"[22]EssHnKqGocIHBJCErgJaHe",231,0.99569,22,232,1,231,1,1,0,1,1,113,113,119,118,46
"3924",23,"[22]EssHnKqGocIHBJCErgJaHe",229,0.995652,22,230,1,229,1,1,0,1,1,116,116,114,113,46
"3925",24,"[22]EssHnKqGocIHBJCErgJaHe",226,0.995595,22,227,1,226,1,1,0,1,1,119,119,108,107,46
"3926",25,"[22]EssHnKqGocIHBJCErgJaHe",213,0.995327,22,214,1,213,1,1,0,1,1,130,130,84,83,46
"3927",26,"[22]EssHnKqGocIHBJCErgJaHe",236,0.995781,22,237,1,236,1,1,0,1,1,109,109,128,127,46
"3928",27,"[22]EssHnKqGocIHBJCErgJaHe",235,0.995763,22,236,1,235,1,1,0,1,1,111,111,125,124,46
"3929",28,"[22]EssHnKqGocIHBJCErgJaHe",225,0.995575,22,226,1,225,1,1,0,1,1,119,119,107,106,46
"3930",29,"[22]EssHnKqGocIHBJCErgJaHe",225,0.995575,22,226,1,225,1,1,0,1,1,121,121,105,104,46
"3931",30,"[22]EssHnKqGocIHBJCErgJaHe",235,0.995763,22,236,1,235,1,1,0,1,1,113,113,123,122,46
"3932",31,"[22]EssHnKqGocIHBJCErgJaHe",228,0.995633,22,229,1,228,1,1,0,1,1,118,118,111,110,46
"3933",32,"[22]EssHnKqGocIHBJCErgJaHe",242,0.995885,22,243,1,242,1,1,0,1,1,107,107,136,135,46
"3934",33,"[22]EssHnKqGocIHBJCErgJaHe",239,0.995833,22,240,1,239,1,1,0,1,1,109,109,131,130,46
"3935",34,"[22]EssHnKqGocIHBJCErgJaHe",234,0.995745,22,235,1,234,1,1,0,1,1,118,118,117,116,46
"3936",35,"[22]EssHnKqGocIHBJCErgJaHe",233,0.995726,22,234,1,233,1,1,0,1,1,112,112,122,121,46
"3937",36,"[22]EssHnKqGocIHBJCErgJaHe",236,0.995781,22,237,1,236,1,1,0,1,1,111,111,126,125,46
"3938",37,"[22]EssHnKqGocIHBJCErgJaHe",242,0.995885,22,243,1,242,1,1,0,1,1,108,108,135,134,46
"3939",38,"[22]EssHnKqGocIHBJCErgJaHe",232,0.995708,22,233,1,232,1,1,0,1,1,113,113,120,119,46
"3940",39,"[22]EssHnKqGocIHBJCErgJaHe",231,0.99569,22,232,1,231,1,1,0,1,1,113,113,119,118,46
"3941",40,"[22]EssHnKqGocIHBJCErgJaHe",236,0.995781,22,237,1,236,1,1,0,1,1,116,116,121,120,46
"3942",41,"[22]EssHnKqGocIHBJCErgJaHe",230,0.995671,22,231,1,230,1,1,0,1,1,114,114,117,116,46
"3943",42,"[22]EssHnKqGocIHBJCErgJaHe",222,0.995516,22,223,1,222,1,1,0,1,1,121,121,102,101,46
"3944",43,"[22]EssHnKqGocIHBJCErgJaHe",231,0.99569,22,232,1,231,1,1,0,1,1,114,114,118,117,46
"3945",44,"[22]EssHnKqGocIHBJCErgJaHe",227,0.995614,22,228,1,227,1,1,0,1,1,119,119,109,108,46
"3946",45,"[22]EssHnKqGocIHBJCErgJaHe",229,0.995652,22,230,1,229,1,1,0,1,1,115,115,115,114,46
"3947",46,"[22]EssHnKqGocIHBJCErgJaHe",237,0.995798,22,238,1,237,1,1,0,1,1,111,111,127,126,46
"3948",47,"[22]EssHnKqGocIHBJCErgJaHe",223,0.995536,22,224,1,223,1,1,0,1,1,121,121,103,102,46
"3949",48,"[22]EssHnKqGocIHBJCErgJaHe",228,0.995633,22,229,1,228,1,1,0,1,1,117,117,112,111,46
"3950",49,"[22]EssHnKqGocIHBJCErgJaHe",235,0.995763,22,236,1,235,1,1,0,1,1,115,115,121,120,46
"3951",50,"[22]EssHnKqGocIHBJCErgJaHe",228,0.995633,22,229,1,228,1,1,0,1,1,117,117,112,111,46
"3952",51,"[22]EssHnKqGocIHBJCErgJaHe",234,0.995745,22,235,1,234,1,1,0,1,1,112,112,123,122,46
"3953",52,"[22]EssHnKqGocIHBJCErgJaHe",234,0.995745,22,235,1,234,1,1,0,1,1,112,112,123,122,46
"3954",53,"[22]EssHnKqGocIHBJCErgJaHe",240,0.995851,22,241,1,240,1,1,0,1,1,108,108,133,132,46
"3955",54,"[22]EssHnKqGocIHBJCErgJaHe",233,0.995726,22,234,1,233,1,1,0,1,1,113,113,121,120,46
"3956",55,"[22]EssHnKqGocIHBJCErgJaHe",229,0.995652,22,230,1,229,1,1,0,1,1,116,116,114,113,46
"3957",56,"[22]EssHnKqGocIHBJCErgJaHe",228,0.995633,22,229,1,228,1,1,0,1,1,116,116,113,112,46
"3958",57,"[22]EssHnKqGocIHBJCErgJaHe",230,0.995671,22,231,1,230,1,1,0,1,1,115,115,116,115,46
"3959",58,"[22]EssHnKqGocIHBJCErgJaHe",235,0.995763,22,236,1,235,1,1,0,1,1,111,111,125,124,46
"3960",59,"[22]EssHnKqGocIHBJCErgJaHe",218,0.995434,22,219,1,218,1,1,0,1,1,124,124,95,94,46
"3961",60,"[22]EssHnKqGocIHBJCErgJaHe",233,0.995726,22,234,1,233,1,1,0,1,1,113,113,121,120,46
"3962",61,"[22]EssHnKqGocIHBJCErgJaHe",231,0.99569,22,232,1,231,1,1,0,1,1,115,115,117,116,46
"3963",62,"[22]EssHnKqGocIHBJCErgJaHe",223,0.995536,22,224,1,223,1,1,0,1,1,121,121,103,102,46
"3964",63,"[22]EssHnKqGocIHBJCErgJaHe",229,0.995652,22,230,1,229,1,1,0,1,1,118,118,112,111,46
"3965",64,"[22]EssHnKqGocIHBJCErgJaHe",225,0.995575,22,226,1,225,1,1,0,1,1,120,120,106,105,46
"3966",65,"[22]EssHnKqGocIHBJCErgJaHe",232,0.995708,22,233,1,232,1,1,0,1,1,113,113,120,119,46
"3967",66,"[22]EssHnKqGocIHBJCErgJaHe",221,0.995495,22,222,1,221,1,1,0,1,1,121,121,101,100,46
"3968",67,"[22]EssHnKqGocIHBJCErgJaHe",232,0.995708,22,233,1,232,1,1,0,1,1,114,114,119,118,46
"3969",68,"[22]EssHnKqGocIHBJCErgJaHe",237,0.995798,22,238,1,237,1,1,0,1,1,109,109,129,128,46
"3970",69,"[22]EssHnKqGocIHBJCErgJaHe",229,0.995652,22,230,1,229,1,1,0,1,1,115,115,115,114,46
"3971",70,"[22]EssHnKqGocIHBJCErgJaHe",230,0.995671,22,231,1,230,1,1,0,1,1,114,114,117,116,46
"3972",71,"[22]EssHnKqGocIHBJCErgJaHe",233,0.995726,22,234,1,233,1,1,0,1,1,113,113,121,120,46
"3973",72,"[22]EssHnKqGocIHBJCErgJaHe",249,0.996,22,250,1,249,1,1,0,1,1,100,100,150,149,46
"3974",73,"[22]EssHnKqGocIHBJCErgJaHe",234,0.995745,22,235,1,234,1,1,0,1,1,111,111,124,123,46
"3975",74,"[22]EssHnKqGocIHBJCErgJaHe",238,0.995816,22,239,1,238,1,1,0,1,1,109,109,130,129,46
"3976",75,"[22]EssHnKqGocIHBJCErgJaHe",229,0.995652,22,230,1,229,1,1,0,1,1,115,115,115,114,46
"3977",76,"[22]EssHnKqGocIHBJCErgJaHe",236,0.995781,22,237,1,236,1,1,0,1,1,110,110,127,126,46
"3978",77,"[22]EssHnKqGocIHBJCErgJaHe",226,0.995595,22,227,1,226,1,1,0,1,1,118,118,109,108,46
"3979",78,"[22]EssHnKqGocIHBJCErgJaHe",226,0.995595,22,227,1,226,1,1,0,1,1,117,117,110,109,46
"3980",79,"[22]EssHnKqGocIHBJCErgJaHe",235,0.995763,22,236,1,235,1,1,0,1,1,111,111,125,124,46
"3981",80,"[22]EssHnKqGocIHBJCErgJaHe",225,0.995575,22,226,1,225,1,1,0,1,1,120,120,106,105,46
"3982",81,"[22]EssHnKqGocIHBJCErgJaHe",230,0.995671,22,231,1,230,1,1,0,1,1,114,114,117,116,46
"3983",82,"[22]EssHnKqGocIHBJCErgJaHe",231,0.99569,22,232,1,231,1,1,0,1,1,117,117,115,114,46
"3984",83,"[22]EssHnKqGocIHBJCErgJaHe",227,0.995614,22,228,1,227,1,1,0,1,1,119,119,109,108,46
"3985",84,"[22]EssHnKqGocIHBJCErgJaHe",231,0.99569,22,232,1,231,1,1,0,1,1,114,114,118,117,46
"3986",85,"[22]EssHnKqGocIHBJCErgJaHe",227,0.995614,22,228,1,227,1,1,0,1,1,118,118,110,109,46
"3987",86,"[22]EssHnKqGocIHBJCErgJaHe",223,0.995536,22,224,1,223,1,1,0,1,1,120,120,104,103,46
"3988",87,"[22]EssHnKqGocIHBJCErgJaHe",224,0.995556,22,225,1,224,1,1,0,1,1,120,120,105,104,46
"3989",88,"[22]EssHnKqGocIHBJCErgJaHe",236,0.995781,22,237,1,236,1,1,0,1,1,111,111,126,125,46
"3990",89,"[22]EssHnKqGocIHBJCErgJaHe",232,0.995708,22,233,1,232,1,1,0,1,1,115,115,118,117,46
"3991",90,"[22]EssHnKqGocIHBJCErgJaHe",229,0.995652,22,230,1,229,1,1,0,1,1,115,115,115,114,46
"3992",91,"[22]EssHnKqGocIHBJCErgJaHe",225,0.995575,22,226,1,225,1,1,0,1,1,121,121,105,104,46
"3993",92,"[22]EssHnKqGocIHBJCErgJaHe",243,0.995902,22,244,1,243,1,1,0,1,1,104,104,140,139,46
"3994",93,"[22]EssHnKqGocIHBJCErgJaHe",224,0.995556,22,225,1,224,1,1,0,1,1,121,121,104,103,46
"3995",94,"[22]EssHnKqGocIHBJCErgJaHe",231,0.99569,22,232,1,231,1,1,0,1,1,113,113,119,118,46
"3996",95,"[22]EssHnKqGocIHBJCErgJaHe",235,0.995763,22,236,1,235,1,1,0,1,1,110,110,126,125,46
"3997",96,"[22]EssHnKqGocIHBJCErgJaHe",237,0.995798,22,238,1,237,1,1,0,1,1,109,109,129,128,46
"3998",97,"[22]EssHnKqGocIHBJCErgJaHe",236,0.995781,22,237,1,236,1,1,0,1,1,111,111,126,125,46
"3999",98,"[22]EssHnKqGocIHBJCErgJaHe",239,0.995833,22,240,1,239,1,1,0,1,1,109,109,131,130,46
"4000",99,"[22]EssHnKqGocIHBJCErgJaHe",225,0.995575,22,226,1,225,1,1,0,1,1,118,118,108,107,46
"4001",0,"[27]EjwwsHnKqGocIHBJCpKqbEhzpnz",227,0.995614,27,228,1,227,1,1,0,1,1,117,117,111,110,47
"4002",1,"[27]EjwwsHnKqGocIHBJCpKqbEhzpnz",228,0.995633,27,229,1,228,1,1,0,1,1,116,116,113,112,47
"4003",2,"[27]EjwwsHnKqGocIHBJCpKqbEhzpnz",226,0.995595,27,227,1,226,1,1,0,1,1,119,119,108,107,47
"4004",3,"[27]EjwwsHnKqGocIHBJCpKqbEhzpnz",219,0.995455,27,220,1,219,1,1,0,1,1,124,124,96,95,47
"4005",4,"[27]EjwwsHnKqGocIHBJCpKqbEhzpnz",224,0.995556,27,225,1,224,1,1,0,1,1,121,121,104,103,47
"4006",5,"[27]EjwwsHnKqGocIHBJCpKqbEhzpnz",231,0.99569,27,232,1,231,1,1,0,1,1,114,114,118,117,47
"4007",6,"[27]EjwwsHnKqGocIHBJCpKqbEhzpnz",231,0.99569,27,232,1,231,1,1,0,1,1,116,116,116,115,47
"4008",7,"[27]EjwwsHnKqGocIHBJCpKqbEhzpnz",221,0.995495,27,222,1,221,1,1,0,1,1,121,121,101,100,47
"4009",8,"[27]EjwwsHnKqGocIHBJCpKqbEhzpnz",222,0.995516,27,223,1,222,1,1,0,1,1,121,121,102,101,47
"4010",9,"[27]EjwwsHnKqGocIHBJCpKqbEhzpnz",231,0.99569,27,232,1,231,1,1,0,1,1,114,114,118,117,47
"4011",10,"[27]EjwwsHnKqGocIHBJCpKqbEhzpnz",231,0.99569,27,232,1,231,1,1,0,1,1,116,116,116,115,47
"4012",11,"[27]EjwwsHnKqGocIHBJCpKqbEhzpnz",236,0.995781,27,237,1,236,1,1,0,1,1,109,109,128,127,47
"4013",12,"[27]EjwwsHnKqGocIHBJCpKqbEhzpnz",233,0.995726,27,234,1,233,1,1,0,1,1,111,111,123,122,47
"4014",13,"[27]EjwwsHnKqGocIHBJCpKqbEhzpnz",236,0.995781,27,237,1,236,1,1,0,1,1,109,109,128,127,47
"4015",14,"[27]EjwwsHnKqGocIHBJCpKqbEhzpnz",234,0.995745,27,235,1,234,1,1,0,1,1,114,114,121,120,47
"4016",15,"[27]EjwwsHnKqGocIHBJCpKqbEhzpnz",233,0.995726,27,234,1,233,1,1,0,1,1,115,115,119,118,47
"4017",16,"[27]EjwwsHnKqGocIHBJCpKqbEhzpnz",235,0.995763,27,236,1,235,1,1,0,1,1,110,110,126,125,47
"4018",17,"[27]EjwwsHnKqGocIHBJCpKqbEhzpnz",223,0.995536,27,224,1,223,1,1,0,1,1,119,119,105,104,47
"4019",18,"[27]EjwwsHnKqGocIHBJCpKqbEhzpnz",223,0.995536,27,224,1,223,1,1,0,1,1,119,119,105,104,47
"4020",19,"[27]EjwwsHnKqGocIHBJCpKqbEhzpnz",228,0.995633,27,229,1,228,1,1,0,1,1,117,117,112,111,47
"4021",20,"[27]EjwwsHnKqGocIHBJCpKqbEhzpnz",234,0.995745,27,235,1,234,1,1,0,1,1,112,112,123,122,47
"4022",21,"[27]EjwwsHnKqGocIHBJCpKqbEhzpnz",235,0.995763,27,236,1,235,1,1,0,1,1,111,111,125,124,47
"4023",22,"[27]EjwwsHnKqGocIHBJCpKqbEhzpnz",225,0.995575,27,226,1,225,1,1,0,1,1,120,120,106,105,47
"4024",23,"[27]EjwwsHnKqGocIHBJCpKqbEhzpnz",226,0.995595,27,227,1,226,1,1,0,1,1,117,117,110,109,47
"4025",24,"[27]EjwwsHnKqGocIHBJCpKqbEhzpnz",226,0.995595,27,227,1,226,1,1,0,1,1,118,118,109,108,47
"4026",25,"[27]EjwwsHnKqGocIHBJCpKqbEhzpnz",225,0.995575,27,226,1,225,1,1,0,1,1,119,119,107,106,47
"4027",26,"[27]EjwwsHnKqGocIHBJCpKqbEhzpnz",230,0.995671,27,231,1,230,1,1,0,1,1,114,114,117,116,47
"4028",27,"[27]EjwwsHnKqGocIHBJCpKqbEhzpnz",230,0.995671,27,231,1,230,1,1,0,1,1,114,114,117,116,47
"4029",28,"[27]EjwwsHnKqGocIHBJCpKqbEhzpnz",227,0.995614,27,228,1,227,1,1,0,1,1,117,117,111,110,47
"4030",29,"[27]EjwwsHnKqGocIHBJCpKqbEhzpnz",235,0.995763,27,236,1,235,1,1,0,1,1,112,112,124,123,47
"4031",30,"[27]EjwwsHnKqGocIHBJCpKqbEhzpnz",247,0.995968,27,248,1,247,1,1,0,1,1,101,101,147,146,47
"4032",31,"[27]EjwwsHnKqGocIHBJCpKqbEhzpnz",227,0.995614,27,228,1,227,1,1,0,1,1,117,117,111,110,47
"4033",32,"[27]EjwwsHnKqGocIHBJCpKqbEhzpnz",239,0.995833,27,240,1,239,1,1,0,1,1,107,107,133,132,47
"4034",33,"[27]EjwwsHnKqGocIHBJCpKqbEhzpnz",227,0.995614,27,228,1,227,1,1,0,1,1,117,117,111,110,47
"4035",34,"[27]EjwwsHnKqGocIHBJCpKqbEhzpnz",230,0.995671,27,231,1,230,1,1,0,1,1,115,115,116,115,47
"4036",35,"[27]EjwwsHnKqGocIHBJCpKqbEhzpnz",226,0.995595,27,227,1,226,1,1,0,1,1,118,118,109,108,47
"4037",36,"[27]EjwwsHnKqGocIHBJCpKqbEhzpnz",235,0.995763,27,236,1,235,1,1,0,1,1,111,111,125,124,47
"4038",37,"[27]EjwwsHnKqGocIHBJCpKqbEhzpnz",228,0.995633,27,229,1,228,1,1,0,1,1,116,116,113,112,47
"4039",38,"[27]EjwwsHnKqGocIHBJCpKqbEhzpnz",226,0.995595,27,227,1,226,1,1,0,1,1,118,118,109,108,47
"4040",39,"[27]EjwwsHnKqGocIHBJCpKqbEhzpnz",248,0.995984,27,249,1,248,1,1,0,1,1,103,103,146,145,47
"4041",40,"[27]EjwwsHnKqGocIHBJCpKqbEhzpnz",238,0.995816,27,239,1,238,1,1,0,1,1,107,107,132,131,47
"4042",41,"[27]EjwwsHnKqGocIHBJCpKqbEhzpnz",237,0.995798,27,238,1,237,1,1,0,1,1,108,108,130,129,47
"4043",42,"[27]EjwwsHnKqGocIHBJCpKqbEhzpnz",227,0.995614,27,228,1,227,1,1,0,1,1,117,117,111,110,47
"4044",43,"[27]EjwwsHnKqGocIHBJCpKqbEhzpnz",221,0.995495,27,222,1,221,1,1,0,1,1,121,121,101,100,47
"4045",44,"[27]EjwwsHnKqGocIHBJCpKqbEhzpnz",221,0.995495,27,222,1,221,1,1,0,1,1,122,122,100,99,47
"4046",45,"[27]EjwwsHnKqGocIHBJCpKqbEhzpnz",222,0.995516,27,223,1,222,1,1,0,1,1,120,120,103,102,47
"4047",46,"[27]EjwwsHnKqGocIHBJCpKqbEhzpnz",231,0.99569,27,232,1,231,1,1,0,1,1,115,115,117,116,47
"4048",47,"[27]EjwwsHnKqGocIHBJCpKqbEhzpnz",231,0.99569,27,232,1,231,1,1,0,1,1,115,115,117,116,47
"4049",48,"[27]EjwwsHnKqGocIHBJCpKqbEhzpnz",218,0.995434,27,219,1,218,1,1,0,1,1,124,124,95,94,47
"4050",49,"[27]EjwwsHnKqGocIHBJCpKqbEhzpnz",226,0.995595,27,227,1,226,1,1,0,1,1,117,117,110,109,47
"4051",50,"[27]EjwwsHnKqGocIHBJCpKqbEhzpnz",231,0.99569,27,232,1,231,1,1,0,1,1,114,114,118,117,47
"4052",51,"[27]EjwwsHnKqGocIHBJCpKqbEhzpnz",232,0.995708,27,233,1,232,1,1,0,1,1,114,114,119,118,47
"4053",52,"[27]EjwwsHnKqGocIHBJCpKqbEhzpnz",235,0.995763,27,236,1,235,1,1,0,1,1,110,110,126,125,47
"4054",53,"[27]EjwwsHnKqGocIHBJCpKqbEhzpnz",235,0.995763,27,236,1,235,1,1,0,1,1,111,111,125,124,47
"4055",54,"[27]EjwwsHnKqGocIHBJCpKqbEhzpnz",233,0.995726,27,234,1,233,1,1,0,1,1,112,112,122,121,47
"4056",55,"[27]EjwwsHnKqGocIHBJCpKqbEhzpnz",227,0.995614,27,228,1,227,1,1,0,1,1,117,117,111,110,47
"4057",56,"[27]EjwwsHnKqGocIHBJCpKqbEhzpnz",225,0.995575,27,226,1,225,1,1,0,1,1,118,118,108,107,47
"4058",57,"[27]EjwwsHnKqGocIHBJCpKqbEhzpnz",226,0.995595,27,227,1,226,1,1,0,1,1,117,117,110,109,47
"4059",58,"[27]EjwwsHnKqGocIHBJCpKqbEhzpnz",233,0.995726,27,234,1,233,1,1,0,1,1,111,111,123,122,47
"4060",59,"[27]EjwwsHnKqGocIHBJCpKqbEhzpnz",239,0.995833,27,240,1,239,1,1,0,1,1,112,112,128,127,47
"4061",60,"[27]EjwwsHnKqGocIHBJCpKqbEhzpnz",221,0.995495,27,222,1,221,1,1,0,1,1,121,121,101,100,47
"4062",61,"[27]EjwwsHnKqGocIHBJCpKqbEhzpnz",225,0.995575,27,226,1,225,1,1,0,1,1,118,118,108,107,47
"4063",62,"[27]EjwwsHnKqGocIHBJCpKqbEhzpnz",234,0.995745,27,235,1,234,1,1,0,1,1,111,111,124,123,47
"4064",63,"[27]EjwwsHnKqGocIHBJCpKqbEhzpnz",232,0.995708,27,233,1,232,1,1,0,1,1,114,114,119,118,47
"4065",64,"[27]EjwwsHnKqGocIHBJCpKqbEhzpnz",238,0.995816,27,239,1,238,1,1,0,1,1,112,112,127,126,47
"4066",65,"[27]EjwwsHnKqGocIHBJCpKqbEhzpnz",228,0.995633,27,229,1,228,1,1,0,1,1,115,115,114,113,47
"4067",66,"[27]EjwwsHnKqGocIHBJCpKqbEhzpnz",223,0.995536,27,224,1,223,1,1,0,1,1,119,119,105,104,47
"4068",67,"[27]EjwwsHnKqGocIHBJCpKqbEhzpnz",238,0.995816,27,239,1,238,1,1,0,1,1,109,109,130,129,47
"4069",68,"[27]EjwwsHnKqGocIHBJCpKqbEhzpnz",223,0.995536,27,224,1,223,1,1,0,1,1,121,121,103,102,47
"4070",69,"[27]EjwwsHnKqGocIHBJCpKqbEhzpnz",230,0.995671,27,231,1,230,1,1,0,1,1,114,114,117,116,47
"4071",70,"[27]EjwwsHnKqGocIHBJCpKqbEhzpnz",231,0.99569,27,232,1,231,1,1,0,1,1,118,118,114,113,47
"4072",71,"[27]EjwwsHnKqGocIHBJCpKqbEhzpnz",235,0.995763,27,236,1,235,1,1,0,1,1,112,112,124,123,47
"4073",72,"[27]EjwwsHnKqGocIHBJCpKqbEhzpnz",245,0.995935,27,246,1,245,1,1,0,1,1,107,107,139,138,47
"4074",73,"[27]EjwwsHnKqGocIHBJCpKqbEhzpnz",227,0.995614,27,228,1,227,1,1,0,1,1,119,119,109,108,47
"4075",74,"[27]EjwwsHnKqGocIHBJCpKqbEhzpnz",224,0.995556,27,225,1,224,1,1,0,1,1,119,119,106,105,47
"4076",75,"[27]EjwwsHnKqGocIHBJCpKqbEhzpnz",221,0.995495,27,222,1,221,1,1,0,1,1,121,121,101,100,47
"4077",76,"[27]EjwwsHnKqGocIHBJCpKqbEhzpnz",232,0.995708,27,233,1,232,1,1,0,1,1,115,115,118,117,47
"4078",77,"[27]EjwwsHnKqGocIHBJCpKqbEhzpnz",220,0.995475,27,221,1,220,1,1,0,1,1,124,124,97,96,47
"4079",78,"[27]EjwwsHnKqGocIHBJCpKqbEhzpnz",222,0.995516,27,223,1,222,1,1,0,1,1,121,121,102,101,47
"4080",79,"[27]EjwwsHnKqGocIHBJCpKqbEhzpnz",232,0.995708,27,233,1,232,1,1,0,1,1,112,112,121,120,47
"4081",80,"[27]EjwwsHnKqGocIHBJCpKqbEhzpnz",234,0.995745,27,235,1,234,1,1,0,1,1,111,111,124,123,47
"4082",81,"[27]EjwwsHnKqGocIHBJCpKqbEhzpnz",228,0.995633,27,229,1,228,1,1,0,1,1,115,115,114,113,47
"4083",82,"[27]EjwwsHnKqGocIHBJCpKqbEhzpnz",232,0.995708,27,233,1,232,1,1,0,1,1,112,112,121,120,47
"4084",83,"[27]EjwwsHnKqGocIHBJCpKqbEhzpnz",228,0.995633,27,229,1,228,1,1,0,1,1,115,115,114,113,47
"4085",84,"[27]EjwwsHnKqGocIHBJCpKqbEhzpnz",223,0.995536,27,224,1,223,1,1,0,1,1,120,120,104,103,47
"4086",85,"[27]EjwwsHnKqGocIHBJCpKqbEhzpnz",227,0.995614,27,228,1,227,1,1,0,1,1,116,116,112,111,47
"4087",86,"[27]EjwwsHnKqGocIHBJCpKqbEhzpnz",235,0.995763,27,236,1,235,1,1,0,1,1,111,111,125,124,47
"4088",87,"[27]EjwwsHnKqGocIHBJCpKqbEhzpnz",228,0.995633,27,229,1,228,1,1,0,1,1,115,115,114,113,47
"4089",88,"[27]EjwwsHnKqGocIHBJCpKqbEhzpnz",226,0.995595,27,227,1,226,1,1,0,1,1,117,117,110,109,47
"4090",89,"[27]EjwwsHnKqGocIHBJCpKqbEhzpnz",237,0.995798,27,238,1,237,1,1,0,1,1,111,111,127,126,47
"4091",90,"[27]EjwwsHnKqGocIHBJCpKqbEhzpnz",240,0.995851,27,241,1,240,1,1,0,1,1,108,108,133,132,47
"4092",91,"[27]EjwwsHnKqGocIHBJCpKqbEhzpnz",232,0.995708,27,233,1,232,1,1,0,1,1,112,112,121,120,47
"4093",92,"[27]EjwwsHnKqGocIHBJCpKqbEhzpnz",225,0.995575,27,226,1,225,1,1,0,1,1,119,119,107,106,47
"4094",93,"[27]EjwwsHnKqGocIHBJCpKqbEhzpnz",222,0.995516,27,223,1,222,1,1,0,1,1,120,120,103,102,47
"4095",94,"[27]EjwwsHnKqGocIHBJCpKqbEhzpnz",227,0.995614,27,228,1,227,1,1,0,1,1,123,123,105,104,47
"4096",95,"[27]EjwwsHnKqGocIHBJCpKqbEhzpnz",229,0.995652,27,230,1,229,1,1,0,1,1,115,115,115,114,47
"4097",96,"[27]EjwwsHnKqGocIHBJCpKqbEhzpnz",231,0.99569,27,232,1,231,1,1,0,1,1,113,113,119,118,47
"4098",97,"[27]EjwwsHnKqGocIHBJCpKqbEhzpnz",235,0.995763,27,236,1,235,1,1,0,1,1,114,114,122,121,47
"4099",98,"[27]EjwwsHnKqGocIHBJCpKqbEhzpnz",233,0.995726,27,234,1,233,1,1,0,1,1,112,112,122,121,47
"4100",99,"[27]EjwwsHnKqGocIHBJCpKqbEhzpnz",226,0.995595,27,227,1,226,1,1,0,1,1,117,117,110,109,47
"4101",0,"[32]EKyrAwHnKqGocIHBJCpeiJvBKHyccmoa",221,0.995495,32,222,1,221,1,1,0,1,1,123,123,99,98,48
"4102",1,"[32]EKyrAwHnKqGocIHBJCpeiJvBKHyccmoa",220,0.995475,32,221,1,220,1,1,0,1,1,122,122,99,98,48
"4103",2,"[32]EKyrAwHnKqGocIHBJCpeiJvBKHyccmoa",232,0.995708,32,233,1,232,1,1,0,1,1,113,113,120,119,48
"4104",3,"[32]EKyrAwHnKqGocIHBJCpeiJvBKHyccmoa",235,0.995763,32,236,1,235,1,1,0,1,1,111,111,125,124,48
"4105",4,"[32]EKyrAwHnKqGocIHBJCpeiJvBKHyccmoa",235,0.995763,32,236,1,235,1,1,0,1,1,111,111,125,124,48
"4106",5,"[32]EKyrAwHnKqGocIHBJCpeiJvBKHyccmoa",234,0.995745,32,235,1,234,1,1,0,1,1,111,111,124,123,48
"4107",6,"[32]EKyrAwHnKqGocIHBJCpeiJvBKHyccmoa",223,0.995536,32,224,1,223,1,1,0,1,1,120,120,104,103,48
"4108",7,"[32]EKyrAwHnKqGocIHBJCpeiJvBKHyccmoa",225,0.995575,32,226,1,225,1,1,0,1,1,120,120,106,105,48
"4109",8,"[32]EKyrAwHnKqGocIHBJCpeiJvBKHyccmoa",229,0.995652,32,230,1,229,1,1,0,1,1,116,116,114,113,48
"4110",9,"[32]EKyrAwHnKqGocIHBJCpeiJvBKHyccmoa",224,0.995556,32,225,1,224,1,1,0,1,1,119,119,106,105,48
"4111",10,"[32]EKyrAwHnKqGocIHBJCpeiJvBKHyccmoa",218,0.995434,32,219,1,218,1,1,0,1,1,125,125,94,93,48
"4112",11,"[32]EKyrAwHnKqGocIHBJCpeiJvBKHyccmoa",235,0.995763,32,236,1,235,1,1,0,1,1,110,110,126,125,48
"4113",12,"[32]EKyrAwHnKqGocIHBJCpeiJvBKHyccmoa",237,0.995798,32,238,1,237,1,1,0,1,1,109,109,129,128,48
"4114",13,"[32]EKyrAwHnKqGocIHBJCpeiJvBKHyccmoa",233,0.995726,32,234,1,233,1,1,0,1,1,113,113,121,120,48
"4115",14,"[32]EKyrAwHnKqGocIHBJCpeiJvBKHyccmoa",227,0.995614,32,228,1,227,1,1,0,1,1,120,120,108,107,48
"4116",15,"[32]EKyrAwHnKqGocIHBJCpeiJvBKHyccmoa",239,0.995833,32,240,1,239,1,1,0,1,1,109,109,131,130,48
"4117",16,"[32]EKyrAwHnKqGocIHBJCpeiJvBKHyccmoa",237,0.995798,32,238,1,237,1,1,0,1,1,112,112,126,125,48
"4118",17,"[32]EKyrAwHnKqGocIHBJCpeiJvBKHyccmoa",229,0.995652,32,230,1,229,1,1,0,1,1,115,115,115,114,48
"4119",18,"[32]EKyrAwHnKqGocIHBJCpeiJvBKHyccmoa",222,0.995516,32,223,1,222,1,1,0,1,1,122,122,101,100,48
"4120",19,"[32]EKyrAwHnKqGocIHBJCpeiJvBKHyccmoa",229,0.995652,32,230,1,229,1,1,0,1,1,116,116,114,113,48
"4121",20,"[32]EKyrAwHnKqGocIHBJCpeiJvBKHyccmoa",225,0.995575,32,226,1,225,1,1,0,1,1,119,119,107,106,48
"4122",21,"[32]EKyrAwHnKqGocIHBJCpeiJvBKHyccmoa",227,0.995614,32,228,1,227,1,1,0,1,1,117,117,111,110,48
"4123",22,"[32]EKyrAwHnKqGocIHBJCpeiJvBKHyccmoa",235,0.995763,32,236,1,235,1,1,0,1,1,110,110,126,125,48
"4124",23,"[32]EKyrAwHnKqGocIHBJCpeiJvBKHyccmoa",227,0.995614,32,228,1,227,1,1,0,1,1,118,118,110,109,48
"4125",24,"[32]EKyrAwHnKqGocIHBJCpeiJvBKHyccmoa",236,0.995781,32,237,1,236,1,1,0,1,1,110,110,127,126,48
"4126",25,"[32]EKyrAwHnKqGocIHBJCpeiJvBKHyccmoa",229,0.995652,32,230,1,229,1,1,0,1,1,116,116,114,113,48
"4127",26,"[32]EKyrAwHnKqGocIHBJCpeiJvBKHyccmoa",225,0.995575,32,226,1,225,1,1,0,1,1,119,119,107,106,48
"4128",27,"[32]EKyrAwHnKqGocIHBJCpeiJvBKHyccmoa",230,0.995671,32,231,1,230,1,1,0,1,1,114,114,117,116,48
"4129",28,"[32]EKyrAwHnKqGocIHBJCpeiJvBKHyccmoa",232,0.995708,32,233,1,232,1,1,0,1,1,114,114,119,118,48
"4130",29,"[32]EKyrAwHnKqGocIHBJCpeiJvBKHyccmoa",233,0.995726,32,234,1,233,1,1,0,1,1,112,112,122,121,48
"4131",30,"[32]EKyrAwHnKqGocIHBJCpeiJvBKHyccmoa",230,0.995671,32,231,1,230,1,1,0,1,1,115,115,116,115,48
"4132",31,"[32]EKyrAwHnKqGocIHBJCpeiJvBKHyccmoa",230,0.995671,32,231,1,230,1,1,0,1,1,114,114,117,116,48
"4133",32,"[32]EKyrAwHnKqGocIHBJCpeiJvBKHyccmoa",230,0.995671,32,231,1,230,1,1,0,1,1,116,116,115,114,48
"4134",33,"[32]EKyrAwHnKqGocIHBJCpeiJvBKHyccmoa",230,0.995671,32,231,1,230,1,1,0,1,1,119,119,112,111,48
"4135",34,"[32]EKyrAwHnKqGocIHBJCpeiJvBKHyccmoa",220,0.995475,32,221,1,220,1,1,0,1,1,124,124,97,96,48
"4136",35,"[32]EKyrAwHnKqGocIHBJCpeiJvBKHyccmoa",225,0.995575,32,226,1,225,1,1,0,1,1,120,120,106,105,48
"4137",36,"[32]EKyrAwHnKqGocIHBJCpeiJvBKHyccmoa",232,0.995708,32,233,1,232,1,1,0,1,1,113,113,120,119,48
"4138",37,"[32]EKyrAwHnKqGocIHBJCpeiJvBKHyccmoa",224,0.995556,32,225,1,224,1,1,0,1,1,120,120,105,104,48
"4139",38,"[32]EKyrAwHnKqGocIHBJCpeiJvBKHyccmoa",232,0.995708,32,233,1,232,1,1,0,1,1,115,115,118,117,48
"4140",39,"[32]EKyrAwHnKqGocIHBJCpeiJvBKHyccmoa",237,0.995798,32,238,1,237,1,1,0,1,1,112,112,126,125,48
"4141",40,"[32]EKyrAwHnKqGocIHBJCpeiJvBKHyccmoa",233,0.995726,32,234,1,233,1,1,0,1,1,112,112,122,121,48
"4142",41,"[32]EKyrAwHnKqGocIHBJCpeiJvBKHyccmoa",232,0.995708,32,233,1,232,1,1,0,1,1,113,113,120,119,48
"4143",42,"[32]EKyrAwHnKqGocIHBJCpeiJvBKHyccmoa",225,0.995575,32,226,1,225,1,1,0,1,1,119,119,107,106,48
"4144",43,"[32]EKyrAwHnKqGocIHBJCpeiJvBKHyccmoa",230,0.995671,32,231,1,230,1,1,0,1,1,115,115,116,115,48
"4145",44,"[32]EKyrAwHnKqGocIHBJCpeiJvBKHyccmoa",224,0.995556,32,225,1,224,1,1,0,1,1,119,119,106,105,48
"4146",45,"[32]EKyrAwHnKqGocIHBJCpeiJvBKHyccmoa",231,0.99569,32,232,1,231,1,1,0,1,1,115,115,117,116,48
"4147",46,"[32]EKyrAwHnKqGocIHBJCpeiJvBKHyccmoa",227,0.995614,32,228,1,227,1,1,0,1,1,118,118,110,109,48
"4148",47,"[32]EKyrAwHnKqGocIHBJCpeiJvBKHyccmoa",231,0.99569,32,232,1,231,1,1,0,1,1,115,115,117,116,48
"4149",48,"[32]EKyrAwHnKqGocIHBJCpeiJvBKHyccmoa",232,0.995708,32,233,1,232,1,1,0,1,1,113,113,120,119,48
"4150",49,"[32]EKyrAwHnKqGocIHBJCpeiJvBKHyccmoa",242,0.995885,32,243,1,242,1,1,0,1,1,108,108,135,134,48
"4151",50,"[32]EKyrAwHnKqGocIHBJCpeiJvBKHyccmoa",231,0.99569,32,232,1,231,1,1,0,1,1,115,115,117,116,48
"4152",51,"[32]EKyrAwHnKqGocIHBJCpeiJvBKHyccmoa",228,0.995633,32,229,1,228,1,1,0,1,1,117,117,112,111,48
"4153",52,"[32]EKyrAwHnKqGocIHBJCpeiJvBKHyccmoa",232,0.995708,32,233,1,232,1,1,0,1,1,113,113,120,119,48
"4154",53,"[32]EKyrAwHnKqGocIHBJCpeiJvBKHyccmoa",237,0.995798,32,238,1,237,1,1,0,1,1,110,110,128,127,48
"4155",54,"[32]EKyrAwHnKqGocIHBJCpeiJvBKHyccmoa",223,0.995536,32,224,1,223,1,1,0,1,1,120,120,104,103,48
"4156",55,"[32]EKyrAwHnKqGocIHBJCpeiJvBKHyccmoa",236,0.995781,32,237,1,236,1,1,0,1,1,112,112,125,124,48
"4157",56,"[32]EKyrAwHnKqGocIHBJCpeiJvBKHyccmoa",232,0.995708,32,233,1,232,1,1,0,1,1,114,114,119,118,48
"4158",57,"[32]EKyrAwHnKqGocIHBJCpeiJvBKHyccmoa",228,0.995633,32,229,1,228,1,1,0,1,1,116,116,113,112,48
"4159",58,"[32]EKyrAwHnKqGocIHBJCpeiJvBKHyccmoa",228,0.995633,32,229,1,228,1,1,0,1,1,118,118,111,110,48
"4160",59,"[32]EKyrAwHnKqGocIHBJCpeiJvBKHyccmoa",230,0.995671,32,231,1,230,1,1,0,1,1,117,117,114,113,48
"4161",60,"[32]EKyrAwHnKqGocIHBJCpeiJvBKHyccmoa",234,0.995745,32,235,1,234,1,1,0,1,1,111,111,124,123,48
"4162",61,"[32]EKyrAwHnKqGocIHBJCpeiJvBKHyccmoa",242,0.995885,32,243,1,242,1,1,0,1,1,108,108,135,134,48
"4163",62,"[32]EKyrAwHnKqGocIHBJCpeiJvBKHyccmoa",228,0.995633,32,229,1,228,1,1,0,1,1,117,117,112,111,48
"4164",63,"[32]EKyrAwHnKqGocIHBJCpeiJvBKHyccmoa",230,0.995671,32,231,1,230,1,1,0,1,1,116,116,115,114,48
"4165",64,"[32]EKyrAwHnKqGocIHBJCpeiJvBKHyccmoa",232,0.995708,32,233,1,232,1,1,0,1,1,114,114,119,118,48
"4166",65,"[32]EKyrAwHnKqGocIHBJCpeiJvBKHyccmoa",232,0.995708,32,233,1,232,1,1,0,1,1,113,113,120,119,48
"4167",66,"[32]EKyrAwHnKqGocIHBJCpeiJvBKHyccmoa",228,0.995633,32,229,1,228,1,1,0,1,1,116,116,113,112,48
"4168",67,"[32]EKyrAwHnKqGocIHBJCpeiJvBKHyccmoa",238,0.995816,32,239,1,238,1,1,0,1,1,108,108,131,130,48
"4169",68,"[32]EKyrAwHnKqGocIHBJCpeiJvBKHyccmoa",217,0.995413,32,218,1,217,1,1,0,1,1,125,125,93,92,48
"4170",69,"[32]EKyrAwHnKqGocIHBJCpeiJvBKHyccmoa",237,0.995798,32,238,1,237,1,1,0,1,1,109,109,129,128,48
"4171",70,"[32]EKyrAwHnKqGocIHBJCpeiJvBKHyccmoa",233,0.995726,32,234,1,233,1,1,0,1,1,112,112,122,121,48
"4172",71,"[32]EKyrAwHnKqGocIHBJCpeiJvBKHyccmoa",231,0.99569,32,232,1,231,1,1,0,1,1,114,114,118,117,48
"4173",72,"[32]EKyrAwHnKqGocIHBJCpeiJvBKHyccmoa",233,0.995726,32,234,1,233,1,1,0,1,1,112,112,122,121,48
"4174",73,"[32]EKyrAwHnKqGocIHBJCpeiJvBKHyccmoa",221,0.995495,32,222,1,221,1,1,0,1,1,122,122,100,99,48
"4175",74,"[32]EKyrAwHnKqGocIHBJCpeiJvBKHyccmoa",235,0.995763,32,236,1,235,1,1,0,1,1,112,112,124,123,48
"4176",75,"[32]EKyrAwHnKqGocIHBJCpeiJvBKHyccmoa",235,0.995763,32,236,1,235,1,1,0,1,1,111,111,125,124,48
"4177",76,"[32]EKyrAwHnKqGocIHBJCpeiJvBKHyccmoa",227,0.995614,32,228,1,227,1,1,0,1,1,119,119,109,108,48
"4178",77,"[32]EKyrAwHnKqGocIHBJCpeiJvBKHyccmoa",221,0.995495,32,222,1,221,1,1,0,1,1,122,122,100,99,48
"4179",78,"[32]EKyrAwHnKqGocIHBJCpeiJvBKHyccmoa",228,0.995633,32,229,1,228,1,1,0,1,1,117,117,112,111,48
"4180",79,"[32]EKyrAwHnKqGocIHBJCpeiJvBKHyccmoa",228,0.995633,32,229,1,228,1,1,0,1,1,118,118,111,110,48
"4181",80,"[32]EKyrAwHnKqGocIHBJCpeiJvBKHyccmoa",235,0.995763,32,236,1,235,1,1,0,1,1,116,116,120,119,48
"4182",81,"[32]EKyrAwHnKqGocIHBJCpeiJvBKHyccmoa",243,0.995902,32,244,1,243,1,1,0,1,1,108,108,136,135,48
"4183",82,"[32]EKyrAwHnKqGocIHBJCpeiJvBKHyccmoa",250,0.996016,32,251,1,250,1,1,0,1,1,102,102,149,148,48
"4184",83,"[32]EKyrAwHnKqGocIHBJCpeiJvBKHyccmoa",233,0.995726,32,234,1,233,1,1,0,1,1,113,113,121,120,48
"4185",84,"[32]EKyrAwHnKqGocIHBJCpeiJvBKHyccmoa",244,0.995918,32,245,1,244,1,1,0,1,1,104,104,141,140,48
"4186",85,"[32]EKyrAwHnKqGocIHBJCpeiJvBKHyccmoa",231,0.99569,32,232,1,231,1,1,0,1,1,115,115,117,116,48
"4187",86,"[32]EKyrAwHnKqGocIHBJCpeiJvBKHyccmoa",235,0.995763,32,236,1,235,1,1,0,1,1,112,112,124,123,48
"4188",87,"[32]EKyrAwHnKqGocIHBJCpeiJvBKHyccmoa",239,0.995833,32,240,1,239,1,1,0,1,1,108,108,132,131,48
"4189",88,"[32]EKyrAwHnKqGocIHBJCpeiJvBKHyccmoa",232,0.995708,32,233,1,232,1,1,0,1,1,114,114,119,118,48
"4190",89,"[32]EKyrAwHnKqGocIHBJCpeiJvBKHyccmoa",228,0.995633,32,229,1,228,1,1,0,1,1,117,117,112,111,48
"4191",90,"[32]EKyrAwHnKqGocIHBJCpeiJvBKHyccmoa",222,0.995516,32,223,1,222,1,1,0,1,1,122,122,101,100,48
"4192",91,"[32]EKyrAwHnKqGocIHBJCpeiJvBKHyccmoa",222,0.995516,32,223,1,222,1,1,0,1,1,122,122,101,100,48
"4193",92,"[32]EKyrAwHnKqGocIHBJCpeiJvBKHyccmoa",239,0.995833,32,240,1,239,1,1,0,1,1,108,108,132,131,48
"4194",93,"[32]EKyrAwHnKqGocIHBJCpeiJvBKHyccmoa",235,0.995763,32,236,1,235,1,1,0,1,1,112,112,124,123,48
"4195",94,"[32]EKyrAwHnKqGocIHBJCpeiJvBKHyccmoa",241,0.995868,32,242,1,241,1,1,0,1,1,106,106,136,135,48
"4196",95,"[32]EKyrAwHnKqGocIHBJCpeiJvBKHyccmoa",230,0.995671,32,231,1,230,1,1,0,1,1,114,114,117,116,48
"4197",96,"[32]EKyrAwHnKqGocIHBJCpeiJvBKHyccmoa",223,0.995536,32,224,1,223,1,1,0,1,1,120,120,104,103,48
"4198",97,"[32]EKyrAwHnKqGocIHBJCpeiJvBKHyccmoa",234,0.995745,32,235,1,234,1,1,0,1,1,113,113,122,121,48
"4199",98,"[32]EKyrAwHnKqGocIHBJCpeiJvBKHyccmoa",243,0.995902,32,244,1,243,1,1,0,1,1,104,104,140,139,48
"4200",99,"[32]EKyrAwHnKqGocIHBJCpeiJvBKHyccmoa",223,0.995536,32,224,1,223,1,1,0,1,1,120,120,104,103,48
"4201",0,"[34]EelKsHnKqGocIHcJCotaFpKiGthDxfEapq",239,0.995833,34,240,1,239,1,1,0,1,1,107,107,133,132,49
"4202",1,"[34]EelKsHnKqGocIHcJCotaFpKiGthDxfEapq",239,0.995833,34,240,1,239,1,1,0,1,1,108,108,132,131,49
"4203",2,"[34]EelKsHnKqGocIHcJCotaFpKiGthDxfEapq",223,0.995536,34,224,1,223,1,1,0,1,1,122,122,102,101,49
"4204",3,"[34]EelKsHnKqGocIHcJCotaFpKiGthDxfEapq",224,0.995556,34,225,1,224,1,1,0,1,1,121,121,104,103,49
"4205",4,"[34]EelKsHnKqGocIHcJCotaFpKiGthDxfEapq",237,0.995798,34,238,1,237,1,1,0,1,1,111,111,127,126,49
"4206",5,"[34]EelKsHnKqGocIHcJCotaFpKiGthDxfEapq",243,0.995902,34,244,1,243,1,1,0,1,1,104,104,140,139,49
"4207",6,"[34]EelKsHnKqGocIHcJCotaFpKiGthDxfEapq",227,0.995614,34,228,1,227,1,1,0,1,1,117,117,111,110,49
"4208",7,"[34]EelKsHnKqGocIHcJCotaFpKiGthDxfEapq",227,0.995614,34,228,1,227,1,1,0,1,1,118,118,110,109,49
"4209",8,"[34]EelKsHnKqGocIHcJCotaFpKiGthDxfEapq",222,0.995516,34,223,1,222,1,1,0,1,1,122,122,101,100,49
"4210",9,"[34]EelKsHnKqGocIHcJCotaFpKiGthDxfEapq",231,0.99569,34,232,1,231,1,1,0,1,1,115,115,117,116,49
"4211",10,"[34]EelKsHnKqGocIHcJCotaFpKiGthDxfEapq",227,0.995614,34,228,1,227,1,1,0,1,1,119,119,109,108,49
"4212",11,"[34]EelKsHnKqGocIHcJCotaFpKiGthDxfEapq",226,0.995595,34,227,1,226,1,1,0,1,1,120,120,107,106,49
"4213",12,"[34]EelKsHnKqGocIHcJCotaFpKiGthDxfEapq",233,0.995726,34,234,1,233,1,1,0,1,1,113,113,121,120,49
"4214",13,"[34]EelKsHnKqGocIHcJCotaFpKiGthDxfEapq",238,0.995816,34,239,1,238,1,1,0,1,1,108,108,131,130,49
"4215",14,"[34]EelKsHnKqGocIHcJCotaFpKiGthDxfEapq",239,0.995833,34,240,1,239,1,1,0,1,1,112,112,128,127,49
"4216",15,"[34]EelKsHnKqGocIHcJCotaFpKiGthDxfEapq",238,0.995816,34,239,1,238,1,1,0,1,1,111,111,128,127,49
"4217",16,"[34]EelKsHnKqGocIHcJCotaFpKiGthDxfEapq",228,0.995633,34,229,1,228,1,1,0,1,1,118,118,111,110,49
"4218",17,"[34]EelKsHnKqGocIHcJCotaFpKiGthDxfEapq",228,0.995633,34,229,1,228,1,1,0,1,1,117,117,112,111,49
"4219",18,"[34]EelKsHnKqGocIHcJCotaFpKiGthDxfEapq",230,0.995671,34,231,1,230,1,1,0,1,1,115,115,116,115,49
"4220",19,"[34]EelKsHnKqGocIHcJCotaFpKiGthDxfEapq",233,0.995726,34,234,1,233,1,1,0,1,1,113,113,121,120,49
"4221",20,"[34]EelKsHnKqGocIHcJCotaFpKiGthDxfEapq",227,0.995614,34,228,1,227,1,1,0,1,1,117,117,111,110,49
"4222",21,"[34]EelKsHnKqGocIHcJCotaFpKiGthDxfEapq",230,0.995671,34,231,1,230,1,1,0,1,1,117,117,114,113,49
"4223",22,"[34]EelKsHnKqGocIHcJCotaFpKiGthDxfEapq",228,0.995633,34,229,1,228,1,1,0,1,1,116,116,113,112,49
"4224",23,"[34]EelKsHnKqGocIHcJCotaFpKiGthDxfEapq",232,0.995708,34,233,1,232,1,1,0,1,1,116,116,117,116,49
"4225",24,"[34]EelKsHnKqGocIHcJCotaFpKiGthDxfEapq",222,0.995516,34,223,1,222,1,1,0,1,1,121,121,102,101,49
"4226",25,"[34]EelKsHnKqGocIHcJCotaFpKiGthDxfEapq",232,0.995708,34,233,1,232,1,1,0,1,1,115,115,118,117,49
"4227",26,"[34]EelKsHnKqGocIHcJCotaFpKiGthDxfEapq",229,0.995652,34,230,1,229,1,1,0,1,1,116,116,114,113,49
"4228",27,"[34]EelKsHnKqGocIHcJCotaFpKiGthDxfEapq",231,0.99569,34,232,1,231,1,1,0,1,1,115,115,117,116,49
"4229",28,"[34]EelKsHnKqGocIHcJCotaFpKiGthDxfEapq",243,0.995902,34,244,1,243,1,1,0,1,1,107,107,137,136,49
"4230",29,"[34]EelKsHnKqGocIHcJCotaFpKiGthDxfEapq",233,0.995726,34,234,1,233,1,1,0,1,1,113,113,121,120,49
"4231",30,"[34]EelKsHnKqGocIHcJCotaFpKiGthDxfEapq",226,0.995595,34,227,1,226,1,1,0,1,1,118,118,109,108,49
"4232",31,"[34]EelKsHnKqGocIHcJCotaFpKiGthDxfEapq",235,0.995763,34,236,1,235,1,1,0,1,1,111,111,125,124,49
"4233",32,"[34]EelKsHnKqGocIHcJCotaFpKiGthDxfEapq",237,0.995798,34,238,1,237,1,1,0,1,1,113,113,125,124,49
"4234",33,"[34]EelKsHnKqGocIHcJCotaFpKiGthDxfEapq",234,0.995745,34,235,1,234,1,1,0,1,1,113,113,122,121,49
"4235",34,"[34]EelKsHnKqGocIHcJCotaFpKiGthDxfEapq",232,0.995708,34,233,1,232,1,1,0,1,1,114,114,119,118,49
"4236",35,"[34]EelKsHnKqGocIHcJCotaFpKiGthDxfEapq",235,0.995763,34,236,1,235,1,1,0,1,1,112,112,124,123,49
"4237",36,"[34]EelKsHnKqGocIHcJCotaFpKiGthDxfEapq",231,0.99569,34,232,1,231,1,1,0,1,1,117,117,115,114,49
"4238",37,"[34]EelKsHnKqGocIHcJCotaFpKiGthDxfEapq",235,0.995763,34,236,1,235,1,1,0,1,1,113,113,123,122,49
"4239",38,"[34]EelKsHnKqGocIHcJCotaFpKiGthDxfEapq",239,0.995833,34,240,1,239,1,1,0,1,1,107,107,133,132,49
"4240",39,"[34]EelKsHnKqGocIHcJCotaFpKiGthDxfEapq",219,0.995455,34,220,1,219,1,1,0,1,1,123,123,97,96,49
"4241",40,"[34]EelKsHnKqGocIHcJCotaFpKiGthDxfEapq",224,0.995556,34,225,1,224,1,1,0,1,1,120,120,105,104,49
"4242",41,"[34]EelKsHnKqGocIHcJCotaFpKiGthDxfEapq",230,0.995671,34,231,1,230,1,1,0,1,1,117,117,114,113,49
"4243",42,"[34]EelKsHnKqGocIHcJCotaFpKiGthDxfEapq",228,0.995633,34,229,1,228,1,1,0,1,1,116,116,113,112,49
"4244",43,"[34]EelKsHnKqGocIHcJCotaFpKiGthDxfEapq",227,0.995614,34,228,1,227,1,1,0,1,1,118,118,110,109,49
"4245",44,"[34]EelKsHnKqGocIHcJCotaFpKiGthDxfEapq",234,0.995745,34,235,1,234,1,1,0,1,1,113,113,122,121,49
"4246",45,"[34]EelKsHnKqGocIHcJCotaFpKiGthDxfEapq",226,0.995595,34,227,1,226,1,1,0,1,1,119,119,108,107,49
"4247",46,"[34]EelKsHnKqGocIHcJCotaFpKiGthDxfEapq",234,0.995745,34,235,1,234,1,1,0,1,1,112,112,123,122,49
"4248",47,"[34]EelKsHnKqGocIHcJCotaFpKiGthDxfEapq",227,0.995614,34,228,1,227,1,1,0,1,1,117,117,111,110,49
"4249",48,"[34]EelKsHnKqGocIHcJCotaFpKiGthDxfEapq",234,0.995745,34,235,1,234,1,1,0,1,1,115,115,120,119,49
"4250",49,"[34]EelKsHnKqGocIHcJCotaFpKiGthDxfEapq",236,0.995781,34,237,1,236,1,1,0,1,1,110,110,127,126,49
"4251",50,"[34]EelKsHnKqGocIHcJCotaFpKiGthDxfEapq",224,0.995556,34,225,1,224,1,1,0,1,1,120,120,105,104,49
"4252",51,"[34]EelKsHnKqGocIHcJCotaFpKiGthDxfEapq",235,0.995763,34,236,1,235,1,1,0,1,1,111,111,125,124,49
"4253",52,"[34]EelKsHnKqGocIHcJCotaFpKiGthDxfEapq",230,0.995671,34,231,1,230,1,1,0,1,1,116,116,115,114,49
"4254",53,"[34]EelKsHnKqGocIHcJCotaFpKiGthDxfEapq",240,0.995851,34,241,1,240,1,1,0,1,1,108,108,133,132,49
"4255",54,"[34]EelKsHnKqGocIHcJCotaFpKiGthDxfEapq",235,0.995763,34,236,1,235,1,1,0,1,1,111,111,125,124,49
"4256",55,"[34]EelKsHnKqGocIHcJCotaFpKiGthDxfEapq",226,0.995595,34,227,1,226,1,1,0,1,1,119,119,108,107,49
"4257",56,"[34]EelKsHnKqGocIHcJCotaFpKiGthDxfEapq",230,0.995671,34,231,1,230,1,1,0,1,1,118,118,113,112,49
"4258",57,"[34]EelKsHnKqGocIHcJCotaFpKiGthDxfEapq",225,0.995575,34,226,1,225,1,1,0,1,1,119,119,107,106,49
"4259",58,"[34]EelKsHnKqGocIHcJCotaFpKiGthDxfEapq",224,0.995556,34,225,1,224,1,1,0,1,1,119,119,106,105,49
"4260",59,"[34]EelKsHnKqGocIHcJCotaFpKiGthDxfEapq",222,0.995516,34,223,1,222,1,1,0,1,1,121,121,102,101,49
"4261",60,"[34]EelKsHnKqGocIHcJCotaFpKiGthDxfEapq",224,0.995556,34,225,1,224,1,1,0,1,1,119,119,106,105,49
"4262",61,"[34]EelKsHnKqGocIHcJCotaFpKiGthDxfEapq",226,0.995595,34,227,1,226,1,1,0,1,1,118,118,109,108,49
"4263",62,"[34]EelKsHnKqGocIHcJCotaFpKiGthDxfEapq",238,0.995816,34,239,1,238,1,1,0,1,1,109,109,130,129,49
"4264",63,"[34]EelKsHnKqGocIHcJCotaFpKiGthDxfEapq",230,0.995671,34,231,1,230,1,1,0,1,1,116,116,115,114,49
"4265",64,"[34]EelKsHnKqGocIHcJCotaFpKiGthDxfEapq",225,0.995575,34,226,1,225,1,1,0,1,1,120,120,106,105,49
"4266",65,"[34]EelKsHnKqGocIHcJCotaFpKiGthDxfEapq",233,0.995726,34,234,1,233,1,1,0,1,1,112,112,122,121,49
"4267",66,"[34]EelKsHnKqGocIHcJCotaFpKiGthDxfEapq",227,0.995614,34,228,1,227,1,1,0,1,1,120,120,108,107,49
"4268",67,"[34]EelKsHnKqGocIHcJCotaFpKiGthDxfEapq",228,0.995633,34,229,1,228,1,1,0,1,1,116,116,113,112,49
"4269",68,"[34]EelKsHnKqGocIHcJCotaFpKiGthDxfEapq",230,0.995671,34,231,1,230,1,1,0,1,1,116,116,115,114,49
"4270",69,"[34]EelKsHnKqGocIHcJCotaFpKiGthDxfEapq",235,0.995763,34,236,1,235,1,1,0,1,1,112,112,124,123,49
"4271",70,"[34]EelKsHnKqGocIHcJCotaFpKiGthDxfEapq",233,0.995726,34,234,1,233,1,1,0,1,1,114,114,120,119,49
"4272",71,"[34]EelKsHnKqGocIHcJCotaFpKiGthDxfEapq",234,0.995745,34,235,1,234,1,1,0,1,1,112,112,123,122,49
"4273",72,"[34]EelKsHnKqGocIHcJCotaFpKiGthDxfEapq",236,0.995781,34,237,1,236,1,1,0,1,1,111,111,126,125,49
"4274",73,"[34]EelKsHnKqGocIHcJCotaFpKiGthDxfEapq",233,0.995726,34,234,1,233,1,1,0,1,1,113,113,121,120,49
"4275",74,"[34]EelKsHnKqGocIHcJCotaFpKiGthDxfEapq",223,0.995536,34,224,1,223,1,1,0,1,1,121,121,103,102,49
"4276",75,"[34]EelKsHnKqGocIHcJCotaFpKiGthDxfEapq",242,0.995885,34,243,1,242,1,1,0,1,1,105,105,138,137,49
"4277",76,"[34]EelKsHnKqGocIHcJCotaFpKiGthDxfEapq",229,0.995652,34,230,1,229,1,1,0,1,1,118,118,112,111,49
"4278",77,"[34]EelKsHnKqGocIHcJCotaFpKiGthDxfEapq",238,0.995816,34,239,1,238,1,1,0,1,1,108,108,131,130,49
"4279",78,"[34]EelKsHnKqGocIHcJCotaFpKiGthDxfEapq",227,0.995614,34,228,1,227,1,1,0,1,1,119,119,109,108,49
"4280",79,"[34]EelKsHnKqGocIHcJCotaFpKiGthDxfEapq",226,0.995595,34,227,1,226,1,1,0,1,1,120,120,107,106,49
"4281",80,"[34]EelKsHnKqGocIHcJCotaFpKiGthDxfEapq",219,0.995455,34,220,1,219,1,1,0,1,1,124,124,96,95,49
"4282",81,"[34]EelKsHnKqGocIHcJCotaFpKiGthDxfEapq",238,0.995816,34,239,1,238,1,1,0,1,1,113,113,126,125,49
"4283",82,"[34]EelKsHnKqGocIHcJCotaFpKiGthDxfEapq",237,0.995798,34,238,1,237,1,1,0,1,1,109,109,129,128,49
"4284",83,"[34]EelKsHnKqGocIHcJCotaFpKiGthDxfEapq",233,0.995726,34,234,1,233,1,1,0,1,1,112,112,122,121,49
"4285",84,"[34]EelKsHnKqGocIHcJCotaFpKiGthDxfEapq",227,0.995614,34,228,1,227,1,1,0,1,1,118,118,110,109,49
"4286",85,"[34]EelKsHnKqGocIHcJCotaFpKiGthDxfEapq",231,0.99569,34,232,1,231,1,1,0,1,1,114,114,118,117,49
"4287",86,"[34]EelKsHnKqGocIHcJCotaFpKiGthDxfEapq",234,0.995745,34,235,1,234,1,1,0,1,1,112,112,123,122,49
"4288",87,"[34]EelKsHnKqGocIHcJCotaFpKiGthDxfEapq",236,0.995781,34,237,1,236,1,1,0,1,1,111,111,126,125,49
"4289",88,"[34]EelKsHnKqGocIHcJCotaFpKiGthDxfEapq",221,0.995495,34,222,1,221,1,1,0,1,1,123,123,99,98,49
"4290",89,"[34]EelKsHnKqGocIHcJCotaFpKiGthDxfEapq",229,0.995652,34,230,1,229,1,1,0,1,1,115,115,115,114,49
"4291",90,"[34]EelKsHnKqGocIHcJCotaFpKiGthDxfEapq",241,0.995868,34,242,1,241,1,1,0,1,1,107,107,135,134,49
"4292",91,"[34]EelKsHnKqGocIHcJCotaFpKiGthDxfEapq",230,0.995671,34,231,1,230,1,1,0,1,1,115,115,116,115,49
"4293",92,"[34]EelKsHnKqGocIHcJCotaFpKiGthDxfEapq",232,0.995708,34,233,1,232,1,1,0,1,1,114,114,119,118,49
"4294",93,"[34]EelKsHnKqGocIHcJCotaFpKiGthDxfEapq",225,0.995575,34,226,1,225,1,1,0,1,1,119,119,107,106,49
"4295",94,"[34]EelKsHnKqGocIHcJCotaFpKiGthDxfEapq",224,0.995556,34,225,1,224,1,1,0,1,1,120,120,105,104,49
"4296",95,"[34]EelKsHnKqGocIHcJCotaFpKiGthDxfEapq",224,0.995556,34,225,1,224,1,1,0,1,1,119,119,106,105,49
"4297",96,"[34]EelKsHnKqGocIHcJCotaFpKiGthDxfEapq",226,0.995595,34,227,1,226,1,1,0,1,1,118,118,109,108,49
"4298",97,"[34]EelKsHnKqGocIHcJCotaFpKiGthDxfEapq",234,0.995745,34,235,1,234,1,1,0,1,1,113,113,122,121,49
"4299",98,"[34]EelKsHnKqGocIHcJCotaFpKiGthDxfEapq",230,0.995671,34,231,1,230,1,1,0,1,1,116,116,115,114,49
"4300",99,"[34]EelKsHnKqGocIHcJCotaFpKiGthDxfEapq",231,0.99569,34,232,1,231,1,1,0,1,1,117,117,115,114,49
"4301",0,"[22]EtGDKwHnKqGocIHcJCtAgg",231,0.99569,22,232,1,231,1,1,0,1,1,115,115,117,116,50
"4302",1,"[22]EtGDKwHnKqGocIHcJCtAgg",239,0.995833,22,240,1,239,1,1,0,1,1,107,107,133,132,50
"4303",2,"[22]EtGDKwHnKqGocIHcJCtAgg",226,0.995595,22,227,1,226,1,1,0,1,1,118,118,109,108,50
"4304",3,"[22]EtGDKwHnKqGocIHcJCtAgg",223,0.995536,22,224,1,223,1,1,0,1,1,119,119,105,104,50
"4305",4,"[22]EtGDKwHnKqGocIHcJCtAgg",225,0.995575,22,226,1,225,1,1,0,1,1,118,118,108,107,50
"4306",5,"[22]EtGDKwHnKqGocIHcJCtAgg",223,0.995536,22,224,1,223,1,1,0,1,1,120,120,104,103,50
"4307",6,"[22]EtGDKwHnKqGocIHcJCtAgg",216,0.995392,22,217,1,216,1,1,0,1,1,125,125,92,91,50
"4308",7,"[22]EtGDKwHnKqGocIHcJCtAgg",228,0.995633,22,229,1,228,1,1,0,1,1,116,116,113,112,50
"4309",8,"[22]EtGDKwHnKqGocIHcJCtAgg",228,0.995633,22,229,1,228,1,1,0,1,1,115,115,114,113,50
"4310",9,"[22]EtGDKwHnKqGocIHcJCtAgg",231,0.99569,22,232,1,231,1,1,0,1,1,114,114,118,117,50
"4311",10,"[22]EtGDKwHnKqGocIHcJCtAgg",221,0.995495,22,222,1,221,1,1,0,1,1,121,121,101,100,50
"4312",11,"[22]EtGDKwHnKqGocIHcJCtAgg",230,0.995671,22,231,1,230,1,1,0,1,1,114,114,117,116,50
"4313",12,"[22]EtGDKwHnKqGocIHcJCtAgg",229,0.995652,22,230,1,229,1,1,0,1,1,117,117,113,112,50
"4314",13,"[22]EtGDKwHnKqGocIHcJCtAgg",223,0.995536,22,224,1,223,1,1,0,1,1,122,122,102,101,50
"4315",14,"[22]EtGDKwHnKqGocIHcJCtAgg",222,0.995516,22,223,1,222,1,1,0,1,1,120,120,103,102,50
"4316",15,"[22]EtGDKwHnKqGocIHcJCtAgg",231,0.99569,22,232,1,231,1,1,0,1,1,114,114,118,117,50
"4317",16,"[22]EtGDKwHnKqGocIHcJCtAgg",232,0.995708,22,233,1,232,1,1,0,1,1,113,113,120,119,50
"4318",17,"[22]EtGDKwHnKqGocIHcJCtAgg",244,0.995918,22,245,1,244,1,1,0,1,1,103,103,142,141,50
"4319",18,"[22]EtGDKwHnKqGocIHcJCtAgg",222,0.995516,22,223,1,222,1,1,0,1,1,122,122,101,100,50
"4320",19,"[22]EtGDKwHnKqGocIHcJCtAgg",231,0.99569,22,232,1,231,1,1,0,1,1,114,114,118,117,50
"4321",20,"[22]EtGDKwHnKqGocIHcJCtAgg",231,0.99569,22,232,1,231,1,1,0,1,1,113,113,119,118,50
"4322",21,"[22]EtGDKwHnKqGocIHcJCtAgg",230,0.995671,22,231,1,230,1,1,0,1,1,114,114,117,116,50
"4323",22,"[22]EtGDKwHnKqGocIHcJCtAgg",227,0.995614,22,228,1,227,1,1,0,1,1,118,118,110,109,50
"4324",23,"[22]EtGDKwHnKqGocIHcJCtAgg",226,0.995595,22,227,1,226,1,1,0,1,1,117,117,110,109,50
"4325",24,"[22]EtGDKwHnKqGocIHcJCtAgg",218,0.995434,22,219,1,218,1,1,0,1,1,123,123,96,95,50
"4326",25,"[22]EtGDKwHnKqGocIHcJCtAgg",228,0.995633,22,229,1,228,1,1,0,1,1,117,117,112,111,50
"4327",26,"[22]EtGDKwHnKqGocIHcJCtAgg",227,0.995614,22,228,1,227,1,1,0,1,1,117,117,111,110,50
"4328",27,"[22]EtGDKwHnKqGocIHcJCtAgg",222,0.995516,22,223,1,222,1,1,0,1,1,121,121,102,101,50
"4329",28,"[22]EtGDKwHnKqGocIHcJCtAgg",228,0.995633,22,229,1,228,1,1,0,1,1,116,116,113,112,50
"4330",29,"[22]EtGDKwHnKqGocIHcJCtAgg",232,0.995708,22,233,1,232,1,1,0,1,1,113,113,120,119,50
"4331",30,"[22]EtGDKwHnKqGocIHcJCtAgg",217,0.995413,22,218,1,217,1,1,0,1,1,125,125,93,92,50
"4332",31,"[22]EtGDKwHnKqGocIHcJCtAgg",220,0.995475,22,221,1,220,1,1,0,1,1,122,122,99,98,50
"4333",32,"[22]EtGDKwHnKqGocIHcJCtAgg",230,0.995671,22,231,1,230,1,1,0,1,1,115,115,116,115,50
"4334",33,"[22]EtGDKwHnKqGocIHcJCtAgg",232,0.995708,22,233,1,232,1,1,0,1,1,113,113,120,119,50
"4335",34,"[22]EtGDKwHnKqGocIHcJCtAgg",235,0.995763,22,236,1,235,1,1,0,1,1,111,111,125,124,50
"4336",35,"[22]EtGDKwHnKqGocIHcJCtAgg",231,0.99569,22,232,1,231,1,1,0,1,1,114,114,118,117,50
"4337",36,"[22]EtGDKwHnKqGocIHcJCtAgg",232,0.995708,22,233,1,232,1,1,0,1,1,112,112,121,120,50
"4338",37,"[22]EtGDKwHnKqGocIHcJCtAgg",225,0.995575,22,226,1,225,1,1,0,1,1,118,118,108,107,50
"4339",38,"[22]EtGDKwHnKqGocIHcJCtAgg",230,0.995671,22,231,1,230,1,1,0,1,1,115,115,116,115,50
"4340",39,"[22]EtGDKwHnKqGocIHcJCtAgg",225,0.995575,22,226,1,225,1,1,0,1,1,120,120,106,105,50
"4341",40,"[22]EtGDKwHnKqGocIHcJCtAgg",236,0.995781,22,237,1,236,1,1,0,1,1,110,110,127,126,50
"4342",41,"[22]EtGDKwHnKqGocIHcJCtAgg",231,0.99569,22,232,1,231,1,1,0,1,1,113,113,119,118,50
"4343",42,"[22]EtGDKwHnKqGocIHcJCtAgg",225,0.995575,22,226,1,225,1,1,0,1,1,119,119,107,106,50
"4344",43,"[22]EtGDKwHnKqGocIHcJCtAgg",240,0.995851,22,241,1,240,1,1,0,1,1,107,107,134,133,50
"4345",44,"[22]EtGDKwHnKqGocIHcJCtAgg",236,0.995781,22,237,1,236,1,1,0,1,1,109,109,128,127,50
"4346",45,"[22]EtGDKwHnKqGocIHcJCtAgg",228,0.995633,22,229,1,228,1,1,0,1,1,116,116,113,112,50
"4347",46,"[22]EtGDKwHnKqGocIHcJCtAgg",230,0.995671,22,231,1,230,1,1,0,1,1,115,115,116,115,50
"4348",47,"[22]EtGDKwHnKqGocIHcJCtAgg",222,0.995516,22,223,1,222,1,1,0,1,1,120,120,103,102,50
"4349",48,"[22]EtGDKwHnKqGocIHcJCtAgg",223,0.995536,22,224,1,223,1,1,0,1,1,122,122,102,101,50
"4350",49,"[22]EtGDKwHnKqGocIHcJCtAgg",232,0.995708,22,233,1,232,1,1,0,1,1,113,113,120,119,50
"4351",50,"[22]EtGDKwHnKqGocIHcJCtAgg",221,0.995495,22,222,1,221,1,1,0,1,1,121,121,101,100,50
"4352",51,"[22]EtGDKwHnKqGocIHcJCtAgg",222,0.995516,22,223,1,222,1,1,0,1,1,122,122,101,100,50
"4353",52,"[22]EtGDKwHnKqGocIHcJCtAgg",230,0.995671,22,231,1,230,1,1,0,1,1,114,114,117,116,50
"4354",53,"[22]EtGDKwHnKqGocIHcJCtAgg",238,0.995816,22,239,1,238,1,1,0,1,1,107,107,132,131,50
"4355",54,"[22]EtGDKwHnKqGocIHcJCtAgg",231,0.99569,22,232,1,231,1,1,0,1,1,116,116,116,115,50
"4356",55,"[22]EtGDKwHnKqGocIHcJCtAgg",233,0.995726,22,234,1,233,1,1,0,1,1,114,114,120,119,50
"4357",56,"[22]EtGDKwHnKqGocIHcJCtAgg",228,0.995633,22,229,1,228,1,1,0,1,1,116,116,113,112,50
"4358",57,"[22]EtGDKwHnKqGocIHcJCtAgg",222,0.995516,22,223,1,222,1,1,0,1,1,120,120,103,102,50
"4359",58,"[22]EtGDKwHnKqGocIHcJCtAgg",235,0.995763,22,236,1,235,1,1,0,1,1,111,111,125,124,50
"4360",59,"[22]EtGDKwHnKqGocIHcJCtAgg",236,0.995781,22,237,1,236,1,1,0,1,1,111,111,126,125,50
"4361",60,"[22]EtGDKwHnKqGocIHcJCtAgg",223,0.995536,22,224,1,223,1,1,0,1,1,120,120,104,103,50
"4362",61,"[22]EtGDKwHnKqGocIHcJCtAgg",222,0.995516,22,223,1,222,1,1,0,1,1,120,120,103,102,50
"4363",62,"[22]EtGDKwHnKqGocIHcJCtAgg",236,0.995781,22,237,1,236,1,1,0,1,1,109,109,128,127,50
"4364",63,"[22]EtGDKwHnKqGocIHcJCtAgg",230,0.995671,22,231,1,230,1,1,0,1,1,114,114,117,116,50
"4365",64,"[22]EtGDKwHnKqGocIHcJCtAgg",227,0.995614,22,228,1,227,1,1,0,1,1,117,117,111,110,50
"4366",65,"[22]EtGDKwHnKqGocIHcJCtAgg",226,0.995595,22,227,1,226,1,1,0,1,1,118,118,109,108,50
"4367",66,"[22]EtGDKwHnKqGocIHcJCtAgg",230,0.995671,22,231,1,230,1,1,0,1,1,115,115,116,115,50
"4368",67,"[22]EtGDKwHnKqGocIHcJCtAgg",226,0.995595,22,227,1,226,1,1,0,1,1,117,117,110,109,50
"4369",68,"[22]EtGDKwHnKqGocIHcJCtAgg",238,0.995816,22,239,1,238,1,1,0,1,1,108,108,131,130,50
"4370",69,"[22]EtGDKwHnKqGocIHcJCtAgg",227,0.995614,22,228,1,227,1,1,0,1,1,116,116,112,111,50
"4371",70,"[22]EtGDKwHnKqGocIHcJCtAgg",228,0.995633,22,229,1,228,1,1,0,1,1,117,117,112,111,50
"4372",71,"[22]EtGDKwHnKqGocIHcJCtAgg",238,0.995816,22,239,1,238,1,1,0,1,1,108,108,131,130,50
"4373",72,"[22]EtGDKwHnKqGocIHcJCtAgg",232,0.995708,22,233,1,232,1,1,0,1,1,113,113,120,119,50
"4374",73,"[22]EtGDKwHnKqGocIHcJCtAgg",217,0.995413,22,218,1,217,1,1,0,1,1,124,124,94,93,50
"4375",74,"[22]EtGDKwHnKqGocIHcJCtAgg",235,0.995763,22,236,1,235,1,1,0,1,1,110,110,126,125,50
"4376",75,"[22]EtGDKwHnKqGocIHcJCtAgg",220,0.995475,22,221,1,220,1,1,0,1,1,122,122,99,98,50
"4377",76,"[22]EtGDKwHnKqGocIHcJCtAgg",231,0.99569,22,232,1,231,1,1,0,1,1,115,115,117,116,50
"4378",77,"[22]EtGDKwHnKqGocIHcJCtAgg",234,0.995745,22,235,1,234,1,1,0,1,1,113,113,122,121,50
"4379",78,"[22]EtGDKwHnKqGocIHcJCtAgg",228,0.995633,22,229,1,228,1,1,0,1,1,116,116,113,112,50
"4380",79,"[22]EtGDKwHnKqGocIHcJCtAgg",234,0.995745,22,235,1,234,1,1,0,1,1,113,113,122,121,50
"4381",80,"[22]EtGDKwHnKqGocIHcJCtAgg",227,0.995614,22,228,1,227,1,1,0,1,1,116,116,112,111,50
"4382",81,"[22]EtGDKwHnKqGocIHcJCtAgg",237,0.995798,22,238,1,237,1,1,0,1,1,110,110,128,127,50
"4383",82,"[22]EtGDKwHnKqGocIHcJCtAgg",236,0.995781,22,237,1,236,1,1,0,1,1,109,109,128,127,50
"4384",83,"[22]EtGDKwHnKqGocIHcJCtAgg",230,0.995671,22,231,1,230,1,1,0,1,1,118,118,113,112,50
"4385",84,"[22]EtGDKwHnKqGocIHcJCtAgg",222,0.995516,22,223,1,222,1,1,0,1,1,121,121,102,101,50
"4386",85,"[22]EtGDKwHnKqGocIHcJCtAgg",228,0.995633,22,229,1,228,1,1,0,1,1,116,116,113,112,50
"4387",86,"[22]EtGDKwHnKqGocIHcJCtAgg",237,0.995798,22,238,1,237,1,1,0,1,1,110,110,128,127,50
"4388",87,"[22]EtGDKwHnKqGocIHcJCtAgg",223,0.995536,22,224,1,223,1,1,0,1,1,119,119,105,104,50
"4389",88,"[22]EtGDKwHnKqGocIHcJCtAgg",228,0.995633,22,229,1,228,1,1,0,1,1,116,116,113,112,50
"4390",89,"[22]EtGDKwHnKqGocIHcJCtAgg",219,0.995455,22,220,1,219,1,1,0,1,1,126,126,94,93,50
"4391",90,"[22]EtGDKwHnKqGocIHcJCtAgg",226,0.995595,22,227,1,226,1,1,0,1,1,118,118,109,108,50
"4392",91,"[22]EtGDKwHnKqGocIHcJCtAgg",234,0.995745,22,235,1,234,1,1,0,1,1,111,111,124,123,50
"4393",92,"[22]EtGDKwHnKqGocIHcJCtAgg",236,0.995781,22,237,1,236,1,1,0,1,1,113,113,124,123,50
"4394",93,"[22]EtGDKwHnKqGocIHcJCtAgg",231,0.99569,22,232,1,231,1,1,0,1,1,115,115,117,116,50
"4395",94,"[22]EtGDKwHnKqGocIHcJCtAgg",232,0.995708,22,233,1,232,1,1,0,1,1,113,113,120,119,50
"4396",95,"[22]EtGDKwHnKqGocIHcJCtAgg",227,0.995614,22,228,1,227,1,1,0,1,1,118,118,110,109,50
"4397",96,"[22]EtGDKwHnKqGocIHcJCtAgg",233,0.995726,22,234,1,233,1,1,0,1,1,111,111,123,122,50
"4398",97,"[22]EtGDKwHnKqGocIHcJCtAgg",227,0.995614,22,228,1,227,1,1,0,1,1,119,119,109,108,50
"4399",98,"[22]EtGDKwHnKqGocIHcJCtAgg",230,0.995671,22,231,1,230,1,1,0,1,1,114,114,117,116,50
"4400",99,"[22]EtGDKwHnKqGocIHcJCtAgg",223,0.995536,22,224,1,223,1,1,0,1,1,120,120,104,103,50
"4401",0,"[28]EbtnxxHnKqGocIHcJCkvyjDkewxm",238,0.995816,28,239,1,238,1,1,0,1,1,107,107,132,131,51
"4402",1,"[28]EbtnxxHnKqGocIHcJCkvyjDkewxm",226,0.995595,28,227,1,226,1,1,0,1,1,117,117,110,109,51
"4403",2,"[28]EbtnxxHnKqGocIHcJCkvyjDkewxm",224,0.995556,28,225,1,224,1,1,0,1,1,119,119,106,105,51
"4404",3,"[28]EbtnxxHnKqGocIHcJCkvyjDkewxm",229,0.995652,28,230,1,229,1,1,0,1,1,115,115,115,114,51
"4405",4,"[28]EbtnxxHnKqGocIHcJCkvyjDkewxm",224,0.995556,28,225,1,224,1,1,0,1,1,119,119,106,105,51
"4406",5,"[28]EbtnxxHnKqGocIHcJCkvyjDkewxm",225,0.995575,28,226,1,225,1,1,0,1,1,119,119,107,106,51
"4407",6,"[28]EbtnxxHnKqGocIHcJCkvyjDkewxm",234,0.995745,28,235,1,234,1,1,0,1,1,111,111,124,123,51
"4408",7,"[28]EbtnxxHnKqGocIHcJCkvyjDkewxm",231,0.99569,28,232,1,231,1,1,0,1,1,113,113,119,118,51
"4409",8,"[28]EbtnxxHnKqGocIHcJCkvyjDkewxm",232,0.995708,28,233,1,232,1,1,0,1,1,116,116,117,116,51
"4410",9,"[28]EbtnxxHnKqGocIHcJCkvyjDkewxm",231,0.99569,28,232,1,231,1,1,0,1,1,113,113,119,118,51
"4411",10,"[28]EbtnxxHnKqGocIHcJCkvyjDkewxm",227,0.995614,28,228,1,227,1,1,0,1,1,116,116,112,111,51
"4412",11,"[28]EbtnxxHnKqGocIHcJCkvyjDkewxm",231,0.99569,28,232,1,231,1,1,0,1,1,114,114,118,117,51
"4413",12,"[28]EbtnxxHnKqGocIHcJCkvyjDkewxm",237,0.995798,28,238,1,237,1,1,0,1,1,112,112,126,125,51
"4414",13,"[28]EbtnxxHnKqGocIHcJCkvyjDkewxm",219,0.995455,28,220,1,219,1,1,0,1,1,123,123,97,96,51
"4415",14,"[28]EbtnxxHnKqGocIHcJCkvyjDkewxm",238,0.995816,28,239,1,238,1,1,0,1,1,109,109,130,129,51
"4416",15,"[28]EbtnxxHnKqGocIHcJCkvyjDkewxm",238,0.995816,28,239,1,238,1,1,0,1,1,111,111,128,127,51
"4417",16,"[28]EbtnxxHnKqGocIHcJCkvyjDkewxm",232,0.995708,28,233,1,232,1,1,0,1,1,112,112,121,120,51
"4418",17,"[28]EbtnxxHnKqGocIHcJCkvyjDkewxm",245,0.995935,28,246,1,245,1,1,0,1,1,103,103,143,142,51
"4419",18,"[28]EbtnxxHnKqGocIHcJCkvyjDkewxm",221,0.995495,28,222,1,221,1,1,0,1,1,122,122,100,99,51
"4420",19,"[28]EbtnxxHnKqGocIHcJCkvyjDkewxm",221,0.995495,28,222,1,221,1,1,0,1,1,121,121,101,100,51
"4421",20,"[28]EbtnxxHnKqGocIHcJCkvyjDkewxm",234,0.995745,28,235,1,234,1,1,0,1,1,113,113,122,121,51
"4422",21,"[28]EbtnxxHnKqGocIHcJCkvyjDkewxm",229,0.995652,28,230,1,229,1,1,0,1,1,115,115,115,114,51
"4423",22,"[28]EbtnxxHnKqGocIHcJCkvyjDkewxm",234,0.995745,28,235,1,234,1,1,0,1,1,111,111,124,123,51
"4424",23,"[28]EbtnxxHnKqGocIHcJCkvyjDkewxm",238,0.995816,28,239,1,238,1,1,0,1,1,107,107,132,131,51
"4425",24,"[28]EbtnxxHnKqGocIHcJCkvyjDkewxm",236,0.995781,28,237,1,236,1,1,0,1,1,113,113,124,123,51
"4426",25,"[28]EbtnxxHnKqGocIHcJCkvyjDkewxm",232,0.995708,28,233,1,232,1,1,0,1,1,112,112,121,120,51
"4427",26,"[28]EbtnxxHnKqGocIHcJCkvyjDkewxm",239,0.995833,28,240,1,239,1,1,0,1,1,108,108,132,131,51
"4428",27,"[28]EbtnxxHnKqGocIHcJCkvyjDkewxm",229,0.995652,28,230,1,229,1,1,0,1,1,116,116,114,113,51
"4429",28,"[28]EbtnxxHnKqGocIHcJCkvyjDkewxm",230,0.995671,28,231,1,230,1,1,0,1,1,114,114,117,116,51
"4430",29,"[28]EbtnxxHnKqGocIHcJCkvyjDkewxm",230,0.995671,28,231,1,230,1,1,0,1,1,118,118,113,112,51
"4431",30,"[28]EbtnxxHnKqGocIHcJCkvyjDkewxm",214,0.995349,28,215,1,214,1,1,0,1,1,127,127,88,87,51
"4432",31,"[28]EbtnxxHnKqGocIHcJCkvyjDkewxm",235,0.995763,28,236,1,235,1,1,0,1,1,111,111,125,124,51
"4433",32,"[28]EbtnxxHnKqGocIHcJCkvyjDkewxm",224,0.995556,28,225,1,224,1,1,0,1,1,118,118,107,106,51
"4434",33,"[28]EbtnxxHnKqGocIHcJCkvyjDkewxm",233,0.995726,28,234,1,233,1,1,0,1,1,112,112,122,121,51
"4435",34,"[28]EbtnxxHnKqGocIHcJCkvyjDkewxm",234,0.995745,28,235,1,234,1,1,0,1,1,112,112,123,122,51
"4436",35,"[28]EbtnxxHnKqGocIHcJCkvyjDkewxm",233,0.995726,28,234,1,233,1,1,0,1,1,111,111,123,122,51
"4437",36,"[28]EbtnxxHnKqGocIHcJCkvyjDkewxm",236,0.995781,28,237,1,236,1,1,0,1,1,112,112,125,124,51
"4438",37,"[28]EbtnxxHnKqGocIHcJCkvyjDkewxm",224,0.995556,28,225,1,224,1,1,0,1,1,119,119,106,105,51
"4439",38,"[28]EbtnxxHnKqGocIHcJCkvyjDkewxm",234,0.995745,28,235,1,234,1,1,0,1,1,111,111,124,123,51
"4440",39,"[28]EbtnxxHnKqGocIHcJCkvyjDkewxm",223,0.995536,28,224,1,223,1,1,0,1,1,120,120,104,103,51
"4441",40,"[28]EbtnxxHnKqGocIHcJCkvyjDkewxm",236,0.995781,28,237,1,236,1,1,0,1,1,109,109,128,127,51
"4442",41,"[28]EbtnxxHnKqGocIHcJCkvyjDkewxm",239,0.995833,28,240,1,239,1,1,0,1,1,110,110,130,129,51
"4443",42,"[28]EbtnxxHnKqGocIHcJCkvyjDkewxm",232,0.995708,28,233,1,232,1,1,0,1,1,112,112,121,120,51
"4444",43,"[28]EbtnxxHnKqGocIHcJCkvyjDkewxm",232,0.995708,28,233,1,232,1,1,0,1,1,115,115,118,117,51
"4445",44,"[28]EbtnxxHnKqGocIHcJCkvyjDkewxm",236,0.995781,28,237,1,236,1,1,0,1,1,110,110,127,126,51
"4446",45,"[28]EbtnxxHnKqGocIHcJCkvyjDkewxm",228,0.995633,28,229,1,228,1,1,0,1,1,115,115,114,113,51
"4447",46,"[28]EbtnxxHnKqGocIHcJCkvyjDkewxm",223,0.995536,28,224,1,223,1,1,0,1,1,120,120,104,103,51
"4448",47,"[28]EbtnxxHnKqGocIHcJCkvyjDkewxm",232,0.995708,28,233,1,232,1,1,0,1,1,113,113,120,119,51
"4449",48,"[28]EbtnxxHnKqGocIHcJCkvyjDkewxm",237,0.995798,28,238,1,237,1,1,0,1,1,108,108,130,129,51
"4450",49,"[28]EbtnxxHnKqGocIHcJCkvyjDkewxm",226,0.995595,28,227,1,226,1,1,0,1,1,118,118,109,108,51
"4451",50,"[28]EbtnxxHnKqGocIHcJCkvyjDkewxm",228,0.995633,28,229,1,228,1,1,0,1,1,115,115,114,113,51
"4452",51,"[28]EbtnxxHnKqGocIHcJCkvyjDkewxm",234,0.995745,28,235,1,234,1,1,0,1,1,111,111,124,123,51
"4453",52,"[28]EbtnxxHnKqGocIHcJCkvyjDkewxm",229,0.995652,28,230,1,229,1,1,0,1,1,115,115,115,114,51
"4454",53,"[28]EbtnxxHnKqGocIHcJCkvyjDkewxm",231,0.99569,28,232,1,231,1,1,0,1,1,114,114,118,117,51
"4455",54,"[28]EbtnxxHnKqGocIHcJCkvyjDkewxm",235,0.995763,28,236,1,235,1,1,0,1,1,110,110,126,125,51
"4456",55,"[28]EbtnxxHnKqGocIHcJCkvyjDkewxm",228,0.995633,28,229,1,228,1,1,0,1,1,115,115,114,113,51
"4457",56,"[28]EbtnxxHnKqGocIHcJCkvyjDkewxm",233,0.995726,28,234,1,233,1,1,0,1,1,111,111,123,122,51
"4458",57,"[28]EbtnxxHnKqGocIHcJCkvyjDkewxm",235,0.995763,28,236,1,235,1,1,0,1,1,111,111,125,124,51
"4459",58,"[28]EbtnxxHnKqGocIHcJCkvyjDkewxm",228,0.995633,28,229,1,228,1,1,0,1,1,118,118,111,110,51
"4460",59,"[28]EbtnxxHnKqGocIHcJCkvyjDkewxm",228,0.995633,28,229,1,228,1,1,0,1,1,118,118,111,110,51
"4461",60,"[28]EbtnxxHnKqGocIHcJCkvyjDkewxm",224,0.995556,28,225,1,224,1,1,0,1,1,118,118,107,106,51
"4462",61,"[28]EbtnxxHnKqGocIHcJCkvyjDkewxm",228,0.995633,28,229,1,228,1,1,0,1,1,117,117,112,111,51
"4463",62,"[28]EbtnxxHnKqGocIHcJCkvyjDkewxm",234,0.995745,28,235,1,234,1,1,0,1,1,111,111,124,123,51
"4464",63,"[28]EbtnxxHnKqGocIHcJCkvyjDkewxm",223,0.995536,28,224,1,223,1,1,0,1,1,120,120,104,103,51
"4465",64,"[28]EbtnxxHnKqGocIHcJCkvyjDkewxm",227,0.995614,28,228,1,227,1,1,0,1,1,117,117,111,110,51
"4466",65,"[28]EbtnxxHnKqGocIHcJCkvyjDkewxm",213,0.995327,28,214,1,213,1,1,0,1,1,128,128,86,85,51
"4467",66,"[28]EbtnxxHnKqGocIHcJCkvyjDkewxm",230,0.995671,28,231,1,230,1,1,0,1,1,114,114,117,116,51
"4468",67,"[28]EbtnxxHnKqGocIHcJCkvyjDkewxm",231,0.99569,28,232,1,231,1,1,0,1,1,114,114,118,117,51
"4469",68,"[28]EbtnxxHnKqGocIHcJCkvyjDkewxm",230,0.995671,28,231,1,230,1,1,0,1,1,115,115,116,115,51
"4470",69,"[28]EbtnxxHnKqGocIHcJCkvyjDkewxm",225,0.995575,28,226,1,225,1,1,0,1,1,118,118,108,107,51
"4471",70,"[28]EbtnxxHnKqGocIHcJCkvyjDkewxm",237,0.995798,28,238,1,237,1,1,0,1,1,108,108,130,129,51
"4472",71,"[28]EbtnxxHnKqGocIHcJCkvyjDkewxm",234,0.995745,28,235,1,234,1,1,0,1,1,112,112,123,122,51
"4473",72,"[28]EbtnxxHnKqGocIHcJCkvyjDkewxm",225,0.995575,28,226,1,225,1,1,0,1,1,118,118,108,107,51
"4474",73,"[28]EbtnxxHnKqGocIHcJCkvyjDkewxm",235,0.995763,28,236,1,235,1,1,0,1,1,111,111,125,124,51
"4475",74,"[28]EbtnxxHnKqGocIHcJCkvyjDkewxm",227,0.995614,28,228,1,227,1,1,0,1,1,121,121,107,106,51
"4476",75,"[28]EbtnxxHnKqGocIHcJCkvyjDkewxm",229,0.995652,28,230,1,229,1,1,0,1,1,114,114,116,115,51
"4477",76,"[28]EbtnxxHnKqGocIHcJCkvyjDkewxm",229,0.995652,28,230,1,229,1,1,0,1,1,116,116,114,113,51
"4478",77,"[28]EbtnxxHnKqGocIHcJCkvyjDkewxm",229,0.995652,28,230,1,229,1,1,0,1,1,115,115,115,114,51
"4479",78,"[28]EbtnxxHnKqGocIHcJCkvyjDkewxm",236,0.995781,28,237,1,236,1,1,0,1,1,109,109,128,127,51
"4480",79,"[28]EbtnxxHnKqGocIHcJCkvyjDkewxm",220,0.995475,28,221,1,220,1,1,0,1,1,122,122,99,98,51
"4481",80,"[28]EbtnxxHnKqGocIHcJCkvyjDkewxm",239,0.995833,28,240,1,239,1,1,0,1,1,113,113,127,126,51
"4482",81,"[28]EbtnxxHnKqGocIHcJCkvyjDkewxm",224,0.995556,28,225,1,224,1,1,0,1,1,119,119,106,105,51
"4483",82,"[28]EbtnxxHnKqGocIHcJCkvyjDkewxm",239,0.995833,28,240,1,239,1,1,0,1,1,106,106,134,133,51
"4484",83,"[28]EbtnxxHnKqGocIHcJCkvyjDkewxm",237,0.995798,28,238,1,237,1,1,0,1,1,112,112,126,125,51
"4485",84,"[28]EbtnxxHnKqGocIHcJCkvyjDkewxm",239,0.995833,28,240,1,239,1,1,0,1,1,106,106,134,133,51
"4486",85,"[28]EbtnxxHnKqGocIHcJCkvyjDkewxm",232,0.995708,28,233,1,232,1,1,0,1,1,113,113,120,119,51
"4487",86,"[28]EbtnxxHnKqGocIHcJCkvyjDkewxm",230,0.995671,28,231,1,230,1,1,0,1,1,116,116,115,114,51
"4488",87,"[28]EbtnxxHnKqGocIHcJCkvyjDkewxm",234,0.995745,28,235,1,234,1,1,0,1,1,112,112,123,122,51
"4489",88,"[28]EbtnxxHnKqGocIHcJCkvyjDkewxm",221,0.995495,28,222,1,221,1,1,0,1,1,122,122,100,99,51
"4490",89,"[28]EbtnxxHnKqGocIHcJCkvyjDkewxm",227,0.995614,28,228,1,227,1,1,0,1,1,117,117,111,110,51
"4491",90,"[28]EbtnxxHnKqGocIHcJCkvyjDkewxm",229,0.995652,28,230,1,229,1,1,0,1,1,114,114,116,115,51
"4492",91,"[28]EbtnxxHnKqGocIHcJCkvyjDkewxm",238,0.995816,28,239,1,238,1,1,0,1,1,108,108,131,130,51
"4493",92,"[28]EbtnxxHnKqGocIHcJCkvyjDkewxm",223,0.995536,28,224,1,223,1,1,0,1,1,119,119,105,104,51
"4494",93,"[28]EbtnxxHnKqGocIHcJCkvyjDkewxm",244,0.995918,28,245,1,244,1,1,0,1,1,103,103,142,141,51
"4495",94,"[28]EbtnxxHnKqGocIHcJCkvyjDkewxm",231,0.99569,28,232,1,231,1,1,0,1,1,115,115,117,116,51
"4496",95,"[28]EbtnxxHnKqGocIHcJCkvyjDkewxm",229,0.995652,28,230,1,229,1,1,0,1,1,115,115,115,114,51
"4497",96,"[28]EbtnxxHnKqGocIHcJCkvyjDkewxm",224,0.995556,28,225,1,224,1,1,0,1,1,118,118,107,106,51
"4498",97,"[28]EbtnxxHnKqGocIHcJCkvyjDkewxm",223,0.995536,28,224,1,223,1,1,0,1,1,121,121,103,102,51
"4499",98,"[28]EbtnxxHnKqGocIHcJCkvyjDkewxm",229,0.995652,28,230,1,229,1,1,0,1,1,115,115,115,114,51
"4500",99,"[28]EbtnxxHnKqGocIHcJCkvyjDkewxm",222,0.995516,28,223,1,222,1,1,0,1,1,123,123,100,99,51
"4501",0,"[26]ExlFsHnKqGocIHcJChbyhxyBik",222,0.995516,26,223,1,222,1,1,0,1,1,121,121,102,101,52
"4502",1,"[26]ExlFsHnKqGocIHcJChbyhxyBik",237,0.995798,26,238,1,237,1,1,0,1,1,109,109,129,128,52
"4503",2,"[26]ExlFsHnKqGocIHcJChbyhxyBik",231,0.99569,26,232,1,231,1,1,0,1,1,114,114,118,117,52
"4504",3,"[26]ExlFsHnKqGocIHcJChbyhxyBik",231,0.99569,26,232,1,231,1,1,0,1,1,117,117,115,114,52
"4505",4,"[26]ExlFsHnKqGocIHcJChbyhxyBik",232,0.995708,26,233,1,232,1,1,0,1,1,113,113,120,119,52
"4506",5,"[26]ExlFsHnKqGocIHcJChbyhxyBik",228,0.995633,26,229,1,228,1,1,0,1,1,116,116,113,112,52
"4507",6,"[26]ExlFsHnKqGocIHcJChbyhxyBik",232,0.995708,26,233,1,232,1,1,0,1,1,112,112,121,120,52
"4508",7,"[26]ExlFsHnKqGocIHcJChbyhxyBik",228,0.995633,26,229,1,228,1,1,0,1,1,118,118,111,110,52
"4509",8,"[26]ExlFsHnKqGocIHcJChbyhxyBik",228,0.995633,26,229,1,228,1,1,0,1,1,117,117,112,111,52
"4510",9,"[26]ExlFsHnKqGocIHcJChbyhxyBik",215,0.99537,26,216,1,215,1,1,0,1,1,128,128,88,87,52
"4511",10,"[26]ExlFsHnKqGocIHcJChbyhxyBik",215,0.99537,26,216,1,215,1,1,0,1,1,126,126,90,89,52
"4512",11,"[26]ExlFsHnKqGocIHcJChbyhxyBik",227,0.995614,26,228,1,227,1,1,0,1,1,117,117,111,110,52
"4513",12,"[26]ExlFsHnKqGocIHcJChbyhxyBik",236,0.995781,26,237,1,236,1,1,0,1,1,110,110,127,126,52
"4514",13,"[26]ExlFsHnKqGocIHcJChbyhxyBik",235,0.995763,26,236,1,235,1,1,0,1,1,110,110,126,125,52
"4515",14,"[26]ExlFsHnKqGocIHcJChbyhxyBik",226,0.995595,26,227,1,226,1,1,0,1,1,119,119,108,107,52
"4516",15,"[26]ExlFsHnKqGocIHcJChbyhxyBik",226,0.995595,26,227,1,226,1,1,0,1,1,117,117,110,109,52
"4517",16,"[26]ExlFsHnKqGocIHcJChbyhxyBik",221,0.995495,26,222,1,221,1,1,0,1,1,122,122,100,99,52
"4518",17,"[26]ExlFsHnKqGocIHcJChbyhxyBik",230,0.995671,26,231,1,230,1,1,0,1,1,114,114,117,116,52
"4519",18,"[26]ExlFsHnKqGocIHcJChbyhxyBik",228,0.995633,26,229,1,228,1,1,0,1,1,116,116,113,112,52
"4520",19,"[26]ExlFsHnKqGocIHcJChbyhxyBik",228,0.995633,26,229,1,228,1,1,0,1,1,115,115,114,113,52
"4521",20,"[26]ExlFsHnKqGocIHcJChbyhxyBik",225,0.995575,26,226,1,225,1,1,0,1,1,119,119,107,106,52
"4522",21,"[26]ExlFsHnKqGocIHcJChbyhxyBik",233,0.995726,26,234,1,233,1,1,0,1,1,112,112,122,121,52
"4523",22,"[26]ExlFsHnKqGocIHcJChbyhxyBik",232,0.995708,26,233,1,232,1,1,0,1,1,112,112,121,120,52
"4524",23,"[26]ExlFsHnKqGocIHcJChbyhxyBik",227,0.995614,26,228,1,227,1,1,0,1,1,116,116,112,111,52
"4525",24,"[26]ExlFsHnKqGocIHcJChbyhxyBik",234,0.995745,26,235,1,234,1,1,0,1,1,113,113,122,121,52
"4526",25,"[26]ExlFsHnKqGocIHcJChbyhxyBik",229,0.995652,26,230,1,229,1,1,0,1,1,116,116,114,113,52
"4527",26,"[26]ExlFsHnKqGocIHcJChbyhxyBik",241,0.995868,26,242,1,241,1,1,0,1,1,107,107,135,134,52
"4528",27,"[26]ExlFsHnKqGocIHcJChbyhxyBik",233,0.995726,26,234,1,233,1,1,0,1,1,111,111,123,122,52
"4529",28,"[26]ExlFsHnKqGocIHcJChbyhxyBik",237,0.995798,26,238,1,237,1,1,0,1,1,110,110,128,127,52
"4530",29,"[26]ExlFsHnKqGocIHcJChbyhxyBik",221,0.995495,26,222,1,221,1,1,0,1,1,122,122,100,99,52
"4531",30,"[26]ExlFsHnKqGocIHcJChbyhxyBik",236,0.995781,26,237,1,236,1,1,0,1,1,111,111,126,125,52
"4532",31,"[26]ExlFsHnKqGocIHcJChbyhxyBik",223,0.995536,26,224,1,223,1,1,0,1,1,119,119,105,104,52
"4533",32,"[26]ExlFsHnKqGocIHcJChbyhxyBik",237,0.995798,26,238,1,237,1,1,0,1,1,109,109,129,128,52
"4534",33,"[26]ExlFsHnKqGocIHcJChbyhxyBik",236,0.995781,26,237,1,236,1,1,0,1,1,110,110,127,126,52
"4535",34,"[26]ExlFsHnKqGocIHcJChbyhxyBik",227,0.995614,26,228,1,227,1,1,0,1,1,118,118,110,109,52
"4536",35,"[26]ExlFsHnKqGocIHcJChbyhxyBik",232,0.995708,26,233,1,232,1,1,0,1,1,112,112,121,120,52
"4537",36,"[26]ExlFsHnKqGocIHcJChbyhxyBik",220,0.995475,26,221,1,220,1,1,0,1,1,123,123,98,97,52
"4538",37,"[26]ExlFsHnKqGocIHcJChbyhxyBik",227,0.995614,26,228,1,227,1,1,0,1,1,117,117,111,110,52
"4539",38,"[26]ExlFsHnKqGocIHcJChbyhxyBik",230,0.995671,26,231,1,230,1,1,0,1,1,115,115,116,115,52
"4540",39,"[26]ExlFsHnKqGocIHcJChbyhxyBik",237,0.995798,26,238,1,237,1,1,0,1,1,112,112,126,125,52
"4541",40,"[26]ExlFsHnKqGocIHcJChbyhxyBik",222,0.995516,26,223,1,222,1,1,0,1,1,120,120,103,102,52
"4542",41,"[26]ExlFsHnKqGocIHcJChbyhxyBik",222,0.995516,26,223,1,222,1,1,0,1,1,120,120,103,102,52
"4543",42,"[26]ExlFsHnKqGocIHcJChbyhxyBik",234,0.995745,26,235,1,234,1,1,0,1,1,111,111,124,123,52
"4544",43,"[26]ExlFsHnKqGocIHcJChbyhxyBik",238,0.995816,26,239,1,238,1,1,0,1,1,108,108,131,130,52
"4545",44,"[26]ExlFsHnKqGocIHcJChbyhxyBik",226,0.995595,26,227,1,226,1,1,0,1,1,118,118,109,108,52
"4546",45,"[26]ExlFsHnKqGocIHcJChbyhxyBik",230,0.995671,26,231,1,230,1,1,0,1,1,114,114,117,116,52
"4547",46,"[26]ExlFsHnKqGocIHcJChbyhxyBik",225,0.995575,26,226,1,225,1,1,0,1,1,119,119,107,106,52
"4548",47,"[26]ExlFsHnKqGocIHcJChbyhxyBik",233,0.995726,26,234,1,233,1,1,0,1,1,114,114,120,119,52
"4549",48,"[26]ExlFsHnKqGocIHcJChbyhxyBik",239,0.995833,26,240,1,239,1,1,0,1,1,109,109,131,130,52
"4550",49,"[26]ExlFsHnKqGocIHcJChbyhxyBik",242,0.995885,26,243,1,242,1,1,0,1,1,107,107,136,135,52
"4551",50,"[26]ExlFsHnKqGocIHcJChbyhxyBik",230,0.995671,26,231,1,230,1,1,0,1,1,114,114,117,116,52
"4552",51,"[26]ExlFsHnKqGocIHcJChbyhxyBik",226,0.995595,26,227,1,226,1,1,0,1,1,117,117,110,109,52
"4553",52,"[26]ExlFsHnKqGocIHcJChbyhxyBik",235,0.995763,26,236,1,235,1,1,0,1,1,111,111,125,124,52
"4554",53,"[26]ExlFsHnKqGocIHcJChbyhxyBik",225,0.995575,26,226,1,225,1,1,0,1,1,118,118,108,107,52
"4555",54,"[26]ExlFsHnKqGocIHcJChbyhxyBik",230,0.995671,26,231,1,230,1,1,0,1,1,118,118,113,112,52
"4556",55,"[26]ExlFsHnKqGocIHcJChbyhxyBik",233,0.995726,26,234,1,233,1,1,0,1,1,114,114,120,119,52
"4557",56,"[26]ExlFsHnKqGocIHcJChbyhxyBik",236,0.995781,26,237,1,236,1,1,0,1,1,110,110,127,126,52
"4558",57,"[26]ExlFsHnKqGocIHcJChbyhxyBik",225,0.995575,26,226,1,225,1,1,0,1,1,118,118,108,107,52
"4559",58,"[26]ExlFsHnKqGocIHcJChbyhxyBik",233,0.995726,26,234,1,233,1,1,0,1,1,111,111,123,122,52
"4560",59,"[26]ExlFsHnKqGocIHcJChbyhxyBik",230,0.995671,26,231,1,230,1,1,0,1,1,115,115,116,115,52
"4561",60,"[26]ExlFsHnKqGocIHcJChbyhxyBik",234,0.995745,26,235,1,234,1,1,0,1,1,111,111,124,123,52
"4562",61,"[26]ExlFsHnKqGocIHcJChbyhxyBik",223,0.995536,26,224,1,223,1,1,0,1,1,119,119,105,104,52
"4563",62,"[26]ExlFsHnKqGocIHcJChbyhxyBik",225,0.995575,26,226,1,225,1,1,0,1,1,119,119,107,106,52
"4564",63,"[26]ExlFsHnKqGocIHcJChbyhxyBik",232,0.995708,26,233,1,232,1,1,0,1,1,112,112,121,120,52
"4565",64,"[26]ExlFsHnKqGocIHcJChbyhxyBik",244,0.995918,26,245,1,244,1,1,0,1,1,103,103,142,141,52
"4566",65,"[26]ExlFsHnKqGocIHcJChbyhxyBik",227,0.995614,26,228,1,227,1,1,0,1,1,117,117,111,110,52
"4567",66,"[26]ExlFsHnKqGocIHcJChbyhxyBik",222,0.995516,26,223,1,222,1,1,0,1,1,120,120,103,102,52
"4568",67,"[26]ExlFsHnKqGocIHcJChbyhxyBik",234,0.995745,26,235,1,234,1,1,0,1,1,112,112,123,122,52
"4569",68,"[26]ExlFsHnKqGocIHcJChbyhxyBik",235,0.995763,26,236,1,235,1,1,0,1,1,113,113,123,122,52
"4570",69,"[26]ExlFsHnKqGocIHcJChbyhxyBik",219,0.995455,26,220,1,219,1,1,0,1,1,124,124,96,95,52
"4571",70,"[26]ExlFsHnKqGocIHcJChbyhxyBik",239,0.995833,26,240,1,239,1,1,0,1,1,108,108,132,131,52
"4572",71,"[26]ExlFsHnKqGocIHcJChbyhxyBik",233,0.995726,26,234,1,233,1,1,0,1,1,111,111,123,122,52
"4573",72,"[26]ExlFsHnKqGocIHcJChbyhxyBik",223,0.995536,26,224,1,223,1,1,0,1,1,119,119,105,104,52
"4574",73,"[26]ExlFsHnKqGocIHcJChbyhxyBik",233,0.995726,26,234,1,233,1,1,0,1,1,113,113,121,120,52
"4575",74,"[26]ExlFsHnKqGocIHcJChbyhxyBik",243,0.995902,26,244,1,243,1,1,0,1,1,106,106,138,137,52
"4576",75,"[26]ExlFsHnKqGocIHcJChbyhxyBik",230,0.995671,26,231,1,230,1,1,0,1,1,116,116,115,114,52
"4577",76,"[26]ExlFsHnKqGocIHcJChbyhxyBik",232,0.995708,26,233,1,232,1,1,0,1,1,113,113,120,119,52
"4578",77,"[26]ExlFsHnKqGocIHcJChbyhxyBik",219,0.995455,26,220,1,219,1,1,0,1,1,125,125,95,94,52
"4579",78,"[26]ExlFsHnKqGocIHcJChbyhxyBik",228,0.995633,26,229,1,228,1,1,0,1,1,118,118,111,110,52
"4580",79,"[26]ExlFsHnKqGocIHcJChbyhxyBik",227,0.995614,26,228,1,227,1,1,0,1,1,117,117,111,110,52
"4581",80,"[26]ExlFsHnKqGocIHcJChbyhxyBik",229,0.995652,26,230,1,229,1,1,0,1,1,116,116,114,113,52
"4582",81,"[26]ExlFsHnKqGocIHcJChbyhxyBik",234,0.995745,26,235,1,234,1,1,0,1,1,113,113,122,121,52
"4583",82,"[26]ExlFsHnKqGocIHcJChbyhxyBik",238,0.995816,26,239,1,238,1,1,0,1,1,107,107,132,131,52
"4584",83,"[26]ExlFsHnKqGocIHcJChbyhxyBik",232,0.995708,26,233,1,232,1,1,0,1,1,114,114,119,118,52
"4585",84,"[26]ExlFsHnKqGocIHcJChbyhxyBik",234,0.995745,26,235,1,234,1,1,0,1,1,111,111,124,123,52
"4586",85,"[26]ExlFsHnKqGocIHcJChbyhxyBik",224,0.995556,26,225,1,224,1,1,0,1,1,120,120,105,104,52
"4587",86,"[26]ExlFsHnKqGocIHcJChbyhxyBik",228,0.995633,26,229,1,228,1,1,0,1,1,116,116,113,112,52
"4588",87,"[26]ExlFsHnKqGocIHcJChbyhxyBik",226,0.995595,26,227,1,226,1,1,0,1,1,121,121,106,105,52
"4589",88,"[26]ExlFsHnKqGocIHcJChbyhxyBik",233,0.995726,26,234,1,233,1,1,0,1,1,111,111,123,122,52
"4590",89,"[26]ExlFsHnKqGocIHcJChbyhxyBik",234,0.995745,26,235,1,234,1,1,0,1,1,111,111,124,123,52
"4591",90,"[26]ExlFsHnKqGocIHcJChbyhxyBik",234,0.995745,26,235,1,234,1,1,0,1,1,111,111,124,123,52
"4592",91,"[26]ExlFsHnKqGocIHcJChbyhxyBik",242,0.995885,26,243,1,242,1,1,0,1,1,105,105,138,137,52
"4593",92,"[26]ExlFsHnKqGocIHcJChbyhxyBik",232,0.995708,26,233,1,232,1,1,0,1,1,113,113,120,119,52
"4594",93,"[26]ExlFsHnKqGocIHcJChbyhxyBik",238,0.995816,26,239,1,238,1,1,0,1,1,108,108,131,130,52
"4595",94,"[26]ExlFsHnKqGocIHcJChbyhxyBik",230,0.995671,26,231,1,230,1,1,0,1,1,115,115,116,115,52
"4596",95,"[26]ExlFsHnKqGocIHcJChbyhxyBik",223,0.995536,26,224,1,223,1,1,0,1,1,119,119,105,104,52
"4597",96,"[26]ExlFsHnKqGocIHcJChbyhxyBik",230,0.995671,26,231,1,230,1,1,0,1,1,115,115,116,115,52
"4598",97,"[26]ExlFsHnKqGocIHcJChbyhxyBik",228,0.995633,26,229,1,228,1,1,0,1,1,119,119,110,109,52
"4599",98,"[26]ExlFsHnKqGocIHcJChbyhxyBik",233,0.995726,26,234,1,233,1,1,0,1,1,112,112,122,121,52
"4600",99,"[26]ExlFsHnKqGocIHcJChbyhxyBik",230,0.995671,26,231,1,230,1,1,0,1,1,114,114,117,116,52
"4601",0,"[32]EFmdGiAisHnKqGocIHcJCHypFCzrAbEg",227,0.995614,32,228,1,227,1,1,0,1,1,118,118,110,109,53
"4602",1,"[32]EFmdGiAisHnKqGocIHcJCHypFCzrAbEg",236,0.995781,32,237,1,236,1,1,0,1,1,110,110,127,126,53
"4603",2,"[32]EFmdGiAisHnKqGocIHcJCHypFCzrAbEg",226,0.995595,32,227,1,226,1,1,0,1,1,116,116,111,110,53
"4604",3,"[32]EFmdGiAisHnKqGocIHcJCHypFCzrAbEg",227,0.995614,32,228,1,227,1,1,0,1,1,117,117,111,110,53
"4605",4,"[32]EFmdGiAisHnKqGocIHcJCHypFCzrAbEg",220,0.995475,32,221,1,220,1,1,0,1,1,121,121,100,99,53
"4606",5,"[32]EFmdGiAisHnKqGocIHcJCHypFCzrAbEg",224,0.995556,32,225,1,224,1,1,0,1,1,119,119,106,105,53
"4607",6,"[32]EFmdGiAisHnKqGocIHcJCHypFCzrAbEg",227,0.995614,32,228,1,227,1,1,0,1,1,115,115,113,112,53
"4608",7,"[32]EFmdGiAisHnKqGocIHcJCHypFCzrAbEg",235,0.995763,32,236,1,235,1,1,0,1,1,111,111,125,124,53
"4609",8,"[32]EFmdGiAisHnKqGocIHcJCHypFCzrAbEg",224,0.995556,32,225,1,224,1,1,0,1,1,120,120,105,104,53
"4610",9,"[32]EFmdGiAisHnKqGocIHcJCHypFCzrAbEg",234,0.995745,32,235,1,234,1,1,0,1,1,115,115,120,119,53
"4611",10,"[32]EFmdGiAisHnKqGocIHcJCHypFCzrAbEg",224,0.995556,32,225,1,224,1,1,0,1,1,119,119,106,105,53
"4612",11,"[32]EFmdGiAisHnKqGocIHcJCHypFCzrAbEg",218,0.995434,32,219,1,218,1,1,0,1,1,123,123,96,95,53
"4613",12,"[32]EFmdGiAisHnKqGocIHcJCHypFCzrAbEg",234,0.995745,32,235,1,234,1,1,0,1,1,110,110,125,124,53
"4614",13,"[32]EFmdGiAisHnKqGocIHcJCHypFCzrAbEg",223,0.995536,32,224,1,223,1,1,0,1,1,121,121,103,102,53
"4615",14,"[32]EFmdGiAisHnKqGocIHcJCHypFCzrAbEg",228,0.995633,32,229,1,228,1,1,0,1,1,115,115,114,113,53
"4616",15,"[32]EFmdGiAisHnKqGocIHcJCHypFCzrAbEg",220,0.995475,32,221,1,220,1,1,0,1,1,122,122,99,98,53
"4617",16,"[32]EFmdGiAisHnKqGocIHcJCHypFCzrAbEg",232,0.995708,32,233,1,232,1,1,0,1,1,112,112,121,120,53
"4618",17,"[32]EFmdGiAisHnKqGocIHcJCHypFCzrAbEg",227,0.995614,32,228,1,227,1,1,0,1,1,117,117,111,110,53
"4619",18,"[32]EFmdGiAisHnKqGocIHcJCHypFCzrAbEg",224,0.995556,32,225,1,224,1,1,0,1,1,121,121,104,103,53
"4620",19,"[32]EFmdGiAisHnKqGocIHcJCHypFCzrAbEg",230,0.995671,32,231,1,230,1,1,0,1,1,115,115,116,115,53
"4621",20,"[32]EFmdGiAisHnKqGocIHcJCHypFCzrAbEg",222,0.995516,32,223,1,222,1,1,0,1,1,119,119,104,103,53
"4622",21,"[32]EFmdGiAisHnKqGocIHcJCHypFCzrAbEg",233,0.995726,32,234,1,233,1,1,0,1,1,111,111,123,122,53
"4623",22,"[32]EFmdGiAisHnKqGocIHcJCHypFCzrAbEg",226,0.995595,32,227,1,226,1,1,0,1,1,117,117,110,109,53
"4624",23,"[32]EFmdGiAisHnKqGocIHcJCHypFCzrAbEg",228,0.995633,32,229,1,228,1,1,0,1,1,115,115,114,113,53
"4625",24,"[32]EFmdGiAisHnKqGocIHcJCHypFCzrAbEg",225,0.995575,32,226,1,225,1,1,0,1,1,117,117,109,108,53
"4626",25,"[32]EFmdGiAisHnKqGocIHcJCHypFCzrAbEg",232,0.995708,32,233,1,232,1,1,0,1,1,112,112,121,120,53
"4627",26,"[32]EFmdGiAisHnKqGocIHcJCHypFCzrAbEg",238,0.995816,32,239,1,238,1,1,0,1,1,110,110,129,128,53
"4628",27,"[32]EFmdGiAisHnKqGocIHcJCHypFCzrAbEg",222,0.995516,32,223,1,222,1,1,0,1,1,121,121,102,101,53
"4629",28,"[32]EFmdGiAisHnKqGocIHcJCHypFCzrAbEg",229,0.995652,32,230,1,229,1,1,0,1,1,114,114,116,115,53
"4630",29,"[32]EFmdGiAisHnKqGocIHcJCHypFCzrAbEg",226,0.995595,32,227,1,226,1,1,0,1,1,117,117,110,109,53
"4631",30,"[32]EFmdGiAisHnKqGocIHcJCHypFCzrAbEg",226,0.995595,32,227,1,226,1,1,0,1,1,116,116,111,110,53
"4632",31,"[32]EFmdGiAisHnKqGocIHcJCHypFCzrAbEg",225,0.995575,32,226,1,225,1,1,0,1,1,118,118,108,107,53
"4633",32,"[32]EFmdGiAisHnKqGocIHcJCHypFCzrAbEg",234,0.995745,32,235,1,234,1,1,0,1,1,111,111,124,123,53
"4634",33,"[32]EFmdGiAisHnKqGocIHcJCHypFCzrAbEg",231,0.99569,32,232,1,231,1,1,0,1,1,114,114,118,117,53
"4635",34,"[32]EFmdGiAisHnKqGocIHcJCHypFCzrAbEg",234,0.995745,32,235,1,234,1,1,0,1,1,111,111,124,123,53
"4636",35,"[32]EFmdGiAisHnKqGocIHcJCHypFCzrAbEg",233,0.995726,32,234,1,233,1,1,0,1,1,112,112,122,121,53
"4637",36,"[32]EFmdGiAisHnKqGocIHcJCHypFCzrAbEg",239,0.995833,32,240,1,239,1,1,0,1,1,107,107,133,132,53
"4638",37,"[32]EFmdGiAisHnKqGocIHcJCHypFCzrAbEg",222,0.995516,32,223,1,222,1,1,0,1,1,122,122,101,100,53
"4639",38,"[32]EFmdGiAisHnKqGocIHcJCHypFCzrAbEg",223,0.995536,32,224,1,223,1,1,0,1,1,119,119,105,104,53
"4640",39,"[32]EFmdGiAisHnKqGocIHcJCHypFCzrAbEg",234,0.995745,32,235,1,234,1,1,0,1,1,111,111,124,123,53
"4641",40,"[32]EFmdGiAisHnKqGocIHcJCHypFCzrAbEg",236,0.995781,32,237,1,236,1,1,0,1,1,112,112,125,124,53
"4642",41,"[32]EFmdGiAisHnKqGocIHcJCHypFCzrAbEg",240,0.995851,32,241,1,240,1,1,0,1,1,106,106,135,134,53
"4643",42,"[32]EFmdGiAisHnKqGocIHcJCHypFCzrAbEg",230,0.995671,32,231,1,230,1,1,0,1,1,113,113,118,117,53
"4644",43,"[32]EFmdGiAisHnKqGocIHcJCHypFCzrAbEg",231,0.99569,32,232,1,231,1,1,0,1,1,112,112,120,119,53
"4645",44,"[32]EFmdGiAisHnKqGocIHcJCHypFCzrAbEg",225,0.995575,32,226,1,225,1,1,0,1,1,118,118,108,107,53
"4646",45,"[32]EFmdGiAisHnKqGocIHcJCHypFCzrAbEg",239,0.995833,32,240,1,239,1,1,0,1,1,111,111,129,128,53
"4647",46,"[32]EFmdGiAisHnKqGocIHcJCHypFCzrAbEg",227,0.995614,32,228,1,227,1,1,0,1,1,116,116,112,111,53
"4648",47,"[32]EFmdGiAisHnKqGocIHcJCHypFCzrAbEg",223,0.995536,32,224,1,223,1,1,0,1,1,121,121,103,102,53
"4649",48,"[32]EFmdGiAisHnKqGocIHcJCHypFCzrAbEg",228,0.995633,32,229,1,228,1,1,0,1,1,115,115,114,113,53
"4650",49,"[32]EFmdGiAisHnKqGocIHcJCHypFCzrAbEg",234,0.995745,32,235,1,234,1,1,0,1,1,110,110,125,124,53
"4651",50,"[32]EFmdGiAisHnKqGocIHcJCHypFCzrAbEg",225,0.995575,32,226,1,225,1,1,0,1,1,120,120,106,105,53
"4652",51,"[32]EFmdGiAisHnKqGocIHcJCHypFCzrAbEg",231,0.99569,32,232,1,231,1,1,0,1,1,115,115,117,116,53
"4653",52,"[32]EFmdGiAisHnKqGocIHcJCHypFCzrAbEg",230,0.995671,32,231,1,230,1,1,0,1,1,115,115,116,115,53
"4654",53,"[32]EFmdGiAisHnKqGocIHcJCHypFCzrAbEg",230,0.995671,32,231,1,230,1,1,0,1,1,114,114,117,116,53
"4655",54,"[32]EFmdGiAisHnKqGocIHcJCHypFCzrAbEg",241,0.995868,32,242,1,241,1,1,0,1,1,107,107,135,134,53
"4656",55,"[32]EFmdGiAisHnKqGocIHcJCHypFCzrAbEg",223,0.995536,32,224,1,223,1,1,0,1,1,119,119,105,104,53
"4657",56,"[32]EFmdGiAisHnKqGocIHcJCHypFCzrAbEg",233,0.995726,32,234,1,233,1,1,0,1,1,111,111,123,122,53
"4658",57,"[32]EFmdGiAisHnKqGocIHcJCHypFCzrAbEg",228,0.995633,32,229,1,228,1,1,0,1,1,115,115,114,113,53
"4659",58,"[32]EFmdGiAisHnKqGocIHcJCHypFCzrAbEg",220,0.995475,32,221,1,220,1,1,0,1,1,122,122,99,98,53
"4660",59,"[32]EFmdGiAisHnKqGocIHcJCHypFCzrAbEg",230,0.995671,32,231,1,230,1,1,0,1,1,113,113,118,117,53
"4661",60,"[32]EFmdGiAisHnKqGocIHcJCHypFCzrAbEg",225,0.995575,32,226,1,225,1,1,0,1,1,118,118,108,107,53
"4662",61,"[32]EFmdGiAisHnKqGocIHcJCHypFCzrAbEg",245,0.995935,32,246,1,245,1,1,0,1,1,102,102,144,143,53
"4663",62,"[32]EFmdGiAisHnKqGocIHcJCHypFCzrAbEg",231,0.99569,32,232,1,231,1,1,0,1,1,114,114,118,117,53
"4664",63,"[32]EFmdGiAisHnKqGocIHcJCHypFCzrAbEg",226,0.995595,32,227,1,226,1,1,0,1,1,116,116,111,110,53
"4665",64,"[32]EFmdGiAisHnKqGocIHcJCHypFCzrAbEg",237,0.995798,32,238,1,237,1,1,0,1,1,108,108,130,129,53
"4666",65,"[32]EFmdGiAisHnKqGocIHcJCHypFCzrAbEg",232,0.995708,32,233,1,232,1,1,0,1,1,113,113,120,119,53
"4667",66,"[32]EFmdGiAisHnKqGocIHcJCHypFCzrAbEg",233,0.995726,32,234,1,233,1,1,0,1,1,113,113,121,120,53
"4668",67,"[32]EFmdGiAisHnKqGocIHcJCHypFCzrAbEg",240,0.995851,32,241,1,240,1,1,0,1,1,108,108,133,132,53
"4669",68,"[32]EFmdGiAisHnKqGocIHcJCHypFCzrAbEg",231,0.99569,32,232,1,231,1,1,0,1,1,113,113,119,118,53
"4670",69,"[32]EFmdGiAisHnKqGocIHcJCHypFCzrAbEg",236,0.995781,32,237,1,236,1,1,0,1,1,108,108,129,128,53
"4671",70,"[32]EFmdGiAisHnKqGocIHcJCHypFCzrAbEg",234,0.995745,32,235,1,234,1,1,0,1,1,110,110,125,124,53
"4672",71,"[32]EFmdGiAisHnKqGocIHcJCHypFCzrAbEg",234,0.995745,32,235,1,234,1,1,0,1,1,111,111,124,123,53
"4673",72,"[32]EFmdGiAisHnKqGocIHcJCHypFCzrAbEg",227,0.995614,32,228,1,227,1,1,0,1,1,116,116,112,111,53
"4674",73,"[32]EFmdGiAisHnKqGocIHcJCHypFCzrAbEg",227,0.995614,32,228,1,227,1,1,0,1,1,115,115,113,112,53
"4675",74,"[32]EFmdGiAisHnKqGocIHcJCHypFCzrAbEg",233,0.995726,32,234,1,233,1,1,0,1,1,111,111,123,122,53
"4676",75,"[32]EFmdGiAisHnKqGocIHcJCHypFCzrAbEg",230,0.995671,32,231,1,230,1,1,0,1,1,114,114,117,116,53
"4677",76,"[32]EFmdGiAisHnKqGocIHcJCHypFCzrAbEg",220,0.995475,32,221,1,220,1,1,0,1,1,121,121,100,99,53
"4678",77,"[32]EFmdGiAisHnKqGocIHcJCHypFCzrAbEg",220,0.995475,32,221,1,220,1,1,0,1,1,121,121,100,99,53
"4679",78,"[32]EFmdGiAisHnKqGocIHcJCHypFCzrAbEg",236,0.995781,32,237,1,236,1,1,0,1,1,108,108,129,128,53
"4680",79,"[32]EFmdGiAisHnKqGocIHcJCHypFCzrAbEg",216,0.995392,32,217,1,216,1,1,0,1,1,128,128,89,88,53
"4681",80,"[32]EFmdGiAisHnKqGocIHcJCHypFCzrAbEg",237,0.995798,32,238,1,237,1,1,0,1,1,109,109,129,128,53
"4682",81,"[32]EFmdGiAisHnKqGocIHcJCHypFCzrAbEg",229,0.995652,32,230,1,229,1,1,0,1,1,115,115,115,114,53
"4683",82,"[32]EFmdGiAisHnKqGocIHcJCHypFCzrAbEg",225,0.995575,32,226,1,225,1,1,0,1,1,117,117,109,108,53
"4684",83,"[32]EFmdGiAisHnKqGocIHcJCHypFCzrAbEg",218,0.995434,32,219,1,218,1,1,0,1,1,123,123,96,95,53
"4685",84,"[32]EFmdGiAisHnKqGocIHcJCHypFCzrAbEg",231,0.99569,32,232,1,231,1,1,0,1,1,114,114,118,117,53
"4686",85,"[32]EFmdGiAisHnKqGocIHcJCHypFCzrAbEg",235,0.995763,32,236,1,235,1,1,0,1,1,111,111,125,124,53
"4687",86,"[32]EFmdGiAisHnKqGocIHcJCHypFCzrAbEg",237,0.995798,32,238,1,237,1,1,0,1,1,108,108,130,129,53
"4688",87,"[32]EFmdGiAisHnKqGocIHcJCHypFCzrAbEg",228,0.995633,32,229,1,228,1,1,0,1,1,120,120,109,108,53
"4689",88,"[32]EFmdGiAisHnKqGocIHcJCHypFCzrAbEg",241,0.995868,32,242,1,241,1,1,0,1,1,105,105,137,136,53
"4690",89,"[32]EFmdGiAisHnKqGocIHcJCHypFCzrAbEg",233,0.995726,32,234,1,233,1,1,0,1,1,112,112,122,121,53
"4691",90,"[32]EFmdGiAisHnKqGocIHcJCHypFCzrAbEg",217,0.995413,32,218,1,217,1,1,0,1,1,124,124,94,93,53
"4692",91,"[32]EFmdGiAisHnKqGocIHcJCHypFCzrAbEg",231,0.99569,32,232,1,231,1,1,0,1,1,112,112,120,119,53
"4693",92,"[32]EFmdGiAisHnKqGocIHcJCHypFCzrAbEg",243,0.995902,32,244,1,243,1,1,0,1,1,104,104,140,139,53
"4694",93,"[32]EFmdGiAisHnKqGocIHcJCHypFCzrAbEg",230,0.995671,32,231,1,230,1,1,0,1,1,118,118,113,112,53
"4695",94,"[32]EFmdGiAisHnKqGocIHcJCHypFCzrAbEg",235,0.995763,32,236,1,235,1,1,0,1,1,110,110,126,125,53
"4696",95,"[32]EFmdGiAisHnKqGocIHcJCHypFCzrAbEg",236,0.995781,32,237,1,236,1,1,0,1,1,108,108,129,128,53
"4697",96,"[32]EFmdGiAisHnKqGocIHcJCHypFCzrAbEg",224,0.995556,32,225,1,224,1,1,0,1,1,118,118,107,106,53
"4698",97,"[32]EFmdGiAisHnKqGocIHcJCHypFCzrAbEg",232,0.995708,32,233,1,232,1,1,0,1,1,115,115,118,117,53
"4699",98,"[32]EFmdGiAisHnKqGocIHcJCHypFCzrAbEg",227,0.995614,32,228,1,227,1,1,0,1,1,117,117,111,110,53
"4700",99,"[32]EFmdGiAisHnKqGocIHcJCHypFCzrAbEg",240,0.995851,32,241,1,240,1,1,0,1,1,108,108,133,132,53
"4701",0,"[29]EKwebwxHnKqGocIHBJCmqFwIkAsak",227,0.995614,29,228,1,227,1,1,0,1,1,117,117,111,110,54
"4702",1,"[29]EKwebwxHnKqGocIHBJCmqFwIkAsak",228,0.995633,29,229,1,228,1,1,0,1,1,117,117,112,111,54
"4703",2,"[29]EKwebwxHnKqGocIHBJCmqFwIkAsak",226,0.995595,29,227,1,226,1,1,0,1,1,118,118,109,108,54
"4704",3,"[29]EKwebwxHnKqGocIHBJCmqFwIkAsak",227,0.995614,29,228,1,227,1,1,0,1,1,119,119,109,108,54
"4705",4,"[29]EKwebwxHnKqGocIHBJCmqFwIkAsak",234,0.995745,29,235,1,234,1,1,0,1,1,113,113,122,121,54
"4706",5,"[29]EKwebwxHnKqGocIHBJCmqFwIkAsak",229,0.995652,29,230,1,229,1,1,0,1,1,116,116,114,113,54
"4707",6,"[29]EKwebwxHnKqGocIHBJCmqFwIkAsak",226,0.995595,29,227,1,226,1,1,0,1,1,117,117,110,109,54
"4708",7,"[29]EKwebwxHnKqGocIHBJCmqFwIkAsak",232,0.995708,29,233,1,232,1,1,0,1,1,114,114,119,118,54
"4709",8,"[29]EKwebwxHnKqGocIHBJCmqFwIkAsak",233,0.995726,29,234,1,233,1,1,0,1,1,112,112,122,121,54
"4710",9,"[29]EKwebwxHnKqGocIHBJCmqFwIkAsak",234,0.995745,29,235,1,234,1,1,0,1,1,112,112,123,122,54
"4711",10,"[29]EKwebwxHnKqGocIHBJCmqFwIkAsak",230,0.995671,29,231,1,230,1,1,0,1,1,115,115,116,115,54
"4712",11,"[29]EKwebwxHnKqGocIHBJCmqFwIkAsak",234,0.995745,29,235,1,234,1,1,0,1,1,115,115,120,119,54
"4713",12,"[29]EKwebwxHnKqGocIHBJCmqFwIkAsak",229,0.995652,29,230,1,229,1,1,0,1,1,115,115,115,114,54
"4714",13,"[29]EKwebwxHnKqGocIHBJCmqFwIkAsak",229,0.995652,29,230,1,229,1,1,0,1,1,115,115,115,114,54
"4715",14,"[29]EKwebwxHnKqGocIHBJCmqFwIkAsak",229,0.995652,29,230,1,229,1,1,0,1,1,116,116,114,113,54
"4716",15,"[29]EKwebwxHnKqGocIHBJCmqFwIkAsak",229,0.995652,29,230,1,229,1,1,0,1,1,115,115,115,114,54
"4717",16,"[29]EKwebwxHnKqGocIHBJCmqFwIkAsak",229,0.995652,29,230,1,229,1,1,0,1,1,115,115,115,114,54
"4718",17,"[29]EKwebwxHnKqGocIHBJCmqFwIkAsak",236,0.995781,29,237,1,236,1,1,0,1,1,111,111,126,125,54
"4719",18,"[29]EKwebwxHnKqGocIHBJCmqFwIkAsak",234,0.995745,29,235,1,234,1,1,0,1,1,113,113,122,121,54
"4720",19,"[29]EKwebwxHnKqGocIHBJCmqFwIkAsak",237,0.995798,29,238,1,237,1,1,0,1,1,112,112,126,125,54
"4721",20,"[29]EKwebwxHnKqGocIHBJCmqFwIkAsak",226,0.995595,29,227,1,226,1,1,0,1,1,117,117,110,109,54
"4722",21,"[29]EKwebwxHnKqGocIHBJCmqFwIkAsak",228,0.995633,29,229,1,228,1,1,0,1,1,116,116,113,112,54
"4723",22,"[29]EKwebwxHnKqGocIHBJCmqFwIkAsak",232,0.995708,29,233,1,232,1,1,0,1,1,113,113,120,119,54
"4724",23,"[29]EKwebwxHnKqGocIHBJCmqFwIkAsak",229,0.995652,29,230,1,229,1,1,0,1,1,115,115,115,114,54
"4725",24,"[29]EKwebwxHnKqGocIHBJCmqFwIkAsak",225,0.995575,29,226,1,225,1,1,0,1,1,118,118,108,107,54
"4726",25,"[29]EKwebwxHnKqGocIHBJCmqFwIkAsak",229,0.995652,29,230,1,229,1,1,0,1,1,116,116,114,113,54
"4727",26,"[29]EKwebwxHnKqGocIHBJCmqFwIkAsak",224,0.995556,29,225,1,224,1,1,0,1,1,119,119,106,105,54
"4728",27,"[29]EKwebwxHnKqGocIHBJCmqFwIkAsak",234,0.995745,29,235,1,234,1,1,0,1,1,113,113,122,121,54
"4729",28,"[29]EKwebwxHnKqGocIHBJCmqFwIkAsak",236,0.995781,29,237,1,236,1,1,0,1,1,109,109,128,127,54
"4730",29,"[29]EKwebwxHnKqGocIHBJCmqFwIkAsak",230,0.995671,29,231,1,230,1,1,0,1,1,116,116,115,114,54
"4731",30,"[29]EKwebwxHnKqGocIHBJCmqFwIkAsak",235,0.995763,29,236,1,235,1,1,0,1,1,112,112,124,123,54
"4732",31,"[29]EKwebwxHnKqGocIHBJCmqFwIkAsak",229,0.995652,29,230,1,229,1,1,0,1,1,116,116,114,113,54
"4733",32,"[29]EKwebwxHnKqGocIHBJCmqFwIkAsak",229,0.995652,29,230,1,229,1,1,0,1,1,117,117,113,112,54
"4734",33,"[29]EKwebwxHnKqGocIHBJCmqFwIkAsak",234,0.995745,29,235,1,234,1,1,0,1,1,112,112,123,122,54
"4735",34,"[29]EKwebwxHnKqGocIHBJCmqFwIkAsak",230,0.995671,29,231,1,230,1,1,0,1,1,116,116,115,114,54
"4736",35,"[29]EKwebwxHnKqGocIHBJCmqFwIkAsak",228,0.995633,29,229,1,228,1,1,0,1,1,117,117,112,111,54
"4737",36,"[29]EKwebwxHnKqGocIHBJCmqFwIkAsak",230,0.995671,29,231,1,230,1,1,0,1,1,115,115,116,115,54
"4738",37,"[29]EKwebwxHnKqGocIHBJCmqFwIkAsak",238,0.995816,29,239,1,238,1,1,0,1,1,111,111,128,127,54
"4739",38,"[29]EKwebwxHnKqGocIHBJCmqFwIkAsak",225,0.995575,29,226,1,225,1,1,0,1,1,118,118,108,107,54
"4740",39,"[29]EKwebwxHnKqGocIHBJCmqFwIkAsak",230,0.995671,29,231,1,230,1,1,0,1,1,114,114,117,116,54
"4741",40,"[29]EKwebwxHnKqGocIHBJCmqFwIkAsak",239,0.995833,29,240,1,239,1,1,0,1,1,109,109,131,130,54
"4742",41,"[29]EKwebwxHnKqGocIHBJCmqFwIkAsak",229,0.995652,29,230,1,229,1,1,0,1,1,115,115,115,114,54
"4743",42,"[29]EKwebwxHnKqGocIHBJCmqFwIkAsak",240,0.995851,29,241,1,240,1,1,0,1,1,107,107,134,133,54
"4744",43,"[29]EKwebwxHnKqGocIHBJCmqFwIkAsak",223,0.995536,29,224,1,223,1,1,0,1,1,123,123,101,100,54
"4745",44,"[29]EKwebwxHnKqGocIHBJCmqFwIkAsak",233,0.995726,29,234,1,233,1,1,0,1,1,112,112,122,121,54
"4746",45,"[29]EKwebwxHnKqGocIHBJCmqFwIkAsak",235,0.995763,29,236,1,235,1,1,0,1,1,110,110,126,125,54
"4747",46,"[29]EKwebwxHnKqGocIHBJCmqFwIkAsak",237,0.995798,29,238,1,237,1,1,0,1,1,110,110,128,127,54
"4748",47,"[29]EKwebwxHnKqGocIHBJCmqFwIkAsak",231,0.99569,29,232,1,231,1,1,0,1,1,116,116,116,115,54
"4749",48,"[29]EKwebwxHnKqGocIHBJCmqFwIkAsak",221,0.995495,29,222,1,221,1,1,0,1,1,122,122,100,99,54
"4750",49,"[29]EKwebwxHnKqGocIHBJCmqFwIkAsak",235,0.995763,29,236,1,235,1,1,0,1,1,111,111,125,124,54
"4751",50,"[29]EKwebwxHnKqGocIHBJCmqFwIkAsak",224,0.995556,29,225,1,224,1,1,0,1,1,119,119,106,105,54
"4752",51,"[29]EKwebwxHnKqGocIHBJCmqFwIkAsak",233,0.995726,29,234,1,233,1,1,0,1,1,114,114,120,119,54
"4753",52,"[29]EKwebwxHnKqGocIHBJCmqFwIkAsak",229,0.995652,29,230,1,229,1,1,0,1,1,117,117,113,112,54
"4754",53,"[29]EKwebwxHnKqGocIHBJCmqFwIkAsak",238,0.995816,29,239,1,238,1,1,0,1,1,111,111,128,127,54
"4755",54,"[29]EKwebwxHnKqGocIHBJCmqFwIkAsak",221,0.995495,29,222,1,221,1,1,0,1,1,121,121,101,100,54
"4756",55,"[29]EKwebwxHnKqGocIHBJCmqFwIkAsak",245,0.995935,29,246,1,245,1,1,0,1,1,104,104,142,141,54
"4757",56,"[29]EKwebwxHnKqGocIHBJCmqFwIkAsak",220,0.995475,29,221,1,220,1,1,0,1,1,122,122,99,98,54
"4758",57,"[29]EKwebwxHnKqGocIHBJCmqFwIkAsak",225,0.995575,29,226,1,225,1,1,0,1,1,121,121,105,104,54
"4759",58,"[29]EKwebwxHnKqGocIHBJCmqFwIkAsak",224,0.995556,29,225,1,224,1,1,0,1,1,119,119,106,105,54
"4760",59,"[29]EKwebwxHnKqGocIHBJCmqFwIkAsak",228,0.995633,29,229,1,228,1,1,0,1,1,117,117,112,111,54
"4761",60,"[29]EKwebwxHnKqGocIHBJCmqFwIkAsak",238,0.995816,29,239,1,238,1,1,0,1,1,109,109,130,129,54
"4762",61,"[29]EKwebwxHnKqGocIHBJCmqFwIkAsak",243,0.995902,29,244,1,243,1,1,0,1,1,105,105,139,138,54
"4763",62,"[29]EKwebwxHnKqGocIHBJCmqFwIkAsak",231,0.99569,29,232,1,231,1,1,0,1,1,116,116,116,115,54
"4764",63,"[29]EKwebwxHnKqGocIHBJCmqFwIkAsak",229,0.995652,29,230,1,229,1,1,0,1,1,116,116,114,113,54
"4765",64,"[29]EKwebwxHnKqGocIHBJCmqFwIkAsak",236,0.995781,29,237,1,236,1,1,0,1,1,115,115,122,121,54
"4766",65,"[29]EKwebwxHnKqGocIHBJCmqFwIkAsak",231,0.99569,29,232,1,231,1,1,0,1,1,114,114,118,117,54
"4767",66,"[29]EKwebwxHnKqGocIHBJCmqFwIkAsak",229,0.995652,29,230,1,229,1,1,0,1,1,115,115,115,114,54
"4768",67,"[29]EKwebwxHnKqGocIHBJCmqFwIkAsak",221,0.995495,29,222,1,221,1,1,0,1,1,122,122,100,99,54
"4769",68,"[29]EKwebwxHnKqGocIHBJCmqFwIkAsak",232,0.995708,29,233,1,232,1,1,0,1,1,118,118,115,114,54
"4770",69,"[29]EKwebwxHnKqGocIHBJCmqFwIkAsak",233,0.995726,29,234,1,233,1,1,0,1,1,112,112,122,121,54
"4771",70,"[29]EKwebwxHnKqGocIHBJCmqFwIkAsak",231,0.99569,29,232,1,231,1,1,0,1,1,113,113,119,118,54
"4772",71,"[29]EKwebwxHnKqGocIHBJCmqFwIkAsak",243,0.995902,29,244,1,243,1,1,0,1,1,104,104,140,139,54
"4773",72,"[29]EKwebwxHnKqGocIHBJCmqFwIkAsak",217,0.995413,29,218,1,217,1,1,0,1,1,125,125,93,92,54
"4774",73,"[29]EKwebwxHnKqGocIHBJCmqFwIkAsak",237,0.995798,29,238,1,237,1,1,0,1,1,110,110,128,127,54
"4775",74,"[29]EKwebwxHnKqGocIHBJCmqFwIkAsak",231,0.99569,29,232,1,231,1,1,0,1,1,114,114,118,117,54
"4776",75,"[29]EKwebwxHnKqGocIHBJCmqFwIkAsak",234,0.995745,29,235,1,234,1,1,0,1,1,113,113,122,121,54
"4777",76,"[29]EKwebwxHnKqGocIHBJCmqFwIkAsak",228,0.995633,29,229,1,228,1,1,0,1,1,117,117,112,111,54
"4778",77,"[29]EKwebwxHnKqGocIHBJCmqFwIkAsak",229,0.995652,29,230,1,229,1,1,0,1,1,115,115,115,114,54
"4779",78,"[29]EKwebwxHnKqGocIHBJCmqFwIkAsak",231,0.99569,29,232,1,231,1,1,0,1,1,113,113,119,118,54
"4780",79,"[29]EKwebwxHnKqGocIHBJCmqFwIkAsak",231,0.99569,29,232,1,231,1,1,0,1,1,116,116,116,115,54
"4781",80,"[29]EKwebwxHnKqGocIHBJCmqFwIkAsak",231,0.99569,29,232,1,231,1,1,0,1,1,114,114,118,117,54
"4782",81,"[29]EKwebwxHnKqGocIHBJCmqFwIkAsak",235,0.995763,29,236,1,235,1,1,0,1,1,110,110,126,125,54
"4783",82,"[29]EKwebwxHnKqGocIHBJCmqFwIkAsak",230,0.995671,29,231,1,230,1,1,0,1,1,114,114,117,116,54
"4784",83,"[29]EKwebwxHnKqGocIHBJCmqFwIkAsak",232,0.995708,29,233,1,232,1,1,0,1,1,113,113,120,119,54
"4785",84,"[29]EKwebwxHnKqGocIHBJCmqFwIkAsak",222,0.995516,29,223,1,222,1,1,0,1,1,121,121,102,101,54
"4786",85,"[29]EKwebwxHnKqGocIHBJCmqFwIkAsak",220,0.995475,29,221,1,220,1,1,0,1,1,124,124,97,96,54
"4787",86,"[29]EKwebwxHnKqGocIHBJCmqFwIkAsak",233,0.995726,29,234,1,233,1,1,0,1,1,112,112,122,121,54
"4788",87,"[29]EKwebwxHnKqGocIHBJCmqFwIkAsak",248,0.995984,29,249,1,248,1,1,0,1,1,100,100,149,148,54
"4789",88,"[29]EKwebwxHnKqGocIHBJCmqFwIkAsak",229,0.995652,29,230,1,229,1,1,0,1,1,115,115,115,114,54
"4790",89,"[29]EKwebwxHnKqGocIHBJCmqFwIkAsak",238,0.995816,29,239,1,238,1,1,0,1,1,111,111,128,127,54
"4791",90,"[29]EKwebwxHnKqGocIHBJCmqFwIkAsak",227,0.995614,29,228,1,227,1,1,0,1,1,117,117,111,110,54
"4792",91,"[29]EKwebwxHnKqGocIHBJCmqFwIkAsak",238,0.995816,29,239,1,238,1,1,0,1,1,109,109,130,129,54
"4793",92,"[29]EKwebwxHnKqGocIHBJCmqFwIkAsak",234,0.995745,29,235,1,234,1,1,0,1,1,113,113,122,121,54
"4794",93,"[29]EKwebwxHnKqGocIHBJCmqFwIkAsak",228,0.995633,29,229,1,228,1,1,0,1,1,121,121,108,107,54
"4795",94,"[29]EKwebwxHnKqGocIHBJCmqFwIkAsak",238,0.995816,29,239,1,238,1,1,0,1,1,111,111,128,127,54
"4796",95,"[29]EKwebwxHnKqGocIHBJCmqFwIkAsak",230,0.995671,29,231,1,230,1,1,0,1,1,117,117,114,113,54
"4797",96,"[29]EKwebwxHnKqGocIHBJCmqFwIkAsak",218,0.995434,29,219,1,218,1,1,0,1,1,124,124,95,94,54
"4798",97,"[29]EKwebwxHnKqGocIHBJCmqFwIkAsak",236,0.995781,29,237,1,236,1,1,0,1,1,110,110,127,126,54
"4799",98,"[29]EKwebwxHnKqGocIHBJCmqFwIkAsak",234,0.995745,29,235,1,234,1,1,0,1,1,112,112,123,122,54
"4800",99,"[29]EKwebwxHnKqGocIHBJCmqFwIkAsak",234,0.995745,29,235,1,234,1,1,0,1,1,111,111,124,123,54
"4801",0,"[27]EjKiuHnKqGocIHcJCAHIEqBKtDy",234,0.995745,27,235,1,234,1,1,0,1,1,111,111,124,123,56
"4802",1,"[27]EjKiuHnKqGocIHcJCAHIEqBKtDy",231,0.99569,27,232,1,231,1,1,0,1,1,114,114,118,117,56
"4803",2,"[27]EjKiuHnKqGocIHcJCAHIEqBKtDy",224,0.995556,27,225,1,224,1,1,0,1,1,120,120,105,104,56
"4804",3,"[27]EjKiuHnKqGocIHcJCAHIEqBKtDy",223,0.995536,27,224,1,223,1,1,0,1,1,120,120,104,103,56
"4805",4,"[27]EjKiuHnKqGocIHcJCAHIEqBKtDy",232,0.995708,27,233,1,232,1,1,0,1,1,115,115,118,117,56
"4806",5,"[27]EjKiuHnKqGocIHcJCAHIEqBKtDy",242,0.995885,27,243,1,242,1,1,0,1,1,107,107,136,135,56
"4807",6,"[27]EjKiuHnKqGocIHcJCAHIEqBKtDy",229,0.995652,27,230,1,229,1,1,0,1,1,115,115,115,114,56
"4808",7,"[27]EjKiuHnKqGocIHcJCAHIEqBKtDy",233,0.995726,27,234,1,233,1,1,0,1,1,112,112,122,121,56
"4809",8,"[27]EjKiuHnKqGocIHcJCAHIEqBKtDy",232,0.995708,27,233,1,232,1,1,0,1,1,115,115,118,117,56
"4810",9,"[27]EjKiuHnKqGocIHcJCAHIEqBKtDy",235,0.995763,27,236,1,235,1,1,0,1,1,112,112,124,123,56
"4811",10,"[27]EjKiuHnKqGocIHcJCAHIEqBKtDy",224,0.995556,27,225,1,224,1,1,0,1,1,120,120,105,104,56
"4812",11,"[27]EjKiuHnKqGocIHcJCAHIEqBKtDy",224,0.995556,27,225,1,224,1,1,0,1,1,120,120,105,104,56
"4813",12,"[27]EjKiuHnKqGocIHcJCAHIEqBKtDy",228,0.995633,27,229,1,228,1,1,0,1,1,116,116,113,112,56
"4814",13,"[27]EjKiuHnKqGocIHcJCAHIEqBKtDy",229,0.995652,27,230,1,229,1,1,0,1,1,115,115,115,114,56
"4815",14,"[27]EjKiuHnKqGocIHcJCAHIEqBKtDy",223,0.995536,27,224,1,223,1,1,0,1,1,120,120,104,103,56
"4816",15,"[27]EjKiuHnKqGocIHcJCAHIEqBKtDy",237,0.995798,27,238,1,237,1,1,0,1,1,110,110,128,127,56
"4817",16,"[27]EjKiuHnKqGocIHcJCAHIEqBKtDy",232,0.995708,27,233,1,232,1,1,0,1,1,117,117,116,115,56
"4818",17,"[27]EjKiuHnKqGocIHcJCAHIEqBKtDy",232,0.995708,27,233,1,232,1,1,0,1,1,114,114,119,118,56
"4819",18,"[27]EjKiuHnKqGocIHcJCAHIEqBKtDy",224,0.995556,27,225,1,224,1,1,0,1,1,121,121,104,103,56
"4820",19,"[27]EjKiuHnKqGocIHcJCAHIEqBKtDy",242,0.995885,27,243,1,242,1,1,0,1,1,107,107,136,135,56
"4821",20,"[27]EjKiuHnKqGocIHcJCAHIEqBKtDy",234,0.995745,27,235,1,234,1,1,0,1,1,115,115,120,119,56
"4822",21,"[27]EjKiuHnKqGocIHcJCAHIEqBKtDy",228,0.995633,27,229,1,228,1,1,0,1,1,116,116,113,112,56
"4823",22,"[27]EjKiuHnKqGocIHcJCAHIEqBKtDy",227,0.995614,27,228,1,227,1,1,0,1,1,118,118,110,109,56
"4824",23,"[27]EjKiuHnKqGocIHcJCAHIEqBKtDy",224,0.995556,27,225,1,224,1,1,0,1,1,119,119,106,105,56
"4825",24,"[27]EjKiuHnKqGocIHcJCAHIEqBKtDy",223,0.995536,27,224,1,223,1,1,0,1,1,121,121,103,102,56
"4826",25,"[27]EjKiuHnKqGocIHcJCAHIEqBKtDy",230,0.995671,27,231,1,230,1,1,0,1,1,115,115,116,115,56
"4827",26,"[27]EjKiuHnKqGocIHcJCAHIEqBKtDy",234,0.995745,27,235,1,234,1,1,0,1,1,114,114,121,120,56
"4828",27,"[27]EjKiuHnKqGocIHcJCAHIEqBKtDy",231,0.99569,27,232,1,231,1,1,0,1,1,115,115,117,116,56
"4829",28,"[27]EjKiuHnKqGocIHcJCAHIEqBKtDy",246,0.995951,27,247,1,246,1,1,0,1,1,102,102,145,144,56
"4830",29,"[27]EjKiuHnKqGocIHcJCAHIEqBKtDy",239,0.995833,27,240,1,239,1,1,0,1,1,108,108,132,131,56
"4831",30,"[27]EjKiuHnKqGocIHcJCAHIEqBKtDy",228,0.995633,27,229,1,228,1,1,0,1,1,117,117,112,111,56
"4832",31,"[27]EjKiuHnKqGocIHcJCAHIEqBKtDy",246,0.995951,27,247,1,246,1,1,0,1,1,105,105,142,141,56
"4833",32,"[27]EjKiuHnKqGocIHcJCAHIEqBKtDy",233,0.995726,27,234,1,233,1,1,0,1,1,113,113,121,120,56
"4834",33,"[27]EjKiuHnKqGocIHcJCAHIEqBKtDy",237,0.995798,27,238,1,237,1,1,0,1,1,111,111,127,126,56
"4835",34,"[27]EjKiuHnKqGocIHcJCAHIEqBKtDy",219,0.995455,27,220,1,219,1,1,0,1,1,124,124,96,95,56
"4836",35,"[27]EjKiuHnKqGocIHcJCAHIEqBKtDy",234,0.995745,27,235,1,234,1,1,0,1,1,114,114,121,120,56
"4837",36,"[27]EjKiuHnKqGocIHcJCAHIEqBKtDy",235,0.995763,27,236,1,235,1,1,0,1,1,112,112,124,123,56
"4838",37,"[27]EjKiuHnKqGocIHcJCAHIEqBKtDy",234,0.995745,27,235,1,234,1,1,0,1,1,111,111,124,123,56
"4839",38,"[27]EjKiuHnKqGocIHcJCAHIEqBKtDy",232,0.995708,27,233,1,232,1,1,0,1,1,114,114,119,118,56
"4840",39,"[27]EjKiuHnKqGocIHcJCAHIEqBKtDy",236,0.995781,27,237,1,236,1,1,0,1,1,111,111,126,125,56
"4841",40,"[27]EjKiuHnKqGocIHcJCAHIEqBKtDy",224,0.995556,27,225,1,224,1,1,0,1,1,120,120,105,104,56
"4842",41,"[27]EjKiuHnKqGocIHcJCAHIEqBKtDy",243,0.995902,27,244,1,243,1,1,0,1,1,107,107,137,136,56
"4843",42,"[27]EjKiuHnKqGocIHcJCAHIEqBKtDy",229,0.995652,27,230,1,229,1,1,0,1,1,115,115,115,114,56
"4844",43,"[27]EjKiuHnKqGocIHcJCAHIEqBKtDy",228,0.995633,27,229,1,228,1,1,0,1,1,119,119,110,109,56
"4845",44,"[27]EjKiuHnKqGocIHcJCAHIEqBKtDy",237,0.995798,27,238,1,237,1,1,0,1,1,110,110,128,127,56
"4846",45,"[27]EjKiuHnKqGocIHcJCAHIEqBKtDy",235,0.995763,27,236,1,235,1,1,0,1,1,111,111,125,124,56
"4847",46,"[27]EjKiuHnKqGocIHcJCAHIEqBKtDy",229,0.995652,27,230,1,229,1,1,0,1,1,116,116,114,113,56
"4848",47,"[27]EjKiuHnKqGocIHcJCAHIEqBKtDy",223,0.995536,27,224,1,223,1,1,0,1,1,121,121,103,102,56
"4849",48,"[27]EjKiuHnKqGocIHcJCAHIEqBKtDy",229,0.995652,27,230,1,229,1,1,0,1,1,116,116,114,113,56
"4850",49,"[27]EjKiuHnKqGocIHcJCAHIEqBKtDy",232,0.995708,27,233,1,232,1,1,0,1,1,113,113,120,119,56
"4851",50,"[27]EjKiuHnKqGocIHcJCAHIEqBKtDy",230,0.995671,27,231,1,230,1,1,0,1,1,115,115,116,115,56
"4852",51,"[27]EjKiuHnKqGocIHcJCAHIEqBKtDy",231,0.99569,27,232,1,231,1,1,0,1,1,115,115,117,116,56
"4853",52,"[27]EjKiuHnKqGocIHcJCAHIEqBKtDy",230,0.995671,27,231,1,230,1,1,0,1,1,118,118,113,112,56
"4854",53,"[27]EjKiuHnKqGocIHcJCAHIEqBKtDy",229,0.995652,27,230,1,229,1,1,0,1,1,116,116,114,113,56
"4855",54,"[27]EjKiuHnKqGocIHcJCAHIEqBKtDy",220,0.995475,27,221,1,220,1,1,0,1,1,123,123,98,97,56
"4856",55,"[27]EjKiuHnKqGocIHcJCAHIEqBKtDy",217,0.995413,27,218,1,217,1,1,0,1,1,127,127,91,90,56
"4857",56,"[27]EjKiuHnKqGocIHcJCAHIEqBKtDy",220,0.995475,27,221,1,220,1,1,0,1,1,126,126,95,94,56
"4858",57,"[27]EjKiuHnKqGocIHcJCAHIEqBKtDy",232,0.995708,27,233,1,232,1,1,0,1,1,114,114,119,118,56
"4859",58,"[27]EjKiuHnKqGocIHcJCAHIEqBKtDy",231,0.99569,27,232,1,231,1,1,0,1,1,115,115,117,116,56
"4860",59,"[27]EjKiuHnKqGocIHcJCAHIEqBKtDy",243,0.995902,27,244,1,243,1,1,0,1,1,107,107,137,136,56
"4861",60,"[27]EjKiuHnKqGocIHcJCAHIEqBKtDy",230,0.995671,27,231,1,230,1,1,0,1,1,115,115,116,115,56
"4862",61,"[27]EjKiuHnKqGocIHcJCAHIEqBKtDy",234,0.995745,27,235,1,234,1,1,0,1,1,112,112,123,122,56
"4863",62,"[27]EjKiuHnKqGocIHcJCAHIEqBKtDy",231,0.99569,27,232,1,231,1,1,0,1,1,114,114,118,117,56
"4864",63,"[27]EjKiuHnKqGocIHcJCAHIEqBKtDy",234,0.995745,27,235,1,234,1,1,0,1,1,114,114,121,120,56
"4865",64,"[27]EjKiuHnKqGocIHcJCAHIEqBKtDy",236,0.995781,27,237,1,236,1,1,0,1,1,112,112,125,124,56
"4866",65,"[27]EjKiuHnKqGocIHcJCAHIEqBKtDy",234,0.995745,27,235,1,234,1,1,0,1,1,111,111,124,123,56
"4867",66,"[27]EjKiuHnKqGocIHcJCAHIEqBKtDy",226,0.995595,27,227,1,226,1,1,0,1,1,119,119,108,107,56
"4868",67,"[27]EjKiuHnKqGocIHcJCAHIEqBKtDy",239,0.995833,27,240,1,239,1,1,0,1,1,109,109,131,130,56
"4869",68,"[27]EjKiuHnKqGocIHcJCAHIEqBKtDy",236,0.995781,27,237,1,236,1,1,0,1,1,111,111,126,125,56
"4870",69,"[27]EjKiuHnKqGocIHcJCAHIEqBKtDy",233,0.995726,27,234,1,233,1,1,0,1,1,115,115,119,118,56
"4871",70,"[27]EjKiuHnKqGocIHcJCAHIEqBKtDy",228,0.995633,27,229,1,228,1,1,0,1,1,117,117,112,111,56
"4872",71,"[27]EjKiuHnKqGocIHcJCAHIEqBKtDy",231,0.99569,27,232,1,231,1,1,0,1,1,114,114,118,117,56
"4873",72,"[27]EjKiuHnKqGocIHcJCAHIEqBKtDy",244,0.995918,27,245,1,244,1,1,0,1,1,104,104,141,140,56
"4874",73,"[27]EjKiuHnKqGocIHcJCAHIEqBKtDy",227,0.995614,27,228,1,227,1,1,0,1,1,117,117,111,110,56
"4875",74,"[27]EjKiuHnKqGocIHcJCAHIEqBKtDy",223,0.995536,27,224,1,223,1,1,0,1,1,121,121,103,102,56
"4876",75,"[27]EjKiuHnKqGocIHcJCAHIEqBKtDy",242,0.995885,27,243,1,242,1,1,0,1,1,105,105,138,137,56
"4877",76,"[27]EjKiuHnKqGocIHcJCAHIEqBKtDy",214,0.995349,27,215,1,214,1,1,0,1,1,128,128,87,86,56
"4878",77,"[27]EjKiuHnKqGocIHcJCAHIEqBKtDy",236,0.995781,27,237,1,236,1,1,0,1,1,111,111,126,125,56
"4879",78,"[27]EjKiuHnKqGocIHcJCAHIEqBKtDy",227,0.995614,27,228,1,227,1,1,0,1,1,118,118,110,109,56
"4880",79,"[27]EjKiuHnKqGocIHcJCAHIEqBKtDy",237,0.995798,27,238,1,237,1,1,0,1,1,111,111,127,126,56
"4881",80,"[27]EjKiuHnKqGocIHcJCAHIEqBKtDy",232,0.995708,27,233,1,232,1,1,0,1,1,114,114,119,118,56
"4882",81,"[27]EjKiuHnKqGocIHcJCAHIEqBKtDy",217,0.995413,27,218,1,217,1,1,0,1,1,125,125,93,92,56
"4883",82,"[27]EjKiuHnKqGocIHcJCAHIEqBKtDy",234,0.995745,27,235,1,234,1,1,0,1,1,112,112,123,122,56
"4884",83,"[27]EjKiuHnKqGocIHcJCAHIEqBKtDy",232,0.995708,27,233,1,232,1,1,0,1,1,114,114,119,118,56
"4885",84,"[27]EjKiuHnKqGocIHcJCAHIEqBKtDy",230,0.995671,27,231,1,230,1,1,0,1,1,118,118,113,112,56
"4886",85,"[27]EjKiuHnKqGocIHcJCAHIEqBKtDy",230,0.995671,27,231,1,230,1,1,0,1,1,115,115,116,115,56
"4887",86,"[27]EjKiuHnKqGocIHcJCAHIEqBKtDy",234,0.995745,27,235,1,234,1,1,0,1,1,111,111,124,123,56
"4888",87,"[27]EjKiuHnKqGocIHcJCAHIEqBKtDy",240,0.995851,27,241,1,240,1,1,0,1,1,107,107,134,133,56
"4889",88,"[27]EjKiuHnKqGocIHcJCAHIEqBKtDy",230,0.995671,27,231,1,230,1,1,0,1,1,116,116,115,114,56
"4890",89,"[27]EjKiuHnKqGocIHcJCAHIEqBKtDy",237,0.995798,27,238,1,237,1,1,0,1,1,109,109,129,128,56
"4891",90,"[27]EjKiuHnKqGocIHcJCAHIEqBKtDy",222,0.995516,27,223,1,222,1,1,0,1,1,123,123,100,99,56
"4892",91,"[27]EjKiuHnKqGocIHcJCAHIEqBKtDy",221,0.995495,27,222,1,221,1,1,0,1,1,122,122,100,99,56
"4893",92,"[27]EjKiuHnKqGocIHcJCAHIEqBKtDy",223,0.995536,27,224,1,223,1,1,0,1,1,122,122,102,101,56
"4894",93,"[27]EjKiuHnKqGocIHcJCAHIEqBKtDy",225,0.995575,27,226,1,225,1,1,0,1,1,121,121,105,104,56
"4895",94,"[27]EjKiuHnKqGocIHcJCAHIEqBKtDy",234,0.995745,27,235,1,234,1,1,0,1,1,112,112,123,122,56
"4896",95,"[27]EjKiuHnKqGocIHcJCAHIEqBKtDy",234,0.995745,27,235,1,234,1,1,0,1,1,114,114,121,120,56
"4897",96,"[27]EjKiuHnKqGocIHcJCAHIEqBKtDy",240,0.995851,27,241,1,240,1,1,0,1,1,107,107,134,133,56
"4898",97,"[27]EjKiuHnKqGocIHcJCAHIEqBKtDy",228,0.995633,27,229,1,228,1,1,0,1,1,118,118,111,110,56
"4899",98,"[27]EjKiuHnKqGocIHcJCAHIEqBKtDy",228,0.995633,27,229,1,228,1,1,0,1,1,118,118,111,110,56
"4900",99,"[27]EjKiuHnKqGocIHcJCAHIEqBKtDy",231,0.99569,27,232,1,231,1,1,0,1,1,114,114,118,117,56
"4901",0,"[24]ErutHnKqGocIHBJCjkJrBdld",223,0.995536,24,224,1,223,1,1,0,1,1,121,121,103,102,57
"4902",1,"[24]ErutHnKqGocIHBJCjkJrBdld",237,0.995798,24,238,1,237,1,1,0,1,1,109,109,129,128,57
"4903",2,"[24]ErutHnKqGocIHBJCjkJrBdld",227,0.995614,24,228,1,227,1,1,0,1,1,120,120,108,107,57
"4904",3,"[24]ErutHnKqGocIHBJCjkJrBdld",230,0.995671,24,231,1,230,1,1,0,1,1,115,115,116,115,57
"4905",4,"[24]ErutHnKqGocIHBJCjkJrBdld",226,0.995595,24,227,1,226,1,1,0,1,1,120,120,107,106,57
"4906",5,"[24]ErutHnKqGocIHBJCjkJrBdld",232,0.995708,24,233,1,232,1,1,0,1,1,112,112,121,120,57
"4907",6,"[24]ErutHnKqGocIHBJCjkJrBdld",231,0.99569,24,232,1,231,1,1,0,1,1,114,114,118,117,57
"4908",7,"[24]ErutHnKqGocIHBJCjkJrBdld",237,0.995798,24,238,1,237,1,1,0,1,1,110,110,128,127,57
"4909",8,"[24]ErutHnKqGocIHBJCjkJrBdld",234,0.995745,24,235,1,234,1,1,0,1,1,113,113,122,121,57
"4910",9,"[24]ErutHnKqGocIHBJCjkJrBdld",227,0.995614,24,228,1,227,1,1,0,1,1,118,118,110,109,57
"4911",10,"[24]ErutHnKqGocIHBJCjkJrBdld",225,0.995575,24,226,1,225,1,1,0,1,1,118,118,108,107,57
"4912",11,"[24]ErutHnKqGocIHBJCjkJrBdld",237,0.995798,24,238,1,237,1,1,0,1,1,109,109,129,128,57
"4913",12,"[24]ErutHnKqGocIHBJCjkJrBdld",237,0.995798,24,238,1,237,1,1,0,1,1,108,108,130,129,57
"4914",13,"[24]ErutHnKqGocIHBJCjkJrBdld",223,0.995536,24,224,1,223,1,1,0,1,1,120,120,104,103,57
"4915",14,"[24]ErutHnKqGocIHBJCjkJrBdld",234,0.995745,24,235,1,234,1,1,0,1,1,111,111,124,123,57
"4916",15,"[24]ErutHnKqGocIHBJCjkJrBdld",237,0.995798,24,238,1,237,1,1,0,1,1,110,110,128,127,57
"4917",16,"[24]ErutHnKqGocIHBJCjkJrBdld",221,0.995495,24,222,1,221,1,1,0,1,1,122,122,100,99,57
"4918",17,"[24]ErutHnKqGocIHBJCjkJrBdld",228,0.995633,24,229,1,228,1,1,0,1,1,116,116,113,112,57
"4919",18,"[24]ErutHnKqGocIHBJCjkJrBdld",231,0.99569,24,232,1,231,1,1,0,1,1,115,115,117,116,57
"4920",19,"[24]ErutHnKqGocIHBJCjkJrBdld",228,0.995633,24,229,1,228,1,1,0,1,1,117,117,112,111,57
"4921",20,"[24]ErutHnKqGocIHBJCjkJrBdld",229,0.995652,24,230,1,229,1,1,0,1,1,116,116,114,113,57
"4922",21,"[24]ErutHnKqGocIHBJCjkJrBdld",232,0.995708,24,233,1,232,1,1,0,1,1,112,112,121,120,57
"4923",22,"[24]ErutHnKqGocIHBJCjkJrBdld",229,0.995652,24,230,1,229,1,1,0,1,1,115,115,115,114,57
"4924",23,"[24]ErutHnKqGocIHBJCjkJrBdld",232,0.995708,24,233,1,232,1,1,0,1,1,113,113,120,119,57
"4925",24,"[24]ErutHnKqGocIHBJCjkJrBdld",229,0.995652,24,230,1,229,1,1,0,1,1,116,116,114,113,57
"4926",25,"[24]ErutHnKqGocIHBJCjkJrBdld",229,0.995652,24,230,1,229,1,1,0,1,1,115,115,115,114,57
"4927",26,"[24]ErutHnKqGocIHBJCjkJrBdld",229,0.995652,24,230,1,229,1,1,0,1,1,119,119,111,110,57
"4928",27,"[24]ErutHnKqGocIHBJCjkJrBdld",237,0.995798,24,238,1,237,1,1,0,1,1,108,108,130,129,57
"4929",28,"[24]ErutHnKqGocIHBJCjkJrBdld",235,0.995763,24,236,1,235,1,1,0,1,1,111,111,125,124,57
"4930",29,"[24]ErutHnKqGocIHBJCjkJrBdld",231,0.99569,24,232,1,231,1,1,0,1,1,113,113,119,118,57
"4931",30,"[24]ErutHnKqGocIHBJCjkJrBdld",234,0.995745,24,235,1,234,1,1,0,1,1,112,112,123,122,57
"4932",31,"[24]ErutHnKqGocIHBJCjkJrBdld",224,0.995556,24,225,1,224,1,1,0,1,1,120,120,105,104,57
"4933",32,"[24]ErutHnKqGocIHBJCjkJrBdld",230,0.995671,24,231,1,230,1,1,0,1,1,118,118,113,112,57
"4934",33,"[24]ErutHnKqGocIHBJCjkJrBdld",229,0.995652,24,230,1,229,1,1,0,1,1,115,115,115,114,57
"4935",34,"[24]ErutHnKqGocIHBJCjkJrBdld",230,0.995671,24,231,1,230,1,1,0,1,1,116,116,115,114,57
"4936",35,"[24]ErutHnKqGocIHBJCjkJrBdld",227,0.995614,24,228,1,227,1,1,0,1,1,119,119,109,108,57
"4937",36,"[24]ErutHnKqGocIHBJCjkJrBdld",231,0.99569,24,232,1,231,1,1,0,1,1,115,115,117,116,57
"4938",37,"[24]ErutHnKqGocIHBJCjkJrBdld",230,0.995671,24,231,1,230,1,1,0,1,1,116,116,115,114,57
"4939",38,"[24]ErutHnKqGocIHBJCjkJrBdld",227,0.995614,24,228,1,227,1,1,0,1,1,116,116,112,111,57
"4940",39,"[24]ErutHnKqGocIHBJCjkJrBdld",230,0.995671,24,231,1,230,1,1,0,1,1,115,115,116,115,57
"4941",40,"[24]ErutHnKqGocIHBJCjkJrBdld",233,0.995726,24,234,1,233,1,1,0,1,1,112,112,122,121,57
"4942",41,"[24]ErutHnKqGocIHBJCjkJrBdld",240,0.995851,24,241,1,240,1,1,0,1,1,107,107,134,133,57
"4943",42,"[24]ErutHnKqGocIHBJCjkJrBdld",239,0.995833,24,240,1,239,1,1,0,1,1,108,108,132,131,57
"4944",43,"[24]ErutHnKqGocIHBJCjkJrBdld",222,0.995516,24,223,1,222,1,1,0,1,1,123,123,100,99,57
"4945",44,"[24]ErutHnKqGocIHBJCjkJrBdld",226,0.995595,24,227,1,226,1,1,0,1,1,118,118,109,108,57
"4946",45,"[24]ErutHnKqGocIHBJCjkJrBdld",222,0.995516,24,223,1,222,1,1,0,1,1,121,121,102,101,57
"4947",46,"[24]ErutHnKqGocIHBJCjkJrBdld",223,0.995536,24,224,1,223,1,1,0,1,1,122,122,102,101,57
"4948",47,"[24]ErutHnKqGocIHBJCjkJrBdld",232,0.995708,24,233,1,232,1,1,0,1,1,112,112,121,120,57
"4949",48,"[24]ErutHnKqGocIHBJCjkJrBdld",223,0.995536,24,224,1,223,1,1,0,1,1,122,122,102,101,57
"4950",49,"[24]ErutHnKqGocIHBJCjkJrBdld",221,0.995495,24,222,1,221,1,1,0,1,1,122,122,100,99,57
"4951",50,"[24]ErutHnKqGocIHBJCjkJrBdld",224,0.995556,24,225,1,224,1,1,0,1,1,119,119,106,105,57
"4952",51,"[24]ErutHnKqGocIHBJCjkJrBdld",226,0.995595,24,227,1,226,1,1,0,1,1,118,118,109,108,57
"4953",52,"[24]ErutHnKqGocIHBJCjkJrBdld",225,0.995575,24,226,1,225,1,1,0,1,1,119,119,107,106,57
"4954",53,"[24]ErutHnKqGocIHBJCjkJrBdld",230,0.995671,24,231,1,230,1,1,0,1,1,116,116,115,114,57
"4955",54,"[24]ErutHnKqGocIHBJCjkJrBdld",226,0.995595,24,227,1,226,1,1,0,1,1,118,118,109,108,57
"4956",55,"[24]ErutHnKqGocIHBJCjkJrBdld",235,0.995763,24,236,1,235,1,1,0,1,1,110,110,126,125,57
"4957",56,"[24]ErutHnKqGocIHBJCjkJrBdld",229,0.995652,24,230,1,229,1,1,0,1,1,115,115,115,114,57
"4958",57,"[24]ErutHnKqGocIHBJCjkJrBdld",231,0.99569,24,232,1,231,1,1,0,1,1,113,113,119,118,57
"4959",58,"[24]ErutHnKqGocIHBJCjkJrBdld",222,0.995516,24,223,1,222,1,1,0,1,1,122,122,101,100,57
"4960",59,"[24]ErutHnKqGocIHBJCjkJrBdld",227,0.995614,24,228,1,227,1,1,0,1,1,117,117,111,110,57
"4961",60,"[24]ErutHnKqGocIHBJCjkJrBdld",228,0.995633,24,229,1,228,1,1,0,1,1,116,116,113,112,57
"4962",61,"[24]ErutHnKqGocIHBJCjkJrBdld",231,0.99569,24,232,1,231,1,1,0,1,1,113,113,119,118,57
"4963",62,"[24]ErutHnKqGocIHBJCjkJrBdld",231,0.99569,24,232,1,231,1,1,0,1,1,115,115,117,116,57
"4964",63,"[24]ErutHnKqGocIHBJCjkJrBdld",232,0.995708,24,233,1,232,1,1,0,1,1,113,113,120,119,57
"4965",64,"[24]ErutHnKqGocIHBJCjkJrBdld",232,0.995708,24,233,1,232,1,1,0,1,1,115,115,118,117,57
"4966",65,"[24]ErutHnKqGocIHBJCjkJrBdld",224,0.995556,24,225,1,224,1,1,0,1,1,119,119,106,105,57
"4967",66,"[24]ErutHnKqGocIHBJCjkJrBdld",231,0.99569,24,232,1,231,1,1,0,1,1,113,113,119,118,57
"4968",67,"[24]ErutHnKqGocIHBJCjkJrBdld",224,0.995556,24,225,1,224,1,1,0,1,1,119,119,106,105,57
"4969",68,"[24]ErutHnKqGocIHBJCjkJrBdld",229,0.995652,24,230,1,229,1,1,0,1,1,115,115,115,114,57
"4970",69,"[24]ErutHnKqGocIHBJCjkJrBdld",236,0.995781,24,237,1,236,1,1,0,1,1,110,110,127,126,57
"4971",70,"[24]ErutHnKqGocIHBJCjkJrBdld",219,0.995455,24,220,1,219,1,1,0,1,1,124,124,96,95,57
"4972",71,"[24]ErutHnKqGocIHBJCjkJrBdld",242,0.995885,24,243,1,242,1,1,0,1,1,104,104,139,138,57
"4973",72,"[24]ErutHnKqGocIHBJCjkJrBdld",236,0.995781,24,237,1,236,1,1,0,1,1,111,111,126,125,57
"4974",73,"[24]ErutHnKqGocIHBJCjkJrBdld",238,0.995816,24,239,1,238,1,1,0,1,1,108,108,131,130,57
"4975",74,"[24]ErutHnKqGocIHBJCjkJrBdld",225,0.995575,24,226,1,225,1,1,0,1,1,119,119,107,106,57
"4976",75,"[24]ErutHnKqGocIHBJCjkJrBdld",238,0.995816,24,239,1,238,1,1,0,1,1,108,108,131,130,57
"4977",76,"[24]ErutHnKqGocIHBJCjkJrBdld",225,0.995575,24,226,1,225,1,1,0,1,1,120,120,106,105,57
"4978",77,"[24]ErutHnKqGocIHBJCjkJrBdld",230,0.995671,24,231,1,230,1,1,0,1,1,117,117,114,113,57
"4979",78,"[24]ErutHnKqGocIHBJCjkJrBdld",229,0.995652,24,230,1,229,1,1,0,1,1,115,115,115,114,57
"4980",79,"[24]ErutHnKqGocIHBJCjkJrBdld",232,0.995708,24,233,1,232,1,1,0,1,1,115,115,118,117,57
"4981",80,"[24]ErutHnKqGocIHBJCjkJrBdld",230,0.995671,24,231,1,230,1,1,0,1,1,116,116,115,114,57
"4982",81,"[24]ErutHnKqGocIHBJCjkJrBdld",225,0.995575,24,226,1,225,1,1,0,1,1,118,118,108,107,57
"4983",82,"[24]ErutHnKqGocIHBJCjkJrBdld",241,0.995868,24,242,1,241,1,1,0,1,1,108,108,134,133,57
"4984",83,"[24]ErutHnKqGocIHBJCjkJrBdld",226,0.995595,24,227,1,226,1,1,0,1,1,118,118,109,108,57
"4985",84,"[24]ErutHnKqGocIHBJCjkJrBdld",239,0.995833,24,240,1,239,1,1,0,1,1,107,107,133,132,57
"4986",85,"[24]ErutHnKqGocIHBJCjkJrBdld",228,0.995633,24,229,1,228,1,1,0,1,1,116,116,113,112,57
"4987",86,"[24]ErutHnKqGocIHBJCjkJrBdld",221,0.995495,24,222,1,221,1,1,0,1,1,121,121,101,100,57
"4988",87,"[24]ErutHnKqGocIHBJCjkJrBdld",231,0.99569,24,232,1,231,1,1,0,1,1,116,116,116,115,57
"4989",88,"[24]ErutHnKqGocIHBJCjkJrBdld",228,0.995633,24,229,1,228,1,1,0,1,1,117,117,112,111,57
"4990",89,"[24]ErutHnKqGocIHBJCjkJrBdld",228,0.995633,24,229,1,228,1,1,0,1,1,116,116,113,112,57
"4991",90,"[24]ErutHnKqGocIHBJCjkJrBdld",227,0.995614,24,228,1,227,1,1,0,1,1,118,118,110,109,57
"4992",91,"[24]ErutHnKqGocIHBJCjkJrBdld",232,0.995708,24,233,1,232,1,1,0,1,1,113,113,120,119,57
"4993",92,"[24]ErutHnKqGocIHBJCjkJrBdld",230,0.995671,24,231,1,230,1,1,0,1,1,115,115,116,115,57
"4994",93,"[24]ErutHnKqGocIHBJCjkJrBdld",227,0.995614,24,228,1,227,1,1,0,1,1,117,117,111,110,57
"4995",94,"[24]ErutHnKqGocIHBJCjkJrBdld",242,0.995885,24,243,1,242,1,1,0,1,1,108,108,135,134,57
"4996",95,"[24]ErutHnKqGocIHBJCjkJrBdld",225,0.995575,24,226,1,225,1,1,0,1,1,118,118,108,107,57
"4997",96,"[24]ErutHnKqGocIHBJCjkJrBdld",223,0.995536,24,224,1,223,1,1,0,1,1,120,120,104,103,57
"4998",97,"[24]ErutHnKqGocIHBJCjkJrBdld",234,0.995745,24,235,1,234,1,1,0,1,1,111,111,124,123,57
"4999",98,"[24]ErutHnKqGocIHBJCjkJrBdld",226,0.995595,24,227,1,226,1,1,0,1,1,119,119,108,107,57
"5000",99,"[24]ErutHnKqGocIHBJCjkJrBdld",222,0.995516,24,223,1,222,1,1,0,1,1,121,121,102,101,57
"5001",0,"[24]EnvHnKqGocIHBJCssvwyHxKC",241,0.995868,24,242,1,241,1,1,0,1,1,113,113,129,128,59
"5002",1,"[24]EnvHnKqGocIHBJCssvwyHxKC",242,0.995885,24,243,1,242,1,1,0,1,1,106,106,137,136,59
"5003",2,"[24]EnvHnKqGocIHBJCssvwyHxKC",232,0.995708,24,233,1,232,1,1,0,1,1,113,113,120,119,59
"5004",3,"[24]EnvHnKqGocIHBJCssvwyHxKC",229,0.995652,24,230,1,229,1,1,0,1,1,115,115,115,114,59
"5005",4,"[24]EnvHnKqGocIHBJCssvwyHxKC",230,0.995671,24,231,1,230,1,1,0,1,1,116,116,115,114,59
"5006",5,"[24]EnvHnKqGocIHBJCssvwyHxKC",232,0.995708,24,233,1,232,1,1,0,1,1,114,114,119,118,59
"5007",6,"[24]EnvHnKqGocIHBJCssvwyHxKC",237,0.995798,24,238,1,237,1,1,0,1,1,111,111,127,126,59
"5008",7,"[24]EnvHnKqGocIHBJCssvwyHxKC",230,0.995671,24,231,1,230,1,1,0,1,1,117,117,114,113,59
"5009",8,"[24]EnvHnKqGocIHBJCssvwyHxKC",226,0.995595,24,227,1,226,1,1,0,1,1,119,119,108,107,59
"5010",9,"[24]EnvHnKqGocIHBJCssvwyHxKC",221,0.995495,24,222,1,221,1,1,0,1,1,122,122,100,99,59
"5011",10,"[24]EnvHnKqGocIHBJCssvwyHxKC",224,0.995556,24,225,1,224,1,1,0,1,1,122,122,103,102,59
"5012",11,"[24]EnvHnKqGocIHBJCssvwyHxKC",234,0.995745,24,235,1,234,1,1,0,1,1,111,111,124,123,59
"5013",12,"[24]EnvHnKqGocIHBJCssvwyHxKC",238,0.995816,24,239,1,238,1,1,0,1,1,109,109,130,129,59
"5014",13,"[24]EnvHnKqGocIHBJCssvwyHxKC",236,0.995781,24,237,1,236,1,1,0,1,1,109,109,128,127,59
"5015",14,"[24]EnvHnKqGocIHBJCssvwyHxKC",237,0.995798,24,238,1,237,1,1,0,1,1,114,114,124,123,59
"5016",15,"[24]EnvHnKqGocIHBJCssvwyHxKC",232,0.995708,24,233,1,232,1,1,0,1,1,113,113,120,119,59
"5017",16,"[24]EnvHnKqGocIHBJCssvwyHxKC",236,0.995781,24,237,1,236,1,1,0,1,1,110,110,127,126,59
"5018",17,"[24]EnvHnKqGocIHBJCssvwyHxKC",241,0.995868,24,242,1,241,1,1,0,1,1,105,105,137,136,59
"5019",18,"[24]EnvHnKqGocIHBJCssvwyHxKC",234,0.995745,24,235,1,234,1,1,0,1,1,111,111,124,123,59
"5020",19,"[24]EnvHnKqGocIHBJCssvwyHxKC",232,0.995708,24,233,1,232,1,1,0,1,1,113,113,120,119,59
"5021",20,"[24]EnvHnKqGocIHBJCssvwyHxKC",221,0.995495,24,222,1,221,1,1,0,1,1,122,122,100,99,59
"5022",21,"[24]EnvHnKqGocIHBJCssvwyHxKC",234,0.995745,24,235,1,234,1,1,0,1,1,113,113,122,121,59
"5023",22,"[24]EnvHnKqGocIHBJCssvwyHxKC",229,0.995652,24,230,1,229,1,1,0,1,1,115,115,115,114,59
"5024",23,"[24]EnvHnKqGocIHBJCssvwyHxKC",231,0.99569,24,232,1,231,1,1,0,1,1,113,113,119,118,59
"5025",24,"[24]EnvHnKqGocIHBJCssvwyHxKC",234,0.995745,24,235,1,234,1,1,0,1,1,112,112,123,122,59
"5026",25,"[24]EnvHnKqGocIHBJCssvwyHxKC",225,0.995575,24,226,1,225,1,1,0,1,1,119,119,107,106,59
"5027",26,"[24]EnvHnKqGocIHBJCssvwyHxKC",232,0.995708,24,233,1,232,1,1,0,1,1,113,113,120,119,59
"5028",27,"[24]EnvHnKqGocIHBJCssvwyHxKC",233,0.995726,24,234,1,233,1,1,0,1,1,113,113,121,120,59
"5029",28,"[24]EnvHnKqGocIHBJCssvwyHxKC",233,0.995726,24,234,1,233,1,1,0,1,1,112,112,122,121,59
"5030",29,"[24]EnvHnKqGocIHBJCssvwyHxKC",240,0.995851,24,241,1,240,1,1,0,1,1,107,107,134,133,59
"5031",30,"[24]EnvHnKqGocIHBJCssvwyHxKC",234,0.995745,24,235,1,234,1,1,0,1,1,111,111,124,123,59
"5032",31,"[24]EnvHnKqGocIHBJCssvwyHxKC",232,0.995708,24,233,1,232,1,1,0,1,1,115,115,118,117,59
"5033",32,"[24]EnvHnKqGocIHBJCssvwyHxKC",239,0.995833,24,240,1,239,1,1,0,1,1,109,109,131,130,59
"5034",33,"[24]EnvHnKqGocIHBJCssvwyHxKC",229,0.995652,24,230,1,229,1,1,0,1,1,115,115,115,114,59
"5035",34,"[24]EnvHnKqGocIHBJCssvwyHxKC",228,0.995633,24,229,1,228,1,1,0,1,1,117,117,112,111,59
"5036",35,"[24]EnvHnKqGocIHBJCssvwyHxKC",231,0.99569,24,232,1,231,1,1,0,1,1,113,113,119,118,59
"5037",36,"[24]EnvHnKqGocIHBJCssvwyHxKC",229,0.995652,24,230,1,229,1,1,0,1,1,116,116,114,113,59
"5038",37,"[24]EnvHnKqGocIHBJCssvwyHxKC",240,0.995851,24,241,1,240,1,1,0,1,1,108,108,133,132,59
"5039",38,"[24]EnvHnKqGocIHBJCssvwyHxKC",234,0.995745,24,235,1,234,1,1,0,1,1,112,112,123,122,59
"5040",39,"[24]EnvHnKqGocIHBJCssvwyHxKC",229,0.995652,24,230,1,229,1,1,0,1,1,115,115,115,114,59
"5041",40,"[24]EnvHnKqGocIHBJCssvwyHxKC",247,0.995968,24,248,1,247,1,1,0,1,1,101,101,147,146,59
"5042",41,"[24]EnvHnKqGocIHBJCssvwyHxKC",220,0.995475,24,221,1,220,1,1,0,1,1,122,122,99,98,59
"5043",42,"[24]EnvHnKqGocIHBJCssvwyHxKC",234,0.995745,24,235,1,234,1,1,0,1,1,112,112,123,122,59
"5044",43,"[24]EnvHnKqGocIHBJCssvwyHxKC",222,0.995516,24,223,1,222,1,1,0,1,1,122,122,101,100,59
"5045",44,"[24]EnvHnKqGocIHBJCssvwyHxKC",238,0.995816,24,239,1,238,1,1,0,1,1,112,112,127,126,59
"5046",45,"[24]EnvHnKqGocIHBJCssvwyHxKC",228,0.995633,24,229,1,228,1,1,0,1,1,116,116,113,112,59
"5047",46,"[24]EnvHnKqGocIHBJCssvwyHxKC",221,0.995495,24,222,1,221,1,1,0,1,1,121,121,101,100,59
"5048",47,"[24]EnvHnKqGocIHBJCssvwyHxKC",235,0.995763,24,236,1,235,1,1,0,1,1,112,112,124,123,59
"5049",48,"[24]EnvHnKqGocIHBJCssvwyHxKC",236,0.995781,24,237,1,236,1,1,0,1,1,113,113,124,123,59
"5050",49,"[24]EnvHnKqGocIHBJCssvwyHxKC",221,0.995495,24,222,1,221,1,1,0,1,1,122,122,100,99,59
"5051",50,"[24]EnvHnKqGocIHBJCssvwyHxKC",223,0.995536,24,224,1,223,1,1,0,1,1,120,120,104,103,59
"5052",51,"[24]EnvHnKqGocIHBJCssvwyHxKC",228,0.995633,24,229,1,228,1,1,0,1,1,116,116,113,112,59
"5053",52,"[24]EnvHnKqGocIHBJCssvwyHxKC",233,0.995726,24,234,1,233,1,1,0,1,1,113,113,121,120,59
"5054",53,"[24]EnvHnKqGocIHBJCssvwyHxKC",219,0.995455,24,220,1,219,1,1,0,1,1,123,123,97,96,59
"5055",54,"[24]EnvHnKqGocIHBJCssvwyHxKC",221,0.995495,24,222,1,221,1,1,0,1,1,121,121,101,100,59
"5056",55,"[24]EnvHnKqGocIHBJCssvwyHxKC",236,0.995781,24,237,1,236,1,1,0,1,1,109,109,128,127,59
"5057",56,"[24]EnvHnKqGocIHBJCssvwyHxKC",230,0.995671,24,231,1,230,1,1,0,1,1,114,114,117,116,59
"5058",57,"[24]EnvHnKqGocIHBJCssvwyHxKC",225,0.995575,24,226,1,225,1,1,0,1,1,118,118,108,107,59
"5059",58,"[24]EnvHnKqGocIHBJCssvwyHxKC",238,0.995816,24,239,1,238,1,1,0,1,1,111,111,128,127,59
"5060",59,"[24]EnvHnKqGocIHBJCssvwyHxKC",231,0.99569,24,232,1,231,1,1,0,1,1,113,113,119,118,59
"5061",60,"[24]EnvHnKqGocIHBJCssvwyHxKC",221,0.995495,24,222,1,221,1,1,0,1,1,122,122,100,99,59
"5062",61,"[24]EnvHnKqGocIHBJCssvwyHxKC",233,0.995726,24,234,1,233,1,1,0,1,1,113,113,121,120,59
"5063",62,"[24]EnvHnKqGocIHBJCssvwyHxKC",230,0.995671,24,231,1,230,1,1,0,1,1,117,117,114,113,59
"5064",63,"[24]EnvHnKqGocIHBJCssvwyHxKC",224,0.995556,24,225,1,224,1,1,0,1,1,119,119,106,105,59
"5065",64,"[24]EnvHnKqGocIHBJCssvwyHxKC",236,0.995781,24,237,1,236,1,1,0,1,1,111,111,126,125,59
"5066",65,"[24]EnvHnKqGocIHBJCssvwyHxKC",236,0.995781,24,237,1,236,1,1,0,1,1,109,109,128,127,59
"5067",66,"[24]EnvHnKqGocIHBJCssvwyHxKC",219,0.995455,24,220,1,219,1,1,0,1,1,123,123,97,96,59
"5068",67,"[24]EnvHnKqGocIHBJCssvwyHxKC",228,0.995633,24,229,1,228,1,1,0,1,1,117,117,112,111,59
"5069",68,"[24]EnvHnKqGocIHBJCssvwyHxKC",237,0.995798,24,238,1,237,1,1,0,1,1,109,109,129,128,59
"5070",69,"[24]EnvHnKqGocIHBJCssvwyHxKC",225,0.995575,24,226,1,225,1,1,0,1,1,118,118,108,107,59
"5071",70,"[24]EnvHnKqGocIHBJCssvwyHxKC",232,0.995708,24,233,1,232,1,1,0,1,1,113,113,120,119,59
"5072",71,"[24]EnvHnKqGocIHBJCssvwyHxKC",231,0.99569,24,232,1,231,1,1,0,1,1,113,113,119,118,59
"5073",72,"[24]EnvHnKqGocIHBJCssvwyHxKC",236,0.995781,24,237,1,236,1,1,0,1,1,111,111,126,125,59
"5074",73,"[24]EnvHnKqGocIHBJCssvwyHxKC",231,0.99569,24,232,1,231,1,1,0,1,1,114,114,118,117,59
"5075",74,"[24]EnvHnKqGocIHBJCssvwyHxKC",227,0.995614,24,228,1,227,1,1,0,1,1,118,118,110,109,59
"5076",75,"[24]EnvHnKqGocIHBJCssvwyHxKC",226,0.995595,24,227,1,226,1,1,0,1,1,118,118,109,108,59
"5077",76,"[24]EnvHnKqGocIHBJCssvwyHxKC",240,0.995851,24,241,1,240,1,1,0,1,1,110,110,131,130,59
"5078",77,"[24]EnvHnKqGocIHBJCssvwyHxKC",224,0.995556,24,225,1,224,1,1,0,1,1,120,120,105,104,59
"5079",78,"[24]EnvHnKqGocIHBJCssvwyHxKC",222,0.995516,24,223,1,222,1,1,0,1,1,121,121,102,101,59
"5080",79,"[24]EnvHnKqGocIHBJCssvwyHxKC",218,0.995434,24,219,1,218,1,1,0,1,1,124,124,95,94,59
"5081",80,"[24]EnvHnKqGocIHBJCssvwyHxKC",236,0.995781,24,237,1,236,1,1,0,1,1,111,111,126,125,59
"5082",81,"[24]EnvHnKqGocIHBJCssvwyHxKC",225,0.995575,24,226,1,225,1,1,0,1,1,119,119,107,106,59
"5083",82,"[24]EnvHnKqGocIHBJCssvwyHxKC",233,0.995726,24,234,1,233,1,1,0,1,1,113,113,121,120,59
"5084",83,"[24]EnvHnKqGocIHBJCssvwyHxKC",234,0.995745,24,235,1,234,1,1,0,1,1,114,114,121,120,59
"5085",84,"[24]EnvHnKqGocIHBJCssvwyHxKC",235,0.995763,24,236,1,235,1,1,0,1,1,115,115,121,120,59
"5086",85,"[24]EnvHnKqGocIHBJCssvwyHxKC",242,0.995885,24,243,1,242,1,1,0,1,1,106,106,137,136,59
"5087",86,"[24]EnvHnKqGocIHBJCssvwyHxKC",230,0.995671,24,231,1,230,1,1,0,1,1,115,115,116,115,59
"5088",87,"[24]EnvHnKqGocIHBJCssvwyHxKC",237,0.995798,24,238,1,237,1,1,0,1,1,110,110,128,127,59
"5089",88,"[24]EnvHnKqGocIHBJCssvwyHxKC",227,0.995614,24,228,1,227,1,1,0,1,1,117,117,111,110,59
"5090",89,"[24]EnvHnKqGocIHBJCssvwyHxKC",232,0.995708,24,233,1,232,1,1,0,1,1,113,113,120,119,59
"5091",90,"[24]EnvHnKqGocIHBJCssvwyHxKC",231,0.99569,24,232,1,231,1,1,0,1,1,113,113,119,118,59
"5092",91,"[24]EnvHnKqGocIHBJCssvwyHxKC",225,0.995575,24,226,1,225,1,1,0,1,1,119,119,107,106,59
"5093",92,"[24]EnvHnKqGocIHBJCssvwyHxKC",229,0.995652,24,230,1,229,1,1,0,1,1,116,116,114,113,59
"5094",93,"[24]EnvHnKqGocIHBJCssvwyHxKC",227,0.995614,24,228,1,227,1,1,0,1,1,117,117,111,110,59
"5095",94,"[24]EnvHnKqGocIHBJCssvwyHxKC",220,0.995475,24,221,1,220,1,1,0,1,1,122,122,99,98,59
"5096",95,"[24]EnvHnKqGocIHBJCssvwyHxKC",234,0.995745,24,235,1,234,1,1,0,1,1,113,113,122,121,59
"5097",96,"[24]EnvHnKqGocIHBJCssvwyHxKC",243,0.995902,24,244,1,243,1,1,0,1,1,105,105,139,138,59
"5098",97,"[24]EnvHnKqGocIHBJCssvwyHxKC",235,0.995763,24,236,1,235,1,1,0,1,1,111,111,125,124,59
"5099",98,"[24]EnvHnKqGocIHBJCssvwyHxKC",230,0.995671,24,231,1,230,1,1,0,1,1,114,114,117,116,59
"5100",99,"[24]EnvHnKqGocIHBJCssvwyHxKC",226,0.995595,24,227,1,226,1,1,0,1,1,118,118,109,108,59
"5101",0,"[28]EyhKxHnKqGocIHBJCCpECGjfgogx",230,0.995671,28,231,1,230,1,1,0,1,1,115,115,116,115,60
"5102",1,"[28]EyhKxHnKqGocIHBJCCpECGjfgogx",232,0.995708,28,233,1,232,1,1,0,1,1,114,114,119,118,60
"5103",2,"[28]EyhKxHnKqGocIHBJCCpECGjfgogx",231,0.99569,28,232,1,231,1,1,0,1,1,114,114,118,117,60
"5104",3,"[28]EyhKxHnKqGocIHBJCCpECGjfgogx",243,0.995902,28,244,1,243,1,1,0,1,1,105,105,139,138,60
"5105",4,"[28]EyhKxHnKqGocIHBJCCpECGjfgogx",234,0.995745,28,235,1,234,1,1,0,1,1,111,111,124,123,60
"5106",5,"[28]EyhKxHnKqGocIHBJCCpECGjfgogx",235,0.995763,28,236,1,235,1,1,0,1,1,111,111,125,124,60
"5107",6,"[28]EyhKxHnKqGocIHBJCCpECGjfgogx",232,0.995708,28,233,1,232,1,1,0,1,1,114,114,119,118,60
"5108",7,"[28]EyhKxHnKqGocIHBJCCpECGjfgogx",233,0.995726,28,234,1,233,1,1,0,1,1,112,112,122,121,60
"5109",8,"[28]EyhKxHnKqGocIHBJCCpECGjfgogx",235,0.995763,28,236,1,235,1,1,0,1,1,112,112,124,123,60
"5110",9,"[28]EyhKxHnKqGocIHBJCCpECGjfgogx",227,0.995614,28,228,1,227,1,1,0,1,1,117,117,111,110,60
"5111",10,"[28]EyhKxHnKqGocIHBJCCpECGjfgogx",225,0.995575,28,226,1,225,1,1,0,1,1,120,120,106,105,60
"5112",11,"[28]EyhKxHnKqGocIHBJCCpECGjfgogx",228,0.995633,28,229,1,228,1,1,0,1,1,116,116,113,112,60
"5113",12,"[28]EyhKxHnKqGocIHBJCCpECGjfgogx",236,0.995781,28,237,1,236,1,1,0,1,1,110,110,127,126,60
"5114",13,"[28]EyhKxHnKqGocIHBJCCpECGjfgogx",235,0.995763,28,236,1,235,1,1,0,1,1,113,113,123,122,60
"5115",14,"[28]EyhKxHnKqGocIHBJCCpECGjfgogx",235,0.995763,28,236,1,235,1,1,0,1,1,112,112,124,123,60
"5116",15,"[28]EyhKxHnKqGocIHBJCCpECGjfgogx",239,0.995833,28,240,1,239,1,1,0,1,1,107,107,133,132,60
"5117",16,"[28]EyhKxHnKqGocIHBJCCpECGjfgogx",238,0.995816,28,239,1,238,1,1,0,1,1,110,110,129,128,60
"5118",17,"[28]EyhKxHnKqGocIHBJCCpECGjfgogx",221,0.995495,28,222,1,221,1,1,0,1,1,122,122,100,99,60
"5119",18,"[28]EyhKxHnKqGocIHBJCCpECGjfgogx",234,0.995745,28,235,1,234,1,1,0,1,1,112,112,123,122,60
"5120",19,"[28]EyhKxHnKqGocIHBJCCpECGjfgogx",239,0.995833,28,240,1,239,1,1,0,1,1,107,107,133,132,60
"5121",20,"[28]EyhKxHnKqGocIHBJCCpECGjfgogx",236,0.995781,28,237,1,236,1,1,0,1,1,110,110,127,126,60
"5122",21,"[28]EyhKxHnKqGocIHBJCCpECGjfgogx",232,0.995708,28,233,1,232,1,1,0,1,1,114,114,119,118,60
"5123",22,"[28]EyhKxHnKqGocIHBJCCpECGjfgogx",226,0.995595,28,227,1,226,1,1,0,1,1,119,119,108,107,60
"5124",23,"[28]EyhKxHnKqGocIHBJCCpECGjfgogx",235,0.995763,28,236,1,235,1,1,0,1,1,111,111,125,124,60
"5125",24,"[28]EyhKxHnKqGocIHBJCCpECGjfgogx",228,0.995633,28,229,1,228,1,1,0,1,1,116,116,113,112,60
"5126",25,"[28]EyhKxHnKqGocIHBJCCpECGjfgogx",233,0.995726,28,234,1,233,1,1,0,1,1,112,112,122,121,60
"5127",26,"[28]EyhKxHnKqGocIHBJCCpECGjfgogx",238,0.995816,28,239,1,238,1,1,0,1,1,110,110,129,128,60
"5128",27,"[28]EyhKxHnKqGocIHBJCCpECGjfgogx",227,0.995614,28,228,1,227,1,1,0,1,1,117,117,111,110,60
"5129",28,"[28]EyhKxHnKqGocIHBJCCpECGjfgogx",231,0.99569,28,232,1,231,1,1,0,1,1,114,114,118,117,60
"5130",29,"[28]EyhKxHnKqGocIHBJCCpECGjfgogx",233,0.995726,28,234,1,233,1,1,0,1,1,113,113,121,120,60
"5131",30,"[28]EyhKxHnKqGocIHBJCCpECGjfgogx",240,0.995851,28,241,1,240,1,1,0,1,1,112,112,129,128,60
"5132",31,"[28]EyhKxHnKqGocIHBJCCpECGjfgogx",233,0.995726,28,234,1,233,1,1,0,1,1,112,112,122,121,60
"5133",32,"[28]EyhKxHnKqGocIHBJCCpECGjfgogx",229,0.995652,28,230,1,229,1,1,0,1,1,117,117,113,112,60
"5134",33,"[28]EyhKxHnKqGocIHBJCCpECGjfgogx",230,0.995671,28,231,1,230,1,1,0,1,1,117,117,114,113,60
"5135",34,"[28]EyhKxHnKqGocIHBJCCpECGjfgogx",222,0.995516,28,223,1,222,1,1,0,1,1,122,122,101,100,60
"5136",35,"[28]EyhKxHnKqGocIHBJCCpECGjfgogx",233,0.995726,28,234,1,233,1,1,0,1,1,114,114,120,119,60
"5137",36,"[28]EyhKxHnKqGocIHBJCCpECGjfgogx",228,0.995633,28,229,1,228,1,1,0,1,1,119,119,110,109,60
"5138",37,"[28]EyhKxHnKqGocIHBJCCpECGjfgogx",246,0.995951,28,247,1,246,1,1,0,1,1,105,105,142,141,60
"5139",38,"[28]EyhKxHnKqGocIHBJCCpECGjfgogx",224,0.995556,28,225,1,224,1,1,0,1,1,119,119,106,105,60
"5140",39,"[28]EyhKxHnKqGocIHBJCCpECGjfgogx",230,0.995671,28,231,1,230,1,1,0,1,1,115,115,116,115,60
"5141",40,"[28]EyhKxHnKqGocIHBJCCpECGjfgogx",228,0.995633,28,229,1,228,1,1,0,1,1,117,117,112,111,60
"5142",41,"[28]EyhKxHnKqGocIHBJCCpECGjfgogx",231,0.99569,28,232,1,231,1,1,0,1,1,116,116,116,115,60
"5143",42,"[28]EyhKxHnKqGocIHBJCCpECGjfgogx",229,0.995652,28,230,1,229,1,1,0,1,1,116,116,114,113,60
"5144",43,"[28]EyhKxHnKqGocIHBJCCpECGjfgogx",239,0.995833,28,240,1,239,1,1,0,1,1,111,111,129,128,60
"5145",44,"[28]EyhKxHnKqGocIHBJCCpECGjfgogx",226,0.995595,28,227,1,226,1,1,0,1,1,118,118,109,108,60
"5146",45,"[28]EyhKxHnKqGocIHBJCCpECGjfgogx",226,0.995595,28,227,1,226,1,1,0,1,1,118,118,109,108,60
"5147",46,"[28]EyhKxHnKqGocIHBJCCpECGjfgogx",236,0.995781,28,237,1,236,1,1,0,1,1,111,111,126,125,60
"5148",47,"[28]EyhKxHnKqGocIHBJCCpECGjfgogx",224,0.995556,28,225,1,224,1,1,0,1,1,121,121,104,103,60
"5149",48,"[28]EyhKxHnKqGocIHBJCCpECGjfgogx",232,0.995708,28,233,1,232,1,1,0,1,1,113,113,120,119,60
"5150",49,"[28]EyhKxHnKqGocIHBJCCpECGjfgogx",224,0.995556,28,225,1,224,1,1,0,1,1,119,119,106,105,60
"5151",50,"[28]EyhKxHnKqGocIHBJCCpECGjfgogx",232,0.995708,28,233,1,232,1,1,0,1,1,114,114,119,118,60
"5152",51,"[28]EyhKxHnKqGocIHBJCCpECGjfgogx",232,0.995708,28,233,1,232,1,1,0,1,1,113,113,120,119,60
"5153",52,"[28]EyhKxHnKqGocIHBJCCpECGjfgogx",242,0.995885,28,243,1,242,1,1,0,1,1,106,106,137,136,60
"5154",53,"[28]EyhKxHnKqGocIHBJCCpECGjfgogx",234,0.995745,28,235,1,234,1,1,0,1,1,112,112,123,122,60
"5155",54,"[28]EyhKxHnKqGocIHBJCCpECGjfgogx",223,0.995536,28,224,1,223,1,1,0,1,1,122,122,102,101,60
"5156",55,"[28]EyhKxHnKqGocIHBJCCpECGjfgogx",222,0.995516,28,223,1,222,1,1,0,1,1,122,122,101,100,60
"5157",56,"[28]EyhKxHnKqGocIHBJCCpECGjfgogx",240,0.995851,28,241,1,240,1,1,0,1,1,107,107,134,133,60
"5158",57,"[28]EyhKxHnKqGocIHBJCCpECGjfgogx",234,0.995745,28,235,1,234,1,1,0,1,1,111,111,124,123,60
"5159",58,"[28]EyhKxHnKqGocIHBJCCpECGjfgogx",230,0.995671,28,231,1,230,1,1,0,1,1,115,115,116,115,60
"5160",59,"[28]EyhKxHnKqGocIHBJCCpECGjfgogx",237,0.995798,28,238,1,237,1,1,0,1,1,109,109,129,128,60
"5161",60,"[28]EyhKxHnKqGocIHBJCCpECGjfgogx",217,0.995413,28,218,1,217,1,1,0,1,1,125,125,93,92,60
"5162",61,"[28]EyhKxHnKqGocIHBJCCpECGjfgogx",227,0.995614,28,228,1,227,1,1,0,1,1,121,121,107,106,60
"5163",62,"[28]EyhKxHnKqGocIHBJCCpECGjfgogx",231,0.99569,28,232,1,231,1,1,0,1,1,116,116,116,115,60
"5164",63,"[28]EyhKxHnKqGocIHBJCCpECGjfgogx",232,0.995708,28,233,1,232,1,1,0,1,1,113,113,120,119,60
"5165",64,"[28]EyhKxHnKqGocIHBJCCpECGjfgogx",221,0.995495,28,222,1,221,1,1,0,1,1,123,123,99,98,60
"5166",65,"[28]EyhKxHnKqGocIHBJCCpECGjfgogx",224,0.995556,28,225,1,224,1,1,0,1,1,121,121,104,103,60
"5167",66,"[28]EyhKxHnKqGocIHBJCCpECGjfgogx",227,0.995614,28,228,1,227,1,1,0,1,1,118,118,110,109,60
"5168",67,"[28]EyhKxHnKqGocIHBJCCpECGjfgogx",217,0.995413,28,218,1,217,1,1,0,1,1,125,125,93,92,60
"5169",68,"[28]EyhKxHnKqGocIHBJCCpECGjfgogx",244,0.995918,28,245,1,244,1,1,0,1,1,105,105,140,139,60
"5170",69,"[28]EyhKxHnKqGocIHBJCCpECGjfgogx",235,0.995763,28,236,1,235,1,1,0,1,1,111,111,125,124,60
"5171",70,"[28]EyhKxHnKqGocIHBJCCpECGjfgogx",232,0.995708,28,233,1,232,1,1,0,1,1,114,114,119,118,60
"5172",71,"[28]EyhKxHnKqGocIHBJCCpECGjfgogx",229,0.995652,28,230,1,229,1,1,0,1,1,118,118,112,111,60
"5173",72,"[28]EyhKxHnKqGocIHBJCCpECGjfgogx",223,0.995536,28,224,1,223,1,1,0,1,1,121,121,103,102,60
"5174",73,"[28]EyhKxHnKqGocIHBJCCpECGjfgogx",244,0.995918,28,245,1,244,1,1,0,1,1,104,104,141,140,60
"5175",74,"[28]EyhKxHnKqGocIHBJCCpECGjfgogx",223,0.995536,28,224,1,223,1,1,0,1,1,120,120,104,103,60
"5176",75,"[28]EyhKxHnKqGocIHBJCCpECGjfgogx",234,0.995745,28,235,1,234,1,1,0,1,1,112,112,123,122,60
"5177",76,"[28]EyhKxHnKqGocIHBJCCpECGjfgogx",239,0.995833,28,240,1,239,1,1,0,1,1,109,109,131,130,60
"5178",77,"[28]EyhKxHnKqGocIHBJCCpECGjfgogx",223,0.995536,28,224,1,223,1,1,0,1,1,121,121,103,102,60
"5179",78,"[28]EyhKxHnKqGocIHBJCCpECGjfgogx",236,0.995781,28,237,1,236,1,1,0,1,1,110,110,127,126,60
"5180",79,"[28]EyhKxHnKqGocIHBJCCpECGjfgogx",235,0.995763,28,236,1,235,1,1,0,1,1,111,111,125,124,60
"5181",80,"[28]EyhKxHnKqGocIHBJCCpECGjfgogx",219,0.995455,28,220,1,219,1,1,0,1,1,124,124,96,95,60
"5182",81,"[28]EyhKxHnKqGocIHBJCCpECGjfgogx",228,0.995633,28,229,1,228,1,1,0,1,1,118,118,111,110,60
"5183",82,"[28]EyhKxHnKqGocIHBJCCpECGjfgogx",239,0.995833,28,240,1,239,1,1,0,1,1,107,107,133,132,60
"5184",83,"[28]EyhKxHnKqGocIHBJCCpECGjfgogx",223,0.995536,28,224,1,223,1,1,0,1,1,120,120,104,103,60
"5185",84,"[28]EyhKxHnKqGocIHBJCCpECGjfgogx",233,0.995726,28,234,1,233,1,1,0,1,1,114,114,120,119,60
"5186",85,"[28]EyhKxHnKqGocIHBJCCpECGjfgogx",225,0.995575,28,226,1,225,1,1,0,1,1,119,119,107,106,60
"5187",86,"[28]EyhKxHnKqGocIHBJCCpECGjfgogx",234,0.995745,28,235,1,234,1,1,0,1,1,111,111,124,123,60
"5188",87,"[28]EyhKxHnKqGocIHBJCCpECGjfgogx",244,0.995918,28,245,1,244,1,1,0,1,1,111,111,134,133,60
"5189",88,"[28]EyhKxHnKqGocIHBJCCpECGjfgogx",238,0.995816,28,239,1,238,1,1,0,1,1,109,109,130,129,60
"5190",89,"[28]EyhKxHnKqGocIHBJCCpECGjfgogx",233,0.995726,28,234,1,233,1,1,0,1,1,112,112,122,121,60
"5191",90,"[28]EyhKxHnKqGocIHBJCCpECGjfgogx",227,0.995614,28,228,1,227,1,1,0,1,1,117,117,111,110,60
"5192",91,"[28]EyhKxHnKqGocIHBJCCpECGjfgogx",235,0.995763,28,236,1,235,1,1,0,1,1,111,111,125,124,60
"5193",92,"[28]EyhKxHnKqGocIHBJCCpECGjfgogx",225,0.995575,28,226,1,225,1,1,0,1,1,122,122,104,103,60
"5194",93,"[28]EyhKxHnKqGocIHBJCCpECGjfgogx",227,0.995614,28,228,1,227,1,1,0,1,1,119,119,109,108,60
"5195",94,"[28]EyhKxHnKqGocIHBJCCpECGjfgogx",225,0.995575,28,226,1,225,1,1,0,1,1,120,120,106,105,60
"5196",95,"[28]EyhKxHnKqGocIHBJCCpECGjfgogx",226,0.995595,28,227,1,226,1,1,0,1,1,119,119,108,107,60
"5197",96,"[28]EyhKxHnKqGocIHBJCCpECGjfgogx",228,0.995633,28,229,1,228,1,1,0,1,1,120,120,109,108,60
"5198",97,"[28]EyhKxHnKqGocIHBJCCpECGjfgogx",225,0.995575,28,226,1,225,1,1,0,1,1,119,119,107,106,60
"5199",98,"[28]EyhKxHnKqGocIHBJCCpECGjfgogx",232,0.995708,28,233,1,232,1,1,0,1,1,114,114,119,118,60
"5200",99,"[28]EyhKxHnKqGocIHBJCCpECGjfgogx",226,0.995595,28,227,1,226,1,1,0,1,1,119,119,108,107,60
"5201",0,"[29]ErmFxKxtHnKqGocIHBJCogABqwHgp",239,0.995833,29,240,1,239,1,1,0,1,1,108,108,132,131,61
"5202",1,"[29]ErmFxKxtHnKqGocIHBJCogABqwHgp",230,0.995671,29,231,1,230,1,1,0,1,1,115,115,116,115,61
"5203",2,"[29]ErmFxKxtHnKqGocIHBJCogABqwHgp",222,0.995516,29,223,1,222,1,1,0,1,1,120,120,103,102,61
"5204",3,"[29]ErmFxKxtHnKqGocIHBJCogABqwHgp",218,0.995434,29,219,1,218,1,1,0,1,1,125,125,94,93,61
"5205",4,"[29]ErmFxKxtHnKqGocIHBJCogABqwHgp",229,0.995652,29,230,1,229,1,1,0,1,1,116,116,114,113,61
"5206",5,"[29]ErmFxKxtHnKqGocIHBJCogABqwHgp",229,0.995652,29,230,1,229,1,1,0,1,1,116,116,114,113,61
"5207",6,"[29]ErmFxKxtHnKqGocIHBJCogABqwHgp",230,0.995671,29,231,1,230,1,1,0,1,1,114,114,117,116,61
"5208",7,"[29]ErmFxKxtHnKqGocIHBJCogABqwHgp",231,0.99569,29,232,1,231,1,1,0,1,1,113,113,119,118,61
"5209",8,"[29]ErmFxKxtHnKqGocIHBJCogABqwHgp",230,0.995671,29,231,1,230,1,1,0,1,1,115,115,116,115,61
"5210",9,"[29]ErmFxKxtHnKqGocIHBJCogABqwHgp",233,0.995726,29,234,1,233,1,1,0,1,1,112,112,122,121,61
"5211",10,"[29]ErmFxKxtHnKqGocIHBJCogABqwHgp",234,0.995745,29,235,1,234,1,1,0,1,1,111,111,124,123,61
"5212",11,"[29]ErmFxKxtHnKqGocIHBJCogABqwHgp",231,0.99569,29,232,1,231,1,1,0,1,1,115,115,117,116,61
"5213",12,"[29]ErmFxKxtHnKqGocIHBJCogABqwHgp",236,0.995781,29,237,1,236,1,1,0,1,1,110,110,127,126,61
"5214",13,"[29]ErmFxKxtHnKqGocIHBJCogABqwHgp",241,0.995868,29,242,1,241,1,1,0,1,1,112,112,130,129,61
"5215",14,"[29]ErmFxKxtHnKqGocIHBJCogABqwHgp",240,0.995851,29,241,1,240,1,1,0,1,1,107,107,134,133,61
"5216",15,"[29]ErmFxKxtHnKqGocIHBJCogABqwHgp",224,0.995556,29,225,1,224,1,1,0,1,1,120,120,105,104,61
"5217",16,"[29]ErmFxKxtHnKqGocIHBJCogABqwHgp",234,0.995745,29,235,1,234,1,1,0,1,1,112,112,123,122,61
"5218",17,"[29]ErmFxKxtHnKqGocIHBJCogABqwHgp",218,0.995434,29,219,1,218,1,1,0,1,1,124,124,95,94,61
"5219",18,"[29]ErmFxKxtHnKqGocIHBJCogABqwHgp",240,0.995851,29,241,1,240,1,1,0,1,1,112,112,129,128,61
"5220",19,"[29]ErmFxKxtHnKqGocIHBJCogABqwHgp",235,0.995763,29,236,1,235,1,1,0,1,1,110,110,126,125,61
"5221",20,"[29]ErmFxKxtHnKqGocIHBJCogABqwHgp",235,0.995763,29,236,1,235,1,1,0,1,1,112,112,124,123,61
"5222",21,"[29]ErmFxKxtHnKqGocIHBJCogABqwHgp",226,0.995595,29,227,1,226,1,1,0,1,1,119,119,108,107,61
"5223",22,"[29]ErmFxKxtHnKqGocIHBJCogABqwHgp",236,0.995781,29,237,1,236,1,1,0,1,1,112,112,125,124,61
"5224",23,"[29]ErmFxKxtHnKqGocIHBJCogABqwHgp",231,0.99569,29,232,1,231,1,1,0,1,1,113,113,119,118,61
"5225",24,"[29]ErmFxKxtHnKqGocIHBJCogABqwHgp",227,0.995614,29,228,1,227,1,1,0,1,1,116,116,112,111,61
"5226",25,"[29]ErmFxKxtHnKqGocIHBJCogABqwHgp",238,0.995816,29,239,1,238,1,1,0,1,1,111,111,128,127,61
"5227",26,"[29]ErmFxKxtHnKqGocIHBJCogABqwHgp",221,0.995495,29,222,1,221,1,1,0,1,1,122,122,100,99,61
"5228",27,"[29]ErmFxKxtHnKqGocIHBJCogABqwHgp",231,0.99569,29,232,1,231,1,1,0,1,1,113,113,119,118,61
"5229",28,"[29]ErmFxKxtHnKqGocIHBJCogABqwHgp",227,0.995614,29,228,1,227,1,1,0,1,1,118,118,110,109,61
"5230",29,"[29]ErmFxKxtHnKqGocIHBJCogABqwHgp",235,0.995763,29,236,1,235,1,1,0,1,1,110,110,126,125,61
"5231",30,"[29]ErmFxKxtHnKqGocIHBJCogABqwHgp",238,0.995816,29,239,1,238,1,1,0,1,1,108,108,131,130,61
"5232",31,"[29]ErmFxKxtHnKqGocIHBJCogABqwHgp",230,0.995671,29,231,1,230,1,1,0,1,1,115,115,116,115,61
"5233",32,"[29]ErmFxKxtHnKqGocIHBJCogABqwHgp",233,0.995726,29,234,1,233,1,1,0,1,1,112,112,122,121,61
"5234",33,"[29]ErmFxKxtHnKqGocIHBJCogABqwHgp",224,0.995556,29,225,1,224,1,1,0,1,1,121,121,104,103,61
"5235",34,"[29]ErmFxKxtHnKqGocIHBJCogABqwHgp",230,0.995671,29,231,1,230,1,1,0,1,1,115,115,116,115,61
"5236",35,"[29]ErmFxKxtHnKqGocIHBJCogABqwHgp",225,0.995575,29,226,1,225,1,1,0,1,1,121,121,105,104,61
"5237",36,"[29]ErmFxKxtHnKqGocIHBJCogABqwHgp",219,0.995455,29,220,1,219,1,1,0,1,1,123,123,97,96,61
"5238",37,"[29]ErmFxKxtHnKqGocIHBJCogABqwHgp",230,0.995671,29,231,1,230,1,1,0,1,1,115,115,116,115,61
"5239",38,"[29]ErmFxKxtHnKqGocIHBJCogABqwHgp",229,0.995652,29,230,1,229,1,1,0,1,1,116,116,114,113,61
"5240",39,"[29]ErmFxKxtHnKqGocIHBJCogABqwHgp",223,0.995536,29,224,1,223,1,1,0,1,1,120,120,104,103,61
"5241",40,"[29]ErmFxKxtHnKqGocIHBJCogABqwHgp",222,0.995516,29,223,1,222,1,1,0,1,1,120,120,103,102,61
"5242",41,"[29]ErmFxKxtHnKqGocIHBJCogABqwHgp",235,0.995763,29,236,1,235,1,1,0,1,1,111,111,125,124,61
"5243",42,"[29]ErmFxKxtHnKqGocIHBJCogABqwHgp",235,0.995763,29,236,1,235,1,1,0,1,1,110,110,126,125,61
"5244",43,"[29]ErmFxKxtHnKqGocIHBJCogABqwHgp",234,0.995745,29,235,1,234,1,1,0,1,1,111,111,124,123,61
"5245",44,"[29]ErmFxKxtHnKqGocIHBJCogABqwHgp",235,0.995763,29,236,1,235,1,1,0,1,1,110,110,126,125,61
"5246",45,"[29]ErmFxKxtHnKqGocIHBJCogABqwHgp",229,0.995652,29,230,1,229,1,1,0,1,1,117,117,113,112,61
"5247",46,"[29]ErmFxKxtHnKqGocIHBJCogABqwHgp",238,0.995816,29,239,1,238,1,1,0,1,1,108,108,131,130,61
"5248",47,"[29]ErmFxKxtHnKqGocIHBJCogABqwHgp",229,0.995652,29,230,1,229,1,1,0,1,1,115,115,115,114,61
"5249",48,"[29]ErmFxKxtHnKqGocIHBJCogABqwHgp",235,0.995763,29,236,1,235,1,1,0,1,1,111,111,125,124,61
"5250",49,"[29]ErmFxKxtHnKqGocIHBJCogABqwHgp",231,0.99569,29,232,1,231,1,1,0,1,1,113,113,119,118,61
"5251",50,"[29]ErmFxKxtHnKqGocIHBJCogABqwHgp",237,0.995798,29,238,1,237,1,1,0,1,1,110,110,128,127,61
"5252",51,"[29]ErmFxKxtHnKqGocIHBJCogABqwHgp",232,0.995708,29,233,1,232,1,1,0,1,1,112,112,121,120,61
"5253",52,"[29]ErmFxKxtHnKqGocIHBJCogABqwHgp",220,0.995475,29,221,1,220,1,1,0,1,1,122,122,99,98,61
"5254",53,"[29]ErmFxKxtHnKqGocIHBJCogABqwHgp",227,0.995614,29,228,1,227,1,1,0,1,1,116,116,112,111,61
"5255",54,"[29]ErmFxKxtHnKqGocIHBJCogABqwHgp",233,0.995726,29,234,1,233,1,1,0,1,1,114,114,120,119,61
"5256",55,"[29]ErmFxKxtHnKqGocIHBJCogABqwHgp",242,0.995885,29,243,1,242,1,1,0,1,1,104,104,139,138,61
"5257",56,"[29]ErmFxKxtHnKqGocIHBJCogABqwHgp",225,0.995575,29,226,1,225,1,1,0,1,1,119,119,107,106,61
"5258",57,"[29]ErmFxKxtHnKqGocIHBJCogABqwHgp",232,0.995708,29,233,1,232,1,1,0,1,1,112,112,121,120,61
"5259",58,"[29]ErmFxKxtHnKqGocIHBJCogABqwHgp",236,0.995781,29,237,1,236,1,1,0,1,1,109,109,128,127,61
"5260",59,"[29]ErmFxKxtHnKqGocIHBJCogABqwHgp",228,0.995633,29,229,1,228,1,1,0,1,1,116,116,113,112,61
"5261",60,"[29]ErmFxKxtHnKqGocIHBJCogABqwHgp",232,0.995708,29,233,1,232,1,1,0,1,1,113,113,120,119,61
"5262",61,"[29]ErmFxKxtHnKqGocIHBJCogABqwHgp",237,0.995798,29,238,1,237,1,1,0,1,1,110,110,128,127,61
"5263",62,"[29]ErmFxKxtHnKqGocIHBJCogABqwHgp",222,0.995516,29,223,1,222,1,1,0,1,1,120,120,103,102,61
"5264",63,"[29]ErmFxKxtHnKqGocIHBJCogABqwHgp",228,0.995633,29,229,1,228,1,1,0,1,1,118,118,111,110,61
"5265",64,"[29]ErmFxKxtHnKqGocIHBJCogABqwHgp",239,0.995833,29,240,1,239,1,1,0,1,1,113,113,127,126,61
"5266",65,"[29]ErmFxKxtHnKqGocIHBJCogABqwHgp",234,0.995745,29,235,1,234,1,1,0,1,1,111,111,124,123,61
"5267",66,"[29]ErmFxKxtHnKqGocIHBJCogABqwHgp",237,0.995798,29,238,1,237,1,1,0,1,1,108,108,130,129,61
"5268",67,"[29]ErmFxKxtHnKqGocIHBJCogABqwHgp",232,0.995708,29,233,1,232,1,1,0,1,1,114,114,119,118,61
"5269",68,"[29]ErmFxKxtHnKqGocIHBJCogABqwHgp",229,0.995652,29,230,1,229,1,1,0,1,1,117,117,113,112,61
"5270",69,"[29]ErmFxKxtHnKqGocIHBJCogABqwHgp",234,0.995745,29,235,1,234,1,1,0,1,1,112,112,123,122,61
"5271",70,"[29]ErmFxKxtHnKqGocIHBJCogABqwHgp",231,0.99569,29,232,1,231,1,1,0,1,1,114,114,118,117,61
"5272",71,"[29]ErmFxKxtHnKqGocIHBJCogABqwHgp",230,0.995671,29,231,1,230,1,1,0,1,1,115,115,116,115,61
"5273",72,"[29]ErmFxKxtHnKqGocIHBJCogABqwHgp",227,0.995614,29,228,1,227,1,1,0,1,1,118,118,110,109,61
"5274",73,"[29]ErmFxKxtHnKqGocIHBJCogABqwHgp",232,0.995708,29,233,1,232,1,1,0,1,1,115,115,118,117,61
"5275",74,"[29]ErmFxKxtHnKqGocIHBJCogABqwHgp",239,0.995833,29,240,1,239,1,1,0,1,1,111,111,129,128,61
"5276",75,"[29]ErmFxKxtHnKqGocIHBJCogABqwHgp",232,0.995708,29,233,1,232,1,1,0,1,1,112,112,121,120,61
"5277",76,"[29]ErmFxKxtHnKqGocIHBJCogABqwHgp",237,0.995798,29,238,1,237,1,1,0,1,1,109,109,129,128,61
"5278",77,"[29]ErmFxKxtHnKqGocIHBJCogABqwHgp",228,0.995633,29,229,1,228,1,1,0,1,1,119,119,110,109,61
"5279",78,"[29]ErmFxKxtHnKqGocIHBJCogABqwHgp",234,0.995745,29,235,1,234,1,1,0,1,1,111,111,124,123,61
"5280",79,"[29]ErmFxKxtHnKqGocIHBJCogABqwHgp",233,0.995726,29,234,1,233,1,1,0,1,1,113,113,121,120,61
"5281",80,"[29]ErmFxKxtHnKqGocIHBJCogABqwHgp",236,0.995781,29,237,1,236,1,1,0,1,1,109,109,128,127,61
"5282",81,"[29]ErmFxKxtHnKqGocIHBJCogABqwHgp",222,0.995516,29,223,1,222,1,1,0,1,1,121,121,102,101,61
"5283",82,"[29]ErmFxKxtHnKqGocIHBJCogABqwHgp",221,0.995495,29,222,1,221,1,1,0,1,1,123,123,99,98,61
"5284",83,"[29]ErmFxKxtHnKqGocIHBJCogABqwHgp",233,0.995726,29,234,1,233,1,1,0,1,1,113,113,121,120,61
"5285",84,"[29]ErmFxKxtHnKqGocIHBJCogABqwHgp",234,0.995745,29,235,1,234,1,1,0,1,1,111,111,124,123,61
"5286",85,"[29]ErmFxKxtHnKqGocIHBJCogABqwHgp",226,0.995595,29,227,1,226,1,1,0,1,1,118,118,109,108,61
"5287",86,"[29]ErmFxKxtHnKqGocIHBJCogABqwHgp",227,0.995614,29,228,1,227,1,1,0,1,1,119,119,109,108,61
"5288",87,"[29]ErmFxKxtHnKqGocIHBJCogABqwHgp",235,0.995763,29,236,1,235,1,1,0,1,1,111,111,125,124,61
"5289",88,"[29]ErmFxKxtHnKqGocIHBJCogABqwHgp",230,0.995671,29,231,1,230,1,1,0,1,1,115,115,116,115,61
"5290",89,"[29]ErmFxKxtHnKqGocIHBJCogABqwHgp",235,0.995763,29,236,1,235,1,1,0,1,1,110,110,126,125,61
"5291",90,"[29]ErmFxKxtHnKqGocIHBJCogABqwHgp",234,0.995745,29,235,1,234,1,1,0,1,1,116,116,119,118,61
"5292",91,"[29]ErmFxKxtHnKqGocIHBJCogABqwHgp",243,0.995902,29,244,1,243,1,1,0,1,1,105,105,139,138,61
"5293",92,"[29]ErmFxKxtHnKqGocIHBJCogABqwHgp",230,0.995671,29,231,1,230,1,1,0,1,1,115,115,116,115,61
"5294",93,"[29]ErmFxKxtHnKqGocIHBJCogABqwHgp",232,0.995708,29,233,1,232,1,1,0,1,1,114,114,119,118,61
"5295",94,"[29]ErmFxKxtHnKqGocIHBJCogABqwHgp",226,0.995595,29,227,1,226,1,1,0,1,1,117,117,110,109,61
"5296",95,"[29]ErmFxKxtHnKqGocIHBJCogABqwHgp",229,0.995652,29,230,1,229,1,1,0,1,1,120,120,110,109,61
"5297",96,"[29]ErmFxKxtHnKqGocIHBJCogABqwHgp",225,0.995575,29,226,1,225,1,1,0,1,1,119,119,107,106,61
"5298",97,"[29]ErmFxKxtHnKqGocIHBJCogABqwHgp",237,0.995798,29,238,1,237,1,1,0,1,1,112,112,126,125,61
"5299",98,"[29]ErmFxKxtHnKqGocIHBJCogABqwHgp",227,0.995614,29,228,1,227,1,1,0,1,1,119,119,109,108,61
"5300",99,"[29]ErmFxKxtHnKqGocIHBJCogABqwHgp",218,0.995434,29,219,1,218,1,1,0,1,1,124,124,95,94,61
"5301",0,"[31]ElbwHnKqGocIHcJCkkftvEcvJHrwywp",231,0.99569,31,232,1,231,1,1,0,1,1,115,115,117,116,62
"5302",1,"[31]ElbwHnKqGocIHcJCkkftvEcvJHrwywp",231,0.99569,31,232,1,231,1,1,0,1,1,116,116,116,115,62
"5303",2,"[31]ElbwHnKqGocIHcJCkkftvEcvJHrwywp",237,0.995798,31,238,1,237,1,1,0,1,1,109,109,129,128,62
"5304",3,"[31]ElbwHnKqGocIHcJCkkftvEcvJHrwywp",225,0.995575,31,226,1,225,1,1,0,1,1,118,118,108,107,62
"5305",4,"[31]ElbwHnKqGocIHcJCkkftvEcvJHrwywp",236,0.995781,31,237,1,236,1,1,0,1,1,109,109,128,127,62
"5306",5,"[31]ElbwHnKqGocIHcJCkkftvEcvJHrwywp",221,0.995495,31,222,1,221,1,1,0,1,1,121,121,101,100,62
"5307",6,"[31]ElbwHnKqGocIHcJCkkftvEcvJHrwywp",228,0.995633,31,229,1,228,1,1,0,1,1,117,117,112,111,62
"5308",7,"[31]ElbwHnKqGocIHcJCkkftvEcvJHrwywp",242,0.995885,31,243,1,242,1,1,0,1,1,104,104,139,138,62
"5309",8,"[31]ElbwHnKqGocIHcJCkkftvEcvJHrwywp",241,0.995868,31,242,1,241,1,1,0,1,1,105,105,137,136,62
"5310",9,"[31]ElbwHnKqGocIHcJCkkftvEcvJHrwywp",222,0.995516,31,223,1,222,1,1,0,1,1,120,120,103,102,62
"5311",10,"[31]ElbwHnKqGocIHcJCkkftvEcvJHrwywp",220,0.995475,31,221,1,220,1,1,0,1,1,123,123,98,97,62
"5312",11,"[31]ElbwHnKqGocIHcJCkkftvEcvJHrwywp",227,0.995614,31,228,1,227,1,1,0,1,1,119,119,109,108,62
"5313",12,"[31]ElbwHnKqGocIHcJCkkftvEcvJHrwywp",224,0.995556,31,225,1,224,1,1,0,1,1,120,120,105,104,62
"5314",13,"[31]ElbwHnKqGocIHcJCkkftvEcvJHrwywp",231,0.99569,31,232,1,231,1,1,0,1,1,113,113,119,118,62
"5315",14,"[31]ElbwHnKqGocIHcJCkkftvEcvJHrwywp",230,0.995671,31,231,1,230,1,1,0,1,1,116,116,115,114,62
"5316",15,"[31]ElbwHnKqGocIHcJCkkftvEcvJHrwywp",227,0.995614,31,228,1,227,1,1,0,1,1,116,116,112,111,62
"5317",16,"[31]ElbwHnKqGocIHcJCkkftvEcvJHrwywp",232,0.995708,31,233,1,232,1,1,0,1,1,115,115,118,117,62
"5318",17,"[31]ElbwHnKqGocIHcJCkkftvEcvJHrwywp",215,0.99537,31,216,1,215,1,1,0,1,1,126,126,90,89,62
"5319",18,"[31]ElbwHnKqGocIHcJCkkftvEcvJHrwywp",233,0.995726,31,234,1,233,1,1,0,1,1,112,112,122,121,62
"5320",19,"[31]ElbwHnKqGocIHcJCkkftvEcvJHrwywp",246,0.995951,31,247,1,246,1,1,0,1,1,102,102,145,144,62
"5321",20,"[31]ElbwHnKqGocIHcJCkkftvEcvJHrwywp",232,0.995708,31,233,1,232,1,1,0,1,1,115,115,118,117,62
"5322",21,"[31]ElbwHnKqGocIHcJCkkftvEcvJHrwywp",236,0.995781,31,237,1,236,1,1,0,1,1,111,111,126,125,62
"5323",22,"[31]ElbwHnKqGocIHcJCkkftvEcvJHrwywp",221,0.995495,31,222,1,221,1,1,0,1,1,121,121,101,100,62
"5324",23,"[31]ElbwHnKqGocIHcJCkkftvEcvJHrwywp",231,0.99569,31,232,1,231,1,1,0,1,1,115,115,117,116,62
"5325",24,"[31]ElbwHnKqGocIHcJCkkftvEcvJHrwywp",224,0.995556,31,225,1,224,1,1,0,1,1,120,120,105,104,62
"5326",25,"[31]ElbwHnKqGocIHcJCkkftvEcvJHrwywp",229,0.995652,31,230,1,229,1,1,0,1,1,116,116,114,113,62
"5327",26,"[31]ElbwHnKqGocIHcJCkkftvEcvJHrwywp",226,0.995595,31,227,1,226,1,1,0,1,1,120,120,107,106,62
"5328",27,"[31]ElbwHnKqGocIHcJCkkftvEcvJHrwywp",242,0.995885,31,243,1,242,1,1,0,1,1,105,105,138,137,62
"5329",28,"[31]ElbwHnKqGocIHcJCkkftvEcvJHrwywp",229,0.995652,31,230,1,229,1,1,0,1,1,116,116,114,113,62
"5330",29,"[31]ElbwHnKqGocIHcJCkkftvEcvJHrwywp",224,0.995556,31,225,1,224,1,1,0,1,1,122,122,103,102,62
"5331",30,"[31]ElbwHnKqGocIHcJCkkftvEcvJHrwywp",234,0.995745,31,235,1,234,1,1,0,1,1,111,111,124,123,62
"5332",31,"[31]ElbwHnKqGocIHcJCkkftvEcvJHrwywp",229,0.995652,31,230,1,229,1,1,0,1,1,115,115,115,114,62
"5333",32,"[31]ElbwHnKqGocIHcJCkkftvEcvJHrwywp",231,0.99569,31,232,1,231,1,1,0,1,1,113,113,119,118,62
"5334",33,"[31]ElbwHnKqGocIHcJCkkftvEcvJHrwywp",240,0.995851,31,241,1,240,1,1,0,1,1,107,107,134,133,62
"5335",34,"[31]ElbwHnKqGocIHcJCkkftvEcvJHrwywp",226,0.995595,31,227,1,226,1,1,0,1,1,117,117,110,109,62
"5336",35,"[31]ElbwHnKqGocIHcJCkkftvEcvJHrwywp",236,0.995781,31,237,1,236,1,1,0,1,1,110,110,127,126,62
"5337",36,"[31]ElbwHnKqGocIHcJCkkftvEcvJHrwywp",228,0.995633,31,229,1,228,1,1,0,1,1,121,121,108,107,62
"5338",37,"[31]ElbwHnKqGocIHcJCkkftvEcvJHrwywp",226,0.995595,31,227,1,226,1,1,0,1,1,118,118,109,108,62
"5339",38,"[31]ElbwHnKqGocIHcJCkkftvEcvJHrwywp",229,0.995652,31,230,1,229,1,1,0,1,1,116,116,114,113,62
"5340",39,"[31]ElbwHnKqGocIHcJCkkftvEcvJHrwywp",228,0.995633,31,229,1,228,1,1,0,1,1,116,116,113,112,62
"5341",40,"[31]ElbwHnKqGocIHcJCkkftvEcvJHrwywp",233,0.995726,31,234,1,233,1,1,0,1,1,112,112,122,121,62
"5342",41,"[31]ElbwHnKqGocIHcJCkkftvEcvJHrwywp",233,0.995726,31,234,1,233,1,1,0,1,1,112,112,122,121,62
"5343",42,"[31]ElbwHnKqGocIHcJCkkftvEcvJHrwywp",241,0.995868,31,242,1,241,1,1,0,1,1,107,107,135,134,62
"5344",43,"[31]ElbwHnKqGocIHcJCkkftvEcvJHrwywp",236,0.995781,31,237,1,236,1,1,0,1,1,110,110,127,126,62
"5345",44,"[31]ElbwHnKqGocIHcJCkkftvEcvJHrwywp",226,0.995595,31,227,1,226,1,1,0,1,1,119,119,108,107,62
"5346",45,"[31]ElbwHnKqGocIHcJCkkftvEcvJHrwywp",231,0.99569,31,232,1,231,1,1,0,1,1,114,114,118,117,62
"5347",46,"[31]ElbwHnKqGocIHcJCkkftvEcvJHrwywp",234,0.995745,31,235,1,234,1,1,0,1,1,111,111,124,123,62
"5348",47,"[31]ElbwHnKqGocIHcJCkkftvEcvJHrwywp",222,0.995516,31,223,1,222,1,1,0,1,1,120,120,103,102,62
"5349",48,"[31]ElbwHnKqGocIHcJCkkftvEcvJHrwywp",235,0.995763,31,236,1,235,1,1,0,1,1,112,112,124,123,62
"5350",49,"[31]ElbwHnKqGocIHcJCkkftvEcvJHrwywp",224,0.995556,31,225,1,224,1,1,0,1,1,120,120,105,104,62
"5351",50,"[31]ElbwHnKqGocIHcJCkkftvEcvJHrwywp",226,0.995595,31,227,1,226,1,1,0,1,1,117,117,110,109,62
"5352",51,"[31]ElbwHnKqGocIHcJCkkftvEcvJHrwywp",236,0.995781,31,237,1,236,1,1,0,1,1,110,110,127,126,62
"5353",52,"[31]ElbwHnKqGocIHcJCkkftvEcvJHrwywp",226,0.995595,31,227,1,226,1,1,0,1,1,118,118,109,108,62
"5354",53,"[31]ElbwHnKqGocIHcJCkkftvEcvJHrwywp",225,0.995575,31,226,1,225,1,1,0,1,1,118,118,108,107,62
"5355",54,"[31]ElbwHnKqGocIHcJCkkftvEcvJHrwywp",226,0.995595,31,227,1,226,1,1,0,1,1,119,119,108,107,62
"5356",55,"[31]ElbwHnKqGocIHcJCkkftvEcvJHrwywp",231,0.99569,31,232,1,231,1,1,0,1,1,115,115,117,116,62
"5357",56,"[31]ElbwHnKqGocIHcJCkkftvEcvJHrwywp",233,0.995726,31,234,1,233,1,1,0,1,1,113,113,121,120,62
"5358",57,"[31]ElbwHnKqGocIHcJCkkftvEcvJHrwywp",224,0.995556,31,225,1,224,1,1,0,1,1,119,119,106,105,62
"5359",58,"[31]ElbwHnKqGocIHcJCkkftvEcvJHrwywp",231,0.99569,31,232,1,231,1,1,0,1,1,113,113,119,118,62
"5360",59,"[31]ElbwHnKqGocIHcJCkkftvEcvJHrwywp",232,0.995708,31,233,1,232,1,1,0,1,1,112,112,121,120,62
"5361",60,"[31]ElbwHnKqGocIHcJCkkftvEcvJHrwywp",228,0.995633,31,229,1,228,1,1,0,1,1,117,117,112,111,62
"5362",61,"[31]ElbwHnKqGocIHcJCkkftvEcvJHrwywp",226,0.995595,31,227,1,226,1,1,0,1,1,120,120,107,106,62
"5363",62,"[31]ElbwHnKqGocIHcJCkkftvEcvJHrwywp",229,0.995652,31,230,1,229,1,1,0,1,1,116,116,114,113,62
"5364",63,"[31]ElbwHnKqGocIHcJCkkftvEcvJHrwywp",231,0.99569,31,232,1,231,1,1,0,1,1,114,114,118,117,62
"5365",64,"[31]ElbwHnKqGocIHcJCkkftvEcvJHrwywp",234,0.995745,31,235,1,234,1,1,0,1,1,112,112,123,122,62
"5366",65,"[31]ElbwHnKqGocIHcJCkkftvEcvJHrwywp",225,0.995575,31,226,1,225,1,1,0,1,1,121,121,105,104,62
"5367",66,"[31]ElbwHnKqGocIHcJCkkftvEcvJHrwywp",230,0.995671,31,231,1,230,1,1,0,1,1,116,116,115,114,62
"5368",67,"[31]ElbwHnKqGocIHcJCkkftvEcvJHrwywp",227,0.995614,31,228,1,227,1,1,0,1,1,117,117,111,110,62
"5369",68,"[31]ElbwHnKqGocIHcJCkkftvEcvJHrwywp",235,0.995763,31,236,1,235,1,1,0,1,1,112,112,124,123,62
"5370",69,"[31]ElbwHnKqGocIHcJCkkftvEcvJHrwywp",222,0.995516,31,223,1,222,1,1,0,1,1,121,121,102,101,62
"5371",70,"[31]ElbwHnKqGocIHcJCkkftvEcvJHrwywp",235,0.995763,31,236,1,235,1,1,0,1,1,116,116,120,119,62
"5372",71,"[31]ElbwHnKqGocIHcJCkkftvEcvJHrwywp",226,0.995595,31,227,1,226,1,1,0,1,1,117,117,110,109,62
"5373",72,"[31]ElbwHnKqGocIHcJCkkftvEcvJHrwywp",237,0.995798,31,238,1,237,1,1,0,1,1,111,111,127,126,62
"5374",73,"[31]ElbwHnKqGocIHcJCkkftvEcvJHrwywp",229,0.995652,31,230,1,229,1,1,0,1,1,115,115,115,114,62
"5375",74,"[31]ElbwHnKqGocIHcJCkkftvEcvJHrwywp",226,0.995595,31,227,1,226,1,1,0,1,1,117,117,110,109,62
"5376",75,"[31]ElbwHnKqGocIHcJCkkftvEcvJHrwywp",234,0.995745,31,235,1,234,1,1,0,1,1,111,111,124,123,62
"5377",76,"[31]ElbwHnKqGocIHcJCkkftvEcvJHrwywp",225,0.995575,31,226,1,225,1,1,0,1,1,118,118,108,107,62
"5378",77,"[31]ElbwHnKqGocIHcJCkkftvEcvJHrwywp",231,0.99569,31,232,1,231,1,1,0,1,1,118,118,114,113,62
"5379",78,"[31]ElbwHnKqGocIHcJCkkftvEcvJHrwywp",217,0.995413,31,218,1,217,1,1,0,1,1,126,126,92,91,62
"5380",79,"[31]ElbwHnKqGocIHcJCkkftvEcvJHrwywp",231,0.99569,31,232,1,231,1,1,0,1,1,113,113,119,118,62
"5381",80,"[31]ElbwHnKqGocIHcJCkkftvEcvJHrwywp",236,0.995781,31,237,1,236,1,1,0,1,1,110,110,127,126,62
"5382",81,"[31]ElbwHnKqGocIHcJCkkftvEcvJHrwywp",234,0.995745,31,235,1,234,1,1,0,1,1,115,115,120,119,62
"5383",82,"[31]ElbwHnKqGocIHcJCkkftvEcvJHrwywp",227,0.995614,31,228,1,227,1,1,0,1,1,117,117,111,110,62
"5384",83,"[31]ElbwHnKqGocIHcJCkkftvEcvJHrwywp",224,0.995556,31,225,1,224,1,1,0,1,1,120,120,105,104,62
"5385",84,"[31]ElbwHnKqGocIHcJCkkftvEcvJHrwywp",234,0.995745,31,235,1,234,1,1,0,1,1,114,114,121,120,62
"5386",85,"[31]ElbwHnKqGocIHcJCkkftvEcvJHrwywp",223,0.995536,31,224,1,223,1,1,0,1,1,120,120,104,103,62
"5387",86,"[31]ElbwHnKqGocIHcJCkkftvEcvJHrwywp",235,0.995763,31,236,1,235,1,1,0,1,1,111,111,125,124,62
"5388",87,"[31]ElbwHnKqGocIHcJCkkftvEcvJHrwywp",232,0.995708,31,233,1,232,1,1,0,1,1,112,112,121,120,62
"5389",88,"[31]ElbwHnKqGocIHcJCkkftvEcvJHrwywp",235,0.995763,31,236,1,235,1,1,0,1,1,111,111,125,124,62
"5390",89,"[31]ElbwHnKqGocIHcJCkkftvEcvJHrwywp",227,0.995614,31,228,1,227,1,1,0,1,1,116,116,112,111,62
"5391",90,"[31]ElbwHnKqGocIHcJCkkftvEcvJHrwywp",225,0.995575,31,226,1,225,1,1,0,1,1,118,118,108,107,62
"5392",91,"[31]ElbwHnKqGocIHcJCkkftvEcvJHrwywp",240,0.995851,31,241,1,240,1,1,0,1,1,107,107,134,133,62
"5393",92,"[31]ElbwHnKqGocIHcJCkkftvEcvJHrwywp",226,0.995595,31,227,1,226,1,1,0,1,1,118,118,109,108,62
"5394",93,"[31]ElbwHnKqGocIHcJCkkftvEcvJHrwywp",226,0.995595,31,227,1,226,1,1,0,1,1,118,118,109,108,62
"5395",94,"[31]ElbwHnKqGocIHcJCkkftvEcvJHrwywp",227,0.995614,31,228,1,227,1,1,0,1,1,117,117,111,110,62
"5396",95,"[31]ElbwHnKqGocIHcJCkkftvEcvJHrwywp",235,0.995763,31,236,1,235,1,1,0,1,1,110,110,126,125,62
"5397",96,"[31]ElbwHnKqGocIHcJCkkftvEcvJHrwywp",243,0.995902,31,244,1,243,1,1,0,1,1,104,104,140,139,62
"5398",97,"[31]ElbwHnKqGocIHcJCkkftvEcvJHrwywp",241,0.995868,31,242,1,241,1,1,0,1,1,107,107,135,134,62
"5399",98,"[31]ElbwHnKqGocIHcJCkkftvEcvJHrwywp",227,0.995614,31,228,1,227,1,1,0,1,1,116,116,112,111,62
"5400",99,"[31]ElbwHnKqGocIHcJCkkftvEcvJHrwywp",235,0.995763,31,236,1,235,1,1,0,1,1,116,116,120,119,62
"5401",0,"[33]EsryvcKxHnKqGocIHBJCEjbGotecmBshr",238,0.995816,33,239,1,238,1,1,0,1,1,110,110,129,128,63
"5402",1,"[33]EsryvcKxHnKqGocIHBJCEjbGotecmBshr",231,0.99569,33,232,1,231,1,1,0,1,1,114,114,118,117,63
"5403",2,"[33]EsryvcKxHnKqGocIHBJCEjbGotecmBshr",233,0.995726,33,234,1,233,1,1,0,1,1,114,114,120,119,63
"5404",3,"[33]EsryvcKxHnKqGocIHBJCEjbGotecmBshr",236,0.995781,33,237,1,236,1,1,0,1,1,109,109,128,127,63
"5405",4,"[33]EsryvcKxHnKqGocIHBJCEjbGotecmBshr",221,0.995495,33,222,1,221,1,1,0,1,1,121,121,101,100,63
"5406",5,"[33]EsryvcKxHnKqGocIHBJCEjbGotecmBshr",242,0.995885,33,243,1,242,1,1,0,1,1,105,105,138,137,63
"5407",6,"[33]EsryvcKxHnKqGocIHBJCEjbGotecmBshr",228,0.995633,33,229,1,228,1,1,0,1,1,117,117,112,111,63
"5408",7,"[33]EsryvcKxHnKqGocIHBJCEjbGotecmBshr",230,0.995671,33,231,1,230,1,1,0,1,1,114,114,117,116,63
"5409",8,"[33]EsryvcKxHnKqGocIHBJCEjbGotecmBshr",232,0.995708,33,233,1,232,1,1,0,1,1,115,115,118,117,63
"5410",9,"[33]EsryvcKxHnKqGocIHBJCEjbGotecmBshr",237,0.995798,33,238,1,237,1,1,0,1,1,108,108,130,129,63
"5411",10,"[33]EsryvcKxHnKqGocIHBJCEjbGotecmBshr",231,0.99569,33,232,1,231,1,1,0,1,1,116,116,116,115,63
"5412",11,"[33]EsryvcKxHnKqGocIHBJCEjbGotecmBshr",224,0.995556,33,225,1,224,1,1,0,1,1,119,119,106,105,63
"5413",12,"[33]EsryvcKxHnKqGocIHBJCEjbGotecmBshr",230,0.995671,33,231,1,230,1,1,0,1,1,115,115,116,115,63
"5414",13,"[33]EsryvcKxHnKqGocIHBJCEjbGotecmBshr",241,0.995868,33,242,1,241,1,1,0,1,1,105,105,137,136,63
"5415",14,"[33]EsryvcKxHnKqGocIHBJCEjbGotecmBshr",246,0.995951,33,247,1,246,1,1,0,1,1,102,102,145,144,63
"5416",15,"[33]EsryvcKxHnKqGocIHBJCEjbGotecmBshr",229,0.995652,33,230,1,229,1,1,0,1,1,116,116,114,113,63
"5417",16,"[33]EsryvcKxHnKqGocIHBJCEjbGotecmBshr",234,0.995745,33,235,1,234,1,1,0,1,1,111,111,124,123,63
"5418",17,"[33]EsryvcKxHnKqGocIHBJCEjbGotecmBshr",234,0.995745,33,235,1,234,1,1,0,1,1,111,111,124,123,63
"5419",18,"[33]EsryvcKxHnKqGocIHBJCEjbGotecmBshr",229,0.995652,33,230,1,229,1,1,0,1,1,115,115,115,114,63
"5420",19,"[33]EsryvcKxHnKqGocIHBJCEjbGotecmBshr",227,0.995614,33,228,1,227,1,1,0,1,1,117,117,111,110,63
"5421",20,"[33]EsryvcKxHnKqGocIHBJCEjbGotecmBshr",231,0.99569,33,232,1,231,1,1,0,1,1,118,118,114,113,63
"5422",21,"[33]EsryvcKxHnKqGocIHBJCEjbGotecmBshr",227,0.995614,33,228,1,227,1,1,0,1,1,117,117,111,110,63
"5423",22,"[33]EsryvcKxHnKqGocIHBJCEjbGotecmBshr",241,0.995868,33,242,1,241,1,1,0,1,1,106,106,136,135,63
"5424",23,"[33]EsryvcKxHnKqGocIHBJCEjbGotecmBshr",239,0.995833,33,240,1,239,1,1,0,1,1,109,109,131,130,63
"5425",24,"[33]EsryvcKxHnKqGocIHBJCEjbGotecmBshr",224,0.995556,33,225,1,224,1,1,0,1,1,120,120,105,104,63
"5426",25,"[33]EsryvcKxHnKqGocIHBJCEjbGotecmBshr",234,0.995745,33,235,1,234,1,1,0,1,1,111,111,124,123,63
"5427",26,"[33]EsryvcKxHnKqGocIHBJCEjbGotecmBshr",234,0.995745,33,235,1,234,1,1,0,1,1,112,112,123,122,63
"5428",27,"[33]EsryvcKxHnKqGocIHBJCEjbGotecmBshr",240,0.995851,33,241,1,240,1,1,0,1,1,107,107,134,133,63
"5429",28,"[33]EsryvcKxHnKqGocIHBJCEjbGotecmBshr",230,0.995671,33,231,1,230,1,1,0,1,1,115,115,116,115,63
"5430",29,"[33]EsryvcKxHnKqGocIHBJCEjbGotecmBshr",226,0.995595,33,227,1,226,1,1,0,1,1,117,117,110,109,63
"5431",30,"[33]EsryvcKxHnKqGocIHBJCEjbGotecmBshr",223,0.995536,33,224,1,223,1,1,0,1,1,121,121,103,102,63
"5432",31,"[33]EsryvcKxHnKqGocIHBJCEjbGotecmBshr",232,0.995708,33,233,1,232,1,1,0,1,1,113,113,120,119,63
"5433",32,"[33]EsryvcKxHnKqGocIHBJCEjbGotecmBshr",229,0.995652,33,230,1,229,1,1,0,1,1,118,118,112,111,63
"5434",33,"[33]EsryvcKxHnKqGocIHBJCEjbGotecmBshr",222,0.995516,33,223,1,222,1,1,0,1,1,120,120,103,102,63
"5435",34,"[33]EsryvcKxHnKqGocIHBJCEjbGotecmBshr",233,0.995726,33,234,1,233,1,1,0,1,1,112,112,122,121,63
"5436",35,"[33]EsryvcKxHnKqGocIHBJCEjbGotecmBshr",232,0.995708,33,233,1,232,1,1,0,1,1,113,113,120,119,63
"5437",36,"[33]EsryvcKxHnKqGocIHBJCEjbGotecmBshr",241,0.995868,33,242,1,241,1,1,0,1,1,106,106,136,135,63
"5438",37,"[33]EsryvcKxHnKqGocIHBJCEjbGotecmBshr",225,0.995575,33,226,1,225,1,1,0,1,1,119,119,107,106,63
"5439",38,"[33]EsryvcKxHnKqGocIHBJCEjbGotecmBshr",215,0.99537,33,216,1,215,1,1,0,1,1,128,128,88,87,63
"5440",39,"[33]EsryvcKxHnKqGocIHBJCEjbGotecmBshr",223,0.995536,33,224,1,223,1,1,0,1,1,120,120,104,103,63
"5441",40,"[33]EsryvcKxHnKqGocIHBJCEjbGotecmBshr",232,0.995708,33,233,1,232,1,1,0,1,1,114,114,119,118,63
"5442",41,"[33]EsryvcKxHnKqGocIHBJCEjbGotecmBshr",229,0.995652,33,230,1,229,1,1,0,1,1,116,116,114,113,63
"5443",42,"[33]EsryvcKxHnKqGocIHBJCEjbGotecmBshr",233,0.995726,33,234,1,233,1,1,0,1,1,113,113,121,120,63
"5444",43,"[33]EsryvcKxHnKqGocIHBJCEjbGotecmBshr",236,0.995781,33,237,1,236,1,1,0,1,1,109,109,128,127,63
"5445",44,"[33]EsryvcKxHnKqGocIHBJCEjbGotecmBshr",224,0.995556,33,225,1,224,1,1,0,1,1,120,120,105,104,63
"5446",45,"[33]EsryvcKxHnKqGocIHBJCEjbGotecmBshr",229,0.995652,33,230,1,229,1,1,0,1,1,115,115,115,114,63
"5447",46,"[33]EsryvcKxHnKqGocIHBJCEjbGotecmBshr",231,0.99569,33,232,1,231,1,1,0,1,1,113,113,119,118,63
"5448",47,"[33]EsryvcKxHnKqGocIHBJCEjbGotecmBshr",231,0.99569,33,232,1,231,1,1,0,1,1,113,113,119,118,63
"5449",48,"[33]EsryvcKxHnKqGocIHBJCEjbGotecmBshr",223,0.995536,33,224,1,223,1,1,0,1,1,120,120,104,103,63
"5450",49,"[33]EsryvcKxHnKqGocIHBJCEjbGotecmBshr",220,0.995475,33,221,1,220,1,1,0,1,1,123,123,98,97,63
"5451",50,"[33]EsryvcKxHnKqGocIHBJCEjbGotecmBshr",236,0.995781,33,237,1,236,1,1,0,1,1,109,109,128,127,63
"5452",51,"[33]EsryvcKxHnKqGocIHBJCEjbGotecmBshr",234,0.995745,33,235,1,234,1,1,0,1,1,111,111,124,123,63
"5453",52,"[33]EsryvcKxHnKqGocIHBJCEjbGotecmBshr",226,0.995595,33,227,1,226,1,1,0,1,1,117,117,110,109,63
"5454",53,"[33]EsryvcKxHnKqGocIHBJCEjbGotecmBshr",223,0.995536,33,224,1,223,1,1,0,1,1,121,121,103,102,63
"5455",54,"[33]EsryvcKxHnKqGocIHBJCEjbGotecmBshr",228,0.995633,33,229,1,228,1,1,0,1,1,116,116,113,112,63
"5456",55,"[33]EsryvcKxHnKqGocIHBJCEjbGotecmBshr",235,0.995763,33,236,1,235,1,1,0,1,1,111,111,125,124,63
"5457",56,"[33]EsryvcKxHnKqGocIHBJCEjbGotecmBshr",224,0.995556,33,225,1,224,1,1,0,1,1,120,120,105,104,63
"5458",57,"[33]EsryvcKxHnKqGocIHBJCEjbGotecmBshr",234,0.995745,33,235,1,234,1,1,0,1,1,112,112,123,122,63
"5459",58,"[33]EsryvcKxHnKqGocIHBJCEjbGotecmBshr",230,0.995671,33,231,1,230,1,1,0,1,1,115,115,116,115,63
"5460",59,"[33]EsryvcKxHnKqGocIHBJCEjbGotecmBshr",235,0.995763,33,236,1,235,1,1,0,1,1,110,110,126,125,63
"5461",60,"[33]EsryvcKxHnKqGocIHBJCEjbGotecmBshr",235,0.995763,33,236,1,235,1,1,0,1,1,112,112,124,123,63
"5462",61,"[33]EsryvcKxHnKqGocIHBJCEjbGotecmBshr",229,0.995652,33,230,1,229,1,1,0,1,1,115,115,115,114,63
"5463",62,"[33]EsryvcKxHnKqGocIHBJCEjbGotecmBshr",237,0.995798,33,238,1,237,1,1,0,1,1,110,110,128,127,63
"5464",63,"[33]EsryvcKxHnKqGocIHBJCEjbGotecmBshr",238,0.995816,33,239,1,238,1,1,0,1,1,111,111,128,127,63
"5465",64,"[33]EsryvcKxHnKqGocIHBJCEjbGotecmBshr",232,0.995708,33,233,1,232,1,1,0,1,1,112,112,121,120,63
"5466",65,"[33]EsryvcKxHnKqGocIHBJCEjbGotecmBshr",226,0.995595,33,227,1,226,1,1,0,1,1,117,117,110,109,63
"5467",66,"[33]EsryvcKxHnKqGocIHBJCEjbGotecmBshr",243,0.995902,33,244,1,243,1,1,0,1,1,108,108,136,135,63
"5468",67,"[33]EsryvcKxHnKqGocIHBJCEjbGotecmBshr",220,0.995475,33,221,1,220,1,1,0,1,1,122,122,99,98,63
"5469",68,"[33]EsryvcKxHnKqGocIHBJCEjbGotecmBshr",243,0.995902,33,244,1,243,1,1,0,1,1,111,111,133,132,63
"5470",69,"[33]EsryvcKxHnKqGocIHBJCEjbGotecmBshr",239,0.995833,33,240,1,239,1,1,0,1,1,108,108,132,131,63
"5471",70,"[33]EsryvcKxHnKqGocIHBJCEjbGotecmBshr",234,0.995745,33,235,1,234,1,1,0,1,1,112,112,123,122,63
"5472",71,"[33]EsryvcKxHnKqGocIHBJCEjbGotecmBshr",230,0.995671,33,231,1,230,1,1,0,1,1,114,114,117,116,63
"5473",72,"[33]EsryvcKxHnKqGocIHBJCEjbGotecmBshr",241,0.995868,33,242,1,241,1,1,0,1,1,107,107,135,134,63
"5474",73,"[33]EsryvcKxHnKqGocIHBJCEjbGotecmBshr",226,0.995595,33,227,1,226,1,1,0,1,1,117,117,110,109,63
"5475",74,"[33]EsryvcKxHnKqGocIHBJCEjbGotecmBshr",230,0.995671,33,231,1,230,1,1,0,1,1,114,114,117,116,63
"5476",75,"[33]EsryvcKxHnKqGocIHBJCEjbGotecmBshr",233,0.995726,33,234,1,233,1,1,0,1,1,113,113,121,120,63
"5477",76,"[33]EsryvcKxHnKqGocIHBJCEjbGotecmBshr",220,0.995475,33,221,1,220,1,1,0,1,1,123,123,98,97,63
"5478",77,"[33]EsryvcKxHnKqGocIHBJCEjbGotecmBshr",228,0.995633,33,229,1,228,1,1,0,1,1,116,116,113,112,63
"5479",78,"[33]EsryvcKxHnKqGocIHBJCEjbGotecmBshr",221,0.995495,33,222,1,221,1,1,0,1,1,123,123,99,98,63
"5480",79,"[33]EsryvcKxHnKqGocIHBJCEjbGotecmBshr",220,0.995475,33,221,1,220,1,1,0,1,1,122,122,99,98,63
"5481",80,"[33]EsryvcKxHnKqGocIHBJCEjbGotecmBshr",234,0.995745,33,235,1,234,1,1,0,1,1,112,112,123,122,63
"5482",81,"[33]EsryvcKxHnKqGocIHBJCEjbGotecmBshr",248,0.995984,33,249,1,248,1,1,0,1,1,102,102,147,146,63
"5483",82,"[33]EsryvcKxHnKqGocIHBJCEjbGotecmBshr",231,0.99569,33,232,1,231,1,1,0,1,1,114,114,118,117,63
"5484",83,"[33]EsryvcKxHnKqGocIHBJCEjbGotecmBshr",244,0.995918,33,245,1,244,1,1,0,1,1,104,104,141,140,63
"5485",84,"[33]EsryvcKxHnKqGocIHBJCEjbGotecmBshr",228,0.995633,33,229,1,228,1,1,0,1,1,120,120,109,108,63
"5486",85,"[33]EsryvcKxHnKqGocIHBJCEjbGotecmBshr",236,0.995781,33,237,1,236,1,1,0,1,1,110,110,127,126,63
"5487",86,"[33]EsryvcKxHnKqGocIHBJCEjbGotecmBshr",229,0.995652,33,230,1,229,1,1,0,1,1,117,117,113,112,63
"5488",87,"[33]EsryvcKxHnKqGocIHBJCEjbGotecmBshr",235,0.995763,33,236,1,235,1,1,0,1,1,112,112,124,123,63
"5489",88,"[33]EsryvcKxHnKqGocIHBJCEjbGotecmBshr",216,0.995392,33,217,1,216,1,1,0,1,1,127,127,90,89,63
"5490",89,"[33]EsryvcKxHnKqGocIHBJCEjbGotecmBshr",237,0.995798,33,238,1,237,1,1,0,1,1,112,112,126,125,63
"5491",90,"[33]EsryvcKxHnKqGocIHBJCEjbGotecmBshr",235,0.995763,33,236,1,235,1,1,0,1,1,113,113,123,122,63
"5492",91,"[33]EsryvcKxHnKqGocIHBJCEjbGotecmBshr",220,0.995475,33,221,1,220,1,1,0,1,1,123,123,98,97,63
"5493",92,"[33]EsryvcKxHnKqGocIHBJCEjbGotecmBshr",229,0.995652,33,230,1,229,1,1,0,1,1,115,115,115,114,63
"5494",93,"[33]EsryvcKxHnKqGocIHBJCEjbGotecmBshr",236,0.995781,33,237,1,236,1,1,0,1,1,109,109,128,127,63
"5495",94,"[33]EsryvcKxHnKqGocIHBJCEjbGotecmBshr",237,0.995798,33,238,1,237,1,1,0,1,1,110,110,128,127,63
"5496",95,"[33]EsryvcKxHnKqGocIHBJCEjbGotecmBshr",229,0.995652,33,230,1,229,1,1,0,1,1,116,116,114,113,63
"5497",96,"[33]EsryvcKxHnKqGocIHBJCEjbGotecmBshr",243,0.995902,33,244,1,243,1,1,0,1,1,107,107,137,136,63
"5498",97,"[33]EsryvcKxHnKqGocIHBJCEjbGotecmBshr",232,0.995708,33,233,1,232,1,1,0,1,1,112,112,121,120,63
"5499",98,"[33]EsryvcKxHnKqGocIHBJCEjbGotecmBshr",227,0.995614,33,228,1,227,1,1,0,1,1,117,117,111,110,63
"5500",99,"[33]EsryvcKxHnKqGocIHBJCEjbGotecmBshr",226,0.995595,33,227,1,226,1,1,0,1,1,117,117,110,109,63
"5501",0,"[31]EFlwHnKqGocIHcJChpGvyqgmoJphueh",226,0.995595,31,227,1,226,1,1,0,1,1,119,119,108,107,64
"5502",1,"[31]EFlwHnKqGocIHcJChpGvyqgmoJphueh",232,0.995708,31,233,1,232,1,1,0,1,1,112,112,121,120,64
"5503",2,"[31]EFlwHnKqGocIHcJChpGvyqgmoJphueh",234,0.995745,31,235,1,234,1,1,0,1,1,112,112,123,122,64
"5504",3,"[31]EFlwHnKqGocIHcJChpGvyqgmoJphueh",237,0.995798,31,238,1,237,1,1,0,1,1,108,108,130,129,64
"5505",4,"[31]EFlwHnKqGocIHcJChpGvyqgmoJphueh",232,0.995708,31,233,1,232,1,1,0,1,1,115,115,118,117,64
"5506",5,"[31]EFlwHnKqGocIHcJChpGvyqgmoJphueh",240,0.995851,31,241,1,240,1,1,0,1,1,108,108,133,132,64
"5507",6,"[31]EFlwHnKqGocIHcJChpGvyqgmoJphueh",220,0.995475,31,221,1,220,1,1,0,1,1,122,122,99,98,64
"5508",7,"[31]EFlwHnKqGocIHcJChpGvyqgmoJphueh",230,0.995671,31,231,1,230,1,1,0,1,1,114,114,117,116,64
"5509",8,"[31]EFlwHnKqGocIHcJChpGvyqgmoJphueh",234,0.995745,31,235,1,234,1,1,0,1,1,111,111,124,123,64
"5510",9,"[31]EFlwHnKqGocIHcJChpGvyqgmoJphueh",223,0.995536,31,224,1,223,1,1,0,1,1,121,121,103,102,64
"5511",10,"[31]EFlwHnKqGocIHcJChpGvyqgmoJphueh",240,0.995851,31,241,1,240,1,1,0,1,1,106,106,135,134,64
"5512",11,"[31]EFlwHnKqGocIHcJChpGvyqgmoJphueh",222,0.995516,31,223,1,222,1,1,0,1,1,120,120,103,102,64
"5513",12,"[31]EFlwHnKqGocIHcJChpGvyqgmoJphueh",233,0.995726,31,234,1,233,1,1,0,1,1,112,112,122,121,64
"5514",13,"[31]EFlwHnKqGocIHcJChpGvyqgmoJphueh",235,0.995763,31,236,1,235,1,1,0,1,1,110,110,126,125,64
"5515",14,"[31]EFlwHnKqGocIHcJChpGvyqgmoJphueh",231,0.99569,31,232,1,231,1,1,0,1,1,114,114,118,117,64
"5516",15,"[31]EFlwHnKqGocIHcJChpGvyqgmoJphueh",222,0.995516,31,223,1,222,1,1,0,1,1,122,122,101,100,64
"5517",16,"[31]EFlwHnKqGocIHcJChpGvyqgmoJphueh",221,0.995495,31,222,1,221,1,1,0,1,1,122,122,100,99,64
"5518",17,"[31]EFlwHnKqGocIHcJChpGvyqgmoJphueh",233,0.995726,31,234,1,233,1,1,0,1,1,112,112,122,121,64
"5519",18,"[31]EFlwHnKqGocIHcJChpGvyqgmoJphueh",246,0.995951,31,247,1,246,1,1,0,1,1,106,106,141,140,64
"5520",19,"[31]EFlwHnKqGocIHcJChpGvyqgmoJphueh",233,0.995726,31,234,1,233,1,1,0,1,1,113,113,121,120,64
"5521",20,"[31]EFlwHnKqGocIHcJChpGvyqgmoJphueh",231,0.99569,31,232,1,231,1,1,0,1,1,113,113,119,118,64
"5522",21,"[31]EFlwHnKqGocIHcJChpGvyqgmoJphueh",233,0.995726,31,234,1,233,1,1,0,1,1,112,112,122,121,64
"5523",22,"[31]EFlwHnKqGocIHcJChpGvyqgmoJphueh",230,0.995671,31,231,1,230,1,1,0,1,1,114,114,117,116,64
"5524",23,"[31]EFlwHnKqGocIHcJChpGvyqgmoJphueh",236,0.995781,31,237,1,236,1,1,0,1,1,112,112,125,124,64
"5525",24,"[31]EFlwHnKqGocIHcJChpGvyqgmoJphueh",230,0.995671,31,231,1,230,1,1,0,1,1,114,114,117,116,64
"5526",25,"[31]EFlwHnKqGocIHcJChpGvyqgmoJphueh",218,0.995434,31,219,1,218,1,1,0,1,1,125,125,94,93,64
"5527",26,"[31]EFlwHnKqGocIHcJChpGvyqgmoJphueh",238,0.995816,31,239,1,238,1,1,0,1,1,110,110,129,128,64
"5528",27,"[31]EFlwHnKqGocIHcJChpGvyqgmoJphueh",236,0.995781,31,237,1,236,1,1,0,1,1,111,111,126,125,64
"5529",28,"[31]EFlwHnKqGocIHcJChpGvyqgmoJphueh",232,0.995708,31,233,1,232,1,1,0,1,1,114,114,119,118,64
"5530",29,"[31]EFlwHnKqGocIHcJChpGvyqgmoJphueh",235,0.995763,31,236,1,235,1,1,0,1,1,111,111,125,124,64
"5531",30,"[31]EFlwHnKqGocIHcJChpGvyqgmoJphueh",237,0.995798,31,238,1,237,1,1,0,1,1,109,109,129,128,64
"5532",31,"[31]EFlwHnKqGocIHcJChpGvyqgmoJphueh",223,0.995536,31,224,1,223,1,1,0,1,1,120,120,104,103,64
"5533",32,"[31]EFlwHnKqGocIHcJChpGvyqgmoJphueh",219,0.995455,31,220,1,219,1,1,0,1,1,123,123,97,96,64
"5534",33,"[31]EFlwHnKqGocIHcJChpGvyqgmoJphueh",234,0.995745,31,235,1,234,1,1,0,1,1,111,111,124,123,64
"5535",34,"[31]EFlwHnKqGocIHcJChpGvyqgmoJphueh",231,0.99569,31,232,1,231,1,1,0,1,1,115,115,117,116,64
"5536",35,"[31]EFlwHnKqGocIHcJChpGvyqgmoJphueh",227,0.995614,31,228,1,227,1,1,0,1,1,117,117,111,110,64
"5537",36,"[31]EFlwHnKqGocIHcJChpGvyqgmoJphueh",236,0.995781,31,237,1,236,1,1,0,1,1,112,112,125,124,64
"5538",37,"[31]EFlwHnKqGocIHcJChpGvyqgmoJphueh",225,0.995575,31,226,1,225,1,1,0,1,1,118,118,108,107,64
"5539",38,"[31]EFlwHnKqGocIHcJChpGvyqgmoJphueh",222,0.995516,31,223,1,222,1,1,0,1,1,122,122,101,100,64
"5540",39,"[31]EFlwHnKqGocIHcJChpGvyqgmoJphueh",229,0.995652,31,230,1,229,1,1,0,1,1,116,116,114,113,64
"5541",40,"[31]EFlwHnKqGocIHcJChpGvyqgmoJphueh",231,0.99569,31,232,1,231,1,1,0,1,1,113,113,119,118,64
"5542",41,"[31]EFlwHnKqGocIHcJChpGvyqgmoJphueh",226,0.995595,31,227,1,226,1,1,0,1,1,120,120,107,106,64
"5543",42,"[31]EFlwHnKqGocIHcJChpGvyqgmoJphueh",236,0.995781,31,237,1,236,1,1,0,1,1,111,111,126,125,64
"5544",43,"[31]EFlwHnKqGocIHcJChpGvyqgmoJphueh",233,0.995726,31,234,1,233,1,1,0,1,1,112,112,122,121,64
"5545",44,"[31]EFlwHnKqGocIHcJChpGvyqgmoJphueh",228,0.995633,31,229,1,228,1,1,0,1,1,116,116,113,112,64
"5546",45,"[31]EFlwHnKqGocIHcJChpGvyqgmoJphueh",230,0.995671,31,231,1,230,1,1,0,1,1,115,115,116,115,64
"5547",46,"[31]EFlwHnKqGocIHcJChpGvyqgmoJphueh",228,0.995633,31,229,1,228,1,1,0,1,1,116,116,113,112,64
"5548",47,"[31]EFlwHnKqGocIHcJChpGvyqgmoJphueh",223,0.995536,31,224,1,223,1,1,0,1,1,120,120,104,103,64
"5549",48,"[31]EFlwHnKqGocIHcJChpGvyqgmoJphueh",233,0.995726,31,234,1,233,1,1,0,1,1,112,112,122,121,64
"5550",49,"[31]EFlwHnKqGocIHcJChpGvyqgmoJphueh",231,0.99569,31,232,1,231,1,1,0,1,1,114,114,118,117,64
"5551",50,"[31]EFlwHnKqGocIHcJChpGvyqgmoJphueh",228,0.995633,31,229,1,228,1,1,0,1,1,116,116,113,112,64
"5552",51,"[31]EFlwHnKqGocIHcJChpGvyqgmoJphueh",236,0.995781,31,237,1,236,1,1,0,1,1,112,112,125,124,64
"5553",52,"[31]EFlwHnKqGocIHcJChpGvyqgmoJphueh",227,0.995614,31,228,1,227,1,1,0,1,1,116,116,112,111,64
"5554",53,"[31]EFlwHnKqGocIHcJChpGvyqgmoJphueh",233,0.995726,31,234,1,233,1,1,0,1,1,112,112,122,121,64
"5555",54,"[31]EFlwHnKqGocIHcJChpGvyqgmoJphueh",226,0.995595,31,227,1,226,1,1,0,1,1,119,119,108,107,64
"5556",55,"[31]EFlwHnKqGocIHcJChpGvyqgmoJphueh",243,0.995902,31,244,1,243,1,1,0,1,1,107,107,137,136,64
"5557",56,"[31]EFlwHnKqGocIHcJChpGvyqgmoJphueh",233,0.995726,31,234,1,233,1,1,0,1,1,112,112,122,121,64
"5558",57,"[31]EFlwHnKqGocIHcJChpGvyqgmoJphueh",231,0.99569,31,232,1,231,1,1,0,1,1,114,114,118,117,64
"5559",58,"[31]EFlwHnKqGocIHcJChpGvyqgmoJphueh",234,0.995745,31,235,1,234,1,1,0,1,1,111,111,124,123,64
"5560",59,"[31]EFlwHnKqGocIHcJChpGvyqgmoJphueh",233,0.995726,31,234,1,233,1,1,0,1,1,112,112,122,121,64
"5561",60,"[31]EFlwHnKqGocIHcJChpGvyqgmoJphueh",227,0.995614,31,228,1,227,1,1,0,1,1,117,117,111,110,64
"5562",61,"[31]EFlwHnKqGocIHcJChpGvyqgmoJphueh",235,0.995763,31,236,1,235,1,1,0,1,1,112,112,124,123,64
"5563",62,"[31]EFlwHnKqGocIHcJChpGvyqgmoJphueh",235,0.995763,31,236,1,235,1,1,0,1,1,111,111,125,124,64
"5564",63,"[31]EFlwHnKqGocIHcJChpGvyqgmoJphueh",230,0.995671,31,231,1,230,1,1,0,1,1,116,116,115,114,64
"5565",64,"[31]EFlwHnKqGocIHcJChpGvyqgmoJphueh",233,0.995726,31,234,1,233,1,1,0,1,1,112,112,122,121,64
"5566",65,"[31]EFlwHnKqGocIHcJChpGvyqgmoJphueh",249,0.996,31,250,1,249,1,1,0,1,1,101,101,149,148,64
"5567",66,"[31]EFlwHnKqGocIHcJChpGvyqgmoJphueh",235,0.995763,31,236,1,235,1,1,0,1,1,111,111,125,124,64
"5568",67,"[31]EFlwHnKqGocIHcJChpGvyqgmoJphueh",239,0.995833,31,240,1,239,1,1,0,1,1,110,110,130,129,64
"5569",68,"[31]EFlwHnKqGocIHcJChpGvyqgmoJphueh",228,0.995633,31,229,1,228,1,1,0,1,1,120,120,109,108,64
"5570",69,"[31]EFlwHnKqGocIHcJChpGvyqgmoJphueh",226,0.995595,31,227,1,226,1,1,0,1,1,118,118,109,108,64
"5571",70,"[31]EFlwHnKqGocIHcJChpGvyqgmoJphueh",226,0.995595,31,227,1,226,1,1,0,1,1,117,117,110,109,64
"5572",71,"[31]EFlwHnKqGocIHcJChpGvyqgmoJphueh",231,0.99569,31,232,1,231,1,1,0,1,1,114,114,118,117,64
"5573",72,"[31]EFlwHnKqGocIHcJChpGvyqgmoJphueh",236,0.995781,31,237,1,236,1,1,0,1,1,110,110,127,126,64
"5574",73,"[31]EFlwHnKqGocIHcJChpGvyqgmoJphueh",237,0.995798,31,238,1,237,1,1,0,1,1,108,108,130,129,64
"5575",74,"[31]EFlwHnKqGocIHcJChpGvyqgmoJphueh",229,0.995652,31,230,1,229,1,1,0,1,1,115,115,115,114,64
"5576",75,"[31]EFlwHnKqGocIHcJChpGvyqgmoJphueh",247,0.995968,31,248,1,247,1,1,0,1,1,101,101,147,146,64
"5577",76,"[31]EFlwHnKqGocIHcJChpGvyqgmoJphueh",231,0.99569,31,232,1,231,1,1,0,1,1,114,114,118,117,64
"5578",77,"[31]EFlwHnKqGocIHcJChpGvyqgmoJphueh",228,0.995633,31,229,1,228,1,1,0,1,1,116,116,113,112,64
"5579",78,"[31]EFlwHnKqGocIHcJChpGvyqgmoJphueh",232,0.995708,31,233,1,232,1,1,0,1,1,112,112,121,120,64
"5580",79,"[31]EFlwHnKqGocIHcJChpGvyqgmoJphueh",226,0.995595,31,227,1,226,1,1,0,1,1,118,118,109,108,64
"5581",80,"[31]EFlwHnKqGocIHcJChpGvyqgmoJphueh",228,0.995633,31,229,1,228,1,1,0,1,1,116,116,113,112,64
"5582",81,"[31]EFlwHnKqGocIHcJChpGvyqgmoJphueh",229,0.995652,31,230,1,229,1,1,0,1,1,116,116,114,113,64
"5583",82,"[31]EFlwHnKqGocIHcJChpGvyqgmoJphueh",225,0.995575,31,226,1,225,1,1,0,1,1,120,120,106,105,64
"5584",83,"[31]EFlwHnKqGocIHcJChpGvyqgmoJphueh",243,0.995902,31,244,1,243,1,1,0,1,1,109,109,135,134,64
"5585",84,"[31]EFlwHnKqGocIHcJChpGvyqgmoJphueh",235,0.995763,31,236,1,235,1,1,0,1,1,112,112,124,123,64
"5586",85,"[31]EFlwHnKqGocIHcJChpGvyqgmoJphueh",243,0.995902,31,244,1,243,1,1,0,1,1,105,105,139,138,64
"5587",86,"[31]EFlwHnKqGocIHcJChpGvyqgmoJphueh",223,0.995536,31,224,1,223,1,1,0,1,1,120,120,104,103,64
"5588",87,"[31]EFlwHnKqGocIHcJChpGvyqgmoJphueh",225,0.995575,31,226,1,225,1,1,0,1,1,119,119,107,106,64
"5589",88,"[31]EFlwHnKqGocIHcJChpGvyqgmoJphueh",231,0.99569,31,232,1,231,1,1,0,1,1,114,114,118,117,64
"5590",89,"[31]EFlwHnKqGocIHcJChpGvyqgmoJphueh",223,0.995536,31,224,1,223,1,1,0,1,1,122,122,102,101,64
"5591",90,"[31]EFlwHnKqGocIHcJChpGvyqgmoJphueh",232,0.995708,31,233,1,232,1,1,0,1,1,116,116,117,116,64
"5592",91,"[31]EFlwHnKqGocIHcJChpGvyqgmoJphueh",224,0.995556,31,225,1,224,1,1,0,1,1,119,119,106,105,64
"5593",92,"[31]EFlwHnKqGocIHcJChpGvyqgmoJphueh",235,0.995763,31,236,1,235,1,1,0,1,1,111,111,125,124,64
"5594",93,"[31]EFlwHnKqGocIHcJChpGvyqgmoJphueh",228,0.995633,31,229,1,228,1,1,0,1,1,119,119,110,109,64
"5595",94,"[31]EFlwHnKqGocIHcJChpGvyqgmoJphueh",221,0.995495,31,222,1,221,1,1,0,1,1,121,121,101,100,64
"5596",95,"[31]EFlwHnKqGocIHcJChpGvyqgmoJphueh",231,0.99569,31,232,1,231,1,1,0,1,1,114,114,118,117,64
"5597",96,"[31]EFlwHnKqGocIHcJChpGvyqgmoJphueh",227,0.995614,31,228,1,227,1,1,0,1,1,117,117,111,110,64
"5598",97,"[31]EFlwHnKqGocIHcJChpGvyqgmoJphueh",230,0.995671,31,231,1,230,1,1,0,1,1,117,117,114,113,64
"5599",98,"[31]EFlwHnKqGocIHcJChpGvyqgmoJphueh",229,0.995652,31,230,1,229,1,1,0,1,1,116,116,114,113,64
"5600",99,"[31]EFlwHnKqGocIHcJChpGvyqgmoJphueh",229,0.995652,31,230,1,229,1,1,0,1,1,115,115,115,114,64
"5601",0,"[28]EDwhwHnKqGocIHcJCqGjsIDkexsJ",225,0.995575,28,226,1,225,1,1,0,1,1,118,118,108,107,65
"5602",1,"[28]EDwhwHnKqGocIHcJCqGjsIDkexsJ",234,0.995745,28,235,1,234,1,1,0,1,1,112,112,123,122,65
"5603",2,"[28]EDwhwHnKqGocIHcJCqGjsIDkexsJ",230,0.995671,28,231,1,230,1,1,0,1,1,114,114,117,116,65
"5604",3,"[28]EDwhwHnKqGocIHcJCqGjsIDkexsJ",221,0.995495,28,222,1,221,1,1,0,1,1,122,122,100,99,65
"5605",4,"[28]EDwhwHnKqGocIHcJCqGjsIDkexsJ",239,0.995833,28,240,1,239,1,1,0,1,1,107,107,133,132,65
"5606",5,"[28]EDwhwHnKqGocIHcJCqGjsIDkexsJ",224,0.995556,28,225,1,224,1,1,0,1,1,119,119,106,105,65
"5607",6,"[28]EDwhwHnKqGocIHcJCqGjsIDkexsJ",237,0.995798,28,238,1,237,1,1,0,1,1,110,110,128,127,65
"5608",7,"[28]EDwhwHnKqGocIHcJCqGjsIDkexsJ",229,0.995652,28,230,1,229,1,1,0,1,1,115,115,115,114,65
"5609",8,"[28]EDwhwHnKqGocIHcJCqGjsIDkexsJ",226,0.995595,28,227,1,226,1,1,0,1,1,118,118,109,108,65
"5610",9,"[28]EDwhwHnKqGocIHcJCqGjsIDkexsJ",225,0.995575,28,226,1,225,1,1,0,1,1,118,118,108,107,65
"5611",10,"[28]EDwhwHnKqGocIHcJCqGjsIDkexsJ",236,0.995781,28,237,1,236,1,1,0,1,1,109,109,128,127,65
"5612",11,"[28]EDwhwHnKqGocIHcJCqGjsIDkexsJ",234,0.995745,28,235,1,234,1,1,0,1,1,113,113,122,121,65
"5613",12,"[28]EDwhwHnKqGocIHcJCqGjsIDkexsJ",224,0.995556,28,225,1,224,1,1,0,1,1,120,120,105,104,65
"5614",13,"[28]EDwhwHnKqGocIHcJCqGjsIDkexsJ",231,0.99569,28,232,1,231,1,1,0,1,1,115,115,117,116,65
"5615",14,"[28]EDwhwHnKqGocIHcJCqGjsIDkexsJ",237,0.995798,28,238,1,237,1,1,0,1,1,109,109,129,128,65
"5616",15,"[28]EDwhwHnKqGocIHcJCqGjsIDkexsJ",231,0.99569,28,232,1,231,1,1,0,1,1,116,116,116,115,65
"5617",16,"[28]EDwhwHnKqGocIHcJCqGjsIDkexsJ",228,0.995633,28,229,1,228,1,1,0,1,1,116,116,113,112,65
"5618",17,"[28]EDwhwHnKqGocIHcJCqGjsIDkexsJ",236,0.995781,28,237,1,236,1,1,0,1,1,109,109,128,127,65
"5619",18,"[28]EDwhwHnKqGocIHcJCqGjsIDkexsJ",232,0.995708,28,233,1,232,1,1,0,1,1,115,115,118,117,65
"5620",19,"[28]EDwhwHnKqGocIHcJCqGjsIDkexsJ",226,0.995595,28,227,1,226,1,1,0,1,1,119,119,108,107,65
"5621",20,"[28]EDwhwHnKqGocIHcJCqGjsIDkexsJ",236,0.995781,28,237,1,236,1,1,0,1,1,110,110,127,126,65
"5622",21,"[28]EDwhwHnKqGocIHcJCqGjsIDkexsJ",241,0.995868,28,242,1,241,1,1,0,1,1,107,107,135,134,65
"5623",22,"[28]EDwhwHnKqGocIHcJCqGjsIDkexsJ",226,0.995595,28,227,1,226,1,1,0,1,1,118,118,109,108,65
"5624",23,"[28]EDwhwHnKqGocIHcJCqGjsIDkexsJ",237,0.995798,28,238,1,237,1,1,0,1,1,108,108,130,129,65
"5625",24,"[28]EDwhwHnKqGocIHcJCqGjsIDkexsJ",232,0.995708,28,233,1,232,1,1,0,1,1,112,112,121,120,65
"5626",25,"[28]EDwhwHnKqGocIHcJCqGjsIDkexsJ",227,0.995614,28,228,1,227,1,1,0,1,1,116,116,112,111,65
"5627",26,"[28]EDwhwHnKqGocIHcJCqGjsIDkexsJ",219,0.995455,28,220,1,219,1,1,0,1,1,123,123,97,96,65
"5628",27,"[28]EDwhwHnKqGocIHcJCqGjsIDkexsJ",223,0.995536,28,224,1,223,1,1,0,1,1,121,121,103,102,65
"5629",28,"[28]EDwhwHnKqGocIHcJCqGjsIDkexsJ",227,0.995614,28,228,1,227,1,1,0,1,1,116,116,112,111,65
"5630",29,"[28]EDwhwHnKqGocIHcJCqGjsIDkexsJ",235,0.995763,28,236,1,235,1,1,0,1,1,112,112,124,123,65
"5631",30,"[28]EDwhwHnKqGocIHcJCqGjsIDkexsJ",225,0.995575,28,226,1,225,1,1,0,1,1,119,119,107,106,65
"5632",31,"[28]EDwhwHnKqGocIHcJCqGjsIDkexsJ",224,0.995556,28,225,1,224,1,1,0,1,1,119,119,106,105,65
"5633",32,"[28]EDwhwHnKqGocIHcJCqGjsIDkexsJ",230,0.995671,28,231,1,230,1,1,0,1,1,116,116,115,114,65
"5634",33,"[28]EDwhwHnKqGocIHcJCqGjsIDkexsJ",226,0.995595,28,227,1,226,1,1,0,1,1,117,117,110,109,65
"5635",34,"[28]EDwhwHnKqGocIHcJCqGjsIDkexsJ",232,0.995708,28,233,1,232,1,1,0,1,1,114,114,119,118,65
"5636",35,"[28]EDwhwHnKqGocIHcJCqGjsIDkexsJ",225,0.995575,28,226,1,225,1,1,0,1,1,118,118,108,107,65
"5637",36,"[28]EDwhwHnKqGocIHcJCqGjsIDkexsJ",228,0.995633,28,229,1,228,1,1,0,1,1,116,116,113,112,65
"5638",37,"[28]EDwhwHnKqGocIHcJCqGjsIDkexsJ",229,0.995652,28,230,1,229,1,1,0,1,1,117,117,113,112,65
"5639",38,"[28]EDwhwHnKqGocIHcJCqGjsIDkexsJ",227,0.995614,28,228,1,227,1,1,0,1,1,116,116,112,111,65
"5640",39,"[28]EDwhwHnKqGocIHcJCqGjsIDkexsJ",236,0.995781,28,237,1,236,1,1,0,1,1,109,109,128,127,65
"5641",40,"[28]EDwhwHnKqGocIHcJCqGjsIDkexsJ",234,0.995745,28,235,1,234,1,1,0,1,1,111,111,124,123,65
"5642",41,"[28]EDwhwHnKqGocIHcJCqGjsIDkexsJ",224,0.995556,28,225,1,224,1,1,0,1,1,119,119,106,105,65
"5643",42,"[28]EDwhwHnKqGocIHcJCqGjsIDkexsJ",213,0.995327,28,214,1,213,1,1,0,1,1,128,128,86,85,65
"5644",43,"[28]EDwhwHnKqGocIHcJCqGjsIDkexsJ",222,0.995516,28,223,1,222,1,1,0,1,1,120,120,103,102,65
"5645",44,"[28]EDwhwHnKqGocIHcJCqGjsIDkexsJ",231,0.99569,28,232,1,231,1,1,0,1,1,116,116,116,115,65
"5646",45,"[28]EDwhwHnKqGocIHcJCqGjsIDkexsJ",224,0.995556,28,225,1,224,1,1,0,1,1,119,119,106,105,65
"5647",46,"[28]EDwhwHnKqGocIHcJCqGjsIDkexsJ",245,0.995935,28,246,1,245,1,1,0,1,1,105,105,141,140,65
"5648",47,"[28]EDwhwHnKqGocIHcJCqGjsIDkexsJ",239,0.995833,28,240,1,239,1,1,0,1,1,107,107,133,132,65
"5649",48,"[28]EDwhwHnKqGocIHcJCqGjsIDkexsJ",224,0.995556,28,225,1,224,1,1,0,1,1,120,120,105,104,65
"5650",49,"[28]EDwhwHnKqGocIHcJCqGjsIDkexsJ",229,0.995652,28,230,1,229,1,1,0,1,1,115,115,115,114,65
"5651",50,"[28]EDwhwHnKqGocIHcJCqGjsIDkexsJ",237,0.995798,28,238,1,237,1,1,0,1,1,111,111,127,126,65
"5652",51,"[28]EDwhwHnKqGocIHcJCqGjsIDkexsJ",226,0.995595,28,227,1,226,1,1,0,1,1,118,118,109,108,65
"5653",52,"[28]EDwhwHnKqGocIHcJCqGjsIDkexsJ",242,0.995885,28,243,1,242,1,1,0,1,1,107,107,136,135,65
"5654",53,"[28]EDwhwHnKqGocIHcJCqGjsIDkexsJ",231,0.99569,28,232,1,231,1,1,0,1,1,114,114,118,117,65
"5655",54,"[28]EDwhwHnKqGocIHcJCqGjsIDkexsJ",234,0.995745,28,235,1,234,1,1,0,1,1,112,112,123,122,65
"5656",55,"[28]EDwhwHnKqGocIHcJCqGjsIDkexsJ",217,0.995413,28,218,1,217,1,1,0,1,1,125,125,93,92,65
"5657",56,"[28]EDwhwHnKqGocIHcJCqGjsIDkexsJ",227,0.995614,28,228,1,227,1,1,0,1,1,116,116,112,111,65
"5658",57,"[28]EDwhwHnKqGocIHcJCqGjsIDkexsJ",241,0.995868,28,242,1,241,1,1,0,1,1,106,106,136,135,65
"5659",58,"[28]EDwhwHnKqGocIHcJCqGjsIDkexsJ",229,0.995652,28,230,1,229,1,1,0,1,1,115,115,115,114,65
"5660",59,"[28]EDwhwHnKqGocIHcJCqGjsIDkexsJ",237,0.995798,28,238,1,237,1,1,0,1,1,109,109,129,128,65
"5661",60,"[28]EDwhwHnKqGocIHcJCqGjsIDkexsJ",237,0.995798,28,238,1,237,1,1,0,1,1,109,109,129,128,65
"5662",61,"[28]EDwhwHnKqGocIHcJCqGjsIDkexsJ",246,0.995951,28,247,1,246,1,1,0,1,1,102,102,145,144,65
"5663",62,"[28]EDwhwHnKqGocIHcJCqGjsIDkexsJ",227,0.995614,28,228,1,227,1,1,0,1,1,118,118,110,109,65
"5664",63,"[28]EDwhwHnKqGocIHcJCqGjsIDkexsJ",245,0.995935,28,246,1,245,1,1,0,1,1,104,104,142,141,65
"5665",64,"[28]EDwhwHnKqGocIHcJCqGjsIDkexsJ",232,0.995708,28,233,1,232,1,1,0,1,1,112,112,121,120,65
"5666",65,"[28]EDwhwHnKqGocIHcJCqGjsIDkexsJ",220,0.995475,28,221,1,220,1,1,0,1,1,122,122,99,98,65
"5667",66,"[28]EDwhwHnKqGocIHcJCqGjsIDkexsJ",235,0.995763,28,236,1,235,1,1,0,1,1,110,110,126,125,65
"5668",67,"[28]EDwhwHnKqGocIHcJCqGjsIDkexsJ",225,0.995575,28,226,1,225,1,1,0,1,1,119,119,107,106,65
"5669",68,"[28]EDwhwHnKqGocIHcJCqGjsIDkexsJ",231,0.99569,28,232,1,231,1,1,0,1,1,113,113,119,118,65
"5670",69,"[28]EDwhwHnKqGocIHcJCqGjsIDkexsJ",234,0.995745,28,235,1,234,1,1,0,1,1,111,111,124,123,65
"5671",70,"[28]EDwhwHnKqGocIHcJCqGjsIDkexsJ",211,0.995283,28,212,1,211,1,1,0,1,1,133,133,79,78,65
"5672",71,"[28]EDwhwHnKqGocIHcJCqGjsIDkexsJ",230,0.995671,28,231,1,230,1,1,0,1,1,116,116,115,114,65
"5673",72,"[28]EDwhwHnKqGocIHcJCqGjsIDkexsJ",231,0.99569,28,232,1,231,1,1,0,1,1,114,114,118,117,65
"5674",73,"[28]EDwhwHnKqGocIHcJCqGjsIDkexsJ",233,0.995726,28,234,1,233,1,1,0,1,1,112,112,122,121,65
"5675",74,"[28]EDwhwHnKqGocIHcJCqGjsIDkexsJ",236,0.995781,28,237,1,236,1,1,0,1,1,111,111,126,125,65
"5676",75,"[28]EDwhwHnKqGocIHcJCqGjsIDkexsJ",227,0.995614,28,228,1,227,1,1,0,1,1,118,118,110,109,65
"5677",76,"[28]EDwhwHnKqGocIHcJCqGjsIDkexsJ",240,0.995851,28,241,1,240,1,1,0,1,1,106,106,135,134,65
"5678",77,"[28]EDwhwHnKqGocIHcJCqGjsIDkexsJ",230,0.995671,28,231,1,230,1,1,0,1,1,115,115,116,115,65
"5679",78,"[28]EDwhwHnKqGocIHcJCqGjsIDkexsJ",247,0.995968,28,248,1,247,1,1,0,1,1,100,100,148,147,65
"5680",79,"[28]EDwhwHnKqGocIHcJCqGjsIDkexsJ",240,0.995851,28,241,1,240,1,1,0,1,1,106,106,135,134,65
"5681",80,"[28]EDwhwHnKqGocIHcJCqGjsIDkexsJ",230,0.995671,28,231,1,230,1,1,0,1,1,115,115,116,115,65
"5682",81,"[28]EDwhwHnKqGocIHcJCqGjsIDkexsJ",247,0.995968,28,248,1,247,1,1,0,1,1,101,101,147,146,65
"5683",82,"[28]EDwhwHnKqGocIHcJCqGjsIDkexsJ",226,0.995595,28,227,1,226,1,1,0,1,1,117,117,110,109,65
"5684",83,"[28]EDwhwHnKqGocIHcJCqGjsIDkexsJ",236,0.995781,28,237,1,236,1,1,0,1,1,110,110,127,126,65
"5685",84,"[28]EDwhwHnKqGocIHcJCqGjsIDkexsJ",239,0.995833,28,240,1,239,1,1,0,1,1,107,107,133,132,65
"5686",85,"[28]EDwhwHnKqGocIHcJCqGjsIDkexsJ",227,0.995614,28,228,1,227,1,1,0,1,1,116,116,112,111,65
"5687",86,"[28]EDwhwHnKqGocIHcJCqGjsIDkexsJ",235,0.995763,28,236,1,235,1,1,0,1,1,112,112,124,123,65
"5688",87,"[28]EDwhwHnKqGocIHcJCqGjsIDkexsJ",236,0.995781,28,237,1,236,1,1,0,1,1,109,109,128,127,65
"5689",88,"[28]EDwhwHnKqGocIHcJCqGjsIDkexsJ",227,0.995614,28,228,1,227,1,1,0,1,1,119,119,109,108,65
"5690",89,"[28]EDwhwHnKqGocIHcJCqGjsIDkexsJ",233,0.995726,28,234,1,233,1,1,0,1,1,115,115,119,118,65
"5691",90,"[28]EDwhwHnKqGocIHcJCqGjsIDkexsJ",229,0.995652,28,230,1,229,1,1,0,1,1,116,116,114,113,65
"5692",91,"[28]EDwhwHnKqGocIHcJCqGjsIDkexsJ",235,0.995763,28,236,1,235,1,1,0,1,1,113,113,123,122,65
"5693",92,"[28]EDwhwHnKqGocIHcJCqGjsIDkexsJ",238,0.995816,28,239,1,238,1,1,0,1,1,110,110,129,128,65
"5694",93,"[28]EDwhwHnKqGocIHcJCqGjsIDkexsJ",229,0.995652,28,230,1,229,1,1,0,1,1,116,116,114,113,65
"5695",94,"[28]EDwhwHnKqGocIHcJCqGjsIDkexsJ",231,0.99569,28,232,1,231,1,1,0,1,1,116,116,116,115,65
"5696",95,"[28]EDwhwHnKqGocIHcJCqGjsIDkexsJ",219,0.995455,28,220,1,219,1,1,0,1,1,123,123,97,96,65
"5697",96,"[28]EDwhwHnKqGocIHcJCqGjsIDkexsJ",231,0.99569,28,232,1,231,1,1,0,1,1,114,114,118,117,65
"5698",97,"[28]EDwhwHnKqGocIHcJCqGjsIDkexsJ",233,0.995726,28,234,1,233,1,1,0,1,1,113,113,121,120,65
"5699",98,"[28]EDwhwHnKqGocIHcJCqGjsIDkexsJ",232,0.995708,28,233,1,232,1,1,0,1,1,112,112,121,120,65
"5700",99,"[28]EDwhwHnKqGocIHcJCqGjsIDkexsJ",239,0.995833,28,240,1,239,1,1,0,1,1,107,107,133,132,65
"5701",0,"[28]EjhtHnKqGocIHBJCrEhiByCyuJgG",225,0.995575,28,226,1,225,1,1,0,1,1,121,121,105,104,66
"5702",1,"[28]EjhtHnKqGocIHBJCrEhiByCyuJgG",231,0.99569,28,232,1,231,1,1,0,1,1,113,113,119,118,66
"5703",2,"[28]EjhtHnKqGocIHBJCrEhiByCyuJgG",235,0.995763,28,236,1,235,1,1,0,1,1,111,111,125,124,66
"5704",3,"[28]EjhtHnKqGocIHBJCrEhiByCyuJgG",230,0.995671,28,231,1,230,1,1,0,1,1,116,116,115,114,66
"5705",4,"[28]EjhtHnKqGocIHBJCrEhiByCyuJgG",232,0.995708,28,233,1,232,1,1,0,1,1,116,116,117,116,66
"5706",5,"[28]EjhtHnKqGocIHBJCrEhiByCyuJgG",230,0.995671,28,231,1,230,1,1,0,1,1,114,114,117,116,66
"5707",6,"[28]EjhtHnKqGocIHBJCrEhiByCyuJgG",225,0.995575,28,226,1,225,1,1,0,1,1,118,118,108,107,66
"5708",7,"[28]EjhtHnKqGocIHBJCrEhiByCyuJgG",230,0.995671,28,231,1,230,1,1,0,1,1,115,115,116,115,66
"5709",8,"[28]EjhtHnKqGocIHBJCrEhiByCyuJgG",235,0.995763,28,236,1,235,1,1,0,1,1,113,113,123,122,66
"5710",9,"[28]EjhtHnKqGocIHBJCrEhiByCyuJgG",226,0.995595,28,227,1,226,1,1,0,1,1,117,117,110,109,66
"5711",10,"[28]EjhtHnKqGocIHBJCrEhiByCyuJgG",231,0.99569,28,232,1,231,1,1,0,1,1,114,114,118,117,66
"5712",11,"[28]EjhtHnKqGocIHBJCrEhiByCyuJgG",222,0.995516,28,223,1,222,1,1,0,1,1,122,122,101,100,66
"5713",12,"[28]EjhtHnKqGocIHBJCrEhiByCyuJgG",225,0.995575,28,226,1,225,1,1,0,1,1,120,120,106,105,66
"5714",13,"[28]EjhtHnKqGocIHBJCrEhiByCyuJgG",225,0.995575,28,226,1,225,1,1,0,1,1,118,118,108,107,66
"5715",14,"[28]EjhtHnKqGocIHBJCrEhiByCyuJgG",238,0.995816,28,239,1,238,1,1,0,1,1,109,109,130,129,66
"5716",15,"[28]EjhtHnKqGocIHBJCrEhiByCyuJgG",229,0.995652,28,230,1,229,1,1,0,1,1,116,116,114,113,66
"5717",16,"[28]EjhtHnKqGocIHBJCrEhiByCyuJgG",227,0.995614,28,228,1,227,1,1,0,1,1,118,118,110,109,66
"5718",17,"[28]EjhtHnKqGocIHBJCrEhiByCyuJgG",240,0.995851,28,241,1,240,1,1,0,1,1,107,107,134,133,66
"5719",18,"[28]EjhtHnKqGocIHBJCrEhiByCyuJgG",235,0.995763,28,236,1,235,1,1,0,1,1,110,110,126,125,66
"5720",19,"[28]EjhtHnKqGocIHBJCrEhiByCyuJgG",228,0.995633,28,229,1,228,1,1,0,1,1,118,118,111,110,66
"5721",20,"[28]EjhtHnKqGocIHBJCrEhiByCyuJgG",234,0.995745,28,235,1,234,1,1,0,1,1,111,111,124,123,66
"5722",21,"[28]EjhtHnKqGocIHBJCrEhiByCyuJgG",231,0.99569,28,232,1,231,1,1,0,1,1,114,114,118,117,66
"5723",22,"[28]EjhtHnKqGocIHBJCrEhiByCyuJgG",230,0.995671,28,231,1,230,1,1,0,1,1,116,116,115,114,66
"5724",23,"[28]EjhtHnKqGocIHBJCrEhiByCyuJgG",226,0.995595,28,227,1,226,1,1,0,1,1,117,117,110,109,66
"5725",24,"[28]EjhtHnKqGocIHBJCrEhiByCyuJgG",232,0.995708,28,233,1,232,1,1,0,1,1,112,112,121,120,66
"5726",25,"[28]EjhtHnKqGocIHBJCrEhiByCyuJgG",244,0.995918,28,245,1,244,1,1,0,1,1,104,104,141,140,66
"5727",26,"[28]EjhtHnKqGocIHBJCrEhiByCyuJgG",220,0.995475,28,221,1,220,1,1,0,1,1,122,122,99,98,66
"5728",27,"[28]EjhtHnKqGocIHBJCrEhiByCyuJgG",236,0.995781,28,237,1,236,1,1,0,1,1,111,111,126,125,66
"5729",28,"[28]EjhtHnKqGocIHBJCrEhiByCyuJgG",227,0.995614,28,228,1,227,1,1,0,1,1,117,117,111,110,66
"5730",29,"[28]EjhtHnKqGocIHBJCrEhiByCyuJgG",226,0.995595,28,227,1,226,1,1,0,1,1,118,118,109,108,66
"5731",30,"[28]EjhtHnKqGocIHBJCrEhiByCyuJgG",237,0.995798,28,238,1,237,1,1,0,1,1,109,109,129,128,66
"5732",31,"[28]EjhtHnKqGocIHBJCrEhiByCyuJgG",225,0.995575,28,226,1,225,1,1,0,1,1,118,118,108,107,66
"5733",32,"[28]EjhtHnKqGocIHBJCrEhiByCyuJgG",231,0.99569,28,232,1,231,1,1,0,1,1,114,114,118,117,66
"5734",33,"[28]EjhtHnKqGocIHBJCrEhiByCyuJgG",232,0.995708,28,233,1,232,1,1,0,1,1,114,114,119,118,66
"5735",34,"[28]EjhtHnKqGocIHBJCrEhiByCyuJgG",231,0.99569,28,232,1,231,1,1,0,1,1,113,113,119,118,66
"5736",35,"[28]EjhtHnKqGocIHBJCrEhiByCyuJgG",227,0.995614,28,228,1,227,1,1,0,1,1,118,118,110,109,66
"5737",36,"[28]EjhtHnKqGocIHBJCrEhiByCyuJgG",232,0.995708,28,233,1,232,1,1,0,1,1,115,115,118,117,66
"5738",37,"[28]EjhtHnKqGocIHBJCrEhiByCyuJgG",233,0.995726,28,234,1,233,1,1,0,1,1,115,115,119,118,66
"5739",38,"[28]EjhtHnKqGocIHBJCrEhiByCyuJgG",222,0.995516,28,223,1,222,1,1,0,1,1,121,121,102,101,66
"5740",39,"[28]EjhtHnKqGocIHBJCrEhiByCyuJgG",229,0.995652,28,230,1,229,1,1,0,1,1,116,116,114,113,66
"5741",40,"[28]EjhtHnKqGocIHBJCrEhiByCyuJgG",228,0.995633,28,229,1,228,1,1,0,1,1,117,117,112,111,66
"5742",41,"[28]EjhtHnKqGocIHBJCrEhiByCyuJgG",218,0.995434,28,219,1,218,1,1,0,1,1,124,124,95,94,66
"5743",42,"[28]EjhtHnKqGocIHBJCrEhiByCyuJgG",220,0.995475,28,221,1,220,1,1,0,1,1,123,123,98,97,66
"5744",43,"[28]EjhtHnKqGocIHBJCrEhiByCyuJgG",229,0.995652,28,230,1,229,1,1,0,1,1,116,116,114,113,66
"5745",44,"[28]EjhtHnKqGocIHBJCrEhiByCyuJgG",232,0.995708,28,233,1,232,1,1,0,1,1,114,114,119,118,66
"5746",45,"[28]EjhtHnKqGocIHBJCrEhiByCyuJgG",226,0.995595,28,227,1,226,1,1,0,1,1,118,118,109,108,66
"5747",46,"[28]EjhtHnKqGocIHBJCrEhiByCyuJgG",230,0.995671,28,231,1,230,1,1,0,1,1,116,116,115,114,66
"5748",47,"[28]EjhtHnKqGocIHBJCrEhiByCyuJgG",242,0.995885,28,243,1,242,1,1,0,1,1,107,107,136,135,66
"5749",48,"[28]EjhtHnKqGocIHBJCrEhiByCyuJgG",229,0.995652,28,230,1,229,1,1,0,1,1,118,118,112,111,66
"5750",49,"[28]EjhtHnKqGocIHBJCrEhiByCyuJgG",235,0.995763,28,236,1,235,1,1,0,1,1,111,111,125,124,66
"5751",50,"[28]EjhtHnKqGocIHBJCrEhiByCyuJgG",239,0.995833,28,240,1,239,1,1,0,1,1,110,110,130,129,66
"5752",51,"[28]EjhtHnKqGocIHBJCrEhiByCyuJgG",233,0.995726,28,234,1,233,1,1,0,1,1,113,113,121,120,66
"5753",52,"[28]EjhtHnKqGocIHBJCrEhiByCyuJgG",227,0.995614,28,228,1,227,1,1,0,1,1,116,116,112,111,66
"5754",53,"[28]EjhtHnKqGocIHBJCrEhiByCyuJgG",232,0.995708,28,233,1,232,1,1,0,1,1,114,114,119,118,66
"5755",54,"[28]EjhtHnKqGocIHBJCrEhiByCyuJgG",226,0.995595,28,227,1,226,1,1,0,1,1,117,117,110,109,66
"5756",55,"[28]EjhtHnKqGocIHBJCrEhiByCyuJgG",235,0.995763,28,236,1,235,1,1,0,1,1,110,110,126,125,66
"5757",56,"[28]EjhtHnKqGocIHBJCrEhiByCyuJgG",227,0.995614,28,228,1,227,1,1,0,1,1,117,117,111,110,66
"5758",57,"[28]EjhtHnKqGocIHBJCrEhiByCyuJgG",230,0.995671,28,231,1,230,1,1,0,1,1,114,114,117,116,66
"5759",58,"[28]EjhtHnKqGocIHBJCrEhiByCyuJgG",229,0.995652,28,230,1,229,1,1,0,1,1,116,116,114,113,66
"5760",59,"[28]EjhtHnKqGocIHBJCrEhiByCyuJgG",234,0.995745,28,235,1,234,1,1,0,1,1,112,112,123,122,66
"5761",60,"[28]EjhtHnKqGocIHBJCrEhiByCyuJgG",232,0.995708,28,233,1,232,1,1,0,1,1,114,114,119,118,66
"5762",61,"[28]EjhtHnKqGocIHBJCrEhiByCyuJgG",226,0.995595,28,227,1,226,1,1,0,1,1,118,118,109,108,66
"5763",62,"[28]EjhtHnKqGocIHBJCrEhiByCyuJgG",237,0.995798,28,238,1,237,1,1,0,1,1,108,108,130,129,66
"5764",63,"[28]EjhtHnKqGocIHBJCrEhiByCyuJgG",229,0.995652,28,230,1,229,1,1,0,1,1,117,117,113,112,66
"5765",64,"[28]EjhtHnKqGocIHBJCrEhiByCyuJgG",233,0.995726,28,234,1,233,1,1,0,1,1,113,113,121,120,66
"5766",65,"[28]EjhtHnKqGocIHBJCrEhiByCyuJgG",225,0.995575,28,226,1,225,1,1,0,1,1,119,119,107,106,66
"5767",66,"[28]EjhtHnKqGocIHBJCrEhiByCyuJgG",244,0.995918,28,245,1,244,1,1,0,1,1,108,108,137,136,66
"5768",67,"[28]EjhtHnKqGocIHBJCrEhiByCyuJgG",231,0.99569,28,232,1,231,1,1,0,1,1,114,114,118,117,66
"5769",68,"[28]EjhtHnKqGocIHBJCrEhiByCyuJgG",224,0.995556,28,225,1,224,1,1,0,1,1,119,119,106,105,66
"5770",69,"[28]EjhtHnKqGocIHBJCrEhiByCyuJgG",226,0.995595,28,227,1,226,1,1,0,1,1,118,118,109,108,66
"5771",70,"[28]EjhtHnKqGocIHBJCrEhiByCyuJgG",225,0.995575,28,226,1,225,1,1,0,1,1,120,120,106,105,66
"5772",71,"[28]EjhtHnKqGocIHBJCrEhiByCyuJgG",230,0.995671,28,231,1,230,1,1,0,1,1,115,115,116,115,66
"5773",72,"[28]EjhtHnKqGocIHBJCrEhiByCyuJgG",222,0.995516,28,223,1,222,1,1,0,1,1,121,121,102,101,66
"5774",73,"[28]EjhtHnKqGocIHBJCrEhiByCyuJgG",235,0.995763,28,236,1,235,1,1,0,1,1,111,111,125,124,66
"5775",74,"[28]EjhtHnKqGocIHBJCrEhiByCyuJgG",237,0.995798,28,238,1,237,1,1,0,1,1,109,109,129,128,66
"5776",75,"[28]EjhtHnKqGocIHBJCrEhiByCyuJgG",236,0.995781,28,237,1,236,1,1,0,1,1,112,112,125,124,66
"5777",76,"[28]EjhtHnKqGocIHBJCrEhiByCyuJgG",238,0.995816,28,239,1,238,1,1,0,1,1,116,116,123,122,66
"5778",77,"[28]EjhtHnKqGocIHBJCrEhiByCyuJgG",226,0.995595,28,227,1,226,1,1,0,1,1,117,117,110,109,66
"5779",78,"[28]EjhtHnKqGocIHBJCrEhiByCyuJgG",226,0.995595,28,227,1,226,1,1,0,1,1,119,119,108,107,66
"5780",79,"[28]EjhtHnKqGocIHBJCrEhiByCyuJgG",242,0.995885,28,243,1,242,1,1,0,1,1,106,106,137,136,66
"5781",80,"[28]EjhtHnKqGocIHBJCrEhiByCyuJgG",223,0.995536,28,224,1,223,1,1,0,1,1,120,120,104,103,66
"5782",81,"[28]EjhtHnKqGocIHBJCrEhiByCyuJgG",242,0.995885,28,243,1,242,1,1,0,1,1,106,106,137,136,66
"5783",82,"[28]EjhtHnKqGocIHBJCrEhiByCyuJgG",234,0.995745,28,235,1,234,1,1,0,1,1,116,116,119,118,66
"5784",83,"[28]EjhtHnKqGocIHBJCrEhiByCyuJgG",240,0.995851,28,241,1,240,1,1,0,1,1,108,108,133,132,66
"5785",84,"[28]EjhtHnKqGocIHBJCrEhiByCyuJgG",230,0.995671,28,231,1,230,1,1,0,1,1,117,117,114,113,66
"5786",85,"[28]EjhtHnKqGocIHBJCrEhiByCyuJgG",235,0.995763,28,236,1,235,1,1,0,1,1,110,110,126,125,66
"5787",86,"[28]EjhtHnKqGocIHBJCrEhiByCyuJgG",242,0.995885,28,243,1,242,1,1,0,1,1,106,106,137,136,66
"5788",87,"[28]EjhtHnKqGocIHBJCrEhiByCyuJgG",230,0.995671,28,231,1,230,1,1,0,1,1,114,114,117,116,66
"5789",88,"[28]EjhtHnKqGocIHBJCrEhiByCyuJgG",230,0.995671,28,231,1,230,1,1,0,1,1,116,116,115,114,66
"5790",89,"[28]EjhtHnKqGocIHBJCrEhiByCyuJgG",231,0.99569,28,232,1,231,1,1,0,1,1,114,114,118,117,66
"5791",90,"[28]EjhtHnKqGocIHBJCrEhiByCyuJgG",219,0.995455,28,220,1,219,1,1,0,1,1,127,127,93,92,66
"5792",91,"[28]EjhtHnKqGocIHBJCrEhiByCyuJgG",237,0.995798,28,238,1,237,1,1,0,1,1,109,109,129,128,66
"5793",92,"[28]EjhtHnKqGocIHBJCrEhiByCyuJgG",230,0.995671,28,231,1,230,1,1,0,1,1,114,114,117,116,66
"5794",93,"[28]EjhtHnKqGocIHBJCrEhiByCyuJgG",228,0.995633,28,229,1,228,1,1,0,1,1,120,120,109,108,66
"5795",94,"[28]EjhtHnKqGocIHBJCrEhiByCyuJgG",231,0.99569,28,232,1,231,1,1,0,1,1,113,113,119,118,66
"5796",95,"[28]EjhtHnKqGocIHBJCrEhiByCyuJgG",231,0.99569,28,232,1,231,1,1,0,1,1,114,114,118,117,66
"5797",96,"[28]EjhtHnKqGocIHBJCrEhiByCyuJgG",233,0.995726,28,234,1,233,1,1,0,1,1,114,114,120,119,66
"5798",97,"[28]EjhtHnKqGocIHBJCrEhiByCyuJgG",225,0.995575,28,226,1,225,1,1,0,1,1,119,119,107,106,66
"5799",98,"[28]EjhtHnKqGocIHBJCrEhiByCyuJgG",223,0.995536,28,224,1,223,1,1,0,1,1,122,122,102,101,66
"5800",99,"[28]EjhtHnKqGocIHBJCrEhiByCyuJgG",235,0.995763,28,236,1,235,1,1,0,1,1,110,110,126,125,66
"5801",0,"[35]EjwxHnKqGocIHBJCtpIlDzdlxhnEcpxiFsm",235,0.995763,35,236,1,235,1,1,0,1,1,113,113,123,122,67
"5802",1,"[35]EjwxHnKqGocIHBJCtpIlDzdlxhnEcpxiFsm",229,0.995652,35,230,1,229,1,1,0,1,1,116,116,114,113,67
"5803",2,"[35]EjwxHnKqGocIHBJCtpIlDzdlxhnEcpxiFsm",225,0.995575,35,226,1,225,1,1,0,1,1,123,123,103,102,67
"5804",3,"[35]EjwxHnKqGocIHBJCtpIlDzdlxhnEcpxiFsm",230,0.995671,35,231,1,230,1,1,0,1,1,114,114,117,116,67
"5805",4,"[35]EjwxHnKqGocIHBJCtpIlDzdlxhnEcpxiFsm",227,0.995614,35,228,1,227,1,1,0,1,1,116,116,112,111,67
"5806",5,"[35]EjwxHnKqGocIHBJCtpIlDzdlxhnEcpxiFsm",232,0.995708,35,233,1,232,1,1,0,1,1,113,113,120,119,67
"5807",6,"[35]EjwxHnKqGocIHBJCtpIlDzdlxhnEcpxiFsm",236,0.995781,35,237,1,236,1,1,0,1,1,110,110,127,126,67
"5808",7,"[35]EjwxHnKqGocIHBJCtpIlDzdlxhnEcpxiFsm",230,0.995671,35,231,1,230,1,1,0,1,1,116,116,115,114,67
"5809",8,"[35]EjwxHnKqGocIHBJCtpIlDzdlxhnEcpxiFsm",234,0.995745,35,235,1,234,1,1,0,1,1,111,111,124,123,67
"5810",9,"[35]EjwxHnKqGocIHBJCtpIlDzdlxhnEcpxiFsm",236,0.995781,35,237,1,236,1,1,0,1,1,110,110,127,126,67
"5811",10,"[35]EjwxHnKqGocIHBJCtpIlDzdlxhnEcpxiFsm",240,0.995851,35,241,1,240,1,1,0,1,1,107,107,134,133,67
"5812",11,"[35]EjwxHnKqGocIHBJCtpIlDzdlxhnEcpxiFsm",232,0.995708,35,233,1,232,1,1,0,1,1,112,112,121,120,67
"5813",12,"[35]EjwxHnKqGocIHBJCtpIlDzdlxhnEcpxiFsm",238,0.995816,35,239,1,238,1,1,0,1,1,108,108,131,130,67
"5814",13,"[35]EjwxHnKqGocIHBJCtpIlDzdlxhnEcpxiFsm",236,0.995781,35,237,1,236,1,1,0,1,1,109,109,128,127,67
"5815",14,"[35]EjwxHnKqGocIHBJCtpIlDzdlxhnEcpxiFsm",235,0.995763,35,236,1,235,1,1,0,1,1,110,110,126,125,67
"5816",15,"[35]EjwxHnKqGocIHBJCtpIlDzdlxhnEcpxiFsm",235,0.995763,35,236,1,235,1,1,0,1,1,111,111,125,124,67
"5817",16,"[35]EjwxHnKqGocIHBJCtpIlDzdlxhnEcpxiFsm",232,0.995708,35,233,1,232,1,1,0,1,1,113,113,120,119,67
"5818",17,"[35]EjwxHnKqGocIHBJCtpIlDzdlxhnEcpxiFsm",233,0.995726,35,234,1,233,1,1,0,1,1,113,113,121,120,67
"5819",18,"[35]EjwxHnKqGocIHBJCtpIlDzdlxhnEcpxiFsm",230,0.995671,35,231,1,230,1,1,0,1,1,114,114,117,116,67
"5820",19,"[35]EjwxHnKqGocIHBJCtpIlDzdlxhnEcpxiFsm",234,0.995745,35,235,1,234,1,1,0,1,1,112,112,123,122,67
"5821",20,"[35]EjwxHnKqGocIHBJCtpIlDzdlxhnEcpxiFsm",226,0.995595,35,227,1,226,1,1,0,1,1,117,117,110,109,67
"5822",21,"[35]EjwxHnKqGocIHBJCtpIlDzdlxhnEcpxiFsm",237,0.995798,35,238,1,237,1,1,0,1,1,109,109,129,128,67
"5823",22,"[35]EjwxHnKqGocIHBJCtpIlDzdlxhnEcpxiFsm",233,0.995726,35,234,1,233,1,1,0,1,1,114,114,120,119,67
"5824",23,"[35]EjwxHnKqGocIHBJCtpIlDzdlxhnEcpxiFsm",235,0.995763,35,236,1,235,1,1,0,1,1,111,111,125,124,67
"5825",24,"[35]EjwxHnKqGocIHBJCtpIlDzdlxhnEcpxiFsm",228,0.995633,35,229,1,228,1,1,0,1,1,116,116,113,112,67
"5826",25,"[35]EjwxHnKqGocIHBJCtpIlDzdlxhnEcpxiFsm",232,0.995708,35,233,1,232,1,1,0,1,1,114,114,119,118,67
"5827",26,"[35]EjwxHnKqGocIHBJCtpIlDzdlxhnEcpxiFsm",230,0.995671,35,231,1,230,1,1,0,1,1,115,115,116,115,67
"5828",27,"[35]EjwxHnKqGocIHBJCtpIlDzdlxhnEcpxiFsm",236,0.995781,35,237,1,236,1,1,0,1,1,111,111,126,125,67
"5829",28,"[35]EjwxHnKqGocIHBJCtpIlDzdlxhnEcpxiFsm",232,0.995708,35,233,1,232,1,1,0,1,1,113,113,120,119,67
"5830",29,"[35]EjwxHnKqGocIHBJCtpIlDzdlxhnEcpxiFsm",233,0.995726,35,234,1,233,1,1,0,1,1,112,112,122,121,67
"5831",30,"[35]EjwxHnKqGocIHBJCtpIlDzdlxhnEcpxiFsm",235,0.995763,35,236,1,235,1,1,0,1,1,113,113,123,122,67
"5832",31,"[35]EjwxHnKqGocIHBJCtpIlDzdlxhnEcpxiFsm",236,0.995781,35,237,1,236,1,1,0,1,1,110,110,127,126,67
"5833",32,"[35]EjwxHnKqGocIHBJCtpIlDzdlxhnEcpxiFsm",232,0.995708,35,233,1,232,1,1,0,1,1,112,112,121,120,67
"5834",33,"[35]EjwxHnKqGocIHBJCtpIlDzdlxhnEcpxiFsm",234,0.995745,35,235,1,234,1,1,0,1,1,111,111,124,123,67
"5835",34,"[35]EjwxHnKqGocIHBJCtpIlDzdlxhnEcpxiFsm",238,0.995816,35,239,1,238,1,1,0,1,1,108,108,131,130,67
"5836",35,"[35]EjwxHnKqGocIHBJCtpIlDzdlxhnEcpxiFsm",236,0.995781,35,237,1,236,1,1,0,1,1,110,110,127,126,67
"5837",36,"[35]EjwxHnKqGocIHBJCtpIlDzdlxhnEcpxiFsm",232,0.995708,35,233,1,232,1,1,0,1,1,112,112,121,120,67
"5838",37,"[35]EjwxHnKqGocIHBJCtpIlDzdlxhnEcpxiFsm",231,0.99569,35,232,1,231,1,1,0,1,1,114,114,118,117,67
"5839",38,"[35]EjwxHnKqGocIHBJCtpIlDzdlxhnEcpxiFsm",223,0.995536,35,224,1,223,1,1,0,1,1,121,121,103,102,67
"5840",39,"[35]EjwxHnKqGocIHBJCtpIlDzdlxhnEcpxiFsm",222,0.995516,35,223,1,222,1,1,0,1,1,121,121,102,101,67
"5841",40,"[35]EjwxHnKqGocIHBJCtpIlDzdlxhnEcpxiFsm",235,0.995763,35,236,1,235,1,1,0,1,1,111,111,125,124,67
"5842",41,"[35]EjwxHnKqGocIHBJCtpIlDzdlxhnEcpxiFsm",226,0.995595,35,227,1,226,1,1,0,1,1,117,117,110,109,67
"5843",42,"[35]EjwxHnKqGocIHBJCtpIlDzdlxhnEcpxiFsm",231,0.99569,35,232,1,231,1,1,0,1,1,114,114,118,117,67
"5844",43,"[35]EjwxHnKqGocIHBJCtpIlDzdlxhnEcpxiFsm",234,0.995745,35,235,1,234,1,1,0,1,1,113,113,122,121,67
"5845",44,"[35]EjwxHnKqGocIHBJCtpIlDzdlxhnEcpxiFsm",234,0.995745,35,235,1,234,1,1,0,1,1,111,111,124,123,67
"5846",45,"[35]EjwxHnKqGocIHBJCtpIlDzdlxhnEcpxiFsm",240,0.995851,35,241,1,240,1,1,0,1,1,109,109,132,131,67
"5847",46,"[35]EjwxHnKqGocIHBJCtpIlDzdlxhnEcpxiFsm",225,0.995575,35,226,1,225,1,1,0,1,1,120,120,106,105,67
"5848",47,"[35]EjwxHnKqGocIHBJCtpIlDzdlxhnEcpxiFsm",236,0.995781,35,237,1,236,1,1,0,1,1,113,113,124,123,67
"5849",48,"[35]EjwxHnKqGocIHBJCtpIlDzdlxhnEcpxiFsm",228,0.995633,35,229,1,228,1,1,0,1,1,117,117,112,111,67
"5850",49,"[35]EjwxHnKqGocIHBJCtpIlDzdlxhnEcpxiFsm",236,0.995781,35,237,1,236,1,1,0,1,1,109,109,128,127,67
"5851",50,"[35]EjwxHnKqGocIHBJCtpIlDzdlxhnEcpxiFsm",227,0.995614,35,228,1,227,1,1,0,1,1,116,116,112,111,67
"5852",51,"[35]EjwxHnKqGocIHBJCtpIlDzdlxhnEcpxiFsm",232,0.995708,35,233,1,232,1,1,0,1,1,112,112,121,120,67
"5853",52,"[35]EjwxHnKqGocIHBJCtpIlDzdlxhnEcpxiFsm",221,0.995495,35,222,1,221,1,1,0,1,1,123,123,99,98,67
"5854",53,"[35]EjwxHnKqGocIHBJCtpIlDzdlxhnEcpxiFsm",230,0.995671,35,231,1,230,1,1,0,1,1,115,115,116,115,67
"5855",54,"[35]EjwxHnKqGocIHBJCtpIlDzdlxhnEcpxiFsm",234,0.995745,35,235,1,234,1,1,0,1,1,114,114,121,120,67
"5856",55,"[35]EjwxHnKqGocIHBJCtpIlDzdlxhnEcpxiFsm",212,0.995305,35,213,1,212,1,1,0,1,1,128,128,85,84,67
"5857",56,"[35]EjwxHnKqGocIHBJCtpIlDzdlxhnEcpxiFsm",221,0.995495,35,222,1,221,1,1,0,1,1,123,123,99,98,67
"5858",57,"[35]EjwxHnKqGocIHBJCtpIlDzdlxhnEcpxiFsm",225,0.995575,35,226,1,225,1,1,0,1,1,121,121,105,104,67
"5859",58,"[35]EjwxHnKqGocIHBJCtpIlDzdlxhnEcpxiFsm",232,0.995708,35,233,1,232,1,1,0,1,1,115,115,118,117,67
"5860",59,"[35]EjwxHnKqGocIHBJCtpIlDzdlxhnEcpxiFsm",225,0.995575,35,226,1,225,1,1,0,1,1,119,119,107,106,67
"5861",60,"[35]EjwxHnKqGocIHBJCtpIlDzdlxhnEcpxiFsm",237,0.995798,35,238,1,237,1,1,0,1,1,108,108,130,129,67
"5862",61,"[35]EjwxHnKqGocIHBJCtpIlDzdlxhnEcpxiFsm",239,0.995833,35,240,1,239,1,1,0,1,1,110,110,130,129,67
"5863",62,"[35]EjwxHnKqGocIHBJCtpIlDzdlxhnEcpxiFsm",237,0.995798,35,238,1,237,1,1,0,1,1,110,110,128,127,67
"5864",63,"[35]EjwxHnKqGocIHBJCtpIlDzdlxhnEcpxiFsm",229,0.995652,35,230,1,229,1,1,0,1,1,115,115,115,114,67
"5865",64,"[35]EjwxHnKqGocIHBJCtpIlDzdlxhnEcpxiFsm",237,0.995798,35,238,1,237,1,1,0,1,1,109,109,129,128,67
"5866",65,"[35]EjwxHnKqGocIHBJCtpIlDzdlxhnEcpxiFsm",228,0.995633,35,229,1,228,1,1,0,1,1,117,117,112,111,67
"5867",66,"[35]EjwxHnKqGocIHBJCtpIlDzdlxhnEcpxiFsm",226,0.995595,35,227,1,226,1,1,0,1,1,117,117,110,109,67
"5868",67,"[35]EjwxHnKqGocIHBJCtpIlDzdlxhnEcpxiFsm",230,0.995671,35,231,1,230,1,1,0,1,1,114,114,117,116,67
"5869",68,"[35]EjwxHnKqGocIHBJCtpIlDzdlxhnEcpxiFsm",226,0.995595,35,227,1,226,1,1,0,1,1,118,118,109,108,67
"5870",69,"[35]EjwxHnKqGocIHBJCtpIlDzdlxhnEcpxiFsm",227,0.995614,35,228,1,227,1,1,0,1,1,118,118,110,109,67
"5871",70,"[35]EjwxHnKqGocIHBJCtpIlDzdlxhnEcpxiFsm",225,0.995575,35,226,1,225,1,1,0,1,1,118,118,108,107,67
"5872",71,"[35]EjwxHnKqGocIHBJCtpIlDzdlxhnEcpxiFsm",231,0.99569,35,232,1,231,1,1,0,1,1,114,114,118,117,67
"5873",72,"[35]EjwxHnKqGocIHBJCtpIlDzdlxhnEcpxiFsm",223,0.995536,35,224,1,223,1,1,0,1,1,120,120,104,103,67
"5874",73,"[35]EjwxHnKqGocIHBJCtpIlDzdlxhnEcpxiFsm",240,0.995851,35,241,1,240,1,1,0,1,1,108,108,133,132,67
"5875",74,"[35]EjwxHnKqGocIHBJCtpIlDzdlxhnEcpxiFsm",232,0.995708,35,233,1,232,1,1,0,1,1,113,113,120,119,67
"5876",75,"[35]EjwxHnKqGocIHBJCtpIlDzdlxhnEcpxiFsm",227,0.995614,35,228,1,227,1,1,0,1,1,117,117,111,110,67
"5877",76,"[35]EjwxHnKqGocIHBJCtpIlDzdlxhnEcpxiFsm",225,0.995575,35,226,1,225,1,1,0,1,1,119,119,107,106,67
"5878",77,"[35]EjwxHnKqGocIHBJCtpIlDzdlxhnEcpxiFsm",229,0.995652,35,230,1,229,1,1,0,1,1,116,116,114,113,67
"5879",78,"[35]EjwxHnKqGocIHBJCtpIlDzdlxhnEcpxiFsm",227,0.995614,35,228,1,227,1,1,0,1,1,117,117,111,110,67
"5880",79,"[35]EjwxHnKqGocIHBJCtpIlDzdlxhnEcpxiFsm",231,0.99569,35,232,1,231,1,1,0,1,1,115,115,117,116,67
"5881",80,"[35]EjwxHnKqGocIHBJCtpIlDzdlxhnEcpxiFsm",231,0.99569,35,232,1,231,1,1,0,1,1,113,113,119,118,67
"5882",81,"[35]EjwxHnKqGocIHBJCtpIlDzdlxhnEcpxiFsm",230,0.995671,35,231,1,230,1,1,0,1,1,116,116,115,114,67
"5883",82,"[35]EjwxHnKqGocIHBJCtpIlDzdlxhnEcpxiFsm",238,0.995816,35,239,1,238,1,1,0,1,1,110,110,129,128,67
"5884",83,"[35]EjwxHnKqGocIHBJCtpIlDzdlxhnEcpxiFsm",233,0.995726,35,234,1,233,1,1,0,1,1,112,112,122,121,67
"5885",84,"[35]EjwxHnKqGocIHBJCtpIlDzdlxhnEcpxiFsm",222,0.995516,35,223,1,222,1,1,0,1,1,122,122,101,100,67
"5886",85,"[35]EjwxHnKqGocIHBJCtpIlDzdlxhnEcpxiFsm",233,0.995726,35,234,1,233,1,1,0,1,1,112,112,122,121,67
"5887",86,"[35]EjwxHnKqGocIHBJCtpIlDzdlxhnEcpxiFsm",230,0.995671,35,231,1,230,1,1,0,1,1,116,116,115,114,67
"5888",87,"[35]EjwxHnKqGocIHBJCtpIlDzdlxhnEcpxiFsm",237,0.995798,35,238,1,237,1,1,0,1,1,108,108,130,129,67
"5889",88,"[35]EjwxHnKqGocIHBJCtpIlDzdlxhnEcpxiFsm",233,0.995726,35,234,1,233,1,1,0,1,1,113,113,121,120,67
"5890",89,"[35]EjwxHnKqGocIHBJCtpIlDzdlxhnEcpxiFsm",221,0.995495,35,222,1,221,1,1,0,1,1,121,121,101,100,67
"5891",90,"[35]EjwxHnKqGocIHBJCtpIlDzdlxhnEcpxiFsm",232,0.995708,35,233,1,232,1,1,0,1,1,113,113,120,119,67
"5892",91,"[35]EjwxHnKqGocIHBJCtpIlDzdlxhnEcpxiFsm",231,0.99569,35,232,1,231,1,1,0,1,1,116,116,116,115,67
"5893",92,"[35]EjwxHnKqGocIHBJCtpIlDzdlxhnEcpxiFsm",232,0.995708,35,233,1,232,1,1,0,1,1,113,113,120,119,67
"5894",93,"[35]EjwxHnKqGocIHBJCtpIlDzdlxhnEcpxiFsm",235,0.995763,35,236,1,235,1,1,0,1,1,112,112,124,123,67
"5895",94,"[35]EjwxHnKqGocIHBJCtpIlDzdlxhnEcpxiFsm",226,0.995595,35,227,1,226,1,1,0,1,1,117,117,110,109,67
"5896",95,"[35]EjwxHnKqGocIHBJCtpIlDzdlxhnEcpxiFsm",228,0.995633,35,229,1,228,1,1,0,1,1,118,118,111,110,67
"5897",96,"[35]EjwxHnKqGocIHBJCtpIlDzdlxhnEcpxiFsm",244,0.995918,35,245,1,244,1,1,0,1,1,104,104,141,140,67
"5898",97,"[35]EjwxHnKqGocIHBJCtpIlDzdlxhnEcpxiFsm",236,0.995781,35,237,1,236,1,1,0,1,1,109,109,128,127,67
"5899",98,"[35]EjwxHnKqGocIHBJCtpIlDzdlxhnEcpxiFsm",218,0.995434,35,219,1,218,1,1,0,1,1,124,124,95,94,67
"5900",99,"[35]EjwxHnKqGocIHBJCtpIlDzdlxhnEcpxiFsm",230,0.995671,35,231,1,230,1,1,0,1,1,114,114,117,116,67
"5901",0,"[30]EepAHgKxHnKqGocIHcJCBFpdxeqgwD",230,0.995671,30,231,1,230,1,1,0,1,1,115,115,116,115,68
"5902",1,"[30]EepAHgKxHnKqGocIHcJCBFpdxeqgwD",234,0.995745,30,235,1,234,1,1,0,1,1,112,112,123,122,68
"5903",2,"[30]EepAHgKxHnKqGocIHcJCBFpdxeqgwD",237,0.995798,30,238,1,237,1,1,0,1,1,111,111,127,126,68
"5904",3,"[30]EepAHgKxHnKqGocIHcJCBFpdxeqgwD",238,0.995816,30,239,1,238,1,1,0,1,1,109,109,130,129,68
"5905",4,"[30]EepAHgKxHnKqGocIHcJCBFpdxeqgwD",235,0.995763,30,236,1,235,1,1,0,1,1,110,110,126,125,68
"5906",5,"[30]EepAHgKxHnKqGocIHcJCBFpdxeqgwD",229,0.995652,30,230,1,229,1,1,0,1,1,115,115,115,114,68
"5907",6,"[30]EepAHgKxHnKqGocIHcJCBFpdxeqgwD",235,0.995763,30,236,1,235,1,1,0,1,1,111,111,125,124,68
"5908",7,"[30]EepAHgKxHnKqGocIHcJCBFpdxeqgwD",234,0.995745,30,235,1,234,1,1,0,1,1,111,111,124,123,68
"5909",8,"[30]EepAHgKxHnKqGocIHcJCBFpdxeqgwD",231,0.99569,30,232,1,231,1,1,0,1,1,113,113,119,118,68
"5910",9,"[30]EepAHgKxHnKqGocIHcJCBFpdxeqgwD",241,0.995868,30,242,1,241,1,1,0,1,1,106,106,136,135,68
"5911",10,"[30]EepAHgKxHnKqGocIHcJCBFpdxeqgwD",236,0.995781,30,237,1,236,1,1,0,1,1,109,109,128,127,68
"5912",11,"[30]EepAHgKxHnKqGocIHcJCBFpdxeqgwD",233,0.995726,30,234,1,233,1,1,0,1,1,112,112,122,121,68
"5913",12,"[30]EepAHgKxHnKqGocIHcJCBFpdxeqgwD",234,0.995745,30,235,1,234,1,1,0,1,1,112,112,123,122,68
"5914",13,"[30]EepAHgKxHnKqGocIHcJCBFpdxeqgwD",235,0.995763,30,236,1,235,1,1,0,1,1,111,111,125,124,68
"5915",14,"[30]EepAHgKxHnKqGocIHcJCBFpdxeqgwD",234,0.995745,30,235,1,234,1,1,0,1,1,113,113,122,121,68
"5916",15,"[30]EepAHgKxHnKqGocIHcJCBFpdxeqgwD",226,0.995595,30,227,1,226,1,1,0,1,1,121,121,106,105,68
"5917",16,"[30]EepAHgKxHnKqGocIHcJCBFpdxeqgwD",241,0.995868,30,242,1,241,1,1,0,1,1,109,109,133,132,68
"5918",17,"[30]EepAHgKxHnKqGocIHcJCBFpdxeqgwD",241,0.995868,30,242,1,241,1,1,0,1,1,105,105,137,136,68
"5919",18,"[30]EepAHgKxHnKqGocIHcJCBFpdxeqgwD",224,0.995556,30,225,1,224,1,1,0,1,1,119,119,106,105,68
"5920",19,"[30]EepAHgKxHnKqGocIHcJCBFpdxeqgwD",228,0.995633,30,229,1,228,1,1,0,1,1,117,117,112,111,68
"5921",20,"[30]EepAHgKxHnKqGocIHcJCBFpdxeqgwD",233,0.995726,30,234,1,233,1,1,0,1,1,112,112,122,121,68
"5922",21,"[30]EepAHgKxHnKqGocIHcJCBFpdxeqgwD",239,0.995833,30,240,1,239,1,1,0,1,1,109,109,131,130,68
"5923",22,"[30]EepAHgKxHnKqGocIHcJCBFpdxeqgwD",230,0.995671,30,231,1,230,1,1,0,1,1,114,114,117,116,68
"5924",23,"[30]EepAHgKxHnKqGocIHcJCBFpdxeqgwD",230,0.995671,30,231,1,230,1,1,0,1,1,115,115,116,115,68
"5925",24,"[30]EepAHgKxHnKqGocIHcJCBFpdxeqgwD",231,0.99569,30,232,1,231,1,1,0,1,1,114,114,118,117,68
"5926",25,"[30]EepAHgKxHnKqGocIHcJCBFpdxeqgwD",222,0.995516,30,223,1,222,1,1,0,1,1,122,122,101,100,68
"5927",26,"[30]EepAHgKxHnKqGocIHcJCBFpdxeqgwD",233,0.995726,30,234,1,233,1,1,0,1,1,113,113,121,120,68
"5928",27,"[30]EepAHgKxHnKqGocIHcJCBFpdxeqgwD",226,0.995595,30,227,1,226,1,1,0,1,1,119,119,108,107,68
"5929",28,"[30]EepAHgKxHnKqGocIHcJCBFpdxeqgwD",218,0.995434,30,219,1,218,1,1,0,1,1,125,125,94,93,68
"5930",29,"[30]EepAHgKxHnKqGocIHcJCBFpdxeqgwD",223,0.995536,30,224,1,223,1,1,0,1,1,120,120,104,103,68
"5931",30,"[30]EepAHgKxHnKqGocIHcJCBFpdxeqgwD",240,0.995851,30,241,1,240,1,1,0,1,1,108,108,133,132,68
"5932",31,"[30]EepAHgKxHnKqGocIHcJCBFpdxeqgwD",237,0.995798,30,238,1,237,1,1,0,1,1,109,109,129,128,68
"5933",32,"[30]EepAHgKxHnKqGocIHcJCBFpdxeqgwD",233,0.995726,30,234,1,233,1,1,0,1,1,113,113,121,120,68
"5934",33,"[30]EepAHgKxHnKqGocIHcJCBFpdxeqgwD",221,0.995495,30,222,1,221,1,1,0,1,1,122,122,100,99,68
"5935",34,"[30]EepAHgKxHnKqGocIHcJCBFpdxeqgwD",225,0.995575,30,226,1,225,1,1,0,1,1,119,119,107,106,68
"5936",35,"[30]EepAHgKxHnKqGocIHcJCBFpdxeqgwD",228,0.995633,30,229,1,228,1,1,0,1,1,116,116,113,112,68
"5937",36,"[30]EepAHgKxHnKqGocIHcJCBFpdxeqgwD",225,0.995575,30,226,1,225,1,1,0,1,1,118,118,108,107,68
"5938",37,"[30]EepAHgKxHnKqGocIHcJCBFpdxeqgwD",226,0.995595,30,227,1,226,1,1,0,1,1,118,118,109,108,68
"5939",38,"[30]EepAHgKxHnKqGocIHcJCBFpdxeqgwD",231,0.99569,30,232,1,231,1,1,0,1,1,113,113,119,118,68
"5940",39,"[30]EepAHgKxHnKqGocIHcJCBFpdxeqgwD",226,0.995595,30,227,1,226,1,1,0,1,1,117,117,110,109,68
"5941",40,"[30]EepAHgKxHnKqGocIHcJCBFpdxeqgwD",233,0.995726,30,234,1,233,1,1,0,1,1,113,113,121,120,68
"5942",41,"[30]EepAHgKxHnKqGocIHcJCBFpdxeqgwD",236,0.995781,30,237,1,236,1,1,0,1,1,109,109,128,127,68
"5943",42,"[30]EepAHgKxHnKqGocIHcJCBFpdxeqgwD",230,0.995671,30,231,1,230,1,1,0,1,1,114,114,117,116,68
"5944",43,"[30]EepAHgKxHnKqGocIHcJCBFpdxeqgwD",235,0.995763,30,236,1,235,1,1,0,1,1,113,113,123,122,68
"5945",44,"[30]EepAHgKxHnKqGocIHcJCBFpdxeqgwD",242,0.995885,30,243,1,242,1,1,0,1,1,109,109,134,133,68
"5946",45,"[30]EepAHgKxHnKqGocIHcJCBFpdxeqgwD",232,0.995708,30,233,1,232,1,1,0,1,1,113,113,120,119,68
"5947",46,"[30]EepAHgKxHnKqGocIHcJCBFpdxeqgwD",243,0.995902,30,244,1,243,1,1,0,1,1,106,106,138,137,68
"5948",47,"[30]EepAHgKxHnKqGocIHcJCBFpdxeqgwD",236,0.995781,30,237,1,236,1,1,0,1,1,111,111,126,125,68
"5949",48,"[30]EepAHgKxHnKqGocIHcJCBFpdxeqgwD",234,0.995745,30,235,1,234,1,1,0,1,1,112,112,123,122,68
"5950",49,"[30]EepAHgKxHnKqGocIHcJCBFpdxeqgwD",236,0.995781,30,237,1,236,1,1,0,1,1,109,109,128,127,68
"5951",50,"[30]EepAHgKxHnKqGocIHcJCBFpdxeqgwD",222,0.995516,30,223,1,222,1,1,0,1,1,121,121,102,101,68
"5952",51,"[30]EepAHgKxHnKqGocIHcJCBFpdxeqgwD",222,0.995516,30,223,1,222,1,1,0,1,1,121,121,102,101,68
"5953",52,"[30]EepAHgKxHnKqGocIHcJCBFpdxeqgwD",237,0.995798,30,238,1,237,1,1,0,1,1,109,109,129,128,68
"5954",53,"[30]EepAHgKxHnKqGocIHcJCBFpdxeqgwD",233,0.995726,30,234,1,233,1,1,0,1,1,112,112,122,121,68
"5955",54,"[30]EepAHgKxHnKqGocIHcJCBFpdxeqgwD",243,0.995902,30,244,1,243,1,1,0,1,1,104,104,140,139,68
"5956",55,"[30]EepAHgKxHnKqGocIHcJCBFpdxeqgwD",239,0.995833,30,240,1,239,1,1,0,1,1,109,109,131,130,68
"5957",56,"[30]EepAHgKxHnKqGocIHcJCBFpdxeqgwD",212,0.995305,30,213,1,212,1,1,0,1,1,130,130,83,82,68
"5958",57,"[30]EepAHgKxHnKqGocIHcJCBFpdxeqgwD",237,0.995798,30,238,1,237,1,1,0,1,1,111,111,127,126,68
"5959",58,"[30]EepAHgKxHnKqGocIHcJCBFpdxeqgwD",231,0.99569,30,232,1,231,1,1,0,1,1,114,114,118,117,68
"5960",59,"[30]EepAHgKxHnKqGocIHcJCBFpdxeqgwD",233,0.995726,30,234,1,233,1,1,0,1,1,115,115,119,118,68
"5961",60,"[30]EepAHgKxHnKqGocIHcJCBFpdxeqgwD",233,0.995726,30,234,1,233,1,1,0,1,1,112,112,122,121,68
"5962",61,"[30]EepAHgKxHnKqGocIHcJCBFpdxeqgwD",234,0.995745,30,235,1,234,1,1,0,1,1,113,113,122,121,68
"5963",62,"[30]EepAHgKxHnKqGocIHcJCBFpdxeqgwD",240,0.995851,30,241,1,240,1,1,0,1,1,106,106,135,134,68
"5964",63,"[30]EepAHgKxHnKqGocIHcJCBFpdxeqgwD",228,0.995633,30,229,1,228,1,1,0,1,1,116,116,113,112,68
"5965",64,"[30]EepAHgKxHnKqGocIHcJCBFpdxeqgwD",231,0.99569,30,232,1,231,1,1,0,1,1,113,113,119,118,68
"5966",65,"[30]EepAHgKxHnKqGocIHcJCBFpdxeqgwD",230,0.995671,30,231,1,230,1,1,0,1,1,116,116,115,114,68
"5967",66,"[30]EepAHgKxHnKqGocIHcJCBFpdxeqgwD",226,0.995595,30,227,1,226,1,1,0,1,1,117,117,110,109,68
"5968",67,"[30]EepAHgKxHnKqGocIHcJCBFpdxeqgwD",220,0.995475,30,221,1,220,1,1,0,1,1,122,122,99,98,68
"5969",68,"[30]EepAHgKxHnKqGocIHcJCBFpdxeqgwD",232,0.995708,30,233,1,232,1,1,0,1,1,114,114,119,118,68
"5970",69,"[30]EepAHgKxHnKqGocIHcJCBFpdxeqgwD",221,0.995495,30,222,1,221,1,1,0,1,1,123,123,99,98,68
"5971",70,"[30]EepAHgKxHnKqGocIHcJCBFpdxeqgwD",238,0.995816,30,239,1,238,1,1,0,1,1,110,110,129,128,68
"5972",71,"[30]EepAHgKxHnKqGocIHcJCBFpdxeqgwD",240,0.995851,30,241,1,240,1,1,0,1,1,106,106,135,134,68
"5973",72,"[30]EepAHgKxHnKqGocIHcJCBFpdxeqgwD",230,0.995671,30,231,1,230,1,1,0,1,1,115,115,116,115,68
"5974",73,"[30]EepAHgKxHnKqGocIHcJCBFpdxeqgwD",224,0.995556,30,225,1,224,1,1,0,1,1,119,119,106,105,68
"5975",74,"[30]EepAHgKxHnKqGocIHcJCBFpdxeqgwD",231,0.99569,30,232,1,231,1,1,0,1,1,115,115,117,116,68
"5976",75,"[30]EepAHgKxHnKqGocIHcJCBFpdxeqgwD",237,0.995798,30,238,1,237,1,1,0,1,1,112,112,126,125,68
"5977",76,"[30]EepAHgKxHnKqGocIHcJCBFpdxeqgwD",226,0.995595,30,227,1,226,1,1,0,1,1,117,117,110,109,68
"5978",77,"[30]EepAHgKxHnKqGocIHcJCBFpdxeqgwD",234,0.995745,30,235,1,234,1,1,0,1,1,111,111,124,123,68
"5979",78,"[30]EepAHgKxHnKqGocIHcJCBFpdxeqgwD",221,0.995495,30,222,1,221,1,1,0,1,1,125,125,97,96,68
"5980",79,"[30]EepAHgKxHnKqGocIHcJCBFpdxeqgwD",229,0.995652,30,230,1,229,1,1,0,1,1,118,118,112,111,68
"5981",80,"[30]EepAHgKxHnKqGocIHcJCBFpdxeqgwD",222,0.995516,30,223,1,222,1,1,0,1,1,121,121,102,101,68
"5982",81,"[30]EepAHgKxHnKqGocIHcJCBFpdxeqgwD",236,0.995781,30,237,1,236,1,1,0,1,1,109,109,128,127,68
"5983",82,"[30]EepAHgKxHnKqGocIHcJCBFpdxeqgwD",239,0.995833,30,240,1,239,1,1,0,1,1,108,108,132,131,68
"5984",83,"[30]EepAHgKxHnKqGocIHcJCBFpdxeqgwD",229,0.995652,30,230,1,229,1,1,0,1,1,117,117,113,112,68
"5985",84,"[30]EepAHgKxHnKqGocIHcJCBFpdxeqgwD",243,0.995902,30,244,1,243,1,1,0,1,1,105,105,139,138,68
"5986",85,"[30]EepAHgKxHnKqGocIHcJCBFpdxeqgwD",224,0.995556,30,225,1,224,1,1,0,1,1,120,120,105,104,68
"5987",86,"[30]EepAHgKxHnKqGocIHcJCBFpdxeqgwD",233,0.995726,30,234,1,233,1,1,0,1,1,112,112,122,121,68
"5988",87,"[30]EepAHgKxHnKqGocIHcJCBFpdxeqgwD",234,0.995745,30,235,1,234,1,1,0,1,1,112,112,123,122,68
"5989",88,"[30]EepAHgKxHnKqGocIHcJCBFpdxeqgwD",238,0.995816,30,239,1,238,1,1,0,1,1,108,108,131,130,68
"5990",89,"[30]EepAHgKxHnKqGocIHcJCBFpdxeqgwD",238,0.995816,30,239,1,238,1,1,0,1,1,108,108,131,130,68
"5991",90,"[30]EepAHgKxHnKqGocIHcJCBFpdxeqgwD",233,0.995726,30,234,1,233,1,1,0,1,1,112,112,122,121,68
"5992",91,"[30]EepAHgKxHnKqGocIHcJCBFpdxeqgwD",235,0.995763,30,236,1,235,1,1,0,1,1,112,112,124,123,68
"5993",92,"[30]EepAHgKxHnKqGocIHcJCBFpdxeqgwD",226,0.995595,30,227,1,226,1,1,0,1,1,119,119,108,107,68
"5994",93,"[30]EepAHgKxHnKqGocIHcJCBFpdxeqgwD",232,0.995708,30,233,1,232,1,1,0,1,1,113,113,120,119,68
"5995",94,"[30]EepAHgKxHnKqGocIHcJCBFpdxeqgwD",226,0.995595,30,227,1,226,1,1,0,1,1,119,119,108,107,68
"5996",95,"[30]EepAHgKxHnKqGocIHcJCBFpdxeqgwD",232,0.995708,30,233,1,232,1,1,0,1,1,117,117,116,115,68
"5997",96,"[30]EepAHgKxHnKqGocIHcJCBFpdxeqgwD",228,0.995633,30,229,1,228,1,1,0,1,1,117,117,112,111,68
"5998",97,"[30]EepAHgKxHnKqGocIHcJCBFpdxeqgwD",230,0.995671,30,231,1,230,1,1,0,1,1,116,116,115,114,68
"5999",98,"[30]EepAHgKxHnKqGocIHcJCBFpdxeqgwD",230,0.995671,30,231,1,230,1,1,0,1,1,114,114,117,116,68
"6000",99,"[30]EepAHgKxHnKqGocIHcJCBFpdxeqgwD",224,0.995556,30,225,1,224,1,1,0,1,1,119,119,106,105,68
"6001",0,"[33]EAouHnKqGocIHcJCmzytmqipwHBsqddvi",237,0.995798,33,238,1,237,1,1,0,1,1,108,108,130,129,69
"6002",1,"[33]EAouHnKqGocIHcJCmzytmqipwHBsqddvi",222,0.995516,33,223,1,222,1,1,0,1,1,121,121,102,101,69
"6003",2,"[33]EAouHnKqGocIHcJCmzytmqipwHBsqddvi",239,0.995833,33,240,1,239,1,1,0,1,1,106,106,134,133,69
"6004",3,"[33]EAouHnKqGocIHcJCmzytmqipwHBsqddvi",227,0.995614,33,228,1,227,1,1,0,1,1,115,115,113,112,69
"6005",4,"[33]EAouHnKqGocIHcJCmzytmqipwHBsqddvi",228,0.995633,33,229,1,228,1,1,0,1,1,115,115,114,113,69
"6006",5,"[33]EAouHnKqGocIHcJCmzytmqipwHBsqddvi",227,0.995614,33,228,1,227,1,1,0,1,1,116,116,112,111,69
"6007",6,"[33]EAouHnKqGocIHcJCmzytmqipwHBsqddvi",222,0.995516,33,223,1,222,1,1,0,1,1,120,120,103,102,69
"6008",7,"[33]EAouHnKqGocIHcJCmzytmqipwHBsqddvi",223,0.995536,33,224,1,223,1,1,0,1,1,119,119,105,104,69
"6009",8,"[33]EAouHnKqGocIHcJCmzytmqipwHBsqddvi",230,0.995671,33,231,1,230,1,1,0,1,1,113,113,118,117,69
"6010",9,"[33]EAouHnKqGocIHcJCmzytmqipwHBsqddvi",238,0.995816,33,239,1,238,1,1,0,1,1,107,107,132,131,69
"6011",10,"[33]EAouHnKqGocIHcJCmzytmqipwHBsqddvi",238,0.995816,33,239,1,238,1,1,0,1,1,107,107,132,131,69
"6012",11,"[33]EAouHnKqGocIHcJCmzytmqipwHBsqddvi",234,0.995745,33,235,1,234,1,1,0,1,1,110,110,125,124,69
"6013",12,"[33]EAouHnKqGocIHcJCmzytmqipwHBsqddvi",229,0.995652,33,230,1,229,1,1,0,1,1,114,114,116,115,69
"6014",13,"[33]EAouHnKqGocIHcJCmzytmqipwHBsqddvi",224,0.995556,33,225,1,224,1,1,0,1,1,119,119,106,105,69
"6015",14,"[33]EAouHnKqGocIHcJCmzytmqipwHBsqddvi",230,0.995671,33,231,1,230,1,1,0,1,1,114,114,117,116,69
"6016",15,"[33]EAouHnKqGocIHcJCmzytmqipwHBsqddvi",225,0.995575,33,226,1,225,1,1,0,1,1,117,117,109,108,69
"6017",16,"[33]EAouHnKqGocIHcJCmzytmqipwHBsqddvi",235,0.995763,33,236,1,235,1,1,0,1,1,109,109,127,126,69
"6018",17,"[33]EAouHnKqGocIHcJCmzytmqipwHBsqddvi",222,0.995516,33,223,1,222,1,1,0,1,1,120,120,103,102,69
"6019",18,"[33]EAouHnKqGocIHcJCmzytmqipwHBsqddvi",238,0.995816,33,239,1,238,1,1,0,1,1,108,108,131,130,69
"6020",19,"[33]EAouHnKqGocIHcJCmzytmqipwHBsqddvi",226,0.995595,33,227,1,226,1,1,0,1,1,116,116,111,110,69
"6021",20,"[33]EAouHnKqGocIHcJCmzytmqipwHBsqddvi",237,0.995798,33,238,1,237,1,1,0,1,1,112,112,126,125,69
"6022",21,"[33]EAouHnKqGocIHcJCmzytmqipwHBsqddvi",224,0.995556,33,225,1,224,1,1,0,1,1,118,118,107,106,69
"6023",22,"[33]EAouHnKqGocIHcJCmzytmqipwHBsqddvi",235,0.995763,33,236,1,235,1,1,0,1,1,112,112,124,123,69
"6024",23,"[33]EAouHnKqGocIHcJCmzytmqipwHBsqddvi",227,0.995614,33,228,1,227,1,1,0,1,1,119,119,109,108,69
"6025",24,"[33]EAouHnKqGocIHcJCmzytmqipwHBsqddvi",228,0.995633,33,229,1,228,1,1,0,1,1,115,115,114,113,69
"6026",25,"[33]EAouHnKqGocIHcJCmzytmqipwHBsqddvi",228,0.995633,33,229,1,228,1,1,0,1,1,115,115,114,113,69
"6027",26,"[33]EAouHnKqGocIHcJCmzytmqipwHBsqddvi",242,0.995885,33,243,1,242,1,1,0,1,1,104,104,139,138,69
"6028",27,"[33]EAouHnKqGocIHcJCmzytmqipwHBsqddvi",231,0.99569,33,232,1,231,1,1,0,1,1,115,115,117,116,69
"6029",28,"[33]EAouHnKqGocIHcJCmzytmqipwHBsqddvi",219,0.995455,33,220,1,219,1,1,0,1,1,122,122,98,97,69
"6030",29,"[33]EAouHnKqGocIHcJCmzytmqipwHBsqddvi",231,0.99569,33,232,1,231,1,1,0,1,1,116,116,116,115,69
"6031",30,"[33]EAouHnKqGocIHcJCmzytmqipwHBsqddvi",237,0.995798,33,238,1,237,1,1,0,1,1,108,108,130,129,69
"6032",31,"[33]EAouHnKqGocIHcJCmzytmqipwHBsqddvi",227,0.995614,33,228,1,227,1,1,0,1,1,119,119,109,108,69
"6033",32,"[33]EAouHnKqGocIHcJCmzytmqipwHBsqddvi",226,0.995595,33,227,1,226,1,1,0,1,1,116,116,111,110,69
"6034",33,"[33]EAouHnKqGocIHcJCmzytmqipwHBsqddvi",223,0.995536,33,224,1,223,1,1,0,1,1,119,119,105,104,69
"6035",34,"[33]EAouHnKqGocIHcJCmzytmqipwHBsqddvi",237,0.995798,33,238,1,237,1,1,0,1,1,112,112,126,125,69
"6036",35,"[33]EAouHnKqGocIHcJCmzytmqipwHBsqddvi",225,0.995575,33,226,1,225,1,1,0,1,1,117,117,109,108,69
"6037",36,"[33]EAouHnKqGocIHcJCmzytmqipwHBsqddvi",219,0.995455,33,220,1,219,1,1,0,1,1,122,122,98,97,69
"6038",37,"[33]EAouHnKqGocIHcJCmzytmqipwHBsqddvi",226,0.995595,33,227,1,226,1,1,0,1,1,116,116,111,110,69
"6039",38,"[33]EAouHnKqGocIHcJCmzytmqipwHBsqddvi",234,0.995745,33,235,1,234,1,1,0,1,1,111,111,124,123,69
"6040",39,"[33]EAouHnKqGocIHcJCmzytmqipwHBsqddvi",226,0.995595,33,227,1,226,1,1,0,1,1,116,116,111,110,69
"6041",40,"[33]EAouHnKqGocIHcJCmzytmqipwHBsqddvi",232,0.995708,33,233,1,232,1,1,0,1,1,112,112,121,120,69
"6042",41,"[33]EAouHnKqGocIHcJCmzytmqipwHBsqddvi",235,0.995763,33,236,1,235,1,1,0,1,1,109,109,127,126,69
"6043",42,"[33]EAouHnKqGocIHcJCmzytmqipwHBsqddvi",232,0.995708,33,233,1,232,1,1,0,1,1,112,112,121,120,69
"6044",43,"[33]EAouHnKqGocIHcJCmzytmqipwHBsqddvi",233,0.995726,33,234,1,233,1,1,0,1,1,111,111,123,122,69
"6045",44,"[33]EAouHnKqGocIHcJCmzytmqipwHBsqddvi",222,0.995516,33,223,1,222,1,1,0,1,1,120,120,103,102,69
"6046",45,"[33]EAouHnKqGocIHcJCmzytmqipwHBsqddvi",230,0.995671,33,231,1,230,1,1,0,1,1,116,116,115,114,69
"6047",46,"[33]EAouHnKqGocIHcJCmzytmqipwHBsqddvi",231,0.99569,33,232,1,231,1,1,0,1,1,112,112,120,119,69
"6048",47,"[33]EAouHnKqGocIHcJCmzytmqipwHBsqddvi",234,0.995745,33,235,1,234,1,1,0,1,1,110,110,125,124,69
"6049",48,"[33]EAouHnKqGocIHcJCmzytmqipwHBsqddvi",232,0.995708,33,233,1,232,1,1,0,1,1,114,114,119,118,69
"6050",49,"[33]EAouHnKqGocIHcJCmzytmqipwHBsqddvi",227,0.995614,33,228,1,227,1,1,0,1,1,117,117,111,110,69
"6051",50,"[33]EAouHnKqGocIHcJCmzytmqipwHBsqddvi",244,0.995918,33,245,1,244,1,1,0,1,1,105,105,140,139,69
"6052",51,"[33]EAouHnKqGocIHcJCmzytmqipwHBsqddvi",218,0.995434,33,219,1,218,1,1,0,1,1,122,122,97,96,69
"6053",52,"[33]EAouHnKqGocIHcJCmzytmqipwHBsqddvi",226,0.995595,33,227,1,226,1,1,0,1,1,116,116,111,110,69
"6054",53,"[33]EAouHnKqGocIHcJCmzytmqipwHBsqddvi",225,0.995575,33,226,1,225,1,1,0,1,1,117,117,109,108,69
"6055",54,"[33]EAouHnKqGocIHcJCmzytmqipwHBsqddvi",231,0.99569,33,232,1,231,1,1,0,1,1,113,113,119,118,69
"6056",55,"[33]EAouHnKqGocIHcJCmzytmqipwHBsqddvi",220,0.995475,33,221,1,220,1,1,0,1,1,121,121,100,99,69
"6057",56,"[33]EAouHnKqGocIHcJCmzytmqipwHBsqddvi",228,0.995633,33,229,1,228,1,1,0,1,1,115,115,114,113,69
"6058",57,"[33]EAouHnKqGocIHcJCmzytmqipwHBsqddvi",229,0.995652,33,230,1,229,1,1,0,1,1,114,114,116,115,69
"6059",58,"[33]EAouHnKqGocIHcJCmzytmqipwHBsqddvi",231,0.99569,33,232,1,231,1,1,0,1,1,112,112,120,119,69
"6060",59,"[33]EAouHnKqGocIHcJCmzytmqipwHBsqddvi",228,0.995633,33,229,1,228,1,1,0,1,1,116,116,113,112,69
"6061",60,"[33]EAouHnKqGocIHcJCmzytmqipwHBsqddvi",237,0.995798,33,238,1,237,1,1,0,1,1,111,111,127,126,69
"6062",61,"[33]EAouHnKqGocIHcJCmzytmqipwHBsqddvi",226,0.995595,33,227,1,226,1,1,0,1,1,116,116,111,110,69
"6063",62,"[33]EAouHnKqGocIHcJCmzytmqipwHBsqddvi",225,0.995575,33,226,1,225,1,1,0,1,1,117,117,109,108,69
"6064",63,"[33]EAouHnKqGocIHcJCmzytmqipwHBsqddvi",242,0.995885,33,243,1,242,1,1,0,1,1,103,103,140,139,69
"6065",64,"[33]EAouHnKqGocIHcJCmzytmqipwHBsqddvi",226,0.995595,33,227,1,226,1,1,0,1,1,117,117,110,109,69
"6066",65,"[33]EAouHnKqGocIHcJCmzytmqipwHBsqddvi",234,0.995745,33,235,1,234,1,1,0,1,1,112,112,123,122,69
"6067",66,"[33]EAouHnKqGocIHcJCmzytmqipwHBsqddvi",228,0.995633,33,229,1,228,1,1,0,1,1,115,115,114,113,69
"6068",67,"[33]EAouHnKqGocIHcJCmzytmqipwHBsqddvi",223,0.995536,33,224,1,223,1,1,0,1,1,119,119,105,104,69
"6069",68,"[33]EAouHnKqGocIHcJCmzytmqipwHBsqddvi",232,0.995708,33,233,1,232,1,1,0,1,1,112,112,121,120,69
"6070",69,"[33]EAouHnKqGocIHcJCmzytmqipwHBsqddvi",231,0.99569,33,232,1,231,1,1,0,1,1,114,114,118,117,69
"6071",70,"[33]EAouHnKqGocIHcJCmzytmqipwHBsqddvi",220,0.995475,33,221,1,220,1,1,0,1,1,121,121,100,99,69
"6072",71,"[33]EAouHnKqGocIHcJCmzytmqipwHBsqddvi",232,0.995708,33,233,1,232,1,1,0,1,1,113,113,120,119,69
"6073",72,"[33]EAouHnKqGocIHcJCmzytmqipwHBsqddvi",230,0.995671,33,231,1,230,1,1,0,1,1,116,116,115,114,69
"6074",73,"[33]EAouHnKqGocIHcJCmzytmqipwHBsqddvi",226,0.995595,33,227,1,226,1,1,0,1,1,118,118,109,108,69
"6075",74,"[33]EAouHnKqGocIHcJCmzytmqipwHBsqddvi",228,0.995633,33,229,1,228,1,1,0,1,1,115,115,114,113,69
"6076",75,"[33]EAouHnKqGocIHcJCmzytmqipwHBsqddvi",226,0.995595,33,227,1,226,1,1,0,1,1,116,116,111,110,69
"6077",76,"[33]EAouHnKqGocIHcJCmzytmqipwHBsqddvi",228,0.995633,33,229,1,228,1,1,0,1,1,114,114,115,114,69
"6078",77,"[33]EAouHnKqGocIHcJCmzytmqipwHBsqddvi",224,0.995556,33,225,1,224,1,1,0,1,1,118,118,107,106,69
"6079",78,"[33]EAouHnKqGocIHcJCmzytmqipwHBsqddvi",236,0.995781,33,237,1,236,1,1,0,1,1,108,108,129,128,69
"6080",79,"[33]EAouHnKqGocIHcJCmzytmqipwHBsqddvi",230,0.995671,33,231,1,230,1,1,0,1,1,115,115,116,115,69
"6081",80,"[33]EAouHnKqGocIHcJCmzytmqipwHBsqddvi",221,0.995495,33,222,1,221,1,1,0,1,1,119,119,103,102,69
"6082",81,"[33]EAouHnKqGocIHcJCmzytmqipwHBsqddvi",239,0.995833,33,240,1,239,1,1,0,1,1,107,107,133,132,69
"6083",82,"[33]EAouHnKqGocIHcJCmzytmqipwHBsqddvi",226,0.995595,33,227,1,226,1,1,0,1,1,117,117,110,109,69
"6084",83,"[33]EAouHnKqGocIHcJCmzytmqipwHBsqddvi",229,0.995652,33,230,1,229,1,1,0,1,1,115,115,115,114,69
"6085",84,"[33]EAouHnKqGocIHcJCmzytmqipwHBsqddvi",235,0.995763,33,236,1,235,1,1,0,1,1,108,108,128,127,69
"6086",85,"[33]EAouHnKqGocIHcJCmzytmqipwHBsqddvi",230,0.995671,33,231,1,230,1,1,0,1,1,113,113,118,117,69
"6087",86,"[33]EAouHnKqGocIHcJCmzytmqipwHBsqddvi",243,0.995902,33,244,1,243,1,1,0,1,1,105,105,139,138,69
"6088",87,"[33]EAouHnKqGocIHcJCmzytmqipwHBsqddvi",224,0.995556,33,225,1,224,1,1,0,1,1,119,119,106,105,69
"6089",88,"[33]EAouHnKqGocIHcJCmzytmqipwHBsqddvi",231,0.99569,33,232,1,231,1,1,0,1,1,112,112,120,119,69
"6090",89,"[33]EAouHnKqGocIHcJCmzytmqipwHBsqddvi",220,0.995475,33,221,1,220,1,1,0,1,1,123,123,98,97,69
"6091",90,"[33]EAouHnKqGocIHcJCmzytmqipwHBsqddvi",238,0.995816,33,239,1,238,1,1,0,1,1,109,109,130,129,69
"6092",91,"[33]EAouHnKqGocIHcJCmzytmqipwHBsqddvi",225,0.995575,33,226,1,225,1,1,0,1,1,118,118,108,107,69
"6093",92,"[33]EAouHnKqGocIHcJCmzytmqipwHBsqddvi",224,0.995556,33,225,1,224,1,1,0,1,1,119,119,106,105,69
"6094",93,"[33]EAouHnKqGocIHcJCmzytmqipwHBsqddvi",234,0.995745,33,235,1,234,1,1,0,1,1,110,110,125,124,69
"6095",94,"[33]EAouHnKqGocIHcJCmzytmqipwHBsqddvi",231,0.99569,33,232,1,231,1,1,0,1,1,114,114,118,117,69
"6096",95,"[33]EAouHnKqGocIHcJCmzytmqipwHBsqddvi",226,0.995595,33,227,1,226,1,1,0,1,1,117,117,110,109,69
"6097",96,"[33]EAouHnKqGocIHcJCmzytmqipwHBsqddvi",227,0.995614,33,228,1,227,1,1,0,1,1,112,112,116,115,69
"6098",97,"[33]EAouHnKqGocIHcJCmzytmqipwHBsqddvi",227,0.995614,33,228,1,227,1,1,0,1,1,119,119,109,108,69
"6099",98,"[33]EAouHnKqGocIHcJCmzytmqipwHBsqddvi",227,0.995614,33,228,1,227,1,1,0,1,1,116,116,112,111,69
"6100",99,"[33]EAouHnKqGocIHcJCmzytmqipwHBsqddvi",238,0.995816,33,239,1,238,1,1,0,1,1,107,107,132,131,69
"6101",0,"[30]ExHruHnKqGocIHcJCgDdaFCKtldrkF",230,0.995671,30,231,1,230,1,1,0,1,1,115,115,116,115,70
"6102",1,"[30]ExHruHnKqGocIHcJCgDdaFCKtldrkF",228,0.995633,30,229,1,228,1,1,0,1,1,116,116,113,112,70
"6103",2,"[30]ExHruHnKqGocIHcJCgDdaFCKtldrkF",245,0.995935,30,246,1,245,1,1,0,1,1,104,104,142,141,70
"6104",3,"[30]ExHruHnKqGocIHcJCgDdaFCKtldrkF",228,0.995633,30,229,1,228,1,1,0,1,1,115,115,114,113,70
"6105",4,"[30]ExHruHnKqGocIHcJCgDdaFCKtldrkF",224,0.995556,30,225,1,224,1,1,0,1,1,121,121,104,103,70
"6106",5,"[30]ExHruHnKqGocIHcJCgDdaFCKtldrkF",227,0.995614,30,228,1,227,1,1,0,1,1,117,117,111,110,70
"6107",6,"[30]ExHruHnKqGocIHcJCgDdaFCKtldrkF",227,0.995614,30,228,1,227,1,1,0,1,1,118,118,110,109,70
"6108",7,"[30]ExHruHnKqGocIHcJCgDdaFCKtldrkF",241,0.995868,30,242,1,241,1,1,0,1,1,105,105,137,136,70
"6109",8,"[30]ExHruHnKqGocIHcJCgDdaFCKtldrkF",228,0.995633,30,229,1,228,1,1,0,1,1,116,116,113,112,70
"6110",9,"[30]ExHruHnKqGocIHcJCgDdaFCKtldrkF",237,0.995798,30,238,1,237,1,1,0,1,1,108,108,130,129,70
"6111",10,"[30]ExHruHnKqGocIHcJCgDdaFCKtldrkF",237,0.995798,30,238,1,237,1,1,0,1,1,112,112,126,125,70
"6112",11,"[30]ExHruHnKqGocIHcJCgDdaFCKtldrkF",226,0.995595,30,227,1,226,1,1,0,1,1,118,118,109,108,70
"6113",12,"[30]ExHruHnKqGocIHcJCgDdaFCKtldrkF",235,0.995763,30,236,1,235,1,1,0,1,1,112,112,124,123,70
"6114",13,"[30]ExHruHnKqGocIHcJCgDdaFCKtldrkF",237,0.995798,30,238,1,237,1,1,0,1,1,109,109,129,128,70
"6115",14,"[30]ExHruHnKqGocIHcJCgDdaFCKtldrkF",218,0.995434,30,219,1,218,1,1,0,1,1,123,123,96,95,70
"6116",15,"[30]ExHruHnKqGocIHcJCgDdaFCKtldrkF",227,0.995614,30,228,1,227,1,1,0,1,1,116,116,112,111,70
"6117",16,"[30]ExHruHnKqGocIHcJCgDdaFCKtldrkF",233,0.995726,30,234,1,233,1,1,0,1,1,113,113,121,120,70
"6118",17,"[30]ExHruHnKqGocIHcJCgDdaFCKtldrkF",223,0.995536,30,224,1,223,1,1,0,1,1,119,119,105,104,70
"6119",18,"[30]ExHruHnKqGocIHcJCgDdaFCKtldrkF",228,0.995633,30,229,1,228,1,1,0,1,1,118,118,111,110,70
"6120",19,"[30]ExHruHnKqGocIHcJCgDdaFCKtldrkF",236,0.995781,30,237,1,236,1,1,0,1,1,109,109,128,127,70
"6121",20,"[30]ExHruHnKqGocIHcJCgDdaFCKtldrkF",235,0.995763,30,236,1,235,1,1,0,1,1,113,113,123,122,70
"6122",21,"[30]ExHruHnKqGocIHcJCgDdaFCKtldrkF",231,0.99569,30,232,1,231,1,1,0,1,1,114,114,118,117,70
"6123",22,"[30]ExHruHnKqGocIHcJCgDdaFCKtldrkF",237,0.995798,30,238,1,237,1,1,0,1,1,108,108,130,129,70
"6124",23,"[30]ExHruHnKqGocIHcJCgDdaFCKtldrkF",230,0.995671,30,231,1,230,1,1,0,1,1,117,117,114,113,70
"6125",24,"[30]ExHruHnKqGocIHcJCgDdaFCKtldrkF",234,0.995745,30,235,1,234,1,1,0,1,1,111,111,124,123,70
"6126",25,"[30]ExHruHnKqGocIHcJCgDdaFCKtldrkF",228,0.995633,30,229,1,228,1,1,0,1,1,115,115,114,113,70
"6127",26,"[30]ExHruHnKqGocIHcJCgDdaFCKtldrkF",220,0.995475,30,221,1,220,1,1,0,1,1,122,122,99,98,70
"6128",27,"[30]ExHruHnKqGocIHcJCgDdaFCKtldrkF",230,0.995671,30,231,1,230,1,1,0,1,1,114,114,117,116,70
"6129",28,"[30]ExHruHnKqGocIHcJCgDdaFCKtldrkF",247,0.995968,30,248,1,247,1,1,0,1,1,100,100,148,147,70
"6130",29,"[30]ExHruHnKqGocIHcJCgDdaFCKtldrkF",226,0.995595,30,227,1,226,1,1,0,1,1,119,119,108,107,70
"6131",30,"[30]ExHruHnKqGocIHcJCgDdaFCKtldrkF",226,0.995595,30,227,1,226,1,1,0,1,1,117,117,110,109,70
"6132",31,"[30]ExHruHnKqGocIHcJCgDdaFCKtldrkF",230,0.995671,30,231,1,230,1,1,0,1,1,114,114,117,116,70
"6133",32,"[30]ExHruHnKqGocIHcJCgDdaFCKtldrkF",223,0.995536,30,224,1,223,1,1,0,1,1,122,122,102,101,70
"6134",33,"[30]ExHruHnKqGocIHcJCgDdaFCKtldrkF",225,0.995575,30,226,1,225,1,1,0,1,1,119,119,107,106,70
"6135",34,"[30]ExHruHnKqGocIHcJCgDdaFCKtldrkF",230,0.995671,30,231,1,230,1,1,0,1,1,114,114,117,116,70
"6136",35,"[30]ExHruHnKqGocIHcJCgDdaFCKtldrkF",235,0.995763,30,236,1,235,1,1,0,1,1,111,111,125,124,70
"6137",36,"[30]ExHruHnKqGocIHcJCgDdaFCKtldrkF",236,0.995781,30,237,1,236,1,1,0,1,1,110,110,127,126,70
"6138",37,"[30]ExHruHnKqGocIHcJCgDdaFCKtldrkF",234,0.995745,30,235,1,234,1,1,0,1,1,112,112,123,122,70
"6139",38,"[30]ExHruHnKqGocIHcJCgDdaFCKtldrkF",230,0.995671,30,231,1,230,1,1,0,1,1,115,115,116,115,70
"6140",39,"[30]ExHruHnKqGocIHcJCgDdaFCKtldrkF",231,0.99569,30,232,1,231,1,1,0,1,1,115,115,117,116,70
"6141",40,"[30]ExHruHnKqGocIHcJCgDdaFCKtldrkF",235,0.995763,30,236,1,235,1,1,0,1,1,110,110,126,125,70
"6142",41,"[30]ExHruHnKqGocIHcJCgDdaFCKtldrkF",242,0.995885,30,243,1,242,1,1,0,1,1,105,105,138,137,70
"6143",42,"[30]ExHruHnKqGocIHcJCgDdaFCKtldrkF",226,0.995595,30,227,1,226,1,1,0,1,1,118,118,109,108,70
"6144",43,"[30]ExHruHnKqGocIHcJCgDdaFCKtldrkF",227,0.995614,30,228,1,227,1,1,0,1,1,118,118,110,109,70
"6145",44,"[30]ExHruHnKqGocIHcJCgDdaFCKtldrkF",239,0.995833,30,240,1,239,1,1,0,1,1,109,109,131,130,70
"6146",45,"[30]ExHruHnKqGocIHcJCgDdaFCKtldrkF",236,0.995781,30,237,1,236,1,1,0,1,1,110,110,127,126,70
"6147",46,"[30]ExHruHnKqGocIHcJCgDdaFCKtldrkF",241,0.995868,30,242,1,241,1,1,0,1,1,109,109,133,132,70
"6148",47,"[30]ExHruHnKqGocIHcJCgDdaFCKtldrkF",240,0.995851,30,241,1,240,1,1,0,1,1,109,109,132,131,70
"6149",48,"[30]ExHruHnKqGocIHcJCgDdaFCKtldrkF",227,0.995614,30,228,1,227,1,1,0,1,1,116,116,112,111,70
"6150",49,"[30]ExHruHnKqGocIHcJCgDdaFCKtldrkF",233,0.995726,30,234,1,233,1,1,0,1,1,111,111,123,122,70
"6151",50,"[30]ExHruHnKqGocIHcJCgDdaFCKtldrkF",235,0.995763,30,236,1,235,1,1,0,1,1,112,112,124,123,70
"6152",51,"[30]ExHruHnKqGocIHcJCgDdaFCKtldrkF",223,0.995536,30,224,1,223,1,1,0,1,1,119,119,105,104,70
"6153",52,"[30]ExHruHnKqGocIHcJCgDdaFCKtldrkF",228,0.995633,30,229,1,228,1,1,0,1,1,116,116,113,112,70
"6154",53,"[30]ExHruHnKqGocIHcJCgDdaFCKtldrkF",220,0.995475,30,221,1,220,1,1,0,1,1,123,123,98,97,70
"6155",54,"[30]ExHruHnKqGocIHcJCgDdaFCKtldrkF",227,0.995614,30,228,1,227,1,1,0,1,1,117,117,111,110,70
"6156",55,"[30]ExHruHnKqGocIHcJCgDdaFCKtldrkF",228,0.995633,30,229,1,228,1,1,0,1,1,120,120,109,108,70
"6157",56,"[30]ExHruHnKqGocIHcJCgDdaFCKtldrkF",231,0.99569,30,232,1,231,1,1,0,1,1,115,115,117,116,70
"6158",57,"[30]ExHruHnKqGocIHcJCgDdaFCKtldrkF",220,0.995475,30,221,1,220,1,1,0,1,1,122,122,99,98,70
"6159",58,"[30]ExHruHnKqGocIHcJCgDdaFCKtldrkF",234,0.995745,30,235,1,234,1,1,0,1,1,112,112,123,122,70
"6160",59,"[30]ExHruHnKqGocIHcJCgDdaFCKtldrkF",245,0.995935,30,246,1,245,1,1,0,1,1,103,103,143,142,70
"6161",60,"[30]ExHruHnKqGocIHcJCgDdaFCKtldrkF",229,0.995652,30,230,1,229,1,1,0,1,1,115,115,115,114,70
"6162",61,"[30]ExHruHnKqGocIHcJCgDdaFCKtldrkF",227,0.995614,30,228,1,227,1,1,0,1,1,116,116,112,111,70
"6163",62,"[30]ExHruHnKqGocIHcJCgDdaFCKtldrkF",256,0.996109,30,257,1,256,1,1,0,1,1,95,95,162,161,70
"6164",63,"[30]ExHruHnKqGocIHcJCgDdaFCKtldrkF",226,0.995595,30,227,1,226,1,1,0,1,1,117,117,110,109,70
"6165",64,"[30]ExHruHnKqGocIHcJCgDdaFCKtldrkF",226,0.995595,30,227,1,226,1,1,0,1,1,118,118,109,108,70
"6166",65,"[30]ExHruHnKqGocIHcJCgDdaFCKtldrkF",229,0.995652,30,230,1,229,1,1,0,1,1,115,115,115,114,70
"6167",66,"[30]ExHruHnKqGocIHcJCgDdaFCKtldrkF",229,0.995652,30,230,1,229,1,1,0,1,1,115,115,115,114,70
"6168",67,"[30]ExHruHnKqGocIHcJCgDdaFCKtldrkF",232,0.995708,30,233,1,232,1,1,0,1,1,113,113,120,119,70
"6169",68,"[30]ExHruHnKqGocIHcJCgDdaFCKtldrkF",224,0.995556,30,225,1,224,1,1,0,1,1,119,119,106,105,70
"6170",69,"[30]ExHruHnKqGocIHcJCgDdaFCKtldrkF",227,0.995614,30,228,1,227,1,1,0,1,1,119,119,109,108,70
"6171",70,"[30]ExHruHnKqGocIHcJCgDdaFCKtldrkF",234,0.995745,30,235,1,234,1,1,0,1,1,114,114,121,120,70
"6172",71,"[30]ExHruHnKqGocIHcJCgDdaFCKtldrkF",223,0.995536,30,224,1,223,1,1,0,1,1,119,119,105,104,70
"6173",72,"[30]ExHruHnKqGocIHcJCgDdaFCKtldrkF",225,0.995575,30,226,1,225,1,1,0,1,1,120,120,106,105,70
"6174",73,"[30]ExHruHnKqGocIHcJCgDdaFCKtldrkF",223,0.995536,30,224,1,223,1,1,0,1,1,121,121,103,102,70
"6175",74,"[30]ExHruHnKqGocIHcJCgDdaFCKtldrkF",237,0.995798,30,238,1,237,1,1,0,1,1,108,108,130,129,70
"6176",75,"[30]ExHruHnKqGocIHcJCgDdaFCKtldrkF",231,0.99569,30,232,1,231,1,1,0,1,1,114,114,118,117,70
"6177",76,"[30]ExHruHnKqGocIHcJCgDdaFCKtldrkF",236,0.995781,30,237,1,236,1,1,0,1,1,109,109,128,127,70
"6178",77,"[30]ExHruHnKqGocIHcJCgDdaFCKtldrkF",240,0.995851,30,241,1,240,1,1,0,1,1,106,106,135,134,70
"6179",78,"[30]ExHruHnKqGocIHcJCgDdaFCKtldrkF",233,0.995726,30,234,1,233,1,1,0,1,1,112,112,122,121,70
"6180",79,"[30]ExHruHnKqGocIHcJCgDdaFCKtldrkF",224,0.995556,30,225,1,224,1,1,0,1,1,120,120,105,104,70
"6181",80,"[30]ExHruHnKqGocIHcJCgDdaFCKtldrkF",227,0.995614,30,228,1,227,1,1,0,1,1,117,117,111,110,70
"6182",81,"[30]ExHruHnKqGocIHcJCgDdaFCKtldrkF",222,0.995516,30,223,1,222,1,1,0,1,1,121,121,102,101,70
"6183",82,"[30]ExHruHnKqGocIHcJCgDdaFCKtldrkF",231,0.99569,30,232,1,231,1,1,0,1,1,116,116,116,115,70
"6184",83,"[30]ExHruHnKqGocIHcJCgDdaFCKtldrkF",230,0.995671,30,231,1,230,1,1,0,1,1,115,115,116,115,70
"6185",84,"[30]ExHruHnKqGocIHcJCgDdaFCKtldrkF",240,0.995851,30,241,1,240,1,1,0,1,1,109,109,132,131,70
"6186",85,"[30]ExHruHnKqGocIHcJCgDdaFCKtldrkF",232,0.995708,30,233,1,232,1,1,0,1,1,112,112,121,120,70
"6187",86,"[30]ExHruHnKqGocIHcJCgDdaFCKtldrkF",221,0.995495,30,222,1,221,1,1,0,1,1,121,121,101,100,70
"6188",87,"[30]ExHruHnKqGocIHcJCgDdaFCKtldrkF",233,0.995726,30,234,1,233,1,1,0,1,1,114,114,120,119,70
"6189",88,"[30]ExHruHnKqGocIHcJCgDdaFCKtldrkF",224,0.995556,30,225,1,224,1,1,0,1,1,120,120,105,104,70
"6190",89,"[30]ExHruHnKqGocIHcJCgDdaFCKtldrkF",222,0.995516,30,223,1,222,1,1,0,1,1,120,120,103,102,70
"6191",90,"[30]ExHruHnKqGocIHcJCgDdaFCKtldrkF",230,0.995671,30,231,1,230,1,1,0,1,1,114,114,117,116,70
"6192",91,"[30]ExHruHnKqGocIHcJCgDdaFCKtldrkF",229,0.995652,30,230,1,229,1,1,0,1,1,115,115,115,114,70
"6193",92,"[30]ExHruHnKqGocIHcJCgDdaFCKtldrkF",227,0.995614,30,228,1,227,1,1,0,1,1,117,117,111,110,70
"6194",93,"[30]ExHruHnKqGocIHcJCgDdaFCKtldrkF",234,0.995745,30,235,1,234,1,1,0,1,1,112,112,123,122,70
"6195",94,"[30]ExHruHnKqGocIHcJCgDdaFCKtldrkF",234,0.995745,30,235,1,234,1,1,0,1,1,112,112,123,122,70
"6196",95,"[30]ExHruHnKqGocIHcJCgDdaFCKtldrkF",229,0.995652,30,230,1,229,1,1,0,1,1,115,115,115,114,70
"6197",96,"[30]ExHruHnKqGocIHcJCgDdaFCKtldrkF",242,0.995885,30,243,1,242,1,1,0,1,1,105,105,138,137,70
"6198",97,"[30]ExHruHnKqGocIHcJCgDdaFCKtldrkF",221,0.995495,30,222,1,221,1,1,0,1,1,122,122,100,99,70
"6199",98,"[30]ExHruHnKqGocIHcJCgDdaFCKtldrkF",218,0.995434,30,219,1,218,1,1,0,1,1,123,123,96,95,70
"6200",99,"[30]ExHruHnKqGocIHcJCgDdaFCKtldrkF",225,0.995575,30,226,1,225,1,1,0,1,1,119,119,107,106,70
"6201",0,"[27]EvgxvHnKqGocIHBJCFIlBFIdDEl",230,0.995671,27,231,1,230,1,1,0,1,1,115,115,116,115,71
"6202",1,"[27]EvgxvHnKqGocIHBJCFIlBFIdDEl",228,0.995633,27,229,1,228,1,1,0,1,1,120,120,109,108,71
"6203",2,"[27]EvgxvHnKqGocIHBJCFIlBFIdDEl",232,0.995708,27,233,1,232,1,1,0,1,1,112,112,121,120,71
"6204",3,"[27]EvgxvHnKqGocIHBJCFIlBFIdDEl",232,0.995708,27,233,1,232,1,1,0,1,1,113,113,120,119,71
"6205",4,"[27]EvgxvHnKqGocIHBJCFIlBFIdDEl",222,0.995516,27,223,1,222,1,1,0,1,1,121,121,102,101,71
"6206",5,"[27]EvgxvHnKqGocIHBJCFIlBFIdDEl",236,0.995781,27,237,1,236,1,1,0,1,1,110,110,127,126,71
"6207",6,"[27]EvgxvHnKqGocIHBJCFIlBFIdDEl",219,0.995455,27,220,1,219,1,1,0,1,1,123,123,97,96,71
"6208",7,"[27]EvgxvHnKqGocIHBJCFIlBFIdDEl",231,0.99569,27,232,1,231,1,1,0,1,1,114,114,118,117,71
"6209",8,"[27]EvgxvHnKqGocIHBJCFIlBFIdDEl",240,0.995851,27,241,1,240,1,1,0,1,1,107,107,134,133,71
"6210",9,"[27]EvgxvHnKqGocIHBJCFIlBFIdDEl",225,0.995575,27,226,1,225,1,1,0,1,1,119,119,107,106,71
"6211",10,"[27]EvgxvHnKqGocIHBJCFIlBFIdDEl",235,0.995763,27,236,1,235,1,1,0,1,1,110,110,126,125,71
"6212",11,"[27]EvgxvHnKqGocIHBJCFIlBFIdDEl",238,0.995816,27,239,1,238,1,1,0,1,1,107,107,132,131,71
"6213",12,"[27]EvgxvHnKqGocIHBJCFIlBFIdDEl",233,0.995726,27,234,1,233,1,1,0,1,1,112,112,122,121,71
"6214",13,"[27]EvgxvHnKqGocIHBJCFIlBFIdDEl",232,0.995708,27,233,1,232,1,1,0,1,1,112,112,121,120,71
"6215",14,"[27]EvgxvHnKqGocIHBJCFIlBFIdDEl",238,0.995816,27,239,1,238,1,1,0,1,1,108,108,131,130,71
"6216",15,"[27]EvgxvHnKqGocIHBJCFIlBFIdDEl",229,0.995652,27,230,1,229,1,1,0,1,1,116,116,114,113,71
"6217",16,"[27]EvgxvHnKqGocIHBJCFIlBFIdDEl",236,0.995781,27,237,1,236,1,1,0,1,1,110,110,127,126,71
"6218",17,"[27]EvgxvHnKqGocIHBJCFIlBFIdDEl",232,0.995708,27,233,1,232,1,1,0,1,1,113,113,120,119,71
"6219",18,"[27]EvgxvHnKqGocIHBJCFIlBFIdDEl",221,0.995495,27,222,1,221,1,1,0,1,1,122,122,100,99,71
"6220",19,"[27]EvgxvHnKqGocIHBJCFIlBFIdDEl",232,0.995708,27,233,1,232,1,1,0,1,1,114,114,119,118,71
"6221",20,"[27]EvgxvHnKqGocIHBJCFIlBFIdDEl",239,0.995833,27,240,1,239,1,1,0,1,1,109,109,131,130,71
"6222",21,"[27]EvgxvHnKqGocIHBJCFIlBFIdDEl",225,0.995575,27,226,1,225,1,1,0,1,1,118,118,108,107,71
"6223",22,"[27]EvgxvHnKqGocIHBJCFIlBFIdDEl",232,0.995708,27,233,1,232,1,1,0,1,1,114,114,119,118,71
"6224",23,"[27]EvgxvHnKqGocIHBJCFIlBFIdDEl",236,0.995781,27,237,1,236,1,1,0,1,1,110,110,127,126,71
"6225",24,"[27]EvgxvHnKqGocIHBJCFIlBFIdDEl",238,0.995816,27,239,1,238,1,1,0,1,1,108,108,131,130,71
"6226",25,"[27]EvgxvHnKqGocIHBJCFIlBFIdDEl",220,0.995475,27,221,1,220,1,1,0,1,1,122,122,99,98,71
"6227",26,"[27]EvgxvHnKqGocIHBJCFIlBFIdDEl",231,0.99569,27,232,1,231,1,1,0,1,1,113,113,119,118,71
"6228",27,"[27]EvgxvHnKqGocIHBJCFIlBFIdDEl",227,0.995614,27,228,1,227,1,1,0,1,1,117,117,111,110,71
"6229",28,"[27]EvgxvHnKqGocIHBJCFIlBFIdDEl",236,0.995781,27,237,1,236,1,1,0,1,1,109,109,128,127,71
"6230",29,"[27]EvgxvHnKqGocIHBJCFIlBFIdDEl",228,0.995633,27,229,1,228,1,1,0,1,1,116,116,113,112,71
"6231",30,"[27]EvgxvHnKqGocIHBJCFIlBFIdDEl",229,0.995652,27,230,1,229,1,1,0,1,1,115,115,115,114,71
"6232",31,"[27]EvgxvHnKqGocIHBJCFIlBFIdDEl",229,0.995652,27,230,1,229,1,1,0,1,1,116,116,114,113,71
"6233",32,"[27]EvgxvHnKqGocIHBJCFIlBFIdDEl",233,0.995726,27,234,1,233,1,1,0,1,1,111,111,123,122,71
"6234",33,"[27]EvgxvHnKqGocIHBJCFIlBFIdDEl",234,0.995745,27,235,1,234,1,1,0,1,1,114,114,121,120,71
"6235",34,"[27]EvgxvHnKqGocIHBJCFIlBFIdDEl",233,0.995726,27,234,1,233,1,1,0,1,1,111,111,123,122,71
"6236",35,"[27]EvgxvHnKqGocIHBJCFIlBFIdDEl",237,0.995798,27,238,1,237,1,1,0,1,1,109,109,129,128,71
"6237",36,"[27]EvgxvHnKqGocIHBJCFIlBFIdDEl",217,0.995413,27,218,1,217,1,1,0,1,1,124,124,94,93,71
"6238",37,"[27]EvgxvHnKqGocIHBJCFIlBFIdDEl",230,0.995671,27,231,1,230,1,1,0,1,1,117,117,114,113,71
"6239",38,"[27]EvgxvHnKqGocIHBJCFIlBFIdDEl",225,0.995575,27,226,1,225,1,1,0,1,1,118,118,108,107,71
"6240",39,"[27]EvgxvHnKqGocIHBJCFIlBFIdDEl",235,0.995763,27,236,1,235,1,1,0,1,1,110,110,126,125,71
"6241",40,"[27]EvgxvHnKqGocIHBJCFIlBFIdDEl",233,0.995726,27,234,1,233,1,1,0,1,1,112,112,122,121,71
"6242",41,"[27]EvgxvHnKqGocIHBJCFIlBFIdDEl",235,0.995763,27,236,1,235,1,1,0,1,1,115,115,121,120,71
"6243",42,"[27]EvgxvHnKqGocIHBJCFIlBFIdDEl",232,0.995708,27,233,1,232,1,1,0,1,1,112,112,121,120,71
"6244",43,"[27]EvgxvHnKqGocIHBJCFIlBFIdDEl",231,0.99569,27,232,1,231,1,1,0,1,1,114,114,118,117,71
"6245",44,"[27]EvgxvHnKqGocIHBJCFIlBFIdDEl",245,0.995935,27,246,1,245,1,1,0,1,1,103,103,143,142,71
"6246",45,"[27]EvgxvHnKqGocIHBJCFIlBFIdDEl",225,0.995575,27,226,1,225,1,1,0,1,1,119,119,107,106,71
"6247",46,"[27]EvgxvHnKqGocIHBJCFIlBFIdDEl",223,0.995536,27,224,1,223,1,1,0,1,1,119,119,105,104,71
"6248",47,"[27]EvgxvHnKqGocIHBJCFIlBFIdDEl",228,0.995633,27,229,1,228,1,1,0,1,1,115,115,114,113,71
"6249",48,"[27]EvgxvHnKqGocIHBJCFIlBFIdDEl",229,0.995652,27,230,1,229,1,1,0,1,1,117,117,113,112,71
"6250",49,"[27]EvgxvHnKqGocIHBJCFIlBFIdDEl",232,0.995708,27,233,1,232,1,1,0,1,1,113,113,120,119,71
"6251",50,"[27]EvgxvHnKqGocIHBJCFIlBFIdDEl",235,0.995763,27,236,1,235,1,1,0,1,1,111,111,125,124,71
"6252",51,"[27]EvgxvHnKqGocIHBJCFIlBFIdDEl",238,0.995816,27,239,1,238,1,1,0,1,1,113,113,126,125,71
"6253",52,"[27]EvgxvHnKqGocIHBJCFIlBFIdDEl",224,0.995556,27,225,1,224,1,1,0,1,1,119,119,106,105,71
"6254",53,"[27]EvgxvHnKqGocIHBJCFIlBFIdDEl",238,0.995816,27,239,1,238,1,1,0,1,1,108,108,131,130,71
"6255",54,"[27]EvgxvHnKqGocIHBJCFIlBFIdDEl",233,0.995726,27,234,1,233,1,1,0,1,1,111,111,123,122,71
"6256",55,"[27]EvgxvHnKqGocIHBJCFIlBFIdDEl",241,0.995868,27,242,1,241,1,1,0,1,1,108,108,134,133,71
"6257",56,"[27]EvgxvHnKqGocIHBJCFIlBFIdDEl",220,0.995475,27,221,1,220,1,1,0,1,1,123,123,98,97,71
"6258",57,"[27]EvgxvHnKqGocIHBJCFIlBFIdDEl",228,0.995633,27,229,1,228,1,1,0,1,1,115,115,114,113,71
"6259",58,"[27]EvgxvHnKqGocIHBJCFIlBFIdDEl",238,0.995816,27,239,1,238,1,1,0,1,1,107,107,132,131,71
"6260",59,"[27]EvgxvHnKqGocIHBJCFIlBFIdDEl",231,0.99569,27,232,1,231,1,1,0,1,1,115,115,117,116,71
"6261",60,"[27]EvgxvHnKqGocIHBJCFIlBFIdDEl",237,0.995798,27,238,1,237,1,1,0,1,1,108,108,130,129,71
"6262",61,"[27]EvgxvHnKqGocIHBJCFIlBFIdDEl",226,0.995595,27,227,1,226,1,1,0,1,1,118,118,109,108,71
"6263",62,"[27]EvgxvHnKqGocIHBJCFIlBFIdDEl",218,0.995434,27,219,1,218,1,1,0,1,1,123,123,96,95,71
"6264",63,"[27]EvgxvHnKqGocIHBJCFIlBFIdDEl",227,0.995614,27,228,1,227,1,1,0,1,1,116,116,112,111,71
"6265",64,"[27]EvgxvHnKqGocIHBJCFIlBFIdDEl",230,0.995671,27,231,1,230,1,1,0,1,1,114,114,117,116,71
"6266",65,"[27]EvgxvHnKqGocIHBJCFIlBFIdDEl",225,0.995575,27,226,1,225,1,1,0,1,1,118,118,108,107,71
"6267",66,"[27]EvgxvHnKqGocIHBJCFIlBFIdDEl",227,0.995614,27,228,1,227,1,1,0,1,1,119,119,109,108,71
"6268",67,"[27]EvgxvHnKqGocIHBJCFIlBFIdDEl",228,0.995633,27,229,1,228,1,1,0,1,1,119,119,110,109,71
"6269",68,"[27]EvgxvHnKqGocIHBJCFIlBFIdDEl",235,0.995763,27,236,1,235,1,1,0,1,1,113,113,123,122,71
"6270",69,"[27]EvgxvHnKqGocIHBJCFIlBFIdDEl",228,0.995633,27,229,1,228,1,1,0,1,1,116,116,113,112,71
"6271",70,"[27]EvgxvHnKqGocIHBJCFIlBFIdDEl",236,0.995781,27,237,1,236,1,1,0,1,1,109,109,128,127,71
"6272",71,"[27]EvgxvHnKqGocIHBJCFIlBFIdDEl",226,0.995595,27,227,1,226,1,1,0,1,1,118,118,109,108,71
"6273",72,"[27]EvgxvHnKqGocIHBJCFIlBFIdDEl",230,0.995671,27,231,1,230,1,1,0,1,1,115,115,116,115,71
"6274",73,"[27]EvgxvHnKqGocIHBJCFIlBFIdDEl",226,0.995595,27,227,1,226,1,1,0,1,1,118,118,109,108,71
"6275",74,"[27]EvgxvHnKqGocIHBJCFIlBFIdDEl",231,0.99569,27,232,1,231,1,1,0,1,1,114,114,118,117,71
"6276",75,"[27]EvgxvHnKqGocIHBJCFIlBFIdDEl",223,0.995536,27,224,1,223,1,1,0,1,1,119,119,105,104,71
"6277",76,"[27]EvgxvHnKqGocIHBJCFIlBFIdDEl",231,0.99569,27,232,1,231,1,1,0,1,1,114,114,118,117,71
"6278",77,"[27]EvgxvHnKqGocIHBJCFIlBFIdDEl",223,0.995536,27,224,1,223,1,1,0,1,1,119,119,105,104,71
"6279",78,"[27]EvgxvHnKqGocIHBJCFIlBFIdDEl",233,0.995726,27,234,1,233,1,1,0,1,1,114,114,120,119,71
"6280",79,"[27]EvgxvHnKqGocIHBJCFIlBFIdDEl",223,0.995536,27,224,1,223,1,1,0,1,1,119,119,105,104,71
"6281",80,"[27]EvgxvHnKqGocIHBJCFIlBFIdDEl",228,0.995633,27,229,1,228,1,1,0,1,1,116,116,113,112,71
"6282",81,"[27]EvgxvHnKqGocIHBJCFIlBFIdDEl",234,0.995745,27,235,1,234,1,1,0,1,1,111,111,124,123,71
"6283",82,"[27]EvgxvHnKqGocIHBJCFIlBFIdDEl",230,0.995671,27,231,1,230,1,1,0,1,1,114,114,117,116,71
"6284",83,"[27]EvgxvHnKqGocIHBJCFIlBFIdDEl",227,0.995614,27,228,1,227,1,1,0,1,1,116,116,112,111,71
"6285",84,"[27]EvgxvHnKqGocIHBJCFIlBFIdDEl",231,0.99569,27,232,1,231,1,1,0,1,1,114,114,118,117,71
"6286",85,"[27]EvgxvHnKqGocIHBJCFIlBFIdDEl",229,0.995652,27,230,1,229,1,1,0,1,1,118,118,112,111,71
"6287",86,"[27]EvgxvHnKqGocIHBJCFIlBFIdDEl",226,0.995595,27,227,1,226,1,1,0,1,1,117,117,110,109,71
"6288",87,"[27]EvgxvHnKqGocIHBJCFIlBFIdDEl",228,0.995633,27,229,1,228,1,1,0,1,1,116,116,113,112,71
"6289",88,"[27]EvgxvHnKqGocIHBJCFIlBFIdDEl",231,0.99569,27,232,1,231,1,1,0,1,1,115,115,117,116,71
"6290",89,"[27]EvgxvHnKqGocIHBJCFIlBFIdDEl",231,0.99569,27,232,1,231,1,1,0,1,1,114,114,118,117,71
"6291",90,"[27]EvgxvHnKqGocIHBJCFIlBFIdDEl",227,0.995614,27,228,1,227,1,1,0,1,1,117,117,111,110,71
"6292",91,"[27]EvgxvHnKqGocIHBJCFIlBFIdDEl",233,0.995726,27,234,1,233,1,1,0,1,1,112,112,122,121,71
"6293",92,"[27]EvgxvHnKqGocIHBJCFIlBFIdDEl",228,0.995633,27,229,1,228,1,1,0,1,1,116,116,113,112,71
"6294",93,"[27]EvgxvHnKqGocIHBJCFIlBFIdDEl",230,0.995671,27,231,1,230,1,1,0,1,1,115,115,116,115,71
"6295",94,"[27]EvgxvHnKqGocIHBJCFIlBFIdDEl",238,0.995816,27,239,1,238,1,1,0,1,1,108,108,131,130,71
"6296",95,"[27]EvgxvHnKqGocIHBJCFIlBFIdDEl",237,0.995798,27,238,1,237,1,1,0,1,1,109,109,129,128,71
"6297",96,"[27]EvgxvHnKqGocIHBJCFIlBFIdDEl",235,0.995763,27,236,1,235,1,1,0,1,1,112,112,124,123,71
"6298",97,"[27]EvgxvHnKqGocIHBJCFIlBFIdDEl",231,0.99569,27,232,1,231,1,1,0,1,1,114,114,118,117,71
"6299",98,"[27]EvgxvHnKqGocIHBJCFIlBFIdDEl",236,0.995781,27,237,1,236,1,1,0,1,1,109,109,128,127,71
"6300",99,"[27]EvgxvHnKqGocIHBJCFIlBFIdDEl",233,0.995726,27,234,1,233,1,1,0,1,1,112,112,122,121,71
"6301",0,"[28]EmgDDtHnKqGocIHcJChBvFacEecs",238,0.995816,28,239,1,238,1,1,0,1,1,110,110,129,128,72
"6302",1,"[28]EmgDDtHnKqGocIHcJChBvFacEecs",236,0.995781,28,237,1,236,1,1,0,1,1,110,110,127,126,72
"6303",2,"[28]EmgDDtHnKqGocIHcJChBvFacEecs",225,0.995575,28,226,1,225,1,1,0,1,1,119,119,107,106,72
"6304",3,"[28]EmgDDtHnKqGocIHcJChBvFacEecs",225,0.995575,28,226,1,225,1,1,0,1,1,119,119,107,106,72
"6305",4,"[28]EmgDDtHnKqGocIHcJChBvFacEecs",226,0.995595,28,227,1,226,1,1,0,1,1,117,117,110,109,72
"6306",5,"[28]EmgDDtHnKqGocIHcJChBvFacEecs",229,0.995652,28,230,1,229,1,1,0,1,1,115,115,115,114,72
"6307",6,"[28]EmgDDtHnKqGocIHcJChBvFacEecs",232,0.995708,28,233,1,232,1,1,0,1,1,115,115,118,117,72
"6308",7,"[28]EmgDDtHnKqGocIHcJChBvFacEecs",232,0.995708,28,233,1,232,1,1,0,1,1,114,114,119,118,72
"6309",8,"[28]EmgDDtHnKqGocIHcJChBvFacEecs",241,0.995868,28,242,1,241,1,1,0,1,1,108,108,134,133,72
"6310",9,"[28]EmgDDtHnKqGocIHcJChBvFacEecs",223,0.995536,28,224,1,223,1,1,0,1,1,121,121,103,102,72
"6311",10,"[28]EmgDDtHnKqGocIHcJChBvFacEecs",230,0.995671,28,231,1,230,1,1,0,1,1,114,114,117,116,72
"6312",11,"[28]EmgDDtHnKqGocIHcJChBvFacEecs",237,0.995798,28,238,1,237,1,1,0,1,1,111,111,127,126,72
"6313",12,"[28]EmgDDtHnKqGocIHcJChBvFacEecs",225,0.995575,28,226,1,225,1,1,0,1,1,119,119,107,106,72
"6314",13,"[28]EmgDDtHnKqGocIHcJChBvFacEecs",224,0.995556,28,225,1,224,1,1,0,1,1,120,120,105,104,72
"6315",14,"[28]EmgDDtHnKqGocIHcJChBvFacEecs",236,0.995781,28,237,1,236,1,1,0,1,1,109,109,128,127,72
"6316",15,"[28]EmgDDtHnKqGocIHcJChBvFacEecs",227,0.995614,28,228,1,227,1,1,0,1,1,116,116,112,111,72
"6317",16,"[28]EmgDDtHnKqGocIHcJChBvFacEecs",232,0.995708,28,233,1,232,1,1,0,1,1,112,112,121,120,72
"6318",17,"[28]EmgDDtHnKqGocIHcJChBvFacEecs",227,0.995614,28,228,1,227,1,1,0,1,1,117,117,111,110,72
"6319",18,"[28]EmgDDtHnKqGocIHcJChBvFacEecs",235,0.995763,28,236,1,235,1,1,0,1,1,114,114,122,121,72
"6320",19,"[28]EmgDDtHnKqGocIHcJChBvFacEecs",231,0.99569,28,232,1,231,1,1,0,1,1,118,118,114,113,72
"6321",20,"[28]EmgDDtHnKqGocIHcJChBvFacEecs",229,0.995652,28,230,1,229,1,1,0,1,1,115,115,115,114,72
"6322",21,"[28]EmgDDtHnKqGocIHcJChBvFacEecs",226,0.995595,28,227,1,226,1,1,0,1,1,118,118,109,108,72
"6323",22,"[28]EmgDDtHnKqGocIHcJChBvFacEecs",232,0.995708,28,233,1,232,1,1,0,1,1,114,114,119,118,72
"6324",23,"[28]EmgDDtHnKqGocIHcJChBvFacEecs",232,0.995708,28,233,1,232,1,1,0,1,1,113,113,120,119,72
"6325",24,"[28]EmgDDtHnKqGocIHcJChBvFacEecs",227,0.995614,28,228,1,227,1,1,0,1,1,117,117,111,110,72
"6326",25,"[28]EmgDDtHnKqGocIHcJChBvFacEecs",230,0.995671,28,231,1,230,1,1,0,1,1,115,115,116,115,72
"6327",26,"[28]EmgDDtHnKqGocIHcJChBvFacEecs",233,0.995726,28,234,1,233,1,1,0,1,1,112,112,122,121,72
"6328",27,"[28]EmgDDtHnKqGocIHcJChBvFacEecs",233,0.995726,28,234,1,233,1,1,0,1,1,111,111,123,122,72
"6329",28,"[28]EmgDDtHnKqGocIHcJChBvFacEecs",233,0.995726,28,234,1,233,1,1,0,1,1,111,111,123,122,72
"6330",29,"[28]EmgDDtHnKqGocIHcJChBvFacEecs",238,0.995816,28,239,1,238,1,1,0,1,1,107,107,132,131,72
"6331",30,"[28]EmgDDtHnKqGocIHcJChBvFacEecs",225,0.995575,28,226,1,225,1,1,0,1,1,119,119,107,106,72
"6332",31,"[28]EmgDDtHnKqGocIHcJChBvFacEecs",236,0.995781,28,237,1,236,1,1,0,1,1,113,113,124,123,72
"6333",32,"[28]EmgDDtHnKqGocIHcJChBvFacEecs",236,0.995781,28,237,1,236,1,1,0,1,1,109,109,128,127,72
"6334",33,"[28]EmgDDtHnKqGocIHcJChBvFacEecs",239,0.995833,28,240,1,239,1,1,0,1,1,111,111,129,128,72
"6335",34,"[28]EmgDDtHnKqGocIHcJChBvFacEecs",231,0.99569,28,232,1,231,1,1,0,1,1,115,115,117,116,72
"6336",35,"[28]EmgDDtHnKqGocIHcJChBvFacEecs",238,0.995816,28,239,1,238,1,1,0,1,1,109,109,130,129,72
"6337",36,"[28]EmgDDtHnKqGocIHcJChBvFacEecs",228,0.995633,28,229,1,228,1,1,0,1,1,115,115,114,113,72
"6338",37,"[28]EmgDDtHnKqGocIHcJChBvFacEecs",226,0.995595,28,227,1,226,1,1,0,1,1,117,117,110,109,72
"6339",38,"[28]EmgDDtHnKqGocIHcJChBvFacEecs",221,0.995495,28,222,1,221,1,1,0,1,1,121,121,101,100,72
"6340",39,"[28]EmgDDtHnKqGocIHcJChBvFacEecs",229,0.995652,28,230,1,229,1,1,0,1,1,116,116,114,113,72
"6341",40,"[28]EmgDDtHnKqGocIHcJChBvFacEecs",245,0.995935,28,246,1,245,1,1,0,1,1,104,104,142,141,72
"6342",41,"[28]EmgDDtHnKqGocIHcJChBvFacEecs",231,0.99569,28,232,1,231,1,1,0,1,1,113,113,119,118,72
"6343",42,"[28]EmgDDtHnKqGocIHcJChBvFacEecs",227,0.995614,28,228,1,227,1,1,0,1,1,117,117,111,110,72
"6344",43,"[28]EmgDDtHnKqGocIHcJChBvFacEecs",237,0.995798,28,238,1,237,1,1,0,1,1,108,108,130,129,72
"6345",44,"[28]EmgDDtHnKqGocIHcJChBvFacEecs",228,0.995633,28,229,1,228,1,1,0,1,1,116,116,113,112,72
"6346",45,"[28]EmgDDtHnKqGocIHcJChBvFacEecs",227,0.995614,28,228,1,227,1,1,0,1,1,117,117,111,110,72
"6347",46,"[28]EmgDDtHnKqGocIHcJChBvFacEecs",223,0.995536,28,224,1,223,1,1,0,1,1,119,119,105,104,72
"6348",47,"[28]EmgDDtHnKqGocIHcJChBvFacEecs",223,0.995536,28,224,1,223,1,1,0,1,1,120,120,104,103,72
"6349",48,"[28]EmgDDtHnKqGocIHcJChBvFacEecs",233,0.995726,28,234,1,233,1,1,0,1,1,113,113,121,120,72
"6350",49,"[28]EmgDDtHnKqGocIHcJChBvFacEecs",237,0.995798,28,238,1,237,1,1,0,1,1,108,108,130,129,72
"6351",50,"[28]EmgDDtHnKqGocIHcJChBvFacEecs",222,0.995516,28,223,1,222,1,1,0,1,1,121,121,102,101,72
"6352",51,"[28]EmgDDtHnKqGocIHcJChBvFacEecs",233,0.995726,28,234,1,233,1,1,0,1,1,115,115,119,118,72
"6353",52,"[28]EmgDDtHnKqGocIHcJChBvFacEecs",239,0.995833,28,240,1,239,1,1,0,1,1,108,108,132,131,72
"6354",53,"[28]EmgDDtHnKqGocIHcJChBvFacEecs",226,0.995595,28,227,1,226,1,1,0,1,1,117,117,110,109,72
"6355",54,"[28]EmgDDtHnKqGocIHcJChBvFacEecs",227,0.995614,28,228,1,227,1,1,0,1,1,116,116,112,111,72
"6356",55,"[28]EmgDDtHnKqGocIHcJChBvFacEecs",232,0.995708,28,233,1,232,1,1,0,1,1,113,113,120,119,72
"6357",56,"[28]EmgDDtHnKqGocIHcJChBvFacEecs",227,0.995614,28,228,1,227,1,1,0,1,1,116,116,112,111,72
"6358",57,"[28]EmgDDtHnKqGocIHcJChBvFacEecs",225,0.995575,28,226,1,225,1,1,0,1,1,119,119,107,106,72
"6359",58,"[28]EmgDDtHnKqGocIHcJChBvFacEecs",229,0.995652,28,230,1,229,1,1,0,1,1,115,115,115,114,72
"6360",59,"[28]EmgDDtHnKqGocIHcJChBvFacEecs",233,0.995726,28,234,1,233,1,1,0,1,1,116,116,118,117,72
"6361",60,"[28]EmgDDtHnKqGocIHcJChBvFacEecs",237,0.995798,28,238,1,237,1,1,0,1,1,110,110,128,127,72
"6362",61,"[28]EmgDDtHnKqGocIHcJChBvFacEecs",228,0.995633,28,229,1,228,1,1,0,1,1,116,116,113,112,72
"6363",62,"[28]EmgDDtHnKqGocIHcJChBvFacEecs",223,0.995536,28,224,1,223,1,1,0,1,1,120,120,104,103,72
"6364",63,"[28]EmgDDtHnKqGocIHcJChBvFacEecs",229,0.995652,28,230,1,229,1,1,0,1,1,115,115,115,114,72
"6365",64,"[28]EmgDDtHnKqGocIHcJChBvFacEecs",228,0.995633,28,229,1,228,1,1,0,1,1,118,118,111,110,72
"6366",65,"[28]EmgDDtHnKqGocIHcJChBvFacEecs",233,0.995726,28,234,1,233,1,1,0,1,1,111,111,123,122,72
"6367",66,"[28]EmgDDtHnKqGocIHcJChBvFacEecs",218,0.995434,28,219,1,218,1,1,0,1,1,123,123,96,95,72
"6368",67,"[28]EmgDDtHnKqGocIHcJChBvFacEecs",235,0.995763,28,236,1,235,1,1,0,1,1,111,111,125,124,72
"6369",68,"[28]EmgDDtHnKqGocIHcJChBvFacEecs",230,0.995671,28,231,1,230,1,1,0,1,1,115,115,116,115,72
"6370",69,"[28]EmgDDtHnKqGocIHcJChBvFacEecs",232,0.995708,28,233,1,232,1,1,0,1,1,114,114,119,118,72
"6371",70,"[28]EmgDDtHnKqGocIHcJChBvFacEecs",231,0.99569,28,232,1,231,1,1,0,1,1,113,113,119,118,72
"6372",71,"[28]EmgDDtHnKqGocIHcJChBvFacEecs",228,0.995633,28,229,1,228,1,1,0,1,1,115,115,114,113,72
"6373",72,"[28]EmgDDtHnKqGocIHcJChBvFacEecs",228,0.995633,28,229,1,228,1,1,0,1,1,115,115,114,113,72
"6374",73,"[28]EmgDDtHnKqGocIHcJChBvFacEecs",230,0.995671,28,231,1,230,1,1,0,1,1,114,114,117,116,72
"6375",74,"[28]EmgDDtHnKqGocIHcJChBvFacEecs",225,0.995575,28,226,1,225,1,1,0,1,1,119,119,107,106,72
"6376",75,"[28]EmgDDtHnKqGocIHcJChBvFacEecs",227,0.995614,28,228,1,227,1,1,0,1,1,117,117,111,110,72
"6377",76,"[28]EmgDDtHnKqGocIHcJChBvFacEecs",230,0.995671,28,231,1,230,1,1,0,1,1,115,115,116,115,72
"6378",77,"[28]EmgDDtHnKqGocIHcJChBvFacEecs",218,0.995434,28,219,1,218,1,1,0,1,1,125,125,94,93,72
"6379",78,"[28]EmgDDtHnKqGocIHcJChBvFacEecs",240,0.995851,28,241,1,240,1,1,0,1,1,109,109,132,131,72
"6380",79,"[28]EmgDDtHnKqGocIHcJChBvFacEecs",230,0.995671,28,231,1,230,1,1,0,1,1,115,115,116,115,72
"6381",80,"[28]EmgDDtHnKqGocIHcJChBvFacEecs",230,0.995671,28,231,1,230,1,1,0,1,1,115,115,116,115,72
"6382",81,"[28]EmgDDtHnKqGocIHcJChBvFacEecs",222,0.995516,28,223,1,222,1,1,0,1,1,120,120,103,102,72
"6383",82,"[28]EmgDDtHnKqGocIHcJChBvFacEecs",229,0.995652,28,230,1,229,1,1,0,1,1,117,117,113,112,72
"6384",83,"[28]EmgDDtHnKqGocIHcJChBvFacEecs",240,0.995851,28,241,1,240,1,1,0,1,1,107,107,134,133,72
"6385",84,"[28]EmgDDtHnKqGocIHcJChBvFacEecs",234,0.995745,28,235,1,234,1,1,0,1,1,111,111,124,123,72
"6386",85,"[28]EmgDDtHnKqGocIHcJChBvFacEecs",230,0.995671,28,231,1,230,1,1,0,1,1,119,119,112,111,72
"6387",86,"[28]EmgDDtHnKqGocIHcJChBvFacEecs",225,0.995575,28,226,1,225,1,1,0,1,1,118,118,108,107,72
"6388",87,"[28]EmgDDtHnKqGocIHcJChBvFacEecs",231,0.99569,28,232,1,231,1,1,0,1,1,114,114,118,117,72
"6389",88,"[28]EmgDDtHnKqGocIHcJChBvFacEecs",230,0.995671,28,231,1,230,1,1,0,1,1,114,114,117,116,72
"6390",89,"[28]EmgDDtHnKqGocIHcJChBvFacEecs",230,0.995671,28,231,1,230,1,1,0,1,1,116,116,115,114,72
"6391",90,"[28]EmgDDtHnKqGocIHcJChBvFacEecs",232,0.995708,28,233,1,232,1,1,0,1,1,113,113,120,119,72
"6392",91,"[28]EmgDDtHnKqGocIHcJChBvFacEecs",243,0.995902,28,244,1,243,1,1,0,1,1,106,106,138,137,72
"6393",92,"[28]EmgDDtHnKqGocIHcJChBvFacEecs",236,0.995781,28,237,1,236,1,1,0,1,1,113,113,124,123,72
"6394",93,"[28]EmgDDtHnKqGocIHcJChBvFacEecs",230,0.995671,28,231,1,230,1,1,0,1,1,115,115,116,115,72
"6395",94,"[28]EmgDDtHnKqGocIHcJChBvFacEecs",235,0.995763,28,236,1,235,1,1,0,1,1,110,110,126,125,72
"6396",95,"[28]EmgDDtHnKqGocIHcJChBvFacEecs",235,0.995763,28,236,1,235,1,1,0,1,1,111,111,125,124,72
"6397",96,"[28]EmgDDtHnKqGocIHcJChBvFacEecs",232,0.995708,28,233,1,232,1,1,0,1,1,113,113,120,119,72
"6398",97,"[28]EmgDDtHnKqGocIHcJChBvFacEecs",245,0.995935,28,246,1,245,1,1,0,1,1,103,103,143,142,72
"6399",98,"[28]EmgDDtHnKqGocIHcJChBvFacEecs",234,0.995745,28,235,1,234,1,1,0,1,1,111,111,124,123,72
"6400",99,"[28]EmgDDtHnKqGocIHcJChBvFacEecs",231,0.99569,28,232,1,231,1,1,0,1,1,115,115,117,116,72
"6401",0,"[23]ErxsHnKqGocIHBJCeymAsye",229,0.995652,23,230,1,229,1,1,0,1,1,116,116,114,113,73
"6402",1,"[23]ErxsHnKqGocIHBJCeymAsye",222,0.995516,23,223,1,222,1,1,0,1,1,123,123,100,99,73
"6403",2,"[23]ErxsHnKqGocIHBJCeymAsye",229,0.995652,23,230,1,229,1,1,0,1,1,116,116,114,113,73
"6404",3,"[23]ErxsHnKqGocIHBJCeymAsye",236,0.995781,23,237,1,236,1,1,0,1,1,110,110,127,126,73
"6405",4,"[23]ErxsHnKqGocIHBJCeymAsye",227,0.995614,23,228,1,227,1,1,0,1,1,116,116,112,111,73
"6406",5,"[23]ErxsHnKqGocIHBJCeymAsye",234,0.995745,23,235,1,234,1,1,0,1,1,111,111,124,123,73
"6407",6,"[23]ErxsHnKqGocIHBJCeymAsye",241,0.995868,23,242,1,241,1,1,0,1,1,107,107,135,134,73
"6408",7,"[23]ErxsHnKqGocIHBJCeymAsye",228,0.995633,23,229,1,228,1,1,0,1,1,117,117,112,111,73
"6409",8,"[23]ErxsHnKqGocIHBJCeymAsye",236,0.995781,23,237,1,236,1,1,0,1,1,109,109,128,127,73
"6410",9,"[23]ErxsHnKqGocIHBJCeymAsye",226,0.995595,23,227,1,226,1,1,0,1,1,117,117,110,109,73
"6411",10,"[23]ErxsHnKqGocIHBJCeymAsye",223,0.995536,23,224,1,223,1,1,0,1,1,120,120,104,103,73
"6412",11,"[23]ErxsHnKqGocIHBJCeymAsye",223,0.995536,23,224,1,223,1,1,0,1,1,121,121,103,102,73
"6413",12,"[23]ErxsHnKqGocIHBJCeymAsye",239,0.995833,23,240,1,239,1,1,0,1,1,114,114,126,125,73
"6414",13,"[23]ErxsHnKqGocIHBJCeymAsye",224,0.995556,23,225,1,224,1,1,0,1,1,120,120,105,104,73
"6415",14,"[23]ErxsHnKqGocIHBJCeymAsye",231,0.99569,23,232,1,231,1,1,0,1,1,118,118,114,113,73
"6416",15,"[23]ErxsHnKqGocIHBJCeymAsye",231,0.99569,23,232,1,231,1,1,0,1,1,113,113,119,118,73
"6417",16,"[23]ErxsHnKqGocIHBJCeymAsye",234,0.995745,23,235,1,234,1,1,0,1,1,112,112,123,122,73
"6418",17,"[23]ErxsHnKqGocIHBJCeymAsye",231,0.99569,23,232,1,231,1,1,0,1,1,115,115,117,116,73
"6419",18,"[23]ErxsHnKqGocIHBJCeymAsye",231,0.99569,23,232,1,231,1,1,0,1,1,113,113,119,118,73
"6420",19,"[23]ErxsHnKqGocIHBJCeymAsye",231,0.99569,23,232,1,231,1,1,0,1,1,113,113,119,118,73
"6421",20,"[23]ErxsHnKqGocIHBJCeymAsye",243,0.995902,23,244,1,243,1,1,0,1,1,105,105,139,138,73
"6422",21,"[23]ErxsHnKqGocIHBJCeymAsye",230,0.995671,23,231,1,230,1,1,0,1,1,114,114,117,116,73
"6423",22,"[23]ErxsHnKqGocIHBJCeymAsye",224,0.995556,23,225,1,224,1,1,0,1,1,119,119,106,105,73
"6424",23,"[23]ErxsHnKqGocIHBJCeymAsye",226,0.995595,23,227,1,226,1,1,0,1,1,118,118,109,108,73
"6425",24,"[23]ErxsHnKqGocIHBJCeymAsye",226,0.995595,23,227,1,226,1,1,0,1,1,119,119,108,107,73
"6426",25,"[23]ErxsHnKqGocIHBJCeymAsye",234,0.995745,23,235,1,234,1,1,0,1,1,111,111,124,123,73
"6427",26,"[23]ErxsHnKqGocIHBJCeymAsye",238,0.995816,23,239,1,238,1,1,0,1,1,109,109,130,129,73
"6428",27,"[23]ErxsHnKqGocIHBJCeymAsye",226,0.995595,23,227,1,226,1,1,0,1,1,119,119,108,107,73
"6429",28,"[23]ErxsHnKqGocIHBJCeymAsye",233,0.995726,23,234,1,233,1,1,0,1,1,113,113,121,120,73
"6430",29,"[23]ErxsHnKqGocIHBJCeymAsye",238,0.995816,23,239,1,238,1,1,0,1,1,109,109,130,129,73
"6431",30,"[23]ErxsHnKqGocIHBJCeymAsye",232,0.995708,23,233,1,232,1,1,0,1,1,113,113,120,119,73
"6432",31,"[23]ErxsHnKqGocIHBJCeymAsye",229,0.995652,23,230,1,229,1,1,0,1,1,116,116,114,113,73
"6433",32,"[23]ErxsHnKqGocIHBJCeymAsye",224,0.995556,23,225,1,224,1,1,0,1,1,119,119,106,105,73
"6434",33,"[23]ErxsHnKqGocIHBJCeymAsye",225,0.995575,23,226,1,225,1,1,0,1,1,120,120,106,105,73
"6435",34,"[23]ErxsHnKqGocIHBJCeymAsye",226,0.995595,23,227,1,226,1,1,0,1,1,118,118,109,108,73
"6436",35,"[23]ErxsHnKqGocIHBJCeymAsye",230,0.995671,23,231,1,230,1,1,0,1,1,115,115,116,115,73
"6437",36,"[23]ErxsHnKqGocIHBJCeymAsye",226,0.995595,23,227,1,226,1,1,0,1,1,120,120,107,106,73
"6438",37,"[23]ErxsHnKqGocIHBJCeymAsye",229,0.995652,23,230,1,229,1,1,0,1,1,115,115,115,114,73
"6439",38,"[23]ErxsHnKqGocIHBJCeymAsye",229,0.995652,23,230,1,229,1,1,0,1,1,115,115,115,114,73
"6440",39,"[23]ErxsHnKqGocIHBJCeymAsye",228,0.995633,23,229,1,228,1,1,0,1,1,116,116,113,112,73
"6441",40,"[23]ErxsHnKqGocIHBJCeymAsye",218,0.995434,23,219,1,218,1,1,0,1,1,124,124,95,94,73
"6442",41,"[23]ErxsHnKqGocIHBJCeymAsye",221,0.995495,23,222,1,221,1,1,0,1,1,121,121,101,100,73
"6443",42,"[23]ErxsHnKqGocIHBJCeymAsye",233,0.995726,23,234,1,233,1,1,0,1,1,112,112,122,121,73
"6444",43,"[23]ErxsHnKqGocIHBJCeymAsye",223,0.995536,23,224,1,223,1,1,0,1,1,120,120,104,103,73
"6445",44,"[23]ErxsHnKqGocIHBJCeymAsye",227,0.995614,23,228,1,227,1,1,0,1,1,116,116,112,111,73
"6446",45,"[23]ErxsHnKqGocIHBJCeymAsye",225,0.995575,23,226,1,225,1,1,0,1,1,121,121,105,104,73
"6447",46,"[23]ErxsHnKqGocIHBJCeymAsye",225,0.995575,23,226,1,225,1,1,0,1,1,119,119,107,106,73
"6448",47,"[23]ErxsHnKqGocIHBJCeymAsye",226,0.995595,23,227,1,226,1,1,0,1,1,118,118,109,108,73
"6449",48,"[23]ErxsHnKqGocIHBJCeymAsye",227,0.995614,23,228,1,227,1,1,0,1,1,119,119,109,108,73
"6450",49,"[23]ErxsHnKqGocIHBJCeymAsye",226,0.995595,23,227,1,226,1,1,0,1,1,117,117,110,109,73
"6451",50,"[23]ErxsHnKqGocIHBJCeymAsye",234,0.995745,23,235,1,234,1,1,0,1,1,112,112,123,122,73
"6452",51,"[23]ErxsHnKqGocIHBJCeymAsye",240,0.995851,23,241,1,240,1,1,0,1,1,108,108,133,132,73
"6453",52,"[23]ErxsHnKqGocIHBJCeymAsye",235,0.995763,23,236,1,235,1,1,0,1,1,110,110,126,125,73
"6454",53,"[23]ErxsHnKqGocIHBJCeymAsye",227,0.995614,23,228,1,227,1,1,0,1,1,117,117,111,110,73
"6455",54,"[23]ErxsHnKqGocIHBJCeymAsye",225,0.995575,23,226,1,225,1,1,0,1,1,118,118,108,107,73
"6456",55,"[23]ErxsHnKqGocIHBJCeymAsye",234,0.995745,23,235,1,234,1,1,0,1,1,111,111,124,123,73
"6457",56,"[23]ErxsHnKqGocIHBJCeymAsye",230,0.995671,23,231,1,230,1,1,0,1,1,115,115,116,115,73
"6458",57,"[23]ErxsHnKqGocIHBJCeymAsye",231,0.99569,23,232,1,231,1,1,0,1,1,114,114,118,117,73
"6459",58,"[23]ErxsHnKqGocIHBJCeymAsye",227,0.995614,23,228,1,227,1,1,0,1,1,117,117,111,110,73
"6460",59,"[23]ErxsHnKqGocIHBJCeymAsye",236,0.995781,23,237,1,236,1,1,0,1,1,110,110,127,126,73
"6461",60,"[23]ErxsHnKqGocIHBJCeymAsye",225,0.995575,23,226,1,225,1,1,0,1,1,120,120,106,105,73
"6462",61,"[23]ErxsHnKqGocIHBJCeymAsye",226,0.995595,23,227,1,226,1,1,0,1,1,119,119,108,107,73
"6463",62,"[23]ErxsHnKqGocIHBJCeymAsye",226,0.995595,23,227,1,226,1,1,0,1,1,117,117,110,109,73
"6464",63,"[23]ErxsHnKqGocIHBJCeymAsye",236,0.995781,23,237,1,236,1,1,0,1,1,110,110,127,126,73
"6465",64,"[23]ErxsHnKqGocIHBJCeymAsye",229,0.995652,23,230,1,229,1,1,0,1,1,115,115,115,114,73
"6466",65,"[23]ErxsHnKqGocIHBJCeymAsye",227,0.995614,23,228,1,227,1,1,0,1,1,117,117,111,110,73
"6467",66,"[23]ErxsHnKqGocIHBJCeymAsye",229,0.995652,23,230,1,229,1,1,0,1,1,116,116,114,113,73
"6468",67,"[23]ErxsHnKqGocIHBJCeymAsye",240,0.995851,23,241,1,240,1,1,0,1,1,107,107,134,133,73
"6469",68,"[23]ErxsHnKqGocIHBJCeymAsye",230,0.995671,23,231,1,230,1,1,0,1,1,114,114,117,116,73
"6470",69,"[23]ErxsHnKqGocIHBJCeymAsye",234,0.995745,23,235,1,234,1,1,0,1,1,113,113,122,121,73
"6471",70,"[23]ErxsHnKqGocIHBJCeymAsye",240,0.995851,23,241,1,240,1,1,0,1,1,107,107,134,133,73
"6472",71,"[23]ErxsHnKqGocIHBJCeymAsye",237,0.995798,23,238,1,237,1,1,0,1,1,109,109,129,128,73
"6473",72,"[23]ErxsHnKqGocIHBJCeymAsye",227,0.995614,23,228,1,227,1,1,0,1,1,118,118,110,109,73
"6474",73,"[23]ErxsHnKqGocIHBJCeymAsye",229,0.995652,23,230,1,229,1,1,0,1,1,115,115,115,114,73
"6475",74,"[23]ErxsHnKqGocIHBJCeymAsye",232,0.995708,23,233,1,232,1,1,0,1,1,112,112,121,120,73
"6476",75,"[23]ErxsHnKqGocIHBJCeymAsye",229,0.995652,23,230,1,229,1,1,0,1,1,115,115,115,114,73
"6477",76,"[23]ErxsHnKqGocIHBJCeymAsye",227,0.995614,23,228,1,227,1,1,0,1,1,116,116,112,111,73
"6478",77,"[23]ErxsHnKqGocIHBJCeymAsye",238,0.995816,23,239,1,238,1,1,0,1,1,110,110,129,128,73
"6479",78,"[23]ErxsHnKqGocIHBJCeymAsye",229,0.995652,23,230,1,229,1,1,0,1,1,115,115,115,114,73
"6480",79,"[23]ErxsHnKqGocIHBJCeymAsye",232,0.995708,23,233,1,232,1,1,0,1,1,115,115,118,117,73
"6481",80,"[23]ErxsHnKqGocIHBJCeymAsye",222,0.995516,23,223,1,222,1,1,0,1,1,122,122,101,100,73
"6482",81,"[23]ErxsHnKqGocIHBJCeymAsye",228,0.995633,23,229,1,228,1,1,0,1,1,116,116,113,112,73
"6483",82,"[23]ErxsHnKqGocIHBJCeymAsye",222,0.995516,23,223,1,222,1,1,0,1,1,122,122,101,100,73
"6484",83,"[23]ErxsHnKqGocIHBJCeymAsye",224,0.995556,23,225,1,224,1,1,0,1,1,119,119,106,105,73
"6485",84,"[23]ErxsHnKqGocIHBJCeymAsye",229,0.995652,23,230,1,229,1,1,0,1,1,115,115,115,114,73
"6486",85,"[23]ErxsHnKqGocIHBJCeymAsye",225,0.995575,23,226,1,225,1,1,0,1,1,119,119,107,106,73
"6487",86,"[23]ErxsHnKqGocIHBJCeymAsye",225,0.995575,23,226,1,225,1,1,0,1,1,119,119,107,106,73
"6488",87,"[23]ErxsHnKqGocIHBJCeymAsye",232,0.995708,23,233,1,232,1,1,0,1,1,112,112,121,120,73
"6489",88,"[23]ErxsHnKqGocIHBJCeymAsye",222,0.995516,23,223,1,222,1,1,0,1,1,121,121,102,101,73
"6490",89,"[23]ErxsHnKqGocIHBJCeymAsye",229,0.995652,23,230,1,229,1,1,0,1,1,115,115,115,114,73
"6491",90,"[23]ErxsHnKqGocIHBJCeymAsye",238,0.995816,23,239,1,238,1,1,0,1,1,108,108,131,130,73
"6492",91,"[23]ErxsHnKqGocIHBJCeymAsye",227,0.995614,23,228,1,227,1,1,0,1,1,118,118,110,109,73
"6493",92,"[23]ErxsHnKqGocIHBJCeymAsye",227,0.995614,23,228,1,227,1,1,0,1,1,116,116,112,111,73
"6494",93,"[23]ErxsHnKqGocIHBJCeymAsye",240,0.995851,23,241,1,240,1,1,0,1,1,109,109,132,131,73
"6495",94,"[23]ErxsHnKqGocIHBJCeymAsye",226,0.995595,23,227,1,226,1,1,0,1,1,119,119,108,107,73
"6496",95,"[23]ErxsHnKqGocIHBJCeymAsye",231,0.99569,23,232,1,231,1,1,0,1,1,113,113,119,118,73
"6497",96,"[23]ErxsHnKqGocIHBJCeymAsye",226,0.995595,23,227,1,226,1,1,0,1,1,117,117,110,109,73
"6498",97,"[23]ErxsHnKqGocIHBJCeymAsye",224,0.995556,23,225,1,224,1,1,0,1,1,119,119,106,105,73
"6499",98,"[23]ErxsHnKqGocIHBJCeymAsye",233,0.995726,23,234,1,233,1,1,0,1,1,116,116,118,117,73
"6500",99,"[23]ErxsHnKqGocIHBJCeymAsye",237,0.995798,23,238,1,237,1,1,0,1,1,108,108,130,129,73
"6501",0,"[23]EaztuHnKqGocIHBJClbfqua",227,0.995614,23,228,1,227,1,1,0,1,1,116,116,112,111,74
"6502",1,"[23]EaztuHnKqGocIHBJClbfqua",232,0.995708,23,233,1,232,1,1,0,1,1,113,113,120,119,74
"6503",2,"[23]EaztuHnKqGocIHBJClbfqua",223,0.995536,23,224,1,223,1,1,0,1,1,120,120,104,103,74
"6504",3,"[23]EaztuHnKqGocIHBJClbfqua",224,0.995556,23,225,1,224,1,1,0,1,1,120,120,105,104,74
"6505",4,"[23]EaztuHnKqGocIHBJClbfqua",241,0.995868,23,242,1,241,1,1,0,1,1,106,106,136,135,74
"6506",5,"[23]EaztuHnKqGocIHBJClbfqua",221,0.995495,23,222,1,221,1,1,0,1,1,122,122,100,99,74
"6507",6,"[23]EaztuHnKqGocIHBJClbfqua",223,0.995536,23,224,1,223,1,1,0,1,1,119,119,105,104,74
"6508",7,"[23]EaztuHnKqGocIHBJClbfqua",233,0.995726,23,234,1,233,1,1,0,1,1,111,111,123,122,74
"6509",8,"[23]EaztuHnKqGocIHBJClbfqua",231,0.99569,23,232,1,231,1,1,0,1,1,114,114,118,117,74
"6510",9,"[23]EaztuHnKqGocIHBJClbfqua",237,0.995798,23,238,1,237,1,1,0,1,1,110,110,128,127,74
"6511",10,"[23]EaztuHnKqGocIHBJClbfqua",234,0.995745,23,235,1,234,1,1,0,1,1,111,111,124,123,74
"6512",11,"[23]EaztuHnKqGocIHBJClbfqua",232,0.995708,23,233,1,232,1,1,0,1,1,112,112,121,120,74
"6513",12,"[23]EaztuHnKqGocIHBJClbfqua",232,0.995708,23,233,1,232,1,1,0,1,1,113,113,120,119,74
"6514",13,"[23]EaztuHnKqGocIHBJClbfqua",233,0.995726,23,234,1,233,1,1,0,1,1,111,111,123,122,74
"6515",14,"[23]EaztuHnKqGocIHBJClbfqua",233,0.995726,23,234,1,233,1,1,0,1,1,115,115,119,118,74
"6516",15,"[23]EaztuHnKqGocIHBJClbfqua",235,0.995763,23,236,1,235,1,1,0,1,1,110,110,126,125,74
"6517",16,"[23]EaztuHnKqGocIHBJClbfqua",241,0.995868,23,242,1,241,1,1,0,1,1,106,106,136,135,74
"6518",17,"[23]EaztuHnKqGocIHBJClbfqua",236,0.995781,23,237,1,236,1,1,0,1,1,112,112,125,124,74
"6519",18,"[23]EaztuHnKqGocIHBJClbfqua",225,0.995575,23,226,1,225,1,1,0,1,1,119,119,107,106,74
"6520",19,"[23]EaztuHnKqGocIHBJClbfqua",235,0.995763,23,236,1,235,1,1,0,1,1,114,114,122,121,74
"6521",20,"[23]EaztuHnKqGocIHBJClbfqua",236,0.995781,23,237,1,236,1,1,0,1,1,110,110,127,126,74
"6522",21,"[23]EaztuHnKqGocIHBJClbfqua",233,0.995726,23,234,1,233,1,1,0,1,1,115,115,119,118,74
"6523",22,"[23]EaztuHnKqGocIHBJClbfqua",234,0.995745,23,235,1,234,1,1,0,1,1,112,112,123,122,74
"6524",23,"[23]EaztuHnKqGocIHBJClbfqua",236,0.995781,23,237,1,236,1,1,0,1,1,109,109,128,127,74
"6525",24,"[23]EaztuHnKqGocIHBJClbfqua",223,0.995536,23,224,1,223,1,1,0,1,1,119,119,105,104,74
"6526",25,"[23]EaztuHnKqGocIHBJClbfqua",235,0.995763,23,236,1,235,1,1,0,1,1,117,117,119,118,74
"6527",26,"[23]EaztuHnKqGocIHBJClbfqua",225,0.995575,23,226,1,225,1,1,0,1,1,119,119,107,106,74
"6528",27,"[23]EaztuHnKqGocIHBJClbfqua",227,0.995614,23,228,1,227,1,1,0,1,1,117,117,111,110,74
"6529",28,"[23]EaztuHnKqGocIHBJClbfqua",228,0.995633,23,229,1,228,1,1,0,1,1,116,116,113,112,74
"6530",29,"[23]EaztuHnKqGocIHBJClbfqua",232,0.995708,23,233,1,232,1,1,0,1,1,112,112,121,120,74
"6531",30,"[23]EaztuHnKqGocIHBJClbfqua",226,0.995595,23,227,1,226,1,1,0,1,1,120,120,107,106,74
"6532",31,"[23]EaztuHnKqGocIHBJClbfqua",231,0.99569,23,232,1,231,1,1,0,1,1,114,114,118,117,74
"6533",32,"[23]EaztuHnKqGocIHBJClbfqua",230,0.995671,23,231,1,230,1,1,0,1,1,114,114,117,116,74
"6534",33,"[23]EaztuHnKqGocIHBJClbfqua",237,0.995798,23,238,1,237,1,1,0,1,1,110,110,128,127,74
"6535",34,"[23]EaztuHnKqGocIHBJClbfqua",231,0.99569,23,232,1,231,1,1,0,1,1,115,115,117,116,74
"6536",35,"[23]EaztuHnKqGocIHBJClbfqua",229,0.995652,23,230,1,229,1,1,0,1,1,115,115,115,114,74
"6537",36,"[23]EaztuHnKqGocIHBJClbfqua",242,0.995885,23,243,1,242,1,1,0,1,1,105,105,138,137,74
"6538",37,"[23]EaztuHnKqGocIHBJClbfqua",231,0.99569,23,232,1,231,1,1,0,1,1,114,114,118,117,74
"6539",38,"[23]EaztuHnKqGocIHBJClbfqua",220,0.995475,23,221,1,220,1,1,0,1,1,122,122,99,98,74
"6540",39,"[23]EaztuHnKqGocIHBJClbfqua",223,0.995536,23,224,1,223,1,1,0,1,1,119,119,105,104,74
"6541",40,"[23]EaztuHnKqGocIHBJClbfqua",228,0.995633,23,229,1,228,1,1,0,1,1,115,115,114,113,74
"6542",41,"[23]EaztuHnKqGocIHBJClbfqua",225,0.995575,23,226,1,225,1,1,0,1,1,118,118,108,107,74
"6543",42,"[23]EaztuHnKqGocIHBJClbfqua",231,0.99569,23,232,1,231,1,1,0,1,1,116,116,116,115,74
"6544",43,"[23]EaztuHnKqGocIHBJClbfqua",238,0.995816,23,239,1,238,1,1,0,1,1,107,107,132,131,74
"6545",44,"[23]EaztuHnKqGocIHBJClbfqua",233,0.995726,23,234,1,233,1,1,0,1,1,111,111,123,122,74
"6546",45,"[23]EaztuHnKqGocIHBJClbfqua",233,0.995726,23,234,1,233,1,1,0,1,1,112,112,122,121,74
"6547",46,"[23]EaztuHnKqGocIHBJClbfqua",234,0.995745,23,235,1,234,1,1,0,1,1,113,113,122,121,74
"6548",47,"[23]EaztuHnKqGocIHBJClbfqua",230,0.995671,23,231,1,230,1,1,0,1,1,115,115,116,115,74
"6549",48,"[23]EaztuHnKqGocIHBJClbfqua",228,0.995633,23,229,1,228,1,1,0,1,1,117,117,112,111,74
"6550",49,"[23]EaztuHnKqGocIHBJClbfqua",232,0.995708,23,233,1,232,1,1,0,1,1,114,114,119,118,74
"6551",50,"[23]EaztuHnKqGocIHBJClbfqua",219,0.995455,23,220,1,219,1,1,0,1,1,124,124,96,95,74
"6552",51,"[23]EaztuHnKqGocIHBJClbfqua",242,0.995885,23,243,1,242,1,1,0,1,1,111,111,132,131,74
"6553",52,"[23]EaztuHnKqGocIHBJClbfqua",228,0.995633,23,229,1,228,1,1,0,1,1,117,117,112,111,74
"6554",53,"[23]EaztuHnKqGocIHBJClbfqua",223,0.995536,23,224,1,223,1,1,0,1,1,120,120,104,103,74
"6555",54,"[23]EaztuHnKqGocIHBJClbfqua",226,0.995595,23,227,1,226,1,1,0,1,1,117,117,110,109,74
"6556",55,"[23]EaztuHnKqGocIHBJClbfqua",223,0.995536,23,224,1,223,1,1,0,1,1,120,120,104,103,74
"6557",56,"[23]EaztuHnKqGocIHBJClbfqua",231,0.99569,23,232,1,231,1,1,0,1,1,113,113,119,118,74
"6558",57,"[23]EaztuHnKqGocIHBJClbfqua",230,0.995671,23,231,1,230,1,1,0,1,1,115,115,116,115,74
"6559",58,"[23]EaztuHnKqGocIHBJClbfqua",233,0.995726,23,234,1,233,1,1,0,1,1,112,112,122,121,74
"6560",59,"[23]EaztuHnKqGocIHBJClbfqua",232,0.995708,23,233,1,232,1,1,0,1,1,113,113,120,119,74
"6561",60,"[23]EaztuHnKqGocIHBJClbfqua",232,0.995708,23,233,1,232,1,1,0,1,1,113,113,120,119,74
"6562",61,"[23]EaztuHnKqGocIHBJClbfqua",230,0.995671,23,231,1,230,1,1,0,1,1,115,115,116,115,74
"6563",62,"[23]EaztuHnKqGocIHBJClbfqua",232,0.995708,23,233,1,232,1,1,0,1,1,112,112,121,120,74
"6564",63,"[23]EaztuHnKqGocIHBJClbfqua",214,0.995349,23,215,1,214,1,1,0,1,1,128,128,87,86,74
"6565",64,"[23]EaztuHnKqGocIHBJClbfqua",228,0.995633,23,229,1,228,1,1,0,1,1,116,116,113,112,74
"6566",65,"[23]EaztuHnKqGocIHBJClbfqua",235,0.995763,23,236,1,235,1,1,0,1,1,117,117,119,118,74
"6567",66,"[23]EaztuHnKqGocIHBJClbfqua",232,0.995708,23,233,1,232,1,1,0,1,1,113,113,120,119,74
"6568",67,"[23]EaztuHnKqGocIHBJClbfqua",217,0.995413,23,218,1,217,1,1,0,1,1,124,124,94,93,74
"6569",68,"[23]EaztuHnKqGocIHBJClbfqua",231,0.99569,23,232,1,231,1,1,0,1,1,113,113,119,118,74
"6570",69,"[23]EaztuHnKqGocIHBJClbfqua",234,0.995745,23,235,1,234,1,1,0,1,1,111,111,124,123,74
"6571",70,"[23]EaztuHnKqGocIHBJClbfqua",241,0.995868,23,242,1,241,1,1,0,1,1,109,109,133,132,74
"6572",71,"[23]EaztuHnKqGocIHBJClbfqua",236,0.995781,23,237,1,236,1,1,0,1,1,109,109,128,127,74
"6573",72,"[23]EaztuHnKqGocIHBJClbfqua",226,0.995595,23,227,1,226,1,1,0,1,1,117,117,110,109,74
"6574",73,"[23]EaztuHnKqGocIHBJClbfqua",223,0.995536,23,224,1,223,1,1,0,1,1,120,120,104,103,74
"6575",74,"[23]EaztuHnKqGocIHBJClbfqua",236,0.995781,23,237,1,236,1,1,0,1,1,110,110,127,126,74
"6576",75,"[23]EaztuHnKqGocIHBJClbfqua",223,0.995536,23,224,1,223,1,1,0,1,1,120,120,104,103,74
"6577",76,"[23]EaztuHnKqGocIHBJClbfqua",225,0.995575,23,226,1,225,1,1,0,1,1,121,121,105,104,74
"6578",77,"[23]EaztuHnKqGocIHBJClbfqua",225,0.995575,23,226,1,225,1,1,0,1,1,119,119,107,106,74
"6579",78,"[23]EaztuHnKqGocIHBJClbfqua",243,0.995902,23,244,1,243,1,1,0,1,1,103,103,141,140,74
"6580",79,"[23]EaztuHnKqGocIHBJClbfqua",237,0.995798,23,238,1,237,1,1,0,1,1,108,108,130,129,74
"6581",80,"[23]EaztuHnKqGocIHBJClbfqua",228,0.995633,23,229,1,228,1,1,0,1,1,115,115,114,113,74
"6582",81,"[23]EaztuHnKqGocIHBJClbfqua",235,0.995763,23,236,1,235,1,1,0,1,1,111,111,125,124,74
"6583",82,"[23]EaztuHnKqGocIHBJClbfqua",237,0.995798,23,238,1,237,1,1,0,1,1,110,110,128,127,74
"6584",83,"[23]EaztuHnKqGocIHBJClbfqua",245,0.995935,23,246,1,245,1,1,0,1,1,103,103,143,142,74
"6585",84,"[23]EaztuHnKqGocIHBJClbfqua",227,0.995614,23,228,1,227,1,1,0,1,1,118,118,110,109,74
"6586",85,"[23]EaztuHnKqGocIHBJClbfqua",230,0.995671,23,231,1,230,1,1,0,1,1,114,114,117,116,74
"6587",86,"[23]EaztuHnKqGocIHBJClbfqua",235,0.995763,23,236,1,235,1,1,0,1,1,111,111,125,124,74
"6588",87,"[23]EaztuHnKqGocIHBJClbfqua",232,0.995708,23,233,1,232,1,1,0,1,1,113,113,120,119,74
"6589",88,"[23]EaztuHnKqGocIHBJClbfqua",232,0.995708,23,233,1,232,1,1,0,1,1,115,115,118,117,74
"6590",89,"[23]EaztuHnKqGocIHBJClbfqua",229,0.995652,23,230,1,229,1,1,0,1,1,115,115,115,114,74
"6591",90,"[23]EaztuHnKqGocIHBJClbfqua",222,0.995516,23,223,1,222,1,1,0,1,1,121,121,102,101,74
"6592",91,"[23]EaztuHnKqGocIHBJClbfqua",223,0.995536,23,224,1,223,1,1,0,1,1,120,120,104,103,74
"6593",92,"[23]EaztuHnKqGocIHBJClbfqua",218,0.995434,23,219,1,218,1,1,0,1,1,124,124,95,94,74
"6594",93,"[23]EaztuHnKqGocIHBJClbfqua",218,0.995434,23,219,1,218,1,1,0,1,1,124,124,95,94,74
"6595",94,"[23]EaztuHnKqGocIHBJClbfqua",226,0.995595,23,227,1,226,1,1,0,1,1,118,118,109,108,74
"6596",95,"[23]EaztuHnKqGocIHBJClbfqua",233,0.995726,23,234,1,233,1,1,0,1,1,114,114,120,119,74
"6597",96,"[23]EaztuHnKqGocIHBJClbfqua",242,0.995885,23,243,1,242,1,1,0,1,1,105,105,138,137,74
"6598",97,"[23]EaztuHnKqGocIHBJClbfqua",227,0.995614,23,228,1,227,1,1,0,1,1,117,117,111,110,74
"6599",98,"[23]EaztuHnKqGocIHBJClbfqua",235,0.995763,23,236,1,235,1,1,0,1,1,112,112,124,123,74
"6600",99,"[23]EaztuHnKqGocIHBJClbfqua",227,0.995614,23,228,1,227,1,1,0,1,1,117,117,111,110,74
"6601",0,"[27]EozrtHnKqGocIHcJCGIDtGEjgtF",228,0.995633,27,229,1,228,1,1,0,1,1,117,117,112,111,75
"6602",1,"[27]EozrtHnKqGocIHcJCGIDtGEjgtF",230,0.995671,27,231,1,230,1,1,0,1,1,114,114,117,116,75
"6603",2,"[27]EozrtHnKqGocIHcJCGIDtGEjgtF",241,0.995868,27,242,1,241,1,1,0,1,1,106,106,136,135,75
"6604",3,"[27]EozrtHnKqGocIHcJCGIDtGEjgtF",225,0.995575,27,226,1,225,1,1,0,1,1,119,119,107,106,75
"6605",4,"[27]EozrtHnKqGocIHcJCGIDtGEjgtF",230,0.995671,27,231,1,230,1,1,0,1,1,119,119,112,111,75
"6606",5,"[27]EozrtHnKqGocIHcJCGIDtGEjgtF",234,0.995745,27,235,1,234,1,1,0,1,1,111,111,124,123,75
"6607",6,"[27]EozrtHnKqGocIHcJCGIDtGEjgtF",226,0.995595,27,227,1,226,1,1,0,1,1,119,119,108,107,75
"6608",7,"[27]EozrtHnKqGocIHcJCGIDtGEjgtF",242,0.995885,27,243,1,242,1,1,0,1,1,104,104,139,138,75
"6609",8,"[27]EozrtHnKqGocIHcJCGIDtGEjgtF",225,0.995575,27,226,1,225,1,1,0,1,1,118,118,108,107,75
"6610",9,"[27]EozrtHnKqGocIHcJCGIDtGEjgtF",234,0.995745,27,235,1,234,1,1,0,1,1,112,112,123,122,75
"6611",10,"[27]EozrtHnKqGocIHcJCGIDtGEjgtF",235,0.995763,27,236,1,235,1,1,0,1,1,110,110,126,125,75
"6612",11,"[27]EozrtHnKqGocIHcJCGIDtGEjgtF",240,0.995851,27,241,1,240,1,1,0,1,1,108,108,133,132,75
"6613",12,"[27]EozrtHnKqGocIHcJCGIDtGEjgtF",231,0.99569,27,232,1,231,1,1,0,1,1,115,115,117,116,75
"6614",13,"[27]EozrtHnKqGocIHcJCGIDtGEjgtF",225,0.995575,27,226,1,225,1,1,0,1,1,119,119,107,106,75
"6615",14,"[27]EozrtHnKqGocIHcJCGIDtGEjgtF",236,0.995781,27,237,1,236,1,1,0,1,1,109,109,128,127,75
"6616",15,"[27]EozrtHnKqGocIHcJCGIDtGEjgtF",227,0.995614,27,228,1,227,1,1,0,1,1,120,120,108,107,75
"6617",16,"[27]EozrtHnKqGocIHcJCGIDtGEjgtF",233,0.995726,27,234,1,233,1,1,0,1,1,114,114,120,119,75
"6618",17,"[27]EozrtHnKqGocIHcJCGIDtGEjgtF",225,0.995575,27,226,1,225,1,1,0,1,1,118,118,108,107,75
"6619",18,"[27]EozrtHnKqGocIHcJCGIDtGEjgtF",224,0.995556,27,225,1,224,1,1,0,1,1,119,119,106,105,75
"6620",19,"[27]EozrtHnKqGocIHcJCGIDtGEjgtF",229,0.995652,27,230,1,229,1,1,0,1,1,115,115,115,114,75
"6621",20,"[27]EozrtHnKqGocIHcJCGIDtGEjgtF",234,0.995745,27,235,1,234,1,1,0,1,1,112,112,123,122,75
"6622",21,"[27]EozrtHnKqGocIHcJCGIDtGEjgtF",236,0.995781,27,237,1,236,1,1,0,1,1,109,109,128,127,75
"6623",22,"[27]EozrtHnKqGocIHcJCGIDtGEjgtF",230,0.995671,27,231,1,230,1,1,0,1,1,114,114,117,116,75
"6624",23,"[27]EozrtHnKqGocIHcJCGIDtGEjgtF",232,0.995708,27,233,1,232,1,1,0,1,1,112,112,121,120,75
"6625",24,"[27]EozrtHnKqGocIHcJCGIDtGEjgtF",227,0.995614,27,228,1,227,1,1,0,1,1,116,116,112,111,75
"6626",25,"[27]EozrtHnKqGocIHcJCGIDtGEjgtF",237,0.995798,27,238,1,237,1,1,0,1,1,108,108,130,129,75
"6627",26,"[27]EozrtHnKqGocIHcJCGIDtGEjgtF",240,0.995851,27,241,1,240,1,1,0,1,1,107,107,134,133,75
"6628",27,"[27]EozrtHnKqGocIHcJCGIDtGEjgtF",231,0.99569,27,232,1,231,1,1,0,1,1,115,115,117,116,75
"6629",28,"[27]EozrtHnKqGocIHcJCGIDtGEjgtF",220,0.995475,27,221,1,220,1,1,0,1,1,123,123,98,97,75
"6630",29,"[27]EozrtHnKqGocIHcJCGIDtGEjgtF",232,0.995708,27,233,1,232,1,1,0,1,1,112,112,121,120,75
"6631",30,"[27]EozrtHnKqGocIHcJCGIDtGEjgtF",239,0.995833,27,240,1,239,1,1,0,1,1,107,107,133,132,75
"6632",31,"[27]EozrtHnKqGocIHcJCGIDtGEjgtF",224,0.995556,27,225,1,224,1,1,0,1,1,119,119,106,105,75
"6633",32,"[27]EozrtHnKqGocIHcJCGIDtGEjgtF",223,0.995536,27,224,1,223,1,1,0,1,1,124,124,100,99,75
"6634",33,"[27]EozrtHnKqGocIHcJCGIDtGEjgtF",231,0.99569,27,232,1,231,1,1,0,1,1,114,114,118,117,75
"6635",34,"[27]EozrtHnKqGocIHcJCGIDtGEjgtF",235,0.995763,27,236,1,235,1,1,0,1,1,111,111,125,124,75
"6636",35,"[27]EozrtHnKqGocIHcJCGIDtGEjgtF",242,0.995885,27,243,1,242,1,1,0,1,1,104,104,139,138,75
"6637",36,"[27]EozrtHnKqGocIHcJCGIDtGEjgtF",240,0.995851,27,241,1,240,1,1,0,1,1,107,107,134,133,75
"6638",37,"[27]EozrtHnKqGocIHcJCGIDtGEjgtF",233,0.995726,27,234,1,233,1,1,0,1,1,112,112,122,121,75
"6639",38,"[27]EozrtHnKqGocIHcJCGIDtGEjgtF",242,0.995885,27,243,1,242,1,1,0,1,1,105,105,138,137,75
"6640",39,"[27]EozrtHnKqGocIHcJCGIDtGEjgtF",227,0.995614,27,228,1,227,1,1,0,1,1,119,119,109,108,75
"6641",40,"[27]EozrtHnKqGocIHcJCGIDtGEjgtF",234,0.995745,27,235,1,234,1,1,0,1,1,112,112,123,122,75
"6642",41,"[27]EozrtHnKqGocIHcJCGIDtGEjgtF",240,0.995851,27,241,1,240,1,1,0,1,1,107,107,134,133,75
"6643",42,"[27]EozrtHnKqGocIHcJCGIDtGEjgtF",234,0.995745,27,235,1,234,1,1,0,1,1,112,112,123,122,75
"6644",43,"[27]EozrtHnKqGocIHcJCGIDtGEjgtF",229,0.995652,27,230,1,229,1,1,0,1,1,117,117,113,112,75
"6645",44,"[27]EozrtHnKqGocIHcJCGIDtGEjgtF",230,0.995671,27,231,1,230,1,1,0,1,1,119,119,112,111,75
"6646",45,"[27]EozrtHnKqGocIHcJCGIDtGEjgtF",225,0.995575,27,226,1,225,1,1,0,1,1,119,119,107,106,75
"6647",46,"[27]EozrtHnKqGocIHcJCGIDtGEjgtF",222,0.995516,27,223,1,222,1,1,0,1,1,120,120,103,102,75
"6648",47,"[27]EozrtHnKqGocIHcJCGIDtGEjgtF",231,0.99569,27,232,1,231,1,1,0,1,1,113,113,119,118,75
"6649",48,"[27]EozrtHnKqGocIHcJCGIDtGEjgtF",236,0.995781,27,237,1,236,1,1,0,1,1,113,113,124,123,75
"6650",49,"[27]EozrtHnKqGocIHcJCGIDtGEjgtF",229,0.995652,27,230,1,229,1,1,0,1,1,115,115,115,114,75
"6651",50,"[27]EozrtHnKqGocIHcJCGIDtGEjgtF",233,0.995726,27,234,1,233,1,1,0,1,1,113,113,121,120,75
"6652",51,"[27]EozrtHnKqGocIHcJCGIDtGEjgtF",234,0.995745,27,235,1,234,1,1,0,1,1,113,113,122,121,75
"6653",52,"[27]EozrtHnKqGocIHcJCGIDtGEjgtF",232,0.995708,27,233,1,232,1,1,0,1,1,115,115,118,117,75
"6654",53,"[27]EozrtHnKqGocIHcJCGIDtGEjgtF",232,0.995708,27,233,1,232,1,1,0,1,1,115,115,118,117,75
"6655",54,"[27]EozrtHnKqGocIHcJCGIDtGEjgtF",231,0.99569,27,232,1,231,1,1,0,1,1,113,113,119,118,75
"6656",55,"[27]EozrtHnKqGocIHcJCGIDtGEjgtF",220,0.995475,27,221,1,220,1,1,0,1,1,122,122,99,98,75
"6657",56,"[27]EozrtHnKqGocIHcJCGIDtGEjgtF",231,0.99569,27,232,1,231,1,1,0,1,1,116,116,116,115,75
"6658",57,"[27]EozrtHnKqGocIHcJCGIDtGEjgtF",227,0.995614,27,228,1,227,1,1,0,1,1,117,117,111,110,75
"6659",58,"[27]EozrtHnKqGocIHcJCGIDtGEjgtF",234,0.995745,27,235,1,234,1,1,0,1,1,112,112,123,122,75
"6660",59,"[27]EozrtHnKqGocIHcJCGIDtGEjgtF",235,0.995763,27,236,1,235,1,1,0,1,1,112,112,124,123,75
"6661",60,"[27]EozrtHnKqGocIHcJCGIDtGEjgtF",225,0.995575,27,226,1,225,1,1,0,1,1,118,118,108,107,75
"6662",61,"[27]EozrtHnKqGocIHcJCGIDtGEjgtF",228,0.995633,27,229,1,228,1,1,0,1,1,116,116,113,112,75
"6663",62,"[27]EozrtHnKqGocIHcJCGIDtGEjgtF",247,0.995968,27,248,1,247,1,1,0,1,1,104,104,144,143,75
"6664",63,"[27]EozrtHnKqGocIHcJCGIDtGEjgtF",235,0.995763,27,236,1,235,1,1,0,1,1,110,110,126,125,75
"6665",64,"[27]EozrtHnKqGocIHcJCGIDtGEjgtF",224,0.995556,27,225,1,224,1,1,0,1,1,119,119,106,105,75
"6666",65,"[27]EozrtHnKqGocIHcJCGIDtGEjgtF",233,0.995726,27,234,1,233,1,1,0,1,1,114,114,120,119,75
"6667",66,"[27]EozrtHnKqGocIHcJCGIDtGEjgtF",231,0.99569,27,232,1,231,1,1,0,1,1,114,114,118,117,75
"6668",67,"[27]EozrtHnKqGocIHcJCGIDtGEjgtF",241,0.995868,27,242,1,241,1,1,0,1,1,106,106,136,135,75
"6669",68,"[27]EozrtHnKqGocIHcJCGIDtGEjgtF",247,0.995968,27,248,1,247,1,1,0,1,1,104,104,144,143,75
"6670",69,"[27]EozrtHnKqGocIHcJCGIDtGEjgtF",221,0.995495,27,222,1,221,1,1,0,1,1,121,121,101,100,75
"6671",70,"[27]EozrtHnKqGocIHcJCGIDtGEjgtF",238,0.995816,27,239,1,238,1,1,0,1,1,115,115,124,123,75
"6672",71,"[27]EozrtHnKqGocIHcJCGIDtGEjgtF",234,0.995745,27,235,1,234,1,1,0,1,1,112,112,123,122,75
"6673",72,"[27]EozrtHnKqGocIHcJCGIDtGEjgtF",244,0.995918,27,245,1,244,1,1,0,1,1,103,103,142,141,75
"6674",73,"[27]EozrtHnKqGocIHcJCGIDtGEjgtF",221,0.995495,27,222,1,221,1,1,0,1,1,121,121,101,100,75
"6675",74,"[27]EozrtHnKqGocIHcJCGIDtGEjgtF",231,0.99569,27,232,1,231,1,1,0,1,1,114,114,118,117,75
"6676",75,"[27]EozrtHnKqGocIHcJCGIDtGEjgtF",220,0.995475,27,221,1,220,1,1,0,1,1,123,123,98,97,75
"6677",76,"[27]EozrtHnKqGocIHcJCGIDtGEjgtF",223,0.995536,27,224,1,223,1,1,0,1,1,122,122,102,101,75
"6678",77,"[27]EozrtHnKqGocIHcJCGIDtGEjgtF",226,0.995595,27,227,1,226,1,1,0,1,1,117,117,110,109,75
"6679",78,"[27]EozrtHnKqGocIHcJCGIDtGEjgtF",233,0.995726,27,234,1,233,1,1,0,1,1,116,116,118,117,75
"6680",79,"[27]EozrtHnKqGocIHcJCGIDtGEjgtF",231,0.99569,27,232,1,231,1,1,0,1,1,113,113,119,118,75
"6681",80,"[27]EozrtHnKqGocIHcJCGIDtGEjgtF",233,0.995726,27,234,1,233,1,1,0,1,1,113,113,121,120,75
"6682",81,"[27]EozrtHnKqGocIHcJCGIDtGEjgtF",226,0.995595,27,227,1,226,1,1,0,1,1,119,119,108,107,75
"6683",82,"[27]EozrtHnKqGocIHcJCGIDtGEjgtF",225,0.995575,27,226,1,225,1,1,0,1,1,120,120,106,105,75
"6684",83,"[27]EozrtHnKqGocIHcJCGIDtGEjgtF",237,0.995798,27,238,1,237,1,1,0,1,1,109,109,129,128,75
"6685",84,"[27]EozrtHnKqGocIHcJCGIDtGEjgtF",230,0.995671,27,231,1,230,1,1,0,1,1,116,116,115,114,75
"6686",85,"[27]EozrtHnKqGocIHcJCGIDtGEjgtF",227,0.995614,27,228,1,227,1,1,0,1,1,116,116,112,111,75
"6687",86,"[27]EozrtHnKqGocIHcJCGIDtGEjgtF",242,0.995885,27,243,1,242,1,1,0,1,1,106,106,137,136,75
"6688",87,"[27]EozrtHnKqGocIHcJCGIDtGEjgtF",221,0.995495,27,222,1,221,1,1,0,1,1,122,122,100,99,75
"6689",88,"[27]EozrtHnKqGocIHcJCGIDtGEjgtF",237,0.995798,27,238,1,237,1,1,0,1,1,112,112,126,125,75
"6690",89,"[27]EozrtHnKqGocIHcJCGIDtGEjgtF",229,0.995652,27,230,1,229,1,1,0,1,1,116,116,114,113,75
"6691",90,"[27]EozrtHnKqGocIHcJCGIDtGEjgtF",236,0.995781,27,237,1,236,1,1,0,1,1,109,109,128,127,75
"6692",91,"[27]EozrtHnKqGocIHcJCGIDtGEjgtF",224,0.995556,27,225,1,224,1,1,0,1,1,119,119,106,105,75
"6693",92,"[27]EozrtHnKqGocIHcJCGIDtGEjgtF",224,0.995556,27,225,1,224,1,1,0,1,1,120,120,105,104,75
"6694",93,"[27]EozrtHnKqGocIHcJCGIDtGEjgtF",230,0.995671,27,231,1,230,1,1,0,1,1,115,115,116,115,75
"6695",94,"[27]EozrtHnKqGocIHcJCGIDtGEjgtF",232,0.995708,27,233,1,232,1,1,0,1,1,114,114,119,118,75
"6696",95,"[27]EozrtHnKqGocIHcJCGIDtGEjgtF",225,0.995575,27,226,1,225,1,1,0,1,1,119,119,107,106,75
"6697",96,"[27]EozrtHnKqGocIHcJCGIDtGEjgtF",229,0.995652,27,230,1,229,1,1,0,1,1,116,116,114,113,75
"6698",97,"[27]EozrtHnKqGocIHcJCGIDtGEjgtF",231,0.99569,27,232,1,231,1,1,0,1,1,113,113,119,118,75
"6699",98,"[27]EozrtHnKqGocIHcJCGIDtGEjgtF",231,0.99569,27,232,1,231,1,1,0,1,1,113,113,119,118,75
"6700",99,"[27]EozrtHnKqGocIHcJCGIDtGEjgtF",229,0.995652,27,230,1,229,1,1,0,1,1,116,116,114,113,75
"6701",0,"[24]EgyGsHnKqGocIHBJCFggwHtm",229,0.995652,24,230,1,229,1,1,0,1,1,115,115,115,114,76
"6702",1,"[24]EgyGsHnKqGocIHBJCFggwHtm",227,0.995614,24,228,1,227,1,1,0,1,1,117,117,111,110,76
"6703",2,"[24]EgyGsHnKqGocIHBJCFggwHtm",221,0.995495,24,222,1,221,1,1,0,1,1,121,121,101,100,76
"6704",3,"[24]EgyGsHnKqGocIHBJCFggwHtm",230,0.995671,24,231,1,230,1,1,0,1,1,115,115,116,115,76
"6705",4,"[24]EgyGsHnKqGocIHBJCFggwHtm",238,0.995816,24,239,1,238,1,1,0,1,1,112,112,127,126,76
"6706",5,"[24]EgyGsHnKqGocIHBJCFggwHtm",240,0.995851,24,241,1,240,1,1,0,1,1,110,110,131,130,76
"6707",6,"[24]EgyGsHnKqGocIHBJCFggwHtm",231,0.99569,24,232,1,231,1,1,0,1,1,114,114,118,117,76
"6708",7,"[24]EgyGsHnKqGocIHBJCFggwHtm",224,0.995556,24,225,1,224,1,1,0,1,1,119,119,106,105,76
"6709",8,"[24]EgyGsHnKqGocIHBJCFggwHtm",223,0.995536,24,224,1,223,1,1,0,1,1,120,120,104,103,76
"6710",9,"[24]EgyGsHnKqGocIHBJCFggwHtm",231,0.99569,24,232,1,231,1,1,0,1,1,114,114,118,117,76
"6711",10,"[24]EgyGsHnKqGocIHBJCFggwHtm",225,0.995575,24,226,1,225,1,1,0,1,1,118,118,108,107,76
"6712",11,"[24]EgyGsHnKqGocIHBJCFggwHtm",232,0.995708,24,233,1,232,1,1,0,1,1,113,113,120,119,76
"6713",12,"[24]EgyGsHnKqGocIHBJCFggwHtm",238,0.995816,24,239,1,238,1,1,0,1,1,108,108,131,130,76
"6714",13,"[24]EgyGsHnKqGocIHBJCFggwHtm",237,0.995798,24,238,1,237,1,1,0,1,1,108,108,130,129,76
"6715",14,"[24]EgyGsHnKqGocIHBJCFggwHtm",226,0.995595,24,227,1,226,1,1,0,1,1,118,118,109,108,76
"6716",15,"[24]EgyGsHnKqGocIHBJCFggwHtm",222,0.995516,24,223,1,222,1,1,0,1,1,123,123,100,99,76
"6717",16,"[24]EgyGsHnKqGocIHBJCFggwHtm",229,0.995652,24,230,1,229,1,1,0,1,1,116,116,114,113,76
"6718",17,"[24]EgyGsHnKqGocIHBJCFggwHtm",236,0.995781,24,237,1,236,1,1,0,1,1,109,109,128,127,76
"6719",18,"[24]EgyGsHnKqGocIHBJCFggwHtm",233,0.995726,24,234,1,233,1,1,0,1,1,112,112,122,121,76
"6720",19,"[24]EgyGsHnKqGocIHBJCFggwHtm",223,0.995536,24,224,1,223,1,1,0,1,1,120,120,104,103,76
"6721",20,"[24]EgyGsHnKqGocIHBJCFggwHtm",231,0.99569,24,232,1,231,1,1,0,1,1,114,114,118,117,76
"6722",21,"[24]EgyGsHnKqGocIHBJCFggwHtm",234,0.995745,24,235,1,234,1,1,0,1,1,112,112,123,122,76
"6723",22,"[24]EgyGsHnKqGocIHBJCFggwHtm",230,0.995671,24,231,1,230,1,1,0,1,1,118,118,113,112,76
"6724",23,"[24]EgyGsHnKqGocIHBJCFggwHtm",238,0.995816,24,239,1,238,1,1,0,1,1,111,111,128,127,76
"6725",24,"[24]EgyGsHnKqGocIHBJCFggwHtm",231,0.99569,24,232,1,231,1,1,0,1,1,115,115,117,116,76
"6726",25,"[24]EgyGsHnKqGocIHBJCFggwHtm",236,0.995781,24,237,1,236,1,1,0,1,1,110,110,127,126,76
"6727",26,"[24]EgyGsHnKqGocIHBJCFggwHtm",228,0.995633,24,229,1,228,1,1,0,1,1,115,115,114,113,76
"6728",27,"[24]EgyGsHnKqGocIHBJCFggwHtm",218,0.995434,24,219,1,218,1,1,0,1,1,123,123,96,95,76
"6729",28,"[24]EgyGsHnKqGocIHBJCFggwHtm",237,0.995798,24,238,1,237,1,1,0,1,1,111,111,127,126,76
"6730",29,"[24]EgyGsHnKqGocIHBJCFggwHtm",239,0.995833,24,240,1,239,1,1,0,1,1,107,107,133,132,76
"6731",30,"[24]EgyGsHnKqGocIHBJCFggwHtm",230,0.995671,24,231,1,230,1,1,0,1,1,114,114,117,116,76
"6732",31,"[24]EgyGsHnKqGocIHBJCFggwHtm",232,0.995708,24,233,1,232,1,1,0,1,1,114,114,119,118,76
"6733",32,"[24]EgyGsHnKqGocIHBJCFggwHtm",224,0.995556,24,225,1,224,1,1,0,1,1,120,120,105,104,76
"6734",33,"[24]EgyGsHnKqGocIHBJCFggwHtm",223,0.995536,24,224,1,223,1,1,0,1,1,120,120,104,103,76
"6735",34,"[24]EgyGsHnKqGocIHBJCFggwHtm",226,0.995595,24,227,1,226,1,1,0,1,1,118,118,109,108,76
"6736",35,"[24]EgyGsHnKqGocIHBJCFggwHtm",231,0.99569,24,232,1,231,1,1,0,1,1,113,113,119,118,76
"6737",36,"[24]EgyGsHnKqGocIHBJCFggwHtm",245,0.995935,24,246,1,245,1,1,0,1,1,105,105,141,140,76
"6738",37,"[24]EgyGsHnKqGocIHBJCFggwHtm",228,0.995633,24,229,1,228,1,1,0,1,1,117,117,112,111,76
"6739",38,"[24]EgyGsHnKqGocIHBJCFggwHtm",233,0.995726,24,234,1,233,1,1,0,1,1,112,112,122,121,76
"6740",39,"[24]EgyGsHnKqGocIHBJCFggwHtm",233,0.995726,24,234,1,233,1,1,0,1,1,113,113,121,120,76
"6741",40,"[24]EgyGsHnKqGocIHBJCFggwHtm",219,0.995455,24,220,1,219,1,1,0,1,1,124,124,96,95,76
"6742",41,"[24]EgyGsHnKqGocIHBJCFggwHtm",223,0.995536,24,224,1,223,1,1,0,1,1,119,119,105,104,76
"6743",42,"[24]EgyGsHnKqGocIHBJCFggwHtm",233,0.995726,24,234,1,233,1,1,0,1,1,111,111,123,122,76
"6744",43,"[24]EgyGsHnKqGocIHBJCFggwHtm",235,0.995763,24,236,1,235,1,1,0,1,1,112,112,124,123,76
"6745",44,"[24]EgyGsHnKqGocIHBJCFggwHtm",227,0.995614,24,228,1,227,1,1,0,1,1,116,116,112,111,76
"6746",45,"[24]EgyGsHnKqGocIHBJCFggwHtm",231,0.99569,24,232,1,231,1,1,0,1,1,113,113,119,118,76
"6747",46,"[24]EgyGsHnKqGocIHBJCFggwHtm",244,0.995918,24,245,1,244,1,1,0,1,1,104,104,141,140,76
"6748",47,"[24]EgyGsHnKqGocIHBJCFggwHtm",231,0.99569,24,232,1,231,1,1,0,1,1,113,113,119,118,76
"6749",48,"[24]EgyGsHnKqGocIHBJCFggwHtm",235,0.995763,24,236,1,235,1,1,0,1,1,111,111,125,124,76
"6750",49,"[24]EgyGsHnKqGocIHBJCFggwHtm",233,0.995726,24,234,1,233,1,1,0,1,1,113,113,121,120,76
"6751",50,"[24]EgyGsHnKqGocIHBJCFggwHtm",218,0.995434,24,219,1,218,1,1,0,1,1,124,124,95,94,76
"6752",51,"[24]EgyGsHnKqGocIHBJCFggwHtm",227,0.995614,24,228,1,227,1,1,0,1,1,116,116,112,111,76
"6753",52,"[24]EgyGsHnKqGocIHBJCFggwHtm",232,0.995708,24,233,1,232,1,1,0,1,1,112,112,121,120,76
"6754",53,"[24]EgyGsHnKqGocIHBJCFggwHtm",225,0.995575,24,226,1,225,1,1,0,1,1,119,119,107,106,76
"6755",54,"[24]EgyGsHnKqGocIHBJCFggwHtm",239,0.995833,24,240,1,239,1,1,0,1,1,107,107,133,132,76
"6756",55,"[24]EgyGsHnKqGocIHBJCFggwHtm",236,0.995781,24,237,1,236,1,1,0,1,1,111,111,126,125,76
"6757",56,"[24]EgyGsHnKqGocIHBJCFggwHtm",247,0.995968,24,248,1,247,1,1,0,1,1,103,103,145,144,76
"6758",57,"[24]EgyGsHnKqGocIHBJCFggwHtm",222,0.995516,24,223,1,222,1,1,0,1,1,120,120,103,102,76
"6759",58,"[24]EgyGsHnKqGocIHBJCFggwHtm",234,0.995745,24,235,1,234,1,1,0,1,1,113,113,122,121,76
"6760",59,"[24]EgyGsHnKqGocIHBJCFggwHtm",230,0.995671,24,231,1,230,1,1,0,1,1,114,114,117,116,76
"6761",60,"[24]EgyGsHnKqGocIHBJCFggwHtm",223,0.995536,24,224,1,223,1,1,0,1,1,119,119,105,104,76
"6762",61,"[24]EgyGsHnKqGocIHBJCFggwHtm",225,0.995575,24,226,1,225,1,1,0,1,1,118,118,108,107,76
"6763",62,"[24]EgyGsHnKqGocIHBJCFggwHtm",230,0.995671,24,231,1,230,1,1,0,1,1,116,116,115,114,76
"6764",63,"[24]EgyGsHnKqGocIHBJCFggwHtm",246,0.995951,24,247,1,246,1,1,0,1,1,108,108,139,138,76
"6765",64,"[24]EgyGsHnKqGocIHBJCFggwHtm",225,0.995575,24,226,1,225,1,1,0,1,1,118,118,108,107,76
"6766",65,"[24]EgyGsHnKqGocIHBJCFggwHtm",235,0.995763,24,236,1,235,1,1,0,1,1,110,110,126,125,76
"6767",66,"[24]EgyGsHnKqGocIHBJCFggwHtm",224,0.995556,24,225,1,224,1,1,0,1,1,121,121,104,103,76
"6768",67,"[24]EgyGsHnKqGocIHBJCFggwHtm",222,0.995516,24,223,1,222,1,1,0,1,1,122,122,101,100,76
"6769",68,"[24]EgyGsHnKqGocIHBJCFggwHtm",220,0.995475,24,221,1,220,1,1,0,1,1,123,123,98,97,76
"6770",69,"[24]EgyGsHnKqGocIHBJCFggwHtm",227,0.995614,24,228,1,227,1,1,0,1,1,118,118,110,109,76
"6771",70,"[24]EgyGsHnKqGocIHBJCFggwHtm",236,0.995781,24,237,1,236,1,1,0,1,1,112,112,125,124,76
"6772",71,"[24]EgyGsHnKqGocIHBJCFggwHtm",233,0.995726,24,234,1,233,1,1,0,1,1,111,111,123,122,76
"6773",72,"[24]EgyGsHnKqGocIHBJCFggwHtm",229,0.995652,24,230,1,229,1,1,0,1,1,115,115,115,114,76
"6774",73,"[24]EgyGsHnKqGocIHBJCFggwHtm",234,0.995745,24,235,1,234,1,1,0,1,1,111,111,124,123,76
"6775",74,"[24]EgyGsHnKqGocIHBJCFggwHtm",231,0.99569,24,232,1,231,1,1,0,1,1,114,114,118,117,76
"6776",75,"[24]EgyGsHnKqGocIHBJCFggwHtm",221,0.995495,24,222,1,221,1,1,0,1,1,121,121,101,100,76
"6777",76,"[24]EgyGsHnKqGocIHBJCFggwHtm",231,0.99569,24,232,1,231,1,1,0,1,1,113,113,119,118,76
"6778",77,"[24]EgyGsHnKqGocIHBJCFggwHtm",220,0.995475,24,221,1,220,1,1,0,1,1,123,123,98,97,76
"6779",78,"[24]EgyGsHnKqGocIHBJCFggwHtm",230,0.995671,24,231,1,230,1,1,0,1,1,114,114,117,116,76
"6780",79,"[24]EgyGsHnKqGocIHBJCFggwHtm",237,0.995798,24,238,1,237,1,1,0,1,1,108,108,130,129,76
"6781",80,"[24]EgyGsHnKqGocIHBJCFggwHtm",232,0.995708,24,233,1,232,1,1,0,1,1,114,114,119,118,76
"6782",81,"[24]EgyGsHnKqGocIHBJCFggwHtm",230,0.995671,24,231,1,230,1,1,0,1,1,115,115,116,115,76
"6783",82,"[24]EgyGsHnKqGocIHBJCFggwHtm",233,0.995726,24,234,1,233,1,1,0,1,1,111,111,123,122,76
"6784",83,"[24]EgyGsHnKqGocIHBJCFggwHtm",226,0.995595,24,227,1,226,1,1,0,1,1,117,117,110,109,76
"6785",84,"[24]EgyGsHnKqGocIHBJCFggwHtm",231,0.99569,24,232,1,231,1,1,0,1,1,115,115,117,116,76
"6786",85,"[24]EgyGsHnKqGocIHBJCFggwHtm",230,0.995671,24,231,1,230,1,1,0,1,1,114,114,117,116,76
"6787",86,"[24]EgyGsHnKqGocIHBJCFggwHtm",225,0.995575,24,226,1,225,1,1,0,1,1,118,118,108,107,76
"6788",87,"[24]EgyGsHnKqGocIHBJCFggwHtm",224,0.995556,24,225,1,224,1,1,0,1,1,119,119,106,105,76
"6789",88,"[24]EgyGsHnKqGocIHBJCFggwHtm",227,0.995614,24,228,1,227,1,1,0,1,1,116,116,112,111,76
"6790",89,"[24]EgyGsHnKqGocIHBJCFggwHtm",234,0.995745,24,235,1,234,1,1,0,1,1,113,113,122,121,76
"6791",90,"[24]EgyGsHnKqGocIHBJCFggwHtm",224,0.995556,24,225,1,224,1,1,0,1,1,119,119,106,105,76
"6792",91,"[24]EgyGsHnKqGocIHBJCFggwHtm",235,0.995763,24,236,1,235,1,1,0,1,1,112,112,124,123,76
"6793",92,"[24]EgyGsHnKqGocIHBJCFggwHtm",232,0.995708,24,233,1,232,1,1,0,1,1,112,112,121,120,76
"6794",93,"[24]EgyGsHnKqGocIHBJCFggwHtm",226,0.995595,24,227,1,226,1,1,0,1,1,119,119,108,107,76
"6795",94,"[24]EgyGsHnKqGocIHBJCFggwHtm",226,0.995595,24,227,1,226,1,1,0,1,1,118,118,109,108,76
"6796",95,"[24]EgyGsHnKqGocIHBJCFggwHtm",223,0.995536,24,224,1,223,1,1,0,1,1,120,120,104,103,76
"6797",96,"[24]EgyGsHnKqGocIHBJCFggwHtm",234,0.995745,24,235,1,234,1,1,0,1,1,115,115,120,119,76
"6798",97,"[24]EgyGsHnKqGocIHBJCFggwHtm",221,0.995495,24,222,1,221,1,1,0,1,1,121,121,101,100,76
"6799",98,"[24]EgyGsHnKqGocIHBJCFggwHtm",225,0.995575,24,226,1,225,1,1,0,1,1,118,118,108,107,76
"6800",99,"[24]EgyGsHnKqGocIHBJCFggwHtm",228,0.995633,24,229,1,228,1,1,0,1,1,116,116,113,112,76
"6801",0,"[23]EKwHnKqGocIHcJCJHxqEdaf",231,0.99569,23,232,1,231,1,1,0,1,1,117,117,115,114,77
"6802",1,"[23]EKwHnKqGocIHcJCJHxqEdaf",226,0.995595,23,227,1,226,1,1,0,1,1,119,119,108,107,77
"6803",2,"[23]EKwHnKqGocIHcJCJHxqEdaf",232,0.995708,23,233,1,232,1,1,0,1,1,114,114,119,118,77
"6804",3,"[23]EKwHnKqGocIHcJCJHxqEdaf",225,0.995575,23,226,1,225,1,1,0,1,1,119,119,107,106,77
"6805",4,"[23]EKwHnKqGocIHcJCJHxqEdaf",228,0.995633,23,229,1,228,1,1,0,1,1,117,117,112,111,77
"6806",5,"[23]EKwHnKqGocIHcJCJHxqEdaf",222,0.995516,23,223,1,222,1,1,0,1,1,121,121,102,101,77
"6807",6,"[23]EKwHnKqGocIHcJCJHxqEdaf",223,0.995536,23,224,1,223,1,1,0,1,1,121,121,103,102,77
"6808",7,"[23]EKwHnKqGocIHcJCJHxqEdaf",231,0.99569,23,232,1,231,1,1,0,1,1,115,115,117,116,77
"6809",8,"[23]EKwHnKqGocIHcJCJHxqEdaf",233,0.995726,23,234,1,233,1,1,0,1,1,113,113,121,120,77
"6810",9,"[23]EKwHnKqGocIHcJCJHxqEdaf",230,0.995671,23,231,1,230,1,1,0,1,1,116,116,115,114,77
"6811",10,"[23]EKwHnKqGocIHcJCJHxqEdaf",227,0.995614,23,228,1,227,1,1,0,1,1,117,117,111,110,77
"6812",11,"[23]EKwHnKqGocIHcJCJHxqEdaf",229,0.995652,23,230,1,229,1,1,0,1,1,117,117,113,112,77
"6813",12,"[23]EKwHnKqGocIHcJCJHxqEdaf",223,0.995536,23,224,1,223,1,1,0,1,1,121,121,103,102,77
"6814",13,"[23]EKwHnKqGocIHcJCJHxqEdaf",229,0.995652,23,230,1,229,1,1,0,1,1,116,116,114,113,77
"6815",14,"[23]EKwHnKqGocIHcJCJHxqEdaf",240,0.995851,23,241,1,240,1,1,0,1,1,108,108,133,132,77
"6816",15,"[23]EKwHnKqGocIHcJCJHxqEdaf",226,0.995595,23,227,1,226,1,1,0,1,1,118,118,109,108,77
"6817",16,"[23]EKwHnKqGocIHcJCJHxqEdaf",234,0.995745,23,235,1,234,1,1,0,1,1,113,113,122,121,77
"6818",17,"[23]EKwHnKqGocIHcJCJHxqEdaf",225,0.995575,23,226,1,225,1,1,0,1,1,119,119,107,106,77
"6819",18,"[23]EKwHnKqGocIHcJCJHxqEdaf",229,0.995652,23,230,1,229,1,1,0,1,1,117,117,113,112,77
"6820",19,"[23]EKwHnKqGocIHcJCJHxqEdaf",228,0.995633,23,229,1,228,1,1,0,1,1,117,117,112,111,77
"6821",20,"[23]EKwHnKqGocIHcJCJHxqEdaf",236,0.995781,23,237,1,236,1,1,0,1,1,112,112,125,124,77
"6822",21,"[23]EKwHnKqGocIHcJCJHxqEdaf",230,0.995671,23,231,1,230,1,1,0,1,1,116,116,115,114,77
"6823",22,"[23]EKwHnKqGocIHcJCJHxqEdaf",230,0.995671,23,231,1,230,1,1,0,1,1,116,116,115,114,77
"6824",23,"[23]EKwHnKqGocIHcJCJHxqEdaf",226,0.995595,23,227,1,226,1,1,0,1,1,121,121,106,105,77
"6825",24,"[23]EKwHnKqGocIHcJCJHxqEdaf",235,0.995763,23,236,1,235,1,1,0,1,1,111,111,125,124,77
"6826",25,"[23]EKwHnKqGocIHcJCJHxqEdaf",236,0.995781,23,237,1,236,1,1,0,1,1,112,112,125,124,77
"6827",26,"[23]EKwHnKqGocIHcJCJHxqEdaf",234,0.995745,23,235,1,234,1,1,0,1,1,112,112,123,122,77
"6828",27,"[23]EKwHnKqGocIHcJCJHxqEdaf",234,0.995745,23,235,1,234,1,1,0,1,1,112,112,123,122,77
"6829",28,"[23]EKwHnKqGocIHcJCJHxqEdaf",224,0.995556,23,225,1,224,1,1,0,1,1,120,120,105,104,77
"6830",29,"[23]EKwHnKqGocIHcJCJHxqEdaf",236,0.995781,23,237,1,236,1,1,0,1,1,111,111,126,125,77
"6831",30,"[23]EKwHnKqGocIHcJCJHxqEdaf",230,0.995671,23,231,1,230,1,1,0,1,1,116,116,115,114,77
"6832",31,"[23]EKwHnKqGocIHcJCJHxqEdaf",231,0.99569,23,232,1,231,1,1,0,1,1,117,117,115,114,77
"6833",32,"[23]EKwHnKqGocIHcJCJHxqEdaf",224,0.995556,23,225,1,224,1,1,0,1,1,120,120,105,104,77
"6834",33,"[23]EKwHnKqGocIHcJCJHxqEdaf",231,0.99569,23,232,1,231,1,1,0,1,1,114,114,118,117,77
"6835",34,"[23]EKwHnKqGocIHcJCJHxqEdaf",225,0.995575,23,226,1,225,1,1,0,1,1,119,119,107,106,77
"6836",35,"[23]EKwHnKqGocIHcJCJHxqEdaf",232,0.995708,23,233,1,232,1,1,0,1,1,114,114,119,118,77
"6837",36,"[23]EKwHnKqGocIHcJCJHxqEdaf",230,0.995671,23,231,1,230,1,1,0,1,1,116,116,115,114,77
"6838",37,"[23]EKwHnKqGocIHcJCJHxqEdaf",235,0.995763,23,236,1,235,1,1,0,1,1,113,113,123,122,77
"6839",38,"[23]EKwHnKqGocIHcJCJHxqEdaf",225,0.995575,23,226,1,225,1,1,0,1,1,119,119,107,106,77
"6840",39,"[23]EKwHnKqGocIHcJCJHxqEdaf",224,0.995556,23,225,1,224,1,1,0,1,1,120,120,105,104,77
"6841",40,"[23]EKwHnKqGocIHcJCJHxqEdaf",248,0.995984,23,249,1,248,1,1,0,1,1,102,102,147,146,77
"6842",41,"[23]EKwHnKqGocIHcJCJHxqEdaf",242,0.995885,23,243,1,242,1,1,0,1,1,105,105,138,137,77
"6843",42,"[23]EKwHnKqGocIHcJCJHxqEdaf",236,0.995781,23,237,1,236,1,1,0,1,1,112,112,125,124,77
"6844",43,"[23]EKwHnKqGocIHcJCJHxqEdaf",242,0.995885,23,243,1,242,1,1,0,1,1,106,106,137,136,77
"6845",44,"[23]EKwHnKqGocIHcJCJHxqEdaf",232,0.995708,23,233,1,232,1,1,0,1,1,114,114,119,118,77
"6846",45,"[23]EKwHnKqGocIHcJCJHxqEdaf",226,0.995595,23,227,1,226,1,1,0,1,1,121,121,106,105,77
"6847",46,"[23]EKwHnKqGocIHcJCJHxqEdaf",231,0.99569,23,232,1,231,1,1,0,1,1,117,117,115,114,77
"6848",47,"[23]EKwHnKqGocIHcJCJHxqEdaf",246,0.995951,23,247,1,246,1,1,0,1,1,104,104,143,142,77
"6849",48,"[23]EKwHnKqGocIHcJCJHxqEdaf",236,0.995781,23,237,1,236,1,1,0,1,1,111,111,126,125,77
"6850",49,"[23]EKwHnKqGocIHcJCJHxqEdaf",232,0.995708,23,233,1,232,1,1,0,1,1,113,113,120,119,77
"6851",50,"[23]EKwHnKqGocIHcJCJHxqEdaf",218,0.995434,23,219,1,218,1,1,0,1,1,126,126,93,92,77
"6852",51,"[23]EKwHnKqGocIHcJCJHxqEdaf",224,0.995556,23,225,1,224,1,1,0,1,1,121,121,104,103,77
"6853",52,"[23]EKwHnKqGocIHcJCJHxqEdaf",237,0.995798,23,238,1,237,1,1,0,1,1,110,110,128,127,77
"6854",53,"[23]EKwHnKqGocIHcJCJHxqEdaf",250,0.996016,23,251,1,250,1,1,0,1,1,102,102,149,148,77
"6855",54,"[23]EKwHnKqGocIHcJCJHxqEdaf",239,0.995833,23,240,1,239,1,1,0,1,1,109,109,131,130,77
"6856",55,"[23]EKwHnKqGocIHcJCJHxqEdaf",233,0.995726,23,234,1,233,1,1,0,1,1,114,114,120,119,77
"6857",56,"[23]EKwHnKqGocIHcJCJHxqEdaf",230,0.995671,23,231,1,230,1,1,0,1,1,121,121,110,109,77
"6858",57,"[23]EKwHnKqGocIHcJCJHxqEdaf",231,0.99569,23,232,1,231,1,1,0,1,1,116,116,116,115,77
"6859",58,"[23]EKwHnKqGocIHcJCJHxqEdaf",232,0.995708,23,233,1,232,1,1,0,1,1,113,113,120,119,77
"6860",59,"[23]EKwHnKqGocIHcJCJHxqEdaf",235,0.995763,23,236,1,235,1,1,0,1,1,111,111,125,124,77
"6861",60,"[23]EKwHnKqGocIHcJCJHxqEdaf",229,0.995652,23,230,1,229,1,1,0,1,1,116,116,114,113,77
"6862",61,"[23]EKwHnKqGocIHcJCJHxqEdaf",221,0.995495,23,222,1,221,1,1,0,1,1,122,122,100,99,77
"6863",62,"[23]EKwHnKqGocIHcJCJHxqEdaf",225,0.995575,23,226,1,225,1,1,0,1,1,120,120,106,105,77
"6864",63,"[23]EKwHnKqGocIHcJCJHxqEdaf",236,0.995781,23,237,1,236,1,1,0,1,1,111,111,126,125,77
"6865",64,"[23]EKwHnKqGocIHcJCJHxqEdaf",227,0.995614,23,228,1,227,1,1,0,1,1,117,117,111,110,77
"6866",65,"[23]EKwHnKqGocIHcJCJHxqEdaf",226,0.995595,23,227,1,226,1,1,0,1,1,121,121,106,105,77
"6867",66,"[23]EKwHnKqGocIHcJCJHxqEdaf",234,0.995745,23,235,1,234,1,1,0,1,1,112,112,123,122,77
"6868",67,"[23]EKwHnKqGocIHcJCJHxqEdaf",236,0.995781,23,237,1,236,1,1,0,1,1,111,111,126,125,77
"6869",68,"[23]EKwHnKqGocIHcJCJHxqEdaf",234,0.995745,23,235,1,234,1,1,0,1,1,113,113,122,121,77
"6870",69,"[23]EKwHnKqGocIHcJCJHxqEdaf",233,0.995726,23,234,1,233,1,1,0,1,1,116,116,118,117,77
"6871",70,"[23]EKwHnKqGocIHcJCJHxqEdaf",227,0.995614,23,228,1,227,1,1,0,1,1,119,119,109,108,77
"6872",71,"[23]EKwHnKqGocIHcJCJHxqEdaf",228,0.995633,23,229,1,228,1,1,0,1,1,118,118,111,110,77
"6873",72,"[23]EKwHnKqGocIHcJCJHxqEdaf",222,0.995516,23,223,1,222,1,1,0,1,1,123,123,100,99,77
"6874",73,"[23]EKwHnKqGocIHcJCJHxqEdaf",232,0.995708,23,233,1,232,1,1,0,1,1,114,114,119,118,77
"6875",74,"[23]EKwHnKqGocIHcJCJHxqEdaf",231,0.99569,23,232,1,231,1,1,0,1,1,115,115,117,116,77
"6876",75,"[23]EKwHnKqGocIHcJCJHxqEdaf",227,0.995614,23,228,1,227,1,1,0,1,1,120,120,108,107,77
"6877",76,"[23]EKwHnKqGocIHcJCJHxqEdaf",227,0.995614,23,228,1,227,1,1,0,1,1,118,118,110,109,77
"6878",77,"[23]EKwHnKqGocIHcJCJHxqEdaf",221,0.995495,23,222,1,221,1,1,0,1,1,123,123,99,98,77
"6879",78,"[23]EKwHnKqGocIHcJCJHxqEdaf",233,0.995726,23,234,1,233,1,1,0,1,1,113,113,121,120,77
"6880",79,"[23]EKwHnKqGocIHcJCJHxqEdaf",231,0.99569,23,232,1,231,1,1,0,1,1,120,120,112,111,77
"6881",80,"[23]EKwHnKqGocIHcJCJHxqEdaf",226,0.995595,23,227,1,226,1,1,0,1,1,119,119,108,107,77
"6882",81,"[23]EKwHnKqGocIHcJCJHxqEdaf",227,0.995614,23,228,1,227,1,1,0,1,1,120,120,108,107,77
"6883",82,"[23]EKwHnKqGocIHcJCJHxqEdaf",219,0.995455,23,220,1,219,1,1,0,1,1,124,124,96,95,77
"6884",83,"[23]EKwHnKqGocIHcJCJHxqEdaf",227,0.995614,23,228,1,227,1,1,0,1,1,117,117,111,110,77
"6885",84,"[23]EKwHnKqGocIHcJCJHxqEdaf",231,0.99569,23,232,1,231,1,1,0,1,1,114,114,118,117,77
"6886",85,"[23]EKwHnKqGocIHcJCJHxqEdaf",227,0.995614,23,228,1,227,1,1,0,1,1,117,117,111,110,77
"6887",86,"[23]EKwHnKqGocIHcJCJHxqEdaf",225,0.995575,23,226,1,225,1,1,0,1,1,119,119,107,106,77
"6888",87,"[23]EKwHnKqGocIHcJCJHxqEdaf",226,0.995595,23,227,1,226,1,1,0,1,1,119,119,108,107,77
"6889",88,"[23]EKwHnKqGocIHcJCJHxqEdaf",222,0.995516,23,223,1,222,1,1,0,1,1,122,122,101,100,77
"6890",89,"[23]EKwHnKqGocIHcJCJHxqEdaf",237,0.995798,23,238,1,237,1,1,0,1,1,111,111,127,126,77
"6891",90,"[23]EKwHnKqGocIHcJCJHxqEdaf",230,0.995671,23,231,1,230,1,1,0,1,1,116,116,115,114,77
"6892",91,"[23]EKwHnKqGocIHcJCJHxqEdaf",232,0.995708,23,233,1,232,1,1,0,1,1,114,114,119,118,77
"6893",92,"[23]EKwHnKqGocIHcJCJHxqEdaf",232,0.995708,23,233,1,232,1,1,0,1,1,113,113,120,119,77
"6894",93,"[23]EKwHnKqGocIHcJCJHxqEdaf",244,0.995918,23,245,1,244,1,1,0,1,1,106,106,139,138,77
"6895",94,"[23]EKwHnKqGocIHcJCJHxqEdaf",238,0.995816,23,239,1,238,1,1,0,1,1,109,109,130,129,77
"6896",95,"[23]EKwHnKqGocIHcJCJHxqEdaf",239,0.995833,23,240,1,239,1,1,0,1,1,110,110,130,129,77
"6897",96,"[23]EKwHnKqGocIHcJCJHxqEdaf",234,0.995745,23,235,1,234,1,1,0,1,1,113,113,122,121,77
"6898",97,"[23]EKwHnKqGocIHcJCJHxqEdaf",235,0.995763,23,236,1,235,1,1,0,1,1,111,111,125,124,77
"6899",98,"[23]EKwHnKqGocIHcJCJHxqEdaf",224,0.995556,23,225,1,224,1,1,0,1,1,120,120,105,104,77
"6900",99,"[23]EKwHnKqGocIHcJCJHxqEdaf",236,0.995781,23,237,1,236,1,1,0,1,1,112,112,125,124,77
"6901",0,"[30]EfGoGvHnKqGocIHBJComcKEgBbKsHb",222,0.995516,30,223,1,222,1,1,0,1,1,120,120,103,102,78
"6902",1,"[30]EfGoGvHnKqGocIHBJComcKEgBbKsHb",226,0.995595,30,227,1,226,1,1,0,1,1,119,119,108,107,78
"6903",2,"[30]EfGoGvHnKqGocIHBJComcKEgBbKsHb",218,0.995434,30,219,1,218,1,1,0,1,1,123,123,96,95,78
"6904",3,"[30]EfGoGvHnKqGocIHBJComcKEgBbKsHb",231,0.99569,30,232,1,231,1,1,0,1,1,115,115,117,116,78
"6905",4,"[30]EfGoGvHnKqGocIHBJComcKEgBbKsHb",227,0.995614,30,228,1,227,1,1,0,1,1,118,118,110,109,78
"6906",5,"[30]EfGoGvHnKqGocIHBJComcKEgBbKsHb",237,0.995798,30,238,1,237,1,1,0,1,1,109,109,129,128,78
"6907",6,"[30]EfGoGvHnKqGocIHBJComcKEgBbKsHb",231,0.99569,30,232,1,231,1,1,0,1,1,115,115,117,116,78
"6908",7,"[30]EfGoGvHnKqGocIHBJComcKEgBbKsHb",238,0.995816,30,239,1,238,1,1,0,1,1,107,107,132,131,78
"6909",8,"[30]EfGoGvHnKqGocIHBJComcKEgBbKsHb",227,0.995614,30,228,1,227,1,1,0,1,1,116,116,112,111,78
"6910",9,"[30]EfGoGvHnKqGocIHBJComcKEgBbKsHb",234,0.995745,30,235,1,234,1,1,0,1,1,114,114,121,120,78
"6911",10,"[30]EfGoGvHnKqGocIHBJComcKEgBbKsHb",237,0.995798,30,238,1,237,1,1,0,1,1,110,110,128,127,78
"6912",11,"[30]EfGoGvHnKqGocIHBJComcKEgBbKsHb",233,0.995726,30,234,1,233,1,1,0,1,1,112,112,122,121,78
"6913",12,"[30]EfGoGvHnKqGocIHBJComcKEgBbKsHb",236,0.995781,30,237,1,236,1,1,0,1,1,110,110,127,126,78
"6914",13,"[30]EfGoGvHnKqGocIHBJComcKEgBbKsHb",225,0.995575,30,226,1,225,1,1,0,1,1,118,118,108,107,78
"6915",14,"[30]EfGoGvHnKqGocIHBJComcKEgBbKsHb",226,0.995595,30,227,1,226,1,1,0,1,1,120,120,107,106,78
"6916",15,"[30]EfGoGvHnKqGocIHBJComcKEgBbKsHb",234,0.995745,30,235,1,234,1,1,0,1,1,113,113,122,121,78
"6917",16,"[30]EfGoGvHnKqGocIHBJComcKEgBbKsHb",236,0.995781,30,237,1,236,1,1,0,1,1,110,110,127,126,78
"6918",17,"[30]EfGoGvHnKqGocIHBJComcKEgBbKsHb",227,0.995614,30,228,1,227,1,1,0,1,1,116,116,112,111,78
"6919",18,"[30]EfGoGvHnKqGocIHBJComcKEgBbKsHb",219,0.995455,30,220,1,219,1,1,0,1,1,123,123,97,96,78
"6920",19,"[30]EfGoGvHnKqGocIHBJComcKEgBbKsHb",241,0.995868,30,242,1,241,1,1,0,1,1,105,105,137,136,78
"6921",20,"[30]EfGoGvHnKqGocIHBJComcKEgBbKsHb",223,0.995536,30,224,1,223,1,1,0,1,1,120,120,104,103,78
"6922",21,"[30]EfGoGvHnKqGocIHBJComcKEgBbKsHb",233,0.995726,30,234,1,233,1,1,0,1,1,112,112,122,121,78
"6923",22,"[30]EfGoGvHnKqGocIHBJComcKEgBbKsHb",229,0.995652,30,230,1,229,1,1,0,1,1,117,117,113,112,78
"6924",23,"[30]EfGoGvHnKqGocIHBJComcKEgBbKsHb",232,0.995708,30,233,1,232,1,1,0,1,1,113,113,120,119,78
"6925",24,"[30]EfGoGvHnKqGocIHBJComcKEgBbKsHb",235,0.995763,30,236,1,235,1,1,0,1,1,112,112,124,123,78
"6926",25,"[30]EfGoGvHnKqGocIHBJComcKEgBbKsHb",230,0.995671,30,231,1,230,1,1,0,1,1,115,115,116,115,78
"6927",26,"[30]EfGoGvHnKqGocIHBJComcKEgBbKsHb",229,0.995652,30,230,1,229,1,1,0,1,1,115,115,115,114,78
"6928",27,"[30]EfGoGvHnKqGocIHBJComcKEgBbKsHb",224,0.995556,30,225,1,224,1,1,0,1,1,121,121,104,103,78
"6929",28,"[30]EfGoGvHnKqGocIHBJComcKEgBbKsHb",220,0.995475,30,221,1,220,1,1,0,1,1,122,122,99,98,78
"6930",29,"[30]EfGoGvHnKqGocIHBJComcKEgBbKsHb",226,0.995595,30,227,1,226,1,1,0,1,1,118,118,109,108,78
"6931",30,"[30]EfGoGvHnKqGocIHBJComcKEgBbKsHb",224,0.995556,30,225,1,224,1,1,0,1,1,119,119,106,105,78
"6932",31,"[30]EfGoGvHnKqGocIHBJComcKEgBbKsHb",223,0.995536,30,224,1,223,1,1,0,1,1,120,120,104,103,78
"6933",32,"[30]EfGoGvHnKqGocIHBJComcKEgBbKsHb",228,0.995633,30,229,1,228,1,1,0,1,1,115,115,114,113,78
"6934",33,"[30]EfGoGvHnKqGocIHBJComcKEgBbKsHb",231,0.99569,30,232,1,231,1,1,0,1,1,114,114,118,117,78
"6935",34,"[30]EfGoGvHnKqGocIHBJComcKEgBbKsHb",222,0.995516,30,223,1,222,1,1,0,1,1,120,120,103,102,78
"6936",35,"[30]EfGoGvHnKqGocIHBJComcKEgBbKsHb",217,0.995413,30,218,1,217,1,1,0,1,1,125,125,93,92,78
"6937",36,"[30]EfGoGvHnKqGocIHBJComcKEgBbKsHb",226,0.995595,30,227,1,226,1,1,0,1,1,117,117,110,109,78
"6938",37,"[30]EfGoGvHnKqGocIHBJComcKEgBbKsHb",222,0.995516,30,223,1,222,1,1,0,1,1,121,121,102,101,78
"6939",38,"[30]EfGoGvHnKqGocIHBJComcKEgBbKsHb",230,0.995671,30,231,1,230,1,1,0,1,1,118,118,113,112,78
"6940",39,"[30]EfGoGvHnKqGocIHBJComcKEgBbKsHb",229,0.995652,30,230,1,229,1,1,0,1,1,120,120,110,109,78
"6941",40,"[30]EfGoGvHnKqGocIHBJComcKEgBbKsHb",233,0.995726,30,234,1,233,1,1,0,1,1,113,113,121,120,78
"6942",41,"[30]EfGoGvHnKqGocIHBJComcKEgBbKsHb",230,0.995671,30,231,1,230,1,1,0,1,1,115,115,116,115,78
"6943",42,"[30]EfGoGvHnKqGocIHBJComcKEgBbKsHb",231,0.99569,30,232,1,231,1,1,0,1,1,113,113,119,118,78
"6944",43,"[30]EfGoGvHnKqGocIHBJComcKEgBbKsHb",227,0.995614,30,228,1,227,1,1,0,1,1,120,120,108,107,78
"6945",44,"[30]EfGoGvHnKqGocIHBJComcKEgBbKsHb",229,0.995652,30,230,1,229,1,1,0,1,1,115,115,115,114,78
"6946",45,"[30]EfGoGvHnKqGocIHBJComcKEgBbKsHb",233,0.995726,30,234,1,233,1,1,0,1,1,118,118,116,115,78
"6947",46,"[30]EfGoGvHnKqGocIHBJComcKEgBbKsHb",227,0.995614,30,228,1,227,1,1,0,1,1,119,119,109,108,78
"6948",47,"[30]EfGoGvHnKqGocIHBJComcKEgBbKsHb",227,0.995614,30,228,1,227,1,1,0,1,1,116,116,112,111,78
"6949",48,"[30]EfGoGvHnKqGocIHBJComcKEgBbKsHb",233,0.995726,30,234,1,233,1,1,0,1,1,112,112,122,121,78
"6950",49,"[30]EfGoGvHnKqGocIHBJComcKEgBbKsHb",231,0.99569,30,232,1,231,1,1,0,1,1,116,116,116,115,78
"6951",50,"[30]EfGoGvHnKqGocIHBJComcKEgBbKsHb",245,0.995935,30,246,1,245,1,1,0,1,1,102,102,144,143,78
"6952",51,"[30]EfGoGvHnKqGocIHBJComcKEgBbKsHb",252,0.996047,30,253,1,252,1,1,0,1,1,97,97,156,155,78
"6953",52,"[30]EfGoGvHnKqGocIHBJComcKEgBbKsHb",227,0.995614,30,228,1,227,1,1,0,1,1,117,117,111,110,78
"6954",53,"[30]EfGoGvHnKqGocIHBJComcKEgBbKsHb",226,0.995595,30,227,1,226,1,1,0,1,1,118,118,109,108,78
"6955",54,"[30]EfGoGvHnKqGocIHBJComcKEgBbKsHb",225,0.995575,30,226,1,225,1,1,0,1,1,119,119,107,106,78
"6956",55,"[30]EfGoGvHnKqGocIHBJComcKEgBbKsHb",233,0.995726,30,234,1,233,1,1,0,1,1,111,111,123,122,78
"6957",56,"[30]EfGoGvHnKqGocIHBJComcKEgBbKsHb",225,0.995575,30,226,1,225,1,1,0,1,1,118,118,108,107,78
"6958",57,"[30]EfGoGvHnKqGocIHBJComcKEgBbKsHb",230,0.995671,30,231,1,230,1,1,0,1,1,116,116,115,114,78
"6959",58,"[30]EfGoGvHnKqGocIHBJComcKEgBbKsHb",234,0.995745,30,235,1,234,1,1,0,1,1,113,113,122,121,78
"6960",59,"[30]EfGoGvHnKqGocIHBJComcKEgBbKsHb",225,0.995575,30,226,1,225,1,1,0,1,1,119,119,107,106,78
"6961",60,"[30]EfGoGvHnKqGocIHBJComcKEgBbKsHb",232,0.995708,30,233,1,232,1,1,0,1,1,112,112,121,120,78
"6962",61,"[30]EfGoGvHnKqGocIHBJComcKEgBbKsHb",227,0.995614,30,228,1,227,1,1,0,1,1,116,116,112,111,78
"6963",62,"[30]EfGoGvHnKqGocIHBJComcKEgBbKsHb",234,0.995745,30,235,1,234,1,1,0,1,1,111,111,124,123,78
"6964",63,"[30]EfGoGvHnKqGocIHBJComcKEgBbKsHb",232,0.995708,30,233,1,232,1,1,0,1,1,114,114,119,118,78
"6965",64,"[30]EfGoGvHnKqGocIHBJComcKEgBbKsHb",236,0.995781,30,237,1,236,1,1,0,1,1,109,109,128,127,78
"6966",65,"[30]EfGoGvHnKqGocIHBJComcKEgBbKsHb",232,0.995708,30,233,1,232,1,1,0,1,1,113,113,120,119,78
"6967",66,"[30]EfGoGvHnKqGocIHBJComcKEgBbKsHb",231,0.99569,30,232,1,231,1,1,0,1,1,114,114,118,117,78
"6968",67,"[30]EfGoGvHnKqGocIHBJComcKEgBbKsHb",233,0.995726,30,234,1,233,1,1,0,1,1,112,112,122,121,78
"6969",68,"[30]EfGoGvHnKqGocIHBJComcKEgBbKsHb",221,0.995495,30,222,1,221,1,1,0,1,1,122,122,100,99,78
"6970",69,"[30]EfGoGvHnKqGocIHBJComcKEgBbKsHb",226,0.995595,30,227,1,226,1,1,0,1,1,117,117,110,109,78
"6971",70,"[30]EfGoGvHnKqGocIHBJComcKEgBbKsHb",239,0.995833,30,240,1,239,1,1,0,1,1,107,107,133,132,78
"6972",71,"[30]EfGoGvHnKqGocIHBJComcKEgBbKsHb",225,0.995575,30,226,1,225,1,1,0,1,1,119,119,107,106,78
"6973",72,"[30]EfGoGvHnKqGocIHBJComcKEgBbKsHb",233,0.995726,30,234,1,233,1,1,0,1,1,111,111,123,122,78
"6974",73,"[30]EfGoGvHnKqGocIHBJComcKEgBbKsHb",245,0.995935,30,246,1,245,1,1,0,1,1,105,105,141,140,78
"6975",74,"[30]EfGoGvHnKqGocIHBJComcKEgBbKsHb",242,0.995885,30,243,1,242,1,1,0,1,1,105,105,138,137,78
"6976",75,"[30]EfGoGvHnKqGocIHBJComcKEgBbKsHb",215,0.99537,30,216,1,215,1,1,0,1,1,126,126,90,89,78
"6977",76,"[30]EfGoGvHnKqGocIHBJComcKEgBbKsHb",234,0.995745,30,235,1,234,1,1,0,1,1,112,112,123,122,78
"6978",77,"[30]EfGoGvHnKqGocIHBJComcKEgBbKsHb",222,0.995516,30,223,1,222,1,1,0,1,1,121,121,102,101,78
"6979",78,"[30]EfGoGvHnKqGocIHBJComcKEgBbKsHb",223,0.995536,30,224,1,223,1,1,0,1,1,120,120,104,103,78
"6980",79,"[30]EfGoGvHnKqGocIHBJComcKEgBbKsHb",234,0.995745,30,235,1,234,1,1,0,1,1,111,111,124,123,78
"6981",80,"[30]EfGoGvHnKqGocIHBJComcKEgBbKsHb",229,0.995652,30,230,1,229,1,1,0,1,1,116,116,114,113,78
"6982",81,"[30]EfGoGvHnKqGocIHBJComcKEgBbKsHb",239,0.995833,30,240,1,239,1,1,0,1,1,107,107,133,132,78
"6983",82,"[30]EfGoGvHnKqGocIHBJComcKEgBbKsHb",233,0.995726,30,234,1,233,1,1,0,1,1,115,115,119,118,78
"6984",83,"[30]EfGoGvHnKqGocIHBJComcKEgBbKsHb",237,0.995798,30,238,1,237,1,1,0,1,1,108,108,130,129,78
"6985",84,"[30]EfGoGvHnKqGocIHBJComcKEgBbKsHb",230,0.995671,30,231,1,230,1,1,0,1,1,114,114,117,116,78
"6986",85,"[30]EfGoGvHnKqGocIHBJComcKEgBbKsHb",225,0.995575,30,226,1,225,1,1,0,1,1,119,119,107,106,78
"6987",86,"[30]EfGoGvHnKqGocIHBJComcKEgBbKsHb",232,0.995708,30,233,1,232,1,1,0,1,1,115,115,118,117,78
"6988",87,"[30]EfGoGvHnKqGocIHBJComcKEgBbKsHb",230,0.995671,30,231,1,230,1,1,0,1,1,115,115,116,115,78
"6989",88,"[30]EfGoGvHnKqGocIHBJComcKEgBbKsHb",225,0.995575,30,226,1,225,1,1,0,1,1,120,120,106,105,78
"6990",89,"[30]EfGoGvHnKqGocIHBJComcKEgBbKsHb",230,0.995671,30,231,1,230,1,1,0,1,1,114,114,117,116,78
"6991",90,"[30]EfGoGvHnKqGocIHBJComcKEgBbKsHb",225,0.995575,30,226,1,225,1,1,0,1,1,118,118,108,107,78
"6992",91,"[30]EfGoGvHnKqGocIHBJComcKEgBbKsHb",237,0.995798,30,238,1,237,1,1,0,1,1,108,108,130,129,78
"6993",92,"[30]EfGoGvHnKqGocIHBJComcKEgBbKsHb",228,0.995633,30,229,1,228,1,1,0,1,1,117,117,112,111,78
"6994",93,"[30]EfGoGvHnKqGocIHBJComcKEgBbKsHb",231,0.99569,30,232,1,231,1,1,0,1,1,114,114,118,117,78
"6995",94,"[30]EfGoGvHnKqGocIHBJComcKEgBbKsHb",228,0.995633,30,229,1,228,1,1,0,1,1,116,116,113,112,78
"6996",95,"[30]EfGoGvHnKqGocIHBJComcKEgBbKsHb",233,0.995726,30,234,1,233,1,1,0,1,1,113,113,121,120,78
"6997",96,"[30]EfGoGvHnKqGocIHBJComcKEgBbKsHb",236,0.995781,30,237,1,236,1,1,0,1,1,110,110,127,126,78
"6998",97,"[30]EfGoGvHnKqGocIHBJComcKEgBbKsHb",224,0.995556,30,225,1,224,1,1,0,1,1,119,119,106,105,78
"6999",98,"[30]EfGoGvHnKqGocIHBJComcKEgBbKsHb",234,0.995745,30,235,1,234,1,1,0,1,1,111,111,124,123,78
"7000",99,"[30]EfGoGvHnKqGocIHBJComcKEgBbKsHb",233,0.995726,30,234,1,233,1,1,0,1,1,112,112,122,121,78
"7001",0,"[31]EAAeCfrersHnKqocIHBJHqGJCAqKGFG",268,0.996283,31,269,1,268,1,1,0,1,1,145,145,124,123,81
"7002",1,"[31]EAAeCfrersHnKqocIHBJHqGJCAqKGFG",278,0.996416,31,279,1,278,1,1,0,1,1,140,140,139,138,81
"7003",2,"[31]EAAeCfrersHnKqocIHBJHqGJCAqKGFG",274,0.996364,31,275,1,274,1,1,0,1,1,139,139,136,135,81
"7004",3,"[31]EAAeCfrersHnKqocIHBJHqGJCAqKGFG",276,0.99639,31,277,1,276,1,1,0,1,1,124,124,153,152,81
"7005",4,"[31]EAAeCfrersHnKqocIHBJHqGJCAqKGFG",271,0.996324,31,272,1,271,1,1,0,1,1,133,133,139,138,81
"7006",5,"[31]EAAeCfrersHnKqocIHBJHqGJCAqKGFG",273,0.99635,31,274,1,273,1,1,0,1,1,126,126,148,147,81
"7007",6,"[31]EAAeCfrersHnKqocIHBJHqGJCAqKGFG",272,0.996337,31,273,1,272,1,1,0,1,1,147,147,126,125,81
"7008",7,"[31]EAAeCfrersHnKqocIHBJHqGJCAqKGFG",276,0.99639,31,277,1,276,1,1,0,1,1,134,134,143,142,81
"7009",8,"[31]EAAeCfrersHnKqocIHBJHqGJCAqKGFG",275,0.996377,31,276,1,275,1,1,0,1,1,130,130,146,145,81
"7010",9,"[31]EAAeCfrersHnKqocIHBJHqGJCAqKGFG",266,0.996255,31,267,1,266,1,1,0,1,1,149,149,118,117,81
"7011",10,"[31]EAAeCfrersHnKqocIHBJHqGJCAqKGFG",271,0.996324,31,272,1,271,1,1,0,1,1,130,130,142,141,81
"7012",11,"[31]EAAeCfrersHnKqocIHBJHqGJCAqKGFG",276,0.99639,31,277,1,276,1,1,0,1,1,136,136,141,140,81
"7013",12,"[31]EAAeCfrersHnKqocIHBJHqGJCAqKGFG",280,0.996441,31,281,1,280,1,1,0,1,1,140,140,141,140,81
"7014",13,"[31]EAAeCfrersHnKqocIHBJHqGJCAqKGFG",266,0.996255,31,267,1,266,1,1,0,1,1,142,142,125,124,81
"7015",14,"[31]EAAeCfrersHnKqocIHBJHqGJCAqKGFG",274,0.996364,31,275,1,274,1,1,0,1,1,131,131,144,143,81
"7016",15,"[31]EAAeCfrersHnKqocIHBJHqGJCAqKGFG",275,0.996377,31,276,1,275,1,1,0,1,1,144,144,132,131,81
"7017",16,"[31]EAAeCfrersHnKqocIHBJHqGJCAqKGFG",276,0.99639,31,277,1,276,1,1,0,1,1,124,124,153,152,81
"7018",17,"[31]EAAeCfrersHnKqocIHBJHqGJCAqKGFG",267,0.996269,31,268,1,267,1,1,0,1,1,141,141,127,126,81
"7019",18,"[31]EAAeCfrersHnKqocIHBJHqGJCAqKGFG",269,0.996296,31,270,1,269,1,1,0,1,1,133,133,137,136,81
"7020",19,"[31]EAAeCfrersHnKqocIHBJHqGJCAqKGFG",275,0.996377,31,276,1,275,1,1,0,1,1,138,138,138,137,81
"7021",20,"[31]EAAeCfrersHnKqocIHBJHqGJCAqKGFG",281,0.996454,31,282,1,281,1,1,0,1,1,142,142,140,139,81
"7022",21,"[31]EAAeCfrersHnKqocIHBJHqGJCAqKGFG",269,0.996296,31,270,1,269,1,1,0,1,1,136,136,134,133,81
"7023",22,"[31]EAAeCfrersHnKqocIHBJHqGJCAqKGFG",272,0.996337,31,273,1,272,1,1,0,1,1,139,139,134,133,81
"7024",23,"[31]EAAeCfrersHnKqocIHBJHqGJCAqKGFG",274,0.996364,31,275,1,274,1,1,0,1,1,127,127,148,147,81
"7025",24,"[31]EAAeCfrersHnKqocIHBJHqGJCAqKGFG",285,0.996503,31,286,1,285,1,1,0,1,1,136,136,150,149,81
"7026",25,"[31]EAAeCfrersHnKqocIHBJHqGJCAqKGFG",283,0.996479,31,284,1,283,1,1,0,1,1,141,141,143,142,81
"7027",26,"[31]EAAeCfrersHnKqocIHBJHqGJCAqKGFG",277,0.996403,31,278,1,277,1,1,0,1,1,135,135,143,142,81
"7028",27,"[31]EAAeCfrersHnKqocIHBJHqGJCAqKGFG",274,0.996364,31,275,1,274,1,1,0,1,1,134,134,141,140,81
"7029",28,"[31]EAAeCfrersHnKqocIHBJHqGJCAqKGFG",286,0.996516,31,287,1,286,1,1,0,1,1,133,133,154,153,81
"7030",29,"[31]EAAeCfrersHnKqocIHBJHqGJCAqKGFG",278,0.996416,31,279,1,278,1,1,0,1,1,139,139,140,139,81
"7031",30,"[31]EAAeCfrersHnKqocIHBJHqGJCAqKGFG",290,0.996564,31,291,1,290,1,1,0,1,1,116,116,175,174,81
"7032",31,"[31]EAAeCfrersHnKqocIHBJHqGJCAqKGFG",273,0.99635,31,274,1,273,1,1,0,1,1,136,136,138,137,81
"7033",32,"[31]EAAeCfrersHnKqocIHBJHqGJCAqKGFG",275,0.996377,31,276,1,275,1,1,0,1,1,132,132,144,143,81
"7034",33,"[31]EAAeCfrersHnKqocIHBJHqGJCAqKGFG",274,0.996364,31,275,1,274,1,1,0,1,1,135,135,140,139,81
"7035",34,"[31]EAAeCfrersHnKqocIHBJHqGJCAqKGFG",284,0.996491,31,285,1,284,1,1,0,1,1,149,149,136,135,81
"7036",35,"[31]EAAeCfrersHnKqocIHBJHqGJCAqKGFG",270,0.99631,31,271,1,270,1,1,0,1,1,143,143,128,127,81
"7037",36,"[31]EAAeCfrersHnKqocIHBJHqGJCAqKGFG",267,0.996269,31,268,1,267,1,1,0,1,1,136,136,132,131,81
"7038",37,"[31]EAAeCfrersHnKqocIHBJHqGJCAqKGFG",277,0.996403,31,278,1,277,1,1,0,1,1,130,130,148,147,81
"7039",38,"[31]EAAeCfrersHnKqocIHBJHqGJCAqKGFG",272,0.996337,31,273,1,272,1,1,0,1,1,144,144,129,128,81
"7040",39,"[31]EAAeCfrersHnKqocIHBJHqGJCAqKGFG",275,0.996377,31,276,1,275,1,1,0,1,1,147,147,129,128,81
"7041",40,"[31]EAAeCfrersHnKqocIHBJHqGJCAqKGFG",272,0.996337,31,273,1,272,1,1,0,1,1,139,139,134,133,81
"7042",41,"[31]EAAeCfrersHnKqocIHBJHqGJCAqKGFG",269,0.996296,31,270,1,269,1,1,0,1,1,136,136,134,133,81
"7043",42,"[31]EAAeCfrersHnKqocIHBJHqGJCAqKGFG",266,0.996255,31,267,1,266,1,1,0,1,1,130,130,137,136,81
"7044",43,"[31]EAAeCfrersHnKqocIHBJHqGJCAqKGFG",269,0.996296,31,270,1,269,1,1,0,1,1,128,128,142,141,81
"7045",44,"[31]EAAeCfrersHnKqocIHBJHqGJCAqKGFG",278,0.996416,31,279,1,278,1,1,0,1,1,120,120,159,158,81
"7046",45,"[31]EAAeCfrersHnKqocIHBJHqGJCAqKGFG",271,0.996324,31,272,1,271,1,1,0,1,1,135,135,137,136,81
"7047",46,"[31]EAAeCfrersHnKqocIHBJHqGJCAqKGFG",274,0.996364,31,275,1,274,1,1,0,1,1,127,127,148,147,81
"7048",47,"[31]EAAeCfrersHnKqocIHBJHqGJCAqKGFG",265,0.996241,31,266,1,265,1,1,0,1,1,139,139,127,126,81
"7049",48,"[31]EAAeCfrersHnKqocIHBJHqGJCAqKGFG",269,0.996296,31,270,1,269,1,1,0,1,1,142,142,128,127,81
"7050",49,"[31]EAAeCfrersHnKqocIHBJHqGJCAqKGFG",272,0.996337,31,273,1,272,1,1,0,1,1,130,130,143,142,81
"7051",50,"[31]EAAeCfrersHnKqocIHBJHqGJCAqKGFG",270,0.99631,31,271,1,270,1,1,0,1,1,136,136,135,134,81
"7052",51,"[31]EAAeCfrersHnKqocIHBJHqGJCAqKGFG",282,0.996466,31,283,1,282,1,1,0,1,1,142,142,141,140,81
"7053",52,"[31]EAAeCfrersHnKqocIHBJHqGJCAqKGFG",288,0.99654,31,289,1,288,1,1,0,1,1,139,139,150,149,81
"7054",53,"[31]EAAeCfrersHnKqocIHBJHqGJCAqKGFG",269,0.996296,31,270,1,269,1,1,0,1,1,139,139,131,130,81
"7055",54,"[31]EAAeCfrersHnKqocIHBJHqGJCAqKGFG",286,0.996516,31,287,1,286,1,1,0,1,1,131,131,156,155,81
"7056",55,"[31]EAAeCfrersHnKqocIHBJHqGJCAqKGFG",275,0.996377,31,276,1,275,1,1,0,1,1,129,129,147,146,81
"7057",56,"[31]EAAeCfrersHnKqocIHBJHqGJCAqKGFG",268,0.996283,31,269,1,268,1,1,0,1,1,132,132,137,136,81
"7058",57,"[31]EAAeCfrersHnKqocIHBJHqGJCAqKGFG",272,0.996337,31,273,1,272,1,1,0,1,1,142,142,131,130,81
"7059",58,"[31]EAAeCfrersHnKqocIHBJHqGJCAqKGFG",288,0.99654,31,289,1,288,1,1,0,1,1,141,141,148,147,81
"7060",59,"[31]EAAeCfrersHnKqocIHBJHqGJCAqKGFG",274,0.996364,31,275,1,274,1,1,0,1,1,137,137,138,137,81
"7061",60,"[31]EAAeCfrersHnKqocIHBJHqGJCAqKGFG",275,0.996377,31,276,1,275,1,1,0,1,1,136,136,140,139,81
"7062",61,"[31]EAAeCfrersHnKqocIHBJHqGJCAqKGFG",266,0.996255,31,267,1,266,1,1,0,1,1,142,142,125,124,81
"7063",62,"[31]EAAeCfrersHnKqocIHBJHqGJCAqKGFG",277,0.996403,31,278,1,277,1,1,0,1,1,147,147,131,130,81
"7064",63,"[31]EAAeCfrersHnKqocIHBJHqGJCAqKGFG",281,0.996454,31,282,1,281,1,1,0,1,1,137,137,145,144,81
"7065",64,"[31]EAAeCfrersHnKqocIHBJHqGJCAqKGFG",269,0.996296,31,270,1,269,1,1,0,1,1,140,140,130,129,81
"7066",65,"[31]EAAeCfrersHnKqocIHBJHqGJCAqKGFG",272,0.996337,31,273,1,272,1,1,0,1,1,130,130,143,142,81
"7067",66,"[31]EAAeCfrersHnKqocIHBJHqGJCAqKGFG",275,0.996377,31,276,1,275,1,1,0,1,1,133,133,143,142,81
"7068",67,"[31]EAAeCfrersHnKqocIHBJHqGJCAqKGFG",278,0.996416,31,279,1,278,1,1,0,1,1,119,119,160,159,81
"7069",68,"[31]EAAeCfrersHnKqocIHBJHqGJCAqKGFG",273,0.99635,31,274,1,273,1,1,0,1,1,130,130,144,143,81
"7070",69,"[31]EAAeCfrersHnKqocIHBJHqGJCAqKGFG",271,0.996324,31,272,1,271,1,1,0,1,1,130,130,142,141,81
"7071",70,"[31]EAAeCfrersHnKqocIHBJHqGJCAqKGFG",289,0.996552,31,290,1,289,1,1,0,1,1,133,133,157,156,81
"7072",71,"[31]EAAeCfrersHnKqocIHBJHqGJCAqKGFG",285,0.996503,31,286,1,285,1,1,0,1,1,148,148,138,137,81
"7073",72,"[31]EAAeCfrersHnKqocIHBJHqGJCAqKGFG",270,0.99631,31,271,1,270,1,1,0,1,1,133,133,138,137,81
"7074",73,"[31]EAAeCfrersHnKqocIHBJHqGJCAqKGFG",274,0.996364,31,275,1,274,1,1,0,1,1,137,137,138,137,81
"7075",74,"[31]EAAeCfrersHnKqocIHBJHqGJCAqKGFG",273,0.99635,31,274,1,273,1,1,0,1,1,129,129,145,144,81
"7076",75,"[31]EAAeCfrersHnKqocIHBJHqGJCAqKGFG",282,0.996466,31,283,1,282,1,1,0,1,1,133,133,150,149,81
"7077",76,"[31]EAAeCfrersHnKqocIHBJHqGJCAqKGFG",286,0.996516,31,287,1,286,1,1,0,1,1,126,126,161,160,81
"7078",77,"[31]EAAeCfrersHnKqocIHBJHqGJCAqKGFG",280,0.996441,31,281,1,280,1,1,0,1,1,135,135,146,145,81
"7079",78,"[31]EAAeCfrersHnKqocIHBJHqGJCAqKGFG",271,0.996324,31,272,1,271,1,1,0,1,1,142,142,130,129,81
"7080",79,"[31]EAAeCfrersHnKqocIHBJHqGJCAqKGFG",275,0.996377,31,276,1,275,1,1,0,1,1,137,137,139,138,81
"7081",80,"[31]EAAeCfrersHnKqocIHBJHqGJCAqKGFG",278,0.996416,31,279,1,278,1,1,0,1,1,131,131,148,147,81
"7082",81,"[31]EAAeCfrersHnKqocIHBJHqGJCAqKGFG",276,0.99639,31,277,1,276,1,1,0,1,1,127,127,150,149,81
"7083",82,"[31]EAAeCfrersHnKqocIHBJHqGJCAqKGFG",275,0.996377,31,276,1,275,1,1,0,1,1,145,145,131,130,81
"7084",83,"[31]EAAeCfrersHnKqocIHBJHqGJCAqKGFG",277,0.996403,31,278,1,277,1,1,0,1,1,134,134,144,143,81
"7085",84,"[31]EAAeCfrersHnKqocIHBJHqGJCAqKGFG",259,0.996154,31,260,1,259,1,1,0,1,1,148,148,112,111,81
"7086",85,"[31]EAAeCfrersHnKqocIHBJHqGJCAqKGFG",266,0.996255,31,267,1,266,1,1,0,1,1,142,142,125,124,81
"7087",86,"[31]EAAeCfrersHnKqocIHBJHqGJCAqKGFG",273,0.99635,31,274,1,273,1,1,0,1,1,132,132,142,141,81
"7088",87,"[31]EAAeCfrersHnKqocIHBJHqGJCAqKGFG",272,0.996337,31,273,1,272,1,1,0,1,1,134,134,139,138,81
"7089",88,"[31]EAAeCfrersHnKqocIHBJHqGJCAqKGFG",272,0.996337,31,273,1,272,1,1,0,1,1,127,127,146,145,81
"7090",89,"[31]EAAeCfrersHnKqocIHBJHqGJCAqKGFG",274,0.996364,31,275,1,274,1,1,0,1,1,138,138,137,136,81
"7091",90,"[31]EAAeCfrersHnKqocIHBJHqGJCAqKGFG",271,0.996324,31,272,1,271,1,1,0,1,1,133,133,139,138,81
"7092",91,"[31]EAAeCfrersHnKqocIHBJHqGJCAqKGFG",274,0.996364,31,275,1,274,1,1,0,1,1,132,132,143,142,81
"7093",92,"[31]EAAeCfrersHnKqocIHBJHqGJCAqKGFG",293,0.996599,31,294,1,293,1,1,0,1,1,130,130,164,163,81
"7094",93,"[31]EAAeCfrersHnKqocIHBJHqGJCAqKGFG",272,0.996337,31,273,1,272,1,1,0,1,1,132,132,141,140,81
"7095",94,"[31]EAAeCfrersHnKqocIHBJHqGJCAqKGFG",272,0.996337,31,273,1,272,1,1,0,1,1,125,125,148,147,81
"7096",95,"[31]EAAeCfrersHnKqocIHBJHqGJCAqKGFG",272,0.996337,31,273,1,272,1,1,0,1,1,135,135,138,137,81
"7097",96,"[31]EAAeCfrersHnKqocIHBJHqGJCAqKGFG",274,0.996364,31,275,1,274,1,1,0,1,1,127,127,148,147,81
"7098",97,"[31]EAAeCfrersHnKqocIHBJHqGJCAqKGFG",272,0.996337,31,273,1,272,1,1,0,1,1,133,133,140,139,81
"7099",98,"[31]EAAeCfrersHnKqocIHBJHqGJCAqKGFG",273,0.99635,31,274,1,273,1,1,0,1,1,135,135,139,138,81
"7100",99,"[31]EAAeCfrersHnKqocIHBJHqGJCAqKGFG",277,0.996403,31,278,1,277,1,1,0,1,1,133,133,145,144,81
"7101",0,"[26]EoktHnKqGocIHcJCgamnmIDaux",233,0.995726,26,234,1,233,1,1,0,1,1,118,118,116,115,82
"7102",1,"[26]EoktHnKqGocIHcJCgamnmIDaux",236,0.995781,26,237,1,236,1,1,0,1,1,109,109,128,127,82
"7103",2,"[26]EoktHnKqGocIHcJCgamnmIDaux",232,0.995708,26,233,1,232,1,1,0,1,1,115,115,118,117,82
"7104",3,"[26]EoktHnKqGocIHcJCgamnmIDaux",234,0.995745,26,235,1,234,1,1,0,1,1,112,112,123,122,82
"7105",4,"[26]EoktHnKqGocIHcJCgamnmIDaux",236,0.995781,26,237,1,236,1,1,0,1,1,110,110,127,126,82
"7106",5,"[26]EoktHnKqGocIHcJCgamnmIDaux",224,0.995556,26,225,1,224,1,1,0,1,1,121,121,104,103,82
"7107",6,"[26]EoktHnKqGocIHcJCgamnmIDaux",230,0.995671,26,231,1,230,1,1,0,1,1,115,115,116,115,82
"7108",7,"[26]EoktHnKqGocIHcJCgamnmIDaux",228,0.995633,26,229,1,228,1,1,0,1,1,116,116,113,112,82
"7109",8,"[26]EoktHnKqGocIHcJCgamnmIDaux",234,0.995745,26,235,1,234,1,1,0,1,1,112,112,123,122,82
"7110",9,"[26]EoktHnKqGocIHcJCgamnmIDaux",236,0.995781,26,237,1,236,1,1,0,1,1,110,110,127,126,82
"7111",10,"[26]EoktHnKqGocIHcJCgamnmIDaux",230,0.995671,26,231,1,230,1,1,0,1,1,116,116,115,114,82
"7112",11,"[26]EoktHnKqGocIHcJCgamnmIDaux",236,0.995781,26,237,1,236,1,1,0,1,1,112,112,125,124,82
"7113",12,"[26]EoktHnKqGocIHcJCgamnmIDaux",233,0.995726,26,234,1,233,1,1,0,1,1,113,113,121,120,82
"7114",13,"[26]EoktHnKqGocIHcJCgamnmIDaux",232,0.995708,26,233,1,232,1,1,0,1,1,113,113,120,119,82
"7115",14,"[26]EoktHnKqGocIHcJCgamnmIDaux",228,0.995633,26,229,1,228,1,1,0,1,1,116,116,113,112,82
"7116",15,"[26]EoktHnKqGocIHcJCgamnmIDaux",225,0.995575,26,226,1,225,1,1,0,1,1,119,119,107,106,82
"7117",16,"[26]EoktHnKqGocIHcJCgamnmIDaux",230,0.995671,26,231,1,230,1,1,0,1,1,116,116,115,114,82
"7118",17,"[26]EoktHnKqGocIHcJCgamnmIDaux",223,0.995536,26,224,1,223,1,1,0,1,1,120,120,104,103,82
"7119",18,"[26]EoktHnKqGocIHcJCgamnmIDaux",226,0.995595,26,227,1,226,1,1,0,1,1,117,117,110,109,82
"7120",19,"[26]EoktHnKqGocIHcJCgamnmIDaux",230,0.995671,26,231,1,230,1,1,0,1,1,115,115,116,115,82
"7121",20,"[26]EoktHnKqGocIHcJCgamnmIDaux",220,0.995475,26,221,1,220,1,1,0,1,1,122,122,99,98,82
"7122",21,"[26]EoktHnKqGocIHcJCgamnmIDaux",237,0.995798,26,238,1,237,1,1,0,1,1,109,109,129,128,82
"7123",22,"[26]EoktHnKqGocIHcJCgamnmIDaux",237,0.995798,26,238,1,237,1,1,0,1,1,111,111,127,126,82
"7124",23,"[26]EoktHnKqGocIHcJCgamnmIDaux",238,0.995816,26,239,1,238,1,1,0,1,1,108,108,131,130,82
"7125",24,"[26]EoktHnKqGocIHcJCgamnmIDaux",227,0.995614,26,228,1,227,1,1,0,1,1,118,118,110,109,82
"7126",25,"[26]EoktHnKqGocIHcJCgamnmIDaux",238,0.995816,26,239,1,238,1,1,0,1,1,109,109,130,129,82
"7127",26,"[26]EoktHnKqGocIHcJCgamnmIDaux",235,0.995763,26,236,1,235,1,1,0,1,1,112,112,124,123,82
"7128",27,"[26]EoktHnKqGocIHcJCgamnmIDaux",218,0.995434,26,219,1,218,1,1,0,1,1,124,124,95,94,82
"7129",28,"[26]EoktHnKqGocIHcJCgamnmIDaux",231,0.99569,26,232,1,231,1,1,0,1,1,114,114,118,117,82
"7130",29,"[26]EoktHnKqGocIHcJCgamnmIDaux",230,0.995671,26,231,1,230,1,1,0,1,1,114,114,117,116,82
"7131",30,"[26]EoktHnKqGocIHcJCgamnmIDaux",229,0.995652,26,230,1,229,1,1,0,1,1,116,116,114,113,82
"7132",31,"[26]EoktHnKqGocIHcJCgamnmIDaux",238,0.995816,26,239,1,238,1,1,0,1,1,112,112,127,126,82
"7133",32,"[26]EoktHnKqGocIHcJCgamnmIDaux",236,0.995781,26,237,1,236,1,1,0,1,1,109,109,128,127,82
"7134",33,"[26]EoktHnKqGocIHcJCgamnmIDaux",233,0.995726,26,234,1,233,1,1,0,1,1,112,112,122,121,82
"7135",34,"[26]EoktHnKqGocIHcJCgamnmIDaux",226,0.995595,26,227,1,226,1,1,0,1,1,120,120,107,106,82
"7136",35,"[26]EoktHnKqGocIHcJCgamnmIDaux",215,0.99537,26,216,1,215,1,1,0,1,1,127,127,89,88,82
"7137",36,"[26]EoktHnKqGocIHcJCgamnmIDaux",236,0.995781,26,237,1,236,1,1,0,1,1,109,109,128,127,82
"7138",37,"[26]EoktHnKqGocIHcJCgamnmIDaux",230,0.995671,26,231,1,230,1,1,0,1,1,115,115,116,115,82
"7139",38,"[26]EoktHnKqGocIHcJCgamnmIDaux",242,0.995885,26,243,1,242,1,1,0,1,1,107,107,136,135,82
"7140",39,"[26]EoktHnKqGocIHcJCgamnmIDaux",239,0.995833,26,240,1,239,1,1,0,1,1,107,107,133,132,82
"7141",40,"[26]EoktHnKqGocIHcJCgamnmIDaux",230,0.995671,26,231,1,230,1,1,0,1,1,115,115,116,115,82
"7142",41,"[26]EoktHnKqGocIHcJCgamnmIDaux",231,0.99569,26,232,1,231,1,1,0,1,1,114,114,118,117,82
"7143",42,"[26]EoktHnKqGocIHcJCgamnmIDaux",237,0.995798,26,238,1,237,1,1,0,1,1,113,113,125,124,82
"7144",43,"[26]EoktHnKqGocIHcJCgamnmIDaux",225,0.995575,26,226,1,225,1,1,0,1,1,120,120,106,105,82
"7145",44,"[26]EoktHnKqGocIHcJCgamnmIDaux",232,0.995708,26,233,1,232,1,1,0,1,1,113,113,120,119,82
"7146",45,"[26]EoktHnKqGocIHcJCgamnmIDaux",229,0.995652,26,230,1,229,1,1,0,1,1,116,116,114,113,82
"7147",46,"[26]EoktHnKqGocIHcJCgamnmIDaux",236,0.995781,26,237,1,236,1,1,0,1,1,110,110,127,126,82
"7148",47,"[26]EoktHnKqGocIHcJCgamnmIDaux",237,0.995798,26,238,1,237,1,1,0,1,1,110,110,128,127,82
"7149",48,"[26]EoktHnKqGocIHcJCgamnmIDaux",233,0.995726,26,234,1,233,1,1,0,1,1,112,112,122,121,82
"7150",49,"[26]EoktHnKqGocIHcJCgamnmIDaux",226,0.995595,26,227,1,226,1,1,0,1,1,118,118,109,108,82
"7151",50,"[26]EoktHnKqGocIHcJCgamnmIDaux",232,0.995708,26,233,1,232,1,1,0,1,1,114,114,119,118,82
"7152",51,"[26]EoktHnKqGocIHcJCgamnmIDaux",215,0.99537,26,216,1,215,1,1,0,1,1,127,127,89,88,82
"7153",52,"[26]EoktHnKqGocIHcJCgamnmIDaux",235,0.995763,26,236,1,235,1,1,0,1,1,111,111,125,124,82
"7154",53,"[26]EoktHnKqGocIHcJCgamnmIDaux",232,0.995708,26,233,1,232,1,1,0,1,1,114,114,119,118,82
"7155",54,"[26]EoktHnKqGocIHcJCgamnmIDaux",236,0.995781,26,237,1,236,1,1,0,1,1,110,110,127,126,82
"7156",55,"[26]EoktHnKqGocIHcJCgamnmIDaux",231,0.99569,26,232,1,231,1,1,0,1,1,113,113,119,118,82
"7157",56,"[26]EoktHnKqGocIHcJCgamnmIDaux",237,0.995798,26,238,1,237,1,1,0,1,1,110,110,128,127,82
"7158",57,"[26]EoktHnKqGocIHcJCgamnmIDaux",228,0.995633,26,229,1,228,1,1,0,1,1,116,116,113,112,82
"7159",58,"[26]EoktHnKqGocIHcJCgamnmIDaux",233,0.995726,26,234,1,233,1,1,0,1,1,113,113,121,120,82
"7160",59,"[26]EoktHnKqGocIHcJCgamnmIDaux",245,0.995935,26,246,1,245,1,1,0,1,1,103,103,143,142,82
"7161",60,"[26]EoktHnKqGocIHcJCgamnmIDaux",220,0.995475,26,221,1,220,1,1,0,1,1,123,123,98,97,82
"7162",61,"[26]EoktHnKqGocIHcJCgamnmIDaux",231,0.99569,26,232,1,231,1,1,0,1,1,114,114,118,117,82
"7163",62,"[26]EoktHnKqGocIHcJCgamnmIDaux",238,0.995816,26,239,1,238,1,1,0,1,1,109,109,130,129,82
"7164",63,"[26]EoktHnKqGocIHcJCgamnmIDaux",226,0.995595,26,227,1,226,1,1,0,1,1,119,119,108,107,82
"7165",64,"[26]EoktHnKqGocIHcJCgamnmIDaux",234,0.995745,26,235,1,234,1,1,0,1,1,115,115,120,119,82
"7166",65,"[26]EoktHnKqGocIHcJCgamnmIDaux",224,0.995556,26,225,1,224,1,1,0,1,1,119,119,106,105,82
"7167",66,"[26]EoktHnKqGocIHcJCgamnmIDaux",221,0.995495,26,222,1,221,1,1,0,1,1,121,121,101,100,82
"7168",67,"[26]EoktHnKqGocIHcJCgamnmIDaux",229,0.995652,26,230,1,229,1,1,0,1,1,116,116,114,113,82
"7169",68,"[26]EoktHnKqGocIHcJCgamnmIDaux",221,0.995495,26,222,1,221,1,1,0,1,1,122,122,100,99,82
"7170",69,"[26]EoktHnKqGocIHcJCgamnmIDaux",241,0.995868,26,242,1,241,1,1,0,1,1,105,105,137,136,82
"7171",70,"[26]EoktHnKqGocIHcJCgamnmIDaux",243,0.995902,26,244,1,243,1,1,0,1,1,105,105,139,138,82
"7172",71,"[26]EoktHnKqGocIHcJCgamnmIDaux",238,0.995816,26,239,1,238,1,1,0,1,1,108,108,131,130,82
"7173",72,"[26]EoktHnKqGocIHcJCgamnmIDaux",216,0.995392,26,217,1,216,1,1,0,1,1,125,125,92,91,82
"7174",73,"[26]EoktHnKqGocIHcJCgamnmIDaux",230,0.995671,26,231,1,230,1,1,0,1,1,117,117,114,113,82
"7175",74,"[26]EoktHnKqGocIHcJCgamnmIDaux",234,0.995745,26,235,1,234,1,1,0,1,1,111,111,124,123,82
"7176",75,"[26]EoktHnKqGocIHcJCgamnmIDaux",231,0.99569,26,232,1,231,1,1,0,1,1,114,114,118,117,82
"7177",76,"[26]EoktHnKqGocIHcJCgamnmIDaux",224,0.995556,26,225,1,224,1,1,0,1,1,120,120,105,104,82
"7178",77,"[26]EoktHnKqGocIHcJCgamnmIDaux",229,0.995652,26,230,1,229,1,1,0,1,1,115,115,115,114,82
"7179",78,"[26]EoktHnKqGocIHcJCgamnmIDaux",235,0.995763,26,236,1,235,1,1,0,1,1,110,110,126,125,82
"7180",79,"[26]EoktHnKqGocIHcJCgamnmIDaux",232,0.995708,26,233,1,232,1,1,0,1,1,114,114,119,118,82
"7181",80,"[26]EoktHnKqGocIHcJCgamnmIDaux",227,0.995614,26,228,1,227,1,1,0,1,1,117,117,111,110,82
"7182",81,"[26]EoktHnKqGocIHcJCgamnmIDaux",231,0.99569,26,232,1,231,1,1,0,1,1,114,114,118,117,82
"7183",82,"[26]EoktHnKqGocIHcJCgamnmIDaux",235,0.995763,26,236,1,235,1,1,0,1,1,111,111,125,124,82
"7184",83,"[26]EoktHnKqGocIHcJCgamnmIDaux",238,0.995816,26,239,1,238,1,1,0,1,1,112,112,127,126,82
"7185",84,"[26]EoktHnKqGocIHcJCgamnmIDaux",233,0.995726,26,234,1,233,1,1,0,1,1,113,113,121,120,82
"7186",85,"[26]EoktHnKqGocIHcJCgamnmIDaux",226,0.995595,26,227,1,226,1,1,0,1,1,118,118,109,108,82
"7187",86,"[26]EoktHnKqGocIHcJCgamnmIDaux",239,0.995833,26,240,1,239,1,1,0,1,1,107,107,133,132,82
"7188",87,"[26]EoktHnKqGocIHcJCgamnmIDaux",232,0.995708,26,233,1,232,1,1,0,1,1,113,113,120,119,82
"7189",88,"[26]EoktHnKqGocIHcJCgamnmIDaux",231,0.99569,26,232,1,231,1,1,0,1,1,114,114,118,117,82
"7190",89,"[26]EoktHnKqGocIHcJCgamnmIDaux",225,0.995575,26,226,1,225,1,1,0,1,1,121,121,105,104,82
"7191",90,"[26]EoktHnKqGocIHcJCgamnmIDaux",232,0.995708,26,233,1,232,1,1,0,1,1,116,116,117,116,82
"7192",91,"[26]EoktHnKqGocIHcJCgamnmIDaux",227,0.995614,26,228,1,227,1,1,0,1,1,118,118,110,109,82
"7193",92,"[26]EoktHnKqGocIHcJCgamnmIDaux",242,0.995885,26,243,1,242,1,1,0,1,1,105,105,138,137,82
"7194",93,"[26]EoktHnKqGocIHcJCgamnmIDaux",238,0.995816,26,239,1,238,1,1,0,1,1,108,108,131,130,82
"7195",94,"[26]EoktHnKqGocIHcJCgamnmIDaux",225,0.995575,26,226,1,225,1,1,0,1,1,118,118,108,107,82
"7196",95,"[26]EoktHnKqGocIHcJCgamnmIDaux",233,0.995726,26,234,1,233,1,1,0,1,1,117,117,117,116,82
"7197",96,"[26]EoktHnKqGocIHcJCgamnmIDaux",226,0.995595,26,227,1,226,1,1,0,1,1,118,118,109,108,82
"7198",97,"[26]EoktHnKqGocIHcJCgamnmIDaux",227,0.995614,26,228,1,227,1,1,0,1,1,117,117,111,110,82
"7199",98,"[26]EoktHnKqGocIHcJCgamnmIDaux",232,0.995708,26,233,1,232,1,1,0,1,1,114,114,119,118,82
"7200",99,"[26]EoktHnKqGocIHcJCgamnmIDaux",226,0.995595,26,227,1,226,1,1,0,1,1,117,117,110,109,82
"7201",0,"[28]EHnjuHnKqGocIHcJCBHdrcIrClvv",235,0.995763,28,236,1,235,1,1,0,1,1,111,111,125,124,83
"7202",1,"[28]EHnjuHnKqGocIHcJCBHdrcIrClvv",225,0.995575,28,226,1,225,1,1,0,1,1,119,119,107,106,83
"7203",2,"[28]EHnjuHnKqGocIHcJCBHdrcIrClvv",238,0.995816,28,239,1,238,1,1,0,1,1,115,115,124,123,83
"7204",3,"[28]EHnjuHnKqGocIHcJCBHdrcIrClvv",229,0.995652,28,230,1,229,1,1,0,1,1,115,115,115,114,83
"7205",4,"[28]EHnjuHnKqGocIHcJCBHdrcIrClvv",229,0.995652,28,230,1,229,1,1,0,1,1,115,115,115,114,83
"7206",5,"[28]EHnjuHnKqGocIHcJCBHdrcIrClvv",222,0.995516,28,223,1,222,1,1,0,1,1,120,120,103,102,83
"7207",6,"[28]EHnjuHnKqGocIHcJCBHdrcIrClvv",235,0.995763,28,236,1,235,1,1,0,1,1,111,111,125,124,83
"7208",7,"[28]EHnjuHnKqGocIHcJCBHdrcIrClvv",233,0.995726,28,234,1,233,1,1,0,1,1,112,112,122,121,83
"7209",8,"[28]EHnjuHnKqGocIHcJCBHdrcIrClvv",235,0.995763,28,236,1,235,1,1,0,1,1,111,111,125,124,83
"7210",9,"[28]EHnjuHnKqGocIHcJCBHdrcIrClvv",236,0.995781,28,237,1,236,1,1,0,1,1,109,109,128,127,83
"7211",10,"[28]EHnjuHnKqGocIHcJCBHdrcIrClvv",232,0.995708,28,233,1,232,1,1,0,1,1,113,113,120,119,83
"7212",11,"[28]EHnjuHnKqGocIHcJCBHdrcIrClvv",243,0.995902,28,244,1,243,1,1,0,1,1,105,105,139,138,83
"7213",12,"[28]EHnjuHnKqGocIHcJCBHdrcIrClvv",224,0.995556,28,225,1,224,1,1,0,1,1,120,120,105,104,83
"7214",13,"[28]EHnjuHnKqGocIHcJCBHdrcIrClvv",231,0.99569,28,232,1,231,1,1,0,1,1,117,117,115,114,83
"7215",14,"[28]EHnjuHnKqGocIHcJCBHdrcIrClvv",232,0.995708,28,233,1,232,1,1,0,1,1,114,114,119,118,83
"7216",15,"[28]EHnjuHnKqGocIHcJCBHdrcIrClvv",230,0.995671,28,231,1,230,1,1,0,1,1,114,114,117,116,83
"7217",16,"[28]EHnjuHnKqGocIHcJCBHdrcIrClvv",235,0.995763,28,236,1,235,1,1,0,1,1,111,111,125,124,83
"7218",17,"[28]EHnjuHnKqGocIHcJCBHdrcIrClvv",234,0.995745,28,235,1,234,1,1,0,1,1,115,115,120,119,83
"7219",18,"[28]EHnjuHnKqGocIHcJCBHdrcIrClvv",230,0.995671,28,231,1,230,1,1,0,1,1,118,118,113,112,83
"7220",19,"[28]EHnjuHnKqGocIHcJCBHdrcIrClvv",233,0.995726,28,234,1,233,1,1,0,1,1,111,111,123,122,83
"7221",20,"[28]EHnjuHnKqGocIHcJCBHdrcIrClvv",237,0.995798,28,238,1,237,1,1,0,1,1,110,110,128,127,83
"7222",21,"[28]EHnjuHnKqGocIHcJCBHdrcIrClvv",241,0.995868,28,242,1,241,1,1,0,1,1,105,105,137,136,83
"7223",22,"[28]EHnjuHnKqGocIHcJCBHdrcIrClvv",237,0.995798,28,238,1,237,1,1,0,1,1,111,111,127,126,83
"7224",23,"[28]EHnjuHnKqGocIHcJCBHdrcIrClvv",225,0.995575,28,226,1,225,1,1,0,1,1,118,118,108,107,83
"7225",24,"[28]EHnjuHnKqGocIHcJCBHdrcIrClvv",230,0.995671,28,231,1,230,1,1,0,1,1,115,115,116,115,83
"7226",25,"[28]EHnjuHnKqGocIHcJCBHdrcIrClvv",233,0.995726,28,234,1,233,1,1,0,1,1,111,111,123,122,83
"7227",26,"[28]EHnjuHnKqGocIHcJCBHdrcIrClvv",229,0.995652,28,230,1,229,1,1,0,1,1,117,117,113,112,83
"7228",27,"[28]EHnjuHnKqGocIHcJCBHdrcIrClvv",232,0.995708,28,233,1,232,1,1,0,1,1,113,113,120,119,83
"7229",28,"[28]EHnjuHnKqGocIHcJCBHdrcIrClvv",243,0.995902,28,244,1,243,1,1,0,1,1,105,105,139,138,83
"7230",29,"[28]EHnjuHnKqGocIHcJCBHdrcIrClvv",237,0.995798,28,238,1,237,1,1,0,1,1,111,111,127,126,83
"7231",30,"[28]EHnjuHnKqGocIHcJCBHdrcIrClvv",240,0.995851,28,241,1,240,1,1,0,1,1,107,107,134,133,83
"7232",31,"[28]EHnjuHnKqGocIHcJCBHdrcIrClvv",223,0.995536,28,224,1,223,1,1,0,1,1,120,120,104,103,83
"7233",32,"[28]EHnjuHnKqGocIHcJCBHdrcIrClvv",240,0.995851,28,241,1,240,1,1,0,1,1,107,107,134,133,83
"7234",33,"[28]EHnjuHnKqGocIHcJCBHdrcIrClvv",233,0.995726,28,234,1,233,1,1,0,1,1,115,115,119,118,83
"7235",34,"[28]EHnjuHnKqGocIHcJCBHdrcIrClvv",231,0.99569,28,232,1,231,1,1,0,1,1,114,114,118,117,83
"7236",35,"[28]EHnjuHnKqGocIHcJCBHdrcIrClvv",221,0.995495,28,222,1,221,1,1,0,1,1,123,123,99,98,83
"7237",36,"[28]EHnjuHnKqGocIHcJCBHdrcIrClvv",228,0.995633,28,229,1,228,1,1,0,1,1,115,115,114,113,83
"7238",37,"[28]EHnjuHnKqGocIHcJCBHdrcIrClvv",224,0.995556,28,225,1,224,1,1,0,1,1,119,119,106,105,83
"7239",38,"[28]EHnjuHnKqGocIHcJCBHdrcIrClvv",234,0.995745,28,235,1,234,1,1,0,1,1,111,111,124,123,83
"7240",39,"[28]EHnjuHnKqGocIHcJCBHdrcIrClvv",241,0.995868,28,242,1,241,1,1,0,1,1,106,106,136,135,83
"7241",40,"[28]EHnjuHnKqGocIHcJCBHdrcIrClvv",231,0.99569,28,232,1,231,1,1,0,1,1,114,114,118,117,83
"7242",41,"[28]EHnjuHnKqGocIHcJCBHdrcIrClvv",226,0.995595,28,227,1,226,1,1,0,1,1,117,117,110,109,83
"7243",42,"[28]EHnjuHnKqGocIHcJCBHdrcIrClvv",220,0.995475,28,221,1,220,1,1,0,1,1,123,123,98,97,83
"7244",43,"[28]EHnjuHnKqGocIHcJCBHdrcIrClvv",225,0.995575,28,226,1,225,1,1,0,1,1,120,120,106,105,83
"7245",44,"[28]EHnjuHnKqGocIHcJCBHdrcIrClvv",216,0.995392,28,217,1,216,1,1,0,1,1,125,125,92,91,83
"7246",45,"[28]EHnjuHnKqGocIHcJCBHdrcIrClvv",222,0.995516,28,223,1,222,1,1,0,1,1,120,120,103,102,83
"7247",46,"[28]EHnjuHnKqGocIHcJCBHdrcIrClvv",221,0.995495,28,222,1,221,1,1,0,1,1,121,121,101,100,83
"7248",47,"[28]EHnjuHnKqGocIHcJCBHdrcIrClvv",228,0.995633,28,229,1,228,1,1,0,1,1,116,116,113,112,83
"7249",48,"[28]EHnjuHnKqGocIHcJCBHdrcIrClvv",238,0.995816,28,239,1,238,1,1,0,1,1,108,108,131,130,83
"7250",49,"[28]EHnjuHnKqGocIHcJCBHdrcIrClvv",219,0.995455,28,220,1,219,1,1,0,1,1,125,125,95,94,83
"7251",50,"[28]EHnjuHnKqGocIHcJCBHdrcIrClvv",223,0.995536,28,224,1,223,1,1,0,1,1,120,120,104,103,83
"7252",51,"[28]EHnjuHnKqGocIHcJCBHdrcIrClvv",224,0.995556,28,225,1,224,1,1,0,1,1,119,119,106,105,83
"7253",52,"[28]EHnjuHnKqGocIHcJCBHdrcIrClvv",226,0.995595,28,227,1,226,1,1,0,1,1,117,117,110,109,83
"7254",53,"[28]EHnjuHnKqGocIHcJCBHdrcIrClvv",226,0.995595,28,227,1,226,1,1,0,1,1,117,117,110,109,83
"7255",54,"[28]EHnjuHnKqGocIHcJCBHdrcIrClvv",237,0.995798,28,238,1,237,1,1,0,1,1,108,108,130,129,83
"7256",55,"[28]EHnjuHnKqGocIHcJCBHdrcIrClvv",223,0.995536,28,224,1,223,1,1,0,1,1,119,119,105,104,83
"7257",56,"[28]EHnjuHnKqGocIHcJCBHdrcIrClvv",230,0.995671,28,231,1,230,1,1,0,1,1,115,115,116,115,83
"7258",57,"[28]EHnjuHnKqGocIHcJCBHdrcIrClvv",237,0.995798,28,238,1,237,1,1,0,1,1,110,110,128,127,83
"7259",58,"[28]EHnjuHnKqGocIHcJCBHdrcIrClvv",235,0.995763,28,236,1,235,1,1,0,1,1,110,110,126,125,83
"7260",59,"[28]EHnjuHnKqGocIHcJCBHdrcIrClvv",238,0.995816,28,239,1,238,1,1,0,1,1,109,109,130,129,83
"7261",60,"[28]EHnjuHnKqGocIHcJCBHdrcIrClvv",234,0.995745,28,235,1,234,1,1,0,1,1,112,112,123,122,83
"7262",61,"[28]EHnjuHnKqGocIHcJCBHdrcIrClvv",227,0.995614,28,228,1,227,1,1,0,1,1,117,117,111,110,83
"7263",62,"[28]EHnjuHnKqGocIHcJCBHdrcIrClvv",234,0.995745,28,235,1,234,1,1,0,1,1,114,114,121,120,83
"7264",63,"[28]EHnjuHnKqGocIHcJCBHdrcIrClvv",237,0.995798,28,238,1,237,1,1,0,1,1,109,109,129,128,83
"7265",64,"[28]EHnjuHnKqGocIHcJCBHdrcIrClvv",232,0.995708,28,233,1,232,1,1,0,1,1,114,114,119,118,83
"7266",65,"[28]EHnjuHnKqGocIHcJCBHdrcIrClvv",226,0.995595,28,227,1,226,1,1,0,1,1,118,118,109,108,83
"7267",66,"[28]EHnjuHnKqGocIHcJCBHdrcIrClvv",236,0.995781,28,237,1,236,1,1,0,1,1,113,113,124,123,83
"7268",67,"[28]EHnjuHnKqGocIHcJCBHdrcIrClvv",235,0.995763,28,236,1,235,1,1,0,1,1,111,111,125,124,83
"7269",68,"[28]EHnjuHnKqGocIHcJCBHdrcIrClvv",226,0.995595,28,227,1,226,1,1,0,1,1,118,118,109,108,83
"7270",69,"[28]EHnjuHnKqGocIHcJCBHdrcIrClvv",227,0.995614,28,228,1,227,1,1,0,1,1,119,119,109,108,83
"7271",70,"[28]EHnjuHnKqGocIHcJCBHdrcIrClvv",224,0.995556,28,225,1,224,1,1,0,1,1,119,119,106,105,83
"7272",71,"[28]EHnjuHnKqGocIHcJCBHdrcIrClvv",229,0.995652,28,230,1,229,1,1,0,1,1,115,115,115,114,83
"7273",72,"[28]EHnjuHnKqGocIHcJCBHdrcIrClvv",240,0.995851,28,241,1,240,1,1,0,1,1,107,107,134,133,83
"7274",73,"[28]EHnjuHnKqGocIHcJCBHdrcIrClvv",234,0.995745,28,235,1,234,1,1,0,1,1,112,112,123,122,83
"7275",74,"[28]EHnjuHnKqGocIHcJCBHdrcIrClvv",241,0.995868,28,242,1,241,1,1,0,1,1,109,109,133,132,83
"7276",75,"[28]EHnjuHnKqGocIHcJCBHdrcIrClvv",225,0.995575,28,226,1,225,1,1,0,1,1,119,119,107,106,83
"7277",76,"[28]EHnjuHnKqGocIHcJCBHdrcIrClvv",235,0.995763,28,236,1,235,1,1,0,1,1,113,113,123,122,83
"7278",77,"[28]EHnjuHnKqGocIHcJCBHdrcIrClvv",233,0.995726,28,234,1,233,1,1,0,1,1,114,114,120,119,83
"7279",78,"[28]EHnjuHnKqGocIHcJCBHdrcIrClvv",226,0.995595,28,227,1,226,1,1,0,1,1,118,118,109,108,83
"7280",79,"[28]EHnjuHnKqGocIHcJCBHdrcIrClvv",226,0.995595,28,227,1,226,1,1,0,1,1,117,117,110,109,83
"7281",80,"[28]EHnjuHnKqGocIHcJCBHdrcIrClvv",224,0.995556,28,225,1,224,1,1,0,1,1,119,119,106,105,83
"7282",81,"[28]EHnjuHnKqGocIHcJCBHdrcIrClvv",230,0.995671,28,231,1,230,1,1,0,1,1,114,114,117,116,83
"7283",82,"[28]EHnjuHnKqGocIHcJCBHdrcIrClvv",237,0.995798,28,238,1,237,1,1,0,1,1,108,108,130,129,83
"7284",83,"[28]EHnjuHnKqGocIHcJCBHdrcIrClvv",231,0.99569,28,232,1,231,1,1,0,1,1,114,114,118,117,83
"7285",84,"[28]EHnjuHnKqGocIHcJCBHdrcIrClvv",231,0.99569,28,232,1,231,1,1,0,1,1,115,115,117,116,83
"7286",85,"[28]EHnjuHnKqGocIHcJCBHdrcIrClvv",229,0.995652,28,230,1,229,1,1,0,1,1,115,115,115,114,83
"7287",86,"[28]EHnjuHnKqGocIHcJCBHdrcIrClvv",238,0.995816,28,239,1,238,1,1,0,1,1,108,108,131,130,83
"7288",87,"[28]EHnjuHnKqGocIHcJCBHdrcIrClvv",233,0.995726,28,234,1,233,1,1,0,1,1,111,111,123,122,83
"7289",88,"[28]EHnjuHnKqGocIHcJCBHdrcIrClvv",239,0.995833,28,240,1,239,1,1,0,1,1,108,108,132,131,83
"7290",89,"[28]EHnjuHnKqGocIHcJCBHdrcIrClvv",214,0.995349,28,215,1,214,1,1,0,1,1,129,129,86,85,83
"7291",90,"[28]EHnjuHnKqGocIHcJCBHdrcIrClvv",231,0.99569,28,232,1,231,1,1,0,1,1,113,113,119,118,83
"7292",91,"[28]EHnjuHnKqGocIHcJCBHdrcIrClvv",229,0.995652,28,230,1,229,1,1,0,1,1,116,116,114,113,83
"7293",92,"[28]EHnjuHnKqGocIHcJCBHdrcIrClvv",224,0.995556,28,225,1,224,1,1,0,1,1,119,119,106,105,83
"7294",93,"[28]EHnjuHnKqGocIHcJCBHdrcIrClvv",232,0.995708,28,233,1,232,1,1,0,1,1,114,114,119,118,83
"7295",94,"[28]EHnjuHnKqGocIHcJCBHdrcIrClvv",228,0.995633,28,229,1,228,1,1,0,1,1,117,117,112,111,83
"7296",95,"[28]EHnjuHnKqGocIHcJCBHdrcIrClvv",232,0.995708,28,233,1,232,1,1,0,1,1,113,113,120,119,83
"7297",96,"[28]EHnjuHnKqGocIHcJCBHdrcIrClvv",239,0.995833,28,240,1,239,1,1,0,1,1,109,109,131,130,83
"7298",97,"[28]EHnjuHnKqGocIHcJCBHdrcIrClvv",227,0.995614,28,228,1,227,1,1,0,1,1,117,117,111,110,83
"7299",98,"[28]EHnjuHnKqGocIHcJCBHdrcIrClvv",223,0.995536,28,224,1,223,1,1,0,1,1,119,119,105,104,83
"7300",99,"[28]EHnjuHnKqGocIHcJCBHdrcIrClvv",237,0.995798,28,238,1,237,1,1,0,1,1,108,108,130,129,83
"7301",0,"[23]EaGxHnKqGocIHcJCtADBhyI",230,0.995671,23,231,1,230,1,1,0,1,1,114,114,117,116,84
"7302",1,"[23]EaGxHnKqGocIHcJCtADBhyI",235,0.995763,23,236,1,235,1,1,0,1,1,110,110,126,125,84
"7303",2,"[23]EaGxHnKqGocIHcJCtADBhyI",234,0.995745,23,235,1,234,1,1,0,1,1,113,113,122,121,84
"7304",3,"[23]EaGxHnKqGocIHcJCtADBhyI",232,0.995708,23,233,1,232,1,1,0,1,1,113,113,120,119,84
"7305",4,"[23]EaGxHnKqGocIHcJCtADBhyI",229,0.995652,23,230,1,229,1,1,0,1,1,115,115,115,114,84
"7306",5,"[23]EaGxHnKqGocIHcJCtADBhyI",216,0.995392,23,217,1,216,1,1,0,1,1,125,125,92,91,84
"7307",6,"[23]EaGxHnKqGocIHcJCtADBhyI",240,0.995851,23,241,1,240,1,1,0,1,1,106,106,135,134,84
"7308",7,"[23]EaGxHnKqGocIHcJCtADBhyI",236,0.995781,23,237,1,236,1,1,0,1,1,110,110,127,126,84
"7309",8,"[23]EaGxHnKqGocIHcJCtADBhyI",234,0.995745,23,235,1,234,1,1,0,1,1,111,111,124,123,84
"7310",9,"[23]EaGxHnKqGocIHcJCtADBhyI",222,0.995516,23,223,1,222,1,1,0,1,1,121,121,102,101,84
"7311",10,"[23]EaGxHnKqGocIHcJCtADBhyI",223,0.995536,23,224,1,223,1,1,0,1,1,120,120,104,103,84
"7312",11,"[23]EaGxHnKqGocIHcJCtADBhyI",238,0.995816,23,239,1,238,1,1,0,1,1,108,108,131,130,84
"7313",12,"[23]EaGxHnKqGocIHcJCtADBhyI",243,0.995902,23,244,1,243,1,1,0,1,1,104,104,140,139,84
"7314",13,"[23]EaGxHnKqGocIHcJCtADBhyI",234,0.995745,23,235,1,234,1,1,0,1,1,112,112,123,122,84
"7315",14,"[23]EaGxHnKqGocIHcJCtADBhyI",238,0.995816,23,239,1,238,1,1,0,1,1,109,109,130,129,84
"7316",15,"[23]EaGxHnKqGocIHcJCtADBhyI",223,0.995536,23,224,1,223,1,1,0,1,1,120,120,104,103,84
"7317",16,"[23]EaGxHnKqGocIHcJCtADBhyI",238,0.995816,23,239,1,238,1,1,0,1,1,111,111,128,127,84
"7318",17,"[23]EaGxHnKqGocIHcJCtADBhyI",222,0.995516,23,223,1,222,1,1,0,1,1,122,122,101,100,84
"7319",18,"[23]EaGxHnKqGocIHcJCtADBhyI",225,0.995575,23,226,1,225,1,1,0,1,1,119,119,107,106,84
"7320",19,"[23]EaGxHnKqGocIHcJCtADBhyI",232,0.995708,23,233,1,232,1,1,0,1,1,115,115,118,117,84
"7321",20,"[23]EaGxHnKqGocIHcJCtADBhyI",231,0.99569,23,232,1,231,1,1,0,1,1,114,114,118,117,84
"7322",21,"[23]EaGxHnKqGocIHcJCtADBhyI",230,0.995671,23,231,1,230,1,1,0,1,1,115,115,116,115,84
"7323",22,"[23]EaGxHnKqGocIHcJCtADBhyI",234,0.995745,23,235,1,234,1,1,0,1,1,112,112,123,122,84
"7324",23,"[23]EaGxHnKqGocIHcJCtADBhyI",243,0.995902,23,244,1,243,1,1,0,1,1,107,107,137,136,84
"7325",24,"[23]EaGxHnKqGocIHcJCtADBhyI",221,0.995495,23,222,1,221,1,1,0,1,1,121,121,101,100,84
"7326",25,"[23]EaGxHnKqGocIHcJCtADBhyI",233,0.995726,23,234,1,233,1,1,0,1,1,113,113,121,120,84
"7327",26,"[23]EaGxHnKqGocIHcJCtADBhyI",226,0.995595,23,227,1,226,1,1,0,1,1,117,117,110,109,84
"7328",27,"[23]EaGxHnKqGocIHcJCtADBhyI",212,0.995305,23,213,1,212,1,1,0,1,1,128,128,85,84,84
"7329",28,"[23]EaGxHnKqGocIHcJCtADBhyI",234,0.995745,23,235,1,234,1,1,0,1,1,112,112,123,122,84
"7330",29,"[23]EaGxHnKqGocIHcJCtADBhyI",229,0.995652,23,230,1,229,1,1,0,1,1,115,115,115,114,84
"7331",30,"[23]EaGxHnKqGocIHcJCtADBhyI",243,0.995902,23,244,1,243,1,1,0,1,1,108,108,136,135,84
"7332",31,"[23]EaGxHnKqGocIHcJCtADBhyI",230,0.995671,23,231,1,230,1,1,0,1,1,114,114,117,116,84
"7333",32,"[23]EaGxHnKqGocIHcJCtADBhyI",231,0.99569,23,232,1,231,1,1,0,1,1,113,113,119,118,84
"7334",33,"[23]EaGxHnKqGocIHcJCtADBhyI",234,0.995745,23,235,1,234,1,1,0,1,1,111,111,124,123,84
"7335",34,"[23]EaGxHnKqGocIHcJCtADBhyI",221,0.995495,23,222,1,221,1,1,0,1,1,121,121,101,100,84
"7336",35,"[23]EaGxHnKqGocIHcJCtADBhyI",236,0.995781,23,237,1,236,1,1,0,1,1,113,113,124,123,84
"7337",36,"[23]EaGxHnKqGocIHcJCtADBhyI",234,0.995745,23,235,1,234,1,1,0,1,1,114,114,121,120,84
"7338",37,"[23]EaGxHnKqGocIHcJCtADBhyI",227,0.995614,23,228,1,227,1,1,0,1,1,117,117,111,110,84
"7339",38,"[23]EaGxHnKqGocIHcJCtADBhyI",222,0.995516,23,223,1,222,1,1,0,1,1,120,120,103,102,84
"7340",39,"[23]EaGxHnKqGocIHcJCtADBhyI",230,0.995671,23,231,1,230,1,1,0,1,1,119,119,112,111,84
"7341",40,"[23]EaGxHnKqGocIHcJCtADBhyI",231,0.99569,23,232,1,231,1,1,0,1,1,115,115,117,116,84
"7342",41,"[23]EaGxHnKqGocIHcJCtADBhyI",218,0.995434,23,219,1,218,1,1,0,1,1,126,126,93,92,84
"7343",42,"[23]EaGxHnKqGocIHcJCtADBhyI",222,0.995516,23,223,1,222,1,1,0,1,1,120,120,103,102,84
"7344",43,"[23]EaGxHnKqGocIHcJCtADBhyI",243,0.995902,23,244,1,243,1,1,0,1,1,108,108,136,135,84
"7345",44,"[23]EaGxHnKqGocIHcJCtADBhyI",247,0.995968,23,248,1,247,1,1,0,1,1,100,100,148,147,84
"7346",45,"[23]EaGxHnKqGocIHcJCtADBhyI",240,0.995851,23,241,1,240,1,1,0,1,1,107,107,134,133,84
"7347",46,"[23]EaGxHnKqGocIHcJCtADBhyI",229,0.995652,23,230,1,229,1,1,0,1,1,116,116,114,113,84
"7348",47,"[23]EaGxHnKqGocIHcJCtADBhyI",232,0.995708,23,233,1,232,1,1,0,1,1,113,113,120,119,84
"7349",48,"[23]EaGxHnKqGocIHcJCtADBhyI",227,0.995614,23,228,1,227,1,1,0,1,1,119,119,109,108,84
"7350",49,"[23]EaGxHnKqGocIHcJCtADBhyI",230,0.995671,23,231,1,230,1,1,0,1,1,116,116,115,114,84
"7351",50,"[23]EaGxHnKqGocIHcJCtADBhyI",231,0.99569,23,232,1,231,1,1,0,1,1,113,113,119,118,84
"7352",51,"[23]EaGxHnKqGocIHcJCtADBhyI",226,0.995595,23,227,1,226,1,1,0,1,1,118,118,109,108,84
"7353",52,"[23]EaGxHnKqGocIHcJCtADBhyI",222,0.995516,23,223,1,222,1,1,0,1,1,120,120,103,102,84
"7354",53,"[23]EaGxHnKqGocIHcJCtADBhyI",232,0.995708,23,233,1,232,1,1,0,1,1,112,112,121,120,84
"7355",54,"[23]EaGxHnKqGocIHcJCtADBhyI",238,0.995816,23,239,1,238,1,1,0,1,1,109,109,130,129,84
"7356",55,"[23]EaGxHnKqGocIHcJCtADBhyI",225,0.995575,23,226,1,225,1,1,0,1,1,118,118,108,107,84
"7357",56,"[23]EaGxHnKqGocIHcJCtADBhyI",230,0.995671,23,231,1,230,1,1,0,1,1,114,114,117,116,84
"7358",57,"[23]EaGxHnKqGocIHcJCtADBhyI",221,0.995495,23,222,1,221,1,1,0,1,1,122,122,100,99,84
"7359",58,"[23]EaGxHnKqGocIHcJCtADBhyI",234,0.995745,23,235,1,234,1,1,0,1,1,114,114,121,120,84
"7360",59,"[23]EaGxHnKqGocIHcJCtADBhyI",223,0.995536,23,224,1,223,1,1,0,1,1,121,121,103,102,84
"7361",60,"[23]EaGxHnKqGocIHcJCtADBhyI",227,0.995614,23,228,1,227,1,1,0,1,1,117,117,111,110,84
"7362",61,"[23]EaGxHnKqGocIHcJCtADBhyI",225,0.995575,23,226,1,225,1,1,0,1,1,118,118,108,107,84
"7363",62,"[23]EaGxHnKqGocIHcJCtADBhyI",233,0.995726,23,234,1,233,1,1,0,1,1,112,112,122,121,84
"7364",63,"[23]EaGxHnKqGocIHcJCtADBhyI",228,0.995633,23,229,1,228,1,1,0,1,1,117,117,112,111,84
"7365",64,"[23]EaGxHnKqGocIHcJCtADBhyI",229,0.995652,23,230,1,229,1,1,0,1,1,118,118,112,111,84
"7366",65,"[23]EaGxHnKqGocIHcJCtADBhyI",226,0.995595,23,227,1,226,1,1,0,1,1,117,117,110,109,84
"7367",66,"[23]EaGxHnKqGocIHcJCtADBhyI",226,0.995595,23,227,1,226,1,1,0,1,1,119,119,108,107,84
"7368",67,"[23]EaGxHnKqGocIHcJCtADBhyI",232,0.995708,23,233,1,232,1,1,0,1,1,114,114,119,118,84
"7369",68,"[23]EaGxHnKqGocIHcJCtADBhyI",230,0.995671,23,231,1,230,1,1,0,1,1,117,117,114,113,84
"7370",69,"[23]EaGxHnKqGocIHcJCtADBhyI",233,0.995726,23,234,1,233,1,1,0,1,1,114,114,120,119,84
"7371",70,"[23]EaGxHnKqGocIHcJCtADBhyI",228,0.995633,23,229,1,228,1,1,0,1,1,116,116,113,112,84
"7372",71,"[23]EaGxHnKqGocIHcJCtADBhyI",221,0.995495,23,222,1,221,1,1,0,1,1,121,121,101,100,84
"7373",72,"[23]EaGxHnKqGocIHcJCtADBhyI",228,0.995633,23,229,1,228,1,1,0,1,1,120,120,109,108,84
"7374",73,"[23]EaGxHnKqGocIHcJCtADBhyI",232,0.995708,23,233,1,232,1,1,0,1,1,113,113,120,119,84
"7375",74,"[23]EaGxHnKqGocIHcJCtADBhyI",243,0.995902,23,244,1,243,1,1,0,1,1,110,110,134,133,84
"7376",75,"[23]EaGxHnKqGocIHcJCtADBhyI",241,0.995868,23,242,1,241,1,1,0,1,1,110,110,132,131,84
"7377",76,"[23]EaGxHnKqGocIHcJCtADBhyI",237,0.995798,23,238,1,237,1,1,0,1,1,113,113,125,124,84
"7378",77,"[23]EaGxHnKqGocIHcJCtADBhyI",223,0.995536,23,224,1,223,1,1,0,1,1,120,120,104,103,84
"7379",78,"[23]EaGxHnKqGocIHcJCtADBhyI",225,0.995575,23,226,1,225,1,1,0,1,1,118,118,108,107,84
"7380",79,"[23]EaGxHnKqGocIHcJCtADBhyI",226,0.995595,23,227,1,226,1,1,0,1,1,117,117,110,109,84
"7381",80,"[23]EaGxHnKqGocIHcJCtADBhyI",235,0.995763,23,236,1,235,1,1,0,1,1,110,110,126,125,84
"7382",81,"[23]EaGxHnKqGocIHcJCtADBhyI",236,0.995781,23,237,1,236,1,1,0,1,1,110,110,127,126,84
"7383",82,"[23]EaGxHnKqGocIHcJCtADBhyI",234,0.995745,23,235,1,234,1,1,0,1,1,112,112,123,122,84
"7384",83,"[23]EaGxHnKqGocIHcJCtADBhyI",238,0.995816,23,239,1,238,1,1,0,1,1,108,108,131,130,84
"7385",84,"[23]EaGxHnKqGocIHcJCtADBhyI",226,0.995595,23,227,1,226,1,1,0,1,1,118,118,109,108,84
"7386",85,"[23]EaGxHnKqGocIHcJCtADBhyI",236,0.995781,23,237,1,236,1,1,0,1,1,110,110,127,126,84
"7387",86,"[23]EaGxHnKqGocIHcJCtADBhyI",224,0.995556,23,225,1,224,1,1,0,1,1,121,121,104,103,84
"7388",87,"[23]EaGxHnKqGocIHcJCtADBhyI",234,0.995745,23,235,1,234,1,1,0,1,1,112,112,123,122,84
"7389",88,"[23]EaGxHnKqGocIHcJCtADBhyI",239,0.995833,23,240,1,239,1,1,0,1,1,111,111,129,128,84
"7390",89,"[23]EaGxHnKqGocIHcJCtADBhyI",240,0.995851,23,241,1,240,1,1,0,1,1,107,107,134,133,84
"7391",90,"[23]EaGxHnKqGocIHcJCtADBhyI",230,0.995671,23,231,1,230,1,1,0,1,1,114,114,117,116,84
"7392",91,"[23]EaGxHnKqGocIHcJCtADBhyI",230,0.995671,23,231,1,230,1,1,0,1,1,115,115,116,115,84
"7393",92,"[23]EaGxHnKqGocIHcJCtADBhyI",239,0.995833,23,240,1,239,1,1,0,1,1,108,108,132,131,84
"7394",93,"[23]EaGxHnKqGocIHcJCtADBhyI",229,0.995652,23,230,1,229,1,1,0,1,1,117,117,113,112,84
"7395",94,"[23]EaGxHnKqGocIHcJCtADBhyI",237,0.995798,23,238,1,237,1,1,0,1,1,109,109,129,128,84
"7396",95,"[23]EaGxHnKqGocIHcJCtADBhyI",222,0.995516,23,223,1,222,1,1,0,1,1,122,122,101,100,84
"7397",96,"[23]EaGxHnKqGocIHcJCtADBhyI",230,0.995671,23,231,1,230,1,1,0,1,1,115,115,116,115,84
"7398",97,"[23]EaGxHnKqGocIHcJCtADBhyI",235,0.995763,23,236,1,235,1,1,0,1,1,113,113,123,122,84
"7399",98,"[23]EaGxHnKqGocIHcJCtADBhyI",256,0.996109,23,257,1,256,1,1,0,1,1,99,99,158,157,84
"7400",99,"[23]EaGxHnKqGocIHcJCtADBhyI",233,0.995726,23,234,1,233,1,1,0,1,1,112,112,122,121,84
"7401",0,"[23]ErevHnKqGocIHcJCigIHeih",235,0.995763,23,236,1,235,1,1,0,1,1,111,111,125,124,85
"7402",1,"[23]ErevHnKqGocIHcJCigIHeih",222,0.995516,23,223,1,222,1,1,0,1,1,122,122,101,100,85
"7403",2,"[23]ErevHnKqGocIHcJCigIHeih",228,0.995633,23,229,1,228,1,1,0,1,1,117,117,112,111,85
"7404",3,"[23]ErevHnKqGocIHcJCigIHeih",239,0.995833,23,240,1,239,1,1,0,1,1,109,109,131,130,85
"7405",4,"[23]ErevHnKqGocIHcJCigIHeih",233,0.995726,23,234,1,233,1,1,0,1,1,113,113,121,120,85
"7406",5,"[23]ErevHnKqGocIHcJCigIHeih",227,0.995614,23,228,1,227,1,1,0,1,1,116,116,112,111,85
"7407",6,"[23]ErevHnKqGocIHcJCigIHeih",234,0.995745,23,235,1,234,1,1,0,1,1,114,114,121,120,85
"7408",7,"[23]ErevHnKqGocIHcJCigIHeih",229,0.995652,23,230,1,229,1,1,0,1,1,115,115,115,114,85
"7409",8,"[23]ErevHnKqGocIHcJCigIHeih",226,0.995595,23,227,1,226,1,1,0,1,1,117,117,110,109,85
"7410",9,"[23]ErevHnKqGocIHcJCigIHeih",219,0.995455,23,220,1,219,1,1,0,1,1,124,124,96,95,85
"7411",10,"[23]ErevHnKqGocIHcJCigIHeih",243,0.995902,23,244,1,243,1,1,0,1,1,106,106,138,137,85
"7412",11,"[23]ErevHnKqGocIHcJCigIHeih",231,0.99569,23,232,1,231,1,1,0,1,1,113,113,119,118,85
"7413",12,"[23]ErevHnKqGocIHcJCigIHeih",224,0.995556,23,225,1,224,1,1,0,1,1,121,121,104,103,85
"7414",13,"[23]ErevHnKqGocIHcJCigIHeih",229,0.995652,23,230,1,229,1,1,0,1,1,115,115,115,114,85
"7415",14,"[23]ErevHnKqGocIHcJCigIHeih",224,0.995556,23,225,1,224,1,1,0,1,1,120,120,105,104,85
"7416",15,"[23]ErevHnKqGocIHcJCigIHeih",225,0.995575,23,226,1,225,1,1,0,1,1,118,118,108,107,85
"7417",16,"[23]ErevHnKqGocIHcJCigIHeih",226,0.995595,23,227,1,226,1,1,0,1,1,118,118,109,108,85
"7418",17,"[23]ErevHnKqGocIHcJCigIHeih",243,0.995902,23,244,1,243,1,1,0,1,1,106,106,138,137,85
"7419",18,"[23]ErevHnKqGocIHcJCigIHeih",238,0.995816,23,239,1,238,1,1,0,1,1,112,112,127,126,85
"7420",19,"[23]ErevHnKqGocIHcJCigIHeih",231,0.99569,23,232,1,231,1,1,0,1,1,118,118,114,113,85
"7421",20,"[23]ErevHnKqGocIHcJCigIHeih",234,0.995745,23,235,1,234,1,1,0,1,1,111,111,124,123,85
"7422",21,"[23]ErevHnKqGocIHcJCigIHeih",229,0.995652,23,230,1,229,1,1,0,1,1,115,115,115,114,85
"7423",22,"[23]ErevHnKqGocIHcJCigIHeih",220,0.995475,23,221,1,220,1,1,0,1,1,122,122,99,98,85
"7424",23,"[23]ErevHnKqGocIHcJCigIHeih",226,0.995595,23,227,1,226,1,1,0,1,1,118,118,109,108,85
"7425",24,"[23]ErevHnKqGocIHcJCigIHeih",231,0.99569,23,232,1,231,1,1,0,1,1,114,114,118,117,85
"7426",25,"[23]ErevHnKqGocIHcJCigIHeih",236,0.995781,23,237,1,236,1,1,0,1,1,109,109,128,127,85
"7427",26,"[23]ErevHnKqGocIHcJCigIHeih",221,0.995495,23,222,1,221,1,1,0,1,1,121,121,101,100,85
"7428",27,"[23]ErevHnKqGocIHcJCigIHeih",231,0.99569,23,232,1,231,1,1,0,1,1,114,114,118,117,85
"7429",28,"[23]ErevHnKqGocIHcJCigIHeih",238,0.995816,23,239,1,238,1,1,0,1,1,108,108,131,130,85
"7430",29,"[23]ErevHnKqGocIHcJCigIHeih",229,0.995652,23,230,1,229,1,1,0,1,1,116,116,114,113,85
"7431",30,"[23]ErevHnKqGocIHcJCigIHeih",242,0.995885,23,243,1,242,1,1,0,1,1,108,108,135,134,85
"7432",31,"[23]ErevHnKqGocIHcJCigIHeih",227,0.995614,23,228,1,227,1,1,0,1,1,117,117,111,110,85
"7433",32,"[23]ErevHnKqGocIHcJCigIHeih",233,0.995726,23,234,1,233,1,1,0,1,1,112,112,122,121,85
"7434",33,"[23]ErevHnKqGocIHcJCigIHeih",235,0.995763,23,236,1,235,1,1,0,1,1,110,110,126,125,85
"7435",34,"[23]ErevHnKqGocIHcJCigIHeih",224,0.995556,23,225,1,224,1,1,0,1,1,120,120,105,104,85
"7436",35,"[23]ErevHnKqGocIHcJCigIHeih",244,0.995918,23,245,1,244,1,1,0,1,1,105,105,140,139,85
"7437",36,"[23]ErevHnKqGocIHcJCigIHeih",237,0.995798,23,238,1,237,1,1,0,1,1,109,109,129,128,85
"7438",37,"[23]ErevHnKqGocIHcJCigIHeih",226,0.995595,23,227,1,226,1,1,0,1,1,118,118,109,108,85
"7439",38,"[23]ErevHnKqGocIHcJCigIHeih",225,0.995575,23,226,1,225,1,1,0,1,1,123,123,103,102,85
"7440",39,"[23]ErevHnKqGocIHcJCigIHeih",234,0.995745,23,235,1,234,1,1,0,1,1,114,114,121,120,85
"7441",40,"[23]ErevHnKqGocIHcJCigIHeih",237,0.995798,23,238,1,237,1,1,0,1,1,108,108,130,129,85
"7442",41,"[23]ErevHnKqGocIHcJCigIHeih",226,0.995595,23,227,1,226,1,1,0,1,1,118,118,109,108,85
"7443",42,"[23]ErevHnKqGocIHcJCigIHeih",233,0.995726,23,234,1,233,1,1,0,1,1,112,112,122,121,85
"7444",43,"[23]ErevHnKqGocIHcJCigIHeih",232,0.995708,23,233,1,232,1,1,0,1,1,115,115,118,117,85
"7445",44,"[23]ErevHnKqGocIHcJCigIHeih",232,0.995708,23,233,1,232,1,1,0,1,1,114,114,119,118,85
"7446",45,"[23]ErevHnKqGocIHcJCigIHeih",238,0.995816,23,239,1,238,1,1,0,1,1,115,115,124,123,85
"7447",46,"[23]ErevHnKqGocIHcJCigIHeih",236,0.995781,23,237,1,236,1,1,0,1,1,109,109,128,127,85
"7448",47,"[23]ErevHnKqGocIHcJCigIHeih",240,0.995851,23,241,1,240,1,1,0,1,1,112,112,129,128,85
"7449",48,"[23]ErevHnKqGocIHcJCigIHeih",232,0.995708,23,233,1,232,1,1,0,1,1,113,113,120,119,85
"7450",49,"[23]ErevHnKqGocIHcJCigIHeih",231,0.99569,23,232,1,231,1,1,0,1,1,114,114,118,117,85
"7451",50,"[23]ErevHnKqGocIHcJCigIHeih",221,0.995495,23,222,1,221,1,1,0,1,1,123,123,99,98,85
"7452",51,"[23]ErevHnKqGocIHcJCigIHeih",231,0.99569,23,232,1,231,1,1,0,1,1,113,113,119,118,85
"7453",52,"[23]ErevHnKqGocIHcJCigIHeih",244,0.995918,23,245,1,244,1,1,0,1,1,105,105,140,139,85
"7454",53,"[23]ErevHnKqGocIHcJCigIHeih",232,0.995708,23,233,1,232,1,1,0,1,1,116,116,117,116,85
"7455",54,"[23]ErevHnKqGocIHcJCigIHeih",240,0.995851,23,241,1,240,1,1,0,1,1,108,108,133,132,85
"7456",55,"[23]ErevHnKqGocIHcJCigIHeih",239,0.995833,23,240,1,239,1,1,0,1,1,107,107,133,132,85
"7457",56,"[23]ErevHnKqGocIHcJCigIHeih",221,0.995495,23,222,1,221,1,1,0,1,1,121,121,101,100,85
"7458",57,"[23]ErevHnKqGocIHcJCigIHeih",233,0.995726,23,234,1,233,1,1,0,1,1,112,112,122,121,85
"7459",58,"[23]ErevHnKqGocIHcJCigIHeih",226,0.995595,23,227,1,226,1,1,0,1,1,117,117,110,109,85
"7460",59,"[23]ErevHnKqGocIHcJCigIHeih",223,0.995536,23,224,1,223,1,1,0,1,1,121,121,103,102,85
"7461",60,"[23]ErevHnKqGocIHcJCigIHeih",230,0.995671,23,231,1,230,1,1,0,1,1,115,115,116,115,85
"7462",61,"[23]ErevHnKqGocIHcJCigIHeih",237,0.995798,23,238,1,237,1,1,0,1,1,109,109,129,128,85
"7463",62,"[23]ErevHnKqGocIHcJCigIHeih",216,0.995392,23,217,1,216,1,1,0,1,1,126,126,91,90,85
"7464",63,"[23]ErevHnKqGocIHcJCigIHeih",226,0.995595,23,227,1,226,1,1,0,1,1,117,117,110,109,85
"7465",64,"[23]ErevHnKqGocIHcJCigIHeih",232,0.995708,23,233,1,232,1,1,0,1,1,114,114,119,118,85
"7466",65,"[23]ErevHnKqGocIHcJCigIHeih",235,0.995763,23,236,1,235,1,1,0,1,1,111,111,125,124,85
"7467",66,"[23]ErevHnKqGocIHcJCigIHeih",225,0.995575,23,226,1,225,1,1,0,1,1,118,118,108,107,85
"7468",67,"[23]ErevHnKqGocIHcJCigIHeih",228,0.995633,23,229,1,228,1,1,0,1,1,117,117,112,111,85
"7469",68,"[23]ErevHnKqGocIHcJCigIHeih",220,0.995475,23,221,1,220,1,1,0,1,1,122,122,99,98,85
"7470",69,"[23]ErevHnKqGocIHcJCigIHeih",233,0.995726,23,234,1,233,1,1,0,1,1,115,115,119,118,85
"7471",70,"[23]ErevHnKqGocIHcJCigIHeih",231,0.99569,23,232,1,231,1,1,0,1,1,114,114,118,117,85
"7472",71,"[23]ErevHnKqGocIHcJCigIHeih",224,0.995556,23,225,1,224,1,1,0,1,1,120,120,105,104,85
"7473",72,"[23]ErevHnKqGocIHcJCigIHeih",226,0.995595,23,227,1,226,1,1,0,1,1,117,117,110,109,85
"7474",73,"[23]ErevHnKqGocIHcJCigIHeih",229,0.995652,23,230,1,229,1,1,0,1,1,115,115,115,114,85
"7475",74,"[23]ErevHnKqGocIHcJCigIHeih",227,0.995614,23,228,1,227,1,1,0,1,1,116,116,112,111,85
"7476",75,"[23]ErevHnKqGocIHcJCigIHeih",233,0.995726,23,234,1,233,1,1,0,1,1,113,113,121,120,85
"7477",76,"[23]ErevHnKqGocIHcJCigIHeih",228,0.995633,23,229,1,228,1,1,0,1,1,116,116,113,112,85
"7478",77,"[23]ErevHnKqGocIHcJCigIHeih",234,0.995745,23,235,1,234,1,1,0,1,1,112,112,123,122,85
"7479",78,"[23]ErevHnKqGocIHcJCigIHeih",223,0.995536,23,224,1,223,1,1,0,1,1,120,120,104,103,85
"7480",79,"[23]ErevHnKqGocIHcJCigIHeih",234,0.995745,23,235,1,234,1,1,0,1,1,111,111,124,123,85
"7481",80,"[23]ErevHnKqGocIHcJCigIHeih",230,0.995671,23,231,1,230,1,1,0,1,1,115,115,116,115,85
"7482",81,"[23]ErevHnKqGocIHcJCigIHeih",229,0.995652,23,230,1,229,1,1,0,1,1,115,115,115,114,85
"7483",82,"[23]ErevHnKqGocIHcJCigIHeih",222,0.995516,23,223,1,222,1,1,0,1,1,121,121,102,101,85
"7484",83,"[23]ErevHnKqGocIHcJCigIHeih",227,0.995614,23,228,1,227,1,1,0,1,1,117,117,111,110,85
"7485",84,"[23]ErevHnKqGocIHcJCigIHeih",234,0.995745,23,235,1,234,1,1,0,1,1,116,116,119,118,85
"7486",85,"[23]ErevHnKqGocIHcJCigIHeih",237,0.995798,23,238,1,237,1,1,0,1,1,112,112,126,125,85
"7487",86,"[23]ErevHnKqGocIHcJCigIHeih",225,0.995575,23,226,1,225,1,1,0,1,1,119,119,107,106,85
"7488",87,"[23]ErevHnKqGocIHcJCigIHeih",225,0.995575,23,226,1,225,1,1,0,1,1,118,118,108,107,85
"7489",88,"[23]ErevHnKqGocIHcJCigIHeih",235,0.995763,23,236,1,235,1,1,0,1,1,111,111,125,124,85
"7490",89,"[23]ErevHnKqGocIHcJCigIHeih",225,0.995575,23,226,1,225,1,1,0,1,1,119,119,107,106,85
"7491",90,"[23]ErevHnKqGocIHcJCigIHeih",226,0.995595,23,227,1,226,1,1,0,1,1,119,119,108,107,85
"7492",91,"[23]ErevHnKqGocIHcJCigIHeih",236,0.995781,23,237,1,236,1,1,0,1,1,110,110,127,126,85
"7493",92,"[23]ErevHnKqGocIHcJCigIHeih",223,0.995536,23,224,1,223,1,1,0,1,1,120,120,104,103,85
"7494",93,"[23]ErevHnKqGocIHcJCigIHeih",227,0.995614,23,228,1,227,1,1,0,1,1,117,117,111,110,85
"7495",94,"[23]ErevHnKqGocIHcJCigIHeih",231,0.99569,23,232,1,231,1,1,0,1,1,115,115,117,116,85
"7496",95,"[23]ErevHnKqGocIHcJCigIHeih",233,0.995726,23,234,1,233,1,1,0,1,1,112,112,122,121,85
"7497",96,"[23]ErevHnKqGocIHcJCigIHeih",228,0.995633,23,229,1,228,1,1,0,1,1,119,119,110,109,85
"7498",97,"[23]ErevHnKqGocIHcJCigIHeih",227,0.995614,23,228,1,227,1,1,0,1,1,117,117,111,110,85
"7499",98,"[23]ErevHnKqGocIHcJCigIHeih",226,0.995595,23,227,1,226,1,1,0,1,1,120,120,107,106,85
"7500",99,"[23]ErevHnKqGocIHcJCigIHeih",232,0.995708,23,233,1,232,1,1,0,1,1,112,112,121,120,85
"7501",0,"[21]EewtguHnKqGocIHcJCsjw",239,0.995833,21,240,1,239,1,1,0,1,1,108,108,132,131,86
"7502",1,"[21]EewtguHnKqGocIHcJCsjw",232,0.995708,21,233,1,232,1,1,0,1,1,113,113,120,119,86
"7503",2,"[21]EewtguHnKqGocIHcJCsjw",225,0.995575,21,226,1,225,1,1,0,1,1,118,118,108,107,86
"7504",3,"[21]EewtguHnKqGocIHcJCsjw",224,0.995556,21,225,1,224,1,1,0,1,1,118,118,107,106,86
"7505",4,"[21]EewtguHnKqGocIHcJCsjw",226,0.995595,21,227,1,226,1,1,0,1,1,120,120,107,106,86
"7506",5,"[21]EewtguHnKqGocIHcJCsjw",228,0.995633,21,229,1,228,1,1,0,1,1,116,116,113,112,86
"7507",6,"[21]EewtguHnKqGocIHcJCsjw",247,0.995968,21,248,1,247,1,1,0,1,1,104,104,144,143,86
"7508",7,"[21]EewtguHnKqGocIHcJCsjw",232,0.995708,21,233,1,232,1,1,0,1,1,113,113,120,119,86
"7509",8,"[21]EewtguHnKqGocIHcJCsjw",236,0.995781,21,237,1,236,1,1,0,1,1,109,109,128,127,86
"7510",9,"[21]EewtguHnKqGocIHcJCsjw",222,0.995516,21,223,1,222,1,1,0,1,1,121,121,102,101,86
"7511",10,"[21]EewtguHnKqGocIHcJCsjw",222,0.995516,21,223,1,222,1,1,0,1,1,120,120,103,102,86
"7512",11,"[21]EewtguHnKqGocIHcJCsjw",222,0.995516,21,223,1,222,1,1,0,1,1,121,121,102,101,86
"7513",12,"[21]EewtguHnKqGocIHcJCsjw",232,0.995708,21,233,1,232,1,1,0,1,1,113,113,120,119,86
"7514",13,"[21]EewtguHnKqGocIHcJCsjw",223,0.995536,21,224,1,223,1,1,0,1,1,121,121,103,102,86
"7515",14,"[21]EewtguHnKqGocIHcJCsjw",229,0.995652,21,230,1,229,1,1,0,1,1,114,114,116,115,86
"7516",15,"[21]EewtguHnKqGocIHcJCsjw",232,0.995708,21,233,1,232,1,1,0,1,1,113,113,120,119,86
"7517",16,"[21]EewtguHnKqGocIHcJCsjw",224,0.995556,21,225,1,224,1,1,0,1,1,119,119,106,105,86
"7518",17,"[21]EewtguHnKqGocIHcJCsjw",225,0.995575,21,226,1,225,1,1,0,1,1,120,120,106,105,86
"7519",18,"[21]EewtguHnKqGocIHcJCsjw",237,0.995798,21,238,1,237,1,1,0,1,1,110,110,128,127,86
"7520",19,"[21]EewtguHnKqGocIHcJCsjw",222,0.995516,21,223,1,222,1,1,0,1,1,120,120,103,102,86
"7521",20,"[21]EewtguHnKqGocIHcJCsjw",227,0.995614,21,228,1,227,1,1,0,1,1,117,117,111,110,86
"7522",21,"[21]EewtguHnKqGocIHcJCsjw",226,0.995595,21,227,1,226,1,1,0,1,1,118,118,109,108,86
"7523",22,"[21]EewtguHnKqGocIHcJCsjw",233,0.995726,21,234,1,233,1,1,0,1,1,111,111,123,122,86
"7524",23,"[21]EewtguHnKqGocIHcJCsjw",232,0.995708,21,233,1,232,1,1,0,1,1,112,112,121,120,86
"7525",24,"[21]EewtguHnKqGocIHcJCsjw",224,0.995556,21,225,1,224,1,1,0,1,1,118,118,107,106,86
"7526",25,"[21]EewtguHnKqGocIHcJCsjw",227,0.995614,21,228,1,227,1,1,0,1,1,116,116,112,111,86
"7527",26,"[21]EewtguHnKqGocIHcJCsjw",228,0.995633,21,229,1,228,1,1,0,1,1,115,115,114,113,86
"7528",27,"[21]EewtguHnKqGocIHcJCsjw",224,0.995556,21,225,1,224,1,1,0,1,1,118,118,107,106,86
"7529",28,"[21]EewtguHnKqGocIHcJCsjw",228,0.995633,21,229,1,228,1,1,0,1,1,118,118,111,110,86
"7530",29,"[21]EewtguHnKqGocIHcJCsjw",237,0.995798,21,238,1,237,1,1,0,1,1,108,108,130,129,86
"7531",30,"[21]EewtguHnKqGocIHcJCsjw",230,0.995671,21,231,1,230,1,1,0,1,1,115,115,116,115,86
"7532",31,"[21]EewtguHnKqGocIHcJCsjw",224,0.995556,21,225,1,224,1,1,0,1,1,118,118,107,106,86
"7533",32,"[21]EewtguHnKqGocIHcJCsjw",215,0.99537,21,216,1,215,1,1,0,1,1,126,126,90,89,86
"7534",33,"[21]EewtguHnKqGocIHcJCsjw",229,0.995652,21,230,1,229,1,1,0,1,1,116,116,114,113,86
"7535",34,"[21]EewtguHnKqGocIHcJCsjw",236,0.995781,21,237,1,236,1,1,0,1,1,110,110,127,126,86
"7536",35,"[21]EewtguHnKqGocIHcJCsjw",240,0.995851,21,241,1,240,1,1,0,1,1,111,111,130,129,86
"7537",36,"[21]EewtguHnKqGocIHcJCsjw",225,0.995575,21,226,1,225,1,1,0,1,1,118,118,108,107,86
"7538",37,"[21]EewtguHnKqGocIHcJCsjw",234,0.995745,21,235,1,234,1,1,0,1,1,112,112,123,122,86
"7539",38,"[21]EewtguHnKqGocIHcJCsjw",226,0.995595,21,227,1,226,1,1,0,1,1,117,117,110,109,86
"7540",39,"[21]EewtguHnKqGocIHcJCsjw",225,0.995575,21,226,1,225,1,1,0,1,1,125,125,101,100,86
"7541",40,"[21]EewtguHnKqGocIHcJCsjw",229,0.995652,21,230,1,229,1,1,0,1,1,114,114,116,115,86
"7542",41,"[21]EewtguHnKqGocIHcJCsjw",229,0.995652,21,230,1,229,1,1,0,1,1,115,115,115,114,86
"7543",42,"[21]EewtguHnKqGocIHcJCsjw",229,0.995652,21,230,1,229,1,1,0,1,1,114,114,116,115,86
"7544",43,"[21]EewtguHnKqGocIHcJCsjw",230,0.995671,21,231,1,230,1,1,0,1,1,114,114,117,116,86
"7545",44,"[21]EewtguHnKqGocIHcJCsjw",227,0.995614,21,228,1,227,1,1,0,1,1,117,117,111,110,86
"7546",45,"[21]EewtguHnKqGocIHcJCsjw",231,0.99569,21,232,1,231,1,1,0,1,1,114,114,118,117,86
"7547",46,"[21]EewtguHnKqGocIHcJCsjw",231,0.99569,21,232,1,231,1,1,0,1,1,115,115,117,116,86
"7548",47,"[21]EewtguHnKqGocIHcJCsjw",225,0.995575,21,226,1,225,1,1,0,1,1,119,119,107,106,86
"7549",48,"[21]EewtguHnKqGocIHcJCsjw",230,0.995671,21,231,1,230,1,1,0,1,1,117,117,114,113,86
"7550",49,"[21]EewtguHnKqGocIHcJCsjw",231,0.99569,21,232,1,231,1,1,0,1,1,113,113,119,118,86
"7551",50,"[21]EewtguHnKqGocIHcJCsjw",227,0.995614,21,228,1,227,1,1,0,1,1,120,120,108,107,86
"7552",51,"[21]EewtguHnKqGocIHcJCsjw",226,0.995595,21,227,1,226,1,1,0,1,1,118,118,109,108,86
"7553",52,"[21]EewtguHnKqGocIHcJCsjw",236,0.995781,21,237,1,236,1,1,0,1,1,110,110,127,126,86
"7554",53,"[21]EewtguHnKqGocIHcJCsjw",233,0.995726,21,234,1,233,1,1,0,1,1,113,113,121,120,86
"7555",54,"[21]EewtguHnKqGocIHcJCsjw",233,0.995726,21,234,1,233,1,1,0,1,1,112,112,122,121,86
"7556",55,"[21]EewtguHnKqGocIHcJCsjw",231,0.99569,21,232,1,231,1,1,0,1,1,114,114,118,117,86
"7557",56,"[21]EewtguHnKqGocIHcJCsjw",227,0.995614,21,228,1,227,1,1,0,1,1,118,118,110,109,86
"7558",57,"[21]EewtguHnKqGocIHcJCsjw",226,0.995595,21,227,1,226,1,1,0,1,1,117,117,110,109,86
"7559",58,"[21]EewtguHnKqGocIHcJCsjw",221,0.995495,21,222,1,221,1,1,0,1,1,121,121,101,100,86
"7560",59,"[21]EewtguHnKqGocIHcJCsjw",234,0.995745,21,235,1,234,1,1,0,1,1,110,110,125,124,86
"7561",60,"[21]EewtguHnKqGocIHcJCsjw",223,0.995536,21,224,1,223,1,1,0,1,1,119,119,105,104,86
"7562",61,"[21]EewtguHnKqGocIHcJCsjw",229,0.995652,21,230,1,229,1,1,0,1,1,115,115,115,114,86
"7563",62,"[21]EewtguHnKqGocIHcJCsjw",227,0.995614,21,228,1,227,1,1,0,1,1,117,117,111,110,86
"7564",63,"[21]EewtguHnKqGocIHcJCsjw",230,0.995671,21,231,1,230,1,1,0,1,1,116,116,115,114,86
"7565",64,"[21]EewtguHnKqGocIHcJCsjw",229,0.995652,21,230,1,229,1,1,0,1,1,115,115,115,114,86
"7566",65,"[21]EewtguHnKqGocIHcJCsjw",228,0.995633,21,229,1,228,1,1,0,1,1,119,119,110,109,86
"7567",66,"[21]EewtguHnKqGocIHcJCsjw",227,0.995614,21,228,1,227,1,1,0,1,1,117,117,111,110,86
"7568",67,"[21]EewtguHnKqGocIHcJCsjw",223,0.995536,21,224,1,223,1,1,0,1,1,119,119,105,104,86
"7569",68,"[21]EewtguHnKqGocIHcJCsjw",234,0.995745,21,235,1,234,1,1,0,1,1,110,110,125,124,86
"7570",69,"[21]EewtguHnKqGocIHcJCsjw",225,0.995575,21,226,1,225,1,1,0,1,1,120,120,106,105,86
"7571",70,"[21]EewtguHnKqGocIHcJCsjw",224,0.995556,21,225,1,224,1,1,0,1,1,119,119,106,105,86
"7572",71,"[21]EewtguHnKqGocIHcJCsjw",223,0.995536,21,224,1,223,1,1,0,1,1,119,119,105,104,86
"7573",72,"[21]EewtguHnKqGocIHcJCsjw",227,0.995614,21,228,1,227,1,1,0,1,1,117,117,111,110,86
"7574",73,"[21]EewtguHnKqGocIHcJCsjw",231,0.99569,21,232,1,231,1,1,0,1,1,114,114,118,117,86
"7575",74,"[21]EewtguHnKqGocIHcJCsjw",226,0.995595,21,227,1,226,1,1,0,1,1,117,117,110,109,86
"7576",75,"[21]EewtguHnKqGocIHcJCsjw",226,0.995595,21,227,1,226,1,1,0,1,1,117,117,110,109,86
"7577",76,"[21]EewtguHnKqGocIHcJCsjw",229,0.995652,21,230,1,229,1,1,0,1,1,115,115,115,114,86
"7578",77,"[21]EewtguHnKqGocIHcJCsjw",235,0.995763,21,236,1,235,1,1,0,1,1,111,111,125,124,86
"7579",78,"[21]EewtguHnKqGocIHcJCsjw",233,0.995726,21,234,1,233,1,1,0,1,1,111,111,123,122,86
"7580",79,"[21]EewtguHnKqGocIHcJCsjw",219,0.995455,21,220,1,219,1,1,0,1,1,122,122,98,97,86
"7581",80,"[21]EewtguHnKqGocIHcJCsjw",228,0.995633,21,229,1,228,1,1,0,1,1,115,115,114,113,86
"7582",81,"[21]EewtguHnKqGocIHcJCsjw",227,0.995614,21,228,1,227,1,1,0,1,1,116,116,112,111,86
"7583",82,"[21]EewtguHnKqGocIHcJCsjw",233,0.995726,21,234,1,233,1,1,0,1,1,111,111,123,122,86
"7584",83,"[21]EewtguHnKqGocIHcJCsjw",233,0.995726,21,234,1,233,1,1,0,1,1,112,112,122,121,86
"7585",84,"[21]EewtguHnKqGocIHcJCsjw",224,0.995556,21,225,1,224,1,1,0,1,1,121,121,104,103,86
"7586",85,"[21]EewtguHnKqGocIHcJCsjw",222,0.995516,21,223,1,222,1,1,0,1,1,120,120,103,102,86
"7587",86,"[21]EewtguHnKqGocIHcJCsjw",229,0.995652,21,230,1,229,1,1,0,1,1,116,116,114,113,86
"7588",87,"[21]EewtguHnKqGocIHcJCsjw",234,0.995745,21,235,1,234,1,1,0,1,1,110,110,125,124,86
"7589",88,"[21]EewtguHnKqGocIHcJCsjw",228,0.995633,21,229,1,228,1,1,0,1,1,116,116,113,112,86
"7590",89,"[21]EewtguHnKqGocIHcJCsjw",233,0.995726,21,234,1,233,1,1,0,1,1,112,112,122,121,86
"7591",90,"[21]EewtguHnKqGocIHcJCsjw",237,0.995798,21,238,1,237,1,1,0,1,1,109,109,129,128,86
"7592",91,"[21]EewtguHnKqGocIHcJCsjw",228,0.995633,21,229,1,228,1,1,0,1,1,116,116,113,112,86
"7593",92,"[21]EewtguHnKqGocIHcJCsjw",231,0.99569,21,232,1,231,1,1,0,1,1,115,115,117,116,86
"7594",93,"[21]EewtguHnKqGocIHcJCsjw",232,0.995708,21,233,1,232,1,1,0,1,1,114,114,119,118,86
"7595",94,"[21]EewtguHnKqGocIHcJCsjw",231,0.99569,21,232,1,231,1,1,0,1,1,113,113,119,118,86
"7596",95,"[21]EewtguHnKqGocIHcJCsjw",227,0.995614,21,228,1,227,1,1,0,1,1,117,117,111,110,86
"7597",96,"[21]EewtguHnKqGocIHcJCsjw",232,0.995708,21,233,1,232,1,1,0,1,1,113,113,120,119,86
"7598",97,"[21]EewtguHnKqGocIHcJCsjw",230,0.995671,21,231,1,230,1,1,0,1,1,114,114,117,116,86
"7599",98,"[21]EewtguHnKqGocIHcJCsjw",242,0.995885,21,243,1,242,1,1,0,1,1,108,108,135,134,86
"7600",99,"[21]EewtguHnKqGocIHcJCsjw",225,0.995575,21,226,1,225,1,1,0,1,1,118,118,108,107,86
"7601",0,"[26]EDKnavHnKqGocIHcJCDtHndEFj",231,0.99569,26,232,1,231,1,1,0,1,1,114,114,118,117,87
"7602",1,"[26]EDKnavHnKqGocIHcJCDtHndEFj",231,0.99569,26,232,1,231,1,1,0,1,1,117,117,115,114,87
"7603",2,"[26]EDKnavHnKqGocIHcJCDtHndEFj",240,0.995851,26,241,1,240,1,1,0,1,1,108,108,133,132,87
"7604",3,"[26]EDKnavHnKqGocIHcJCDtHndEFj",232,0.995708,26,233,1,232,1,1,0,1,1,112,112,121,120,87
"7605",4,"[26]EDKnavHnKqGocIHcJCDtHndEFj",226,0.995595,26,227,1,226,1,1,0,1,1,121,121,106,105,87
"7606",5,"[26]EDKnavHnKqGocIHcJCDtHndEFj",233,0.995726,26,234,1,233,1,1,0,1,1,113,113,121,120,87
"7607",6,"[26]EDKnavHnKqGocIHcJCDtHndEFj",221,0.995495,26,222,1,221,1,1,0,1,1,121,121,101,100,87
"7608",7,"[26]EDKnavHnKqGocIHcJCDtHndEFj",228,0.995633,26,229,1,228,1,1,0,1,1,116,116,113,112,87
"7609",8,"[26]EDKnavHnKqGocIHcJCDtHndEFj",237,0.995798,26,238,1,237,1,1,0,1,1,111,111,127,126,87
"7610",9,"[26]EDKnavHnKqGocIHcJCDtHndEFj",224,0.995556,26,225,1,224,1,1,0,1,1,119,119,106,105,87
"7611",10,"[26]EDKnavHnKqGocIHcJCDtHndEFj",229,0.995652,26,230,1,229,1,1,0,1,1,115,115,115,114,87
"7612",11,"[26]EDKnavHnKqGocIHcJCDtHndEFj",222,0.995516,26,223,1,222,1,1,0,1,1,121,121,102,101,87
"7613",12,"[26]EDKnavHnKqGocIHcJCDtHndEFj",235,0.995763,26,236,1,235,1,1,0,1,1,110,110,126,125,87
"7614",13,"[26]EDKnavHnKqGocIHcJCDtHndEFj",234,0.995745,26,235,1,234,1,1,0,1,1,111,111,124,123,87
"7615",14,"[26]EDKnavHnKqGocIHcJCDtHndEFj",240,0.995851,26,241,1,240,1,1,0,1,1,108,108,133,132,87
"7616",15,"[26]EDKnavHnKqGocIHcJCDtHndEFj",232,0.995708,26,233,1,232,1,1,0,1,1,112,112,121,120,87
"7617",16,"[26]EDKnavHnKqGocIHcJCDtHndEFj",246,0.995951,26,247,1,246,1,1,0,1,1,105,105,142,141,87
"7618",17,"[26]EDKnavHnKqGocIHcJCDtHndEFj",227,0.995614,26,228,1,227,1,1,0,1,1,116,116,112,111,87
"7619",18,"[26]EDKnavHnKqGocIHcJCDtHndEFj",230,0.995671,26,231,1,230,1,1,0,1,1,114,114,117,116,87
"7620",19,"[26]EDKnavHnKqGocIHcJCDtHndEFj",233,0.995726,26,234,1,233,1,1,0,1,1,112,112,122,121,87
"7621",20,"[26]EDKnavHnKqGocIHcJCDtHndEFj",226,0.995595,26,227,1,226,1,1,0,1,1,118,118,109,108,87
"7622",21,"[26]EDKnavHnKqGocIHcJCDtHndEFj",233,0.995726,26,234,1,233,1,1,0,1,1,112,112,122,121,87
"7623",22,"[26]EDKnavHnKqGocIHcJCDtHndEFj",229,0.995652,26,230,1,229,1,1,0,1,1,116,116,114,113,87
"7624",23,"[26]EDKnavHnKqGocIHcJCDtHndEFj",229,0.995652,26,230,1,229,1,1,0,1,1,116,116,114,113,87
"7625",24,"[26]EDKnavHnKqGocIHcJCDtHndEFj",236,0.995781,26,237,1,236,1,1,0,1,1,110,110,127,126,87
"7626",25,"[26]EDKnavHnKqGocIHcJCDtHndEFj",232,0.995708,26,233,1,232,1,1,0,1,1,113,113,120,119,87
"7627",26,"[26]EDKnavHnKqGocIHcJCDtHndEFj",229,0.995652,26,230,1,229,1,1,0,1,1,116,116,114,113,87
"7628",27,"[26]EDKnavHnKqGocIHcJCDtHndEFj",239,0.995833,26,240,1,239,1,1,0,1,1,108,108,132,131,87
"7629",28,"[26]EDKnavHnKqGocIHcJCDtHndEFj",225,0.995575,26,226,1,225,1,1,0,1,1,119,119,107,106,87
"7630",29,"[26]EDKnavHnKqGocIHcJCDtHndEFj",240,0.995851,26,241,1,240,1,1,0,1,1,106,106,135,134,87
"7631",30,"[26]EDKnavHnKqGocIHcJCDtHndEFj",237,0.995798,26,238,1,237,1,1,0,1,1,109,109,129,128,87
"7632",31,"[26]EDKnavHnKqGocIHcJCDtHndEFj",233,0.995726,26,234,1,233,1,1,0,1,1,115,115,119,118,87
"7633",32,"[26]EDKnavHnKqGocIHcJCDtHndEFj",223,0.995536,26,224,1,223,1,1,0,1,1,120,120,104,103,87
"7634",33,"[26]EDKnavHnKqGocIHcJCDtHndEFj",237,0.995798,26,238,1,237,1,1,0,1,1,111,111,127,126,87
"7635",34,"[26]EDKnavHnKqGocIHcJCDtHndEFj",225,0.995575,26,226,1,225,1,1,0,1,1,119,119,107,106,87
"7636",35,"[26]EDKnavHnKqGocIHcJCDtHndEFj",226,0.995595,26,227,1,226,1,1,0,1,1,124,124,103,102,87
"7637",36,"[26]EDKnavHnKqGocIHcJCDtHndEFj",230,0.995671,26,231,1,230,1,1,0,1,1,116,116,115,114,87
"7638",37,"[26]EDKnavHnKqGocIHcJCDtHndEFj",221,0.995495,26,222,1,221,1,1,0,1,1,121,121,101,100,87
"7639",38,"[26]EDKnavHnKqGocIHcJCDtHndEFj",242,0.995885,26,243,1,242,1,1,0,1,1,104,104,139,138,87
"7640",39,"[26]EDKnavHnKqGocIHcJCDtHndEFj",228,0.995633,26,229,1,228,1,1,0,1,1,118,118,111,110,87
"7641",40,"[26]EDKnavHnKqGocIHcJCDtHndEFj",235,0.995763,26,236,1,235,1,1,0,1,1,111,111,125,124,87
"7642",41,"[26]EDKnavHnKqGocIHcJCDtHndEFj",233,0.995726,26,234,1,233,1,1,0,1,1,118,118,116,115,87
"7643",42,"[26]EDKnavHnKqGocIHcJCDtHndEFj",225,0.995575,26,226,1,225,1,1,0,1,1,119,119,107,106,87
"7644",43,"[26]EDKnavHnKqGocIHcJCDtHndEFj",226,0.995595,26,227,1,226,1,1,0,1,1,117,117,110,109,87
"7645",44,"[26]EDKnavHnKqGocIHcJCDtHndEFj",242,0.995885,26,243,1,242,1,1,0,1,1,106,106,137,136,87
"7646",45,"[26]EDKnavHnKqGocIHcJCDtHndEFj",229,0.995652,26,230,1,229,1,1,0,1,1,117,117,113,112,87
"7647",46,"[26]EDKnavHnKqGocIHcJCDtHndEFj",229,0.995652,26,230,1,229,1,1,0,1,1,115,115,115,114,87
"7648",47,"[26]EDKnavHnKqGocIHcJCDtHndEFj",234,0.995745,26,235,1,234,1,1,0,1,1,111,111,124,123,87
"7649",48,"[26]EDKnavHnKqGocIHcJCDtHndEFj",231,0.99569,26,232,1,231,1,1,0,1,1,116,116,116,115,87
"7650",49,"[26]EDKnavHnKqGocIHcJCDtHndEFj",231,0.99569,26,232,1,231,1,1,0,1,1,113,113,119,118,87
"7651",50,"[26]EDKnavHnKqGocIHcJCDtHndEFj",236,0.995781,26,237,1,236,1,1,0,1,1,110,110,127,126,87
"7652",51,"[26]EDKnavHnKqGocIHcJCDtHndEFj",234,0.995745,26,235,1,234,1,1,0,1,1,112,112,123,122,87
"7653",52,"[26]EDKnavHnKqGocIHcJCDtHndEFj",236,0.995781,26,237,1,236,1,1,0,1,1,110,110,127,126,87
"7654",53,"[26]EDKnavHnKqGocIHcJCDtHndEFj",232,0.995708,26,233,1,232,1,1,0,1,1,113,113,120,119,87
"7655",54,"[26]EDKnavHnKqGocIHcJCDtHndEFj",224,0.995556,26,225,1,224,1,1,0,1,1,122,122,103,102,87
"7656",55,"[26]EDKnavHnKqGocIHcJCDtHndEFj",222,0.995516,26,223,1,222,1,1,0,1,1,120,120,103,102,87
"7657",56,"[26]EDKnavHnKqGocIHcJCDtHndEFj",239,0.995833,26,240,1,239,1,1,0,1,1,107,107,133,132,87
"7658",57,"[26]EDKnavHnKqGocIHcJCDtHndEFj",229,0.995652,26,230,1,229,1,1,0,1,1,118,118,112,111,87
"7659",58,"[26]EDKnavHnKqGocIHcJCDtHndEFj",235,0.995763,26,236,1,235,1,1,0,1,1,111,111,125,124,87
"7660",59,"[26]EDKnavHnKqGocIHcJCDtHndEFj",221,0.995495,26,222,1,221,1,1,0,1,1,124,124,98,97,87
"7661",60,"[26]EDKnavHnKqGocIHcJCDtHndEFj",233,0.995726,26,234,1,233,1,1,0,1,1,113,113,121,120,87
"7662",61,"[26]EDKnavHnKqGocIHcJCDtHndEFj",236,0.995781,26,237,1,236,1,1,0,1,1,109,109,128,127,87
"7663",62,"[26]EDKnavHnKqGocIHcJCDtHndEFj",234,0.995745,26,235,1,234,1,1,0,1,1,112,112,123,122,87
"7664",63,"[26]EDKnavHnKqGocIHcJCDtHndEFj",237,0.995798,26,238,1,237,1,1,0,1,1,110,110,128,127,87
"7665",64,"[26]EDKnavHnKqGocIHcJCDtHndEFj",235,0.995763,26,236,1,235,1,1,0,1,1,110,110,126,125,87
"7666",65,"[26]EDKnavHnKqGocIHcJCDtHndEFj",230,0.995671,26,231,1,230,1,1,0,1,1,114,114,117,116,87
"7667",66,"[26]EDKnavHnKqGocIHcJCDtHndEFj",240,0.995851,26,241,1,240,1,1,0,1,1,107,107,134,133,87
"7668",67,"[26]EDKnavHnKqGocIHcJCDtHndEFj",225,0.995575,26,226,1,225,1,1,0,1,1,119,119,107,106,87
"7669",68,"[26]EDKnavHnKqGocIHcJCDtHndEFj",235,0.995763,26,236,1,235,1,1,0,1,1,111,111,125,124,87
"7670",69,"[26]EDKnavHnKqGocIHcJCDtHndEFj",236,0.995781,26,237,1,236,1,1,0,1,1,111,111,126,125,87
"7671",70,"[26]EDKnavHnKqGocIHcJCDtHndEFj",234,0.995745,26,235,1,234,1,1,0,1,1,114,114,121,120,87
"7672",71,"[26]EDKnavHnKqGocIHcJCDtHndEFj",230,0.995671,26,231,1,230,1,1,0,1,1,114,114,117,116,87
"7673",72,"[26]EDKnavHnKqGocIHcJCDtHndEFj",233,0.995726,26,234,1,233,1,1,0,1,1,114,114,120,119,87
"7674",73,"[26]EDKnavHnKqGocIHcJCDtHndEFj",222,0.995516,26,223,1,222,1,1,0,1,1,120,120,103,102,87
"7675",74,"[26]EDKnavHnKqGocIHcJCDtHndEFj",232,0.995708,26,233,1,232,1,1,0,1,1,112,112,121,120,87
"7676",75,"[26]EDKnavHnKqGocIHcJCDtHndEFj",233,0.995726,26,234,1,233,1,1,0,1,1,112,112,122,121,87
"7677",76,"[26]EDKnavHnKqGocIHcJCDtHndEFj",229,0.995652,26,230,1,229,1,1,0,1,1,116,116,114,113,87
"7678",77,"[26]EDKnavHnKqGocIHcJCDtHndEFj",242,0.995885,26,243,1,242,1,1,0,1,1,104,104,139,138,87
"7679",78,"[26]EDKnavHnKqGocIHcJCDtHndEFj",240,0.995851,26,241,1,240,1,1,0,1,1,110,110,131,130,87
"7680",79,"[26]EDKnavHnKqGocIHcJCDtHndEFj",236,0.995781,26,237,1,236,1,1,0,1,1,109,109,128,127,87
"7681",80,"[26]EDKnavHnKqGocIHcJCDtHndEFj",227,0.995614,26,228,1,227,1,1,0,1,1,117,117,111,110,87
"7682",81,"[26]EDKnavHnKqGocIHcJCDtHndEFj",224,0.995556,26,225,1,224,1,1,0,1,1,120,120,105,104,87
"7683",82,"[26]EDKnavHnKqGocIHcJCDtHndEFj",235,0.995763,26,236,1,235,1,1,0,1,1,111,111,125,124,87
"7684",83,"[26]EDKnavHnKqGocIHcJCDtHndEFj",219,0.995455,26,220,1,219,1,1,0,1,1,124,124,96,95,87
"7685",84,"[26]EDKnavHnKqGocIHcJCDtHndEFj",225,0.995575,26,226,1,225,1,1,0,1,1,118,118,108,107,87
"7686",85,"[26]EDKnavHnKqGocIHcJCDtHndEFj",246,0.995951,26,247,1,246,1,1,0,1,1,101,101,146,145,87
"7687",86,"[26]EDKnavHnKqGocIHcJCDtHndEFj",234,0.995745,26,235,1,234,1,1,0,1,1,111,111,124,123,87
"7688",87,"[26]EDKnavHnKqGocIHcJCDtHndEFj",220,0.995475,26,221,1,220,1,1,0,1,1,122,122,99,98,87
"7689",88,"[26]EDKnavHnKqGocIHcJCDtHndEFj",238,0.995816,26,239,1,238,1,1,0,1,1,112,112,127,126,87
"7690",89,"[26]EDKnavHnKqGocIHcJCDtHndEFj",234,0.995745,26,235,1,234,1,1,0,1,1,112,112,123,122,87
"7691",90,"[26]EDKnavHnKqGocIHcJCDtHndEFj",231,0.99569,26,232,1,231,1,1,0,1,1,113,113,119,118,87
"7692",91,"[26]EDKnavHnKqGocIHcJCDtHndEFj",223,0.995536,26,224,1,223,1,1,0,1,1,121,121,103,102,87
"7693",92,"[26]EDKnavHnKqGocIHcJCDtHndEFj",238,0.995816,26,239,1,238,1,1,0,1,1,108,108,131,130,87
"7694",93,"[26]EDKnavHnKqGocIHcJCDtHndEFj",230,0.995671,26,231,1,230,1,1,0,1,1,114,114,117,116,87
"7695",94,"[26]EDKnavHnKqGocIHcJCDtHndEFj",238,0.995816,26,239,1,238,1,1,0,1,1,109,109,130,129,87
"7696",95,"[26]EDKnavHnKqGocIHcJCDtHndEFj",227,0.995614,26,228,1,227,1,1,0,1,1,118,118,110,109,87
"7697",96,"[26]EDKnavHnKqGocIHcJCDtHndEFj",222,0.995516,26,223,1,222,1,1,0,1,1,120,120,103,102,87
"7698",97,"[26]EDKnavHnKqGocIHcJCDtHndEFj",232,0.995708,26,233,1,232,1,1,0,1,1,114,114,119,118,87
"7699",98,"[26]EDKnavHnKqGocIHcJCDtHndEFj",233,0.995726,26,234,1,233,1,1,0,1,1,113,113,121,120,87
"7700",99,"[26]EDKnavHnKqGocIHcJCDtHndEFj",236,0.995781,26,237,1,236,1,1,0,1,1,111,111,126,125,87
"7701",0,"[35]ExCfnwHnKqGocIHBJCvhulFBtwnwxoGwxmd",228,0.995633,35,229,1,228,1,1,0,1,1,116,116,113,112,88
"7702",1,"[35]ExCfnwHnKqGocIHBJCvhulFBtwnwxoGwxmd",226,0.995595,35,227,1,226,1,1,0,1,1,117,117,110,109,88
"7703",2,"[35]ExCfnwHnKqGocIHBJCvhulFBtwnwxoGwxmd",233,0.995726,35,234,1,233,1,1,0,1,1,112,112,122,121,88
"7704",3,"[35]ExCfnwHnKqGocIHBJCvhulFBtwnwxoGwxmd",243,0.995902,35,244,1,243,1,1,0,1,1,104,104,140,139,88
"7705",4,"[35]ExCfnwHnKqGocIHBJCvhulFBtwnwxoGwxmd",229,0.995652,35,230,1,229,1,1,0,1,1,114,114,116,115,88
"7706",5,"[35]ExCfnwHnKqGocIHBJCvhulFBtwnwxoGwxmd",225,0.995575,35,226,1,225,1,1,0,1,1,118,118,108,107,88
"7707",6,"[35]ExCfnwHnKqGocIHBJCvhulFBtwnwxoGwxmd",224,0.995556,35,225,1,224,1,1,0,1,1,119,119,106,105,88
"7708",7,"[35]ExCfnwHnKqGocIHBJCvhulFBtwnwxoGwxmd",225,0.995575,35,226,1,225,1,1,0,1,1,119,119,107,106,88
"7709",8,"[35]ExCfnwHnKqGocIHBJCvhulFBtwnwxoGwxmd",221,0.995495,35,222,1,221,1,1,0,1,1,121,121,101,100,88
"7710",9,"[35]ExCfnwHnKqGocIHBJCvhulFBtwnwxoGwxmd",223,0.995536,35,224,1,223,1,1,0,1,1,119,119,105,104,88
"7711",10,"[35]ExCfnwHnKqGocIHBJCvhulFBtwnwxoGwxmd",229,0.995652,35,230,1,229,1,1,0,1,1,117,117,113,112,88
"7712",11,"[35]ExCfnwHnKqGocIHBJCvhulFBtwnwxoGwxmd",233,0.995726,35,234,1,233,1,1,0,1,1,113,113,121,120,88
"7713",12,"[35]ExCfnwHnKqGocIHBJCvhulFBtwnwxoGwxmd",229,0.995652,35,230,1,229,1,1,0,1,1,116,116,114,113,88
"7714",13,"[35]ExCfnwHnKqGocIHBJCvhulFBtwnwxoGwxmd",236,0.995781,35,237,1,236,1,1,0,1,1,109,109,128,127,88
"7715",14,"[35]ExCfnwHnKqGocIHBJCvhulFBtwnwxoGwxmd",236,0.995781,35,237,1,236,1,1,0,1,1,112,112,125,124,88
"7716",15,"[35]ExCfnwHnKqGocIHBJCvhulFBtwnwxoGwxmd",231,0.99569,35,232,1,231,1,1,0,1,1,113,113,119,118,88
"7717",16,"[35]ExCfnwHnKqGocIHBJCvhulFBtwnwxoGwxmd",236,0.995781,35,237,1,236,1,1,0,1,1,109,109,128,127,88
"7718",17,"[35]ExCfnwHnKqGocIHBJCvhulFBtwnwxoGwxmd",233,0.995726,35,234,1,233,1,1,0,1,1,112,112,122,121,88
"7719",18,"[35]ExCfnwHnKqGocIHBJCvhulFBtwnwxoGwxmd",237,0.995798,35,238,1,237,1,1,0,1,1,110,110,128,127,88
"7720",19,"[35]ExCfnwHnKqGocIHBJCvhulFBtwnwxoGwxmd",232,0.995708,35,233,1,232,1,1,0,1,1,114,114,119,118,88
"7721",20,"[35]ExCfnwHnKqGocIHBJCvhulFBtwnwxoGwxmd",232,0.995708,35,233,1,232,1,1,0,1,1,114,114,119,118,88
"7722",21,"[35]ExCfnwHnKqGocIHBJCvhulFBtwnwxoGwxmd",226,0.995595,35,227,1,226,1,1,0,1,1,117,117,110,109,88
"7723",22,"[35]ExCfnwHnKqGocIHBJCvhulFBtwnwxoGwxmd",222,0.995516,35,223,1,222,1,1,0,1,1,120,120,103,102,88
"7724",23,"[35]ExCfnwHnKqGocIHBJCvhulFBtwnwxoGwxmd",227,0.995614,35,228,1,227,1,1,0,1,1,116,116,112,111,88
"7725",24,"[35]ExCfnwHnKqGocIHBJCvhulFBtwnwxoGwxmd",224,0.995556,35,225,1,224,1,1,0,1,1,119,119,106,105,88
"7726",25,"[35]ExCfnwHnKqGocIHBJCvhulFBtwnwxoGwxmd",232,0.995708,35,233,1,232,1,1,0,1,1,113,113,120,119,88
"7727",26,"[35]ExCfnwHnKqGocIHBJCvhulFBtwnwxoGwxmd",231,0.99569,35,232,1,231,1,1,0,1,1,114,114,118,117,88
"7728",27,"[35]ExCfnwHnKqGocIHBJCvhulFBtwnwxoGwxmd",227,0.995614,35,228,1,227,1,1,0,1,1,118,118,110,109,88
"7729",28,"[35]ExCfnwHnKqGocIHBJCvhulFBtwnwxoGwxmd",238,0.995816,35,239,1,238,1,1,0,1,1,107,107,132,131,88
"7730",29,"[35]ExCfnwHnKqGocIHBJCvhulFBtwnwxoGwxmd",229,0.995652,35,230,1,229,1,1,0,1,1,115,115,115,114,88
"7731",30,"[35]ExCfnwHnKqGocIHBJCvhulFBtwnwxoGwxmd",229,0.995652,35,230,1,229,1,1,0,1,1,114,114,116,115,88
"7732",31,"[35]ExCfnwHnKqGocIHBJCvhulFBtwnwxoGwxmd",242,0.995885,35,243,1,242,1,1,0,1,1,110,110,133,132,88
"7733",32,"[35]ExCfnwHnKqGocIHBJCvhulFBtwnwxoGwxmd",226,0.995595,35,227,1,226,1,1,0,1,1,118,118,109,108,88
"7734",33,"[35]ExCfnwHnKqGocIHBJCvhulFBtwnwxoGwxmd",223,0.995536,35,224,1,223,1,1,0,1,1,119,119,105,104,88
"7735",34,"[35]ExCfnwHnKqGocIHBJCvhulFBtwnwxoGwxmd",234,0.995745,35,235,1,234,1,1,0,1,1,111,111,124,123,88
"7736",35,"[35]ExCfnwHnKqGocIHBJCvhulFBtwnwxoGwxmd",231,0.99569,35,232,1,231,1,1,0,1,1,114,114,118,117,88
"7737",36,"[35]ExCfnwHnKqGocIHBJCvhulFBtwnwxoGwxmd",233,0.995726,35,234,1,233,1,1,0,1,1,112,112,122,121,88
"7738",37,"[35]ExCfnwHnKqGocIHBJCvhulFBtwnwxoGwxmd",222,0.995516,35,223,1,222,1,1,0,1,1,120,120,103,102,88
"7739",38,"[35]ExCfnwHnKqGocIHBJCvhulFBtwnwxoGwxmd",246,0.995951,35,247,1,246,1,1,0,1,1,101,101,146,145,88
"7740",39,"[35]ExCfnwHnKqGocIHBJCvhulFBtwnwxoGwxmd",229,0.995652,35,230,1,229,1,1,0,1,1,116,116,114,113,88
"7741",40,"[35]ExCfnwHnKqGocIHBJCvhulFBtwnwxoGwxmd",238,0.995816,35,239,1,238,1,1,0,1,1,110,110,129,128,88
"7742",41,"[35]ExCfnwHnKqGocIHBJCvhulFBtwnwxoGwxmd",233,0.995726,35,234,1,233,1,1,0,1,1,111,111,123,122,88
"7743",42,"[35]ExCfnwHnKqGocIHBJCvhulFBtwnwxoGwxmd",229,0.995652,35,230,1,229,1,1,0,1,1,114,114,116,115,88
"7744",43,"[35]ExCfnwHnKqGocIHBJCvhulFBtwnwxoGwxmd",219,0.995455,35,220,1,219,1,1,0,1,1,122,122,98,97,88
"7745",44,"[35]ExCfnwHnKqGocIHBJCvhulFBtwnwxoGwxmd",237,0.995798,35,238,1,237,1,1,0,1,1,108,108,130,129,88
"7746",45,"[35]ExCfnwHnKqGocIHBJCvhulFBtwnwxoGwxmd",231,0.99569,35,232,1,231,1,1,0,1,1,113,113,119,118,88
"7747",46,"[35]ExCfnwHnKqGocIHBJCvhulFBtwnwxoGwxmd",224,0.995556,35,225,1,224,1,1,0,1,1,119,119,106,105,88
"7748",47,"[35]ExCfnwHnKqGocIHBJCvhulFBtwnwxoGwxmd",236,0.995781,35,237,1,236,1,1,0,1,1,110,110,127,126,88
"7749",48,"[35]ExCfnwHnKqGocIHBJCvhulFBtwnwxoGwxmd",231,0.99569,35,232,1,231,1,1,0,1,1,113,113,119,118,88
"7750",49,"[35]ExCfnwHnKqGocIHBJCvhulFBtwnwxoGwxmd",232,0.995708,35,233,1,232,1,1,0,1,1,112,112,121,120,88
"7751",50,"[35]ExCfnwHnKqGocIHBJCvhulFBtwnwxoGwxmd",224,0.995556,35,225,1,224,1,1,0,1,1,120,120,105,104,88
"7752",51,"[35]ExCfnwHnKqGocIHBJCvhulFBtwnwxoGwxmd",244,0.995918,35,245,1,244,1,1,0,1,1,102,102,143,142,88
"7753",52,"[35]ExCfnwHnKqGocIHBJCvhulFBtwnwxoGwxmd",231,0.99569,35,232,1,231,1,1,0,1,1,113,113,119,118,88
"7754",53,"[35]ExCfnwHnKqGocIHBJCvhulFBtwnwxoGwxmd",220,0.995475,35,221,1,220,1,1,0,1,1,123,123,98,97,88
"7755",54,"[35]ExCfnwHnKqGocIHBJCvhulFBtwnwxoGwxmd",233,0.995726,35,234,1,233,1,1,0,1,1,111,111,123,122,88
"7756",55,"[35]ExCfnwHnKqGocIHBJCvhulFBtwnwxoGwxmd",234,0.995745,35,235,1,234,1,1,0,1,1,112,112,123,122,88
"7757",56,"[35]ExCfnwHnKqGocIHBJCvhulFBtwnwxoGwxmd",218,0.995434,35,219,1,218,1,1,0,1,1,123,123,96,95,88
"7758",57,"[35]ExCfnwHnKqGocIHBJCvhulFBtwnwxoGwxmd",243,0.995902,35,244,1,243,1,1,0,1,1,103,103,141,140,88
"7759",58,"[35]ExCfnwHnKqGocIHBJCvhulFBtwnwxoGwxmd",231,0.99569,35,232,1,231,1,1,0,1,1,115,115,117,116,88
"7760",59,"[35]ExCfnwHnKqGocIHBJCvhulFBtwnwxoGwxmd",242,0.995885,35,243,1,242,1,1,0,1,1,105,105,138,137,88
"7761",60,"[35]ExCfnwHnKqGocIHBJCvhulFBtwnwxoGwxmd",232,0.995708,35,233,1,232,1,1,0,1,1,114,114,119,118,88
"7762",61,"[35]ExCfnwHnKqGocIHBJCvhulFBtwnwxoGwxmd",228,0.995633,35,229,1,228,1,1,0,1,1,117,117,112,111,88
"7763",62,"[35]ExCfnwHnKqGocIHBJCvhulFBtwnwxoGwxmd",232,0.995708,35,233,1,232,1,1,0,1,1,112,112,121,120,88
"7764",63,"[35]ExCfnwHnKqGocIHBJCvhulFBtwnwxoGwxmd",221,0.995495,35,222,1,221,1,1,0,1,1,121,121,101,100,88
"7765",64,"[35]ExCfnwHnKqGocIHBJCvhulFBtwnwxoGwxmd",245,0.995935,35,246,1,245,1,1,0,1,1,102,102,144,143,88
"7766",65,"[35]ExCfnwHnKqGocIHBJCvhulFBtwnwxoGwxmd",232,0.995708,35,233,1,232,1,1,0,1,1,113,113,120,119,88
"7767",66,"[35]ExCfnwHnKqGocIHBJCvhulFBtwnwxoGwxmd",229,0.995652,35,230,1,229,1,1,0,1,1,115,115,115,114,88
"7768",67,"[35]ExCfnwHnKqGocIHBJCvhulFBtwnwxoGwxmd",226,0.995595,35,227,1,226,1,1,0,1,1,118,118,109,108,88
"7769",68,"[35]ExCfnwHnKqGocIHBJCvhulFBtwnwxoGwxmd",224,0.995556,35,225,1,224,1,1,0,1,1,119,119,106,105,88
"7770",69,"[35]ExCfnwHnKqGocIHBJCvhulFBtwnwxoGwxmd",226,0.995595,35,227,1,226,1,1,0,1,1,118,118,109,108,88
"7771",70,"[35]ExCfnwHnKqGocIHBJCvhulFBtwnwxoGwxmd",239,0.995833,35,240,1,239,1,1,0,1,1,107,107,133,132,88
"7772",71,"[35]ExCfnwHnKqGocIHBJCvhulFBtwnwxoGwxmd",223,0.995536,35,224,1,223,1,1,0,1,1,119,119,105,104,88
"7773",72,"[35]ExCfnwHnKqGocIHBJCvhulFBtwnwxoGwxmd",229,0.995652,35,230,1,229,1,1,0,1,1,116,116,114,113,88
"7774",73,"[35]ExCfnwHnKqGocIHBJCvhulFBtwnwxoGwxmd",229,0.995652,35,230,1,229,1,1,0,1,1,114,114,116,115,88
"7775",74,"[35]ExCfnwHnKqGocIHBJCvhulFBtwnwxoGwxmd",235,0.995763,35,236,1,235,1,1,0,1,1,110,110,126,125,88
"7776",75,"[35]ExCfnwHnKqGocIHBJCvhulFBtwnwxoGwxmd",242,0.995885,35,243,1,242,1,1,0,1,1,106,106,137,136,88
"7777",76,"[35]ExCfnwHnKqGocIHBJCvhulFBtwnwxoGwxmd",226,0.995595,35,227,1,226,1,1,0,1,1,117,117,110,109,88
"7778",77,"[35]ExCfnwHnKqGocIHBJCvhulFBtwnwxoGwxmd",223,0.995536,35,224,1,223,1,1,0,1,1,119,119,105,104,88
"7779",78,"[35]ExCfnwHnKqGocIHBJCvhulFBtwnwxoGwxmd",227,0.995614,35,228,1,227,1,1,0,1,1,117,117,111,110,88
"7780",79,"[35]ExCfnwHnKqGocIHBJCvhulFBtwnwxoGwxmd",224,0.995556,35,225,1,224,1,1,0,1,1,119,119,106,105,88
"7781",80,"[35]ExCfnwHnKqGocIHBJCvhulFBtwnwxoGwxmd",225,0.995575,35,226,1,225,1,1,0,1,1,119,119,107,106,88
"7782",81,"[35]ExCfnwHnKqGocIHBJCvhulFBtwnwxoGwxmd",224,0.995556,35,225,1,224,1,1,0,1,1,120,120,105,104,88
"7783",82,"[35]ExCfnwHnKqGocIHBJCvhulFBtwnwxoGwxmd",237,0.995798,35,238,1,237,1,1,0,1,1,109,109,129,128,88
"7784",83,"[35]ExCfnwHnKqGocIHBJCvhulFBtwnwxoGwxmd",236,0.995781,35,237,1,236,1,1,0,1,1,110,110,127,126,88
"7785",84,"[35]ExCfnwHnKqGocIHBJCvhulFBtwnwxoGwxmd",224,0.995556,35,225,1,224,1,1,0,1,1,120,120,105,104,88
"7786",85,"[35]ExCfnwHnKqGocIHBJCvhulFBtwnwxoGwxmd",222,0.995516,35,223,1,222,1,1,0,1,1,122,122,101,100,88
"7787",86,"[35]ExCfnwHnKqGocIHBJCvhulFBtwnwxoGwxmd",232,0.995708,35,233,1,232,1,1,0,1,1,112,112,121,120,88
"7788",87,"[35]ExCfnwHnKqGocIHBJCvhulFBtwnwxoGwxmd",241,0.995868,35,242,1,241,1,1,0,1,1,105,105,137,136,88
"7789",88,"[35]ExCfnwHnKqGocIHBJCvhulFBtwnwxoGwxmd",230,0.995671,35,231,1,230,1,1,0,1,1,114,114,117,116,88
"7790",89,"[35]ExCfnwHnKqGocIHBJCvhulFBtwnwxoGwxmd",237,0.995798,35,238,1,237,1,1,0,1,1,109,109,129,128,88
"7791",90,"[35]ExCfnwHnKqGocIHBJCvhulFBtwnwxoGwxmd",228,0.995633,35,229,1,228,1,1,0,1,1,118,118,111,110,88
"7792",91,"[35]ExCfnwHnKqGocIHBJCvhulFBtwnwxoGwxmd",236,0.995781,35,237,1,236,1,1,0,1,1,112,112,125,124,88
"7793",92,"[35]ExCfnwHnKqGocIHBJCvhulFBtwnwxoGwxmd",236,0.995781,35,237,1,236,1,1,0,1,1,110,110,127,126,88
"7794",93,"[35]ExCfnwHnKqGocIHBJCvhulFBtwnwxoGwxmd",223,0.995536,35,224,1,223,1,1,0,1,1,119,119,105,104,88
"7795",94,"[35]ExCfnwHnKqGocIHBJCvhulFBtwnwxoGwxmd",220,0.995475,35,221,1,220,1,1,0,1,1,123,123,98,97,88
"7796",95,"[35]ExCfnwHnKqGocIHBJCvhulFBtwnwxoGwxmd",233,0.995726,35,234,1,233,1,1,0,1,1,112,112,122,121,88
"7797",96,"[35]ExCfnwHnKqGocIHBJCvhulFBtwnwxoGwxmd",238,0.995816,35,239,1,238,1,1,0,1,1,107,107,132,131,88
"7798",97,"[35]ExCfnwHnKqGocIHBJCvhulFBtwnwxoGwxmd",227,0.995614,35,228,1,227,1,1,0,1,1,117,117,111,110,88
"7799",98,"[35]ExCfnwHnKqGocIHBJCvhulFBtwnwxoGwxmd",234,0.995745,35,235,1,234,1,1,0,1,1,112,112,123,122,88
"7800",99,"[35]ExCfnwHnKqGocIHBJCvhulFBtwnwxoGwxmd",236,0.995781,35,237,1,236,1,1,0,1,1,110,110,127,126,88
"7801",0,"[32]EDspmtHnKqGocIHBJCAeFiCtguobdfjq",237,0.995798,32,238,1,237,1,1,0,1,1,108,108,130,129,89
"7802",1,"[32]EDspmtHnKqGocIHBJCAeFiCtguobdfjq",223,0.995536,32,224,1,223,1,1,0,1,1,120,120,104,103,89
"7803",2,"[32]EDspmtHnKqGocIHBJCAeFiCtguobdfjq",228,0.995633,32,229,1,228,1,1,0,1,1,116,116,113,112,89
"7804",3,"[32]EDspmtHnKqGocIHBJCAeFiCtguobdfjq",240,0.995851,32,241,1,240,1,1,0,1,1,106,106,135,134,89
"7805",4,"[32]EDspmtHnKqGocIHBJCAeFiCtguobdfjq",234,0.995745,32,235,1,234,1,1,0,1,1,112,112,123,122,89
"7806",5,"[32]EDspmtHnKqGocIHBJCAeFiCtguobdfjq",217,0.995413,32,218,1,217,1,1,0,1,1,125,125,93,92,89
"7807",6,"[32]EDspmtHnKqGocIHBJCAeFiCtguobdfjq",229,0.995652,32,230,1,229,1,1,0,1,1,115,115,115,114,89
"7808",7,"[32]EDspmtHnKqGocIHBJCAeFiCtguobdfjq",249,0.996,32,250,1,249,1,1,0,1,1,102,102,148,147,89
"7809",8,"[32]EDspmtHnKqGocIHBJCAeFiCtguobdfjq",233,0.995726,32,234,1,233,1,1,0,1,1,112,112,122,121,89
"7810",9,"[32]EDspmtHnKqGocIHBJCAeFiCtguobdfjq",234,0.995745,32,235,1,234,1,1,0,1,1,113,113,122,121,89
"7811",10,"[32]EDspmtHnKqGocIHBJCAeFiCtguobdfjq",221,0.995495,32,222,1,221,1,1,0,1,1,121,121,101,100,89
"7812",11,"[32]EDspmtHnKqGocIHBJCAeFiCtguobdfjq",232,0.995708,32,233,1,232,1,1,0,1,1,112,112,121,120,89
"7813",12,"[32]EDspmtHnKqGocIHBJCAeFiCtguobdfjq",237,0.995798,32,238,1,237,1,1,0,1,1,108,108,130,129,89
"7814",13,"[32]EDspmtHnKqGocIHBJCAeFiCtguobdfjq",218,0.995434,32,219,1,218,1,1,0,1,1,124,124,95,94,89
"7815",14,"[32]EDspmtHnKqGocIHBJCAeFiCtguobdfjq",230,0.995671,32,231,1,230,1,1,0,1,1,115,115,116,115,89
"7816",15,"[32]EDspmtHnKqGocIHBJCAeFiCtguobdfjq",228,0.995633,32,229,1,228,1,1,0,1,1,116,116,113,112,89
"7817",16,"[32]EDspmtHnKqGocIHBJCAeFiCtguobdfjq",234,0.995745,32,235,1,234,1,1,0,1,1,112,112,123,122,89
"7818",17,"[32]EDspmtHnKqGocIHBJCAeFiCtguobdfjq",230,0.995671,32,231,1,230,1,1,0,1,1,114,114,117,116,89
"7819",18,"[32]EDspmtHnKqGocIHBJCAeFiCtguobdfjq",234,0.995745,32,235,1,234,1,1,0,1,1,112,112,123,122,89
"7820",19,"[32]EDspmtHnKqGocIHBJCAeFiCtguobdfjq",230,0.995671,32,231,1,230,1,1,0,1,1,117,117,114,113,89
"7821",20,"[32]EDspmtHnKqGocIHBJCAeFiCtguobdfjq",226,0.995595,32,227,1,226,1,1,0,1,1,120,120,107,106,89
"7822",21,"[32]EDspmtHnKqGocIHBJCAeFiCtguobdfjq",236,0.995781,32,237,1,236,1,1,0,1,1,109,109,128,127,89
"7823",22,"[32]EDspmtHnKqGocIHBJCAeFiCtguobdfjq",225,0.995575,32,226,1,225,1,1,0,1,1,118,118,108,107,89
"7824",23,"[32]EDspmtHnKqGocIHBJCAeFiCtguobdfjq",228,0.995633,32,229,1,228,1,1,0,1,1,116,116,113,112,89
"7825",24,"[32]EDspmtHnKqGocIHBJCAeFiCtguobdfjq",239,0.995833,32,240,1,239,1,1,0,1,1,108,108,132,131,89
"7826",25,"[32]EDspmtHnKqGocIHBJCAeFiCtguobdfjq",235,0.995763,32,236,1,235,1,1,0,1,1,113,113,123,122,89
"7827",26,"[32]EDspmtHnKqGocIHBJCAeFiCtguobdfjq",221,0.995495,32,222,1,221,1,1,0,1,1,122,122,100,99,89
"7828",27,"[32]EDspmtHnKqGocIHBJCAeFiCtguobdfjq",238,0.995816,32,239,1,238,1,1,0,1,1,110,110,129,128,89
"7829",28,"[32]EDspmtHnKqGocIHBJCAeFiCtguobdfjq",235,0.995763,32,236,1,235,1,1,0,1,1,111,111,125,124,89
"7830",29,"[32]EDspmtHnKqGocIHBJCAeFiCtguobdfjq",238,0.995816,32,239,1,238,1,1,0,1,1,108,108,131,130,89
"7831",30,"[32]EDspmtHnKqGocIHBJCAeFiCtguobdfjq",236,0.995781,32,237,1,236,1,1,0,1,1,112,112,125,124,89
"7832",31,"[32]EDspmtHnKqGocIHBJCAeFiCtguobdfjq",231,0.99569,32,232,1,231,1,1,0,1,1,113,113,119,118,89
"7833",32,"[32]EDspmtHnKqGocIHBJCAeFiCtguobdfjq",236,0.995781,32,237,1,236,1,1,0,1,1,110,110,127,126,89
"7834",33,"[32]EDspmtHnKqGocIHBJCAeFiCtguobdfjq",233,0.995726,32,234,1,233,1,1,0,1,1,112,112,122,121,89
"7835",34,"[32]EDspmtHnKqGocIHBJCAeFiCtguobdfjq",226,0.995595,32,227,1,226,1,1,0,1,1,120,120,107,106,89
"7836",35,"[32]EDspmtHnKqGocIHBJCAeFiCtguobdfjq",224,0.995556,32,225,1,224,1,1,0,1,1,119,119,106,105,89
"7837",36,"[32]EDspmtHnKqGocIHBJCAeFiCtguobdfjq",234,0.995745,32,235,1,234,1,1,0,1,1,116,116,119,118,89
"7838",37,"[32]EDspmtHnKqGocIHBJCAeFiCtguobdfjq",235,0.995763,32,236,1,235,1,1,0,1,1,113,113,123,122,89
"7839",38,"[32]EDspmtHnKqGocIHBJCAeFiCtguobdfjq",243,0.995902,32,244,1,243,1,1,0,1,1,104,104,140,139,89
"7840",39,"[32]EDspmtHnKqGocIHBJCAeFiCtguobdfjq",220,0.995475,32,221,1,220,1,1,0,1,1,122,122,99,98,89
"7841",40,"[32]EDspmtHnKqGocIHBJCAeFiCtguobdfjq",230,0.995671,32,231,1,230,1,1,0,1,1,116,116,115,114,89
"7842",41,"[32]EDspmtHnKqGocIHBJCAeFiCtguobdfjq",225,0.995575,32,226,1,225,1,1,0,1,1,119,119,107,106,89
"7843",42,"[32]EDspmtHnKqGocIHBJCAeFiCtguobdfjq",229,0.995652,32,230,1,229,1,1,0,1,1,117,117,113,112,89
"7844",43,"[32]EDspmtHnKqGocIHBJCAeFiCtguobdfjq",222,0.995516,32,223,1,222,1,1,0,1,1,120,120,103,102,89
"7845",44,"[32]EDspmtHnKqGocIHBJCAeFiCtguobdfjq",229,0.995652,32,230,1,229,1,1,0,1,1,115,115,115,114,89
"7846",45,"[32]EDspmtHnKqGocIHBJCAeFiCtguobdfjq",220,0.995475,32,221,1,220,1,1,0,1,1,123,123,98,97,89
"7847",46,"[32]EDspmtHnKqGocIHBJCAeFiCtguobdfjq",223,0.995536,32,224,1,223,1,1,0,1,1,120,120,104,103,89
"7848",47,"[32]EDspmtHnKqGocIHBJCAeFiCtguobdfjq",232,0.995708,32,233,1,232,1,1,0,1,1,112,112,121,120,89
"7849",48,"[32]EDspmtHnKqGocIHBJCAeFiCtguobdfjq",231,0.99569,32,232,1,231,1,1,0,1,1,115,115,117,116,89
"7850",49,"[32]EDspmtHnKqGocIHBJCAeFiCtguobdfjq",238,0.995816,32,239,1,238,1,1,0,1,1,108,108,131,130,89
"7851",50,"[32]EDspmtHnKqGocIHBJCAeFiCtguobdfjq",228,0.995633,32,229,1,228,1,1,0,1,1,117,117,112,111,89
"7852",51,"[32]EDspmtHnKqGocIHBJCAeFiCtguobdfjq",230,0.995671,32,231,1,230,1,1,0,1,1,116,116,115,114,89
"7853",52,"[32]EDspmtHnKqGocIHBJCAeFiCtguobdfjq",232,0.995708,32,233,1,232,1,1,0,1,1,113,113,120,119,89
"7854",53,"[32]EDspmtHnKqGocIHBJCAeFiCtguobdfjq",236,0.995781,32,237,1,236,1,1,0,1,1,113,113,124,123,89
"7855",54,"[32]EDspmtHnKqGocIHBJCAeFiCtguobdfjq",228,0.995633,32,229,1,228,1,1,0,1,1,117,117,112,111,89
"7856",55,"[32]EDspmtHnKqGocIHBJCAeFiCtguobdfjq",234,0.995745,32,235,1,234,1,1,0,1,1,112,112,123,122,89
"7857",56,"[32]EDspmtHnKqGocIHBJCAeFiCtguobdfjq",226,0.995595,32,227,1,226,1,1,0,1,1,117,117,110,109,89
"7858",57,"[32]EDspmtHnKqGocIHBJCAeFiCtguobdfjq",226,0.995595,32,227,1,226,1,1,0,1,1,118,118,109,108,89
"7859",58,"[32]EDspmtHnKqGocIHBJCAeFiCtguobdfjq",239,0.995833,32,240,1,239,1,1,0,1,1,107,107,133,132,89
"7860",59,"[32]EDspmtHnKqGocIHBJCAeFiCtguobdfjq",237,0.995798,32,238,1,237,1,1,0,1,1,109,109,129,128,89
"7861",60,"[32]EDspmtHnKqGocIHBJCAeFiCtguobdfjq",231,0.99569,32,232,1,231,1,1,0,1,1,114,114,118,117,89
"7862",61,"[32]EDspmtHnKqGocIHBJCAeFiCtguobdfjq",230,0.995671,32,231,1,230,1,1,0,1,1,114,114,117,116,89
"7863",62,"[32]EDspmtHnKqGocIHBJCAeFiCtguobdfjq",232,0.995708,32,233,1,232,1,1,0,1,1,114,114,119,118,89
"7864",63,"[32]EDspmtHnKqGocIHBJCAeFiCtguobdfjq",225,0.995575,32,226,1,225,1,1,0,1,1,118,118,108,107,89
"7865",64,"[32]EDspmtHnKqGocIHBJCAeFiCtguobdfjq",226,0.995595,32,227,1,226,1,1,0,1,1,119,119,108,107,89
"7866",65,"[32]EDspmtHnKqGocIHBJCAeFiCtguobdfjq",236,0.995781,32,237,1,236,1,1,0,1,1,111,111,126,125,89
"7867",66,"[32]EDspmtHnKqGocIHBJCAeFiCtguobdfjq",236,0.995781,32,237,1,236,1,1,0,1,1,110,110,127,126,89
"7868",67,"[32]EDspmtHnKqGocIHBJCAeFiCtguobdfjq",219,0.995455,32,220,1,219,1,1,0,1,1,123,123,97,96,89
"7869",68,"[32]EDspmtHnKqGocIHBJCAeFiCtguobdfjq",244,0.995918,32,245,1,244,1,1,0,1,1,105,105,140,139,89
"7870",69,"[32]EDspmtHnKqGocIHBJCAeFiCtguobdfjq",227,0.995614,32,228,1,227,1,1,0,1,1,116,116,112,111,89
"7871",70,"[32]EDspmtHnKqGocIHBJCAeFiCtguobdfjq",233,0.995726,32,234,1,233,1,1,0,1,1,113,113,121,120,89
"7872",71,"[32]EDspmtHnKqGocIHBJCAeFiCtguobdfjq",238,0.995816,32,239,1,238,1,1,0,1,1,110,110,129,128,89
"7873",72,"[32]EDspmtHnKqGocIHBJCAeFiCtguobdfjq",237,0.995798,32,238,1,237,1,1,0,1,1,109,109,129,128,89
"7874",73,"[32]EDspmtHnKqGocIHBJCAeFiCtguobdfjq",237,0.995798,32,238,1,237,1,1,0,1,1,108,108,130,129,89
"7875",74,"[32]EDspmtHnKqGocIHBJCAeFiCtguobdfjq",227,0.995614,32,228,1,227,1,1,0,1,1,116,116,112,111,89
"7876",75,"[32]EDspmtHnKqGocIHBJCAeFiCtguobdfjq",231,0.99569,32,232,1,231,1,1,0,1,1,113,113,119,118,89
"7877",76,"[32]EDspmtHnKqGocIHBJCAeFiCtguobdfjq",235,0.995763,32,236,1,235,1,1,0,1,1,111,111,125,124,89
"7878",77,"[32]EDspmtHnKqGocIHBJCAeFiCtguobdfjq",225,0.995575,32,226,1,225,1,1,0,1,1,119,119,107,106,89
"7879",78,"[32]EDspmtHnKqGocIHBJCAeFiCtguobdfjq",231,0.99569,32,232,1,231,1,1,0,1,1,116,116,116,115,89
"7880",79,"[32]EDspmtHnKqGocIHBJCAeFiCtguobdfjq",222,0.995516,32,223,1,222,1,1,0,1,1,123,123,100,99,89
"7881",80,"[32]EDspmtHnKqGocIHBJCAeFiCtguobdfjq",236,0.995781,32,237,1,236,1,1,0,1,1,112,112,125,124,89
"7882",81,"[32]EDspmtHnKqGocIHBJCAeFiCtguobdfjq",226,0.995595,32,227,1,226,1,1,0,1,1,118,118,109,108,89
"7883",82,"[32]EDspmtHnKqGocIHBJCAeFiCtguobdfjq",241,0.995868,32,242,1,241,1,1,0,1,1,106,106,136,135,89
"7884",83,"[32]EDspmtHnKqGocIHBJCAeFiCtguobdfjq",220,0.995475,32,221,1,220,1,1,0,1,1,122,122,99,98,89
"7885",84,"[32]EDspmtHnKqGocIHBJCAeFiCtguobdfjq",239,0.995833,32,240,1,239,1,1,0,1,1,109,109,131,130,89
"7886",85,"[32]EDspmtHnKqGocIHBJCAeFiCtguobdfjq",225,0.995575,32,226,1,225,1,1,0,1,1,118,118,108,107,89
"7887",86,"[32]EDspmtHnKqGocIHBJCAeFiCtguobdfjq",229,0.995652,32,230,1,229,1,1,0,1,1,115,115,115,114,89
"7888",87,"[32]EDspmtHnKqGocIHBJCAeFiCtguobdfjq",245,0.995935,32,246,1,245,1,1,0,1,1,109,109,137,136,89
"7889",88,"[32]EDspmtHnKqGocIHBJCAeFiCtguobdfjq",230,0.995671,32,231,1,230,1,1,0,1,1,114,114,117,116,89
"7890",89,"[32]EDspmtHnKqGocIHBJCAeFiCtguobdfjq",230,0.995671,32,231,1,230,1,1,0,1,1,114,114,117,116,89
"7891",90,"[32]EDspmtHnKqGocIHBJCAeFiCtguobdfjq",226,0.995595,32,227,1,226,1,1,0,1,1,119,119,108,107,89
"7892",91,"[32]EDspmtHnKqGocIHBJCAeFiCtguobdfjq",232,0.995708,32,233,1,232,1,1,0,1,1,114,114,119,118,89
"7893",92,"[32]EDspmtHnKqGocIHBJCAeFiCtguobdfjq",220,0.995475,32,221,1,220,1,1,0,1,1,123,123,98,97,89
"7894",93,"[32]EDspmtHnKqGocIHBJCAeFiCtguobdfjq",226,0.995595,32,227,1,226,1,1,0,1,1,118,118,109,108,89
"7895",94,"[32]EDspmtHnKqGocIHBJCAeFiCtguobdfjq",232,0.995708,32,233,1,232,1,1,0,1,1,112,112,121,120,89
"7896",95,"[32]EDspmtHnKqGocIHBJCAeFiCtguobdfjq",227,0.995614,32,228,1,227,1,1,0,1,1,118,118,110,109,89
"7897",96,"[32]EDspmtHnKqGocIHBJCAeFiCtguobdfjq",231,0.99569,32,232,1,231,1,1,0,1,1,114,114,118,117,89
"7898",97,"[32]EDspmtHnKqGocIHBJCAeFiCtguobdfjq",227,0.995614,32,228,1,227,1,1,0,1,1,116,116,112,111,89
"7899",98,"[32]EDspmtHnKqGocIHBJCAeFiCtguobdfjq",222,0.995516,32,223,1,222,1,1,0,1,1,120,120,103,102,89
"7900",99,"[32]EDspmtHnKqGocIHBJCAeFiCtguobdfjq",230,0.995671,32,231,1,230,1,1,0,1,1,115,115,116,115,89
"7901",0,"[28]EpibuHnKqGocIHcJCxfjEHbdjpyf",237,0.995798,28,238,1,237,1,1,0,1,1,110,110,128,127,90
"7902",1,"[28]EpibuHnKqGocIHcJCxfjEHbdjpyf",221,0.995495,28,222,1,221,1,1,0,1,1,121,121,101,100,90
"7903",2,"[28]EpibuHnKqGocIHcJCxfjEHbdjpyf",229,0.995652,28,230,1,229,1,1,0,1,1,116,116,114,113,90
"7904",3,"[28]EpibuHnKqGocIHcJCxfjEHbdjpyf",227,0.995614,28,228,1,227,1,1,0,1,1,117,117,111,110,90
"7905",4,"[28]EpibuHnKqGocIHcJCxfjEHbdjpyf",219,0.995455,28,220,1,219,1,1,0,1,1,126,126,94,93,90
"7906",5,"[28]EpibuHnKqGocIHcJCxfjEHbdjpyf",226,0.995595,28,227,1,226,1,1,0,1,1,117,117,110,109,90
"7907",6,"[28]EpibuHnKqGocIHcJCxfjEHbdjpyf",240,0.995851,28,241,1,240,1,1,0,1,1,107,107,134,133,90
"7908",7,"[28]EpibuHnKqGocIHcJCxfjEHbdjpyf",239,0.995833,28,240,1,239,1,1,0,1,1,108,108,132,131,90
"7909",8,"[28]EpibuHnKqGocIHcJCxfjEHbdjpyf",233,0.995726,28,234,1,233,1,1,0,1,1,115,115,119,118,90
"7910",9,"[28]EpibuHnKqGocIHcJCxfjEHbdjpyf",225,0.995575,28,226,1,225,1,1,0,1,1,118,118,108,107,90
"7911",10,"[28]EpibuHnKqGocIHcJCxfjEHbdjpyf",226,0.995595,28,227,1,226,1,1,0,1,1,118,118,109,108,90
"7912",11,"[28]EpibuHnKqGocIHcJCxfjEHbdjpyf",236,0.995781,28,237,1,236,1,1,0,1,1,110,110,127,126,90
"7913",12,"[28]EpibuHnKqGocIHcJCxfjEHbdjpyf",236,0.995781,28,237,1,236,1,1,0,1,1,111,111,126,125,90
"7914",13,"[28]EpibuHnKqGocIHcJCxfjEHbdjpyf",225,0.995575,28,226,1,225,1,1,0,1,1,118,118,108,107,90
"7915",14,"[28]EpibuHnKqGocIHcJCxfjEHbdjpyf",223,0.995536,28,224,1,223,1,1,0,1,1,120,120,104,103,90
"7916",15,"[28]EpibuHnKqGocIHcJCxfjEHbdjpyf",226,0.995595,28,227,1,226,1,1,0,1,1,117,117,110,109,90
"7917",16,"[28]EpibuHnKqGocIHcJCxfjEHbdjpyf",230,0.995671,28,231,1,230,1,1,0,1,1,114,114,117,116,90
"7918",17,"[28]EpibuHnKqGocIHcJCxfjEHbdjpyf",237,0.995798,28,238,1,237,1,1,0,1,1,108,108,130,129,90
"7919",18,"[28]EpibuHnKqGocIHcJCxfjEHbdjpyf",217,0.995413,28,218,1,217,1,1,0,1,1,124,124,94,93,90
"7920",19,"[28]EpibuHnKqGocIHcJCxfjEHbdjpyf",231,0.99569,28,232,1,231,1,1,0,1,1,114,114,118,117,90
"7921",20,"[28]EpibuHnKqGocIHcJCxfjEHbdjpyf",230,0.995671,28,231,1,230,1,1,0,1,1,115,115,116,115,90
"7922",21,"[28]EpibuHnKqGocIHcJCxfjEHbdjpyf",228,0.995633,28,229,1,228,1,1,0,1,1,117,117,112,111,90
"7923",22,"[28]EpibuHnKqGocIHcJCxfjEHbdjpyf",226,0.995595,28,227,1,226,1,1,0,1,1,117,117,110,109,90
"7924",23,"[28]EpibuHnKqGocIHcJCxfjEHbdjpyf",226,0.995595,28,227,1,226,1,1,0,1,1,118,118,109,108,90
"7925",24,"[28]EpibuHnKqGocIHcJCxfjEHbdjpyf",240,0.995851,28,241,1,240,1,1,0,1,1,116,116,125,124,90
"7926",25,"[28]EpibuHnKqGocIHcJCxfjEHbdjpyf",228,0.995633,28,229,1,228,1,1,0,1,1,116,116,113,112,90
"7927",26,"[28]EpibuHnKqGocIHcJCxfjEHbdjpyf",232,0.995708,28,233,1,232,1,1,0,1,1,116,116,117,116,90
"7928",27,"[28]EpibuHnKqGocIHcJCxfjEHbdjpyf",232,0.995708,28,233,1,232,1,1,0,1,1,112,112,121,120,90
"7929",28,"[28]EpibuHnKqGocIHcJCxfjEHbdjpyf",230,0.995671,28,231,1,230,1,1,0,1,1,116,116,115,114,90
"7930",29,"[28]EpibuHnKqGocIHcJCxfjEHbdjpyf",227,0.995614,28,228,1,227,1,1,0,1,1,116,116,112,111,90
"7931",30,"[28]EpibuHnKqGocIHcJCxfjEHbdjpyf",240,0.995851,28,241,1,240,1,1,0,1,1,106,106,135,134,90
"7932",31,"[28]EpibuHnKqGocIHcJCxfjEHbdjpyf",231,0.99569,28,232,1,231,1,1,0,1,1,115,115,117,116,90
"7933",32,"[28]EpibuHnKqGocIHcJCxfjEHbdjpyf",242,0.995885,28,243,1,242,1,1,0,1,1,106,106,137,136,90
"7934",33,"[28]EpibuHnKqGocIHcJCxfjEHbdjpyf",237,0.995798,28,238,1,237,1,1,0,1,1,109,109,129,128,90
"7935",34,"[28]EpibuHnKqGocIHcJCxfjEHbdjpyf",229,0.995652,28,230,1,229,1,1,0,1,1,115,115,115,114,90
"7936",35,"[28]EpibuHnKqGocIHcJCxfjEHbdjpyf",225,0.995575,28,226,1,225,1,1,0,1,1,118,118,108,107,90
"7937",36,"[28]EpibuHnKqGocIHcJCxfjEHbdjpyf",225,0.995575,28,226,1,225,1,1,0,1,1,118,118,108,107,90
"7938",37,"[28]EpibuHnKqGocIHcJCxfjEHbdjpyf",229,0.995652,28,230,1,229,1,1,0,1,1,117,117,113,112,90
"7939",38,"[28]EpibuHnKqGocIHcJCxfjEHbdjpyf",231,0.99569,28,232,1,231,1,1,0,1,1,117,117,115,114,90
"7940",39,"[28]EpibuHnKqGocIHcJCxfjEHbdjpyf",238,0.995816,28,239,1,238,1,1,0,1,1,108,108,131,130,90
"7941",40,"[28]EpibuHnKqGocIHcJCxfjEHbdjpyf",224,0.995556,28,225,1,224,1,1,0,1,1,119,119,106,105,90
"7942",41,"[28]EpibuHnKqGocIHcJCxfjEHbdjpyf",229,0.995652,28,230,1,229,1,1,0,1,1,117,117,113,112,90
"7943",42,"[28]EpibuHnKqGocIHcJCxfjEHbdjpyf",227,0.995614,28,228,1,227,1,1,0,1,1,117,117,111,110,90
"7944",43,"[28]EpibuHnKqGocIHcJCxfjEHbdjpyf",225,0.995575,28,226,1,225,1,1,0,1,1,119,119,107,106,90
"7945",44,"[28]EpibuHnKqGocIHcJCxfjEHbdjpyf",233,0.995726,28,234,1,233,1,1,0,1,1,114,114,120,119,90
"7946",45,"[28]EpibuHnKqGocIHcJCxfjEHbdjpyf",224,0.995556,28,225,1,224,1,1,0,1,1,120,120,105,104,90
"7947",46,"[28]EpibuHnKqGocIHcJCxfjEHbdjpyf",225,0.995575,28,226,1,225,1,1,0,1,1,118,118,108,107,90
"7948",47,"[28]EpibuHnKqGocIHcJCxfjEHbdjpyf",229,0.995652,28,230,1,229,1,1,0,1,1,116,116,114,113,90
"7949",48,"[28]EpibuHnKqGocIHcJCxfjEHbdjpyf",222,0.995516,28,223,1,222,1,1,0,1,1,122,122,101,100,90
"7950",49,"[28]EpibuHnKqGocIHcJCxfjEHbdjpyf",228,0.995633,28,229,1,228,1,1,0,1,1,117,117,112,111,90
"7951",50,"[28]EpibuHnKqGocIHcJCxfjEHbdjpyf",237,0.995798,28,238,1,237,1,1,0,1,1,108,108,130,129,90
"7952",51,"[28]EpibuHnKqGocIHcJCxfjEHbdjpyf",237,0.995798,28,238,1,237,1,1,0,1,1,111,111,127,126,90
"7953",52,"[28]EpibuHnKqGocIHcJCxfjEHbdjpyf",227,0.995614,28,228,1,227,1,1,0,1,1,119,119,109,108,90
"7954",53,"[28]EpibuHnKqGocIHcJCxfjEHbdjpyf",241,0.995868,28,242,1,241,1,1,0,1,1,106,106,136,135,90
"7955",54,"[28]EpibuHnKqGocIHcJCxfjEHbdjpyf",220,0.995475,28,221,1,220,1,1,0,1,1,122,122,99,98,90
"7956",55,"[28]EpibuHnKqGocIHcJCxfjEHbdjpyf",226,0.995595,28,227,1,226,1,1,0,1,1,118,118,109,108,90
"7957",56,"[28]EpibuHnKqGocIHcJCxfjEHbdjpyf",233,0.995726,28,234,1,233,1,1,0,1,1,112,112,122,121,90
"7958",57,"[28]EpibuHnKqGocIHcJCxfjEHbdjpyf",229,0.995652,28,230,1,229,1,1,0,1,1,115,115,115,114,90
"7959",58,"[28]EpibuHnKqGocIHcJCxfjEHbdjpyf",232,0.995708,28,233,1,232,1,1,0,1,1,112,112,121,120,90
"7960",59,"[28]EpibuHnKqGocIHcJCxfjEHbdjpyf",233,0.995726,28,234,1,233,1,1,0,1,1,113,113,121,120,90
"7961",60,"[28]EpibuHnKqGocIHcJCxfjEHbdjpyf",234,0.995745,28,235,1,234,1,1,0,1,1,111,111,124,123,90
"7962",61,"[28]EpibuHnKqGocIHcJCxfjEHbdjpyf",227,0.995614,28,228,1,227,1,1,0,1,1,119,119,109,108,90
"7963",62,"[28]EpibuHnKqGocIHcJCxfjEHbdjpyf",242,0.995885,28,243,1,242,1,1,0,1,1,106,106,137,136,90
"7964",63,"[28]EpibuHnKqGocIHcJCxfjEHbdjpyf",227,0.995614,28,228,1,227,1,1,0,1,1,116,116,112,111,90
"7965",64,"[28]EpibuHnKqGocIHcJCxfjEHbdjpyf",224,0.995556,28,225,1,224,1,1,0,1,1,120,120,105,104,90
"7966",65,"[28]EpibuHnKqGocIHcJCxfjEHbdjpyf",236,0.995781,28,237,1,236,1,1,0,1,1,112,112,125,124,90
"7967",66,"[28]EpibuHnKqGocIHcJCxfjEHbdjpyf",235,0.995763,28,236,1,235,1,1,0,1,1,111,111,125,124,90
"7968",67,"[28]EpibuHnKqGocIHcJCxfjEHbdjpyf",225,0.995575,28,226,1,225,1,1,0,1,1,118,118,108,107,90
"7969",68,"[28]EpibuHnKqGocIHcJCxfjEHbdjpyf",229,0.995652,28,230,1,229,1,1,0,1,1,116,116,114,113,90
"7970",69,"[28]EpibuHnKqGocIHcJCxfjEHbdjpyf",235,0.995763,28,236,1,235,1,1,0,1,1,111,111,125,124,90
"7971",70,"[28]EpibuHnKqGocIHcJCxfjEHbdjpyf",227,0.995614,28,228,1,227,1,1,0,1,1,117,117,111,110,90
"7972",71,"[28]EpibuHnKqGocIHcJCxfjEHbdjpyf",249,0.996,28,250,1,249,1,1,0,1,1,99,99,151,150,90
"7973",72,"[28]EpibuHnKqGocIHcJCxfjEHbdjpyf",244,0.995918,28,245,1,244,1,1,0,1,1,104,104,141,140,90
"7974",73,"[28]EpibuHnKqGocIHcJCxfjEHbdjpyf",231,0.99569,28,232,1,231,1,1,0,1,1,116,116,116,115,90
"7975",74,"[28]EpibuHnKqGocIHcJCxfjEHbdjpyf",225,0.995575,28,226,1,225,1,1,0,1,1,122,122,104,103,90
"7976",75,"[28]EpibuHnKqGocIHcJCxfjEHbdjpyf",229,0.995652,28,230,1,229,1,1,0,1,1,116,116,114,113,90
"7977",76,"[28]EpibuHnKqGocIHcJCxfjEHbdjpyf",226,0.995595,28,227,1,226,1,1,0,1,1,118,118,109,108,90
"7978",77,"[28]EpibuHnKqGocIHcJCxfjEHbdjpyf",237,0.995798,28,238,1,237,1,1,0,1,1,108,108,130,129,90
"7979",78,"[28]EpibuHnKqGocIHcJCxfjEHbdjpyf",221,0.995495,28,222,1,221,1,1,0,1,1,121,121,101,100,90
"7980",79,"[28]EpibuHnKqGocIHcJCxfjEHbdjpyf",233,0.995726,28,234,1,233,1,1,0,1,1,112,112,122,121,90
"7981",80,"[28]EpibuHnKqGocIHcJCxfjEHbdjpyf",223,0.995536,28,224,1,223,1,1,0,1,1,120,120,104,103,90
"7982",81,"[28]EpibuHnKqGocIHcJCxfjEHbdjpyf",237,0.995798,28,238,1,237,1,1,0,1,1,109,109,129,128,90
"7983",82,"[28]EpibuHnKqGocIHcJCxfjEHbdjpyf",236,0.995781,28,237,1,236,1,1,0,1,1,110,110,127,126,90
"7984",83,"[28]EpibuHnKqGocIHcJCxfjEHbdjpyf",214,0.995349,28,215,1,214,1,1,0,1,1,127,127,88,87,90
"7985",84,"[28]EpibuHnKqGocIHcJCxfjEHbdjpyf",237,0.995798,28,238,1,237,1,1,0,1,1,109,109,129,128,90
"7986",85,"[28]EpibuHnKqGocIHcJCxfjEHbdjpyf",230,0.995671,28,231,1,230,1,1,0,1,1,114,114,117,116,90
"7987",86,"[28]EpibuHnKqGocIHcJCxfjEHbdjpyf",227,0.995614,28,228,1,227,1,1,0,1,1,116,116,112,111,90
"7988",87,"[28]EpibuHnKqGocIHcJCxfjEHbdjpyf",225,0.995575,28,226,1,225,1,1,0,1,1,119,119,107,106,90
"7989",88,"[28]EpibuHnKqGocIHcJCxfjEHbdjpyf",223,0.995536,28,224,1,223,1,1,0,1,1,120,120,104,103,90
"7990",89,"[28]EpibuHnKqGocIHcJCxfjEHbdjpyf",222,0.995516,28,223,1,222,1,1,0,1,1,120,120,103,102,90
"7991",90,"[28]EpibuHnKqGocIHcJCxfjEHbdjpyf",227,0.995614,28,228,1,227,1,1,0,1,1,117,117,111,110,90
"7992",91,"[28]EpibuHnKqGocIHcJCxfjEHbdjpyf",233,0.995726,28,234,1,233,1,1,0,1,1,113,113,121,120,90
"7993",92,"[28]EpibuHnKqGocIHcJCxfjEHbdjpyf",228,0.995633,28,229,1,228,1,1,0,1,1,120,120,109,108,90
"7994",93,"[28]EpibuHnKqGocIHcJCxfjEHbdjpyf",225,0.995575,28,226,1,225,1,1,0,1,1,118,118,108,107,90
"7995",94,"[28]EpibuHnKqGocIHcJCxfjEHbdjpyf",235,0.995763,28,236,1,235,1,1,0,1,1,114,114,122,121,90
"7996",95,"[28]EpibuHnKqGocIHcJCxfjEHbdjpyf",228,0.995633,28,229,1,228,1,1,0,1,1,116,116,113,112,90
"7997",96,"[28]EpibuHnKqGocIHcJCxfjEHbdjpyf",231,0.99569,28,232,1,231,1,1,0,1,1,117,117,115,114,90
"7998",97,"[28]EpibuHnKqGocIHcJCxfjEHbdjpyf",229,0.995652,28,230,1,229,1,1,0,1,1,116,116,114,113,90
"7999",98,"[28]EpibuHnKqGocIHcJCxfjEHbdjpyf",238,0.995816,28,239,1,238,1,1,0,1,1,110,110,129,128,90
"8000",99,"[28]EpibuHnKqGocIHcJCxfjEHbdjpyf",231,0.99569,28,232,1,231,1,1,0,1,1,113,113,119,118,90
"8001",0,"[27]EohstHnKqGocIHBJCAlAoynzkdk",236,0.995781,27,237,1,236,1,1,0,1,1,111,111,126,125,91
"8002",1,"[27]EohstHnKqGocIHBJCAlAoynzkdk",233,0.995726,27,234,1,233,1,1,0,1,1,112,112,122,121,91
"8003",2,"[27]EohstHnKqGocIHBJCAlAoynzkdk",229,0.995652,27,230,1,229,1,1,0,1,1,116,116,114,113,91
"8004",3,"[27]EohstHnKqGocIHBJCAlAoynzkdk",221,0.995495,27,222,1,221,1,1,0,1,1,121,121,101,100,91
"8005",4,"[27]EohstHnKqGocIHBJCAlAoynzkdk",224,0.995556,27,225,1,224,1,1,0,1,1,120,120,105,104,91
"8006",5,"[27]EohstHnKqGocIHBJCAlAoynzkdk",221,0.995495,27,222,1,221,1,1,0,1,1,121,121,101,100,91
"8007",6,"[27]EohstHnKqGocIHBJCAlAoynzkdk",221,0.995495,27,222,1,221,1,1,0,1,1,122,122,100,99,91
"8008",7,"[27]EohstHnKqGocIHBJCAlAoynzkdk",237,0.995798,27,238,1,237,1,1,0,1,1,108,108,130,129,91
"8009",8,"[27]EohstHnKqGocIHBJCAlAoynzkdk",225,0.995575,27,226,1,225,1,1,0,1,1,120,120,106,105,91
"8010",9,"[27]EohstHnKqGocIHBJCAlAoynzkdk",228,0.995633,27,229,1,228,1,1,0,1,1,116,116,113,112,91
"8011",10,"[27]EohstHnKqGocIHBJCAlAoynzkdk",227,0.995614,27,228,1,227,1,1,0,1,1,116,116,112,111,91
"8012",11,"[27]EohstHnKqGocIHBJCAlAoynzkdk",222,0.995516,27,223,1,222,1,1,0,1,1,121,121,102,101,91
"8013",12,"[27]EohstHnKqGocIHBJCAlAoynzkdk",229,0.995652,27,230,1,229,1,1,0,1,1,116,116,114,113,91
"8014",13,"[27]EohstHnKqGocIHBJCAlAoynzkdk",234,0.995745,27,235,1,234,1,1,0,1,1,111,111,124,123,91
"8015",14,"[27]EohstHnKqGocIHBJCAlAoynzkdk",228,0.995633,27,229,1,228,1,1,0,1,1,116,116,113,112,91
"8016",15,"[27]EohstHnKqGocIHBJCAlAoynzkdk",230,0.995671,27,231,1,230,1,1,0,1,1,115,115,116,115,91
"8017",16,"[27]EohstHnKqGocIHBJCAlAoynzkdk",231,0.99569,27,232,1,231,1,1,0,1,1,114,114,118,117,91
"8018",17,"[27]EohstHnKqGocIHBJCAlAoynzkdk",225,0.995575,27,226,1,225,1,1,0,1,1,118,118,108,107,91
"8019",18,"[27]EohstHnKqGocIHBJCAlAoynzkdk",231,0.99569,27,232,1,231,1,1,0,1,1,114,114,118,117,91
"8020",19,"[27]EohstHnKqGocIHBJCAlAoynzkdk",229,0.995652,27,230,1,229,1,1,0,1,1,115,115,115,114,91
"8021",20,"[27]EohstHnKqGocIHBJCAlAoynzkdk",230,0.995671,27,231,1,230,1,1,0,1,1,115,115,116,115,91
"8022",21,"[27]EohstHnKqGocIHBJCAlAoynzkdk",221,0.995495,27,222,1,221,1,1,0,1,1,121,121,101,100,91
"8023",22,"[27]EohstHnKqGocIHBJCAlAoynzkdk",227,0.995614,27,228,1,227,1,1,0,1,1,116,116,112,111,91
"8024",23,"[27]EohstHnKqGocIHBJCAlAoynzkdk",237,0.995798,27,238,1,237,1,1,0,1,1,108,108,130,129,91
"8025",24,"[27]EohstHnKqGocIHBJCAlAoynzkdk",225,0.995575,27,226,1,225,1,1,0,1,1,118,118,108,107,91
"8026",25,"[27]EohstHnKqGocIHBJCAlAoynzkdk",222,0.995516,27,223,1,222,1,1,0,1,1,122,122,101,100,91
"8027",26,"[27]EohstHnKqGocIHBJCAlAoynzkdk",232,0.995708,27,233,1,232,1,1,0,1,1,113,113,120,119,91
"8028",27,"[27]EohstHnKqGocIHBJCAlAoynzkdk",232,0.995708,27,233,1,232,1,1,0,1,1,112,112,121,120,91
"8029",28,"[27]EohstHnKqGocIHBJCAlAoynzkdk",226,0.995595,27,227,1,226,1,1,0,1,1,121,121,106,105,91
"8030",29,"[27]EohstHnKqGocIHBJCAlAoynzkdk",231,0.99569,27,232,1,231,1,1,0,1,1,113,113,119,118,91
"8031",30,"[27]EohstHnKqGocIHBJCAlAoynzkdk",231,0.99569,27,232,1,231,1,1,0,1,1,114,114,118,117,91
"8032",31,"[27]EohstHnKqGocIHBJCAlAoynzkdk",238,0.995816,27,239,1,238,1,1,0,1,1,109,109,130,129,91
"8033",32,"[27]EohstHnKqGocIHBJCAlAoynzkdk",217,0.995413,27,218,1,217,1,1,0,1,1,124,124,94,93,91
"8034",33,"[27]EohstHnKqGocIHBJCAlAoynzkdk",234,0.995745,27,235,1,234,1,1,0,1,1,113,113,122,121,91
"8035",34,"[27]EohstHnKqGocIHBJCAlAoynzkdk",229,0.995652,27,230,1,229,1,1,0,1,1,115,115,115,114,91
"8036",35,"[27]EohstHnKqGocIHBJCAlAoynzkdk",234,0.995745,27,235,1,234,1,1,0,1,1,111,111,124,123,91
"8037",36,"[27]EohstHnKqGocIHBJCAlAoynzkdk",235,0.995763,27,236,1,235,1,1,0,1,1,112,112,124,123,91
"8038",37,"[27]EohstHnKqGocIHBJCAlAoynzkdk",225,0.995575,27,226,1,225,1,1,0,1,1,120,120,106,105,91
"8039",38,"[27]EohstHnKqGocIHBJCAlAoynzkdk",225,0.995575,27,226,1,225,1,1,0,1,1,120,120,106,105,91
"8040",39,"[27]EohstHnKqGocIHBJCAlAoynzkdk",230,0.995671,27,231,1,230,1,1,0,1,1,115,115,116,115,91
"8041",40,"[27]EohstHnKqGocIHBJCAlAoynzkdk",238,0.995816,27,239,1,238,1,1,0,1,1,110,110,129,128,91
"8042",41,"[27]EohstHnKqGocIHBJCAlAoynzkdk",224,0.995556,27,225,1,224,1,1,0,1,1,120,120,105,104,91
"8043",42,"[27]EohstHnKqGocIHBJCAlAoynzkdk",231,0.99569,27,232,1,231,1,1,0,1,1,113,113,119,118,91
"8044",43,"[27]EohstHnKqGocIHBJCAlAoynzkdk",237,0.995798,27,238,1,237,1,1,0,1,1,110,110,128,127,91
"8045",44,"[27]EohstHnKqGocIHBJCAlAoynzkdk",220,0.995475,27,221,1,220,1,1,0,1,1,122,122,99,98,91
"8046",45,"[27]EohstHnKqGocIHBJCAlAoynzkdk",238,0.995816,27,239,1,238,1,1,0,1,1,110,110,129,128,91
"8047",46,"[27]EohstHnKqGocIHBJCAlAoynzkdk",230,0.995671,27,231,1,230,1,1,0,1,1,115,115,116,115,91
"8048",47,"[27]EohstHnKqGocIHBJCAlAoynzkdk",234,0.995745,27,235,1,234,1,1,0,1,1,112,112,123,122,91
"8049",48,"[27]EohstHnKqGocIHBJCAlAoynzkdk",230,0.995671,27,231,1,230,1,1,0,1,1,117,117,114,113,91
"8050",49,"[27]EohstHnKqGocIHBJCAlAoynzkdk",227,0.995614,27,228,1,227,1,1,0,1,1,117,117,111,110,91
"8051",50,"[27]EohstHnKqGocIHBJCAlAoynzkdk",230,0.995671,27,231,1,230,1,1,0,1,1,119,119,112,111,91
"8052",51,"[27]EohstHnKqGocIHBJCAlAoynzkdk",234,0.995745,27,235,1,234,1,1,0,1,1,113,113,122,121,91
"8053",52,"[27]EohstHnKqGocIHBJCAlAoynzkdk",234,0.995745,27,235,1,234,1,1,0,1,1,115,115,120,119,91
"8054",53,"[27]EohstHnKqGocIHBJCAlAoynzkdk",238,0.995816,27,239,1,238,1,1,0,1,1,109,109,130,129,91
"8055",54,"[27]EohstHnKqGocIHBJCAlAoynzkdk",227,0.995614,27,228,1,227,1,1,0,1,1,117,117,111,110,91
"8056",55,"[27]EohstHnKqGocIHBJCAlAoynzkdk",222,0.995516,27,223,1,222,1,1,0,1,1,120,120,103,102,91
"8057",56,"[27]EohstHnKqGocIHBJCAlAoynzkdk",226,0.995595,27,227,1,226,1,1,0,1,1,119,119,108,107,91
"8058",57,"[27]EohstHnKqGocIHBJCAlAoynzkdk",236,0.995781,27,237,1,236,1,1,0,1,1,110,110,127,126,91
"8059",58,"[27]EohstHnKqGocIHBJCAlAoynzkdk",230,0.995671,27,231,1,230,1,1,0,1,1,115,115,116,115,91
"8060",59,"[27]EohstHnKqGocIHBJCAlAoynzkdk",218,0.995434,27,219,1,218,1,1,0,1,1,124,124,95,94,91
"8061",60,"[27]EohstHnKqGocIHBJCAlAoynzkdk",232,0.995708,27,233,1,232,1,1,0,1,1,112,112,121,120,91
"8062",61,"[27]EohstHnKqGocIHBJCAlAoynzkdk",233,0.995726,27,234,1,233,1,1,0,1,1,117,117,117,116,91
"8063",62,"[27]EohstHnKqGocIHBJCAlAoynzkdk",224,0.995556,27,225,1,224,1,1,0,1,1,119,119,106,105,91
"8064",63,"[27]EohstHnKqGocIHBJCAlAoynzkdk",224,0.995556,27,225,1,224,1,1,0,1,1,119,119,106,105,91
"8065",64,"[27]EohstHnKqGocIHBJCAlAoynzkdk",230,0.995671,27,231,1,230,1,1,0,1,1,115,115,116,115,91
"8066",65,"[27]EohstHnKqGocIHBJCAlAoynzkdk",231,0.99569,27,232,1,231,1,1,0,1,1,113,113,119,118,91
"8067",66,"[27]EohstHnKqGocIHBJCAlAoynzkdk",231,0.99569,27,232,1,231,1,1,0,1,1,113,113,119,118,91
"8068",67,"[27]EohstHnKqGocIHBJCAlAoynzkdk",237,0.995798,27,238,1,237,1,1,0,1,1,108,108,130,129,91
"8069",68,"[27]EohstHnKqGocIHBJCAlAoynzkdk",241,0.995868,27,242,1,241,1,1,0,1,1,108,108,134,133,91
"8070",69,"[27]EohstHnKqGocIHBJCAlAoynzkdk",228,0.995633,27,229,1,228,1,1,0,1,1,116,116,113,112,91
"8071",70,"[27]EohstHnKqGocIHBJCAlAoynzkdk",234,0.995745,27,235,1,234,1,1,0,1,1,111,111,124,123,91
"8072",71,"[27]EohstHnKqGocIHBJCAlAoynzkdk",220,0.995475,27,221,1,220,1,1,0,1,1,122,122,99,98,91
"8073",72,"[27]EohstHnKqGocIHBJCAlAoynzkdk",232,0.995708,27,233,1,232,1,1,0,1,1,116,116,117,116,91
"8074",73,"[27]EohstHnKqGocIHBJCAlAoynzkdk",227,0.995614,27,228,1,227,1,1,0,1,1,116,116,112,111,91
"8075",74,"[27]EohstHnKqGocIHBJCAlAoynzkdk",220,0.995475,27,221,1,220,1,1,0,1,1,122,122,99,98,91
"8076",75,"[27]EohstHnKqGocIHBJCAlAoynzkdk",227,0.995614,27,228,1,227,1,1,0,1,1,116,116,112,111,91
"8077",76,"[27]EohstHnKqGocIHBJCAlAoynzkdk",233,0.995726,27,234,1,233,1,1,0,1,1,114,114,120,119,91
"8078",77,"[27]EohstHnKqGocIHBJCAlAoynzkdk",228,0.995633,27,229,1,228,1,1,0,1,1,116,116,113,112,91
"8079",78,"[27]EohstHnKqGocIHBJCAlAoynzkdk",223,0.995536,27,224,1,223,1,1,0,1,1,121,121,103,102,91
"8080",79,"[27]EohstHnKqGocIHBJCAlAoynzkdk",226,0.995595,27,227,1,226,1,1,0,1,1,117,117,110,109,91
"8081",80,"[27]EohstHnKqGocIHBJCAlAoynzkdk",236,0.995781,27,237,1,236,1,1,0,1,1,110,110,127,126,91
"8082",81,"[27]EohstHnKqGocIHBJCAlAoynzkdk",226,0.995595,27,227,1,226,1,1,0,1,1,121,121,106,105,91
"8083",82,"[27]EohstHnKqGocIHBJCAlAoynzkdk",235,0.995763,27,236,1,235,1,1,0,1,1,111,111,125,124,91
"8084",83,"[27]EohstHnKqGocIHBJCAlAoynzkdk",234,0.995745,27,235,1,234,1,1,0,1,1,112,112,123,122,91
"8085",84,"[27]EohstHnKqGocIHBJCAlAoynzkdk",238,0.995816,27,239,1,238,1,1,0,1,1,108,108,131,130,91
"8086",85,"[27]EohstHnKqGocIHBJCAlAoynzkdk",227,0.995614,27,228,1,227,1,1,0,1,1,116,116,112,111,91
"8087",86,"[27]EohstHnKqGocIHBJCAlAoynzkdk",234,0.995745,27,235,1,234,1,1,0,1,1,111,111,124,123,91
"8088",87,"[27]EohstHnKqGocIHBJCAlAoynzkdk",233,0.995726,27,234,1,233,1,1,0,1,1,113,113,121,120,91
"8089",88,"[27]EohstHnKqGocIHBJCAlAoynzkdk",221,0.995495,27,222,1,221,1,1,0,1,1,122,122,100,99,91
"8090",89,"[27]EohstHnKqGocIHBJCAlAoynzkdk",231,0.99569,27,232,1,231,1,1,0,1,1,117,117,115,114,91
"8091",90,"[27]EohstHnKqGocIHBJCAlAoynzkdk",230,0.995671,27,231,1,230,1,1,0,1,1,114,114,117,116,91
"8092",91,"[27]EohstHnKqGocIHBJCAlAoynzkdk",222,0.995516,27,223,1,222,1,1,0,1,1,121,121,102,101,91
"8093",92,"[27]EohstHnKqGocIHBJCAlAoynzkdk",232,0.995708,27,233,1,232,1,1,0,1,1,113,113,120,119,91
"8094",93,"[27]EohstHnKqGocIHBJCAlAoynzkdk",224,0.995556,27,225,1,224,1,1,0,1,1,120,120,105,104,91
"8095",94,"[27]EohstHnKqGocIHBJCAlAoynzkdk",229,0.995652,27,230,1,229,1,1,0,1,1,116,116,114,113,91
"8096",95,"[27]EohstHnKqGocIHBJCAlAoynzkdk",227,0.995614,27,228,1,227,1,1,0,1,1,116,116,112,111,91
"8097",96,"[27]EohstHnKqGocIHBJCAlAoynzkdk",227,0.995614,27,228,1,227,1,1,0,1,1,117,117,111,110,91
"8098",97,"[27]EohstHnKqGocIHBJCAlAoynzkdk",229,0.995652,27,230,1,229,1,1,0,1,1,116,116,114,113,91
"8099",98,"[27]EohstHnKqGocIHBJCAlAoynzkdk",229,0.995652,27,230,1,229,1,1,0,1,1,116,116,114,113,91
"8100",99,"[27]EohstHnKqGocIHBJCAlAoynzkdk",224,0.995556,27,225,1,224,1,1,0,1,1,119,119,106,105,91
"8101",0,"[25]EgrvHnKqGocIHcJCnldyKdnpe",228,0.995633,25,229,1,228,1,1,0,1,1,116,116,113,112,92
"8102",1,"[25]EgrvHnKqGocIHcJCnldyKdnpe",230,0.995671,25,231,1,230,1,1,0,1,1,114,114,117,116,92
"8103",2,"[25]EgrvHnKqGocIHcJCnldyKdnpe",241,0.995868,25,242,1,241,1,1,0,1,1,105,105,137,136,92
"8104",3,"[25]EgrvHnKqGocIHcJCnldyKdnpe",229,0.995652,25,230,1,229,1,1,0,1,1,117,117,113,112,92
"8105",4,"[25]EgrvHnKqGocIHcJCnldyKdnpe",229,0.995652,25,230,1,229,1,1,0,1,1,116,116,114,113,92
"8106",5,"[25]EgrvHnKqGocIHcJCnldyKdnpe",239,0.995833,25,240,1,239,1,1,0,1,1,108,108,132,131,92
"8107",6,"[25]EgrvHnKqGocIHcJCnldyKdnpe",229,0.995652,25,230,1,229,1,1,0,1,1,119,119,111,110,92
"8108",7,"[25]EgrvHnKqGocIHcJCnldyKdnpe",242,0.995885,25,243,1,242,1,1,0,1,1,107,107,136,135,92
"8109",8,"[25]EgrvHnKqGocIHcJCnldyKdnpe",232,0.995708,25,233,1,232,1,1,0,1,1,112,112,121,120,92
"8110",9,"[25]EgrvHnKqGocIHcJCnldyKdnpe",225,0.995575,25,226,1,225,1,1,0,1,1,119,119,107,106,92
"8111",10,"[25]EgrvHnKqGocIHcJCnldyKdnpe",231,0.99569,25,232,1,231,1,1,0,1,1,115,115,117,116,92
"8112",11,"[25]EgrvHnKqGocIHcJCnldyKdnpe",233,0.995726,25,234,1,233,1,1,0,1,1,115,115,119,118,92
"8113",12,"[25]EgrvHnKqGocIHcJCnldyKdnpe",236,0.995781,25,237,1,236,1,1,0,1,1,112,112,125,124,92
"8114",13,"[25]EgrvHnKqGocIHcJCnldyKdnpe",240,0.995851,25,241,1,240,1,1,0,1,1,107,107,134,133,92
"8115",14,"[25]EgrvHnKqGocIHcJCnldyKdnpe",211,0.995283,25,212,1,211,1,1,0,1,1,131,131,81,80,92
"8116",15,"[25]EgrvHnKqGocIHcJCnldyKdnpe",226,0.995595,25,227,1,226,1,1,0,1,1,120,120,107,106,92
"8117",16,"[25]EgrvHnKqGocIHcJCnldyKdnpe",238,0.995816,25,239,1,238,1,1,0,1,1,109,109,130,129,92
"8118",17,"[25]EgrvHnKqGocIHcJCnldyKdnpe",229,0.995652,25,230,1,229,1,1,0,1,1,116,116,114,113,92
"8119",18,"[25]EgrvHnKqGocIHcJCnldyKdnpe",221,0.995495,25,222,1,221,1,1,0,1,1,122,122,100,99,92
"8120",19,"[25]EgrvHnKqGocIHcJCnldyKdnpe",230,0.995671,25,231,1,230,1,1,0,1,1,114,114,117,116,92
"8121",20,"[25]EgrvHnKqGocIHcJCnldyKdnpe",230,0.995671,25,231,1,230,1,1,0,1,1,115,115,116,115,92
"8122",21,"[25]EgrvHnKqGocIHcJCnldyKdnpe",216,0.995392,25,217,1,216,1,1,0,1,1,126,126,91,90,92
"8123",22,"[25]EgrvHnKqGocIHcJCnldyKdnpe",227,0.995614,25,228,1,227,1,1,0,1,1,117,117,111,110,92
"8124",23,"[25]EgrvHnKqGocIHcJCnldyKdnpe",225,0.995575,25,226,1,225,1,1,0,1,1,118,118,108,107,92
"8125",24,"[25]EgrvHnKqGocIHcJCnldyKdnpe",244,0.995918,25,245,1,244,1,1,0,1,1,103,103,142,141,92
"8126",25,"[25]EgrvHnKqGocIHcJCnldyKdnpe",244,0.995918,25,245,1,244,1,1,0,1,1,105,105,140,139,92
"8127",26,"[25]EgrvHnKqGocIHcJCnldyKdnpe",222,0.995516,25,223,1,222,1,1,0,1,1,120,120,103,102,92
"8128",27,"[25]EgrvHnKqGocIHcJCnldyKdnpe",226,0.995595,25,227,1,226,1,1,0,1,1,117,117,110,109,92
"8129",28,"[25]EgrvHnKqGocIHcJCnldyKdnpe",232,0.995708,25,233,1,232,1,1,0,1,1,113,113,120,119,92
"8130",29,"[25]EgrvHnKqGocIHcJCnldyKdnpe",226,0.995595,25,227,1,226,1,1,0,1,1,122,122,105,104,92
"8131",30,"[25]EgrvHnKqGocIHcJCnldyKdnpe",224,0.995556,25,225,1,224,1,1,0,1,1,119,119,106,105,92
"8132",31,"[25]EgrvHnKqGocIHcJCnldyKdnpe",235,0.995763,25,236,1,235,1,1,0,1,1,110,110,126,125,92
"8133",32,"[25]EgrvHnKqGocIHcJCnldyKdnpe",243,0.995902,25,244,1,243,1,1,0,1,1,106,106,138,137,92
"8134",33,"[25]EgrvHnKqGocIHcJCnldyKdnpe",226,0.995595,25,227,1,226,1,1,0,1,1,117,117,110,109,92
"8135",34,"[25]EgrvHnKqGocIHcJCnldyKdnpe",222,0.995516,25,223,1,222,1,1,0,1,1,120,120,103,102,92
"8136",35,"[25]EgrvHnKqGocIHcJCnldyKdnpe",228,0.995633,25,229,1,228,1,1,0,1,1,117,117,112,111,92
"8137",36,"[25]EgrvHnKqGocIHcJCnldyKdnpe",229,0.995652,25,230,1,229,1,1,0,1,1,115,115,115,114,92
"8138",37,"[25]EgrvHnKqGocIHcJCnldyKdnpe",227,0.995614,25,228,1,227,1,1,0,1,1,119,119,109,108,92
"8139",38,"[25]EgrvHnKqGocIHcJCnldyKdnpe",233,0.995726,25,234,1,233,1,1,0,1,1,112,112,122,121,92
"8140",39,"[25]EgrvHnKqGocIHcJCnldyKdnpe",236,0.995781,25,237,1,236,1,1,0,1,1,111,111,126,125,92
"8141",40,"[25]EgrvHnKqGocIHcJCnldyKdnpe",235,0.995763,25,236,1,235,1,1,0,1,1,111,111,125,124,92
"8142",41,"[25]EgrvHnKqGocIHcJCnldyKdnpe",232,0.995708,25,233,1,232,1,1,0,1,1,113,113,120,119,92
"8143",42,"[25]EgrvHnKqGocIHcJCnldyKdnpe",238,0.995816,25,239,1,238,1,1,0,1,1,108,108,131,130,92
"8144",43,"[25]EgrvHnKqGocIHcJCnldyKdnpe",230,0.995671,25,231,1,230,1,1,0,1,1,115,115,116,115,92
"8145",44,"[25]EgrvHnKqGocIHcJCnldyKdnpe",230,0.995671,25,231,1,230,1,1,0,1,1,114,114,117,116,92
"8146",45,"[25]EgrvHnKqGocIHcJCnldyKdnpe",226,0.995595,25,227,1,226,1,1,0,1,1,118,118,109,108,92
"8147",46,"[25]EgrvHnKqGocIHcJCnldyKdnpe",227,0.995614,25,228,1,227,1,1,0,1,1,119,119,109,108,92
"8148",47,"[25]EgrvHnKqGocIHcJCnldyKdnpe",225,0.995575,25,226,1,225,1,1,0,1,1,119,119,107,106,92
"8149",48,"[25]EgrvHnKqGocIHcJCnldyKdnpe",232,0.995708,25,233,1,232,1,1,0,1,1,115,115,118,117,92
"8150",49,"[25]EgrvHnKqGocIHcJCnldyKdnpe",237,0.995798,25,238,1,237,1,1,0,1,1,109,109,129,128,92
"8151",50,"[25]EgrvHnKqGocIHcJCnldyKdnpe",231,0.99569,25,232,1,231,1,1,0,1,1,115,115,117,116,92
"8152",51,"[25]EgrvHnKqGocIHcJCnldyKdnpe",228,0.995633,25,229,1,228,1,1,0,1,1,116,116,113,112,92
"8153",52,"[25]EgrvHnKqGocIHcJCnldyKdnpe",237,0.995798,25,238,1,237,1,1,0,1,1,109,109,129,128,92
"8154",53,"[25]EgrvHnKqGocIHcJCnldyKdnpe",237,0.995798,25,238,1,237,1,1,0,1,1,110,110,128,127,92
"8155",54,"[25]EgrvHnKqGocIHcJCnldyKdnpe",220,0.995475,25,221,1,220,1,1,0,1,1,122,122,99,98,92
"8156",55,"[25]EgrvHnKqGocIHcJCnldyKdnpe",231,0.99569,25,232,1,231,1,1,0,1,1,115,115,117,116,92
"8157",56,"[25]EgrvHnKqGocIHcJCnldyKdnpe",225,0.995575,25,226,1,225,1,1,0,1,1,118,118,108,107,92
"8158",57,"[25]EgrvHnKqGocIHcJCnldyKdnpe",233,0.995726,25,234,1,233,1,1,0,1,1,112,112,122,121,92
"8159",58,"[25]EgrvHnKqGocIHcJCnldyKdnpe",229,0.995652,25,230,1,229,1,1,0,1,1,116,116,114,113,92
"8160",59,"[25]EgrvHnKqGocIHcJCnldyKdnpe",219,0.995455,25,220,1,219,1,1,0,1,1,124,124,96,95,92
"8161",60,"[25]EgrvHnKqGocIHcJCnldyKdnpe",226,0.995595,25,227,1,226,1,1,0,1,1,117,117,110,109,92
"8162",61,"[25]EgrvHnKqGocIHcJCnldyKdnpe",225,0.995575,25,226,1,225,1,1,0,1,1,118,118,108,107,92
"8163",62,"[25]EgrvHnKqGocIHcJCnldyKdnpe",221,0.995495,25,222,1,221,1,1,0,1,1,122,122,100,99,92
"8164",63,"[25]EgrvHnKqGocIHcJCnldyKdnpe",234,0.995745,25,235,1,234,1,1,0,1,1,111,111,124,123,92
"8165",64,"[25]EgrvHnKqGocIHcJCnldyKdnpe",234,0.995745,25,235,1,234,1,1,0,1,1,111,111,124,123,92
"8166",65,"[25]EgrvHnKqGocIHcJCnldyKdnpe",239,0.995833,25,240,1,239,1,1,0,1,1,108,108,132,131,92
"8167",66,"[25]EgrvHnKqGocIHcJCnldyKdnpe",235,0.995763,25,236,1,235,1,1,0,1,1,111,111,125,124,92
"8168",67,"[25]EgrvHnKqGocIHcJCnldyKdnpe",236,0.995781,25,237,1,236,1,1,0,1,1,109,109,128,127,92
"8169",68,"[25]EgrvHnKqGocIHcJCnldyKdnpe",233,0.995726,25,234,1,233,1,1,0,1,1,112,112,122,121,92
"8170",69,"[25]EgrvHnKqGocIHcJCnldyKdnpe",230,0.995671,25,231,1,230,1,1,0,1,1,114,114,117,116,92
"8171",70,"[25]EgrvHnKqGocIHcJCnldyKdnpe",238,0.995816,25,239,1,238,1,1,0,1,1,110,110,129,128,92
"8172",71,"[25]EgrvHnKqGocIHcJCnldyKdnpe",246,0.995951,25,247,1,246,1,1,0,1,1,110,110,137,136,92
"8173",72,"[25]EgrvHnKqGocIHcJCnldyKdnpe",229,0.995652,25,230,1,229,1,1,0,1,1,115,115,115,114,92
"8174",73,"[25]EgrvHnKqGocIHcJCnldyKdnpe",224,0.995556,25,225,1,224,1,1,0,1,1,122,122,103,102,92
"8175",74,"[25]EgrvHnKqGocIHcJCnldyKdnpe",229,0.995652,25,230,1,229,1,1,0,1,1,116,116,114,113,92
"8176",75,"[25]EgrvHnKqGocIHcJCnldyKdnpe",233,0.995726,25,234,1,233,1,1,0,1,1,112,112,122,121,92
"8177",76,"[25]EgrvHnKqGocIHcJCnldyKdnpe",247,0.995968,25,248,1,247,1,1,0,1,1,107,107,141,140,92
"8178",77,"[25]EgrvHnKqGocIHcJCnldyKdnpe",226,0.995595,25,227,1,226,1,1,0,1,1,118,118,109,108,92
"8179",78,"[25]EgrvHnKqGocIHcJCnldyKdnpe",223,0.995536,25,224,1,223,1,1,0,1,1,121,121,103,102,92
"8180",79,"[25]EgrvHnKqGocIHcJCnldyKdnpe",225,0.995575,25,226,1,225,1,1,0,1,1,119,119,107,106,92
"8181",80,"[25]EgrvHnKqGocIHcJCnldyKdnpe",229,0.995652,25,230,1,229,1,1,0,1,1,116,116,114,113,92
"8182",81,"[25]EgrvHnKqGocIHcJCnldyKdnpe",237,0.995798,25,238,1,237,1,1,0,1,1,109,109,129,128,92
"8183",82,"[25]EgrvHnKqGocIHcJCnldyKdnpe",227,0.995614,25,228,1,227,1,1,0,1,1,116,116,112,111,92
"8184",83,"[25]EgrvHnKqGocIHcJCnldyKdnpe",239,0.995833,25,240,1,239,1,1,0,1,1,107,107,133,132,92
"8185",84,"[25]EgrvHnKqGocIHcJCnldyKdnpe",239,0.995833,25,240,1,239,1,1,0,1,1,111,111,129,128,92
"8186",85,"[25]EgrvHnKqGocIHcJCnldyKdnpe",230,0.995671,25,231,1,230,1,1,0,1,1,117,117,114,113,92
"8187",86,"[25]EgrvHnKqGocIHcJCnldyKdnpe",224,0.995556,25,225,1,224,1,1,0,1,1,120,120,105,104,92
"8188",87,"[25]EgrvHnKqGocIHcJCnldyKdnpe",227,0.995614,25,228,1,227,1,1,0,1,1,117,117,111,110,92
"8189",88,"[25]EgrvHnKqGocIHcJCnldyKdnpe",227,0.995614,25,228,1,227,1,1,0,1,1,117,117,111,110,92
"8190",89,"[25]EgrvHnKqGocIHcJCnldyKdnpe",227,0.995614,25,228,1,227,1,1,0,1,1,116,116,112,111,92
"8191",90,"[25]EgrvHnKqGocIHcJCnldyKdnpe",232,0.995708,25,233,1,232,1,1,0,1,1,113,113,120,119,92
"8192",91,"[25]EgrvHnKqGocIHcJCnldyKdnpe",229,0.995652,25,230,1,229,1,1,0,1,1,117,117,113,112,92
"8193",92,"[25]EgrvHnKqGocIHcJCnldyKdnpe",230,0.995671,25,231,1,230,1,1,0,1,1,114,114,117,116,92
"8194",93,"[25]EgrvHnKqGocIHcJCnldyKdnpe",227,0.995614,25,228,1,227,1,1,0,1,1,118,118,110,109,92
"8195",94,"[25]EgrvHnKqGocIHcJCnldyKdnpe",235,0.995763,25,236,1,235,1,1,0,1,1,110,110,126,125,92
"8196",95,"[25]EgrvHnKqGocIHcJCnldyKdnpe",229,0.995652,25,230,1,229,1,1,0,1,1,115,115,115,114,92
"8197",96,"[25]EgrvHnKqGocIHcJCnldyKdnpe",237,0.995798,25,238,1,237,1,1,0,1,1,108,108,130,129,92
"8198",97,"[25]EgrvHnKqGocIHcJCnldyKdnpe",238,0.995816,25,239,1,238,1,1,0,1,1,110,110,129,128,92
"8199",98,"[25]EgrvHnKqGocIHcJCnldyKdnpe",221,0.995495,25,222,1,221,1,1,0,1,1,121,121,101,100,92
"8200",99,"[25]EgrvHnKqGocIHcJCnldyKdnpe",235,0.995763,25,236,1,235,1,1,0,1,1,112,112,124,123,92
"8201",0,"[28]EtAGwHnKqGocIHcJCjeEnttokHgd",234,0.995745,28,235,1,234,1,1,0,1,1,112,112,123,122,93
"8202",1,"[28]EtAGwHnKqGocIHcJCjeEnttokHgd",225,0.995575,28,226,1,225,1,1,0,1,1,121,121,105,104,93
"8203",2,"[28]EtAGwHnKqGocIHcJCjeEnttokHgd",225,0.995575,28,226,1,225,1,1,0,1,1,119,119,107,106,93
"8204",3,"[28]EtAGwHnKqGocIHcJCjeEnttokHgd",228,0.995633,28,229,1,228,1,1,0,1,1,116,116,113,112,93
"8205",4,"[28]EtAGwHnKqGocIHcJCjeEnttokHgd",230,0.995671,28,231,1,230,1,1,0,1,1,115,115,116,115,93
"8206",5,"[28]EtAGwHnKqGocIHcJCjeEnttokHgd",230,0.995671,28,231,1,230,1,1,0,1,1,114,114,117,116,93
"8207",6,"[28]EtAGwHnKqGocIHcJCjeEnttokHgd",230,0.995671,28,231,1,230,1,1,0,1,1,115,115,116,115,93
"8208",7,"[28]EtAGwHnKqGocIHcJCjeEnttokHgd",230,0.995671,28,231,1,230,1,1,0,1,1,114,114,117,116,93
"8209",8,"[28]EtAGwHnKqGocIHcJCjeEnttokHgd",231,0.99569,28,232,1,231,1,1,0,1,1,115,115,117,116,93
"8210",9,"[28]EtAGwHnKqGocIHcJCjeEnttokHgd",238,0.995816,28,239,1,238,1,1,0,1,1,111,111,128,127,93
"8211",10,"[28]EtAGwHnKqGocIHcJCjeEnttokHgd",230,0.995671,28,231,1,230,1,1,0,1,1,115,115,116,115,93
"8212",11,"[28]EtAGwHnKqGocIHcJCjeEnttokHgd",227,0.995614,28,228,1,227,1,1,0,1,1,117,117,111,110,93
"8213",12,"[28]EtAGwHnKqGocIHcJCjeEnttokHgd",232,0.995708,28,233,1,232,1,1,0,1,1,118,118,115,114,93
"8214",13,"[28]EtAGwHnKqGocIHcJCjeEnttokHgd",226,0.995595,28,227,1,226,1,1,0,1,1,117,117,110,109,93
"8215",14,"[28]EtAGwHnKqGocIHcJCjeEnttokHgd",245,0.995935,28,246,1,245,1,1,0,1,1,105,105,141,140,93
"8216",15,"[28]EtAGwHnKqGocIHcJCjeEnttokHgd",229,0.995652,28,230,1,229,1,1,0,1,1,115,115,115,114,93
"8217",16,"[28]EtAGwHnKqGocIHcJCjeEnttokHgd",231,0.99569,28,232,1,231,1,1,0,1,1,114,114,118,117,93
"8218",17,"[28]EtAGwHnKqGocIHcJCjeEnttokHgd",226,0.995595,28,227,1,226,1,1,0,1,1,117,117,110,109,93
"8219",18,"[28]EtAGwHnKqGocIHcJCjeEnttokHgd",225,0.995575,28,226,1,225,1,1,0,1,1,118,118,108,107,93
"8220",19,"[28]EtAGwHnKqGocIHcJCjeEnttokHgd",229,0.995652,28,230,1,229,1,1,0,1,1,116,116,114,113,93
"8221",20,"[28]EtAGwHnKqGocIHcJCjeEnttokHgd",232,0.995708,28,233,1,232,1,1,0,1,1,113,113,120,119,93
"8222",21,"[28]EtAGwHnKqGocIHcJCjeEnttokHgd",234,0.995745,28,235,1,234,1,1,0,1,1,111,111,124,123,93
"8223",22,"[28]EtAGwHnKqGocIHcJCjeEnttokHgd",226,0.995595,28,227,1,226,1,1,0,1,1,118,118,109,108,93
"8224",23,"[28]EtAGwHnKqGocIHcJCjeEnttokHgd",225,0.995575,28,226,1,225,1,1,0,1,1,119,119,107,106,93
"8225",24,"[28]EtAGwHnKqGocIHcJCjeEnttokHgd",218,0.995434,28,219,1,218,1,1,0,1,1,124,124,95,94,93
"8226",25,"[28]EtAGwHnKqGocIHcJCjeEnttokHgd",231,0.99569,28,232,1,231,1,1,0,1,1,116,116,116,115,93
"8227",26,"[28]EtAGwHnKqGocIHcJCjeEnttokHgd",228,0.995633,28,229,1,228,1,1,0,1,1,116,116,113,112,93
"8228",27,"[28]EtAGwHnKqGocIHcJCjeEnttokHgd",231,0.99569,28,232,1,231,1,1,0,1,1,113,113,119,118,93
"8229",28,"[28]EtAGwHnKqGocIHcJCjeEnttokHgd",231,0.99569,28,232,1,231,1,1,0,1,1,113,113,119,118,93
"8230",29,"[28]EtAGwHnKqGocIHcJCjeEnttokHgd",222,0.995516,28,223,1,222,1,1,0,1,1,121,121,102,101,93
"8231",30,"[28]EtAGwHnKqGocIHcJCjeEnttokHgd",237,0.995798,28,238,1,237,1,1,0,1,1,110,110,128,127,93
"8232",31,"[28]EtAGwHnKqGocIHcJCjeEnttokHgd",233,0.995726,28,234,1,233,1,1,0,1,1,114,114,120,119,93
"8233",32,"[28]EtAGwHnKqGocIHcJCjeEnttokHgd",238,0.995816,28,239,1,238,1,1,0,1,1,107,107,132,131,93
"8234",33,"[28]EtAGwHnKqGocIHcJCjeEnttokHgd",232,0.995708,28,233,1,232,1,1,0,1,1,113,113,120,119,93
"8235",34,"[28]EtAGwHnKqGocIHcJCjeEnttokHgd",231,0.99569,28,232,1,231,1,1,0,1,1,113,113,119,118,93
"8236",35,"[28]EtAGwHnKqGocIHcJCjeEnttokHgd",241,0.995868,28,242,1,241,1,1,0,1,1,111,111,131,130,93
"8237",36,"[28]EtAGwHnKqGocIHcJCjeEnttokHgd",228,0.995633,28,229,1,228,1,1,0,1,1,115,115,114,113,93
"8238",37,"[28]EtAGwHnKqGocIHcJCjeEnttokHgd",223,0.995536,28,224,1,223,1,1,0,1,1,119,119,105,104,93
"8239",38,"[28]EtAGwHnKqGocIHcJCjeEnttokHgd",233,0.995726,28,234,1,233,1,1,0,1,1,111,111,123,122,93
"8240",39,"[28]EtAGwHnKqGocIHcJCjeEnttokHgd",226,0.995595,28,227,1,226,1,1,0,1,1,117,117,110,109,93
"8241",40,"[28]EtAGwHnKqGocIHcJCjeEnttokHgd",225,0.995575,28,226,1,225,1,1,0,1,1,118,118,108,107,93
"8242",41,"[28]EtAGwHnKqGocIHcJCjeEnttokHgd",217,0.995413,28,218,1,217,1,1,0,1,1,124,124,94,93,93
"8243",42,"[28]EtAGwHnKqGocIHcJCjeEnttokHgd",235,0.995763,28,236,1,235,1,1,0,1,1,111,111,125,124,93
"8244",43,"[28]EtAGwHnKqGocIHcJCjeEnttokHgd",236,0.995781,28,237,1,236,1,1,0,1,1,112,112,125,124,93
"8245",44,"[28]EtAGwHnKqGocIHcJCjeEnttokHgd",237,0.995798,28,238,1,237,1,1,0,1,1,109,109,129,128,93
"8246",45,"[28]EtAGwHnKqGocIHcJCjeEnttokHgd",233,0.995726,28,234,1,233,1,1,0,1,1,112,112,122,121,93
"8247",46,"[28]EtAGwHnKqGocIHcJCjeEnttokHgd",230,0.995671,28,231,1,230,1,1,0,1,1,114,114,117,116,93
"8248",47,"[28]EtAGwHnKqGocIHcJCjeEnttokHgd",230,0.995671,28,231,1,230,1,1,0,1,1,114,114,117,116,93
"8249",48,"[28]EtAGwHnKqGocIHcJCjeEnttokHgd",232,0.995708,28,233,1,232,1,1,0,1,1,112,112,121,120,93
"8250",49,"[28]EtAGwHnKqGocIHcJCjeEnttokHgd",233,0.995726,28,234,1,233,1,1,0,1,1,112,112,122,121,93
"8251",50,"[28]EtAGwHnKqGocIHcJCjeEnttokHgd",229,0.995652,28,230,1,229,1,1,0,1,1,115,115,115,114,93
"8252",51,"[28]EtAGwHnKqGocIHcJCjeEnttokHgd",233,0.995726,28,234,1,233,1,1,0,1,1,113,113,121,120,93
"8253",52,"[28]EtAGwHnKqGocIHcJCjeEnttokHgd",227,0.995614,28,228,1,227,1,1,0,1,1,116,116,112,111,93
"8254",53,"[28]EtAGwHnKqGocIHcJCjeEnttokHgd",225,0.995575,28,226,1,225,1,1,0,1,1,118,118,108,107,93
"8255",54,"[28]EtAGwHnKqGocIHcJCjeEnttokHgd",222,0.995516,28,223,1,222,1,1,0,1,1,120,120,103,102,93
"8256",55,"[28]EtAGwHnKqGocIHcJCjeEnttokHgd",229,0.995652,28,230,1,229,1,1,0,1,1,116,116,114,113,93
"8257",56,"[28]EtAGwHnKqGocIHcJCjeEnttokHgd",238,0.995816,28,239,1,238,1,1,0,1,1,109,109,130,129,93
"8258",57,"[28]EtAGwHnKqGocIHcJCjeEnttokHgd",223,0.995536,28,224,1,223,1,1,0,1,1,119,119,105,104,93
"8259",58,"[28]EtAGwHnKqGocIHcJCjeEnttokHgd",217,0.995413,28,218,1,217,1,1,0,1,1,125,125,93,92,93
"8260",59,"[28]EtAGwHnKqGocIHcJCjeEnttokHgd",224,0.995556,28,225,1,224,1,1,0,1,1,122,122,103,102,93
"8261",60,"[28]EtAGwHnKqGocIHcJCjeEnttokHgd",232,0.995708,28,233,1,232,1,1,0,1,1,112,112,121,120,93
"8262",61,"[28]EtAGwHnKqGocIHcJCjeEnttokHgd",242,0.995885,28,243,1,242,1,1,0,1,1,106,106,137,136,93
"8263",62,"[28]EtAGwHnKqGocIHcJCjeEnttokHgd",232,0.995708,28,233,1,232,1,1,0,1,1,113,113,120,119,93
"8264",63,"[28]EtAGwHnKqGocIHcJCjeEnttokHgd",218,0.995434,28,219,1,218,1,1,0,1,1,124,124,95,94,93
"8265",64,"[28]EtAGwHnKqGocIHcJCjeEnttokHgd",233,0.995726,28,234,1,233,1,1,0,1,1,111,111,123,122,93
"8266",65,"[28]EtAGwHnKqGocIHcJCjeEnttokHgd",223,0.995536,28,224,1,223,1,1,0,1,1,120,120,104,103,93
"8267",66,"[28]EtAGwHnKqGocIHcJCjeEnttokHgd",226,0.995595,28,227,1,226,1,1,0,1,1,117,117,110,109,93
"8268",67,"[28]EtAGwHnKqGocIHcJCjeEnttokHgd",233,0.995726,28,234,1,233,1,1,0,1,1,114,114,120,119,93
"8269",68,"[28]EtAGwHnKqGocIHcJCjeEnttokHgd",228,0.995633,28,229,1,228,1,1,0,1,1,120,120,109,108,93
"8270",69,"[28]EtAGwHnKqGocIHcJCjeEnttokHgd",227,0.995614,28,228,1,227,1,1,0,1,1,117,117,111,110,93
"8271",70,"[28]EtAGwHnKqGocIHcJCjeEnttokHgd",222,0.995516,28,223,1,222,1,1,0,1,1,120,120,103,102,93
"8272",71,"[28]EtAGwHnKqGocIHcJCjeEnttokHgd",227,0.995614,28,228,1,227,1,1,0,1,1,117,117,111,110,93
"8273",72,"[28]EtAGwHnKqGocIHcJCjeEnttokHgd",215,0.99537,28,216,1,215,1,1,0,1,1,126,126,90,89,93
"8274",73,"[28]EtAGwHnKqGocIHcJCjeEnttokHgd",242,0.995885,28,243,1,242,1,1,0,1,1,107,107,136,135,93
"8275",74,"[28]EtAGwHnKqGocIHcJCjeEnttokHgd",232,0.995708,28,233,1,232,1,1,0,1,1,114,114,119,118,93
"8276",75,"[28]EtAGwHnKqGocIHcJCjeEnttokHgd",229,0.995652,28,230,1,229,1,1,0,1,1,115,115,115,114,93
"8277",76,"[28]EtAGwHnKqGocIHcJCjeEnttokHgd",232,0.995708,28,233,1,232,1,1,0,1,1,115,115,118,117,93
"8278",77,"[28]EtAGwHnKqGocIHcJCjeEnttokHgd",232,0.995708,28,233,1,232,1,1,0,1,1,114,114,119,118,93
"8279",78,"[28]EtAGwHnKqGocIHcJCjeEnttokHgd",231,0.99569,28,232,1,231,1,1,0,1,1,115,115,117,116,93
"8280",79,"[28]EtAGwHnKqGocIHcJCjeEnttokHgd",232,0.995708,28,233,1,232,1,1,0,1,1,112,112,121,120,93
"8281",80,"[28]EtAGwHnKqGocIHcJCjeEnttokHgd",230,0.995671,28,231,1,230,1,1,0,1,1,114,114,117,116,93
"8282",81,"[28]EtAGwHnKqGocIHcJCjeEnttokHgd",233,0.995726,28,234,1,233,1,1,0,1,1,111,111,123,122,93
"8283",82,"[28]EtAGwHnKqGocIHcJCjeEnttokHgd",228,0.995633,28,229,1,228,1,1,0,1,1,115,115,114,113,93
"8284",83,"[28]EtAGwHnKqGocIHcJCjeEnttokHgd",226,0.995595,28,227,1,226,1,1,0,1,1,119,119,108,107,93
"8285",84,"[28]EtAGwHnKqGocIHcJCjeEnttokHgd",224,0.995556,28,225,1,224,1,1,0,1,1,119,119,106,105,93
"8286",85,"[28]EtAGwHnKqGocIHcJCjeEnttokHgd",222,0.995516,28,223,1,222,1,1,0,1,1,120,120,103,102,93
"8287",86,"[28]EtAGwHnKqGocIHcJCjeEnttokHgd",233,0.995726,28,234,1,233,1,1,0,1,1,113,113,121,120,93
"8288",87,"[28]EtAGwHnKqGocIHcJCjeEnttokHgd",229,0.995652,28,230,1,229,1,1,0,1,1,115,115,115,114,93
"8289",88,"[28]EtAGwHnKqGocIHcJCjeEnttokHgd",236,0.995781,28,237,1,236,1,1,0,1,1,110,110,127,126,93
"8290",89,"[28]EtAGwHnKqGocIHcJCjeEnttokHgd",223,0.995536,28,224,1,223,1,1,0,1,1,120,120,104,103,93
"8291",90,"[28]EtAGwHnKqGocIHcJCjeEnttokHgd",220,0.995475,28,221,1,220,1,1,0,1,1,124,124,97,96,93
"8292",91,"[28]EtAGwHnKqGocIHcJCjeEnttokHgd",235,0.995763,28,236,1,235,1,1,0,1,1,110,110,126,125,93
"8293",92,"[28]EtAGwHnKqGocIHcJCjeEnttokHgd",232,0.995708,28,233,1,232,1,1,0,1,1,114,114,119,118,93
"8294",93,"[28]EtAGwHnKqGocIHcJCjeEnttokHgd",227,0.995614,28,228,1,227,1,1,0,1,1,118,118,110,109,93
"8295",94,"[28]EtAGwHnKqGocIHcJCjeEnttokHgd",230,0.995671,28,231,1,230,1,1,0,1,1,116,116,115,114,93
"8296",95,"[28]EtAGwHnKqGocIHcJCjeEnttokHgd",231,0.99569,28,232,1,231,1,1,0,1,1,115,115,117,116,93
"8297",96,"[28]EtAGwHnKqGocIHcJCjeEnttokHgd",238,0.995816,28,239,1,238,1,1,0,1,1,109,109,130,129,93
"8298",97,"[28]EtAGwHnKqGocIHcJCjeEnttokHgd",225,0.995575,28,226,1,225,1,1,0,1,1,118,118,108,107,93
"8299",98,"[28]EtAGwHnKqGocIHcJCjeEnttokHgd",231,0.99569,28,232,1,231,1,1,0,1,1,115,115,117,116,93
"8300",99,"[28]EtAGwHnKqGocIHcJCjeEnttokHgd",234,0.995745,28,235,1,234,1,1,0,1,1,112,112,123,122,93
"8301",0,"[32]EimnhxHnKqGocIHcJCxKtbJrAAnJFupu",239,0.995833,32,240,1,239,1,1,0,1,1,107,107,133,132,95
"8302",1,"[32]EimnhxHnKqGocIHcJCxKtbJrAAnJFupu",228,0.995633,32,229,1,228,1,1,0,1,1,116,116,113,112,95
"8303",2,"[32]EimnhxHnKqGocIHcJCxKtbJrAAnJFupu",231,0.99569,32,232,1,231,1,1,0,1,1,117,117,115,114,95
"8304",3,"[32]EimnhxHnKqGocIHcJCxKtbJrAAnJFupu",223,0.995536,32,224,1,223,1,1,0,1,1,120,120,104,103,95
"8305",4,"[32]EimnhxHnKqGocIHcJCxKtbJrAAnJFupu",221,0.995495,32,222,1,221,1,1,0,1,1,121,121,101,100,95
"8306",5,"[32]EimnhxHnKqGocIHcJCxKtbJrAAnJFupu",227,0.995614,32,228,1,227,1,1,0,1,1,117,117,111,110,95
"8307",6,"[32]EimnhxHnKqGocIHcJCxKtbJrAAnJFupu",227,0.995614,32,228,1,227,1,1,0,1,1,117,117,111,110,95
"8308",7,"[32]EimnhxHnKqGocIHcJCxKtbJrAAnJFupu",226,0.995595,32,227,1,226,1,1,0,1,1,117,117,110,109,95
"8309",8,"[32]EimnhxHnKqGocIHcJCxKtbJrAAnJFupu",235,0.995763,32,236,1,235,1,1,0,1,1,110,110,126,125,95
"8310",9,"[32]EimnhxHnKqGocIHcJCxKtbJrAAnJFupu",232,0.995708,32,233,1,232,1,1,0,1,1,113,113,120,119,95
"8311",10,"[32]EimnhxHnKqGocIHcJCxKtbJrAAnJFupu",244,0.995918,32,245,1,244,1,1,0,1,1,104,104,141,140,95
"8312",11,"[32]EimnhxHnKqGocIHcJCxKtbJrAAnJFupu",228,0.995633,32,229,1,228,1,1,0,1,1,117,117,112,111,95
"8313",12,"[32]EimnhxHnKqGocIHcJCxKtbJrAAnJFupu",229,0.995652,32,230,1,229,1,1,0,1,1,116,116,114,113,95
"8314",13,"[32]EimnhxHnKqGocIHcJCxKtbJrAAnJFupu",235,0.995763,32,236,1,235,1,1,0,1,1,111,111,125,124,95
"8315",14,"[32]EimnhxHnKqGocIHcJCxKtbJrAAnJFupu",234,0.995745,32,235,1,234,1,1,0,1,1,111,111,124,123,95
"8316",15,"[32]EimnhxHnKqGocIHcJCxKtbJrAAnJFupu",233,0.995726,32,234,1,233,1,1,0,1,1,112,112,122,121,95
"8317",16,"[32]EimnhxHnKqGocIHcJCxKtbJrAAnJFupu",246,0.995951,32,247,1,246,1,1,0,1,1,104,104,143,142,95
"8318",17,"[32]EimnhxHnKqGocIHcJCxKtbJrAAnJFupu",234,0.995745,32,235,1,234,1,1,0,1,1,113,113,122,121,95
"8319",18,"[32]EimnhxHnKqGocIHcJCxKtbJrAAnJFupu",235,0.995763,32,236,1,235,1,1,0,1,1,111,111,125,124,95
"8320",19,"[32]EimnhxHnKqGocIHcJCxKtbJrAAnJFupu",230,0.995671,32,231,1,230,1,1,0,1,1,116,116,115,114,95
"8321",20,"[32]EimnhxHnKqGocIHcJCxKtbJrAAnJFupu",236,0.995781,32,237,1,236,1,1,0,1,1,113,113,124,123,95
"8322",21,"[32]EimnhxHnKqGocIHcJCxKtbJrAAnJFupu",236,0.995781,32,237,1,236,1,1,0,1,1,109,109,128,127,95
"8323",22,"[32]EimnhxHnKqGocIHcJCxKtbJrAAnJFupu",224,0.995556,32,225,1,224,1,1,0,1,1,120,120,105,104,95
"8324",23,"[32]EimnhxHnKqGocIHcJCxKtbJrAAnJFupu",220,0.995475,32,221,1,220,1,1,0,1,1,122,122,99,98,95
"8325",24,"[32]EimnhxHnKqGocIHcJCxKtbJrAAnJFupu",227,0.995614,32,228,1,227,1,1,0,1,1,117,117,111,110,95
"8326",25,"[32]EimnhxHnKqGocIHcJCxKtbJrAAnJFupu",230,0.995671,32,231,1,230,1,1,0,1,1,114,114,117,116,95
"8327",26,"[32]EimnhxHnKqGocIHcJCxKtbJrAAnJFupu",228,0.995633,32,229,1,228,1,1,0,1,1,115,115,114,113,95
"8328",27,"[32]EimnhxHnKqGocIHcJCxKtbJrAAnJFupu",244,0.995918,32,245,1,244,1,1,0,1,1,103,103,142,141,95
"8329",28,"[32]EimnhxHnKqGocIHcJCxKtbJrAAnJFupu",218,0.995434,32,219,1,218,1,1,0,1,1,123,123,96,95,95
"8330",29,"[32]EimnhxHnKqGocIHcJCxKtbJrAAnJFupu",229,0.995652,32,230,1,229,1,1,0,1,1,115,115,115,114,95
"8331",30,"[32]EimnhxHnKqGocIHcJCxKtbJrAAnJFupu",237,0.995798,32,238,1,237,1,1,0,1,1,110,110,128,127,95
"8332",31,"[32]EimnhxHnKqGocIHcJCxKtbJrAAnJFupu",224,0.995556,32,225,1,224,1,1,0,1,1,121,121,104,103,95
"8333",32,"[32]EimnhxHnKqGocIHcJCxKtbJrAAnJFupu",231,0.99569,32,232,1,231,1,1,0,1,1,115,115,117,116,95
"8334",33,"[32]EimnhxHnKqGocIHcJCxKtbJrAAnJFupu",236,0.995781,32,237,1,236,1,1,0,1,1,113,113,124,123,95
"8335",34,"[32]EimnhxHnKqGocIHcJCxKtbJrAAnJFupu",225,0.995575,32,226,1,225,1,1,0,1,1,119,119,107,106,95
"8336",35,"[32]EimnhxHnKqGocIHcJCxKtbJrAAnJFupu",224,0.995556,32,225,1,224,1,1,0,1,1,119,119,106,105,95
"8337",36,"[32]EimnhxHnKqGocIHcJCxKtbJrAAnJFupu",225,0.995575,32,226,1,225,1,1,0,1,1,119,119,107,106,95
"8338",37,"[32]EimnhxHnKqGocIHcJCxKtbJrAAnJFupu",233,0.995726,32,234,1,233,1,1,0,1,1,111,111,123,122,95
"8339",38,"[32]EimnhxHnKqGocIHcJCxKtbJrAAnJFupu",233,0.995726,32,234,1,233,1,1,0,1,1,115,115,119,118,95
"8340",39,"[32]EimnhxHnKqGocIHcJCxKtbJrAAnJFupu",241,0.995868,32,242,1,241,1,1,0,1,1,105,105,137,136,95
"8341",40,"[32]EimnhxHnKqGocIHcJCxKtbJrAAnJFupu",232,0.995708,32,233,1,232,1,1,0,1,1,112,112,121,120,95
"8342",41,"[32]EimnhxHnKqGocIHcJCxKtbJrAAnJFupu",231,0.99569,32,232,1,231,1,1,0,1,1,113,113,119,118,95
"8343",42,"[32]EimnhxHnKqGocIHcJCxKtbJrAAnJFupu",232,0.995708,32,233,1,232,1,1,0,1,1,114,114,119,118,95
"8344",43,"[32]EimnhxHnKqGocIHcJCxKtbJrAAnJFupu",231,0.99569,32,232,1,231,1,1,0,1,1,116,116,116,115,95
"8345",44,"[32]EimnhxHnKqGocIHcJCxKtbJrAAnJFupu",235,0.995763,32,236,1,235,1,1,0,1,1,111,111,125,124,95
"8346",45,"[32]EimnhxHnKqGocIHcJCxKtbJrAAnJFupu",218,0.995434,32,219,1,218,1,1,0,1,1,125,125,94,93,95
"8347",46,"[32]EimnhxHnKqGocIHcJCxKtbJrAAnJFupu",223,0.995536,32,224,1,223,1,1,0,1,1,121,121,103,102,95
"8348",47,"[32]EimnhxHnKqGocIHcJCxKtbJrAAnJFupu",230,0.995671,32,231,1,230,1,1,0,1,1,114,114,117,116,95
"8349",48,"[32]EimnhxHnKqGocIHcJCxKtbJrAAnJFupu",235,0.995763,32,236,1,235,1,1,0,1,1,111,111,125,124,95
"8350",49,"[32]EimnhxHnKqGocIHcJCxKtbJrAAnJFupu",224,0.995556,32,225,1,224,1,1,0,1,1,119,119,106,105,95
"8351",50,"[32]EimnhxHnKqGocIHcJCxKtbJrAAnJFupu",232,0.995708,32,233,1,232,1,1,0,1,1,113,113,120,119,95
"8352",51,"[32]EimnhxHnKqGocIHcJCxKtbJrAAnJFupu",219,0.995455,32,220,1,219,1,1,0,1,1,123,123,97,96,95
"8353",52,"[32]EimnhxHnKqGocIHcJCxKtbJrAAnJFupu",227,0.995614,32,228,1,227,1,1,0,1,1,118,118,110,109,95
"8354",53,"[32]EimnhxHnKqGocIHcJCxKtbJrAAnJFupu",225,0.995575,32,226,1,225,1,1,0,1,1,118,118,108,107,95
"8355",54,"[32]EimnhxHnKqGocIHcJCxKtbJrAAnJFupu",225,0.995575,32,226,1,225,1,1,0,1,1,118,118,108,107,95
"8356",55,"[32]EimnhxHnKqGocIHcJCxKtbJrAAnJFupu",236,0.995781,32,237,1,236,1,1,0,1,1,109,109,128,127,95
"8357",56,"[32]EimnhxHnKqGocIHcJCxKtbJrAAnJFupu",242,0.995885,32,243,1,242,1,1,0,1,1,106,106,137,136,95
"8358",57,"[32]EimnhxHnKqGocIHcJCxKtbJrAAnJFupu",225,0.995575,32,226,1,225,1,1,0,1,1,119,119,107,106,95
"8359",58,"[32]EimnhxHnKqGocIHcJCxKtbJrAAnJFupu",233,0.995726,32,234,1,233,1,1,0,1,1,113,113,121,120,95
"8360",59,"[32]EimnhxHnKqGocIHcJCxKtbJrAAnJFupu",237,0.995798,32,238,1,237,1,1,0,1,1,109,109,129,128,95
"8361",60,"[32]EimnhxHnKqGocIHcJCxKtbJrAAnJFupu",235,0.995763,32,236,1,235,1,1,0,1,1,110,110,126,125,95
"8362",61,"[32]EimnhxHnKqGocIHcJCxKtbJrAAnJFupu",237,0.995798,32,238,1,237,1,1,0,1,1,109,109,129,128,95
"8363",62,"[32]EimnhxHnKqGocIHcJCxKtbJrAAnJFupu",233,0.995726,32,234,1,233,1,1,0,1,1,114,114,120,119,95
"8364",63,"[32]EimnhxHnKqGocIHcJCxKtbJrAAnJFupu",233,0.995726,32,234,1,233,1,1,0,1,1,115,115,119,118,95
"8365",64,"[32]EimnhxHnKqGocIHcJCxKtbJrAAnJFupu",236,0.995781,32,237,1,236,1,1,0,1,1,110,110,127,126,95
"8366",65,"[32]EimnhxHnKqGocIHcJCxKtbJrAAnJFupu",225,0.995575,32,226,1,225,1,1,0,1,1,118,118,108,107,95
"8367",66,"[32]EimnhxHnKqGocIHcJCxKtbJrAAnJFupu",228,0.995633,32,229,1,228,1,1,0,1,1,118,118,111,110,95
"8368",67,"[32]EimnhxHnKqGocIHcJCxKtbJrAAnJFupu",218,0.995434,32,219,1,218,1,1,0,1,1,125,125,94,93,95
"8369",68,"[32]EimnhxHnKqGocIHcJCxKtbJrAAnJFupu",233,0.995726,32,234,1,233,1,1,0,1,1,111,111,123,122,95
"8370",69,"[32]EimnhxHnKqGocIHcJCxKtbJrAAnJFupu",233,0.995726,32,234,1,233,1,1,0,1,1,111,111,123,122,95
"8371",70,"[32]EimnhxHnKqGocIHcJCxKtbJrAAnJFupu",239,0.995833,32,240,1,239,1,1,0,1,1,107,107,133,132,95
"8372",71,"[32]EimnhxHnKqGocIHcJCxKtbJrAAnJFupu",226,0.995595,32,227,1,226,1,1,0,1,1,118,118,109,108,95
"8373",72,"[32]EimnhxHnKqGocIHcJCxKtbJrAAnJFupu",225,0.995575,32,226,1,225,1,1,0,1,1,119,119,107,106,95
"8374",73,"[32]EimnhxHnKqGocIHcJCxKtbJrAAnJFupu",232,0.995708,32,233,1,232,1,1,0,1,1,113,113,120,119,95
"8375",74,"[32]EimnhxHnKqGocIHcJCxKtbJrAAnJFupu",233,0.995726,32,234,1,233,1,1,0,1,1,114,114,120,119,95
"8376",75,"[32]EimnhxHnKqGocIHcJCxKtbJrAAnJFupu",228,0.995633,32,229,1,228,1,1,0,1,1,115,115,114,113,95
"8377",76,"[32]EimnhxHnKqGocIHcJCxKtbJrAAnJFupu",241,0.995868,32,242,1,241,1,1,0,1,1,106,106,136,135,95
"8378",77,"[32]EimnhxHnKqGocIHcJCxKtbJrAAnJFupu",235,0.995763,32,236,1,235,1,1,0,1,1,110,110,126,125,95
"8379",78,"[32]EimnhxHnKqGocIHcJCxKtbJrAAnJFupu",239,0.995833,32,240,1,239,1,1,0,1,1,108,108,132,131,95
"8380",79,"[32]EimnhxHnKqGocIHcJCxKtbJrAAnJFupu",223,0.995536,32,224,1,223,1,1,0,1,1,119,119,105,104,95
"8381",80,"[32]EimnhxHnKqGocIHcJCxKtbJrAAnJFupu",223,0.995536,32,224,1,223,1,1,0,1,1,120,120,104,103,95
"8382",81,"[32]EimnhxHnKqGocIHcJCxKtbJrAAnJFupu",234,0.995745,32,235,1,234,1,1,0,1,1,111,111,124,123,95
"8383",82,"[32]EimnhxHnKqGocIHcJCxKtbJrAAnJFupu",228,0.995633,32,229,1,228,1,1,0,1,1,117,117,112,111,95
"8384",83,"[32]EimnhxHnKqGocIHcJCxKtbJrAAnJFupu",231,0.99569,32,232,1,231,1,1,0,1,1,115,115,117,116,95
"8385",84,"[32]EimnhxHnKqGocIHcJCxKtbJrAAnJFupu",232,0.995708,32,233,1,232,1,1,0,1,1,113,113,120,119,95
"8386",85,"[32]EimnhxHnKqGocIHcJCxKtbJrAAnJFupu",222,0.995516,32,223,1,222,1,1,0,1,1,121,121,102,101,95
"8387",86,"[32]EimnhxHnKqGocIHcJCxKtbJrAAnJFupu",233,0.995726,32,234,1,233,1,1,0,1,1,111,111,123,122,95
"8388",87,"[32]EimnhxHnKqGocIHcJCxKtbJrAAnJFupu",233,0.995726,32,234,1,233,1,1,0,1,1,112,112,122,121,95
"8389",88,"[32]EimnhxHnKqGocIHcJCxKtbJrAAnJFupu",224,0.995556,32,225,1,224,1,1,0,1,1,119,119,106,105,95
"8390",89,"[32]EimnhxHnKqGocIHcJCxKtbJrAAnJFupu",233,0.995726,32,234,1,233,1,1,0,1,1,113,113,121,120,95
"8391",90,"[32]EimnhxHnKqGocIHcJCxKtbJrAAnJFupu",231,0.99569,32,232,1,231,1,1,0,1,1,114,114,118,117,95
"8392",91,"[32]EimnhxHnKqGocIHcJCxKtbJrAAnJFupu",231,0.99569,32,232,1,231,1,1,0,1,1,114,114,118,117,95
"8393",92,"[32]EimnhxHnKqGocIHcJCxKtbJrAAnJFupu",225,0.995575,32,226,1,225,1,1,0,1,1,118,118,108,107,95
"8394",93,"[32]EimnhxHnKqGocIHcJCxKtbJrAAnJFupu",238,0.995816,32,239,1,238,1,1,0,1,1,108,108,131,130,95
"8395",94,"[32]EimnhxHnKqGocIHcJCxKtbJrAAnJFupu",237,0.995798,32,238,1,237,1,1,0,1,1,111,111,127,126,95
"8396",95,"[32]EimnhxHnKqGocIHcJCxKtbJrAAnJFupu",226,0.995595,32,227,1,226,1,1,0,1,1,118,118,109,108,95
"8397",96,"[32]EimnhxHnKqGocIHcJCxKtbJrAAnJFupu",229,0.995652,32,230,1,229,1,1,0,1,1,117,117,113,112,95
"8398",97,"[32]EimnhxHnKqGocIHcJCxKtbJrAAnJFupu",236,0.995781,32,237,1,236,1,1,0,1,1,112,112,125,124,95
"8399",98,"[32]EimnhxHnKqGocIHcJCxKtbJrAAnJFupu",225,0.995575,32,226,1,225,1,1,0,1,1,120,120,106,105,95
"8400",99,"[32]EimnhxHnKqGocIHcJCxKtbJrAAnJFupu",237,0.995798,32,238,1,237,1,1,0,1,1,109,109,129,128,95
"8401",0,"[23]ExHnKqGocIHcJCkkcFtEJDF",226,0.995595,23,227,1,226,1,1,0,1,1,118,118,109,108,96
"8402",1,"[23]ExHnKqGocIHcJCkkcFtEJDF",235,0.995763,23,236,1,235,1,1,0,1,1,111,111,125,124,96
"8403",2,"[23]ExHnKqGocIHcJCkkcFtEJDF",237,0.995798,23,238,1,237,1,1,0,1,1,110,110,128,127,96
"8404",3,"[23]ExHnKqGocIHcJCkkcFtEJDF",221,0.995495,23,222,1,221,1,1,0,1,1,122,122,100,99,96
"8405",4,"[23]ExHnKqGocIHcJCkkcFtEJDF",239,0.995833,23,240,1,239,1,1,0,1,1,108,108,132,131,96
"8406",5,"[23]ExHnKqGocIHcJCkkcFtEJDF",238,0.995816,23,239,1,238,1,1,0,1,1,109,109,130,129,96
"8407",6,"[23]ExHnKqGocIHcJCkkcFtEJDF",231,0.99569,23,232,1,231,1,1,0,1,1,114,114,118,117,96
"8408",7,"[23]ExHnKqGocIHcJCkkcFtEJDF",231,0.99569,23,232,1,231,1,1,0,1,1,116,116,116,115,96
"8409",8,"[23]ExHnKqGocIHcJCkkcFtEJDF",232,0.995708,23,233,1,232,1,1,0,1,1,113,113,120,119,96
"8410",9,"[23]ExHnKqGocIHcJCkkcFtEJDF",222,0.995516,23,223,1,222,1,1,0,1,1,122,122,101,100,96
"8411",10,"[23]ExHnKqGocIHcJCkkcFtEJDF",234,0.995745,23,235,1,234,1,1,0,1,1,111,111,124,123,96
"8412",11,"[23]ExHnKqGocIHcJCkkcFtEJDF",230,0.995671,23,231,1,230,1,1,0,1,1,115,115,116,115,96
"8413",12,"[23]ExHnKqGocIHcJCkkcFtEJDF",234,0.995745,23,235,1,234,1,1,0,1,1,114,114,121,120,96
"8414",13,"[23]ExHnKqGocIHcJCkkcFtEJDF",228,0.995633,23,229,1,228,1,1,0,1,1,116,116,113,112,96
"8415",14,"[23]ExHnKqGocIHcJCkkcFtEJDF",226,0.995595,23,227,1,226,1,1,0,1,1,119,119,108,107,96
"8416",15,"[23]ExHnKqGocIHcJCkkcFtEJDF",229,0.995652,23,230,1,229,1,1,0,1,1,116,116,114,113,96
"8417",16,"[23]ExHnKqGocIHcJCkkcFtEJDF",233,0.995726,23,234,1,233,1,1,0,1,1,113,113,121,120,96
"8418",17,"[23]ExHnKqGocIHcJCkkcFtEJDF",241,0.995868,23,242,1,241,1,1,0,1,1,108,108,134,133,96
"8419",18,"[23]ExHnKqGocIHcJCkkcFtEJDF",226,0.995595,23,227,1,226,1,1,0,1,1,120,120,107,106,96
"8420",19,"[23]ExHnKqGocIHcJCkkcFtEJDF",225,0.995575,23,226,1,225,1,1,0,1,1,119,119,107,106,96
"8421",20,"[23]ExHnKqGocIHcJCkkcFtEJDF",233,0.995726,23,234,1,233,1,1,0,1,1,115,115,119,118,96
"8422",21,"[23]ExHnKqGocIHcJCkkcFtEJDF",233,0.995726,23,234,1,233,1,1,0,1,1,112,112,122,121,96
"8423",22,"[23]ExHnKqGocIHcJCkkcFtEJDF",236,0.995781,23,237,1,236,1,1,0,1,1,110,110,127,126,96
"8424",23,"[23]ExHnKqGocIHcJCkkcFtEJDF",226,0.995595,23,227,1,226,1,1,0,1,1,118,118,109,108,96
"8425",24,"[23]ExHnKqGocIHcJCkkcFtEJDF",224,0.995556,23,225,1,224,1,1,0,1,1,119,119,106,105,96
"8426",25,"[23]ExHnKqGocIHcJCkkcFtEJDF",230,0.995671,23,231,1,230,1,1,0,1,1,115,115,116,115,96
"8427",26,"[23]ExHnKqGocIHcJCkkcFtEJDF",230,0.995671,23,231,1,230,1,1,0,1,1,114,114,117,116,96
"8428",27,"[23]ExHnKqGocIHcJCkkcFtEJDF",236,0.995781,23,237,1,236,1,1,0,1,1,110,110,127,126,96
"8429",28,"[23]ExHnKqGocIHcJCkkcFtEJDF",241,0.995868,23,242,1,241,1,1,0,1,1,107,107,135,134,96
"8430",29,"[23]ExHnKqGocIHcJCkkcFtEJDF",224,0.995556,23,225,1,224,1,1,0,1,1,120,120,105,104,96
"8431",30,"[23]ExHnKqGocIHcJCkkcFtEJDF",224,0.995556,23,225,1,224,1,1,0,1,1,121,121,104,103,96
"8432",31,"[23]ExHnKqGocIHcJCkkcFtEJDF",239,0.995833,23,240,1,239,1,1,0,1,1,113,113,127,126,96
"8433",32,"[23]ExHnKqGocIHcJCkkcFtEJDF",229,0.995652,23,230,1,229,1,1,0,1,1,115,115,115,114,96
"8434",33,"[23]ExHnKqGocIHcJCkkcFtEJDF",230,0.995671,23,231,1,230,1,1,0,1,1,114,114,117,116,96
"8435",34,"[23]ExHnKqGocIHcJCkkcFtEJDF",230,0.995671,23,231,1,230,1,1,0,1,1,114,114,117,116,96
"8436",35,"[23]ExHnKqGocIHcJCkkcFtEJDF",234,0.995745,23,235,1,234,1,1,0,1,1,112,112,123,122,96
"8437",36,"[23]ExHnKqGocIHcJCkkcFtEJDF",232,0.995708,23,233,1,232,1,1,0,1,1,116,116,117,116,96
"8438",37,"[23]ExHnKqGocIHcJCkkcFtEJDF",234,0.995745,23,235,1,234,1,1,0,1,1,113,113,122,121,96
"8439",38,"[23]ExHnKqGocIHcJCkkcFtEJDF",232,0.995708,23,233,1,232,1,1,0,1,1,113,113,120,119,96
"8440",39,"[23]ExHnKqGocIHcJCkkcFtEJDF",235,0.995763,23,236,1,235,1,1,0,1,1,112,112,124,123,96
"8441",40,"[23]ExHnKqGocIHcJCkkcFtEJDF",238,0.995816,23,239,1,238,1,1,0,1,1,109,109,130,129,96
"8442",41,"[23]ExHnKqGocIHcJCkkcFtEJDF",232,0.995708,23,233,1,232,1,1,0,1,1,114,114,119,118,96
"8443",42,"[23]ExHnKqGocIHcJCkkcFtEJDF",236,0.995781,23,237,1,236,1,1,0,1,1,111,111,126,125,96
"8444",43,"[23]ExHnKqGocIHcJCkkcFtEJDF",236,0.995781,23,237,1,236,1,1,0,1,1,110,110,127,126,96
"8445",44,"[23]ExHnKqGocIHcJCkkcFtEJDF",229,0.995652,23,230,1,229,1,1,0,1,1,116,116,114,113,96
"8446",45,"[23]ExHnKqGocIHcJCkkcFtEJDF",230,0.995671,23,231,1,230,1,1,0,1,1,115,115,116,115,96
"8447",46,"[23]ExHnKqGocIHcJCkkcFtEJDF",227,0.995614,23,228,1,227,1,1,0,1,1,117,117,111,110,96
"8448",47,"[23]ExHnKqGocIHcJCkkcFtEJDF",233,0.995726,23,234,1,233,1,1,0,1,1,115,115,119,118,96
"8449",48,"[23]ExHnKqGocIHcJCkkcFtEJDF",231,0.99569,23,232,1,231,1,1,0,1,1,116,116,116,115,96
"8450",49,"[23]ExHnKqGocIHcJCkkcFtEJDF",231,0.99569,23,232,1,231,1,1,0,1,1,114,114,118,117,96
"8451",50,"[23]ExHnKqGocIHcJCkkcFtEJDF",228,0.995633,23,229,1,228,1,1,0,1,1,116,116,113,112,96
"8452",51,"[23]ExHnKqGocIHcJCkkcFtEJDF",240,0.995851,23,241,1,240,1,1,0,1,1,108,108,133,132,96
"8453",52,"[23]ExHnKqGocIHcJCkkcFtEJDF",230,0.995671,23,231,1,230,1,1,0,1,1,116,116,115,114,96
"8454",53,"[23]ExHnKqGocIHcJCkkcFtEJDF",233,0.995726,23,234,1,233,1,1,0,1,1,112,112,122,121,96
"8455",54,"[23]ExHnKqGocIHcJCkkcFtEJDF",227,0.995614,23,228,1,227,1,1,0,1,1,117,117,111,110,96
"8456",55,"[23]ExHnKqGocIHcJCkkcFtEJDF",225,0.995575,23,226,1,225,1,1,0,1,1,118,118,108,107,96
"8457",56,"[23]ExHnKqGocIHcJCkkcFtEJDF",230,0.995671,23,231,1,230,1,1,0,1,1,114,114,117,116,96
"8458",57,"[23]ExHnKqGocIHcJCkkcFtEJDF",236,0.995781,23,237,1,236,1,1,0,1,1,112,112,125,124,96
"8459",58,"[23]ExHnKqGocIHcJCkkcFtEJDF",240,0.995851,23,241,1,240,1,1,0,1,1,108,108,133,132,96
"8460",59,"[23]ExHnKqGocIHcJCkkcFtEJDF",235,0.995763,23,236,1,235,1,1,0,1,1,112,112,124,123,96
"8461",60,"[23]ExHnKqGocIHcJCkkcFtEJDF",230,0.995671,23,231,1,230,1,1,0,1,1,114,114,117,116,96
"8462",61,"[23]ExHnKqGocIHcJCkkcFtEJDF",229,0.995652,23,230,1,229,1,1,0,1,1,116,116,114,113,96
"8463",62,"[23]ExHnKqGocIHcJCkkcFtEJDF",227,0.995614,23,228,1,227,1,1,0,1,1,118,118,110,109,96
"8464",63,"[23]ExHnKqGocIHcJCkkcFtEJDF",231,0.99569,23,232,1,231,1,1,0,1,1,114,114,118,117,96
"8465",64,"[23]ExHnKqGocIHcJCkkcFtEJDF",236,0.995781,23,237,1,236,1,1,0,1,1,110,110,127,126,96
"8466",65,"[23]ExHnKqGocIHcJCkkcFtEJDF",225,0.995575,23,226,1,225,1,1,0,1,1,118,118,108,107,96
"8467",66,"[23]ExHnKqGocIHcJCkkcFtEJDF",217,0.995413,23,218,1,217,1,1,0,1,1,125,125,93,92,96
"8468",67,"[23]ExHnKqGocIHcJCkkcFtEJDF",235,0.995763,23,236,1,235,1,1,0,1,1,113,113,123,122,96
"8469",68,"[23]ExHnKqGocIHcJCkkcFtEJDF",232,0.995708,23,233,1,232,1,1,0,1,1,114,114,119,118,96
"8470",69,"[23]ExHnKqGocIHcJCkkcFtEJDF",224,0.995556,23,225,1,224,1,1,0,1,1,120,120,105,104,96
"8471",70,"[23]ExHnKqGocIHcJCkkcFtEJDF",229,0.995652,23,230,1,229,1,1,0,1,1,115,115,115,114,96
"8472",71,"[23]ExHnKqGocIHcJCkkcFtEJDF",235,0.995763,23,236,1,235,1,1,0,1,1,110,110,126,125,96
"8473",72,"[23]ExHnKqGocIHcJCkkcFtEJDF",233,0.995726,23,234,1,233,1,1,0,1,1,112,112,122,121,96
"8474",73,"[23]ExHnKqGocIHcJCkkcFtEJDF",226,0.995595,23,227,1,226,1,1,0,1,1,119,119,108,107,96
"8475",74,"[23]ExHnKqGocIHcJCkkcFtEJDF",232,0.995708,23,233,1,232,1,1,0,1,1,114,114,119,118,96
"8476",75,"[23]ExHnKqGocIHcJCkkcFtEJDF",224,0.995556,23,225,1,224,1,1,0,1,1,120,120,105,104,96
"8477",76,"[23]ExHnKqGocIHcJCkkcFtEJDF",226,0.995595,23,227,1,226,1,1,0,1,1,118,118,109,108,96
"8478",77,"[23]ExHnKqGocIHcJCkkcFtEJDF",219,0.995455,23,220,1,219,1,1,0,1,1,124,124,96,95,96
"8479",78,"[23]ExHnKqGocIHcJCkkcFtEJDF",229,0.995652,23,230,1,229,1,1,0,1,1,117,117,113,112,96
"8480",79,"[23]ExHnKqGocIHcJCkkcFtEJDF",225,0.995575,23,226,1,225,1,1,0,1,1,119,119,107,106,96
"8481",80,"[23]ExHnKqGocIHcJCkkcFtEJDF",234,0.995745,23,235,1,234,1,1,0,1,1,111,111,124,123,96
"8482",81,"[23]ExHnKqGocIHcJCkkcFtEJDF",221,0.995495,23,222,1,221,1,1,0,1,1,123,123,99,98,96
"8483",82,"[23]ExHnKqGocIHcJCkkcFtEJDF",220,0.995475,23,221,1,220,1,1,0,1,1,122,122,99,98,96
"8484",83,"[23]ExHnKqGocIHcJCkkcFtEJDF",220,0.995475,23,221,1,220,1,1,0,1,1,122,122,99,98,96
"8485",84,"[23]ExHnKqGocIHcJCkkcFtEJDF",221,0.995495,23,222,1,221,1,1,0,1,1,122,122,100,99,96
"8486",85,"[23]ExHnKqGocIHcJCkkcFtEJDF",223,0.995536,23,224,1,223,1,1,0,1,1,121,121,103,102,96
"8487",86,"[23]ExHnKqGocIHcJCkkcFtEJDF",235,0.995763,23,236,1,235,1,1,0,1,1,110,110,126,125,96
"8488",87,"[23]ExHnKqGocIHcJCkkcFtEJDF",229,0.995652,23,230,1,229,1,1,0,1,1,116,116,114,113,96
"8489",88,"[23]ExHnKqGocIHcJCkkcFtEJDF",230,0.995671,23,231,1,230,1,1,0,1,1,114,114,117,116,96
"8490",89,"[23]ExHnKqGocIHcJCkkcFtEJDF",232,0.995708,23,233,1,232,1,1,0,1,1,114,114,119,118,96
"8491",90,"[23]ExHnKqGocIHcJCkkcFtEJDF",236,0.995781,23,237,1,236,1,1,0,1,1,110,110,127,126,96
"8492",91,"[23]ExHnKqGocIHcJCkkcFtEJDF",233,0.995726,23,234,1,233,1,1,0,1,1,114,114,120,119,96
"8493",92,"[23]ExHnKqGocIHcJCkkcFtEJDF",231,0.99569,23,232,1,231,1,1,0,1,1,115,115,117,116,96
"8494",93,"[23]ExHnKqGocIHcJCkkcFtEJDF",234,0.995745,23,235,1,234,1,1,0,1,1,118,118,117,116,96
"8495",94,"[23]ExHnKqGocIHcJCkkcFtEJDF",226,0.995595,23,227,1,226,1,1,0,1,1,118,118,109,108,96
"8496",95,"[23]ExHnKqGocIHcJCkkcFtEJDF",227,0.995614,23,228,1,227,1,1,0,1,1,117,117,111,110,96
"8497",96,"[23]ExHnKqGocIHcJCkkcFtEJDF",239,0.995833,23,240,1,239,1,1,0,1,1,111,111,129,128,96
"8498",97,"[23]ExHnKqGocIHcJCkkcFtEJDF",230,0.995671,23,231,1,230,1,1,0,1,1,116,116,115,114,96
"8499",98,"[23]ExHnKqGocIHcJCkkcFtEJDF",224,0.995556,23,225,1,224,1,1,0,1,1,122,122,103,102,96
"8500",99,"[23]ExHnKqGocIHcJCkkcFtEJDF",238,0.995816,23,239,1,238,1,1,0,1,1,114,114,125,124,96
"8501",0,"[30]EepzsxHnKqGocIHBJCwvFdkEAvpakx",239,0.995833,30,240,1,239,1,1,0,1,1,108,108,132,131,97
"8502",1,"[30]EepzsxHnKqGocIHBJCwvFdkEAvpakx",231,0.99569,30,232,1,231,1,1,0,1,1,114,114,118,117,97
"8503",2,"[30]EepzsxHnKqGocIHBJCwvFdkEAvpakx",237,0.995798,30,238,1,237,1,1,0,1,1,111,111,127,126,97
"8504",3,"[30]EepzsxHnKqGocIHBJCwvFdkEAvpakx",227,0.995614,30,228,1,227,1,1,0,1,1,117,117,111,110,97
"8505",4,"[30]EepzsxHnKqGocIHBJCwvFdkEAvpakx",238,0.995816,30,239,1,238,1,1,0,1,1,107,107,132,131,97
"8506",5,"[30]EepzsxHnKqGocIHBJCwvFdkEAvpakx",227,0.995614,30,228,1,227,1,1,0,1,1,117,117,111,110,97
"8507",6,"[30]EepzsxHnKqGocIHBJCwvFdkEAvpakx",227,0.995614,30,228,1,227,1,1,0,1,1,116,116,112,111,97
"8508",7,"[30]EepzsxHnKqGocIHBJCwvFdkEAvpakx",236,0.995781,30,237,1,236,1,1,0,1,1,110,110,127,126,97
"8509",8,"[30]EepzsxHnKqGocIHBJCwvFdkEAvpakx",221,0.995495,30,222,1,221,1,1,0,1,1,121,121,101,100,97
"8510",9,"[30]EepzsxHnKqGocIHBJCwvFdkEAvpakx",237,0.995798,30,238,1,237,1,1,0,1,1,109,109,129,128,97
"8511",10,"[30]EepzsxHnKqGocIHBJCwvFdkEAvpakx",228,0.995633,30,229,1,228,1,1,0,1,1,115,115,114,113,97
"8512",11,"[30]EepzsxHnKqGocIHBJCwvFdkEAvpakx",232,0.995708,30,233,1,232,1,1,0,1,1,113,113,120,119,97
"8513",12,"[30]EepzsxHnKqGocIHBJCwvFdkEAvpakx",229,0.995652,30,230,1,229,1,1,0,1,1,116,116,114,113,97
"8514",13,"[30]EepzsxHnKqGocIHBJCwvFdkEAvpakx",236,0.995781,30,237,1,236,1,1,0,1,1,111,111,126,125,97
"8515",14,"[30]EepzsxHnKqGocIHBJCwvFdkEAvpakx",237,0.995798,30,238,1,237,1,1,0,1,1,109,109,129,128,97
"8516",15,"[30]EepzsxHnKqGocIHBJCwvFdkEAvpakx",227,0.995614,30,228,1,227,1,1,0,1,1,116,116,112,111,97
"8517",16,"[30]EepzsxHnKqGocIHBJCwvFdkEAvpakx",243,0.995902,30,244,1,243,1,1,0,1,1,105,105,139,138,97
"8518",17,"[30]EepzsxHnKqGocIHBJCwvFdkEAvpakx",227,0.995614,30,228,1,227,1,1,0,1,1,118,118,110,109,97
"8519",18,"[30]EepzsxHnKqGocIHBJCwvFdkEAvpakx",239,0.995833,30,240,1,239,1,1,0,1,1,111,111,129,128,97
"8520",19,"[30]EepzsxHnKqGocIHBJCwvFdkEAvpakx",242,0.995885,30,243,1,242,1,1,0,1,1,104,104,139,138,97
"8521",20,"[30]EepzsxHnKqGocIHBJCwvFdkEAvpakx",226,0.995595,30,227,1,226,1,1,0,1,1,118,118,109,108,97
"8522",21,"[30]EepzsxHnKqGocIHBJCwvFdkEAvpakx",227,0.995614,30,228,1,227,1,1,0,1,1,117,117,111,110,97
"8523",22,"[30]EepzsxHnKqGocIHBJCwvFdkEAvpakx",234,0.995745,30,235,1,234,1,1,0,1,1,114,114,121,120,97
"8524",23,"[30]EepzsxHnKqGocIHBJCwvFdkEAvpakx",230,0.995671,30,231,1,230,1,1,0,1,1,117,117,114,113,97
"8525",24,"[30]EepzsxHnKqGocIHBJCwvFdkEAvpakx",226,0.995595,30,227,1,226,1,1,0,1,1,117,117,110,109,97
"8526",25,"[30]EepzsxHnKqGocIHBJCwvFdkEAvpakx",235,0.995763,30,236,1,235,1,1,0,1,1,110,110,126,125,97
"8527",26,"[30]EepzsxHnKqGocIHBJCwvFdkEAvpakx",231,0.99569,30,232,1,231,1,1,0,1,1,116,116,116,115,97
"8528",27,"[30]EepzsxHnKqGocIHBJCwvFdkEAvpakx",233,0.995726,30,234,1,233,1,1,0,1,1,113,113,121,120,97
"8529",28,"[30]EepzsxHnKqGocIHBJCwvFdkEAvpakx",226,0.995595,30,227,1,226,1,1,0,1,1,117,117,110,109,97
"8530",29,"[30]EepzsxHnKqGocIHBJCwvFdkEAvpakx",231,0.99569,30,232,1,231,1,1,0,1,1,115,115,117,116,97
"8531",30,"[30]EepzsxHnKqGocIHBJCwvFdkEAvpakx",233,0.995726,30,234,1,233,1,1,0,1,1,111,111,123,122,97
"8532",31,"[30]EepzsxHnKqGocIHBJCwvFdkEAvpakx",231,0.99569,30,232,1,231,1,1,0,1,1,113,113,119,118,97
"8533",32,"[30]EepzsxHnKqGocIHBJCwvFdkEAvpakx",230,0.995671,30,231,1,230,1,1,0,1,1,116,116,115,114,97
"8534",33,"[30]EepzsxHnKqGocIHBJCwvFdkEAvpakx",228,0.995633,30,229,1,228,1,1,0,1,1,119,119,110,109,97
"8535",34,"[30]EepzsxHnKqGocIHBJCwvFdkEAvpakx",225,0.995575,30,226,1,225,1,1,0,1,1,119,119,107,106,97
"8536",35,"[30]EepzsxHnKqGocIHBJCwvFdkEAvpakx",234,0.995745,30,235,1,234,1,1,0,1,1,115,115,120,119,97
"8537",36,"[30]EepzsxHnKqGocIHBJCwvFdkEAvpakx",231,0.99569,30,232,1,231,1,1,0,1,1,114,114,118,117,97
"8538",37,"[30]EepzsxHnKqGocIHBJCwvFdkEAvpakx",234,0.995745,30,235,1,234,1,1,0,1,1,114,114,121,120,97
"8539",38,"[30]EepzsxHnKqGocIHBJCwvFdkEAvpakx",218,0.995434,30,219,1,218,1,1,0,1,1,123,123,96,95,97
"8540",39,"[30]EepzsxHnKqGocIHBJCwvFdkEAvpakx",233,0.995726,30,234,1,233,1,1,0,1,1,114,114,120,119,97
"8541",40,"[30]EepzsxHnKqGocIHBJCwvFdkEAvpakx",235,0.995763,30,236,1,235,1,1,0,1,1,111,111,125,124,97
"8542",41,"[30]EepzsxHnKqGocIHBJCwvFdkEAvpakx",234,0.995745,30,235,1,234,1,1,0,1,1,112,112,123,122,97
"8543",42,"[30]EepzsxHnKqGocIHBJCwvFdkEAvpakx",226,0.995595,30,227,1,226,1,1,0,1,1,117,117,110,109,97
"8544",43,"[30]EepzsxHnKqGocIHBJCwvFdkEAvpakx",233,0.995726,30,234,1,233,1,1,0,1,1,112,112,122,121,97
"8545",44,"[30]EepzsxHnKqGocIHBJCwvFdkEAvpakx",227,0.995614,30,228,1,227,1,1,0,1,1,116,116,112,111,97
"8546",45,"[30]EepzsxHnKqGocIHBJCwvFdkEAvpakx",239,0.995833,30,240,1,239,1,1,0,1,1,108,108,132,131,97
"8547",46,"[30]EepzsxHnKqGocIHBJCwvFdkEAvpakx",224,0.995556,30,225,1,224,1,1,0,1,1,119,119,106,105,97
"8548",47,"[30]EepzsxHnKqGocIHBJCwvFdkEAvpakx",223,0.995536,30,224,1,223,1,1,0,1,1,119,119,105,104,97
"8549",48,"[30]EepzsxHnKqGocIHBJCwvFdkEAvpakx",224,0.995556,30,225,1,224,1,1,0,1,1,123,123,102,101,97
"8550",49,"[30]EepzsxHnKqGocIHBJCwvFdkEAvpakx",234,0.995745,30,235,1,234,1,1,0,1,1,113,113,122,121,97
"8551",50,"[30]EepzsxHnKqGocIHBJCwvFdkEAvpakx",239,0.995833,30,240,1,239,1,1,0,1,1,107,107,133,132,97
"8552",51,"[30]EepzsxHnKqGocIHBJCwvFdkEAvpakx",229,0.995652,30,230,1,229,1,1,0,1,1,115,115,115,114,97
"8553",52,"[30]EepzsxHnKqGocIHBJCwvFdkEAvpakx",236,0.995781,30,237,1,236,1,1,0,1,1,109,109,128,127,97
"8554",53,"[30]EepzsxHnKqGocIHBJCwvFdkEAvpakx",231,0.99569,30,232,1,231,1,1,0,1,1,114,114,118,117,97
"8555",54,"[30]EepzsxHnKqGocIHBJCwvFdkEAvpakx",240,0.995851,30,241,1,240,1,1,0,1,1,106,106,135,134,97
"8556",55,"[30]EepzsxHnKqGocIHBJCwvFdkEAvpakx",216,0.995392,30,217,1,216,1,1,0,1,1,125,125,92,91,97
"8557",56,"[30]EepzsxHnKqGocIHBJCwvFdkEAvpakx",238,0.995816,30,239,1,238,1,1,0,1,1,107,107,132,131,97
"8558",57,"[30]EepzsxHnKqGocIHBJCwvFdkEAvpakx",224,0.995556,30,225,1,224,1,1,0,1,1,119,119,106,105,97
"8559",58,"[30]EepzsxHnKqGocIHBJCwvFdkEAvpakx",222,0.995516,30,223,1,222,1,1,0,1,1,121,121,102,101,97
"8560",59,"[30]EepzsxHnKqGocIHBJCwvFdkEAvpakx",230,0.995671,30,231,1,230,1,1,0,1,1,115,115,116,115,97
"8561",60,"[30]EepzsxHnKqGocIHBJCwvFdkEAvpakx",233,0.995726,30,234,1,233,1,1,0,1,1,114,114,120,119,97
"8562",61,"[30]EepzsxHnKqGocIHBJCwvFdkEAvpakx",225,0.995575,30,226,1,225,1,1,0,1,1,118,118,108,107,97
"8563",62,"[30]EepzsxHnKqGocIHBJCwvFdkEAvpakx",217,0.995413,30,218,1,217,1,1,0,1,1,125,125,93,92,97
"8564",63,"[30]EepzsxHnKqGocIHBJCwvFdkEAvpakx",227,0.995614,30,228,1,227,1,1,0,1,1,116,116,112,111,97
"8565",64,"[30]EepzsxHnKqGocIHBJCwvFdkEAvpakx",222,0.995516,30,223,1,222,1,1,0,1,1,122,122,101,100,97
"8566",65,"[30]EepzsxHnKqGocIHBJCwvFdkEAvpakx",228,0.995633,30,229,1,228,1,1,0,1,1,116,116,113,112,97
"8567",66,"[30]EepzsxHnKqGocIHBJCwvFdkEAvpakx",226,0.995595,30,227,1,226,1,1,0,1,1,119,119,108,107,97
"8568",67,"[30]EepzsxHnKqGocIHBJCwvFdkEAvpakx",228,0.995633,30,229,1,228,1,1,0,1,1,115,115,114,113,97
"8569",68,"[30]EepzsxHnKqGocIHBJCwvFdkEAvpakx",225,0.995575,30,226,1,225,1,1,0,1,1,120,120,106,105,97
"8570",69,"[30]EepzsxHnKqGocIHBJCwvFdkEAvpakx",224,0.995556,30,225,1,224,1,1,0,1,1,119,119,106,105,97
"8571",70,"[30]EepzsxHnKqGocIHBJCwvFdkEAvpakx",245,0.995935,30,246,1,245,1,1,0,1,1,104,104,142,141,97
"8572",71,"[30]EepzsxHnKqGocIHBJCwvFdkEAvpakx",237,0.995798,30,238,1,237,1,1,0,1,1,112,112,126,125,97
"8573",72,"[30]EepzsxHnKqGocIHBJCwvFdkEAvpakx",223,0.995536,30,224,1,223,1,1,0,1,1,120,120,104,103,97
"8574",73,"[30]EepzsxHnKqGocIHBJCwvFdkEAvpakx",221,0.995495,30,222,1,221,1,1,0,1,1,123,123,99,98,97
"8575",74,"[30]EepzsxHnKqGocIHBJCwvFdkEAvpakx",235,0.995763,30,236,1,235,1,1,0,1,1,111,111,125,124,97
"8576",75,"[30]EepzsxHnKqGocIHBJCwvFdkEAvpakx",222,0.995516,30,223,1,222,1,1,0,1,1,123,123,100,99,97
"8577",76,"[30]EepzsxHnKqGocIHBJCwvFdkEAvpakx",229,0.995652,30,230,1,229,1,1,0,1,1,115,115,115,114,97
"8578",77,"[30]EepzsxHnKqGocIHBJCwvFdkEAvpakx",230,0.995671,30,231,1,230,1,1,0,1,1,114,114,117,116,97
"8579",78,"[30]EepzsxHnKqGocIHBJCwvFdkEAvpakx",222,0.995516,30,223,1,222,1,1,0,1,1,122,122,101,100,97
"8580",79,"[30]EepzsxHnKqGocIHBJCwvFdkEAvpakx",234,0.995745,30,235,1,234,1,1,0,1,1,111,111,124,123,97
"8581",80,"[30]EepzsxHnKqGocIHBJCwvFdkEAvpakx",229,0.995652,30,230,1,229,1,1,0,1,1,115,115,115,114,97
"8582",81,"[30]EepzsxHnKqGocIHBJCwvFdkEAvpakx",231,0.99569,30,232,1,231,1,1,0,1,1,113,113,119,118,97
"8583",82,"[30]EepzsxHnKqGocIHBJCwvFdkEAvpakx",240,0.995851,30,241,1,240,1,1,0,1,1,107,107,134,133,97
"8584",83,"[30]EepzsxHnKqGocIHBJCwvFdkEAvpakx",230,0.995671,30,231,1,230,1,1,0,1,1,114,114,117,116,97
"8585",84,"[30]EepzsxHnKqGocIHBJCwvFdkEAvpakx",241,0.995868,30,242,1,241,1,1,0,1,1,105,105,137,136,97
"8586",85,"[30]EepzsxHnKqGocIHBJCwvFdkEAvpakx",232,0.995708,30,233,1,232,1,1,0,1,1,113,113,120,119,97
"8587",86,"[30]EepzsxHnKqGocIHBJCwvFdkEAvpakx",229,0.995652,30,230,1,229,1,1,0,1,1,115,115,115,114,97
"8588",87,"[30]EepzsxHnKqGocIHBJCwvFdkEAvpakx",231,0.99569,30,232,1,231,1,1,0,1,1,114,114,118,117,97
"8589",88,"[30]EepzsxHnKqGocIHBJCwvFdkEAvpakx",228,0.995633,30,229,1,228,1,1,0,1,1,115,115,114,113,97
"8590",89,"[30]EepzsxHnKqGocIHBJCwvFdkEAvpakx",235,0.995763,30,236,1,235,1,1,0,1,1,111,111,125,124,97
"8591",90,"[30]EepzsxHnKqGocIHBJCwvFdkEAvpakx",239,0.995833,30,240,1,239,1,1,0,1,1,109,109,131,130,97
"8592",91,"[30]EepzsxHnKqGocIHBJCwvFdkEAvpakx",238,0.995816,30,239,1,238,1,1,0,1,1,107,107,132,131,97
"8593",92,"[30]EepzsxHnKqGocIHBJCwvFdkEAvpakx",230,0.995671,30,231,1,230,1,1,0,1,1,115,115,116,115,97
"8594",93,"[30]EepzsxHnKqGocIHBJCwvFdkEAvpakx",238,0.995816,30,239,1,238,1,1,0,1,1,110,110,129,128,97
"8595",94,"[30]EepzsxHnKqGocIHBJCwvFdkEAvpakx",232,0.995708,30,233,1,232,1,1,0,1,1,112,112,121,120,97
"8596",95,"[30]EepzsxHnKqGocIHBJCwvFdkEAvpakx",224,0.995556,30,225,1,224,1,1,0,1,1,121,121,104,103,97
"8597",96,"[30]EepzsxHnKqGocIHBJCwvFdkEAvpakx",226,0.995595,30,227,1,226,1,1,0,1,1,118,118,109,108,97
"8598",97,"[30]EepzsxHnKqGocIHBJCwvFdkEAvpakx",233,0.995726,30,234,1,233,1,1,0,1,1,112,112,122,121,97
"8599",98,"[30]EepzsxHnKqGocIHBJCwvFdkEAvpakx",226,0.995595,30,227,1,226,1,1,0,1,1,118,118,109,108,97
"8600",99,"[30]EepzsxHnKqGocIHBJCwvFdkEAvpakx",240,0.995851,30,241,1,240,1,1,0,1,1,106,106,135,134,97
"8601",0,"[25]EvjFsHnKqGocIHBJCHlFvyndo",237,0.995798,25,238,1,237,1,1,0,1,1,113,113,125,124,98
"8602",1,"[25]EvjFsHnKqGocIHBJCHlFvyndo",214,0.995349,25,215,1,214,1,1,0,1,1,130,130,85,84,98
"8603",2,"[25]EvjFsHnKqGocIHBJCHlFvyndo",232,0.995708,25,233,1,232,1,1,0,1,1,113,113,120,119,98
"8604",3,"[25]EvjFsHnKqGocIHBJCHlFvyndo",233,0.995726,25,234,1,233,1,1,0,1,1,111,111,123,122,98
"8605",4,"[25]EvjFsHnKqGocIHBJCHlFvyndo",231,0.99569,25,232,1,231,1,1,0,1,1,113,113,119,118,98
"8606",5,"[25]EvjFsHnKqGocIHBJCHlFvyndo",232,0.995708,25,233,1,232,1,1,0,1,1,112,112,121,120,98
"8607",6,"[25]EvjFsHnKqGocIHBJCHlFvyndo",222,0.995516,25,223,1,222,1,1,0,1,1,121,121,102,101,98
"8608",7,"[25]EvjFsHnKqGocIHBJCHlFvyndo",226,0.995595,25,227,1,226,1,1,0,1,1,117,117,110,109,98
"8609",8,"[25]EvjFsHnKqGocIHBJCHlFvyndo",236,0.995781,25,237,1,236,1,1,0,1,1,110,110,127,126,98
"8610",9,"[25]EvjFsHnKqGocIHBJCHlFvyndo",231,0.99569,25,232,1,231,1,1,0,1,1,114,114,118,117,98
"8611",10,"[25]EvjFsHnKqGocIHBJCHlFvyndo",235,0.995763,25,236,1,235,1,1,0,1,1,110,110,126,125,98
"8612",11,"[25]EvjFsHnKqGocIHBJCHlFvyndo",233,0.995726,25,234,1,233,1,1,0,1,1,112,112,122,121,98
"8613",12,"[25]EvjFsHnKqGocIHBJCHlFvyndo",232,0.995708,25,233,1,232,1,1,0,1,1,113,113,120,119,98
"8614",13,"[25]EvjFsHnKqGocIHBJCHlFvyndo",233,0.995726,25,234,1,233,1,1,0,1,1,112,112,122,121,98
"8615",14,"[25]EvjFsHnKqGocIHBJCHlFvyndo",231,0.99569,25,232,1,231,1,1,0,1,1,114,114,118,117,98
"8616",15,"[25]EvjFsHnKqGocIHBJCHlFvyndo",238,0.995816,25,239,1,238,1,1,0,1,1,109,109,130,129,98
"8617",16,"[25]EvjFsHnKqGocIHBJCHlFvyndo",233,0.995726,25,234,1,233,1,1,0,1,1,111,111,123,122,98
"8618",17,"[25]EvjFsHnKqGocIHBJCHlFvyndo",228,0.995633,25,229,1,228,1,1,0,1,1,121,121,108,107,98
"8619",18,"[25]EvjFsHnKqGocIHBJCHlFvyndo",229,0.995652,25,230,1,229,1,1,0,1,1,115,115,115,114,98
"8620",19,"[25]EvjFsHnKqGocIHBJCHlFvyndo",253,0.996063,25,254,1,253,1,1,0,1,1,98,98,156,155,98
"8621",20,"[25]EvjFsHnKqGocIHBJCHlFvyndo",220,0.995475,25,221,1,220,1,1,0,1,1,123,123,98,97,98
"8622",21,"[25]EvjFsHnKqGocIHBJCHlFvyndo",237,0.995798,25,238,1,237,1,1,0,1,1,111,111,127,126,98
"8623",22,"[25]EvjFsHnKqGocIHBJCHlFvyndo",238,0.995816,25,239,1,238,1,1,0,1,1,110,110,129,128,98
"8624",23,"[25]EvjFsHnKqGocIHBJCHlFvyndo",231,0.99569,25,232,1,231,1,1,0,1,1,114,114,118,117,98
"8625",24,"[25]EvjFsHnKqGocIHBJCHlFvyndo",238,0.995816,25,239,1,238,1,1,0,1,1,107,107,132,131,98
"8626",25,"[25]EvjFsHnKqGocIHBJCHlFvyndo",228,0.995633,25,229,1,228,1,1,0,1,1,116,116,113,112,98
"8627",26,"[25]EvjFsHnKqGocIHBJCHlFvyndo",218,0.995434,25,219,1,218,1,1,0,1,1,123,123,96,95,98
"8628",27,"[25]EvjFsHnKqGocIHBJCHlFvyndo",229,0.995652,25,230,1,229,1,1,0,1,1,115,115,115,114,98
"8629",28,"[25]EvjFsHnKqGocIHBJCHlFvyndo",226,0.995595,25,227,1,226,1,1,0,1,1,117,117,110,109,98
"8630",29,"[25]EvjFsHnKqGocIHBJCHlFvyndo",234,0.995745,25,235,1,234,1,1,0,1,1,111,111,124,123,98
"8631",30,"[25]EvjFsHnKqGocIHBJCHlFvyndo",242,0.995885,25,243,1,242,1,1,0,1,1,105,105,138,137,98
"8632",31,"[25]EvjFsHnKqGocIHBJCHlFvyndo",225,0.995575,25,226,1,225,1,1,0,1,1,119,119,107,106,98
"8633",32,"[25]EvjFsHnKqGocIHBJCHlFvyndo",225,0.995575,25,226,1,225,1,1,0,1,1,118,118,108,107,98
"8634",33,"[25]EvjFsHnKqGocIHBJCHlFvyndo",224,0.995556,25,225,1,224,1,1,0,1,1,119,119,106,105,98
"8635",34,"[25]EvjFsHnKqGocIHBJCHlFvyndo",225,0.995575,25,226,1,225,1,1,0,1,1,118,118,108,107,98
"8636",35,"[25]EvjFsHnKqGocIHBJCHlFvyndo",231,0.99569,25,232,1,231,1,1,0,1,1,114,114,118,117,98
"8637",36,"[25]EvjFsHnKqGocIHBJCHlFvyndo",228,0.995633,25,229,1,228,1,1,0,1,1,116,116,113,112,98
"8638",37,"[25]EvjFsHnKqGocIHBJCHlFvyndo",216,0.995392,25,217,1,216,1,1,0,1,1,127,127,90,89,98
"8639",38,"[25]EvjFsHnKqGocIHBJCHlFvyndo",228,0.995633,25,229,1,228,1,1,0,1,1,116,116,113,112,98
"8640",39,"[25]EvjFsHnKqGocIHBJCHlFvyndo",227,0.995614,25,228,1,227,1,1,0,1,1,117,117,111,110,98
"8641",40,"[25]EvjFsHnKqGocIHBJCHlFvyndo",235,0.995763,25,236,1,235,1,1,0,1,1,110,110,126,125,98
"8642",41,"[25]EvjFsHnKqGocIHBJCHlFvyndo",233,0.995726,25,234,1,233,1,1,0,1,1,112,112,122,121,98
"8643",42,"[25]EvjFsHnKqGocIHBJCHlFvyndo",229,0.995652,25,230,1,229,1,1,0,1,1,115,115,115,114,98
"8644",43,"[25]EvjFsHnKqGocIHBJCHlFvyndo",230,0.995671,25,231,1,230,1,1,0,1,1,115,115,116,115,98
"8645",44,"[25]EvjFsHnKqGocIHBJCHlFvyndo",233,0.995726,25,234,1,233,1,1,0,1,1,111,111,123,122,98
"8646",45,"[25]EvjFsHnKqGocIHBJCHlFvyndo",242,0.995885,25,243,1,242,1,1,0,1,1,104,104,139,138,98
"8647",46,"[25]EvjFsHnKqGocIHBJCHlFvyndo",235,0.995763,25,236,1,235,1,1,0,1,1,113,113,123,122,98
"8648",47,"[25]EvjFsHnKqGocIHBJCHlFvyndo",227,0.995614,25,228,1,227,1,1,0,1,1,116,116,112,111,98
"8649",48,"[25]EvjFsHnKqGocIHBJCHlFvyndo",228,0.995633,25,229,1,228,1,1,0,1,1,115,115,114,113,98
"8650",49,"[25]EvjFsHnKqGocIHBJCHlFvyndo",232,0.995708,25,233,1,232,1,1,0,1,1,112,112,121,120,98
"8651",50,"[25]EvjFsHnKqGocIHBJCHlFvyndo",229,0.995652,25,230,1,229,1,1,0,1,1,115,115,115,114,98
"8652",51,"[25]EvjFsHnKqGocIHBJCHlFvyndo",226,0.995595,25,227,1,226,1,1,0,1,1,118,118,109,108,98
"8653",52,"[25]EvjFsHnKqGocIHBJCHlFvyndo",234,0.995745,25,235,1,234,1,1,0,1,1,111,111,124,123,98
"8654",53,"[25]EvjFsHnKqGocIHBJCHlFvyndo",234,0.995745,25,235,1,234,1,1,0,1,1,111,111,124,123,98
"8655",54,"[25]EvjFsHnKqGocIHBJCHlFvyndo",229,0.995652,25,230,1,229,1,1,0,1,1,115,115,115,114,98
"8656",55,"[25]EvjFsHnKqGocIHBJCHlFvyndo",230,0.995671,25,231,1,230,1,1,0,1,1,114,114,117,116,98
"8657",56,"[25]EvjFsHnKqGocIHBJCHlFvyndo",223,0.995536,25,224,1,223,1,1,0,1,1,121,121,103,102,98
"8658",57,"[25]EvjFsHnKqGocIHBJCHlFvyndo",236,0.995781,25,237,1,236,1,1,0,1,1,113,113,124,123,98
"8659",58,"[25]EvjFsHnKqGocIHBJCHlFvyndo",235,0.995763,25,236,1,235,1,1,0,1,1,111,111,125,124,98
"8660",59,"[25]EvjFsHnKqGocIHBJCHlFvyndo",230,0.995671,25,231,1,230,1,1,0,1,1,114,114,117,116,98
"8661",60,"[25]EvjFsHnKqGocIHBJCHlFvyndo",220,0.995475,25,221,1,220,1,1,0,1,1,122,122,99,98,98
"8662",61,"[25]EvjFsHnKqGocIHBJCHlFvyndo",238,0.995816,25,239,1,238,1,1,0,1,1,107,107,132,131,98
"8663",62,"[25]EvjFsHnKqGocIHBJCHlFvyndo",234,0.995745,25,235,1,234,1,1,0,1,1,111,111,124,123,98
"8664",63,"[25]EvjFsHnKqGocIHBJCHlFvyndo",226,0.995595,25,227,1,226,1,1,0,1,1,121,121,106,105,98
"8665",64,"[25]EvjFsHnKqGocIHBJCHlFvyndo",239,0.995833,25,240,1,239,1,1,0,1,1,110,110,130,129,98
"8666",65,"[25]EvjFsHnKqGocIHBJCHlFvyndo",237,0.995798,25,238,1,237,1,1,0,1,1,109,109,129,128,98
"8667",66,"[25]EvjFsHnKqGocIHBJCHlFvyndo",228,0.995633,25,229,1,228,1,1,0,1,1,116,116,113,112,98
"8668",67,"[25]EvjFsHnKqGocIHBJCHlFvyndo",229,0.995652,25,230,1,229,1,1,0,1,1,117,117,113,112,98
"8669",68,"[25]EvjFsHnKqGocIHBJCHlFvyndo",230,0.995671,25,231,1,230,1,1,0,1,1,114,114,117,116,98
"8670",69,"[25]EvjFsHnKqGocIHBJCHlFvyndo",232,0.995708,25,233,1,232,1,1,0,1,1,113,113,120,119,98
"8671",70,"[25]EvjFsHnKqGocIHBJCHlFvyndo",228,0.995633,25,229,1,228,1,1,0,1,1,116,116,113,112,98
"8672",71,"[25]EvjFsHnKqGocIHBJCHlFvyndo",228,0.995633,25,229,1,228,1,1,0,1,1,116,116,113,112,98
"8673",72,"[25]EvjFsHnKqGocIHBJCHlFvyndo",226,0.995595,25,227,1,226,1,1,0,1,1,117,117,110,109,98
"8674",73,"[25]EvjFsHnKqGocIHBJCHlFvyndo",227,0.995614,25,228,1,227,1,1,0,1,1,117,117,111,110,98
"8675",74,"[25]EvjFsHnKqGocIHBJCHlFvyndo",237,0.995798,25,238,1,237,1,1,0,1,1,110,110,128,127,98
"8676",75,"[25]EvjFsHnKqGocIHBJCHlFvyndo",221,0.995495,25,222,1,221,1,1,0,1,1,121,121,101,100,98
"8677",76,"[25]EvjFsHnKqGocIHBJCHlFvyndo",226,0.995595,25,227,1,226,1,1,0,1,1,117,117,110,109,98
"8678",77,"[25]EvjFsHnKqGocIHBJCHlFvyndo",230,0.995671,25,231,1,230,1,1,0,1,1,115,115,116,115,98
"8679",78,"[25]EvjFsHnKqGocIHBJCHlFvyndo",229,0.995652,25,230,1,229,1,1,0,1,1,116,116,114,113,98
"8680",79,"[25]EvjFsHnKqGocIHBJCHlFvyndo",224,0.995556,25,225,1,224,1,1,0,1,1,119,119,106,105,98
"8681",80,"[25]EvjFsHnKqGocIHBJCHlFvyndo",225,0.995575,25,226,1,225,1,1,0,1,1,118,118,108,107,98
"8682",81,"[25]EvjFsHnKqGocIHBJCHlFvyndo",228,0.995633,25,229,1,228,1,1,0,1,1,115,115,114,113,98
"8683",82,"[25]EvjFsHnKqGocIHBJCHlFvyndo",233,0.995726,25,234,1,233,1,1,0,1,1,111,111,123,122,98
"8684",83,"[25]EvjFsHnKqGocIHBJCHlFvyndo",235,0.995763,25,236,1,235,1,1,0,1,1,111,111,125,124,98
"8685",84,"[25]EvjFsHnKqGocIHBJCHlFvyndo",222,0.995516,25,223,1,222,1,1,0,1,1,120,120,103,102,98
"8686",85,"[25]EvjFsHnKqGocIHBJCHlFvyndo",237,0.995798,25,238,1,237,1,1,0,1,1,110,110,128,127,98
"8687",86,"[25]EvjFsHnKqGocIHBJCHlFvyndo",238,0.995816,25,239,1,238,1,1,0,1,1,108,108,131,130,98
"8688",87,"[25]EvjFsHnKqGocIHBJCHlFvyndo",221,0.995495,25,222,1,221,1,1,0,1,1,123,123,99,98,98
"8689",88,"[25]EvjFsHnKqGocIHBJCHlFvyndo",230,0.995671,25,231,1,230,1,1,0,1,1,114,114,117,116,98
"8690",89,"[25]EvjFsHnKqGocIHBJCHlFvyndo",237,0.995798,25,238,1,237,1,1,0,1,1,108,108,130,129,98
"8691",90,"[25]EvjFsHnKqGocIHBJCHlFvyndo",231,0.99569,25,232,1,231,1,1,0,1,1,113,113,119,118,98
"8692",91,"[25]EvjFsHnKqGocIHBJCHlFvyndo",223,0.995536,25,224,1,223,1,1,0,1,1,119,119,105,104,98
"8693",92,"[25]EvjFsHnKqGocIHBJCHlFvyndo",240,0.995851,25,241,1,240,1,1,0,1,1,106,106,135,134,98
"8694",93,"[25]EvjFsHnKqGocIHBJCHlFvyndo",239,0.995833,25,240,1,239,1,1,0,1,1,109,109,131,130,98
"8695",94,"[25]EvjFsHnKqGocIHBJCHlFvyndo",236,0.995781,25,237,1,236,1,1,0,1,1,109,109,128,127,98
"8696",95,"[25]EvjFsHnKqGocIHBJCHlFvyndo",229,0.995652,25,230,1,229,1,1,0,1,1,115,115,115,114,98
"8697",96,"[25]EvjFsHnKqGocIHBJCHlFvyndo",227,0.995614,25,228,1,227,1,1,0,1,1,116,116,112,111,98
"8698",97,"[25]EvjFsHnKqGocIHBJCHlFvyndo",231,0.99569,25,232,1,231,1,1,0,1,1,114,114,118,117,98
"8699",98,"[25]EvjFsHnKqGocIHBJCHlFvyndo",229,0.995652,25,230,1,229,1,1,0,1,1,117,117,113,112,98
"8700",99,"[25]EvjFsHnKqGocIHBJCHlFvyndo",230,0.995671,25,231,1,230,1,1,0,1,1,114,114,117,116,98
"8701",0,"[28]EvkyjuHnKqGocIHBJCFoycgmxsub",238,0.995816,28,239,1,238,1,1,0,1,1,109,109,130,129,99
"8702",1,"[28]EvkyjuHnKqGocIHBJCFoycgmxsub",235,0.995763,28,236,1,235,1,1,0,1,1,110,110,126,125,99
"8703",2,"[28]EvkyjuHnKqGocIHBJCFoycgmxsub",235,0.995763,28,236,1,235,1,1,0,1,1,111,111,125,124,99
"8704",3,"[28]EvkyjuHnKqGocIHBJCFoycgmxsub",226,0.995595,28,227,1,226,1,1,0,1,1,117,117,110,109,99
"8705",4,"[28]EvkyjuHnKqGocIHBJCFoycgmxsub",238,0.995816,28,239,1,238,1,1,0,1,1,112,112,127,126,99
"8706",5,"[28]EvkyjuHnKqGocIHBJCFoycgmxsub",238,0.995816,28,239,1,238,1,1,0,1,1,110,110,129,128,99
"8707",6,"[28]EvkyjuHnKqGocIHBJCFoycgmxsub",232,0.995708,28,233,1,232,1,1,0,1,1,113,113,120,119,99
"8708",7,"[28]EvkyjuHnKqGocIHBJCFoycgmxsub",231,0.99569,28,232,1,231,1,1,0,1,1,117,117,115,114,99
"8709",8,"[28]EvkyjuHnKqGocIHBJCFoycgmxsub",225,0.995575,28,226,1,225,1,1,0,1,1,119,119,107,106,99
"8710",9,"[28]EvkyjuHnKqGocIHBJCFoycgmxsub",234,0.995745,28,235,1,234,1,1,0,1,1,112,112,123,122,99
"8711",10,"[28]EvkyjuHnKqGocIHBJCFoycgmxsub",231,0.99569,28,232,1,231,1,1,0,1,1,115,115,117,116,99
"8712",11,"[28]EvkyjuHnKqGocIHBJCFoycgmxsub",230,0.995671,28,231,1,230,1,1,0,1,1,114,114,117,116,99
"8713",12,"[28]EvkyjuHnKqGocIHBJCFoycgmxsub",227,0.995614,28,228,1,227,1,1,0,1,1,118,118,110,109,99
"8714",13,"[28]EvkyjuHnKqGocIHBJCFoycgmxsub",230,0.995671,28,231,1,230,1,1,0,1,1,118,118,113,112,99
"8715",14,"[28]EvkyjuHnKqGocIHBJCFoycgmxsub",230,0.995671,28,231,1,230,1,1,0,1,1,114,114,117,116,99
"8716",15,"[28]EvkyjuHnKqGocIHBJCFoycgmxsub",229,0.995652,28,230,1,229,1,1,0,1,1,114,114,116,115,99
"8717",16,"[28]EvkyjuHnKqGocIHBJCFoycgmxsub",229,0.995652,28,230,1,229,1,1,0,1,1,116,116,114,113,99
"8718",17,"[28]EvkyjuHnKqGocIHBJCFoycgmxsub",235,0.995763,28,236,1,235,1,1,0,1,1,112,112,124,123,99
"8719",18,"[28]EvkyjuHnKqGocIHBJCFoycgmxsub",227,0.995614,28,228,1,227,1,1,0,1,1,116,116,112,111,99
"8720",19,"[28]EvkyjuHnKqGocIHBJCFoycgmxsub",240,0.995851,28,241,1,240,1,1,0,1,1,107,107,134,133,99
"8721",20,"[28]EvkyjuHnKqGocIHBJCFoycgmxsub",234,0.995745,28,235,1,234,1,1,0,1,1,112,112,123,122,99
"8722",21,"[28]EvkyjuHnKqGocIHBJCFoycgmxsub",233,0.995726,28,234,1,233,1,1,0,1,1,115,115,119,118,99
"8723",22,"[28]EvkyjuHnKqGocIHBJCFoycgmxsub",225,0.995575,28,226,1,225,1,1,0,1,1,119,119,107,106,99
"8724",23,"[28]EvkyjuHnKqGocIHBJCFoycgmxsub",234,0.995745,28,235,1,234,1,1,0,1,1,112,112,123,122,99
"8725",24,"[28]EvkyjuHnKqGocIHBJCFoycgmxsub",234,0.995745,28,235,1,234,1,1,0,1,1,112,112,123,122,99
"8726",25,"[28]EvkyjuHnKqGocIHBJCFoycgmxsub",229,0.995652,28,230,1,229,1,1,0,1,1,117,117,113,112,99
"8727",26,"[28]EvkyjuHnKqGocIHBJCFoycgmxsub",226,0.995595,28,227,1,226,1,1,0,1,1,118,118,109,108,99
"8728",27,"[28]EvkyjuHnKqGocIHBJCFoycgmxsub",225,0.995575,28,226,1,225,1,1,0,1,1,118,118,108,107,99
"8729",28,"[28]EvkyjuHnKqGocIHBJCFoycgmxsub",233,0.995726,28,234,1,233,1,1,0,1,1,115,115,119,118,99
"8730",29,"[28]EvkyjuHnKqGocIHBJCFoycgmxsub",227,0.995614,28,228,1,227,1,1,0,1,1,116,116,112,111,99
"8731",30,"[28]EvkyjuHnKqGocIHBJCFoycgmxsub",237,0.995798,28,238,1,237,1,1,0,1,1,109,109,129,128,99
"8732",31,"[28]EvkyjuHnKqGocIHBJCFoycgmxsub",234,0.995745,28,235,1,234,1,1,0,1,1,114,114,121,120,99
"8733",32,"[28]EvkyjuHnKqGocIHBJCFoycgmxsub",228,0.995633,28,229,1,228,1,1,0,1,1,116,116,113,112,99
"8734",33,"[28]EvkyjuHnKqGocIHBJCFoycgmxsub",233,0.995726,28,234,1,233,1,1,0,1,1,112,112,122,121,99
"8735",34,"[28]EvkyjuHnKqGocIHBJCFoycgmxsub",228,0.995633,28,229,1,228,1,1,0,1,1,117,117,112,111,99
"8736",35,"[28]EvkyjuHnKqGocIHBJCFoycgmxsub",230,0.995671,28,231,1,230,1,1,0,1,1,114,114,117,116,99
"8737",36,"[28]EvkyjuHnKqGocIHBJCFoycgmxsub",241,0.995868,28,242,1,241,1,1,0,1,1,106,106,136,135,99
"8738",37,"[28]EvkyjuHnKqGocIHBJCFoycgmxsub",229,0.995652,28,230,1,229,1,1,0,1,1,116,116,114,113,99
"8739",38,"[28]EvkyjuHnKqGocIHBJCFoycgmxsub",223,0.995536,28,224,1,223,1,1,0,1,1,121,121,103,102,99
"8740",39,"[28]EvkyjuHnKqGocIHBJCFoycgmxsub",228,0.995633,28,229,1,228,1,1,0,1,1,117,117,112,111,99
"8741",40,"[28]EvkyjuHnKqGocIHBJCFoycgmxsub",222,0.995516,28,223,1,222,1,1,0,1,1,121,121,102,101,99
"8742",41,"[28]EvkyjuHnKqGocIHBJCFoycgmxsub",239,0.995833,28,240,1,239,1,1,0,1,1,107,107,133,132,99
"8743",42,"[28]EvkyjuHnKqGocIHBJCFoycgmxsub",231,0.99569,28,232,1,231,1,1,0,1,1,113,113,119,118,99
"8744",43,"[28]EvkyjuHnKqGocIHBJCFoycgmxsub",232,0.995708,28,233,1,232,1,1,0,1,1,113,113,120,119,99
"8745",44,"[28]EvkyjuHnKqGocIHBJCFoycgmxsub",229,0.995652,28,230,1,229,1,1,0,1,1,115,115,115,114,99
"8746",45,"[28]EvkyjuHnKqGocIHBJCFoycgmxsub",226,0.995595,28,227,1,226,1,1,0,1,1,117,117,110,109,99
"8747",46,"[28]EvkyjuHnKqGocIHBJCFoycgmxsub",226,0.995595,28,227,1,226,1,1,0,1,1,118,118,109,108,99
"8748",47,"[28]EvkyjuHnKqGocIHBJCFoycgmxsub",226,0.995595,28,227,1,226,1,1,0,1,1,117,117,110,109,99
"8749",48,"[28]EvkyjuHnKqGocIHBJCFoycgmxsub",239,0.995833,28,240,1,239,1,1,0,1,1,106,106,134,133,99
"8750",49,"[28]EvkyjuHnKqGocIHBJCFoycgmxsub",229,0.995652,28,230,1,229,1,1,0,1,1,115,115,115,114,99
"8751",50,"[28]EvkyjuHnKqGocIHBJCFoycgmxsub",220,0.995475,28,221,1,220,1,1,0,1,1,122,122,99,98,99
"8752",51,"[28]EvkyjuHnKqGocIHBJCFoycgmxsub",239,0.995833,28,240,1,239,1,1,0,1,1,106,106,134,133,99
"8753",52,"[28]EvkyjuHnKqGocIHBJCFoycgmxsub",245,0.995935,28,246,1,245,1,1,0,1,1,108,108,138,137,99
"8754",53,"[28]EvkyjuHnKqGocIHBJCFoycgmxsub",241,0.995868,28,242,1,241,1,1,0,1,1,106,106,136,135,99
"8755",54,"[28]EvkyjuHnKqGocIHBJCFoycgmxsub",232,0.995708,28,233,1,232,1,1,0,1,1,112,112,121,120,99
"8756",55,"[28]EvkyjuHnKqGocIHBJCFoycgmxsub",220,0.995475,28,221,1,220,1,1,0,1,1,122,122,99,98,99
"8757",56,"[28]EvkyjuHnKqGocIHBJCFoycgmxsub",231,0.99569,28,232,1,231,1,1,0,1,1,113,113,119,118,99
"8758",57,"[28]EvkyjuHnKqGocIHBJCFoycgmxsub",232,0.995708,28,233,1,232,1,1,0,1,1,114,114,119,118,99
"8759",58,"[28]EvkyjuHnKqGocIHBJCFoycgmxsub",231,0.99569,28,232,1,231,1,1,0,1,1,115,115,117,116,99
"8760",59,"[28]EvkyjuHnKqGocIHBJCFoycgmxsub",226,0.995595,28,227,1,226,1,1,0,1,1,118,118,109,108,99
"8761",60,"[28]EvkyjuHnKqGocIHBJCFoycgmxsub",223,0.995536,28,224,1,223,1,1,0,1,1,119,119,105,104,99
"8762",61,"[28]EvkyjuHnKqGocIHBJCFoycgmxsub",221,0.995495,28,222,1,221,1,1,0,1,1,121,121,101,100,99
"8763",62,"[28]EvkyjuHnKqGocIHBJCFoycgmxsub",234,0.995745,28,235,1,234,1,1,0,1,1,111,111,124,123,99
"8764",63,"[28]EvkyjuHnKqGocIHBJCFoycgmxsub",231,0.99569,28,232,1,231,1,1,0,1,1,114,114,118,117,99
"8765",64,"[28]EvkyjuHnKqGocIHBJCFoycgmxsub",232,0.995708,28,233,1,232,1,1,0,1,1,112,112,121,120,99
"8766",65,"[28]EvkyjuHnKqGocIHBJCFoycgmxsub",221,0.995495,28,222,1,221,1,1,0,1,1,122,122,100,99,99
"8767",66,"[28]EvkyjuHnKqGocIHBJCFoycgmxsub",222,0.995516,28,223,1,222,1,1,0,1,1,121,121,102,101,99
"8768",67,"[28]EvkyjuHnKqGocIHBJCFoycgmxsub",225,0.995575,28,226,1,225,1,1,0,1,1,118,118,108,107,99
"8769",68,"[28]EvkyjuHnKqGocIHBJCFoycgmxsub",233,0.995726,28,234,1,233,1,1,0,1,1,113,113,121,120,99
"8770",69,"[28]EvkyjuHnKqGocIHBJCFoycgmxsub",224,0.995556,28,225,1,224,1,1,0,1,1,119,119,106,105,99
"8771",70,"[28]EvkyjuHnKqGocIHBJCFoycgmxsub",232,0.995708,28,233,1,232,1,1,0,1,1,115,115,118,117,99
"8772",71,"[28]EvkyjuHnKqGocIHBJCFoycgmxsub",234,0.995745,28,235,1,234,1,1,0,1,1,110,110,125,124,99
"8773",72,"[28]EvkyjuHnKqGocIHBJCFoycgmxsub",244,0.995918,28,245,1,244,1,1,0,1,1,103,103,142,141,99
"8774",73,"[28]EvkyjuHnKqGocIHBJCFoycgmxsub",224,0.995556,28,225,1,224,1,1,0,1,1,119,119,106,105,99
"8775",74,"[28]EvkyjuHnKqGocIHBJCFoycgmxsub",222,0.995516,28,223,1,222,1,1,0,1,1,120,120,103,102,99
"8776",75,"[28]EvkyjuHnKqGocIHBJCFoycgmxsub",224,0.995556,28,225,1,224,1,1,0,1,1,118,118,107,106,99
"8777",76,"[28]EvkyjuHnKqGocIHBJCFoycgmxsub",236,0.995781,28,237,1,236,1,1,0,1,1,110,110,127,126,99
"8778",77,"[28]EvkyjuHnKqGocIHBJCFoycgmxsub",231,0.99569,28,232,1,231,1,1,0,1,1,113,113,119,118,99
"8779",78,"[28]EvkyjuHnKqGocIHBJCFoycgmxsub",237,0.995798,28,238,1,237,1,1,0,1,1,111,111,127,126,99
"8780",79,"[28]EvkyjuHnKqGocIHBJCFoycgmxsub",234,0.995745,28,235,1,234,1,1,0,1,1,110,110,125,124,99
"8781",80,"[28]EvkyjuHnKqGocIHBJCFoycgmxsub",240,0.995851,28,241,1,240,1,1,0,1,1,106,106,135,134,99
"8782",81,"[28]EvkyjuHnKqGocIHBJCFoycgmxsub",234,0.995745,28,235,1,234,1,1,0,1,1,113,113,122,121,99
"8783",82,"[28]EvkyjuHnKqGocIHBJCFoycgmxsub",219,0.995455,28,220,1,219,1,1,0,1,1,123,123,97,96,99
"8784",83,"[28]EvkyjuHnKqGocIHBJCFoycgmxsub",217,0.995413,28,218,1,217,1,1,0,1,1,125,125,93,92,99
"8785",84,"[28]EvkyjuHnKqGocIHBJCFoycgmxsub",244,0.995918,28,245,1,244,1,1,0,1,1,102,102,143,142,99
"8786",85,"[28]EvkyjuHnKqGocIHBJCFoycgmxsub",234,0.995745,28,235,1,234,1,1,0,1,1,110,110,125,124,99
"8787",86,"[28]EvkyjuHnKqGocIHBJCFoycgmxsub",227,0.995614,28,228,1,227,1,1,0,1,1,116,116,112,111,99
"8788",87,"[28]EvkyjuHnKqGocIHBJCFoycgmxsub",223,0.995536,28,224,1,223,1,1,0,1,1,122,122,102,101,99
"8789",88,"[28]EvkyjuHnKqGocIHBJCFoycgmxsub",233,0.995726,28,234,1,233,1,1,0,1,1,112,112,122,121,99
"8790",89,"[28]EvkyjuHnKqGocIHBJCFoycgmxsub",229,0.995652,28,230,1,229,1,1,0,1,1,116,116,114,113,99
"8791",90,"[28]EvkyjuHnKqGocIHBJCFoycgmxsub",235,0.995763,28,236,1,235,1,1,0,1,1,111,111,125,124,99
"8792",91,"[28]EvkyjuHnKqGocIHBJCFoycgmxsub",237,0.995798,28,238,1,237,1,1,0,1,1,108,108,130,129,99
"8793",92,"[28]EvkyjuHnKqGocIHBJCFoycgmxsub",237,0.995798,28,238,1,237,1,1,0,1,1,111,111,127,126,99
"8794",93,"[28]EvkyjuHnKqGocIHBJCFoycgmxsub",241,0.995868,28,242,1,241,1,1,0,1,1,106,106,136,135,99
"8795",94,"[28]EvkyjuHnKqGocIHBJCFoycgmxsub",228,0.995633,28,229,1,228,1,1,0,1,1,115,115,114,113,99
"8796",95,"[28]EvkyjuHnKqGocIHBJCFoycgmxsub",237,0.995798,28,238,1,237,1,1,0,1,1,109,109,129,128,99
"8797",96,"[28]EvkyjuHnKqGocIHBJCFoycgmxsub",234,0.995745,28,235,1,234,1,1,0,1,1,110,110,125,124,99
"8798",97,"[28]EvkyjuHnKqGocIHBJCFoycgmxsub",238,0.995816,28,239,1,238,1,1,0,1,1,108,108,131,130,99
"8799",98,"[28]EvkyjuHnKqGocIHBJCFoycgmxsub",235,0.995763,28,236,1,235,1,1,0,1,1,110,110,126,125,99
"8800",99,"[28]EvkyjuHnKqGocIHBJCFoycgmxsub",224,0.995556,28,225,1,224,1,1,0,1,1,122,122,103,102,99
"8801",0,"[29]EdwvHnKqGocIHcJCriBKxsqdkvJrw",240,0.995851,29,241,1,240,1,1,0,1,1,106,106,135,134,100
"8802",1,"[29]EdwvHnKqGocIHcJCriBKxsqdkvJrw",229,0.995652,29,230,1,229,1,1,0,1,1,115,115,115,114,100
"8803",2,"[29]EdwvHnKqGocIHcJCriBKxsqdkvJrw",231,0.99569,29,232,1,231,1,1,0,1,1,116,116,116,115,100
"8804",3,"[29]EdwvHnKqGocIHcJCriBKxsqdkvJrw",236,0.995781,29,237,1,236,1,1,0,1,1,110,110,127,126,100
"8805",4,"[29]EdwvHnKqGocIHcJCriBKxsqdkvJrw",229,0.995652,29,230,1,229,1,1,0,1,1,116,116,114,113,100
"8806",5,"[29]EdwvHnKqGocIHcJCriBKxsqdkvJrw",231,0.99569,29,232,1,231,1,1,0,1,1,115,115,117,116,100
"8807",6,"[29]EdwvHnKqGocIHcJCriBKxsqdkvJrw",239,0.995833,29,240,1,239,1,1,0,1,1,107,107,133,132,100
"8808",7,"[29]EdwvHnKqGocIHcJCriBKxsqdkvJrw",221,0.995495,29,222,1,221,1,1,0,1,1,121,121,101,100,100
"8809",8,"[29]EdwvHnKqGocIHcJCriBKxsqdkvJrw",247,0.995968,29,248,1,247,1,1,0,1,1,107,107,141,140,100
"8810",9,"[29]EdwvHnKqGocIHcJCriBKxsqdkvJrw",224,0.995556,29,225,1,224,1,1,0,1,1,119,119,106,105,100
"8811",10,"[29]EdwvHnKqGocIHcJCriBKxsqdkvJrw",232,0.995708,29,233,1,232,1,1,0,1,1,117,117,116,115,100
"8812",11,"[29]EdwvHnKqGocIHcJCriBKxsqdkvJrw",229,0.995652,29,230,1,229,1,1,0,1,1,117,117,113,112,100
"8813",12,"[29]EdwvHnKqGocIHcJCriBKxsqdkvJrw",229,0.995652,29,230,1,229,1,1,0,1,1,115,115,115,114,100
"8814",13,"[29]EdwvHnKqGocIHcJCriBKxsqdkvJrw",227,0.995614,29,228,1,227,1,1,0,1,1,116,116,112,111,100
"8815",14,"[29]EdwvHnKqGocIHcJCriBKxsqdkvJrw",214,0.995349,29,215,1,214,1,1,0,1,1,127,127,88,87,100
"8816",15,"[29]EdwvHnKqGocIHcJCriBKxsqdkvJrw",242,0.995885,29,243,1,242,1,1,0,1,1,104,104,139,138,100
"8817",16,"[29]EdwvHnKqGocIHcJCriBKxsqdkvJrw",239,0.995833,29,240,1,239,1,1,0,1,1,107,107,133,132,100
"8818",17,"[29]EdwvHnKqGocIHcJCriBKxsqdkvJrw",229,0.995652,29,230,1,229,1,1,0,1,1,115,115,115,114,100
"8819",18,"[29]EdwvHnKqGocIHcJCriBKxsqdkvJrw",239,0.995833,29,240,1,239,1,1,0,1,1,108,108,132,131,100
"8820",19,"[29]EdwvHnKqGocIHcJCriBKxsqdkvJrw",223,0.995536,29,224,1,223,1,1,0,1,1,120,120,104,103,100
"8821",20,"[29]EdwvHnKqGocIHcJCriBKxsqdkvJrw",231,0.99569,29,232,1,231,1,1,0,1,1,117,117,115,114,100
"8822",21,"[29]EdwvHnKqGocIHcJCriBKxsqdkvJrw",229,0.995652,29,230,1,229,1,1,0,1,1,115,115,115,114,100
"8823",22,"[29]EdwvHnKqGocIHcJCriBKxsqdkvJrw",223,0.995536,29,224,1,223,1,1,0,1,1,120,120,104,103,100
"8824",23,"[29]EdwvHnKqGocIHcJCriBKxsqdkvJrw",234,0.995745,29,235,1,234,1,1,0,1,1,113,113,122,121,100
"8825",24,"[29]EdwvHnKqGocIHcJCriBKxsqdkvJrw",235,0.995763,29,236,1,235,1,1,0,1,1,112,112,124,123,100
"8826",25,"[29]EdwvHnKqGocIHcJCriBKxsqdkvJrw",225,0.995575,29,226,1,225,1,1,0,1,1,119,119,107,106,100
"8827",26,"[29]EdwvHnKqGocIHcJCriBKxsqdkvJrw",233,0.995726,29,234,1,233,1,1,0,1,1,112,112,122,121,100
"8828",27,"[29]EdwvHnKqGocIHcJCriBKxsqdkvJrw",232,0.995708,29,233,1,232,1,1,0,1,1,115,115,118,117,100
"8829",28,"[29]EdwvHnKqGocIHcJCriBKxsqdkvJrw",227,0.995614,29,228,1,227,1,1,0,1,1,118,118,110,109,100
"8830",29,"[29]EdwvHnKqGocIHcJCriBKxsqdkvJrw",229,0.995652,29,230,1,229,1,1,0,1,1,115,115,115,114,100
"8831",30,"[29]EdwvHnKqGocIHcJCriBKxsqdkvJrw",232,0.995708,29,233,1,232,1,1,0,1,1,113,113,120,119,100
"8832",31,"[29]EdwvHnKqGocIHcJCriBKxsqdkvJrw",236,0.995781,29,237,1,236,1,1,0,1,1,111,111,126,125,100
"8833",32,"[29]EdwvHnKqGocIHcJCriBKxsqdkvJrw",233,0.995726,29,234,1,233,1,1,0,1,1,112,112,122,121,100
"8834",33,"[29]EdwvHnKqGocIHcJCriBKxsqdkvJrw",230,0.995671,29,231,1,230,1,1,0,1,1,120,120,111,110,100
"8835",34,"[29]EdwvHnKqGocIHcJCriBKxsqdkvJrw",222,0.995516,29,223,1,222,1,1,0,1,1,123,123,100,99,100
"8836",35,"[29]EdwvHnKqGocIHcJCriBKxsqdkvJrw",233,0.995726,29,234,1,233,1,1,0,1,1,112,112,122,121,100
"8837",36,"[29]EdwvHnKqGocIHcJCriBKxsqdkvJrw",230,0.995671,29,231,1,230,1,1,0,1,1,114,114,117,116,100
"8838",37,"[29]EdwvHnKqGocIHcJCriBKxsqdkvJrw",221,0.995495,29,222,1,221,1,1,0,1,1,121,121,101,100,100
"8839",38,"[29]EdwvHnKqGocIHcJCriBKxsqdkvJrw",235,0.995763,29,236,1,235,1,1,0,1,1,115,115,121,120,100
"8840",39,"[29]EdwvHnKqGocIHcJCriBKxsqdkvJrw",225,0.995575,29,226,1,225,1,1,0,1,1,118,118,108,107,100
"8841",40,"[29]EdwvHnKqGocIHcJCriBKxsqdkvJrw",241,0.995868,29,242,1,241,1,1,0,1,1,107,107,135,134,100
"8842",41,"[29]EdwvHnKqGocIHcJCriBKxsqdkvJrw",224,0.995556,29,225,1,224,1,1,0,1,1,120,120,105,104,100
"8843",42,"[29]EdwvHnKqGocIHcJCriBKxsqdkvJrw",221,0.995495,29,222,1,221,1,1,0,1,1,122,122,100,99,100
"8844",43,"[29]EdwvHnKqGocIHcJCriBKxsqdkvJrw",233,0.995726,29,234,1,233,1,1,0,1,1,112,112,122,121,100
"8845",44,"[29]EdwvHnKqGocIHcJCriBKxsqdkvJrw",237,0.995798,29,238,1,237,1,1,0,1,1,108,108,130,129,100
"8846",45,"[29]EdwvHnKqGocIHcJCriBKxsqdkvJrw",231,0.99569,29,232,1,231,1,1,0,1,1,114,114,118,117,100
"8847",46,"[29]EdwvHnKqGocIHcJCriBKxsqdkvJrw",228,0.995633,29,229,1,228,1,1,0,1,1,116,116,113,112,100
"8848",47,"[29]EdwvHnKqGocIHcJCriBKxsqdkvJrw",224,0.995556,29,225,1,224,1,1,0,1,1,120,120,105,104,100
"8849",48,"[29]EdwvHnKqGocIHcJCriBKxsqdkvJrw",226,0.995595,29,227,1,226,1,1,0,1,1,118,118,109,108,100
"8850",49,"[29]EdwvHnKqGocIHcJCriBKxsqdkvJrw",224,0.995556,29,225,1,224,1,1,0,1,1,119,119,106,105,100
"8851",50,"[29]EdwvHnKqGocIHcJCriBKxsqdkvJrw",241,0.995868,29,242,1,241,1,1,0,1,1,106,106,136,135,100
"8852",51,"[29]EdwvHnKqGocIHcJCriBKxsqdkvJrw",223,0.995536,29,224,1,223,1,1,0,1,1,121,121,103,102,100
"8853",52,"[29]EdwvHnKqGocIHcJCriBKxsqdkvJrw",236,0.995781,29,237,1,236,1,1,0,1,1,116,116,121,120,100
"8854",53,"[29]EdwvHnKqGocIHcJCriBKxsqdkvJrw",229,0.995652,29,230,1,229,1,1,0,1,1,115,115,115,114,100
"8855",54,"[29]EdwvHnKqGocIHcJCriBKxsqdkvJrw",235,0.995763,29,236,1,235,1,1,0,1,1,112,112,124,123,100
"8856",55,"[29]EdwvHnKqGocIHcJCriBKxsqdkvJrw",239,0.995833,29,240,1,239,1,1,0,1,1,107,107,133,132,100
"8857",56,"[29]EdwvHnKqGocIHcJCriBKxsqdkvJrw",236,0.995781,29,237,1,236,1,1,0,1,1,109,109,128,127,100
"8858",57,"[29]EdwvHnKqGocIHcJCriBKxsqdkvJrw",227,0.995614,29,228,1,227,1,1,0,1,1,119,119,109,108,100
"8859",58,"[29]EdwvHnKqGocIHcJCriBKxsqdkvJrw",225,0.995575,29,226,1,225,1,1,0,1,1,119,119,107,106,100
"8860",59,"[29]EdwvHnKqGocIHcJCriBKxsqdkvJrw",241,0.995868,29,242,1,241,1,1,0,1,1,112,112,130,129,100
"8861",60,"[29]EdwvHnKqGocIHcJCriBKxsqdkvJrw",233,0.995726,29,234,1,233,1,1,0,1,1,113,113,121,120,100
"8862",61,"[29]EdwvHnKqGocIHcJCriBKxsqdkvJrw",233,0.995726,29,234,1,233,1,1,0,1,1,112,112,122,121,100
"8863",62,"[29]EdwvHnKqGocIHcJCriBKxsqdkvJrw",234,0.995745,29,235,1,234,1,1,0,1,1,112,112,123,122,100
"8864",63,"[29]EdwvHnKqGocIHcJCriBKxsqdkvJrw",240,0.995851,29,241,1,240,1,1,0,1,1,107,107,134,133,100
"8865",64,"[29]EdwvHnKqGocIHcJCriBKxsqdkvJrw",226,0.995595,29,227,1,226,1,1,0,1,1,118,118,109,108,100
"8866",65,"[29]EdwvHnKqGocIHcJCriBKxsqdkvJrw",227,0.995614,29,228,1,227,1,1,0,1,1,116,116,112,111,100
"8867",66,"[29]EdwvHnKqGocIHcJCriBKxsqdkvJrw",229,0.995652,29,230,1,229,1,1,0,1,1,115,115,115,114,100
"8868",67,"[29]EdwvHnKqGocIHcJCriBKxsqdkvJrw",227,0.995614,29,228,1,227,1,1,0,1,1,117,117,111,110,100
"8869",68,"[29]EdwvHnKqGocIHcJCriBKxsqdkvJrw",229,0.995652,29,230,1,229,1,1,0,1,1,116,116,114,113,100
"8870",69,"[29]EdwvHnKqGocIHcJCriBKxsqdkvJrw",239,0.995833,29,240,1,239,1,1,0,1,1,107,107,133,132,100
"8871",70,"[29]EdwvHnKqGocIHcJCriBKxsqdkvJrw",231,0.99569,29,232,1,231,1,1,0,1,1,114,114,118,117,100
"8872",71,"[29]EdwvHnKqGocIHcJCriBKxsqdkvJrw",235,0.995763,29,236,1,235,1,1,0,1,1,111,111,125,124,100
"8873",72,"[29]EdwvHnKqGocIHcJCriBKxsqdkvJrw",231,0.99569,29,232,1,231,1,1,0,1,1,114,114,118,117,100
"8874",73,"[29]EdwvHnKqGocIHcJCriBKxsqdkvJrw",227,0.995614,29,228,1,227,1,1,0,1,1,117,117,111,110,100
"8875",74,"[29]EdwvHnKqGocIHcJCriBKxsqdkvJrw",229,0.995652,29,230,1,229,1,1,0,1,1,116,116,114,113,100
"8876",75,"[29]EdwvHnKqGocIHcJCriBKxsqdkvJrw",227,0.995614,29,228,1,227,1,1,0,1,1,117,117,111,110,100
"8877",76,"[29]EdwvHnKqGocIHcJCriBKxsqdkvJrw",233,0.995726,29,234,1,233,1,1,0,1,1,112,112,122,121,100
"8878",77,"[29]EdwvHnKqGocIHcJCriBKxsqdkvJrw",236,0.995781,29,237,1,236,1,1,0,1,1,111,111,126,125,100
"8879",78,"[29]EdwvHnKqGocIHcJCriBKxsqdkvJrw",228,0.995633,29,229,1,228,1,1,0,1,1,116,116,113,112,100
"8880",79,"[29]EdwvHnKqGocIHcJCriBKxsqdkvJrw",237,0.995798,29,238,1,237,1,1,0,1,1,108,108,130,129,100
"8881",80,"[29]EdwvHnKqGocIHcJCriBKxsqdkvJrw",230,0.995671,29,231,1,230,1,1,0,1,1,115,115,116,115,100
"8882",81,"[29]EdwvHnKqGocIHcJCriBKxsqdkvJrw",227,0.995614,29,228,1,227,1,1,0,1,1,117,117,111,110,100
"8883",82,"[29]EdwvHnKqGocIHcJCriBKxsqdkvJrw",244,0.995918,29,245,1,244,1,1,0,1,1,104,104,141,140,100
"8884",83,"[29]EdwvHnKqGocIHcJCriBKxsqdkvJrw",232,0.995708,29,233,1,232,1,1,0,1,1,114,114,119,118,100
"8885",84,"[29]EdwvHnKqGocIHcJCriBKxsqdkvJrw",226,0.995595,29,227,1,226,1,1,0,1,1,117,117,110,109,100
"8886",85,"[29]EdwvHnKqGocIHcJCriBKxsqdkvJrw",242,0.995885,29,243,1,242,1,1,0,1,1,106,106,137,136,100
"8887",86,"[29]EdwvHnKqGocIHcJCriBKxsqdkvJrw",249,0.996,29,250,1,249,1,1,0,1,1,100,100,150,149,100
"8888",87,"[29]EdwvHnKqGocIHcJCriBKxsqdkvJrw",233,0.995726,29,234,1,233,1,1,0,1,1,113,113,121,120,100
"8889",88,"[29]EdwvHnKqGocIHcJCriBKxsqdkvJrw",234,0.995745,29,235,1,234,1,1,0,1,1,112,112,123,122,100
"8890",89,"[29]EdwvHnKqGocIHcJCriBKxsqdkvJrw",239,0.995833,29,240,1,239,1,1,0,1,1,109,109,131,130,100
"8891",90,"[29]EdwvHnKqGocIHcJCriBKxsqdkvJrw",231,0.99569,29,232,1,231,1,1,0,1,1,114,114,118,117,100
"8892",91,"[29]EdwvHnKqGocIHcJCriBKxsqdkvJrw",235,0.995763,29,236,1,235,1,1,0,1,1,111,111,125,124,100
"8893",92,"[29]EdwvHnKqGocIHcJCriBKxsqdkvJrw",220,0.995475,29,221,1,220,1,1,0,1,1,123,123,98,97,100
"8894",93,"[29]EdwvHnKqGocIHcJCriBKxsqdkvJrw",241,0.995868,29,242,1,241,1,1,0,1,1,106,106,136,135,100
"8895",94,"[29]EdwvHnKqGocIHcJCriBKxsqdkvJrw",230,0.995671,29,231,1,230,1,1,0,1,1,116,116,115,114,100
"8896",95,"[29]EdwvHnKqGocIHcJCriBKxsqdkvJrw",234,0.995745,29,235,1,234,1,1,0,1,1,112,112,123,122,100
"8897",96,"[29]EdwvHnKqGocIHcJCriBKxsqdkvJrw",236,0.995781,29,237,1,236,1,1,0,1,1,112,112,125,124,100
"8898",97,"[29]EdwvHnKqGocIHcJCriBKxsqdkvJrw",226,0.995595,29,227,1,226,1,1,0,1,1,119,119,108,107,100
"8899",98,"[29]EdwvHnKqGocIHcJCriBKxsqdkvJrw",231,0.99569,29,232,1,231,1,1,0,1,1,114,114,118,117,100
"8900",99,"[29]EdwvHnKqGocIHcJCriBKxsqdkvJrw",234,0.995745,29,235,1,234,1,1,0,1,1,111,111,124,123,100
