"","trial_number","genome","merit","accuracy","genome_length","door_rooms","exit_rooms","correct_doors","incorrect_doors","correct_exits","incorrect_exits","doors_taken_0","doors_correct_0","doors_taken_1","doors_correct_1","doors_taken_2","doors_correct_2","seed"
"1",0,"[40]jIcHoIkfGBkDtEsAtGDCAzbKDaexwHxnJHqwbGqa",203,0.990291,40,206,2,204,1,2,1,3,2,105,104,100,100,1
"2",1,"[40]jIcHoIkfGBkDtEsAtGDCAzbKDaexwHxnJHqwbGqa",205,0.990385,40,208,2,206,1,2,1,3,2,108,107,99,99,1
"3",2,"[40]jIcHoIkfGBkDtEsAtGDCAzbKDaexwHxnJHqwbGqa",210,0.99061,40,213,2,211,1,2,1,3,2,117,116,95,95,1
"4",3,"[40]jIcHoIkfGBkDtEsAtGDCAzbKDaexwHxnJHqwbGqa",203,0.990291,40,206,2,204,1,2,1,3,2,104,103,101,101,1
"5",4,"[40]jIcHoIkfGBkDtEsAtGDCAzbKDaexwHxnJHqwbGqa",190,0.989637,40,193,2,191,1,2,1,3,2,91,90,101,101,1
"6",5,"[40]jIcHoIkfGBkDtEsAtGDCAzbKDaexwHxnJHqwbGqa",191,0.989691,40,194,2,192,1,2,1,3,2,89,88,104,104,1
"7",6,"[40]jIcHoIkfGBkDtEsAtGDCAzbKDaexwHxnJHqwbGqa",196,0.98995,40,199,2,197,1,2,1,3,2,93,92,105,105,1
"8",7,"[40]jIcHoIkfGBkDtEsAtGDCAzbKDaexwHxnJHqwbGqa",206,0.990431,40,209,2,207,1,2,1,3,2,110,109,98,98,1
"9",8,"[40]jIcHoIkfGBkDtEsAtGDCAzbKDaexwHxnJHqwbGqa",209,0.990566,40,212,2,210,1,2,1,3,2,114,113,97,97,1
"10",9,"[40]jIcHoIkfGBkDtEsAtGDCAzbKDaexwHxnJHqwbGqa",206,0.990431,40,209,2,207,1,2,1,3,2,110,109,98,98,1
"11",10,"[40]jIcHoIkfGBkDtEsAtGDCAzbKDaexwHxnJHqwbGqa",208,0.990521,40,211,2,209,1,2,1,3,2,112,111,98,98,1
"12",11,"[40]jIcHoIkfGBkDtEsAtGDCAzbKDaexwHxnJHqwbGqa",193,0.989796,40,196,2,194,1,2,1,3,2,91,90,104,104,1
"13",12,"[40]jIcHoIkfGBkDtEsAtGDCAzbKDaexwHxnJHqwbGqa",203,0.990291,40,206,2,204,1,2,1,3,2,103,102,102,102,1
"14",13,"[40]jIcHoIkfGBkDtEsAtGDCAzbKDaexwHxnJHqwbGqa",213,0.990741,40,216,2,214,1,2,1,3,2,121,120,94,94,1
"15",14,"[40]jIcHoIkfGBkDtEsAtGDCAzbKDaexwHxnJHqwbGqa",213,0.990741,40,216,2,214,1,2,1,3,2,120,119,95,95,1
"16",15,"[40]jIcHoIkfGBkDtEsAtGDCAzbKDaexwHxnJHqwbGqa",187,0.989474,40,190,2,188,1,2,1,3,2,84,83,105,105,1
"17",16,"[40]jIcHoIkfGBkDtEsAtGDCAzbKDaexwHxnJHqwbGqa",191,0.989691,40,194,2,192,1,2,1,3,2,89,88,104,104,1
"18",17,"[40]jIcHoIkfGBkDtEsAtGDCAzbKDaexwHxnJHqwbGqa",190,0.989637,40,193,2,191,1,2,1,3,2,87,86,105,105,1
"19",18,"[40]jIcHoIkfGBkDtEsAtGDCAzbKDaexwHxnJHqwbGqa",204,0.990338,40,207,2,205,1,2,1,3,2,105,104,101,101,1
"20",19,"[40]jIcHoIkfGBkDtEsAtGDCAzbKDaexwHxnJHqwbGqa",202,0.990244,40,205,2,203,1,2,1,3,2,105,104,99,99,1
"21",20,"[40]jIcHoIkfGBkDtEsAtGDCAzbKDaexwHxnJHqwbGqa",208,0.990521,40,211,2,209,1,2,1,3,2,111,110,99,99,1
"22",21,"[40]jIcHoIkfGBkDtEsAtGDCAzbKDaexwHxnJHqwbGqa",188,0.989529,40,191,2,189,1,2,1,3,2,86,85,104,104,1
"23",22,"[40]jIcHoIkfGBkDtEsAtGDCAzbKDaexwHxnJHqwbGqa",204,0.990338,40,207,2,205,1,2,1,3,2,108,107,98,98,1
"24",23,"[40]jIcHoIkfGBkDtEsAtGDCAzbKDaexwHxnJHqwbGqa",197,0.99,40,200,2,198,1,2,1,3,2,95,94,104,104,1
"25",24,"[40]jIcHoIkfGBkDtEsAtGDCAzbKDaexwHxnJHqwbGqa",204,0.990338,40,207,2,205,1,2,1,3,2,108,107,98,98,1
"26",25,"[40]jIcHoIkfGBkDtEsAtGDCAzbKDaexwHxnJHqwbGqa",198,0.99005,40,201,2,199,1,2,1,3,2,100,99,100,100,1
"27",26,"[40]jIcHoIkfGBkDtEsAtGDCAzbKDaexwHxnJHqwbGqa",188,0.989529,40,191,2,189,1,2,1,3,2,86,85,104,104,1
"28",27,"[40]jIcHoIkfGBkDtEsAtGDCAzbKDaexwHxnJHqwbGqa",198,0.99005,40,201,2,199,1,2,1,3,2,100,99,100,100,1
"29",28,"[40]jIcHoIkfGBkDtEsAtGDCAzbKDaexwHxnJHqwbGqa",197,0.99,40,200,2,198,1,2,1,3,2,96,95,103,103,1
"30",29,"[40]jIcHoIkfGBkDtEsAtGDCAzbKDaexwHxnJHqwbGqa",201,0.990196,40,204,2,202,1,2,1,3,2,105,104,98,98,1
"31",30,"[40]jIcHoIkfGBkDtEsAtGDCAzbKDaexwHxnJHqwbGqa",189,0.989583,40,192,2,190,1,2,1,3,2,86,85,105,105,1
"32",31,"[40]jIcHoIkfGBkDtEsAtGDCAzbKDaexwHxnJHqwbGqa",211,0.990654,40,214,2,212,1,2,1,3,2,116,115,97,97,1
"33",32,"[40]jIcHoIkfGBkDtEsAtGDCAzbKDaexwHxnJHqwbGqa",210,0.99061,40,213,2,211,1,2,1,3,2,114,113,98,98,1
"34",33,"[40]jIcHoIkfGBkDtEsAtGDCAzbKDaexwHxnJHqwbGqa",209,0.990566,40,212,2,210,1,2,1,3,2,113,112,98,98,1
"35",34,"[40]jIcHoIkfGBkDtEsAtGDCAzbKDaexwHxnJHqwbGqa",202,0.990244,40,205,2,203,1,2,1,3,2,103,102,101,101,1
"36",35,"[40]jIcHoIkfGBkDtEsAtGDCAzbKDaexwHxnJHqwbGqa",211,0.990654,40,214,2,212,1,2,1,3,2,115,114,98,98,1
"37",36,"[40]jIcHoIkfGBkDtEsAtGDCAzbKDaexwHxnJHqwbGqa",200,0.990148,40,203,2,201,1,2,1,3,2,100,99,102,102,1
"38",37,"[40]jIcHoIkfGBkDtEsAtGDCAzbKDaexwHxnJHqwbGqa",210,0.99061,40,213,2,211,1,2,1,3,2,116,115,96,96,1
"39",38,"[40]jIcHoIkfGBkDtEsAtGDCAzbKDaexwHxnJHqwbGqa",199,0.990099,40,202,2,200,1,2,1,3,2,97,96,104,104,1
"40",39,"[40]jIcHoIkfGBkDtEsAtGDCAzbKDaexwHxnJHqwbGqa",203,0.990291,40,206,2,204,1,2,1,3,2,106,105,99,99,1
"41",40,"[40]jIcHoIkfGBkDtEsAtGDCAzbKDaexwHxnJHqwbGqa",197,0.99,40,200,2,198,1,2,1,3,2,95,94,104,104,1
"42",41,"[40]jIcHoIkfGBkDtEsAtGDCAzbKDaexwHxnJHqwbGqa",191,0.989691,40,194,2,192,1,2,1,3,2,87,86,106,106,1
"43",42,"[40]jIcHoIkfGBkDtEsAtGDCAzbKDaexwHxnJHqwbGqa",193,0.989796,40,196,2,194,1,2,1,3,2,91,90,104,104,1
"44",43,"[40]jIcHoIkfGBkDtEsAtGDCAzbKDaexwHxnJHqwbGqa",209,0.990566,40,212,2,210,1,2,1,3,2,113,112,98,98,1
"45",44,"[40]jIcHoIkfGBkDtEsAtGDCAzbKDaexwHxnJHqwbGqa",198,0.99005,40,201,2,199,1,2,1,3,2,99,98,101,101,1
"46",45,"[40]jIcHoIkfGBkDtEsAtGDCAzbKDaexwHxnJHqwbGqa",196,0.98995,40,199,2,197,1,2,1,3,2,95,94,103,103,1
"47",46,"[40]jIcHoIkfGBkDtEsAtGDCAzbKDaexwHxnJHqwbGqa",189,0.989583,40,192,2,190,1,2,1,3,2,87,86,104,104,1
"48",47,"[40]jIcHoIkfGBkDtEsAtGDCAzbKDaexwHxnJHqwbGqa",223,0.99115,40,226,2,224,1,2,1,3,2,133,132,92,92,1
"49",48,"[40]jIcHoIkfGBkDtEsAtGDCAzbKDaexwHxnJHqwbGqa",205,0.990385,40,208,2,206,1,2,1,3,2,108,107,99,99,1
"50",49,"[40]jIcHoIkfGBkDtEsAtGDCAzbKDaexwHxnJHqwbGqa",193,0.989796,40,196,2,194,1,2,1,3,2,92,91,103,103,1
"51",50,"[40]jIcHoIkfGBkDtEsAtGDCAzbKDaexwHxnJHqwbGqa",197,0.99,40,200,2,198,1,2,1,3,2,95,94,104,104,1
"52",51,"[40]jIcHoIkfGBkDtEsAtGDCAzbKDaexwHxnJHqwbGqa",191,0.989691,40,194,2,192,1,2,1,3,2,89,88,104,104,1
"53",52,"[40]jIcHoIkfGBkDtEsAtGDCAzbKDaexwHxnJHqwbGqa",205,0.990385,40,208,2,206,1,2,1,3,2,106,105,101,101,1
"54",53,"[40]jIcHoIkfGBkDtEsAtGDCAzbKDaexwHxnJHqwbGqa",203,0.990291,40,206,2,204,1,2,1,3,2,105,104,100,100,1
"55",54,"[40]jIcHoIkfGBkDtEsAtGDCAzbKDaexwHxnJHqwbGqa",204,0.990338,40,207,2,205,1,2,1,3,2,104,103,102,102,1
"56",55,"[40]jIcHoIkfGBkDtEsAtGDCAzbKDaexwHxnJHqwbGqa",204,0.990338,40,207,2,205,1,2,1,3,2,105,104,101,101,1
"57",56,"[40]jIcHoIkfGBkDtEsAtGDCAzbKDaexwHxnJHqwbGqa",202,0.990244,40,205,2,203,1,2,1,3,2,102,101,102,102,1
"58",57,"[40]jIcHoIkfGBkDtEsAtGDCAzbKDaexwHxnJHqwbGqa",215,0.990826,40,218,2,216,1,2,1,3,2,123,122,94,94,1
"59",58,"[40]jIcHoIkfGBkDtEsAtGDCAzbKDaexwHxnJHqwbGqa",198,0.99005,40,201,2,199,1,2,1,3,2,98,97,102,102,1
"60",59,"[40]jIcHoIkfGBkDtEsAtGDCAzbKDaexwHxnJHqwbGqa",205,0.990385,40,208,2,206,1,2,1,3,2,107,106,100,100,1
"61",60,"[40]jIcHoIkfGBkDtEsAtGDCAzbKDaexwHxnJHqwbGqa",197,0.99,40,200,2,198,1,2,1,3,2,95,94,104,104,1
"62",61,"[40]jIcHoIkfGBkDtEsAtGDCAzbKDaexwHxnJHqwbGqa",205,0.990385,40,208,2,206,1,2,1,3,2,105,104,102,102,1
"63",62,"[40]jIcHoIkfGBkDtEsAtGDCAzbKDaexwHxnJHqwbGqa",200,0.990148,40,203,2,201,1,2,1,3,2,101,100,101,101,1
"64",63,"[40]jIcHoIkfGBkDtEsAtGDCAzbKDaexwHxnJHqwbGqa",192,0.989744,40,195,2,193,1,2,1,3,2,89,88,105,105,1
"65",64,"[40]jIcHoIkfGBkDtEsAtGDCAzbKDaexwHxnJHqwbGqa",193,0.989796,40,196,2,194,1,2,1,3,2,91,90,104,104,1
"66",65,"[40]jIcHoIkfGBkDtEsAtGDCAzbKDaexwHxnJHqwbGqa",197,0.99,40,200,2,198,1,2,1,3,2,97,96,102,102,1
"67",66,"[40]jIcHoIkfGBkDtEsAtGDCAzbKDaexwHxnJHqwbGqa",209,0.990566,40,212,2,210,1,2,1,3,2,113,112,98,98,1
"68",67,"[40]jIcHoIkfGBkDtEsAtGDCAzbKDaexwHxnJHqwbGqa",206,0.990431,40,209,2,207,1,2,1,3,2,111,110,97,97,1
"69",68,"[40]jIcHoIkfGBkDtEsAtGDCAzbKDaexwHxnJHqwbGqa",193,0.989796,40,196,2,194,1,2,1,3,2,94,93,101,101,1
"70",69,"[40]jIcHoIkfGBkDtEsAtGDCAzbKDaexwHxnJHqwbGqa",192,0.989744,40,195,2,193,1,2,1,3,2,90,89,104,104,1
"71",70,"[40]jIcHoIkfGBkDtEsAtGDCAzbKDaexwHxnJHqwbGqa",202,0.990244,40,205,2,203,1,2,1,3,2,101,100,103,103,1
"72",71,"[40]jIcHoIkfGBkDtEsAtGDCAzbKDaexwHxnJHqwbGqa",205,0.990385,40,208,2,206,1,2,1,3,2,110,109,97,97,1
"73",72,"[40]jIcHoIkfGBkDtEsAtGDCAzbKDaexwHxnJHqwbGqa",200,0.990148,40,203,2,201,1,2,1,3,2,100,99,102,102,1
"74",73,"[40]jIcHoIkfGBkDtEsAtGDCAzbKDaexwHxnJHqwbGqa",194,0.989848,40,197,2,195,1,2,1,3,2,92,91,104,104,1
"75",74,"[40]jIcHoIkfGBkDtEsAtGDCAzbKDaexwHxnJHqwbGqa",212,0.990698,40,215,2,213,1,2,1,3,2,120,119,94,94,1
"76",75,"[40]jIcHoIkfGBkDtEsAtGDCAzbKDaexwHxnJHqwbGqa",207,0.990476,40,210,2,208,1,2,1,3,2,111,110,98,98,1
"77",76,"[40]jIcHoIkfGBkDtEsAtGDCAzbKDaexwHxnJHqwbGqa",195,0.989899,40,198,2,196,1,2,1,3,2,94,93,103,103,1
"78",77,"[40]jIcHoIkfGBkDtEsAtGDCAzbKDaexwHxnJHqwbGqa",204,0.990338,40,207,2,205,1,2,1,3,2,108,107,98,98,1
"79",78,"[40]jIcHoIkfGBkDtEsAtGDCAzbKDaexwHxnJHqwbGqa",193,0.989796,40,196,2,194,1,2,1,3,2,89,88,106,106,1
"80",79,"[40]jIcHoIkfGBkDtEsAtGDCAzbKDaexwHxnJHqwbGqa",189,0.989583,40,192,2,190,1,2,1,3,2,85,84,106,106,1
"81",80,"[40]jIcHoIkfGBkDtEsAtGDCAzbKDaexwHxnJHqwbGqa",200,0.990148,40,203,2,201,1,2,1,3,2,103,102,99,99,1
"82",81,"[40]jIcHoIkfGBkDtEsAtGDCAzbKDaexwHxnJHqwbGqa",201,0.990196,40,204,2,202,1,2,1,3,2,105,104,98,98,1
"83",82,"[40]jIcHoIkfGBkDtEsAtGDCAzbKDaexwHxnJHqwbGqa",204,0.990338,40,207,2,205,1,2,1,3,2,106,105,100,100,1
"84",83,"[40]jIcHoIkfGBkDtEsAtGDCAzbKDaexwHxnJHqwbGqa",211,0.990654,40,214,2,212,1,2,1,3,2,118,117,95,95,1
"85",84,"[40]jIcHoIkfGBkDtEsAtGDCAzbKDaexwHxnJHqwbGqa",212,0.990698,40,215,2,213,1,2,1,3,2,118,117,96,96,1
"86",85,"[40]jIcHoIkfGBkDtEsAtGDCAzbKDaexwHxnJHqwbGqa",205,0.990385,40,208,2,206,1,2,1,3,2,107,106,100,100,1
"87",86,"[40]jIcHoIkfGBkDtEsAtGDCAzbKDaexwHxnJHqwbGqa",199,0.990099,40,202,2,200,1,2,1,3,2,99,98,102,102,1
"88",87,"[40]jIcHoIkfGBkDtEsAtGDCAzbKDaexwHxnJHqwbGqa",222,0.991111,40,225,2,223,1,2,1,3,2,130,129,94,94,1
"89",88,"[40]jIcHoIkfGBkDtEsAtGDCAzbKDaexwHxnJHqwbGqa",211,0.990654,40,214,2,212,1,2,1,3,2,115,114,98,98,1
"90",89,"[40]jIcHoIkfGBkDtEsAtGDCAzbKDaexwHxnJHqwbGqa",197,0.99,40,200,2,198,1,2,1,3,2,98,97,101,101,1
"91",90,"[40]jIcHoIkfGBkDtEsAtGDCAzbKDaexwHxnJHqwbGqa",195,0.989899,40,198,2,196,1,2,1,3,2,97,96,100,100,1
"92",91,"[40]jIcHoIkfGBkDtEsAtGDCAzbKDaexwHxnJHqwbGqa",208,0.990521,40,211,2,209,1,2,1,3,2,111,110,99,99,1
"93",92,"[40]jIcHoIkfGBkDtEsAtGDCAzbKDaexwHxnJHqwbGqa",203,0.990291,40,206,2,204,1,2,1,3,2,104,103,101,101,1
"94",93,"[40]jIcHoIkfGBkDtEsAtGDCAzbKDaexwHxnJHqwbGqa",210,0.99061,40,213,2,211,1,2,1,3,2,113,112,99,99,1
"95",94,"[40]jIcHoIkfGBkDtEsAtGDCAzbKDaexwHxnJHqwbGqa",210,0.99061,40,213,2,211,1,2,1,3,2,112,111,100,100,1
"96",95,"[40]jIcHoIkfGBkDtEsAtGDCAzbKDaexwHxnJHqwbGqa",203,0.990291,40,206,2,204,1,2,1,3,2,108,107,97,97,1
"97",96,"[40]jIcHoIkfGBkDtEsAtGDCAzbKDaexwHxnJHqwbGqa",198,0.99005,40,201,2,199,1,2,1,3,2,97,96,103,103,1
"98",97,"[40]jIcHoIkfGBkDtEsAtGDCAzbKDaexwHxnJHqwbGqa",215,0.990826,40,218,2,216,1,2,1,3,2,121,120,96,96,1
"99",98,"[40]jIcHoIkfGBkDtEsAtGDCAzbKDaexwHxnJHqwbGqa",214,0.990783,40,217,2,215,1,2,1,3,2,121,120,95,95,1
"100",99,"[40]jIcHoIkfGBkDtEsAtGDCAzbKDaexwHxnJHqwbGqa",204,0.990338,40,207,2,205,1,2,1,3,2,107,106,99,99,1
"101",0,"[40]cIvHoIpvuBkDjgyddwppDabKDeexmHtnJHqwbGqa",211,0.990654,40,214,2,212,1,2,1,3,2,114,113,99,99,2
"102",1,"[40]cIvHoIpvuBkDjgyddwppDabKDeexmHtnJHqwbGqa",200,0.990148,40,203,2,201,1,2,1,3,2,99,98,103,103,2
"103",2,"[40]cIvHoIpvuBkDjgyddwppDabKDeexmHtnJHqwbGqa",193,0.989796,40,196,2,194,1,2,1,3,2,92,91,103,103,2
"104",3,"[40]cIvHoIpvuBkDjgyddwppDabKDeexmHtnJHqwbGqa",200,0.990148,40,203,2,201,1,2,1,3,2,99,98,103,103,2
"105",4,"[40]cIvHoIpvuBkDjgyddwppDabKDeexmHtnJHqwbGqa",198,0.99005,40,201,2,199,1,2,1,3,2,96,95,104,104,2
"106",5,"[40]cIvHoIpvuBkDjgyddwppDabKDeexmHtnJHqwbGqa",202,0.990244,40,205,2,203,1,2,1,3,2,104,103,100,100,2
"107",6,"[40]cIvHoIpvuBkDjgyddwppDabKDeexmHtnJHqwbGqa",205,0.990385,40,208,2,206,1,2,1,3,2,106,105,101,101,2
"108",7,"[40]cIvHoIpvuBkDjgyddwppDabKDeexmHtnJHqwbGqa",212,0.990698,40,215,2,213,1,2,1,3,2,120,119,94,94,2
"109",8,"[40]cIvHoIpvuBkDjgyddwppDabKDeexmHtnJHqwbGqa",208,0.990521,40,211,2,209,1,2,1,3,2,112,111,98,98,2
"110",9,"[40]cIvHoIpvuBkDjgyddwppDabKDeexmHtnJHqwbGqa",214,0.990783,40,217,2,215,1,2,1,3,2,119,118,97,97,2
"111",10,"[40]cIvHoIpvuBkDjgyddwppDabKDeexmHtnJHqwbGqa",200,0.990148,40,203,2,201,1,2,1,3,2,104,103,98,98,2
"112",11,"[40]cIvHoIpvuBkDjgyddwppDabKDeexmHtnJHqwbGqa",194,0.989848,40,197,2,195,1,2,1,3,2,92,91,104,104,2
"113",12,"[40]cIvHoIpvuBkDjgyddwppDabKDeexmHtnJHqwbGqa",190,0.989637,40,193,2,191,1,2,1,3,2,87,86,105,105,2
"114",13,"[40]cIvHoIpvuBkDjgyddwppDabKDeexmHtnJHqwbGqa",195,0.989899,40,198,2,196,1,2,1,3,2,95,94,102,102,2
"115",14,"[40]cIvHoIpvuBkDjgyddwppDabKDeexmHtnJHqwbGqa",209,0.990566,40,212,2,210,1,2,1,3,2,111,110,100,100,2
"116",15,"[40]cIvHoIpvuBkDjgyddwppDabKDeexmHtnJHqwbGqa",203,0.990291,40,206,2,204,1,2,1,3,2,104,103,101,101,2
"117",16,"[40]cIvHoIpvuBkDjgyddwppDabKDeexmHtnJHqwbGqa",218,0.99095,40,221,2,219,1,2,1,3,2,126,125,94,94,2
"118",17,"[40]cIvHoIpvuBkDjgyddwppDabKDeexmHtnJHqwbGqa",212,0.990698,40,215,2,213,1,2,1,3,2,118,117,96,96,2
"119",18,"[40]cIvHoIpvuBkDjgyddwppDabKDeexmHtnJHqwbGqa",194,0.989848,40,197,2,195,1,2,1,3,2,92,91,104,104,2
"120",19,"[40]cIvHoIpvuBkDjgyddwppDabKDeexmHtnJHqwbGqa",203,0.990291,40,206,2,204,1,2,1,3,2,103,102,102,102,2
"121",20,"[40]cIvHoIpvuBkDjgyddwppDabKDeexmHtnJHqwbGqa",193,0.989796,40,196,2,194,1,2,1,3,2,92,91,103,103,2
"122",21,"[40]cIvHoIpvuBkDjgyddwppDabKDeexmHtnJHqwbGqa",202,0.990244,40,205,2,203,1,2,1,3,2,104,103,100,100,2
"123",22,"[40]cIvHoIpvuBkDjgyddwppDabKDeexmHtnJHqwbGqa",191,0.989691,40,194,2,192,1,2,1,3,2,90,89,103,103,2
"124",23,"[40]cIvHoIpvuBkDjgyddwppDabKDeexmHtnJHqwbGqa",201,0.990196,40,204,2,202,1,2,1,3,2,100,99,103,103,2
"125",24,"[40]cIvHoIpvuBkDjgyddwppDabKDeexmHtnJHqwbGqa",206,0.990431,40,209,2,207,1,2,1,3,2,109,108,99,99,2
"126",25,"[40]cIvHoIpvuBkDjgyddwppDabKDeexmHtnJHqwbGqa",208,0.990521,40,211,2,209,1,2,1,3,2,110,109,100,100,2
"127",26,"[40]cIvHoIpvuBkDjgyddwppDabKDeexmHtnJHqwbGqa",193,0.989796,40,196,2,194,1,2,1,3,2,93,92,102,102,2
"128",27,"[40]cIvHoIpvuBkDjgyddwppDabKDeexmHtnJHqwbGqa",202,0.990244,40,205,2,203,1,2,1,3,2,104,103,100,100,2
"129",28,"[40]cIvHoIpvuBkDjgyddwppDabKDeexmHtnJHqwbGqa",212,0.990698,40,215,2,213,1,2,1,3,2,118,117,96,96,2
"130",29,"[40]cIvHoIpvuBkDjgyddwppDabKDeexmHtnJHqwbGqa",221,0.991071,40,224,2,222,1,2,1,3,2,132,131,91,91,2
"131",30,"[40]cIvHoIpvuBkDjgyddwppDabKDeexmHtnJHqwbGqa",200,0.990148,40,203,2,201,1,2,1,3,2,99,98,103,103,2
"132",31,"[40]cIvHoIpvuBkDjgyddwppDabKDeexmHtnJHqwbGqa",207,0.990476,40,210,2,208,1,2,1,3,2,111,110,98,98,2
"133",32,"[40]cIvHoIpvuBkDjgyddwppDabKDeexmHtnJHqwbGqa",199,0.990099,40,202,2,200,1,2,1,3,2,100,99,101,101,2
"134",33,"[40]cIvHoIpvuBkDjgyddwppDabKDeexmHtnJHqwbGqa",194,0.989848,40,197,2,195,1,2,1,3,2,91,90,105,105,2
"135",34,"[40]cIvHoIpvuBkDjgyddwppDabKDeexmHtnJHqwbGqa",191,0.989691,40,194,2,192,1,2,1,3,2,89,88,104,104,2
"136",35,"[40]cIvHoIpvuBkDjgyddwppDabKDeexmHtnJHqwbGqa",205,0.990385,40,208,2,206,1,2,1,3,2,108,107,99,99,2
"137",36,"[40]cIvHoIpvuBkDjgyddwppDabKDeexmHtnJHqwbGqa",204,0.990338,40,207,2,205,1,2,1,3,2,104,103,102,102,2
"138",37,"[40]cIvHoIpvuBkDjgyddwppDabKDeexmHtnJHqwbGqa",207,0.990476,40,210,2,208,1,2,1,3,2,110,109,99,99,2
"139",38,"[40]cIvHoIpvuBkDjgyddwppDabKDeexmHtnJHqwbGqa",201,0.990196,40,204,2,202,1,2,1,3,2,104,103,99,99,2
"140",39,"[40]cIvHoIpvuBkDjgyddwppDabKDeexmHtnJHqwbGqa",199,0.990099,40,202,2,200,1,2,1,3,2,97,96,104,104,2
"141",40,"[40]cIvHoIpvuBkDjgyddwppDabKDeexmHtnJHqwbGqa",203,0.990291,40,206,2,204,1,2,1,3,2,105,104,100,100,2
"142",41,"[40]cIvHoIpvuBkDjgyddwppDabKDeexmHtnJHqwbGqa",193,0.989796,40,196,2,194,1,2,1,3,2,90,89,105,105,2
"143",42,"[40]cIvHoIpvuBkDjgyddwppDabKDeexmHtnJHqwbGqa",201,0.990196,40,204,2,202,1,2,1,3,2,104,103,99,99,2
"144",43,"[40]cIvHoIpvuBkDjgyddwppDabKDeexmHtnJHqwbGqa",207,0.990476,40,210,2,208,1,2,1,3,2,113,112,96,96,2
"145",44,"[40]cIvHoIpvuBkDjgyddwppDabKDeexmHtnJHqwbGqa",201,0.990196,40,204,2,202,1,2,1,3,2,100,99,103,103,2
"146",45,"[40]cIvHoIpvuBkDjgyddwppDabKDeexmHtnJHqwbGqa",200,0.990148,40,203,2,201,1,2,1,3,2,100,99,102,102,2
"147",46,"[40]cIvHoIpvuBkDjgyddwppDabKDeexmHtnJHqwbGqa",206,0.990431,40,209,2,207,1,2,1,3,2,105,104,103,103,2
"148",47,"[40]cIvHoIpvuBkDjgyddwppDabKDeexmHtnJHqwbGqa",201,0.990196,40,204,2,202,1,2,1,3,2,101,100,102,102,2
"149",48,"[40]cIvHoIpvuBkDjgyddwppDabKDeexmHtnJHqwbGqa",199,0.990099,40,202,2,200,1,2,1,3,2,99,98,102,102,2
"150",49,"[40]cIvHoIpvuBkDjgyddwppDabKDeexmHtnJHqwbGqa",191,0.989691,40,194,2,192,1,2,1,3,2,89,88,104,104,2
"151",50,"[40]cIvHoIpvuBkDjgyddwppDabKDeexmHtnJHqwbGqa",197,0.99,40,200,2,198,1,2,1,3,2,94,93,105,105,2
"152",51,"[40]cIvHoIpvuBkDjgyddwppDabKDeexmHtnJHqwbGqa",212,0.990698,40,215,2,213,1,2,1,3,2,114,113,100,100,2
"153",52,"[40]cIvHoIpvuBkDjgyddwppDabKDeexmHtnJHqwbGqa",214,0.990783,40,217,2,215,1,2,1,3,2,121,120,95,95,2
"154",53,"[40]cIvHoIpvuBkDjgyddwppDabKDeexmHtnJHqwbGqa",197,0.99,40,200,2,198,1,2,1,3,2,98,97,101,101,2
"155",54,"[40]cIvHoIpvuBkDjgyddwppDabKDeexmHtnJHqwbGqa",188,0.989529,40,191,2,189,1,2,1,3,2,84,83,106,106,2
"156",55,"[40]cIvHoIpvuBkDjgyddwppDabKDeexmHtnJHqwbGqa",210,0.99061,40,213,2,211,1,2,1,3,2,112,111,100,100,2
"157",56,"[40]cIvHoIpvuBkDjgyddwppDabKDeexmHtnJHqwbGqa",211,0.990654,40,214,2,212,1,2,1,3,2,116,115,97,97,2
"158",57,"[40]cIvHoIpvuBkDjgyddwppDabKDeexmHtnJHqwbGqa",202,0.990244,40,205,2,203,1,2,1,3,2,102,101,102,102,2
"159",58,"[40]cIvHoIpvuBkDjgyddwppDabKDeexmHtnJHqwbGqa",202,0.990244,40,205,2,203,1,2,1,3,2,105,104,99,99,2
"160",59,"[40]cIvHoIpvuBkDjgyddwppDabKDeexmHtnJHqwbGqa",207,0.990476,40,210,2,208,1,2,1,3,2,109,108,100,100,2
"161",60,"[40]cIvHoIpvuBkDjgyddwppDabKDeexmHtnJHqwbGqa",208,0.990521,40,211,2,209,1,2,1,3,2,111,110,99,99,2
"162",61,"[40]cIvHoIpvuBkDjgyddwppDabKDeexmHtnJHqwbGqa",210,0.99061,40,213,2,211,1,2,1,3,2,114,113,98,98,2
"163",62,"[40]cIvHoIpvuBkDjgyddwppDabKDeexmHtnJHqwbGqa",202,0.990244,40,205,2,203,1,2,1,3,2,104,103,100,100,2
"164",63,"[40]cIvHoIpvuBkDjgyddwppDabKDeexmHtnJHqwbGqa",211,0.990654,40,214,2,212,1,2,1,3,2,115,114,98,98,2
"165",64,"[40]cIvHoIpvuBkDjgyddwppDabKDeexmHtnJHqwbGqa",201,0.990196,40,204,2,202,1,2,1,3,2,102,101,101,101,2
"166",65,"[40]cIvHoIpvuBkDjgyddwppDabKDeexmHtnJHqwbGqa",213,0.990741,40,216,2,214,1,2,1,3,2,118,117,97,97,2
"167",66,"[40]cIvHoIpvuBkDjgyddwppDabKDeexmHtnJHqwbGqa",222,0.991111,40,225,2,223,1,2,1,3,2,131,130,93,93,2
"168",67,"[40]cIvHoIpvuBkDjgyddwppDabKDeexmHtnJHqwbGqa",213,0.990741,40,216,2,214,1,2,1,3,2,117,116,98,98,2
"169",68,"[40]cIvHoIpvuBkDjgyddwppDabKDeexmHtnJHqwbGqa",187,0.989474,40,190,2,188,1,2,1,3,2,84,83,105,105,2
"170",69,"[40]cIvHoIpvuBkDjgyddwppDabKDeexmHtnJHqwbGqa",215,0.990826,40,218,2,216,1,2,1,3,2,123,122,94,94,2
"171",70,"[40]cIvHoIpvuBkDjgyddwppDabKDeexmHtnJHqwbGqa",209,0.990566,40,212,2,210,1,2,1,3,2,113,112,98,98,2
"172",71,"[40]cIvHoIpvuBkDjgyddwppDabKDeexmHtnJHqwbGqa",205,0.990385,40,208,2,206,1,2,1,3,2,109,108,98,98,2
"173",72,"[40]cIvHoIpvuBkDjgyddwppDabKDeexmHtnJHqwbGqa",204,0.990338,40,207,2,205,1,2,1,3,2,106,105,100,100,2
"174",73,"[40]cIvHoIpvuBkDjgyddwppDabKDeexmHtnJHqwbGqa",197,0.99,40,200,2,198,1,2,1,3,2,99,98,100,100,2
"175",74,"[40]cIvHoIpvuBkDjgyddwppDabKDeexmHtnJHqwbGqa",190,0.989637,40,193,2,191,1,2,1,3,2,89,88,103,103,2
"176",75,"[40]cIvHoIpvuBkDjgyddwppDabKDeexmHtnJHqwbGqa",200,0.990148,40,203,2,201,1,2,1,3,2,101,100,101,101,2
"177",76,"[40]cIvHoIpvuBkDjgyddwppDabKDeexmHtnJHqwbGqa",200,0.990148,40,203,2,201,1,2,1,3,2,99,98,103,103,2
"178",77,"[40]cIvHoIpvuBkDjgyddwppDabKDeexmHtnJHqwbGqa",207,0.990476,40,210,2,208,1,2,1,3,2,108,107,101,101,2
"179",78,"[40]cIvHoIpvuBkDjgyddwppDabKDeexmHtnJHqwbGqa",204,0.990338,40,207,2,205,1,2,1,3,2,104,103,102,102,2
"180",79,"[40]cIvHoIpvuBkDjgyddwppDabKDeexmHtnJHqwbGqa",195,0.989899,40,198,2,196,1,2,1,3,2,96,95,101,101,2
"181",80,"[40]cIvHoIpvuBkDjgyddwppDabKDeexmHtnJHqwbGqa",211,0.990654,40,214,2,212,1,2,1,3,2,115,114,98,98,2
"182",81,"[40]cIvHoIpvuBkDjgyddwppDabKDeexmHtnJHqwbGqa",208,0.990521,40,211,2,209,1,2,1,3,2,113,112,97,97,2
"183",82,"[40]cIvHoIpvuBkDjgyddwppDabKDeexmHtnJHqwbGqa",185,0.989362,40,188,2,186,1,2,1,3,2,81,80,106,106,2
"184",83,"[40]cIvHoIpvuBkDjgyddwppDabKDeexmHtnJHqwbGqa",193,0.989796,40,196,2,194,1,2,1,3,2,92,91,103,103,2
"185",84,"[40]cIvHoIpvuBkDjgyddwppDabKDeexmHtnJHqwbGqa",199,0.990099,40,202,2,200,1,2,1,3,2,100,99,101,101,2
"186",85,"[40]cIvHoIpvuBkDjgyddwppDabKDeexmHtnJHqwbGqa",195,0.989899,40,198,2,196,1,2,1,3,2,94,93,103,103,2
"187",86,"[40]cIvHoIpvuBkDjgyddwppDabKDeexmHtnJHqwbGqa",195,0.989899,40,198,2,196,1,2,1,3,2,95,94,102,102,2
"188",87,"[40]cIvHoIpvuBkDjgyddwppDabKDeexmHtnJHqwbGqa",204,0.990338,40,207,2,205,1,2,1,3,2,106,105,100,100,2
"189",88,"[40]cIvHoIpvuBkDjgyddwppDabKDeexmHtnJHqwbGqa",207,0.990476,40,210,2,208,1,2,1,3,2,112,111,97,97,2
"190",89,"[40]cIvHoIpvuBkDjgyddwppDabKDeexmHtnJHqwbGqa",209,0.990566,40,212,2,210,1,2,1,3,2,110,109,101,101,2
"191",90,"[40]cIvHoIpvuBkDjgyddwppDabKDeexmHtnJHqwbGqa",200,0.990148,40,203,2,201,1,2,1,3,2,100,99,102,102,2
"192",91,"[40]cIvHoIpvuBkDjgyddwppDabKDeexmHtnJHqwbGqa",200,0.990148,40,203,2,201,1,2,1,3,2,103,102,99,99,2
"193",92,"[40]cIvHoIpvuBkDjgyddwppDabKDeexmHtnJHqwbGqa",193,0.989796,40,196,2,194,1,2,1,3,2,92,91,103,103,2
"194",93,"[40]cIvHoIpvuBkDjgyddwppDabKDeexmHtnJHqwbGqa",208,0.990521,40,211,2,209,1,2,1,3,2,114,113,96,96,2
"195",94,"[40]cIvHoIpvuBkDjgyddwppDabKDeexmHtnJHqwbGqa",201,0.990196,40,204,2,202,1,2,1,3,2,102,101,101,101,2
"196",95,"[40]cIvHoIpvuBkDjgyddwppDabKDeexmHtnJHqwbGqa",194,0.989848,40,197,2,195,1,2,1,3,2,94,93,102,102,2
"197",96,"[40]cIvHoIpvuBkDjgyddwppDabKDeexmHtnJHqwbGqa",206,0.990431,40,209,2,207,1,2,1,3,2,110,109,98,98,2
"198",97,"[40]cIvHoIpvuBkDjgyddwppDabKDeexmHtnJHqwbGqa",191,0.989691,40,194,2,192,1,2,1,3,2,90,89,103,103,2
"199",98,"[40]cIvHoIpvuBkDjgyddwppDabKDeexmHtnJHqwbGqa",209,0.990566,40,212,2,210,1,2,1,3,2,114,113,97,97,2
"200",99,"[40]cIvHoIpvuBkDjgyddwppDabKDeexmHtnJHqwbGqa",211,0.990654,40,214,2,212,1,2,1,3,2,114,113,99,99,2
"201",0,"[38]xIzHoIEBlDspAIwpuIzDbKDeeDyHwnJHqwbGqa",205,0.990385,38,208,2,206,1,2,1,3,2,108,107,99,99,3
"202",1,"[38]xIzHoIEBlDspAIwpuIzDbKDeeDyHwnJHqwbGqa",210,0.99061,38,213,2,211,1,2,1,3,2,114,113,98,98,3
"203",2,"[38]xIzHoIEBlDspAIwpuIzDbKDeeDyHwnJHqwbGqa",188,0.989529,38,191,2,189,1,2,1,3,2,83,82,107,107,3
"204",3,"[38]xIzHoIEBlDspAIwpuIzDbKDeeDyHwnJHqwbGqa",197,0.99,38,200,2,198,1,2,1,3,2,95,94,104,104,3
"205",4,"[38]xIzHoIEBlDspAIwpuIzDbKDeeDyHwnJHqwbGqa",218,0.99095,38,221,2,219,1,2,1,3,2,124,123,96,96,3
"206",5,"[38]xIzHoIEBlDspAIwpuIzDbKDeeDyHwnJHqwbGqa",203,0.990291,38,206,2,204,1,2,1,3,2,102,101,103,103,3
"207",6,"[38]xIzHoIEBlDspAIwpuIzDbKDeeDyHwnJHqwbGqa",198,0.99005,38,201,2,199,1,2,1,3,2,98,97,102,102,3
"208",7,"[38]xIzHoIEBlDspAIwpuIzDbKDeeDyHwnJHqwbGqa",190,0.989637,38,193,2,191,1,2,1,3,2,87,86,105,105,3
"209",8,"[38]xIzHoIEBlDspAIwpuIzDbKDeeDyHwnJHqwbGqa",220,0.991031,38,223,2,221,1,2,1,3,2,127,126,95,95,3
"210",9,"[38]xIzHoIEBlDspAIwpuIzDbKDeeDyHwnJHqwbGqa",208,0.990521,38,211,2,209,1,2,1,3,2,110,109,100,100,3
"211",10,"[38]xIzHoIEBlDspAIwpuIzDbKDeeDyHwnJHqwbGqa",199,0.990099,38,202,2,200,1,2,1,3,2,96,95,105,105,3
"212",11,"[38]xIzHoIEBlDspAIwpuIzDbKDeeDyHwnJHqwbGqa",201,0.990196,38,204,2,202,1,2,1,3,2,104,103,99,99,3
"213",12,"[38]xIzHoIEBlDspAIwpuIzDbKDeeDyHwnJHqwbGqa",217,0.990909,38,220,2,218,1,2,1,3,2,121,120,98,98,3
"214",13,"[38]xIzHoIEBlDspAIwpuIzDbKDeeDyHwnJHqwbGqa",190,0.989637,38,193,2,191,1,2,1,3,2,87,86,105,105,3
"215",14,"[38]xIzHoIEBlDspAIwpuIzDbKDeeDyHwnJHqwbGqa",210,0.99061,38,213,2,211,1,2,1,3,2,113,112,99,99,3
"216",15,"[38]xIzHoIEBlDspAIwpuIzDbKDeeDyHwnJHqwbGqa",189,0.989583,38,192,2,190,1,2,1,3,2,88,87,103,103,3
"217",16,"[38]xIzHoIEBlDspAIwpuIzDbKDeeDyHwnJHqwbGqa",199,0.990099,38,202,2,200,1,2,1,3,2,99,98,102,102,3
"218",17,"[38]xIzHoIEBlDspAIwpuIzDbKDeeDyHwnJHqwbGqa",209,0.990566,38,212,2,210,1,2,1,3,2,114,113,97,97,3
"219",18,"[38]xIzHoIEBlDspAIwpuIzDbKDeeDyHwnJHqwbGqa",201,0.990196,38,204,2,202,1,2,1,3,2,103,102,100,100,3
"220",19,"[38]xIzHoIEBlDspAIwpuIzDbKDeeDyHwnJHqwbGqa",217,0.990909,38,220,2,218,1,2,1,3,2,120,119,99,99,3
"221",20,"[38]xIzHoIEBlDspAIwpuIzDbKDeeDyHwnJHqwbGqa",202,0.990244,38,205,2,203,1,2,1,3,2,103,102,101,101,3
"222",21,"[38]xIzHoIEBlDspAIwpuIzDbKDeeDyHwnJHqwbGqa",202,0.990244,38,205,2,203,1,2,1,3,2,102,101,102,102,3
"223",22,"[38]xIzHoIEBlDspAIwpuIzDbKDeeDyHwnJHqwbGqa",195,0.989899,38,198,2,196,1,2,1,3,2,93,92,104,104,3
"224",23,"[38]xIzHoIEBlDspAIwpuIzDbKDeeDyHwnJHqwbGqa",195,0.989899,38,198,2,196,1,2,1,3,2,94,93,103,103,3
"225",24,"[38]xIzHoIEBlDspAIwpuIzDbKDeeDyHwnJHqwbGqa",208,0.990521,38,211,2,209,1,2,1,3,2,112,111,98,98,3
"226",25,"[38]xIzHoIEBlDspAIwpuIzDbKDeeDyHwnJHqwbGqa",199,0.990099,38,202,2,200,1,2,1,3,2,100,99,101,101,3
"227",26,"[38]xIzHoIEBlDspAIwpuIzDbKDeeDyHwnJHqwbGqa",199,0.990099,38,202,2,200,1,2,1,3,2,97,96,104,104,3
"228",27,"[38]xIzHoIEBlDspAIwpuIzDbKDeeDyHwnJHqwbGqa",210,0.99061,38,213,2,211,1,2,1,3,2,116,115,96,96,3
"229",28,"[38]xIzHoIEBlDspAIwpuIzDbKDeeDyHwnJHqwbGqa",186,0.989418,38,189,2,187,1,2,1,3,2,80,79,108,108,3
"230",29,"[38]xIzHoIEBlDspAIwpuIzDbKDeeDyHwnJHqwbGqa",205,0.990385,38,208,2,206,1,2,1,3,2,108,107,99,99,3
"231",30,"[38]xIzHoIEBlDspAIwpuIzDbKDeeDyHwnJHqwbGqa",198,0.99005,38,201,2,199,1,2,1,3,2,96,95,104,104,3
"232",31,"[38]xIzHoIEBlDspAIwpuIzDbKDeeDyHwnJHqwbGqa",194,0.989848,38,197,2,195,1,2,1,3,2,92,91,104,104,3
"233",32,"[38]xIzHoIEBlDspAIwpuIzDbKDeeDyHwnJHqwbGqa",197,0.99,38,200,2,198,1,2,1,3,2,95,94,104,104,3
"234",33,"[38]xIzHoIEBlDspAIwpuIzDbKDeeDyHwnJHqwbGqa",196,0.98995,38,199,2,197,1,2,1,3,2,97,96,101,101,3
"235",34,"[38]xIzHoIEBlDspAIwpuIzDbKDeeDyHwnJHqwbGqa",203,0.990291,38,206,2,204,1,2,1,3,2,106,105,99,99,3
"236",35,"[38]xIzHoIEBlDspAIwpuIzDbKDeeDyHwnJHqwbGqa",211,0.990654,38,214,2,212,1,2,1,3,2,116,115,97,97,3
"237",36,"[38]xIzHoIEBlDspAIwpuIzDbKDeeDyHwnJHqwbGqa",184,0.989305,38,187,2,185,1,2,1,3,2,78,77,108,108,3
"238",37,"[38]xIzHoIEBlDspAIwpuIzDbKDeeDyHwnJHqwbGqa",207,0.990476,38,210,2,208,1,2,1,3,2,108,107,101,101,3
"239",38,"[38]xIzHoIEBlDspAIwpuIzDbKDeeDyHwnJHqwbGqa",208,0.990521,38,211,2,209,1,2,1,3,2,110,109,100,100,3
"240",39,"[38]xIzHoIEBlDspAIwpuIzDbKDeeDyHwnJHqwbGqa",206,0.990431,38,209,2,207,1,2,1,3,2,109,108,99,99,3
"241",40,"[38]xIzHoIEBlDspAIwpuIzDbKDeeDyHwnJHqwbGqa",186,0.989418,38,189,2,187,1,2,1,3,2,81,80,107,107,3
"242",41,"[38]xIzHoIEBlDspAIwpuIzDbKDeeDyHwnJHqwbGqa",198,0.99005,38,201,2,199,1,2,1,3,2,102,101,98,98,3
"243",42,"[38]xIzHoIEBlDspAIwpuIzDbKDeeDyHwnJHqwbGqa",218,0.99095,38,221,2,219,1,2,1,3,2,125,124,95,95,3
"244",43,"[38]xIzHoIEBlDspAIwpuIzDbKDeeDyHwnJHqwbGqa",206,0.990431,38,209,2,207,1,2,1,3,2,107,106,101,101,3
"245",44,"[38]xIzHoIEBlDspAIwpuIzDbKDeeDyHwnJHqwbGqa",204,0.990338,38,207,2,205,1,2,1,3,2,106,105,100,100,3
"246",45,"[38]xIzHoIEBlDspAIwpuIzDbKDeeDyHwnJHqwbGqa",198,0.99005,38,201,2,199,1,2,1,3,2,98,97,102,102,3
"247",46,"[38]xIzHoIEBlDspAIwpuIzDbKDeeDyHwnJHqwbGqa",197,0.99,38,200,2,198,1,2,1,3,2,96,95,103,103,3
"248",47,"[38]xIzHoIEBlDspAIwpuIzDbKDeeDyHwnJHqwbGqa",215,0.990826,38,218,2,216,1,2,1,3,2,121,120,96,96,3
"249",48,"[38]xIzHoIEBlDspAIwpuIzDbKDeeDyHwnJHqwbGqa",201,0.990196,38,204,2,202,1,2,1,3,2,102,101,101,101,3
"250",49,"[38]xIzHoIEBlDspAIwpuIzDbKDeeDyHwnJHqwbGqa",210,0.99061,38,213,2,211,1,2,1,3,2,113,112,99,99,3
"251",50,"[38]xIzHoIEBlDspAIwpuIzDbKDeeDyHwnJHqwbGqa",204,0.990338,38,207,2,205,1,2,1,3,2,108,107,98,98,3
"252",51,"[38]xIzHoIEBlDspAIwpuIzDbKDeeDyHwnJHqwbGqa",189,0.989583,38,192,2,190,1,2,1,3,2,85,84,106,106,3
"253",52,"[38]xIzHoIEBlDspAIwpuIzDbKDeeDyHwnJHqwbGqa",187,0.989474,38,190,2,188,1,2,1,3,2,82,81,107,107,3
"254",53,"[38]xIzHoIEBlDspAIwpuIzDbKDeeDyHwnJHqwbGqa",202,0.990244,38,205,2,203,1,2,1,3,2,103,102,101,101,3
"255",54,"[38]xIzHoIEBlDspAIwpuIzDbKDeeDyHwnJHqwbGqa",198,0.99005,38,201,2,199,1,2,1,3,2,98,97,102,102,3
"256",55,"[38]xIzHoIEBlDspAIwpuIzDbKDeeDyHwnJHqwbGqa",195,0.989899,38,198,2,196,1,2,1,3,2,93,92,104,104,3
"257",56,"[38]xIzHoIEBlDspAIwpuIzDbKDeeDyHwnJHqwbGqa",198,0.99005,38,201,2,199,1,2,1,3,2,98,97,102,102,3
"258",57,"[38]xIzHoIEBlDspAIwpuIzDbKDeeDyHwnJHqwbGqa",196,0.98995,38,199,2,197,1,2,1,3,2,92,91,106,106,3
"259",58,"[38]xIzHoIEBlDspAIwpuIzDbKDeeDyHwnJHqwbGqa",207,0.990476,38,210,2,208,1,2,1,3,2,111,110,98,98,3
"260",59,"[38]xIzHoIEBlDspAIwpuIzDbKDeeDyHwnJHqwbGqa",196,0.98995,38,199,2,197,1,2,1,3,2,93,92,105,105,3
"261",60,"[38]xIzHoIEBlDspAIwpuIzDbKDeeDyHwnJHqwbGqa",205,0.990385,38,208,2,206,1,2,1,3,2,108,107,99,99,3
"262",61,"[38]xIzHoIEBlDspAIwpuIzDbKDeeDyHwnJHqwbGqa",194,0.989848,38,197,2,195,1,2,1,3,2,93,92,103,103,3
"263",62,"[38]xIzHoIEBlDspAIwpuIzDbKDeeDyHwnJHqwbGqa",207,0.990476,38,210,2,208,1,2,1,3,2,110,109,99,99,3
"264",63,"[38]xIzHoIEBlDspAIwpuIzDbKDeeDyHwnJHqwbGqa",210,0.99061,38,213,2,211,1,2,1,3,2,114,113,98,98,3
"265",64,"[38]xIzHoIEBlDspAIwpuIzDbKDeeDyHwnJHqwbGqa",192,0.989744,38,195,2,193,1,2,1,3,2,89,88,105,105,3
"266",65,"[38]xIzHoIEBlDspAIwpuIzDbKDeeDyHwnJHqwbGqa",206,0.990431,38,209,2,207,1,2,1,3,2,109,108,99,99,3
"267",66,"[38]xIzHoIEBlDspAIwpuIzDbKDeeDyHwnJHqwbGqa",207,0.990476,38,210,2,208,1,2,1,3,2,109,108,100,100,3
"268",67,"[38]xIzHoIEBlDspAIwpuIzDbKDeeDyHwnJHqwbGqa",207,0.990476,38,210,2,208,1,2,1,3,2,109,108,100,100,3
"269",68,"[38]xIzHoIEBlDspAIwpuIzDbKDeeDyHwnJHqwbGqa",197,0.99,38,200,2,198,1,2,1,3,2,96,95,103,103,3
"270",69,"[38]xIzHoIEBlDspAIwpuIzDbKDeeDyHwnJHqwbGqa",194,0.989848,38,197,2,195,1,2,1,3,2,93,92,103,103,3
"271",70,"[38]xIzHoIEBlDspAIwpuIzDbKDeeDyHwnJHqwbGqa",193,0.989796,38,196,2,194,1,2,1,3,2,90,89,105,105,3
"272",71,"[38]xIzHoIEBlDspAIwpuIzDbKDeeDyHwnJHqwbGqa",187,0.989474,38,190,2,188,1,2,1,3,2,83,82,106,106,3
"273",72,"[38]xIzHoIEBlDspAIwpuIzDbKDeeDyHwnJHqwbGqa",186,0.989418,38,189,2,187,1,2,1,3,2,82,81,106,106,3
"274",73,"[38]xIzHoIEBlDspAIwpuIzDbKDeeDyHwnJHqwbGqa",204,0.990338,38,207,2,205,1,2,1,3,2,105,104,101,101,3
"275",74,"[38]xIzHoIEBlDspAIwpuIzDbKDeeDyHwnJHqwbGqa",202,0.990244,38,205,2,203,1,2,1,3,2,103,102,101,101,3
"276",75,"[38]xIzHoIEBlDspAIwpuIzDbKDeeDyHwnJHqwbGqa",210,0.99061,38,213,2,211,1,2,1,3,2,113,112,99,99,3
"277",76,"[38]xIzHoIEBlDspAIwpuIzDbKDeeDyHwnJHqwbGqa",218,0.99095,38,221,2,219,1,2,1,3,2,126,125,94,94,3
"278",77,"[38]xIzHoIEBlDspAIwpuIzDbKDeeDyHwnJHqwbGqa",201,0.990196,38,204,2,202,1,2,1,3,2,100,99,103,103,3
"279",78,"[38]xIzHoIEBlDspAIwpuIzDbKDeeDyHwnJHqwbGqa",193,0.989796,38,196,2,194,1,2,1,3,2,91,90,104,104,3
"280",79,"[38]xIzHoIEBlDspAIwpuIzDbKDeeDyHwnJHqwbGqa",210,0.99061,38,213,2,211,1,2,1,3,2,114,113,98,98,3
"281",80,"[38]xIzHoIEBlDspAIwpuIzDbKDeeDyHwnJHqwbGqa",219,0.990991,38,222,2,220,1,2,1,3,2,127,126,94,94,3
"282",81,"[38]xIzHoIEBlDspAIwpuIzDbKDeeDyHwnJHqwbGqa",204,0.990338,38,207,2,205,1,2,1,3,2,103,102,103,103,3
"283",82,"[38]xIzHoIEBlDspAIwpuIzDbKDeeDyHwnJHqwbGqa",196,0.98995,38,199,2,197,1,2,1,3,2,96,95,102,102,3
"284",83,"[38]xIzHoIEBlDspAIwpuIzDbKDeeDyHwnJHqwbGqa",197,0.99,38,200,2,198,1,2,1,3,2,96,95,103,103,3
"285",84,"[38]xIzHoIEBlDspAIwpuIzDbKDeeDyHwnJHqwbGqa",195,0.989899,38,198,2,196,1,2,1,3,2,92,91,105,105,3
"286",85,"[38]xIzHoIEBlDspAIwpuIzDbKDeeDyHwnJHqwbGqa",206,0.990431,38,209,2,207,1,2,1,3,2,109,108,99,99,3
"287",86,"[38]xIzHoIEBlDspAIwpuIzDbKDeeDyHwnJHqwbGqa",202,0.990244,38,205,2,203,1,2,1,3,2,102,101,102,102,3
"288",87,"[38]xIzHoIEBlDspAIwpuIzDbKDeeDyHwnJHqwbGqa",194,0.989848,38,197,2,195,1,2,1,3,2,93,92,103,103,3
"289",88,"[38]xIzHoIEBlDspAIwpuIzDbKDeeDyHwnJHqwbGqa",205,0.990385,38,208,2,206,1,2,1,3,2,104,103,103,103,3
"290",89,"[38]xIzHoIEBlDspAIwpuIzDbKDeeDyHwnJHqwbGqa",203,0.990291,38,206,2,204,1,2,1,3,2,106,105,99,99,3
"291",90,"[38]xIzHoIEBlDspAIwpuIzDbKDeeDyHwnJHqwbGqa",203,0.990291,38,206,2,204,1,2,1,3,2,107,106,98,98,3
"292",91,"[38]xIzHoIEBlDspAIwpuIzDbKDeeDyHwnJHqwbGqa",201,0.990196,38,204,2,202,1,2,1,3,2,102,101,101,101,3
"293",92,"[38]xIzHoIEBlDspAIwpuIzDbKDeeDyHwnJHqwbGqa",200,0.990148,38,203,2,201,1,2,1,3,2,102,101,100,100,3
"294",93,"[38]xIzHoIEBlDspAIwpuIzDbKDeeDyHwnJHqwbGqa",190,0.989637,38,193,2,191,1,2,1,3,2,87,86,105,105,3
"295",94,"[38]xIzHoIEBlDspAIwpuIzDbKDeeDyHwnJHqwbGqa",207,0.990476,38,210,2,208,1,2,1,3,2,109,108,100,100,3
"296",95,"[38]xIzHoIEBlDspAIwpuIzDbKDeeDyHwnJHqwbGqa",205,0.990385,38,208,2,206,1,2,1,3,2,108,107,99,99,3
"297",96,"[38]xIzHoIEBlDspAIwpuIzDbKDeeDyHwnJHqwbGqa",214,0.990783,38,217,2,215,1,2,1,3,2,119,118,97,97,3
"298",97,"[38]xIzHoIEBlDspAIwpuIzDbKDeeDyHwnJHqwbGqa",197,0.99,38,200,2,198,1,2,1,3,2,93,92,106,106,3
"299",98,"[38]xIzHoIEBlDspAIwpuIzDbKDeeDyHwnJHqwbGqa",219,0.990991,38,222,2,220,1,2,1,3,2,126,125,95,95,3
"300",99,"[38]xIzHoIEBlDspAIwpuIzDbKDeeDyHwnJHqwbGqa",197,0.99,38,200,2,198,1,2,1,3,2,97,96,102,102,3
"301",0,"[40]cIdHoIdrrBkDemyGFEBwufbKDaeywHsnJHqxbGqa",192,0.989744,40,195,2,193,1,2,1,3,2,89,88,105,105,4
"302",1,"[40]cIdHoIdrrBkDemyGFEBwufbKDaeywHsnJHqxbGqa",205,0.990385,40,208,2,206,1,2,1,3,2,105,104,102,102,4
"303",2,"[40]cIdHoIdrrBkDemyGFEBwufbKDaeywHsnJHqxbGqa",202,0.990244,40,205,2,203,1,2,1,3,2,104,103,100,100,4
"304",3,"[40]cIdHoIdrrBkDemyGFEBwufbKDaeywHsnJHqxbGqa",194,0.989848,40,197,2,195,1,2,1,3,2,93,92,103,103,4
"305",4,"[40]cIdHoIdrrBkDemyGFEBwufbKDaeywHsnJHqxbGqa",196,0.98995,40,199,2,197,1,2,1,3,2,98,97,100,100,4
"306",5,"[40]cIdHoIdrrBkDemyGFEBwufbKDaeywHsnJHqxbGqa",201,0.990196,40,204,2,202,1,2,1,3,2,104,103,99,99,4
"307",6,"[40]cIdHoIdrrBkDemyGFEBwufbKDaeywHsnJHqxbGqa",196,0.98995,40,199,2,197,1,2,1,3,2,96,95,102,102,4
"308",7,"[40]cIdHoIdrrBkDemyGFEBwufbKDaeywHsnJHqxbGqa",204,0.990338,40,207,2,205,1,2,1,3,2,102,101,104,104,4
"309",8,"[40]cIdHoIdrrBkDemyGFEBwufbKDaeywHsnJHqxbGqa",198,0.99005,40,201,2,199,1,2,1,3,2,95,94,105,105,4
"310",9,"[40]cIdHoIdrrBkDemyGFEBwufbKDaeywHsnJHqxbGqa",196,0.98995,40,199,2,197,1,2,1,3,2,97,96,101,101,4
"311",10,"[40]cIdHoIdrrBkDemyGFEBwufbKDaeywHsnJHqxbGqa",202,0.990244,40,205,2,203,1,2,1,3,2,106,105,98,98,4
"312",11,"[40]cIdHoIdrrBkDemyGFEBwufbKDaeywHsnJHqxbGqa",204,0.990338,40,207,2,205,1,2,1,3,2,107,106,99,99,4
"313",12,"[40]cIdHoIdrrBkDemyGFEBwufbKDaeywHsnJHqxbGqa",204,0.990338,40,207,2,205,1,2,1,3,2,106,105,100,100,4
"314",13,"[40]cIdHoIdrrBkDemyGFEBwufbKDaeywHsnJHqxbGqa",207,0.990476,40,210,2,208,1,2,1,3,2,110,109,99,99,4
"315",14,"[40]cIdHoIdrrBkDemyGFEBwufbKDaeywHsnJHqxbGqa",198,0.99005,40,201,2,199,1,2,1,3,2,99,98,101,101,4
"316",15,"[40]cIdHoIdrrBkDemyGFEBwufbKDaeywHsnJHqxbGqa",201,0.990196,40,204,2,202,1,2,1,3,2,102,101,101,101,4
"317",16,"[40]cIdHoIdrrBkDemyGFEBwufbKDaeywHsnJHqxbGqa",191,0.989691,40,194,2,192,1,2,1,3,2,89,88,104,104,4
"318",17,"[40]cIdHoIdrrBkDemyGFEBwufbKDaeywHsnJHqxbGqa",200,0.990148,40,203,2,201,1,2,1,3,2,102,101,100,100,4
"319",18,"[40]cIdHoIdrrBkDemyGFEBwufbKDaeywHsnJHqxbGqa",197,0.99,40,200,2,198,1,2,1,3,2,96,95,103,103,4
"320",19,"[40]cIdHoIdrrBkDemyGFEBwufbKDaeywHsnJHqxbGqa",210,0.99061,40,213,2,211,1,2,1,3,2,113,112,99,99,4
"321",20,"[40]cIdHoIdrrBkDemyGFEBwufbKDaeywHsnJHqxbGqa",200,0.990148,40,203,2,201,1,2,1,3,2,101,100,101,101,4
"322",21,"[40]cIdHoIdrrBkDemyGFEBwufbKDaeywHsnJHqxbGqa",188,0.989529,40,191,2,189,1,2,1,3,2,87,86,103,103,4
"323",22,"[40]cIdHoIdrrBkDemyGFEBwufbKDaeywHsnJHqxbGqa",205,0.990385,40,208,2,206,1,2,1,3,2,110,109,97,97,4
"324",23,"[40]cIdHoIdrrBkDemyGFEBwufbKDaeywHsnJHqxbGqa",195,0.989899,40,198,2,196,1,2,1,3,2,95,94,102,102,4
"325",24,"[40]cIdHoIdrrBkDemyGFEBwufbKDaeywHsnJHqxbGqa",207,0.990476,40,210,2,208,1,2,1,3,2,108,107,101,101,4
"326",25,"[40]cIdHoIdrrBkDemyGFEBwufbKDaeywHsnJHqxbGqa",180,0.989071,40,183,2,181,1,2,1,3,2,74,73,108,108,4
"327",26,"[40]cIdHoIdrrBkDemyGFEBwufbKDaeywHsnJHqxbGqa",201,0.990196,40,204,2,202,1,2,1,3,2,103,102,100,100,4
"328",27,"[40]cIdHoIdrrBkDemyGFEBwufbKDaeywHsnJHqxbGqa",206,0.990431,40,209,2,207,1,2,1,3,2,108,107,100,100,4
"329",28,"[40]cIdHoIdrrBkDemyGFEBwufbKDaeywHsnJHqxbGqa",196,0.98995,40,199,2,197,1,2,1,3,2,95,94,103,103,4
"330",29,"[40]cIdHoIdrrBkDemyGFEBwufbKDaeywHsnJHqxbGqa",196,0.98995,40,199,2,197,1,2,1,3,2,96,95,102,102,4
"331",30,"[40]cIdHoIdrrBkDemyGFEBwufbKDaeywHsnJHqxbGqa",191,0.989691,40,194,2,192,1,2,1,3,2,89,88,104,104,4
"332",31,"[40]cIdHoIdrrBkDemyGFEBwufbKDaeywHsnJHqxbGqa",215,0.990826,40,218,2,216,1,2,1,3,2,120,119,97,97,4
"333",32,"[40]cIdHoIdrrBkDemyGFEBwufbKDaeywHsnJHqxbGqa",181,0.98913,40,184,2,182,1,2,1,3,2,75,74,108,108,4
"334",33,"[40]cIdHoIdrrBkDemyGFEBwufbKDaeywHsnJHqxbGqa",194,0.989848,40,197,2,195,1,2,1,3,2,93,92,103,103,4
"335",34,"[40]cIdHoIdrrBkDemyGFEBwufbKDaeywHsnJHqxbGqa",196,0.98995,40,199,2,197,1,2,1,3,2,97,96,101,101,4
"336",35,"[40]cIdHoIdrrBkDemyGFEBwufbKDaeywHsnJHqxbGqa",198,0.99005,40,201,2,199,1,2,1,3,2,99,98,101,101,4
"337",36,"[40]cIdHoIdrrBkDemyGFEBwufbKDaeywHsnJHqxbGqa",188,0.989529,40,191,2,189,1,2,1,3,2,84,83,106,106,4
"338",37,"[40]cIdHoIdrrBkDemyGFEBwufbKDaeywHsnJHqxbGqa",198,0.99005,40,201,2,199,1,2,1,3,2,98,97,102,102,4
"339",38,"[40]cIdHoIdrrBkDemyGFEBwufbKDaeywHsnJHqxbGqa",206,0.990431,40,209,2,207,1,2,1,3,2,111,110,97,97,4
"340",39,"[40]cIdHoIdrrBkDemyGFEBwufbKDaeywHsnJHqxbGqa",208,0.990521,40,211,2,209,1,2,1,3,2,109,108,101,101,4
"341",40,"[40]cIdHoIdrrBkDemyGFEBwufbKDaeywHsnJHqxbGqa",189,0.989583,40,192,2,190,1,2,1,3,2,87,86,104,104,4
"342",41,"[40]cIdHoIdrrBkDemyGFEBwufbKDaeywHsnJHqxbGqa",201,0.990196,40,204,2,202,1,2,1,3,2,102,101,101,101,4
"343",42,"[40]cIdHoIdrrBkDemyGFEBwufbKDaeywHsnJHqxbGqa",205,0.990385,40,208,2,206,1,2,1,3,2,108,107,99,99,4
"344",43,"[40]cIdHoIdrrBkDemyGFEBwufbKDaeywHsnJHqxbGqa",208,0.990521,40,211,2,209,1,2,1,3,2,110,109,100,100,4
"345",44,"[40]cIdHoIdrrBkDemyGFEBwufbKDaeywHsnJHqxbGqa",202,0.990244,40,205,2,203,1,2,1,3,2,104,103,100,100,4
"346",45,"[40]cIdHoIdrrBkDemyGFEBwufbKDaeywHsnJHqxbGqa",189,0.989583,40,192,2,190,1,2,1,3,2,85,84,106,106,4
"347",46,"[40]cIdHoIdrrBkDemyGFEBwufbKDaeywHsnJHqxbGqa",208,0.990521,40,211,2,209,1,2,1,3,2,112,111,98,98,4
"348",47,"[40]cIdHoIdrrBkDemyGFEBwufbKDaeywHsnJHqxbGqa",210,0.99061,40,213,2,211,1,2,1,3,2,119,118,93,93,4
"349",48,"[40]cIdHoIdrrBkDemyGFEBwufbKDaeywHsnJHqxbGqa",211,0.990654,40,214,2,212,1,2,1,3,2,119,118,94,94,4
"350",49,"[40]cIdHoIdrrBkDemyGFEBwufbKDaeywHsnJHqxbGqa",187,0.989474,40,190,2,188,1,2,1,3,2,84,83,105,105,4
"351",50,"[40]cIdHoIdrrBkDemyGFEBwufbKDaeywHsnJHqxbGqa",199,0.990099,40,202,2,200,1,2,1,3,2,99,98,102,102,4
"352",51,"[40]cIdHoIdrrBkDemyGFEBwufbKDaeywHsnJHqxbGqa",206,0.990431,40,209,2,207,1,2,1,3,2,110,109,98,98,4
"353",52,"[40]cIdHoIdrrBkDemyGFEBwufbKDaeywHsnJHqxbGqa",188,0.989529,40,191,2,189,1,2,1,3,2,83,82,107,107,4
"354",53,"[40]cIdHoIdrrBkDemyGFEBwufbKDaeywHsnJHqxbGqa",204,0.990338,40,207,2,205,1,2,1,3,2,107,106,99,99,4
"355",54,"[40]cIdHoIdrrBkDemyGFEBwufbKDaeywHsnJHqxbGqa",191,0.989691,40,194,2,192,1,2,1,3,2,88,87,105,105,4
"356",55,"[40]cIdHoIdrrBkDemyGFEBwufbKDaeywHsnJHqxbGqa",206,0.990431,40,209,2,207,1,2,1,3,2,108,107,100,100,4
"357",56,"[40]cIdHoIdrrBkDemyGFEBwufbKDaeywHsnJHqxbGqa",206,0.990431,40,209,2,207,1,2,1,3,2,110,109,98,98,4
"358",57,"[40]cIdHoIdrrBkDemyGFEBwufbKDaeywHsnJHqxbGqa",207,0.990476,40,210,2,208,1,2,1,3,2,109,108,100,100,4
"359",58,"[40]cIdHoIdrrBkDemyGFEBwufbKDaeywHsnJHqxbGqa",208,0.990521,40,211,2,209,1,2,1,3,2,109,108,101,101,4
"360",59,"[40]cIdHoIdrrBkDemyGFEBwufbKDaeywHsnJHqxbGqa",210,0.99061,40,213,2,211,1,2,1,3,2,116,115,96,96,4
"361",60,"[40]cIdHoIdrrBkDemyGFEBwufbKDaeywHsnJHqxbGqa",200,0.990148,40,203,2,201,1,2,1,3,2,99,98,103,103,4
"362",61,"[40]cIdHoIdrrBkDemyGFEBwufbKDaeywHsnJHqxbGqa",199,0.990099,40,202,2,200,1,2,1,3,2,100,99,101,101,4
"363",62,"[40]cIdHoIdrrBkDemyGFEBwufbKDaeywHsnJHqxbGqa",194,0.989848,40,197,2,195,1,2,1,3,2,94,93,102,102,4
"364",63,"[40]cIdHoIdrrBkDemyGFEBwufbKDaeywHsnJHqxbGqa",212,0.990698,40,215,2,213,1,2,1,3,2,123,122,91,91,4
"365",64,"[40]cIdHoIdrrBkDemyGFEBwufbKDaeywHsnJHqxbGqa",203,0.990291,40,206,2,204,1,2,1,3,2,106,105,99,99,4
"366",65,"[40]cIdHoIdrrBkDemyGFEBwufbKDaeywHsnJHqxbGqa",200,0.990148,40,203,2,201,1,2,1,3,2,101,100,101,101,4
"367",66,"[40]cIdHoIdrrBkDemyGFEBwufbKDaeywHsnJHqxbGqa",200,0.990148,40,203,2,201,1,2,1,3,2,99,98,103,103,4
"368",67,"[40]cIdHoIdrrBkDemyGFEBwufbKDaeywHsnJHqxbGqa",199,0.990099,40,202,2,200,1,2,1,3,2,100,99,101,101,4
"369",68,"[40]cIdHoIdrrBkDemyGFEBwufbKDaeywHsnJHqxbGqa",192,0.989744,40,195,2,193,1,2,1,3,2,89,88,105,105,4
"370",69,"[40]cIdHoIdrrBkDemyGFEBwufbKDaeywHsnJHqxbGqa",213,0.990741,40,216,2,214,1,2,1,3,2,119,118,96,96,4
"371",70,"[40]cIdHoIdrrBkDemyGFEBwufbKDaeywHsnJHqxbGqa",198,0.99005,40,201,2,199,1,2,1,3,2,100,99,100,100,4
"372",71,"[40]cIdHoIdrrBkDemyGFEBwufbKDaeywHsnJHqxbGqa",206,0.990431,40,209,2,207,1,2,1,3,2,109,108,99,99,4
"373",72,"[40]cIdHoIdrrBkDemyGFEBwufbKDaeywHsnJHqxbGqa",191,0.989691,40,194,2,192,1,2,1,3,2,88,87,105,105,4
"374",73,"[40]cIdHoIdrrBkDemyGFEBwufbKDaeywHsnJHqxbGqa",201,0.990196,40,204,2,202,1,2,1,3,2,101,100,102,102,4
"375",74,"[40]cIdHoIdrrBkDemyGFEBwufbKDaeywHsnJHqxbGqa",224,0.991189,40,227,2,225,1,2,1,3,2,132,131,94,94,4
"376",75,"[40]cIdHoIdrrBkDemyGFEBwufbKDaeywHsnJHqxbGqa",206,0.990431,40,209,2,207,1,2,1,3,2,108,107,100,100,4
"377",76,"[40]cIdHoIdrrBkDemyGFEBwufbKDaeywHsnJHqxbGqa",208,0.990521,40,211,2,209,1,2,1,3,2,114,113,96,96,4
"378",77,"[40]cIdHoIdrrBkDemyGFEBwufbKDaeywHsnJHqxbGqa",213,0.990741,40,216,2,214,1,2,1,3,2,118,117,97,97,4
"379",78,"[40]cIdHoIdrrBkDemyGFEBwufbKDaeywHsnJHqxbGqa",198,0.99005,40,201,2,199,1,2,1,3,2,98,97,102,102,4
"380",79,"[40]cIdHoIdrrBkDemyGFEBwufbKDaeywHsnJHqxbGqa",188,0.989529,40,191,2,189,1,2,1,3,2,85,84,105,105,4
"381",80,"[40]cIdHoIdrrBkDemyGFEBwufbKDaeywHsnJHqxbGqa",194,0.989848,40,197,2,195,1,2,1,3,2,95,94,101,101,4
"382",81,"[40]cIdHoIdrrBkDemyGFEBwufbKDaeywHsnJHqxbGqa",190,0.989637,40,193,2,191,1,2,1,3,2,87,86,105,105,4
"383",82,"[40]cIdHoIdrrBkDemyGFEBwufbKDaeywHsnJHqxbGqa",215,0.990826,40,218,2,216,1,2,1,3,2,122,121,95,95,4
"384",83,"[40]cIdHoIdrrBkDemyGFEBwufbKDaeywHsnJHqxbGqa",207,0.990476,40,210,2,208,1,2,1,3,2,112,111,97,97,4
"385",84,"[40]cIdHoIdrrBkDemyGFEBwufbKDaeywHsnJHqxbGqa",186,0.989418,40,189,2,187,1,2,1,3,2,84,83,104,104,4
"386",85,"[40]cIdHoIdrrBkDemyGFEBwufbKDaeywHsnJHqxbGqa",211,0.990654,40,214,2,212,1,2,1,3,2,116,115,97,97,4
"387",86,"[40]cIdHoIdrrBkDemyGFEBwufbKDaeywHsnJHqxbGqa",197,0.99,40,200,2,198,1,2,1,3,2,96,95,103,103,4
"388",87,"[40]cIdHoIdrrBkDemyGFEBwufbKDaeywHsnJHqxbGqa",197,0.99,40,200,2,198,1,2,1,3,2,97,96,102,102,4
"389",88,"[40]cIdHoIdrrBkDemyGFEBwufbKDaeywHsnJHqxbGqa",192,0.989744,40,195,2,193,1,2,1,3,2,92,91,102,102,4
"390",89,"[40]cIdHoIdrrBkDemyGFEBwufbKDaeywHsnJHqxbGqa",188,0.989529,40,191,2,189,1,2,1,3,2,85,84,105,105,4
"391",90,"[40]cIdHoIdrrBkDemyGFEBwufbKDaeywHsnJHqxbGqa",208,0.990521,40,211,2,209,1,2,1,3,2,112,111,98,98,4
"392",91,"[40]cIdHoIdrrBkDemyGFEBwufbKDaeywHsnJHqxbGqa",214,0.990783,40,217,2,215,1,2,1,3,2,122,121,94,94,4
"393",92,"[40]cIdHoIdrrBkDemyGFEBwufbKDaeywHsnJHqxbGqa",193,0.989796,40,196,2,194,1,2,1,3,2,92,91,103,103,4
"394",93,"[40]cIdHoIdrrBkDemyGFEBwufbKDaeywHsnJHqxbGqa",187,0.989474,40,190,2,188,1,2,1,3,2,82,81,107,107,4
"395",94,"[40]cIdHoIdrrBkDemyGFEBwufbKDaeywHsnJHqxbGqa",194,0.989848,40,197,2,195,1,2,1,3,2,92,91,104,104,4
"396",95,"[40]cIdHoIdrrBkDemyGFEBwufbKDaeywHsnJHqxbGqa",192,0.989744,40,195,2,193,1,2,1,3,2,91,90,103,103,4
"397",96,"[40]cIdHoIdrrBkDemyGFEBwufbKDaeywHsnJHqxbGqa",186,0.989418,40,189,2,187,1,2,1,3,2,81,80,107,107,4
"398",97,"[40]cIdHoIdrrBkDemyGFEBwufbKDaeywHsnJHqxbGqa",199,0.990099,40,202,2,200,1,2,1,3,2,97,96,104,104,4
"399",98,"[40]cIdHoIdrrBkDemyGFEBwufbKDaeywHsnJHqxbGqa",188,0.989529,40,191,2,189,1,2,1,3,2,87,86,103,103,4
"400",99,"[40]cIdHoIdrrBkDemyGFEBwufbKDaeywHsnJHqxbGqa",196,0.98995,40,199,2,197,1,2,1,3,2,95,94,103,103,4
"401",0,"[40]sIkHoIpJfBkDFjjAylBuIebKDaefaHtnJHqvbGqa",203,0.990291,40,206,2,204,1,2,1,3,2,106,105,99,99,6
"402",1,"[40]sIkHoIpJfBkDFjjAylBuIebKDaefaHtnJHqvbGqa",197,0.99,40,200,2,198,1,2,1,3,2,99,98,100,100,6
"403",2,"[40]sIkHoIpJfBkDFjjAylBuIebKDaefaHtnJHqvbGqa",198,0.99005,40,201,2,199,1,2,1,3,2,98,97,102,102,6
"404",3,"[40]sIkHoIpJfBkDFjjAylBuIebKDaefaHtnJHqvbGqa",217,0.990909,40,220,2,218,1,2,1,3,2,121,120,98,98,6
"405",4,"[40]sIkHoIpJfBkDFjjAylBuIebKDaefaHtnJHqvbGqa",203,0.990291,40,206,2,204,1,2,1,3,2,105,104,100,100,6
"406",5,"[40]sIkHoIpJfBkDFjjAylBuIebKDaefaHtnJHqvbGqa",186,0.989418,40,189,2,187,1,2,1,3,2,83,82,105,105,6
"407",6,"[40]sIkHoIpJfBkDFjjAylBuIebKDaefaHtnJHqvbGqa",204,0.990338,40,207,2,205,1,2,1,3,2,105,104,101,101,6
"408",7,"[40]sIkHoIpJfBkDFjjAylBuIebKDaefaHtnJHqvbGqa",218,0.99095,40,221,2,219,1,2,1,3,2,125,124,95,95,6
"409",8,"[40]sIkHoIpJfBkDFjjAylBuIebKDaefaHtnJHqvbGqa",208,0.990521,40,211,2,209,1,2,1,3,2,111,110,99,99,6
"410",9,"[40]sIkHoIpJfBkDFjjAylBuIebKDaefaHtnJHqvbGqa",204,0.990338,40,207,2,205,1,2,1,3,2,104,103,102,102,6
"411",10,"[40]sIkHoIpJfBkDFjjAylBuIebKDaefaHtnJHqvbGqa",195,0.989899,40,198,2,196,1,2,1,3,2,96,95,101,101,6
"412",11,"[40]sIkHoIpJfBkDFjjAylBuIebKDaefaHtnJHqvbGqa",201,0.990196,40,204,2,202,1,2,1,3,2,102,101,101,101,6
"413",12,"[40]sIkHoIpJfBkDFjjAylBuIebKDaefaHtnJHqvbGqa",199,0.990099,40,202,2,200,1,2,1,3,2,99,98,102,102,6
"414",13,"[40]sIkHoIpJfBkDFjjAylBuIebKDaefaHtnJHqvbGqa",190,0.989637,40,193,2,191,1,2,1,3,2,86,85,106,106,6
"415",14,"[40]sIkHoIpJfBkDFjjAylBuIebKDaefaHtnJHqvbGqa",207,0.990476,40,210,2,208,1,2,1,3,2,110,109,99,99,6
"416",15,"[40]sIkHoIpJfBkDFjjAylBuIebKDaefaHtnJHqvbGqa",190,0.989637,40,193,2,191,1,2,1,3,2,88,87,104,104,6
"417",16,"[40]sIkHoIpJfBkDFjjAylBuIebKDaefaHtnJHqvbGqa",193,0.989796,40,196,2,194,1,2,1,3,2,92,91,103,103,6
"418",17,"[40]sIkHoIpJfBkDFjjAylBuIebKDaefaHtnJHqvbGqa",205,0.990385,40,208,2,206,1,2,1,3,2,110,109,97,97,6
"419",18,"[40]sIkHoIpJfBkDFjjAylBuIebKDaefaHtnJHqvbGqa",208,0.990521,40,211,2,209,1,2,1,3,2,112,111,98,98,6
"420",19,"[40]sIkHoIpJfBkDFjjAylBuIebKDaefaHtnJHqvbGqa",199,0.990099,40,202,2,200,1,2,1,3,2,100,99,101,101,6
"421",20,"[40]sIkHoIpJfBkDFjjAylBuIebKDaefaHtnJHqvbGqa",201,0.990196,40,204,2,202,1,2,1,3,2,101,100,102,102,6
"422",21,"[40]sIkHoIpJfBkDFjjAylBuIebKDaefaHtnJHqvbGqa",195,0.989899,40,198,2,196,1,2,1,3,2,96,95,101,101,6
"423",22,"[40]sIkHoIpJfBkDFjjAylBuIebKDaefaHtnJHqvbGqa",203,0.990291,40,206,2,204,1,2,1,3,2,105,104,100,100,6
"424",23,"[40]sIkHoIpJfBkDFjjAylBuIebKDaefaHtnJHqvbGqa",196,0.98995,40,199,2,197,1,2,1,3,2,97,96,101,101,6
"425",24,"[40]sIkHoIpJfBkDFjjAylBuIebKDaefaHtnJHqvbGqa",195,0.989899,40,198,2,196,1,2,1,3,2,92,91,105,105,6
"426",25,"[40]sIkHoIpJfBkDFjjAylBuIebKDaefaHtnJHqvbGqa",192,0.989744,40,195,2,193,1,2,1,3,2,90,89,104,104,6
"427",26,"[40]sIkHoIpJfBkDFjjAylBuIebKDaefaHtnJHqvbGqa",202,0.990244,40,205,2,203,1,2,1,3,2,106,105,98,98,6
"428",27,"[40]sIkHoIpJfBkDFjjAylBuIebKDaefaHtnJHqvbGqa",216,0.990868,40,219,2,217,1,2,1,3,2,124,123,94,94,6
"429",28,"[40]sIkHoIpJfBkDFjjAylBuIebKDaefaHtnJHqvbGqa",212,0.990698,40,215,2,213,1,2,1,3,2,116,115,98,98,6
"430",29,"[40]sIkHoIpJfBkDFjjAylBuIebKDaefaHtnJHqvbGqa",218,0.99095,40,221,2,219,1,2,1,3,2,124,123,96,96,6
"431",30,"[40]sIkHoIpJfBkDFjjAylBuIebKDaefaHtnJHqvbGqa",193,0.989796,40,196,2,194,1,2,1,3,2,91,90,104,104,6
"432",31,"[40]sIkHoIpJfBkDFjjAylBuIebKDaefaHtnJHqvbGqa",207,0.990476,40,210,2,208,1,2,1,3,2,112,111,97,97,6
"433",32,"[40]sIkHoIpJfBkDFjjAylBuIebKDaefaHtnJHqvbGqa",214,0.990783,40,217,2,215,1,2,1,3,2,121,120,95,95,6
"434",33,"[40]sIkHoIpJfBkDFjjAylBuIebKDaefaHtnJHqvbGqa",193,0.989796,40,196,2,194,1,2,1,3,2,91,90,104,104,6
"435",34,"[40]sIkHoIpJfBkDFjjAylBuIebKDaefaHtnJHqvbGqa",209,0.990566,40,212,2,210,1,2,1,3,2,114,113,97,97,6
"436",35,"[40]sIkHoIpJfBkDFjjAylBuIebKDaefaHtnJHqvbGqa",194,0.989848,40,197,2,195,1,2,1,3,2,93,92,103,103,6
"437",36,"[40]sIkHoIpJfBkDFjjAylBuIebKDaefaHtnJHqvbGqa",217,0.990909,40,220,2,218,1,2,1,3,2,125,124,94,94,6
"438",37,"[40]sIkHoIpJfBkDFjjAylBuIebKDaefaHtnJHqvbGqa",194,0.989848,40,197,2,195,1,2,1,3,2,94,93,102,102,6
"439",38,"[40]sIkHoIpJfBkDFjjAylBuIebKDaefaHtnJHqvbGqa",209,0.990566,40,212,2,210,1,2,1,3,2,113,112,98,98,6
"440",39,"[40]sIkHoIpJfBkDFjjAylBuIebKDaefaHtnJHqvbGqa",200,0.990148,40,203,2,201,1,2,1,3,2,102,101,100,100,6
"441",40,"[40]sIkHoIpJfBkDFjjAylBuIebKDaefaHtnJHqvbGqa",199,0.990099,40,202,2,200,1,2,1,3,2,100,99,101,101,6
"442",41,"[40]sIkHoIpJfBkDFjjAylBuIebKDaefaHtnJHqvbGqa",205,0.990385,40,208,2,206,1,2,1,3,2,107,106,100,100,6
"443",42,"[40]sIkHoIpJfBkDFjjAylBuIebKDaefaHtnJHqvbGqa",202,0.990244,40,205,2,203,1,2,1,3,2,104,103,100,100,6
"444",43,"[40]sIkHoIpJfBkDFjjAylBuIebKDaefaHtnJHqvbGqa",222,0.991111,40,225,2,223,1,2,1,3,2,127,126,97,97,6
"445",44,"[40]sIkHoIpJfBkDFjjAylBuIebKDaefaHtnJHqvbGqa",209,0.990566,40,212,2,210,1,2,1,3,2,111,110,100,100,6
"446",45,"[40]sIkHoIpJfBkDFjjAylBuIebKDaefaHtnJHqvbGqa",196,0.98995,40,199,2,197,1,2,1,3,2,96,95,102,102,6
"447",46,"[40]sIkHoIpJfBkDFjjAylBuIebKDaefaHtnJHqvbGqa",197,0.99,40,200,2,198,1,2,1,3,2,97,96,102,102,6
"448",47,"[40]sIkHoIpJfBkDFjjAylBuIebKDaefaHtnJHqvbGqa",210,0.99061,40,213,2,211,1,2,1,3,2,114,113,98,98,6
"449",48,"[40]sIkHoIpJfBkDFjjAylBuIebKDaefaHtnJHqvbGqa",204,0.990338,40,207,2,205,1,2,1,3,2,107,106,99,99,6
"450",49,"[40]sIkHoIpJfBkDFjjAylBuIebKDaefaHtnJHqvbGqa",200,0.990148,40,203,2,201,1,2,1,3,2,98,97,104,104,6
"451",50,"[40]sIkHoIpJfBkDFjjAylBuIebKDaefaHtnJHqvbGqa",199,0.990099,40,202,2,200,1,2,1,3,2,100,99,101,101,6
"452",51,"[40]sIkHoIpJfBkDFjjAylBuIebKDaefaHtnJHqvbGqa",194,0.989848,40,197,2,195,1,2,1,3,2,93,92,103,103,6
"453",52,"[40]sIkHoIpJfBkDFjjAylBuIebKDaefaHtnJHqvbGqa",198,0.99005,40,201,2,199,1,2,1,3,2,100,99,100,100,6
"454",53,"[40]sIkHoIpJfBkDFjjAylBuIebKDaefaHtnJHqvbGqa",203,0.990291,40,206,2,204,1,2,1,3,2,105,104,100,100,6
"455",54,"[40]sIkHoIpJfBkDFjjAylBuIebKDaefaHtnJHqvbGqa",198,0.99005,40,201,2,199,1,2,1,3,2,98,97,102,102,6
"456",55,"[40]sIkHoIpJfBkDFjjAylBuIebKDaefaHtnJHqvbGqa",207,0.990476,40,210,2,208,1,2,1,3,2,110,109,99,99,6
"457",56,"[40]sIkHoIpJfBkDFjjAylBuIebKDaefaHtnJHqvbGqa",190,0.989637,40,193,2,191,1,2,1,3,2,87,86,105,105,6
"458",57,"[40]sIkHoIpJfBkDFjjAylBuIebKDaefaHtnJHqvbGqa",199,0.990099,40,202,2,200,1,2,1,3,2,100,99,101,101,6
"459",58,"[40]sIkHoIpJfBkDFjjAylBuIebKDaefaHtnJHqvbGqa",194,0.989848,40,197,2,195,1,2,1,3,2,92,91,104,104,6
"460",59,"[40]sIkHoIpJfBkDFjjAylBuIebKDaefaHtnJHqvbGqa",202,0.990244,40,205,2,203,1,2,1,3,2,103,102,101,101,6
"461",60,"[40]sIkHoIpJfBkDFjjAylBuIebKDaefaHtnJHqvbGqa",214,0.990783,40,217,2,215,1,2,1,3,2,121,120,95,95,6
"462",61,"[40]sIkHoIpJfBkDFjjAylBuIebKDaefaHtnJHqvbGqa",197,0.99,40,200,2,198,1,2,1,3,2,99,98,100,100,6
"463",62,"[40]sIkHoIpJfBkDFjjAylBuIebKDaefaHtnJHqvbGqa",195,0.989899,40,198,2,196,1,2,1,3,2,94,93,103,103,6
"464",63,"[40]sIkHoIpJfBkDFjjAylBuIebKDaefaHtnJHqvbGqa",227,0.991304,40,230,2,228,1,2,1,3,2,137,136,92,92,6
"465",64,"[40]sIkHoIpJfBkDFjjAylBuIebKDaefaHtnJHqvbGqa",197,0.99,40,200,2,198,1,2,1,3,2,97,96,102,102,6
"466",65,"[40]sIkHoIpJfBkDFjjAylBuIebKDaefaHtnJHqvbGqa",195,0.989899,40,198,2,196,1,2,1,3,2,93,92,104,104,6
"467",66,"[40]sIkHoIpJfBkDFjjAylBuIebKDaefaHtnJHqvbGqa",185,0.989362,40,188,2,186,1,2,1,3,2,81,80,106,106,6
"468",67,"[40]sIkHoIpJfBkDFjjAylBuIebKDaefaHtnJHqvbGqa",193,0.989796,40,196,2,194,1,2,1,3,2,93,92,102,102,6
"469",68,"[40]sIkHoIpJfBkDFjjAylBuIebKDaefaHtnJHqvbGqa",188,0.989529,40,191,2,189,1,2,1,3,2,84,83,106,106,6
"470",69,"[40]sIkHoIpJfBkDFjjAylBuIebKDaefaHtnJHqvbGqa",205,0.990385,40,208,2,206,1,2,1,3,2,108,107,99,99,6
"471",70,"[40]sIkHoIpJfBkDFjjAylBuIebKDaefaHtnJHqvbGqa",206,0.990431,40,209,2,207,1,2,1,3,2,110,109,98,98,6
"472",71,"[40]sIkHoIpJfBkDFjjAylBuIebKDaefaHtnJHqvbGqa",189,0.989583,40,192,2,190,1,2,1,3,2,86,85,105,105,6
"473",72,"[40]sIkHoIpJfBkDFjjAylBuIebKDaefaHtnJHqvbGqa",206,0.990431,40,209,2,207,1,2,1,3,2,108,107,100,100,6
"474",73,"[40]sIkHoIpJfBkDFjjAylBuIebKDaefaHtnJHqvbGqa",203,0.990291,40,206,2,204,1,2,1,3,2,105,104,100,100,6
"475",74,"[40]sIkHoIpJfBkDFjjAylBuIebKDaefaHtnJHqvbGqa",202,0.990244,40,205,2,203,1,2,1,3,2,104,103,100,100,6
"476",75,"[40]sIkHoIpJfBkDFjjAylBuIebKDaefaHtnJHqvbGqa",201,0.990196,40,204,2,202,1,2,1,3,2,101,100,102,102,6
"477",76,"[40]sIkHoIpJfBkDFjjAylBuIebKDaefaHtnJHqvbGqa",203,0.990291,40,206,2,204,1,2,1,3,2,106,105,99,99,6
"478",77,"[40]sIkHoIpJfBkDFjjAylBuIebKDaefaHtnJHqvbGqa",204,0.990338,40,207,2,205,1,2,1,3,2,108,107,98,98,6
"479",78,"[40]sIkHoIpJfBkDFjjAylBuIebKDaefaHtnJHqvbGqa",212,0.990698,40,215,2,213,1,2,1,3,2,117,116,97,97,6
"480",79,"[40]sIkHoIpJfBkDFjjAylBuIebKDaefaHtnJHqvbGqa",184,0.989305,40,187,2,185,1,2,1,3,2,80,79,106,106,6
"481",80,"[40]sIkHoIpJfBkDFjjAylBuIebKDaefaHtnJHqvbGqa",199,0.990099,40,202,2,200,1,2,1,3,2,98,97,103,103,6
"482",81,"[40]sIkHoIpJfBkDFjjAylBuIebKDaefaHtnJHqvbGqa",181,0.98913,40,184,2,182,1,2,1,3,2,75,74,108,108,6
"483",82,"[40]sIkHoIpJfBkDFjjAylBuIebKDaefaHtnJHqvbGqa",192,0.989744,40,195,2,193,1,2,1,3,2,89,88,105,105,6
"484",83,"[40]sIkHoIpJfBkDFjjAylBuIebKDaefaHtnJHqvbGqa",210,0.99061,40,213,2,211,1,2,1,3,2,113,112,99,99,6
"485",84,"[40]sIkHoIpJfBkDFjjAylBuIebKDaefaHtnJHqvbGqa",195,0.989899,40,198,2,196,1,2,1,3,2,94,93,103,103,6
"486",85,"[40]sIkHoIpJfBkDFjjAylBuIebKDaefaHtnJHqvbGqa",204,0.990338,40,207,2,205,1,2,1,3,2,108,107,98,98,6
"487",86,"[40]sIkHoIpJfBkDFjjAylBuIebKDaefaHtnJHqvbGqa",187,0.989474,40,190,2,188,1,2,1,3,2,84,83,105,105,6
"488",87,"[40]sIkHoIpJfBkDFjjAylBuIebKDaefaHtnJHqvbGqa",207,0.990476,40,210,2,208,1,2,1,3,2,111,110,98,98,6
"489",88,"[40]sIkHoIpJfBkDFjjAylBuIebKDaefaHtnJHqvbGqa",191,0.989691,40,194,2,192,1,2,1,3,2,89,88,104,104,6
"490",89,"[40]sIkHoIpJfBkDFjjAylBuIebKDaefaHtnJHqvbGqa",209,0.990566,40,212,2,210,1,2,1,3,2,116,115,95,95,6
"491",90,"[40]sIkHoIpJfBkDFjjAylBuIebKDaefaHtnJHqvbGqa",206,0.990431,40,209,2,207,1,2,1,3,2,110,109,98,98,6
"492",91,"[40]sIkHoIpJfBkDFjjAylBuIebKDaefaHtnJHqvbGqa",197,0.99,40,200,2,198,1,2,1,3,2,98,97,101,101,6
"493",92,"[40]sIkHoIpJfBkDFjjAylBuIebKDaefaHtnJHqvbGqa",203,0.990291,40,206,2,204,1,2,1,3,2,106,105,99,99,6
"494",93,"[40]sIkHoIpJfBkDFjjAylBuIebKDaefaHtnJHqvbGqa",201,0.990196,40,204,2,202,1,2,1,3,2,102,101,101,101,6
"495",94,"[40]sIkHoIpJfBkDFjjAylBuIebKDaefaHtnJHqvbGqa",199,0.990099,40,202,2,200,1,2,1,3,2,100,99,101,101,6
"496",95,"[40]sIkHoIpJfBkDFjjAylBuIebKDaefaHtnJHqvbGqa",186,0.989418,40,189,2,187,1,2,1,3,2,83,82,105,105,6
"497",96,"[40]sIkHoIpJfBkDFjjAylBuIebKDaefaHtnJHqvbGqa",205,0.990385,40,208,2,206,1,2,1,3,2,109,108,98,98,6
"498",97,"[40]sIkHoIpJfBkDFjjAylBuIebKDaefaHtnJHqvbGqa",196,0.98995,40,199,2,197,1,2,1,3,2,96,95,102,102,6
"499",98,"[40]sIkHoIpJfBkDFjjAylBuIebKDaefaHtnJHqvbGqa",201,0.990196,40,204,2,202,1,2,1,3,2,102,101,101,101,6
"500",99,"[40]sIkHoIpJfBkDFjjAylBuIebKDaefaHtnJHqvbGqa",192,0.989744,40,195,2,193,1,2,1,3,2,87,86,107,107,6
"501",0,"[33]HIHoIEBGDIDFBxobKDaeBmHtnJHqvbGqa",207,0.990476,33,210,2,208,1,2,1,3,2,108,107,101,101,7
"502",1,"[33]HIHoIEBGDIDFBxobKDaeBmHtnJHqvbGqa",215,0.990826,33,218,2,216,1,2,1,3,2,121,120,96,96,7
"503",2,"[33]HIHoIEBGDIDFBxobKDaeBmHtnJHqvbGqa",215,0.990826,33,218,2,216,1,2,1,3,2,119,118,98,98,7
"504",3,"[33]HIHoIEBGDIDFBxobKDaeBmHtnJHqvbGqa",196,0.98995,33,199,2,197,1,2,1,3,2,96,95,102,102,7
"505",4,"[33]HIHoIEBGDIDFBxobKDaeBmHtnJHqvbGqa",209,0.990566,33,212,2,210,1,2,1,3,2,110,109,101,101,7
"506",5,"[33]HIHoIEBGDIDFBxobKDaeBmHtnJHqvbGqa",198,0.99005,33,201,2,199,1,2,1,3,2,95,94,105,105,7
"507",6,"[33]HIHoIEBGDIDFBxobKDaeBmHtnJHqvbGqa",211,0.990654,33,214,2,212,1,2,1,3,2,114,113,99,99,7
"508",7,"[33]HIHoIEBGDIDFBxobKDaeBmHtnJHqvbGqa",203,0.990291,33,206,2,204,1,2,1,3,2,104,103,101,101,7
"509",8,"[33]HIHoIEBGDIDFBxobKDaeBmHtnJHqvbGqa",203,0.990291,33,206,2,204,1,2,1,3,2,104,103,101,101,7
"510",9,"[33]HIHoIEBGDIDFBxobKDaeBmHtnJHqvbGqa",209,0.990566,33,212,2,210,1,2,1,3,2,112,111,99,99,7
"511",10,"[33]HIHoIEBGDIDFBxobKDaeBmHtnJHqvbGqa",207,0.990476,33,210,2,208,1,2,1,3,2,110,109,99,99,7
"512",11,"[33]HIHoIEBGDIDFBxobKDaeBmHtnJHqvbGqa",207,0.990476,33,210,2,208,1,2,1,3,2,108,107,101,101,7
"513",12,"[33]HIHoIEBGDIDFBxobKDaeBmHtnJHqvbGqa",209,0.990566,33,212,2,210,1,2,1,3,2,112,111,99,99,7
"514",13,"[33]HIHoIEBGDIDFBxobKDaeBmHtnJHqvbGqa",205,0.990385,33,208,2,206,1,2,1,3,2,104,103,103,103,7
"515",14,"[33]HIHoIEBGDIDFBxobKDaeBmHtnJHqvbGqa",190,0.989637,33,193,2,191,1,2,1,3,2,85,84,107,107,7
"516",15,"[33]HIHoIEBGDIDFBxobKDaeBmHtnJHqvbGqa",197,0.99,33,200,2,198,1,2,1,3,2,93,92,106,106,7
"517",16,"[33]HIHoIEBGDIDFBxobKDaeBmHtnJHqvbGqa",203,0.990291,33,206,2,204,1,2,1,3,2,103,102,102,102,7
"518",17,"[33]HIHoIEBGDIDFBxobKDaeBmHtnJHqvbGqa",196,0.98995,33,199,2,197,1,2,1,3,2,97,96,101,101,7
"519",18,"[33]HIHoIEBGDIDFBxobKDaeBmHtnJHqvbGqa",198,0.99005,33,201,2,199,1,2,1,3,2,96,95,104,104,7
"520",19,"[33]HIHoIEBGDIDFBxobKDaeBmHtnJHqvbGqa",211,0.990654,33,214,2,212,1,2,1,3,2,113,112,100,100,7
"521",20,"[33]HIHoIEBGDIDFBxobKDaeBmHtnJHqvbGqa",197,0.99,33,200,2,198,1,2,1,3,2,97,96,102,102,7
"522",21,"[33]HIHoIEBGDIDFBxobKDaeBmHtnJHqvbGqa",197,0.99,33,200,2,198,1,2,1,3,2,95,94,104,104,7
"523",22,"[33]HIHoIEBGDIDFBxobKDaeBmHtnJHqvbGqa",196,0.98995,33,199,2,197,1,2,1,3,2,93,92,105,105,7
"524",23,"[33]HIHoIEBGDIDFBxobKDaeBmHtnJHqvbGqa",205,0.990385,33,208,2,206,1,2,1,3,2,107,106,100,100,7
"525",24,"[33]HIHoIEBGDIDFBxobKDaeBmHtnJHqvbGqa",204,0.990338,33,207,2,205,1,2,1,3,2,103,102,103,103,7
"526",25,"[33]HIHoIEBGDIDFBxobKDaeBmHtnJHqvbGqa",195,0.989899,33,198,2,196,1,2,1,3,2,88,87,109,109,7
"527",26,"[33]HIHoIEBGDIDFBxobKDaeBmHtnJHqvbGqa",204,0.990338,33,207,2,205,1,2,1,3,2,103,102,103,103,7
"528",27,"[33]HIHoIEBGDIDFBxobKDaeBmHtnJHqvbGqa",196,0.98995,33,199,2,197,1,2,1,3,2,94,93,104,104,7
"529",28,"[33]HIHoIEBGDIDFBxobKDaeBmHtnJHqvbGqa",207,0.990476,33,210,2,208,1,2,1,3,2,108,107,101,101,7
"530",29,"[33]HIHoIEBGDIDFBxobKDaeBmHtnJHqvbGqa",200,0.990148,33,203,2,201,1,2,1,3,2,100,99,102,102,7
"531",30,"[33]HIHoIEBGDIDFBxobKDaeBmHtnJHqvbGqa",195,0.989899,33,198,2,196,1,2,1,3,2,92,91,105,105,7
"532",31,"[33]HIHoIEBGDIDFBxobKDaeBmHtnJHqvbGqa",196,0.98995,33,199,2,197,1,2,1,3,2,93,92,105,105,7
"533",32,"[33]HIHoIEBGDIDFBxobKDaeBmHtnJHqvbGqa",204,0.990338,33,207,2,205,1,2,1,3,2,105,104,101,101,7
"534",33,"[33]HIHoIEBGDIDFBxobKDaeBmHtnJHqvbGqa",206,0.990431,33,209,2,207,1,2,1,3,2,107,106,101,101,7
"535",34,"[33]HIHoIEBGDIDFBxobKDaeBmHtnJHqvbGqa",196,0.98995,33,199,2,197,1,2,1,3,2,92,91,106,106,7
"536",35,"[33]HIHoIEBGDIDFBxobKDaeBmHtnJHqvbGqa",201,0.990196,33,204,2,202,1,2,1,3,2,99,98,104,104,7
"537",36,"[33]HIHoIEBGDIDFBxobKDaeBmHtnJHqvbGqa",199,0.990099,33,202,2,200,1,2,1,3,2,100,99,101,101,7
"538",37,"[33]HIHoIEBGDIDFBxobKDaeBmHtnJHqvbGqa",211,0.990654,33,214,2,212,1,2,1,3,2,114,113,99,99,7
"539",38,"[33]HIHoIEBGDIDFBxobKDaeBmHtnJHqvbGqa",189,0.989583,33,192,2,190,1,2,1,3,2,86,85,105,105,7
"540",39,"[33]HIHoIEBGDIDFBxobKDaeBmHtnJHqvbGqa",201,0.990196,33,204,2,202,1,2,1,3,2,100,99,103,103,7
"541",40,"[33]HIHoIEBGDIDFBxobKDaeBmHtnJHqvbGqa",195,0.989899,33,198,2,196,1,2,1,3,2,93,92,104,104,7
"542",41,"[33]HIHoIEBGDIDFBxobKDaeBmHtnJHqvbGqa",188,0.989529,33,191,2,189,1,2,1,3,2,80,79,110,110,7
"543",42,"[33]HIHoIEBGDIDFBxobKDaeBmHtnJHqvbGqa",200,0.990148,33,203,2,201,1,2,1,3,2,96,95,106,106,7
"544",43,"[33]HIHoIEBGDIDFBxobKDaeBmHtnJHqvbGqa",197,0.99,33,200,2,198,1,2,1,3,2,95,94,104,104,7
"545",44,"[33]HIHoIEBGDIDFBxobKDaeBmHtnJHqvbGqa",200,0.990148,33,203,2,201,1,2,1,3,2,100,99,102,102,7
"546",45,"[33]HIHoIEBGDIDFBxobKDaeBmHtnJHqvbGqa",206,0.990431,33,209,2,207,1,2,1,3,2,105,104,103,103,7
"547",46,"[33]HIHoIEBGDIDFBxobKDaeBmHtnJHqvbGqa",205,0.990385,33,208,2,206,1,2,1,3,2,105,104,102,102,7
"548",47,"[33]HIHoIEBGDIDFBxobKDaeBmHtnJHqvbGqa",204,0.990338,33,207,2,205,1,2,1,3,2,104,103,102,102,7
"549",48,"[33]HIHoIEBGDIDFBxobKDaeBmHtnJHqvbGqa",209,0.990566,33,212,2,210,1,2,1,3,2,112,111,99,99,7
"550",49,"[33]HIHoIEBGDIDFBxobKDaeBmHtnJHqvbGqa",200,0.990148,33,203,2,201,1,2,1,3,2,100,99,102,102,7
"551",50,"[33]HIHoIEBGDIDFBxobKDaeBmHtnJHqvbGqa",213,0.990741,33,216,2,214,1,2,1,3,2,117,116,98,98,7
"552",51,"[33]HIHoIEBGDIDFBxobKDaeBmHtnJHqvbGqa",209,0.990566,33,212,2,210,1,2,1,3,2,111,110,100,100,7
"553",52,"[33]HIHoIEBGDIDFBxobKDaeBmHtnJHqvbGqa",207,0.990476,33,210,2,208,1,2,1,3,2,107,106,102,102,7
"554",53,"[33]HIHoIEBGDIDFBxobKDaeBmHtnJHqvbGqa",198,0.99005,33,201,2,199,1,2,1,3,2,96,95,104,104,7
"555",54,"[33]HIHoIEBGDIDFBxobKDaeBmHtnJHqvbGqa",209,0.990566,33,212,2,210,1,2,1,3,2,112,111,99,99,7
"556",55,"[33]HIHoIEBGDIDFBxobKDaeBmHtnJHqvbGqa",202,0.990244,33,205,2,203,1,2,1,3,2,100,99,104,104,7
"557",56,"[33]HIHoIEBGDIDFBxobKDaeBmHtnJHqvbGqa",215,0.990826,33,218,2,216,1,2,1,3,2,120,119,97,97,7
"558",57,"[33]HIHoIEBGDIDFBxobKDaeBmHtnJHqvbGqa",197,0.99,33,200,2,198,1,2,1,3,2,96,95,103,103,7
"559",58,"[33]HIHoIEBGDIDFBxobKDaeBmHtnJHqvbGqa",198,0.99005,33,201,2,199,1,2,1,3,2,96,95,104,104,7
"560",59,"[33]HIHoIEBGDIDFBxobKDaeBmHtnJHqvbGqa",224,0.991189,33,227,2,225,1,2,1,3,2,129,128,97,97,7
"561",60,"[33]HIHoIEBGDIDFBxobKDaeBmHtnJHqvbGqa",207,0.990476,33,210,2,208,1,2,1,3,2,108,107,101,101,7
"562",61,"[33]HIHoIEBGDIDFBxobKDaeBmHtnJHqvbGqa",195,0.989899,33,198,2,196,1,2,1,3,2,93,92,104,104,7
"563",62,"[33]HIHoIEBGDIDFBxobKDaeBmHtnJHqvbGqa",203,0.990291,33,206,2,204,1,2,1,3,2,102,101,103,103,7
"564",63,"[33]HIHoIEBGDIDFBxobKDaeBmHtnJHqvbGqa",191,0.989691,33,194,2,192,1,2,1,3,2,84,83,109,109,7
"565",64,"[33]HIHoIEBGDIDFBxobKDaeBmHtnJHqvbGqa",191,0.989691,33,194,2,192,1,2,1,3,2,87,86,106,106,7
"566",65,"[33]HIHoIEBGDIDFBxobKDaeBmHtnJHqvbGqa",197,0.99,33,200,2,198,1,2,1,3,2,94,93,105,105,7
"567",66,"[33]HIHoIEBGDIDFBxobKDaeBmHtnJHqvbGqa",212,0.990698,33,215,2,213,1,2,1,3,2,116,115,98,98,7
"568",67,"[33]HIHoIEBGDIDFBxobKDaeBmHtnJHqvbGqa",208,0.990521,33,211,2,209,1,2,1,3,2,109,108,101,101,7
"569",68,"[33]HIHoIEBGDIDFBxobKDaeBmHtnJHqvbGqa",195,0.989899,33,198,2,196,1,2,1,3,2,91,90,106,106,7
"570",69,"[33]HIHoIEBGDIDFBxobKDaeBmHtnJHqvbGqa",206,0.990431,33,209,2,207,1,2,1,3,2,106,105,102,102,7
"571",70,"[33]HIHoIEBGDIDFBxobKDaeBmHtnJHqvbGqa",207,0.990476,33,210,2,208,1,2,1,3,2,107,106,102,102,7
"572",71,"[33]HIHoIEBGDIDFBxobKDaeBmHtnJHqvbGqa",223,0.99115,33,226,2,224,1,2,1,3,2,130,129,95,95,7
"573",72,"[33]HIHoIEBGDIDFBxobKDaeBmHtnJHqvbGqa",210,0.99061,33,213,2,211,1,2,1,3,2,113,112,99,99,7
"574",73,"[33]HIHoIEBGDIDFBxobKDaeBmHtnJHqvbGqa",197,0.99,33,200,2,198,1,2,1,3,2,95,94,104,104,7
"575",74,"[33]HIHoIEBGDIDFBxobKDaeBmHtnJHqvbGqa",200,0.990148,33,203,2,201,1,2,1,3,2,99,98,103,103,7
"576",75,"[33]HIHoIEBGDIDFBxobKDaeBmHtnJHqvbGqa",208,0.990521,33,211,2,209,1,2,1,3,2,108,107,102,102,7
"577",76,"[33]HIHoIEBGDIDFBxobKDaeBmHtnJHqvbGqa",195,0.989899,33,198,2,196,1,2,1,3,2,92,91,105,105,7
"578",77,"[33]HIHoIEBGDIDFBxobKDaeBmHtnJHqvbGqa",210,0.99061,33,213,2,211,1,2,1,3,2,111,110,101,101,7
"579",78,"[33]HIHoIEBGDIDFBxobKDaeBmHtnJHqvbGqa",214,0.990783,33,217,2,215,1,2,1,3,2,121,120,95,95,7
"580",79,"[33]HIHoIEBGDIDFBxobKDaeBmHtnJHqvbGqa",205,0.990385,33,208,2,206,1,2,1,3,2,104,103,103,103,7
"581",80,"[33]HIHoIEBGDIDFBxobKDaeBmHtnJHqvbGqa",209,0.990566,33,212,2,210,1,2,1,3,2,112,111,99,99,7
"582",81,"[33]HIHoIEBGDIDFBxobKDaeBmHtnJHqvbGqa",214,0.990783,33,217,2,215,1,2,1,3,2,120,119,96,96,7
"583",82,"[33]HIHoIEBGDIDFBxobKDaeBmHtnJHqvbGqa",209,0.990566,33,212,2,210,1,2,1,3,2,112,111,99,99,7
"584",83,"[33]HIHoIEBGDIDFBxobKDaeBmHtnJHqvbGqa",199,0.990099,33,202,2,200,1,2,1,3,2,99,98,102,102,7
"585",84,"[33]HIHoIEBGDIDFBxobKDaeBmHtnJHqvbGqa",202,0.990244,33,205,2,203,1,2,1,3,2,102,101,102,102,7
"586",85,"[33]HIHoIEBGDIDFBxobKDaeBmHtnJHqvbGqa",198,0.99005,33,201,2,199,1,2,1,3,2,98,97,102,102,7
"587",86,"[33]HIHoIEBGDIDFBxobKDaeBmHtnJHqvbGqa",207,0.990476,33,210,2,208,1,2,1,3,2,108,107,101,101,7
"588",87,"[33]HIHoIEBGDIDFBxobKDaeBmHtnJHqvbGqa",213,0.990741,33,216,2,214,1,2,1,3,2,113,112,102,102,7
"589",88,"[33]HIHoIEBGDIDFBxobKDaeBmHtnJHqvbGqa",209,0.990566,33,212,2,210,1,2,1,3,2,112,111,99,99,7
"590",89,"[33]HIHoIEBGDIDFBxobKDaeBmHtnJHqvbGqa",218,0.99095,33,221,2,219,1,2,1,3,2,124,123,96,96,7
"591",90,"[33]HIHoIEBGDIDFBxobKDaeBmHtnJHqvbGqa",222,0.991111,33,225,2,223,1,2,1,3,2,130,129,94,94,7
"592",91,"[33]HIHoIEBGDIDFBxobKDaeBmHtnJHqvbGqa",201,0.990196,33,204,2,202,1,2,1,3,2,101,100,102,102,7
"593",92,"[33]HIHoIEBGDIDFBxobKDaeBmHtnJHqvbGqa",192,0.989744,33,195,2,193,1,2,1,3,2,89,88,105,105,7
"594",93,"[33]HIHoIEBGDIDFBxobKDaeBmHtnJHqvbGqa",198,0.99005,33,201,2,199,1,2,1,3,2,96,95,104,104,7
"595",94,"[33]HIHoIEBGDIDFBxobKDaeBmHtnJHqvbGqa",203,0.990291,33,206,2,204,1,2,1,3,2,103,102,102,102,7
"596",95,"[33]HIHoIEBGDIDFBxobKDaeBmHtnJHqvbGqa",213,0.990741,33,216,2,214,1,2,1,3,2,119,118,96,96,7
"597",96,"[33]HIHoIEBGDIDFBxobKDaeBmHtnJHqvbGqa",188,0.989529,33,191,2,189,1,2,1,3,2,83,82,107,107,7
"598",97,"[33]HIHoIEBGDIDFBxobKDaeBmHtnJHqvbGqa",208,0.990521,33,211,2,209,1,2,1,3,2,111,110,99,99,7
"599",98,"[33]HIHoIEBGDIDFBxobKDaeBmHtnJHqvbGqa",211,0.990654,33,214,2,212,1,2,1,3,2,114,113,99,99,7
"600",99,"[33]HIHoIEBGDIDFBxobKDaeBmHtnJHqvbGqa",211,0.990654,33,214,2,212,1,2,1,3,2,114,113,99,99,7
"601",0,"[40]AIhHoIpgFBkDlbKblJkviKbKDeeHtHunJHqvbGqa",193,0.989796,40,196,2,194,1,2,1,3,2,92,91,103,103,8
"602",1,"[40]AIhHoIpgFBkDlbKblJkviKbKDeeHtHunJHqvbGqa",209,0.990566,40,212,2,210,1,2,1,3,2,113,112,98,98,8
"603",2,"[40]AIhHoIpgFBkDlbKblJkviKbKDeeHtHunJHqvbGqa",210,0.99061,40,213,2,211,1,2,1,3,2,118,117,94,94,8
"604",3,"[40]AIhHoIpgFBkDlbKblJkviKbKDeeHtHunJHqvbGqa",201,0.990196,40,204,2,202,1,2,1,3,2,103,102,100,100,8
"605",4,"[40]AIhHoIpgFBkDlbKblJkviKbKDeeHtHunJHqvbGqa",205,0.990385,40,208,2,206,1,2,1,3,2,109,108,98,98,8
"606",5,"[40]AIhHoIpgFBkDlbKblJkviKbKDeeHtHunJHqvbGqa",194,0.989848,40,197,2,195,1,2,1,3,2,94,93,102,102,8
"607",6,"[40]AIhHoIpgFBkDlbKblJkviKbKDeeHtHunJHqvbGqa",199,0.990099,40,202,2,200,1,2,1,3,2,98,97,103,103,8
"608",7,"[40]AIhHoIpgFBkDlbKblJkviKbKDeeHtHunJHqvbGqa",204,0.990338,40,207,2,205,1,2,1,3,2,107,106,99,99,8
"609",8,"[40]AIhHoIpgFBkDlbKblJkviKbKDeeHtHunJHqvbGqa",210,0.99061,40,213,2,211,1,2,1,3,2,114,113,98,98,8
"610",9,"[40]AIhHoIpgFBkDlbKblJkviKbKDeeHtHunJHqvbGqa",211,0.990654,40,214,2,212,1,2,1,3,2,116,115,97,97,8
"611",10,"[40]AIhHoIpgFBkDlbKblJkviKbKDeeHtHunJHqvbGqa",213,0.990741,40,216,2,214,1,2,1,3,2,119,118,96,96,8
"612",11,"[40]AIhHoIpgFBkDlbKblJkviKbKDeeHtHunJHqvbGqa",206,0.990431,40,209,2,207,1,2,1,3,2,109,108,99,99,8
"613",12,"[40]AIhHoIpgFBkDlbKblJkviKbKDeeHtHunJHqvbGqa",189,0.989583,40,192,2,190,1,2,1,3,2,85,84,106,106,8
"614",13,"[40]AIhHoIpgFBkDlbKblJkviKbKDeeHtHunJHqvbGqa",197,0.99,40,200,2,198,1,2,1,3,2,96,95,103,103,8
"615",14,"[40]AIhHoIpgFBkDlbKblJkviKbKDeeHtHunJHqvbGqa",194,0.989848,40,197,2,195,1,2,1,3,2,92,91,104,104,8
"616",15,"[40]AIhHoIpgFBkDlbKblJkviKbKDeeHtHunJHqvbGqa",209,0.990566,40,212,2,210,1,2,1,3,2,110,109,101,101,8
"617",16,"[40]AIhHoIpgFBkDlbKblJkviKbKDeeHtHunJHqvbGqa",192,0.989744,40,195,2,193,1,2,1,3,2,89,88,105,105,8
"618",17,"[40]AIhHoIpgFBkDlbKblJkviKbKDeeHtHunJHqvbGqa",209,0.990566,40,212,2,210,1,2,1,3,2,115,114,96,96,8
"619",18,"[40]AIhHoIpgFBkDlbKblJkviKbKDeeHtHunJHqvbGqa",217,0.990909,40,220,2,218,1,2,1,3,2,127,126,92,92,8
"620",19,"[40]AIhHoIpgFBkDlbKblJkviKbKDeeHtHunJHqvbGqa",191,0.989691,40,194,2,192,1,2,1,3,2,87,86,106,106,8
"621",20,"[40]AIhHoIpgFBkDlbKblJkviKbKDeeHtHunJHqvbGqa",207,0.990476,40,210,2,208,1,2,1,3,2,109,108,100,100,8
"622",21,"[40]AIhHoIpgFBkDlbKblJkviKbKDeeHtHunJHqvbGqa",205,0.990385,40,208,2,206,1,2,1,3,2,109,108,98,98,8
"623",22,"[40]AIhHoIpgFBkDlbKblJkviKbKDeeHtHunJHqvbGqa",198,0.99005,40,201,2,199,1,2,1,3,2,96,95,104,104,8
"624",23,"[40]AIhHoIpgFBkDlbKblJkviKbKDeeHtHunJHqvbGqa",213,0.990741,40,216,2,214,1,2,1,3,2,118,117,97,97,8
"625",24,"[40]AIhHoIpgFBkDlbKblJkviKbKDeeHtHunJHqvbGqa",193,0.989796,40,196,2,194,1,2,1,3,2,93,92,102,102,8
"626",25,"[40]AIhHoIpgFBkDlbKblJkviKbKDeeHtHunJHqvbGqa",226,0.991266,40,229,2,227,1,2,1,3,2,135,134,93,93,8
"627",26,"[40]AIhHoIpgFBkDlbKblJkviKbKDeeHtHunJHqvbGqa",194,0.989848,40,197,2,195,1,2,1,3,2,93,92,103,103,8
"628",27,"[40]AIhHoIpgFBkDlbKblJkviKbKDeeHtHunJHqvbGqa",192,0.989744,40,195,2,193,1,2,1,3,2,89,88,105,105,8
"629",28,"[40]AIhHoIpgFBkDlbKblJkviKbKDeeHtHunJHqvbGqa",192,0.989744,40,195,2,193,1,2,1,3,2,90,89,104,104,8
"630",29,"[40]AIhHoIpgFBkDlbKblJkviKbKDeeHtHunJHqvbGqa",195,0.989899,40,198,2,196,1,2,1,3,2,95,94,102,102,8
"631",30,"[40]AIhHoIpgFBkDlbKblJkviKbKDeeHtHunJHqvbGqa",192,0.989744,40,195,2,193,1,2,1,3,2,92,91,102,102,8
"632",31,"[40]AIhHoIpgFBkDlbKblJkviKbKDeeHtHunJHqvbGqa",202,0.990244,40,205,2,203,1,2,1,3,2,104,103,100,100,8
"633",32,"[40]AIhHoIpgFBkDlbKblJkviKbKDeeHtHunJHqvbGqa",197,0.99,40,200,2,198,1,2,1,3,2,96,95,103,103,8
"634",33,"[40]AIhHoIpgFBkDlbKblJkviKbKDeeHtHunJHqvbGqa",212,0.990698,40,215,2,213,1,2,1,3,2,116,115,98,98,8
"635",34,"[40]AIhHoIpgFBkDlbKblJkviKbKDeeHtHunJHqvbGqa",193,0.989796,40,196,2,194,1,2,1,3,2,93,92,102,102,8
"636",35,"[40]AIhHoIpgFBkDlbKblJkviKbKDeeHtHunJHqvbGqa",197,0.99,40,200,2,198,1,2,1,3,2,99,98,100,100,8
"637",36,"[40]AIhHoIpgFBkDlbKblJkviKbKDeeHtHunJHqvbGqa",203,0.990291,40,206,2,204,1,2,1,3,2,106,105,99,99,8
"638",37,"[40]AIhHoIpgFBkDlbKblJkviKbKDeeHtHunJHqvbGqa",193,0.989796,40,196,2,194,1,2,1,3,2,90,89,105,105,8
"639",38,"[40]AIhHoIpgFBkDlbKblJkviKbKDeeHtHunJHqvbGqa",205,0.990385,40,208,2,206,1,2,1,3,2,108,107,99,99,8
"640",39,"[40]AIhHoIpgFBkDlbKblJkviKbKDeeHtHunJHqvbGqa",191,0.989691,40,194,2,192,1,2,1,3,2,89,88,104,104,8
"641",40,"[40]AIhHoIpgFBkDlbKblJkviKbKDeeHtHunJHqvbGqa",208,0.990521,40,211,2,209,1,2,1,3,2,109,108,101,101,8
"642",41,"[40]AIhHoIpgFBkDlbKblJkviKbKDeeHtHunJHqvbGqa",197,0.99,40,200,2,198,1,2,1,3,2,97,96,102,102,8
"643",42,"[40]AIhHoIpgFBkDlbKblJkviKbKDeeHtHunJHqvbGqa",215,0.990826,40,218,2,216,1,2,1,3,2,121,120,96,96,8
"644",43,"[40]AIhHoIpgFBkDlbKblJkviKbKDeeHtHunJHqvbGqa",204,0.990338,40,207,2,205,1,2,1,3,2,108,107,98,98,8
"645",44,"[40]AIhHoIpgFBkDlbKblJkviKbKDeeHtHunJHqvbGqa",199,0.990099,40,202,2,200,1,2,1,3,2,101,100,100,100,8
"646",45,"[40]AIhHoIpgFBkDlbKblJkviKbKDeeHtHunJHqvbGqa",200,0.990148,40,203,2,201,1,2,1,3,2,101,100,101,101,8
"647",46,"[40]AIhHoIpgFBkDlbKblJkviKbKDeeHtHunJHqvbGqa",206,0.990431,40,209,2,207,1,2,1,3,2,108,107,100,100,8
"648",47,"[40]AIhHoIpgFBkDlbKblJkviKbKDeeHtHunJHqvbGqa",205,0.990385,40,208,2,206,1,2,1,3,2,105,104,102,102,8
"649",48,"[40]AIhHoIpgFBkDlbKblJkviKbKDeeHtHunJHqvbGqa",211,0.990654,40,214,2,212,1,2,1,3,2,117,116,96,96,8
"650",49,"[40]AIhHoIpgFBkDlbKblJkviKbKDeeHtHunJHqvbGqa",200,0.990148,40,203,2,201,1,2,1,3,2,99,98,103,103,8
"651",50,"[40]AIhHoIpgFBkDlbKblJkviKbKDeeHtHunJHqvbGqa",209,0.990566,40,212,2,210,1,2,1,3,2,112,111,99,99,8
"652",51,"[40]AIhHoIpgFBkDlbKblJkviKbKDeeHtHunJHqvbGqa",209,0.990566,40,212,2,210,1,2,1,3,2,112,111,99,99,8
"653",52,"[40]AIhHoIpgFBkDlbKblJkviKbKDeeHtHunJHqvbGqa",202,0.990244,40,205,2,203,1,2,1,3,2,103,102,101,101,8
"654",53,"[40]AIhHoIpgFBkDlbKblJkviKbKDeeHtHunJHqvbGqa",196,0.98995,40,199,2,197,1,2,1,3,2,97,96,101,101,8
"655",54,"[40]AIhHoIpgFBkDlbKblJkviKbKDeeHtHunJHqvbGqa",213,0.990741,40,216,2,214,1,2,1,3,2,117,116,98,98,8
"656",55,"[40]AIhHoIpgFBkDlbKblJkviKbKDeeHtHunJHqvbGqa",212,0.990698,40,215,2,213,1,2,1,3,2,116,115,98,98,8
"657",56,"[40]AIhHoIpgFBkDlbKblJkviKbKDeeHtHunJHqvbGqa",197,0.99,40,200,2,198,1,2,1,3,2,96,95,103,103,8
"658",57,"[40]AIhHoIpgFBkDlbKblJkviKbKDeeHtHunJHqvbGqa",198,0.99005,40,201,2,199,1,2,1,3,2,97,96,103,103,8
"659",58,"[40]AIhHoIpgFBkDlbKblJkviKbKDeeHtHunJHqvbGqa",205,0.990385,40,208,2,206,1,2,1,3,2,107,106,100,100,8
"660",59,"[40]AIhHoIpgFBkDlbKblJkviKbKDeeHtHunJHqvbGqa",212,0.990698,40,215,2,213,1,2,1,3,2,120,119,94,94,8
"661",60,"[40]AIhHoIpgFBkDlbKblJkviKbKDeeHtHunJHqvbGqa",196,0.98995,40,199,2,197,1,2,1,3,2,97,96,101,101,8
"662",61,"[40]AIhHoIpgFBkDlbKblJkviKbKDeeHtHunJHqvbGqa",207,0.990476,40,210,2,208,1,2,1,3,2,110,109,99,99,8
"663",62,"[40]AIhHoIpgFBkDlbKblJkviKbKDeeHtHunJHqvbGqa",190,0.989637,40,193,2,191,1,2,1,3,2,87,86,105,105,8
"664",63,"[40]AIhHoIpgFBkDlbKblJkviKbKDeeHtHunJHqvbGqa",214,0.990783,40,217,2,215,1,2,1,3,2,119,118,97,97,8
"665",64,"[40]AIhHoIpgFBkDlbKblJkviKbKDeeHtHunJHqvbGqa",185,0.989362,40,188,2,186,1,2,1,3,2,78,77,109,109,8
"666",65,"[40]AIhHoIpgFBkDlbKblJkviKbKDeeHtHunJHqvbGqa",213,0.990741,40,216,2,214,1,2,1,3,2,119,118,96,96,8
"667",66,"[40]AIhHoIpgFBkDlbKblJkviKbKDeeHtHunJHqvbGqa",203,0.990291,40,206,2,204,1,2,1,3,2,103,102,102,102,8
"668",67,"[40]AIhHoIpgFBkDlbKblJkviKbKDeeHtHunJHqvbGqa",200,0.990148,40,203,2,201,1,2,1,3,2,102,101,100,100,8
"669",68,"[40]AIhHoIpgFBkDlbKblJkviKbKDeeHtHunJHqvbGqa",204,0.990338,40,207,2,205,1,2,1,3,2,107,106,99,99,8
"670",69,"[40]AIhHoIpgFBkDlbKblJkviKbKDeeHtHunJHqvbGqa",202,0.990244,40,205,2,203,1,2,1,3,2,107,106,97,97,8
"671",70,"[40]AIhHoIpgFBkDlbKblJkviKbKDeeHtHunJHqvbGqa",186,0.989418,40,189,2,187,1,2,1,3,2,80,79,108,108,8
"672",71,"[40]AIhHoIpgFBkDlbKblJkviKbKDeeHtHunJHqvbGqa",195,0.989899,40,198,2,196,1,2,1,3,2,93,92,104,104,8
"673",72,"[40]AIhHoIpgFBkDlbKblJkviKbKDeeHtHunJHqvbGqa",200,0.990148,40,203,2,201,1,2,1,3,2,98,97,104,104,8
"674",73,"[40]AIhHoIpgFBkDlbKblJkviKbKDeeHtHunJHqvbGqa",218,0.99095,40,221,2,219,1,2,1,3,2,126,125,94,94,8
"675",74,"[40]AIhHoIpgFBkDlbKblJkviKbKDeeHtHunJHqvbGqa",208,0.990521,40,211,2,209,1,2,1,3,2,110,109,100,100,8
"676",75,"[40]AIhHoIpgFBkDlbKblJkviKbKDeeHtHunJHqvbGqa",210,0.99061,40,213,2,211,1,2,1,3,2,114,113,98,98,8
"677",76,"[40]AIhHoIpgFBkDlbKblJkviKbKDeeHtHunJHqvbGqa",188,0.989529,40,191,2,189,1,2,1,3,2,84,83,106,106,8
"678",77,"[40]AIhHoIpgFBkDlbKblJkviKbKDeeHtHunJHqvbGqa",198,0.99005,40,201,2,199,1,2,1,3,2,98,97,102,102,8
"679",78,"[40]AIhHoIpgFBkDlbKblJkviKbKDeeHtHunJHqvbGqa",199,0.990099,40,202,2,200,1,2,1,3,2,102,101,99,99,8
"680",79,"[40]AIhHoIpgFBkDlbKblJkviKbKDeeHtHunJHqvbGqa",191,0.989691,40,194,2,192,1,2,1,3,2,88,87,105,105,8
"681",80,"[40]AIhHoIpgFBkDlbKblJkviKbKDeeHtHunJHqvbGqa",197,0.99,40,200,2,198,1,2,1,3,2,98,97,101,101,8
"682",81,"[40]AIhHoIpgFBkDlbKblJkviKbKDeeHtHunJHqvbGqa",207,0.990476,40,210,2,208,1,2,1,3,2,111,110,98,98,8
"683",82,"[40]AIhHoIpgFBkDlbKblJkviKbKDeeHtHunJHqvbGqa",209,0.990566,40,212,2,210,1,2,1,3,2,113,112,98,98,8
"684",83,"[40]AIhHoIpgFBkDlbKblJkviKbKDeeHtHunJHqvbGqa",199,0.990099,40,202,2,200,1,2,1,3,2,100,99,101,101,8
"685",84,"[40]AIhHoIpgFBkDlbKblJkviKbKDeeHtHunJHqvbGqa",189,0.989583,40,192,2,190,1,2,1,3,2,85,84,106,106,8
"686",85,"[40]AIhHoIpgFBkDlbKblJkviKbKDeeHtHunJHqvbGqa",206,0.990431,40,209,2,207,1,2,1,3,2,110,109,98,98,8
"687",86,"[40]AIhHoIpgFBkDlbKblJkviKbKDeeHtHunJHqvbGqa",205,0.990385,40,208,2,206,1,2,1,3,2,108,107,99,99,8
"688",87,"[40]AIhHoIpgFBkDlbKblJkviKbKDeeHtHunJHqvbGqa",205,0.990385,40,208,2,206,1,2,1,3,2,108,107,99,99,8
"689",88,"[40]AIhHoIpgFBkDlbKblJkviKbKDeeHtHunJHqvbGqa",202,0.990244,40,205,2,203,1,2,1,3,2,105,104,99,99,8
"690",89,"[40]AIhHoIpgFBkDlbKblJkviKbKDeeHtHunJHqvbGqa",196,0.98995,40,199,2,197,1,2,1,3,2,94,93,104,104,8
"691",90,"[40]AIhHoIpgFBkDlbKblJkviKbKDeeHtHunJHqvbGqa",192,0.989744,40,195,2,193,1,2,1,3,2,91,90,103,103,8
"692",91,"[40]AIhHoIpgFBkDlbKblJkviKbKDeeHtHunJHqvbGqa",206,0.990431,40,209,2,207,1,2,1,3,2,109,108,99,99,8
"693",92,"[40]AIhHoIpgFBkDlbKblJkviKbKDeeHtHunJHqvbGqa",183,0.989247,40,186,2,184,1,2,1,3,2,80,79,105,105,8
"694",93,"[40]AIhHoIpgFBkDlbKblJkviKbKDeeHtHunJHqvbGqa",208,0.990521,40,211,2,209,1,2,1,3,2,111,110,99,99,8
"695",94,"[40]AIhHoIpgFBkDlbKblJkviKbKDeeHtHunJHqvbGqa",195,0.989899,40,198,2,196,1,2,1,3,2,96,95,101,101,8
"696",95,"[40]AIhHoIpgFBkDlbKblJkviKbKDeeHtHunJHqvbGqa",210,0.99061,40,213,2,211,1,2,1,3,2,115,114,97,97,8
"697",96,"[40]AIhHoIpgFBkDlbKblJkviKbKDeeHtHunJHqvbGqa",206,0.990431,40,209,2,207,1,2,1,3,2,107,106,101,101,8
"698",97,"[40]AIhHoIpgFBkDlbKblJkviKbKDeeHtHunJHqvbGqa",193,0.989796,40,196,2,194,1,2,1,3,2,93,92,102,102,8
"699",98,"[40]AIhHoIpgFBkDlbKblJkviKbKDeeHtHunJHqvbGqa",217,0.990909,40,220,2,218,1,2,1,3,2,123,122,96,96,8
"700",99,"[40]AIhHoIpgFBkDlbKblJkviKbKDeeHtHunJHqvbGqa",205,0.990385,40,208,2,206,1,2,1,3,2,108,107,99,99,8
"701",0,"[37]hIHHoIGEBDwBBotEvcvbgpeeeKHsnJHqveGqa",225,0.991228,37,228,2,226,1,2,1,3,2,123,122,104,104,9
"702",1,"[37]hIHHoIGEBDwBBotEvcvbgpeeeKHsnJHqveGqa",210,0.99061,37,213,2,211,1,2,1,3,2,102,101,110,110,9
"703",2,"[37]hIHHoIGEBDwBBotEvcvbgpeeeKHsnJHqveGqa",202,0.990244,37,205,2,203,1,2,1,3,2,90,89,114,114,9
"704",3,"[37]hIHHoIGEBDwBBotEvcvbgpeeeKHsnJHqveGqa",224,0.991189,37,227,2,225,1,2,1,3,2,122,121,104,104,9
"705",4,"[37]hIHHoIGEBDwBBotEvcvbgpeeeKHsnJHqveGqa",213,0.990741,37,216,2,214,1,2,1,3,2,106,105,109,109,9
"706",5,"[37]hIHHoIGEBDwBBotEvcvbgpeeeKHsnJHqveGqa",209,0.990566,37,212,2,210,1,2,1,3,2,100,99,111,111,9
"707",6,"[37]hIHHoIGEBDwBBotEvcvbgpeeeKHsnJHqveGqa",207,0.990476,37,210,2,208,1,2,1,3,2,96,95,113,113,9
"708",7,"[37]hIHHoIGEBDwBBotEvcvbgpeeeKHsnJHqveGqa",234,0.991561,37,237,2,235,1,2,1,3,2,135,134,101,101,9
"709",8,"[37]hIHHoIGEBDwBBotEvcvbgpeeeKHsnJHqveGqa",218,0.99095,37,221,2,219,1,2,1,3,2,116,115,104,104,9
"710",9,"[37]hIHHoIGEBDwBBotEvcvbgpeeeKHsnJHqveGqa",208,0.990521,37,211,2,209,1,2,1,3,2,97,96,113,113,9
"711",10,"[37]hIHHoIGEBDwBBotEvcvbgpeeeKHsnJHqveGqa",202,0.990244,37,205,2,203,1,2,1,3,2,92,91,112,112,9
"712",11,"[37]hIHHoIGEBDwBBotEvcvbgpeeeKHsnJHqveGqa",210,0.99061,37,213,2,211,1,2,1,3,2,102,101,110,110,9
"713",12,"[37]hIHHoIGEBDwBBotEvcvbgpeeeKHsnJHqveGqa",210,0.99061,37,213,2,211,1,2,1,3,2,105,104,107,107,9
"714",13,"[37]hIHHoIGEBDwBBotEvcvbgpeeeKHsnJHqveGqa",231,0.991453,37,234,2,232,1,2,1,3,2,129,128,104,104,9
"715",14,"[37]hIHHoIGEBDwBBotEvcvbgpeeeKHsnJHqveGqa",198,0.99005,37,201,2,199,1,2,1,3,2,84,83,116,116,9
"716",15,"[37]hIHHoIGEBDwBBotEvcvbgpeeeKHsnJHqveGqa",234,0.991561,37,237,2,235,1,2,1,3,2,136,135,100,100,9
"717",16,"[37]hIHHoIGEBDwBBotEvcvbgpeeeKHsnJHqveGqa",193,0.989796,37,196,2,194,1,2,1,3,2,76,75,119,119,9
"718",17,"[37]hIHHoIGEBDwBBotEvcvbgpeeeKHsnJHqveGqa",233,0.991525,37,236,2,234,1,2,1,3,2,134,133,101,101,9
"719",18,"[37]hIHHoIGEBDwBBotEvcvbgpeeeKHsnJHqveGqa",219,0.990991,37,222,2,220,1,2,1,3,2,119,118,102,102,9
"720",19,"[37]hIHHoIGEBDwBBotEvcvbgpeeeKHsnJHqveGqa",213,0.990741,37,216,2,214,1,2,1,3,2,105,104,110,110,9
"721",20,"[37]hIHHoIGEBDwBBotEvcvbgpeeeKHsnJHqveGqa",211,0.990654,37,214,2,212,1,2,1,3,2,105,104,108,108,9
"722",21,"[37]hIHHoIGEBDwBBotEvcvbgpeeeKHsnJHqveGqa",224,0.991189,37,227,2,225,1,2,1,3,2,122,121,104,104,9
"723",22,"[37]hIHHoIGEBDwBBotEvcvbgpeeeKHsnJHqveGqa",214,0.990783,37,217,2,215,1,2,1,3,2,107,106,109,109,9
"724",23,"[37]hIHHoIGEBDwBBotEvcvbgpeeeKHsnJHqveGqa",212,0.990698,37,215,2,213,1,2,1,3,2,108,107,106,106,9
"725",24,"[37]hIHHoIGEBDwBBotEvcvbgpeeeKHsnJHqveGqa",206,0.990431,37,209,2,207,1,2,1,3,2,96,95,112,112,9
"726",25,"[37]hIHHoIGEBDwBBotEvcvbgpeeeKHsnJHqveGqa",226,0.991266,37,229,2,227,1,2,1,3,2,126,125,102,102,9
"727",26,"[37]hIHHoIGEBDwBBotEvcvbgpeeeKHsnJHqveGqa",216,0.990868,37,219,2,217,1,2,1,3,2,112,111,106,106,9
"728",27,"[37]hIHHoIGEBDwBBotEvcvbgpeeeKHsnJHqveGqa",210,0.99061,37,213,2,211,1,2,1,3,2,103,102,109,109,9
"729",28,"[37]hIHHoIGEBDwBBotEvcvbgpeeeKHsnJHqveGqa",224,0.991189,37,227,2,225,1,2,1,3,2,124,123,102,102,9
"730",29,"[37]hIHHoIGEBDwBBotEvcvbgpeeeKHsnJHqveGqa",211,0.990654,37,214,2,212,1,2,1,3,2,104,103,109,109,9
"731",30,"[37]hIHHoIGEBDwBBotEvcvbgpeeeKHsnJHqveGqa",202,0.990244,37,205,2,203,1,2,1,3,2,91,90,113,113,9
"732",31,"[37]hIHHoIGEBDwBBotEvcvbgpeeeKHsnJHqveGqa",214,0.990783,37,217,2,215,1,2,1,3,2,106,105,110,110,9
"733",32,"[37]hIHHoIGEBDwBBotEvcvbgpeeeKHsnJHqveGqa",218,0.99095,37,221,2,219,1,2,1,3,2,110,109,110,110,9
"734",33,"[37]hIHHoIGEBDwBBotEvcvbgpeeeKHsnJHqveGqa",215,0.990826,37,218,2,216,1,2,1,3,2,106,105,111,111,9
"735",34,"[37]hIHHoIGEBDwBBotEvcvbgpeeeKHsnJHqveGqa",224,0.991189,37,227,2,225,1,2,1,3,2,123,122,103,103,9
"736",35,"[37]hIHHoIGEBDwBBotEvcvbgpeeeKHsnJHqveGqa",220,0.991031,37,223,2,221,1,2,1,3,2,116,115,106,106,9
"737",36,"[37]hIHHoIGEBDwBBotEvcvbgpeeeKHsnJHqveGqa",213,0.990741,37,216,2,214,1,2,1,3,2,106,105,109,109,9
"738",37,"[37]hIHHoIGEBDwBBotEvcvbgpeeeKHsnJHqveGqa",225,0.991228,37,228,2,226,1,2,1,3,2,122,121,105,105,9
"739",38,"[37]hIHHoIGEBDwBBotEvcvbgpeeeKHsnJHqveGqa",214,0.990783,37,217,2,215,1,2,1,3,2,108,107,108,108,9
"740",39,"[37]hIHHoIGEBDwBBotEvcvbgpeeeKHsnJHqveGqa",209,0.990566,37,212,2,210,1,2,1,3,2,102,101,109,109,9
"741",40,"[37]hIHHoIGEBDwBBotEvcvbgpeeeKHsnJHqveGqa",224,0.991189,37,227,2,225,1,2,1,3,2,121,120,105,105,9
"742",41,"[37]hIHHoIGEBDwBBotEvcvbgpeeeKHsnJHqveGqa",232,0.991489,37,235,2,233,1,2,1,3,2,135,134,99,99,9
"743",42,"[37]hIHHoIGEBDwBBotEvcvbgpeeeKHsnJHqveGqa",219,0.990991,37,222,2,220,1,2,1,3,2,116,115,105,105,9
"744",43,"[37]hIHHoIGEBDwBBotEvcvbgpeeeKHsnJHqveGqa",220,0.991031,37,223,2,221,1,2,1,3,2,114,113,108,108,9
"745",44,"[37]hIHHoIGEBDwBBotEvcvbgpeeeKHsnJHqveGqa",221,0.991071,37,224,2,222,1,2,1,3,2,116,115,107,107,9
"746",45,"[37]hIHHoIGEBDwBBotEvcvbgpeeeKHsnJHqveGqa",217,0.990909,37,220,2,218,1,2,1,3,2,114,113,105,105,9
"747",46,"[37]hIHHoIGEBDwBBotEvcvbgpeeeKHsnJHqveGqa",218,0.99095,37,221,2,219,1,2,1,3,2,114,113,106,106,9
"748",47,"[37]hIHHoIGEBDwBBotEvcvbgpeeeKHsnJHqveGqa",223,0.99115,37,226,2,224,1,2,1,3,2,119,118,106,106,9
"749",48,"[37]hIHHoIGEBDwBBotEvcvbgpeeeKHsnJHqveGqa",214,0.990783,37,217,2,215,1,2,1,3,2,109,108,107,107,9
"750",49,"[37]hIHHoIGEBDwBBotEvcvbgpeeeKHsnJHqveGqa",217,0.990909,37,220,2,218,1,2,1,3,2,109,108,110,110,9
"751",50,"[37]hIHHoIGEBDwBBotEvcvbgpeeeKHsnJHqveGqa",216,0.990868,37,219,2,217,1,2,1,3,2,111,110,107,107,9
"752",51,"[37]hIHHoIGEBDwBBotEvcvbgpeeeKHsnJHqveGqa",210,0.99061,37,213,2,211,1,2,1,3,2,101,100,111,111,9
"753",52,"[37]hIHHoIGEBDwBBotEvcvbgpeeeKHsnJHqveGqa",206,0.990431,37,209,2,207,1,2,1,3,2,95,94,113,113,9
"754",53,"[37]hIHHoIGEBDwBBotEvcvbgpeeeKHsnJHqveGqa",216,0.990868,37,219,2,217,1,2,1,3,2,111,110,107,107,9
"755",54,"[37]hIHHoIGEBDwBBotEvcvbgpeeeKHsnJHqveGqa",214,0.990783,37,217,2,215,1,2,1,3,2,106,105,110,110,9
"756",55,"[37]hIHHoIGEBDwBBotEvcvbgpeeeKHsnJHqveGqa",217,0.990909,37,220,2,218,1,2,1,3,2,114,113,105,105,9
"757",56,"[37]hIHHoIGEBDwBBotEvcvbgpeeeKHsnJHqveGqa",214,0.990783,37,217,2,215,1,2,1,3,2,108,107,108,108,9
"758",57,"[37]hIHHoIGEBDwBBotEvcvbgpeeeKHsnJHqveGqa",228,0.991342,37,231,2,229,1,2,1,3,2,126,125,104,104,9
"759",58,"[37]hIHHoIGEBDwBBotEvcvbgpeeeKHsnJHqveGqa",214,0.990783,37,217,2,215,1,2,1,3,2,106,105,110,110,9
"760",59,"[37]hIHHoIGEBDwBBotEvcvbgpeeeKHsnJHqveGqa",208,0.990521,37,211,2,209,1,2,1,3,2,100,99,110,110,9
"761",60,"[37]hIHHoIGEBDwBBotEvcvbgpeeeKHsnJHqveGqa",223,0.99115,37,226,2,224,1,2,1,3,2,121,120,104,104,9
"762",61,"[37]hIHHoIGEBDwBBotEvcvbgpeeeKHsnJHqveGqa",224,0.991189,37,227,2,225,1,2,1,3,2,121,120,105,105,9
"763",62,"[37]hIHHoIGEBDwBBotEvcvbgpeeeKHsnJHqveGqa",224,0.991189,37,227,2,225,1,2,1,3,2,124,123,102,102,9
"764",63,"[37]hIHHoIGEBDwBBotEvcvbgpeeeKHsnJHqveGqa",224,0.991189,37,227,2,225,1,2,1,3,2,121,120,105,105,9
"765",64,"[37]hIHHoIGEBDwBBotEvcvbgpeeeKHsnJHqveGqa",209,0.990566,37,212,2,210,1,2,1,3,2,101,100,110,110,9
"766",65,"[37]hIHHoIGEBDwBBotEvcvbgpeeeKHsnJHqveGqa",212,0.990698,37,215,2,213,1,2,1,3,2,105,104,109,109,9
"767",66,"[37]hIHHoIGEBDwBBotEvcvbgpeeeKHsnJHqveGqa",202,0.990244,37,205,2,203,1,2,1,3,2,91,90,113,113,9
"768",67,"[37]hIHHoIGEBDwBBotEvcvbgpeeeKHsnJHqveGqa",211,0.990654,37,214,2,212,1,2,1,3,2,104,103,109,109,9
"769",68,"[37]hIHHoIGEBDwBBotEvcvbgpeeeKHsnJHqveGqa",212,0.990698,37,215,2,213,1,2,1,3,2,101,100,113,113,9
"770",69,"[37]hIHHoIGEBDwBBotEvcvbgpeeeKHsnJHqveGqa",217,0.990909,37,220,2,218,1,2,1,3,2,110,109,109,109,9
"771",70,"[37]hIHHoIGEBDwBBotEvcvbgpeeeKHsnJHqveGqa",217,0.990909,37,220,2,218,1,2,1,3,2,114,113,105,105,9
"772",71,"[37]hIHHoIGEBDwBBotEvcvbgpeeeKHsnJHqveGqa",220,0.991031,37,223,2,221,1,2,1,3,2,115,114,107,107,9
"773",72,"[37]hIHHoIGEBDwBBotEvcvbgpeeeKHsnJHqveGqa",221,0.991071,37,224,2,222,1,2,1,3,2,120,119,103,103,9
"774",73,"[37]hIHHoIGEBDwBBotEvcvbgpeeeKHsnJHqveGqa",226,0.991266,37,229,2,227,1,2,1,3,2,123,122,105,105,9
"775",74,"[37]hIHHoIGEBDwBBotEvcvbgpeeeKHsnJHqveGqa",220,0.991031,37,223,2,221,1,2,1,3,2,114,113,108,108,9
"776",75,"[37]hIHHoIGEBDwBBotEvcvbgpeeeKHsnJHqveGqa",208,0.990521,37,211,2,209,1,2,1,3,2,99,98,111,111,9
"777",76,"[37]hIHHoIGEBDwBBotEvcvbgpeeeKHsnJHqveGqa",217,0.990909,37,220,2,218,1,2,1,3,2,111,110,108,108,9
"778",77,"[37]hIHHoIGEBDwBBotEvcvbgpeeeKHsnJHqveGqa",224,0.991189,37,227,2,225,1,2,1,3,2,121,120,105,105,9
"779",78,"[37]hIHHoIGEBDwBBotEvcvbgpeeeKHsnJHqveGqa",204,0.990338,37,207,2,205,1,2,1,3,2,95,94,111,111,9
"780",79,"[37]hIHHoIGEBDwBBotEvcvbgpeeeKHsnJHqveGqa",227,0.991304,37,230,2,228,1,2,1,3,2,127,126,102,102,9
"781",80,"[37]hIHHoIGEBDwBBotEvcvbgpeeeKHsnJHqveGqa",219,0.990991,37,222,2,220,1,2,1,3,2,117,116,104,104,9
"782",81,"[37]hIHHoIGEBDwBBotEvcvbgpeeeKHsnJHqveGqa",204,0.990338,37,207,2,205,1,2,1,3,2,92,91,114,114,9
"783",82,"[37]hIHHoIGEBDwBBotEvcvbgpeeeKHsnJHqveGqa",212,0.990698,37,215,2,213,1,2,1,3,2,104,103,110,110,9
"784",83,"[37]hIHHoIGEBDwBBotEvcvbgpeeeKHsnJHqveGqa",221,0.991071,37,224,2,222,1,2,1,3,2,121,120,102,102,9
"785",84,"[37]hIHHoIGEBDwBBotEvcvbgpeeeKHsnJHqveGqa",209,0.990566,37,212,2,210,1,2,1,3,2,101,100,110,110,9
"786",85,"[37]hIHHoIGEBDwBBotEvcvbgpeeeKHsnJHqveGqa",218,0.99095,37,221,2,219,1,2,1,3,2,110,109,110,110,9
"787",86,"[37]hIHHoIGEBDwBBotEvcvbgpeeeKHsnJHqveGqa",226,0.991266,37,229,2,227,1,2,1,3,2,125,124,103,103,9
"788",87,"[37]hIHHoIGEBDwBBotEvcvbgpeeeKHsnJHqveGqa",217,0.990909,37,220,2,218,1,2,1,3,2,112,111,107,107,9
"789",88,"[37]hIHHoIGEBDwBBotEvcvbgpeeeKHsnJHqveGqa",218,0.99095,37,221,2,219,1,2,1,3,2,112,111,108,108,9
"790",89,"[37]hIHHoIGEBDwBBotEvcvbgpeeeKHsnJHqveGqa",229,0.991379,37,232,2,230,1,2,1,3,2,128,127,103,103,9
"791",90,"[37]hIHHoIGEBDwBBotEvcvbgpeeeKHsnJHqveGqa",220,0.991031,37,223,2,221,1,2,1,3,2,119,118,103,103,9
"792",91,"[37]hIHHoIGEBDwBBotEvcvbgpeeeKHsnJHqveGqa",220,0.991031,37,223,2,221,1,2,1,3,2,114,113,108,108,9
"793",92,"[37]hIHHoIGEBDwBBotEvcvbgpeeeKHsnJHqveGqa",227,0.991304,37,230,2,228,1,2,1,3,2,126,125,103,103,9
"794",93,"[37]hIHHoIGEBDwBBotEvcvbgpeeeKHsnJHqveGqa",223,0.99115,37,226,2,224,1,2,1,3,2,121,120,104,104,9
"795",94,"[37]hIHHoIGEBDwBBotEvcvbgpeeeKHsnJHqveGqa",218,0.99095,37,221,2,219,1,2,1,3,2,114,113,106,106,9
"796",95,"[37]hIHHoIGEBDwBBotEvcvbgpeeeKHsnJHqveGqa",213,0.990741,37,216,2,214,1,2,1,3,2,103,102,112,112,9
"797",96,"[37]hIHHoIGEBDwBBotEvcvbgpeeeKHsnJHqveGqa",227,0.991304,37,230,2,228,1,2,1,3,2,126,125,103,103,9
"798",97,"[37]hIHHoIGEBDwBBotEvcvbgpeeeKHsnJHqveGqa",223,0.99115,37,226,2,224,1,2,1,3,2,119,118,106,106,9
"799",98,"[37]hIHHoIGEBDwBBotEvcvbgpeeeKHsnJHqveGqa",210,0.99061,37,213,2,211,1,2,1,3,2,104,103,108,108,9
"800",99,"[37]hIHHoIGEBDwBBotEvcvbgpeeeKHsnJHqveGqa",210,0.99061,37,213,2,211,1,2,1,3,2,101,100,111,111,9
"801",0,"[40]uIhHoIfdxBkADjEtlhyKopbKDaefhHunJHqvbGqa",207,0.990476,40,210,2,208,1,2,1,3,2,112,111,97,97,10
"802",1,"[40]uIhHoIfdxBkADjEtlhyKopbKDaefhHunJHqvbGqa",208,0.990521,40,211,2,209,1,2,1,3,2,114,113,96,96,10
"803",2,"[40]uIhHoIfdxBkADjEtlhyKopbKDaefhHunJHqvbGqa",204,0.990338,40,207,2,205,1,2,1,3,2,106,105,100,100,10
"804",3,"[40]uIhHoIfdxBkADjEtlhyKopbKDaefhHunJHqvbGqa",201,0.990196,40,204,2,202,1,2,1,3,2,103,102,100,100,10
"805",4,"[40]uIhHoIfdxBkADjEtlhyKopbKDaefhHunJHqvbGqa",193,0.989796,40,196,2,194,1,2,1,3,2,90,89,105,105,10
"806",5,"[40]uIhHoIfdxBkADjEtlhyKopbKDaefhHunJHqvbGqa",211,0.990654,40,214,2,212,1,2,1,3,2,115,114,98,98,10
"807",6,"[40]uIhHoIfdxBkADjEtlhyKopbKDaefhHunJHqvbGqa",205,0.990385,40,208,2,206,1,2,1,3,2,106,105,101,101,10
"808",7,"[40]uIhHoIfdxBkADjEtlhyKopbKDaefhHunJHqvbGqa",212,0.990698,40,215,2,213,1,2,1,3,2,117,116,97,97,10
"809",8,"[40]uIhHoIfdxBkADjEtlhyKopbKDaefhHunJHqvbGqa",192,0.989744,40,195,2,193,1,2,1,3,2,91,90,103,103,10
"810",9,"[40]uIhHoIfdxBkADjEtlhyKopbKDaefhHunJHqvbGqa",190,0.989637,40,193,2,191,1,2,1,3,2,85,84,107,107,10
"811",10,"[40]uIhHoIfdxBkADjEtlhyKopbKDaefhHunJHqvbGqa",187,0.989474,40,190,2,188,1,2,1,3,2,85,84,104,104,10
"812",11,"[40]uIhHoIfdxBkADjEtlhyKopbKDaefhHunJHqvbGqa",211,0.990654,40,214,2,212,1,2,1,3,2,115,114,98,98,10
"813",12,"[40]uIhHoIfdxBkADjEtlhyKopbKDaefhHunJHqvbGqa",202,0.990244,40,205,2,203,1,2,1,3,2,103,102,101,101,10
"814",13,"[40]uIhHoIfdxBkADjEtlhyKopbKDaefhHunJHqvbGqa",216,0.990868,40,219,2,217,1,2,1,3,2,124,123,94,94,10
"815",14,"[40]uIhHoIfdxBkADjEtlhyKopbKDaefhHunJHqvbGqa",211,0.990654,40,214,2,212,1,2,1,3,2,118,117,95,95,10
"816",15,"[40]uIhHoIfdxBkADjEtlhyKopbKDaefhHunJHqvbGqa",198,0.99005,40,201,2,199,1,2,1,3,2,99,98,101,101,10
"817",16,"[40]uIhHoIfdxBkADjEtlhyKopbKDaefhHunJHqvbGqa",215,0.990826,40,218,2,216,1,2,1,3,2,124,123,93,93,10
"818",17,"[40]uIhHoIfdxBkADjEtlhyKopbKDaefhHunJHqvbGqa",192,0.989744,40,195,2,193,1,2,1,3,2,91,90,103,103,10
"819",18,"[40]uIhHoIfdxBkADjEtlhyKopbKDaefhHunJHqvbGqa",224,0.991189,40,227,2,225,1,2,1,3,2,134,133,92,92,10
"820",19,"[40]uIhHoIfdxBkADjEtlhyKopbKDaefhHunJHqvbGqa",200,0.990148,40,203,2,201,1,2,1,3,2,100,99,102,102,10
"821",20,"[40]uIhHoIfdxBkADjEtlhyKopbKDaefhHunJHqvbGqa",209,0.990566,40,212,2,210,1,2,1,3,2,113,112,98,98,10
"822",21,"[40]uIhHoIfdxBkADjEtlhyKopbKDaefhHunJHqvbGqa",213,0.990741,40,216,2,214,1,2,1,3,2,119,118,96,96,10
"823",22,"[40]uIhHoIfdxBkADjEtlhyKopbKDaefhHunJHqvbGqa",196,0.98995,40,199,2,197,1,2,1,3,2,95,94,103,103,10
"824",23,"[40]uIhHoIfdxBkADjEtlhyKopbKDaefhHunJHqvbGqa",202,0.990244,40,205,2,203,1,2,1,3,2,104,103,100,100,10
"825",24,"[40]uIhHoIfdxBkADjEtlhyKopbKDaefhHunJHqvbGqa",210,0.99061,40,213,2,211,1,2,1,3,2,115,114,97,97,10
"826",25,"[40]uIhHoIfdxBkADjEtlhyKopbKDaefhHunJHqvbGqa",207,0.990476,40,210,2,208,1,2,1,3,2,111,110,98,98,10
"827",26,"[40]uIhHoIfdxBkADjEtlhyKopbKDaefhHunJHqvbGqa",206,0.990431,40,209,2,207,1,2,1,3,2,108,107,100,100,10
"828",27,"[40]uIhHoIfdxBkADjEtlhyKopbKDaefhHunJHqvbGqa",192,0.989744,40,195,2,193,1,2,1,3,2,91,90,103,103,10
"829",28,"[40]uIhHoIfdxBkADjEtlhyKopbKDaefhHunJHqvbGqa",188,0.989529,40,191,2,189,1,2,1,3,2,83,82,107,107,10
"830",29,"[40]uIhHoIfdxBkADjEtlhyKopbKDaefhHunJHqvbGqa",211,0.990654,40,214,2,212,1,2,1,3,2,117,116,96,96,10
"831",30,"[40]uIhHoIfdxBkADjEtlhyKopbKDaefhHunJHqvbGqa",194,0.989848,40,197,2,195,1,2,1,3,2,92,91,104,104,10
"832",31,"[40]uIhHoIfdxBkADjEtlhyKopbKDaefhHunJHqvbGqa",185,0.989362,40,188,2,186,1,2,1,3,2,82,81,105,105,10
"833",32,"[40]uIhHoIfdxBkADjEtlhyKopbKDaefhHunJHqvbGqa",204,0.990338,40,207,2,205,1,2,1,3,2,108,107,98,98,10
"834",33,"[40]uIhHoIfdxBkADjEtlhyKopbKDaefhHunJHqvbGqa",206,0.990431,40,209,2,207,1,2,1,3,2,109,108,99,99,10
"835",34,"[40]uIhHoIfdxBkADjEtlhyKopbKDaefhHunJHqvbGqa",195,0.989899,40,198,2,196,1,2,1,3,2,91,90,106,106,10
"836",35,"[40]uIhHoIfdxBkADjEtlhyKopbKDaefhHunJHqvbGqa",206,0.990431,40,209,2,207,1,2,1,3,2,111,110,97,97,10
"837",36,"[40]uIhHoIfdxBkADjEtlhyKopbKDaefhHunJHqvbGqa",203,0.990291,40,206,2,204,1,2,1,3,2,103,102,102,102,10
"838",37,"[40]uIhHoIfdxBkADjEtlhyKopbKDaefhHunJHqvbGqa",201,0.990196,40,204,2,202,1,2,1,3,2,104,103,99,99,10
"839",38,"[40]uIhHoIfdxBkADjEtlhyKopbKDaefhHunJHqvbGqa",204,0.990338,40,207,2,205,1,2,1,3,2,105,104,101,101,10
"840",39,"[40]uIhHoIfdxBkADjEtlhyKopbKDaefhHunJHqvbGqa",193,0.989796,40,196,2,194,1,2,1,3,2,91,90,104,104,10
"841",40,"[40]uIhHoIfdxBkADjEtlhyKopbKDaefhHunJHqvbGqa",200,0.990148,40,203,2,201,1,2,1,3,2,102,101,100,100,10
"842",41,"[40]uIhHoIfdxBkADjEtlhyKopbKDaefhHunJHqvbGqa",191,0.989691,40,194,2,192,1,2,1,3,2,91,90,102,102,10
"843",42,"[40]uIhHoIfdxBkADjEtlhyKopbKDaefhHunJHqvbGqa",208,0.990521,40,211,2,209,1,2,1,3,2,111,110,99,99,10
"844",43,"[40]uIhHoIfdxBkADjEtlhyKopbKDaefhHunJHqvbGqa",210,0.99061,40,213,2,211,1,2,1,3,2,111,110,101,101,10
"845",44,"[40]uIhHoIfdxBkADjEtlhyKopbKDaefhHunJHqvbGqa",199,0.990099,40,202,2,200,1,2,1,3,2,101,100,100,100,10
"846",45,"[40]uIhHoIfdxBkADjEtlhyKopbKDaefhHunJHqvbGqa",203,0.990291,40,206,2,204,1,2,1,3,2,104,103,101,101,10
"847",46,"[40]uIhHoIfdxBkADjEtlhyKopbKDaefhHunJHqvbGqa",194,0.989848,40,197,2,195,1,2,1,3,2,93,92,103,103,10
"848",47,"[40]uIhHoIfdxBkADjEtlhyKopbKDaefhHunJHqvbGqa",192,0.989744,40,195,2,193,1,2,1,3,2,90,89,104,104,10
"849",48,"[40]uIhHoIfdxBkADjEtlhyKopbKDaefhHunJHqvbGqa",203,0.990291,40,206,2,204,1,2,1,3,2,107,106,98,98,10
"850",49,"[40]uIhHoIfdxBkADjEtlhyKopbKDaefhHunJHqvbGqa",202,0.990244,40,205,2,203,1,2,1,3,2,103,102,101,101,10
"851",50,"[40]uIhHoIfdxBkADjEtlhyKopbKDaefhHunJHqvbGqa",200,0.990148,40,203,2,201,1,2,1,3,2,101,100,101,101,10
"852",51,"[40]uIhHoIfdxBkADjEtlhyKopbKDaefhHunJHqvbGqa",203,0.990291,40,206,2,204,1,2,1,3,2,106,105,99,99,10
"853",52,"[40]uIhHoIfdxBkADjEtlhyKopbKDaefhHunJHqvbGqa",208,0.990521,40,211,2,209,1,2,1,3,2,112,111,98,98,10
"854",53,"[40]uIhHoIfdxBkADjEtlhyKopbKDaefhHunJHqvbGqa",206,0.990431,40,209,2,207,1,2,1,3,2,108,107,100,100,10
"855",54,"[40]uIhHoIfdxBkADjEtlhyKopbKDaefhHunJHqvbGqa",193,0.989796,40,196,2,194,1,2,1,3,2,91,90,104,104,10
"856",55,"[40]uIhHoIfdxBkADjEtlhyKopbKDaefhHunJHqvbGqa",198,0.99005,40,201,2,199,1,2,1,3,2,97,96,103,103,10
"857",56,"[40]uIhHoIfdxBkADjEtlhyKopbKDaefhHunJHqvbGqa",206,0.990431,40,209,2,207,1,2,1,3,2,109,108,99,99,10
"858",57,"[40]uIhHoIfdxBkADjEtlhyKopbKDaefhHunJHqvbGqa",223,0.99115,40,226,2,224,1,2,1,3,2,129,128,96,96,10
"859",58,"[40]uIhHoIfdxBkADjEtlhyKopbKDaefhHunJHqvbGqa",180,0.989071,40,183,2,181,1,2,1,3,2,75,74,107,107,10
"860",59,"[40]uIhHoIfdxBkADjEtlhyKopbKDaefhHunJHqvbGqa",194,0.989848,40,197,2,195,1,2,1,3,2,94,93,102,102,10
"861",60,"[40]uIhHoIfdxBkADjEtlhyKopbKDaefhHunJHqvbGqa",200,0.990148,40,203,2,201,1,2,1,3,2,102,101,100,100,10
"862",61,"[40]uIhHoIfdxBkADjEtlhyKopbKDaefhHunJHqvbGqa",190,0.989637,40,193,2,191,1,2,1,3,2,87,86,105,105,10
"863",62,"[40]uIhHoIfdxBkADjEtlhyKopbKDaefhHunJHqvbGqa",198,0.99005,40,201,2,199,1,2,1,3,2,97,96,103,103,10
"864",63,"[40]uIhHoIfdxBkADjEtlhyKopbKDaefhHunJHqvbGqa",189,0.989583,40,192,2,190,1,2,1,3,2,86,85,105,105,10
"865",64,"[40]uIhHoIfdxBkADjEtlhyKopbKDaefhHunJHqvbGqa",213,0.990741,40,216,2,214,1,2,1,3,2,123,122,92,92,10
"866",65,"[40]uIhHoIfdxBkADjEtlhyKopbKDaefhHunJHqvbGqa",201,0.990196,40,204,2,202,1,2,1,3,2,101,100,102,102,10
"867",66,"[40]uIhHoIfdxBkADjEtlhyKopbKDaefhHunJHqvbGqa",209,0.990566,40,212,2,210,1,2,1,3,2,115,114,96,96,10
"868",67,"[40]uIhHoIfdxBkADjEtlhyKopbKDaefhHunJHqvbGqa",190,0.989637,40,193,2,191,1,2,1,3,2,88,87,104,104,10
"869",68,"[40]uIhHoIfdxBkADjEtlhyKopbKDaefhHunJHqvbGqa",207,0.990476,40,210,2,208,1,2,1,3,2,110,109,99,99,10
"870",69,"[40]uIhHoIfdxBkADjEtlhyKopbKDaefhHunJHqvbGqa",210,0.99061,40,213,2,211,1,2,1,3,2,114,113,98,98,10
"871",70,"[40]uIhHoIfdxBkADjEtlhyKopbKDaefhHunJHqvbGqa",194,0.989848,40,197,2,195,1,2,1,3,2,93,92,103,103,10
"872",71,"[40]uIhHoIfdxBkADjEtlhyKopbKDaefhHunJHqvbGqa",202,0.990244,40,205,2,203,1,2,1,3,2,101,100,103,103,10
"873",72,"[40]uIhHoIfdxBkADjEtlhyKopbKDaefhHunJHqvbGqa",187,0.989474,40,190,2,188,1,2,1,3,2,84,83,105,105,10
"874",73,"[40]uIhHoIfdxBkADjEtlhyKopbKDaefhHunJHqvbGqa",207,0.990476,40,210,2,208,1,2,1,3,2,112,111,97,97,10
"875",74,"[40]uIhHoIfdxBkADjEtlhyKopbKDaefhHunJHqvbGqa",196,0.98995,40,199,2,197,1,2,1,3,2,95,94,103,103,10
"876",75,"[40]uIhHoIfdxBkADjEtlhyKopbKDaefhHunJHqvbGqa",215,0.990826,40,218,2,216,1,2,1,3,2,121,120,96,96,10
"877",76,"[40]uIhHoIfdxBkADjEtlhyKopbKDaefhHunJHqvbGqa",214,0.990783,40,217,2,215,1,2,1,3,2,120,119,96,96,10
"878",77,"[40]uIhHoIfdxBkADjEtlhyKopbKDaefhHunJHqvbGqa",197,0.99,40,200,2,198,1,2,1,3,2,98,97,101,101,10
"879",78,"[40]uIhHoIfdxBkADjEtlhyKopbKDaefhHunJHqvbGqa",198,0.99005,40,201,2,199,1,2,1,3,2,97,96,103,103,10
"880",79,"[40]uIhHoIfdxBkADjEtlhyKopbKDaefhHunJHqvbGqa",205,0.990385,40,208,2,206,1,2,1,3,2,108,107,99,99,10
"881",80,"[40]uIhHoIfdxBkADjEtlhyKopbKDaefhHunJHqvbGqa",204,0.990338,40,207,2,205,1,2,1,3,2,106,105,100,100,10
"882",81,"[40]uIhHoIfdxBkADjEtlhyKopbKDaefhHunJHqvbGqa",213,0.990741,40,216,2,214,1,2,1,3,2,118,117,97,97,10
"883",82,"[40]uIhHoIfdxBkADjEtlhyKopbKDaefhHunJHqvbGqa",197,0.99,40,200,2,198,1,2,1,3,2,96,95,103,103,10
"884",83,"[40]uIhHoIfdxBkADjEtlhyKopbKDaefhHunJHqvbGqa",200,0.990148,40,203,2,201,1,2,1,3,2,100,99,102,102,10
"885",84,"[40]uIhHoIfdxBkADjEtlhyKopbKDaefhHunJHqvbGqa",189,0.989583,40,192,2,190,1,2,1,3,2,88,87,103,103,10
"886",85,"[40]uIhHoIfdxBkADjEtlhyKopbKDaefhHunJHqvbGqa",204,0.990338,40,207,2,205,1,2,1,3,2,106,105,100,100,10
"887",86,"[40]uIhHoIfdxBkADjEtlhyKopbKDaefhHunJHqvbGqa",193,0.989796,40,196,2,194,1,2,1,3,2,93,92,102,102,10
"888",87,"[40]uIhHoIfdxBkADjEtlhyKopbKDaefhHunJHqvbGqa",191,0.989691,40,194,2,192,1,2,1,3,2,87,86,106,106,10
"889",88,"[40]uIhHoIfdxBkADjEtlhyKopbKDaefhHunJHqvbGqa",213,0.990741,40,216,2,214,1,2,1,3,2,120,119,95,95,10
"890",89,"[40]uIhHoIfdxBkADjEtlhyKopbKDaefhHunJHqvbGqa",200,0.990148,40,203,2,201,1,2,1,3,2,102,101,100,100,10
"891",90,"[40]uIhHoIfdxBkADjEtlhyKopbKDaefhHunJHqvbGqa",196,0.98995,40,199,2,197,1,2,1,3,2,97,96,101,101,10
"892",91,"[40]uIhHoIfdxBkADjEtlhyKopbKDaefhHunJHqvbGqa",196,0.98995,40,199,2,197,1,2,1,3,2,94,93,104,104,10
"893",92,"[40]uIhHoIfdxBkADjEtlhyKopbKDaefhHunJHqvbGqa",208,0.990521,40,211,2,209,1,2,1,3,2,111,110,99,99,10
"894",93,"[40]uIhHoIfdxBkADjEtlhyKopbKDaefhHunJHqvbGqa",204,0.990338,40,207,2,205,1,2,1,3,2,103,102,103,103,10
"895",94,"[40]uIhHoIfdxBkADjEtlhyKopbKDaefhHunJHqvbGqa",201,0.990196,40,204,2,202,1,2,1,3,2,104,103,99,99,10
"896",95,"[40]uIhHoIfdxBkADjEtlhyKopbKDaefhHunJHqvbGqa",205,0.990385,40,208,2,206,1,2,1,3,2,106,105,101,101,10
"897",96,"[40]uIhHoIfdxBkADjEtlhyKopbKDaefhHunJHqvbGqa",205,0.990385,40,208,2,206,1,2,1,3,2,106,105,101,101,10
"898",97,"[40]uIhHoIfdxBkADjEtlhyKopbKDaefhHunJHqvbGqa",195,0.989899,40,198,2,196,1,2,1,3,2,95,94,102,102,10
"899",98,"[40]uIhHoIfdxBkADjEtlhyKopbKDaefhHunJHqvbGqa",198,0.99005,40,201,2,199,1,2,1,3,2,99,98,101,101,10
"900",99,"[40]uIhHoIfdxBkADjEtlhyKopbKDaefhHunJHqvbGqa",202,0.990244,40,205,2,203,1,2,1,3,2,106,105,98,98,10
"901",0,"[42]tIHHoIttGEBDumHgFEmGaDJbaElKwbKHvnJHqvbGqa",216,0.990868,42,219,2,217,1,2,1,3,2,108,107,110,110,11
"902",1,"[42]tIHHoIttGEBDumHgFEmGaDJbaElKwbKHvnJHqvbGqa",219,0.990991,42,222,2,220,1,2,1,3,2,111,110,110,110,11
"903",2,"[42]tIHHoIttGEBDumHgFEmGaDJbaElKwbKHvnJHqvbGqa",209,0.990566,42,212,2,210,1,2,1,3,2,97,96,114,114,11
"904",3,"[42]tIHHoIttGEBDumHgFEmGaDJbaElKwbKHvnJHqvbGqa",218,0.99095,42,221,2,219,1,2,1,3,2,112,111,108,108,11
"905",4,"[42]tIHHoIttGEBDumHgFEmGaDJbaElKwbKHvnJHqvbGqa",218,0.99095,42,221,2,219,1,2,1,3,2,111,110,109,109,11
"906",5,"[42]tIHHoIttGEBDumHgFEmGaDJbaElKwbKHvnJHqvbGqa",206,0.990431,42,209,2,207,1,2,1,3,2,93,92,115,115,11
"907",6,"[42]tIHHoIttGEBDumHgFEmGaDJbaElKwbKHvnJHqvbGqa",211,0.990654,42,214,2,212,1,2,1,3,2,104,103,109,109,11
"908",7,"[42]tIHHoIttGEBDumHgFEmGaDJbaElKwbKHvnJHqvbGqa",219,0.990991,42,222,2,220,1,2,1,3,2,113,112,108,108,11
"909",8,"[42]tIHHoIttGEBDumHgFEmGaDJbaElKwbKHvnJHqvbGqa",229,0.991379,42,232,2,230,1,2,1,3,2,129,128,102,102,11
"910",9,"[42]tIHHoIttGEBDumHgFEmGaDJbaElKwbKHvnJHqvbGqa",213,0.990741,42,216,2,214,1,2,1,3,2,102,101,113,113,11
"911",10,"[42]tIHHoIttGEBDumHgFEmGaDJbaElKwbKHvnJHqvbGqa",205,0.990385,42,208,2,206,1,2,1,3,2,94,93,113,113,11
"912",11,"[42]tIHHoIttGEBDumHgFEmGaDJbaElKwbKHvnJHqvbGqa",224,0.991189,42,227,2,225,1,2,1,3,2,120,119,106,106,11
"913",12,"[42]tIHHoIttGEBDumHgFEmGaDJbaElKwbKHvnJHqvbGqa",231,0.991453,42,234,2,232,1,2,1,3,2,131,130,102,102,11
"914",13,"[42]tIHHoIttGEBDumHgFEmGaDJbaElKwbKHvnJHqvbGqa",209,0.990566,42,212,2,210,1,2,1,3,2,99,98,112,112,11
"915",14,"[42]tIHHoIttGEBDumHgFEmGaDJbaElKwbKHvnJHqvbGqa",229,0.991379,42,232,2,230,1,2,1,3,2,128,127,103,103,11
"916",15,"[42]tIHHoIttGEBDumHgFEmGaDJbaElKwbKHvnJHqvbGqa",219,0.990991,42,222,2,220,1,2,1,3,2,114,113,107,107,11
"917",16,"[42]tIHHoIttGEBDumHgFEmGaDJbaElKwbKHvnJHqvbGqa",222,0.991111,42,225,2,223,1,2,1,3,2,116,115,108,108,11
"918",17,"[42]tIHHoIttGEBDumHgFEmGaDJbaElKwbKHvnJHqvbGqa",214,0.990783,42,217,2,215,1,2,1,3,2,106,105,110,110,11
"919",18,"[42]tIHHoIttGEBDumHgFEmGaDJbaElKwbKHvnJHqvbGqa",207,0.990476,42,210,2,208,1,2,1,3,2,99,98,110,110,11
"920",19,"[42]tIHHoIttGEBDumHgFEmGaDJbaElKwbKHvnJHqvbGqa",211,0.990654,42,214,2,212,1,2,1,3,2,104,103,109,109,11
"921",20,"[42]tIHHoIttGEBDumHgFEmGaDJbaElKwbKHvnJHqvbGqa",231,0.991453,42,234,2,232,1,2,1,3,2,132,131,101,101,11
"922",21,"[42]tIHHoIttGEBDumHgFEmGaDJbaElKwbKHvnJHqvbGqa",218,0.99095,42,221,2,219,1,2,1,3,2,114,113,106,106,11
"923",22,"[42]tIHHoIttGEBDumHgFEmGaDJbaElKwbKHvnJHqvbGqa",216,0.990868,42,219,2,217,1,2,1,3,2,112,111,106,106,11
"924",23,"[42]tIHHoIttGEBDumHgFEmGaDJbaElKwbKHvnJHqvbGqa",206,0.990431,42,209,2,207,1,2,1,3,2,94,93,114,114,11
"925",24,"[42]tIHHoIttGEBDumHgFEmGaDJbaElKwbKHvnJHqvbGqa",205,0.990385,42,208,2,206,1,2,1,3,2,93,92,114,114,11
"926",25,"[42]tIHHoIttGEBDumHgFEmGaDJbaElKwbKHvnJHqvbGqa",211,0.990654,42,214,2,212,1,2,1,3,2,102,101,111,111,11
"927",26,"[42]tIHHoIttGEBDumHgFEmGaDJbaElKwbKHvnJHqvbGqa",206,0.990431,42,209,2,207,1,2,1,3,2,97,96,111,111,11
"928",27,"[42]tIHHoIttGEBDumHgFEmGaDJbaElKwbKHvnJHqvbGqa",218,0.99095,42,221,2,219,1,2,1,3,2,110,109,110,110,11
"929",28,"[42]tIHHoIttGEBDumHgFEmGaDJbaElKwbKHvnJHqvbGqa",218,0.99095,42,221,2,219,1,2,1,3,2,115,114,105,105,11
"930",29,"[42]tIHHoIttGEBDumHgFEmGaDJbaElKwbKHvnJHqvbGqa",213,0.990741,42,216,2,214,1,2,1,3,2,103,102,112,112,11
"931",30,"[42]tIHHoIttGEBDumHgFEmGaDJbaElKwbKHvnJHqvbGqa",215,0.990826,42,218,2,216,1,2,1,3,2,107,106,110,110,11
"932",31,"[42]tIHHoIttGEBDumHgFEmGaDJbaElKwbKHvnJHqvbGqa",204,0.990338,42,207,2,205,1,2,1,3,2,93,92,113,113,11
"933",32,"[42]tIHHoIttGEBDumHgFEmGaDJbaElKwbKHvnJHqvbGqa",222,0.991111,42,225,2,223,1,2,1,3,2,114,113,110,110,11
"934",33,"[42]tIHHoIttGEBDumHgFEmGaDJbaElKwbKHvnJHqvbGqa",224,0.991189,42,227,2,225,1,2,1,3,2,122,121,104,104,11
"935",34,"[42]tIHHoIttGEBDumHgFEmGaDJbaElKwbKHvnJHqvbGqa",213,0.990741,42,216,2,214,1,2,1,3,2,106,105,109,109,11
"936",35,"[42]tIHHoIttGEBDumHgFEmGaDJbaElKwbKHvnJHqvbGqa",216,0.990868,42,219,2,217,1,2,1,3,2,112,111,106,106,11
"937",36,"[42]tIHHoIttGEBDumHgFEmGaDJbaElKwbKHvnJHqvbGqa",220,0.991031,42,223,2,221,1,2,1,3,2,117,116,105,105,11
"938",37,"[42]tIHHoIttGEBDumHgFEmGaDJbaElKwbKHvnJHqvbGqa",216,0.990868,42,219,2,217,1,2,1,3,2,110,109,108,108,11
"939",38,"[42]tIHHoIttGEBDumHgFEmGaDJbaElKwbKHvnJHqvbGqa",228,0.991342,42,231,2,229,1,2,1,3,2,126,125,104,104,11
"940",39,"[42]tIHHoIttGEBDumHgFEmGaDJbaElKwbKHvnJHqvbGqa",213,0.990741,42,216,2,214,1,2,1,3,2,108,107,107,107,11
"941",40,"[42]tIHHoIttGEBDumHgFEmGaDJbaElKwbKHvnJHqvbGqa",211,0.990654,42,214,2,212,1,2,1,3,2,101,100,112,112,11
"942",41,"[42]tIHHoIttGEBDumHgFEmGaDJbaElKwbKHvnJHqvbGqa",198,0.99005,42,201,2,199,1,2,1,3,2,86,85,114,114,11
"943",42,"[42]tIHHoIttGEBDumHgFEmGaDJbaElKwbKHvnJHqvbGqa",221,0.991071,42,224,2,222,1,2,1,3,2,119,118,104,104,11
"944",43,"[42]tIHHoIttGEBDumHgFEmGaDJbaElKwbKHvnJHqvbGqa",217,0.990909,42,220,2,218,1,2,1,3,2,114,113,105,105,11
"945",44,"[42]tIHHoIttGEBDumHgFEmGaDJbaElKwbKHvnJHqvbGqa",211,0.990654,42,214,2,212,1,2,1,3,2,104,103,109,109,11
"946",45,"[42]tIHHoIttGEBDumHgFEmGaDJbaElKwbKHvnJHqvbGqa",196,0.98995,42,199,2,197,1,2,1,3,2,83,82,115,115,11
"947",46,"[42]tIHHoIttGEBDumHgFEmGaDJbaElKwbKHvnJHqvbGqa",215,0.990826,42,218,2,216,1,2,1,3,2,111,110,106,106,11
"948",47,"[42]tIHHoIttGEBDumHgFEmGaDJbaElKwbKHvnJHqvbGqa",208,0.990521,42,211,2,209,1,2,1,3,2,98,97,112,112,11
"949",48,"[42]tIHHoIttGEBDumHgFEmGaDJbaElKwbKHvnJHqvbGqa",218,0.99095,42,221,2,219,1,2,1,3,2,116,115,104,104,11
"950",49,"[42]tIHHoIttGEBDumHgFEmGaDJbaElKwbKHvnJHqvbGqa",206,0.990431,42,209,2,207,1,2,1,3,2,95,94,113,113,11
"951",50,"[42]tIHHoIttGEBDumHgFEmGaDJbaElKwbKHvnJHqvbGqa",205,0.990385,42,208,2,206,1,2,1,3,2,95,94,112,112,11
"952",51,"[42]tIHHoIttGEBDumHgFEmGaDJbaElKwbKHvnJHqvbGqa",221,0.991071,42,224,2,222,1,2,1,3,2,116,115,107,107,11
"953",52,"[42]tIHHoIttGEBDumHgFEmGaDJbaElKwbKHvnJHqvbGqa",216,0.990868,42,219,2,217,1,2,1,3,2,111,110,107,107,11
"954",53,"[42]tIHHoIttGEBDumHgFEmGaDJbaElKwbKHvnJHqvbGqa",213,0.990741,42,216,2,214,1,2,1,3,2,107,106,108,108,11
"955",54,"[42]tIHHoIttGEBDumHgFEmGaDJbaElKwbKHvnJHqvbGqa",222,0.991111,42,225,2,223,1,2,1,3,2,118,117,106,106,11
"956",55,"[42]tIHHoIttGEBDumHgFEmGaDJbaElKwbKHvnJHqvbGqa",209,0.990566,42,212,2,210,1,2,1,3,2,100,99,111,111,11
"957",56,"[42]tIHHoIttGEBDumHgFEmGaDJbaElKwbKHvnJHqvbGqa",227,0.991304,42,230,2,228,1,2,1,3,2,124,123,105,105,11
"958",57,"[42]tIHHoIttGEBDumHgFEmGaDJbaElKwbKHvnJHqvbGqa",204,0.990338,42,207,2,205,1,2,1,3,2,94,93,112,112,11
"959",58,"[42]tIHHoIttGEBDumHgFEmGaDJbaElKwbKHvnJHqvbGqa",210,0.99061,42,213,2,211,1,2,1,3,2,100,99,112,112,11
"960",59,"[42]tIHHoIttGEBDumHgFEmGaDJbaElKwbKHvnJHqvbGqa",230,0.991416,42,233,2,231,1,2,1,3,2,128,127,104,104,11
"961",60,"[42]tIHHoIttGEBDumHgFEmGaDJbaElKwbKHvnJHqvbGqa",211,0.990654,42,214,2,212,1,2,1,3,2,102,101,111,111,11
"962",61,"[42]tIHHoIttGEBDumHgFEmGaDJbaElKwbKHvnJHqvbGqa",231,0.991453,42,234,2,232,1,2,1,3,2,136,135,97,97,11
"963",62,"[42]tIHHoIttGEBDumHgFEmGaDJbaElKwbKHvnJHqvbGqa",214,0.990783,42,217,2,215,1,2,1,3,2,108,107,108,108,11
"964",63,"[42]tIHHoIttGEBDumHgFEmGaDJbaElKwbKHvnJHqvbGqa",201,0.990196,42,204,2,202,1,2,1,3,2,90,89,113,113,11
"965",64,"[42]tIHHoIttGEBDumHgFEmGaDJbaElKwbKHvnJHqvbGqa",206,0.990431,42,209,2,207,1,2,1,3,2,96,95,112,112,11
"966",65,"[42]tIHHoIttGEBDumHgFEmGaDJbaElKwbKHvnJHqvbGqa",215,0.990826,42,218,2,216,1,2,1,3,2,112,111,105,105,11
"967",66,"[42]tIHHoIttGEBDumHgFEmGaDJbaElKwbKHvnJHqvbGqa",218,0.99095,42,221,2,219,1,2,1,3,2,116,115,104,104,11
"968",67,"[42]tIHHoIttGEBDumHgFEmGaDJbaElKwbKHvnJHqvbGqa",229,0.991379,42,232,2,230,1,2,1,3,2,128,127,103,103,11
"969",68,"[42]tIHHoIttGEBDumHgFEmGaDJbaElKwbKHvnJHqvbGqa",211,0.990654,42,214,2,212,1,2,1,3,2,102,101,111,111,11
"970",69,"[42]tIHHoIttGEBDumHgFEmGaDJbaElKwbKHvnJHqvbGqa",216,0.990868,42,219,2,217,1,2,1,3,2,110,109,108,108,11
"971",70,"[42]tIHHoIttGEBDumHgFEmGaDJbaElKwbKHvnJHqvbGqa",209,0.990566,42,212,2,210,1,2,1,3,2,98,97,113,113,11
"972",71,"[42]tIHHoIttGEBDumHgFEmGaDJbaElKwbKHvnJHqvbGqa",231,0.991453,42,234,2,232,1,2,1,3,2,134,133,99,99,11
"973",72,"[42]tIHHoIttGEBDumHgFEmGaDJbaElKwbKHvnJHqvbGqa",225,0.991228,42,228,2,226,1,2,1,3,2,122,121,105,105,11
"974",73,"[42]tIHHoIttGEBDumHgFEmGaDJbaElKwbKHvnJHqvbGqa",217,0.990909,42,220,2,218,1,2,1,3,2,111,110,108,108,11
"975",74,"[42]tIHHoIttGEBDumHgFEmGaDJbaElKwbKHvnJHqvbGqa",212,0.990698,42,215,2,213,1,2,1,3,2,104,103,110,110,11
"976",75,"[42]tIHHoIttGEBDumHgFEmGaDJbaElKwbKHvnJHqvbGqa",219,0.990991,42,222,2,220,1,2,1,3,2,114,113,107,107,11
"977",76,"[42]tIHHoIttGEBDumHgFEmGaDJbaElKwbKHvnJHqvbGqa",207,0.990476,42,210,2,208,1,2,1,3,2,99,98,110,110,11
"978",77,"[42]tIHHoIttGEBDumHgFEmGaDJbaElKwbKHvnJHqvbGqa",212,0.990698,42,215,2,213,1,2,1,3,2,105,104,109,109,11
"979",78,"[42]tIHHoIttGEBDumHgFEmGaDJbaElKwbKHvnJHqvbGqa",208,0.990521,42,211,2,209,1,2,1,3,2,98,97,112,112,11
"980",79,"[42]tIHHoIttGEBDumHgFEmGaDJbaElKwbKHvnJHqvbGqa",217,0.990909,42,220,2,218,1,2,1,3,2,114,113,105,105,11
"981",80,"[42]tIHHoIttGEBDumHgFEmGaDJbaElKwbKHvnJHqvbGqa",216,0.990868,42,219,2,217,1,2,1,3,2,109,108,109,109,11
"982",81,"[42]tIHHoIttGEBDumHgFEmGaDJbaElKwbKHvnJHqvbGqa",218,0.99095,42,221,2,219,1,2,1,3,2,112,111,108,108,11
"983",82,"[42]tIHHoIttGEBDumHgFEmGaDJbaElKwbKHvnJHqvbGqa",226,0.991266,42,229,2,227,1,2,1,3,2,125,124,103,103,11
"984",83,"[42]tIHHoIttGEBDumHgFEmGaDJbaElKwbKHvnJHqvbGqa",212,0.990698,42,215,2,213,1,2,1,3,2,104,103,110,110,11
"985",84,"[42]tIHHoIttGEBDumHgFEmGaDJbaElKwbKHvnJHqvbGqa",229,0.991379,42,232,2,230,1,2,1,3,2,128,127,103,103,11
"986",85,"[42]tIHHoIttGEBDumHgFEmGaDJbaElKwbKHvnJHqvbGqa",206,0.990431,42,209,2,207,1,2,1,3,2,95,94,113,113,11
"987",86,"[42]tIHHoIttGEBDumHgFEmGaDJbaElKwbKHvnJHqvbGqa",220,0.991031,42,223,2,221,1,2,1,3,2,115,114,107,107,11
"988",87,"[42]tIHHoIttGEBDumHgFEmGaDJbaElKwbKHvnJHqvbGqa",239,0.991736,42,242,2,240,1,2,1,3,2,144,143,97,97,11
"989",88,"[42]tIHHoIttGEBDumHgFEmGaDJbaElKwbKHvnJHqvbGqa",215,0.990826,42,218,2,216,1,2,1,3,2,108,107,109,109,11
"990",89,"[42]tIHHoIttGEBDumHgFEmGaDJbaElKwbKHvnJHqvbGqa",210,0.99061,42,213,2,211,1,2,1,3,2,102,101,110,110,11
"991",90,"[42]tIHHoIttGEBDumHgFEmGaDJbaElKwbKHvnJHqvbGqa",223,0.99115,42,226,2,224,1,2,1,3,2,120,119,105,105,11
"992",91,"[42]tIHHoIttGEBDumHgFEmGaDJbaElKwbKHvnJHqvbGqa",225,0.991228,42,228,2,226,1,2,1,3,2,123,122,104,104,11
"993",92,"[42]tIHHoIttGEBDumHgFEmGaDJbaElKwbKHvnJHqvbGqa",216,0.990868,42,219,2,217,1,2,1,3,2,109,108,109,109,11
"994",93,"[42]tIHHoIttGEBDumHgFEmGaDJbaElKwbKHvnJHqvbGqa",224,0.991189,42,227,2,225,1,2,1,3,2,121,120,105,105,11
"995",94,"[42]tIHHoIttGEBDumHgFEmGaDJbaElKwbKHvnJHqvbGqa",230,0.991416,42,233,2,231,1,2,1,3,2,130,129,102,102,11
"996",95,"[42]tIHHoIttGEBDumHgFEmGaDJbaElKwbKHvnJHqvbGqa",206,0.990431,42,209,2,207,1,2,1,3,2,94,93,114,114,11
"997",96,"[42]tIHHoIttGEBDumHgFEmGaDJbaElKwbKHvnJHqvbGqa",219,0.990991,42,222,2,220,1,2,1,3,2,115,114,106,106,11
"998",97,"[42]tIHHoIttGEBDumHgFEmGaDJbaElKwbKHvnJHqvbGqa",209,0.990566,42,212,2,210,1,2,1,3,2,99,98,112,112,11
"999",98,"[42]tIHHoIttGEBDumHgFEmGaDJbaElKwbKHvnJHqvbGqa",215,0.990826,42,218,2,216,1,2,1,3,2,108,107,109,109,11
"1000",99,"[42]tIHHoIttGEBDumHgFEmGaDJbaElKwbKHvnJHqvbGqa",213,0.990741,42,216,2,214,1,2,1,3,2,104,103,111,111,11
"1001",0,"[40]BIzHoIFprBkDjkHqfIdfdvbKDeeeAHwnJHqvbGqa",221,0.991071,40,224,2,222,1,2,1,3,2,127,126,96,96,12
"1002",1,"[40]BIzHoIFprBkDjkHqfIdfdvbKDeeeAHwnJHqvbGqa",204,0.990338,40,207,2,205,1,2,1,3,2,108,107,98,98,12
"1003",2,"[40]BIzHoIFprBkDjkHqfIdfdvbKDeeeAHwnJHqvbGqa",197,0.99,40,200,2,198,1,2,1,3,2,98,97,101,101,12
"1004",3,"[40]BIzHoIFprBkDjkHqfIdfdvbKDeeeAHwnJHqvbGqa",197,0.99,40,200,2,198,1,2,1,3,2,98,97,101,101,12
"1005",4,"[40]BIzHoIFprBkDjkHqfIdfdvbKDeeeAHwnJHqvbGqa",184,0.989305,40,187,2,185,1,2,1,3,2,78,77,108,108,12
"1006",5,"[40]BIzHoIFprBkDjkHqfIdfdvbKDeeeAHwnJHqvbGqa",210,0.99061,40,213,2,211,1,2,1,3,2,118,117,94,94,12
"1007",6,"[40]BIzHoIFprBkDjkHqfIdfdvbKDeeeAHwnJHqvbGqa",207,0.990476,40,210,2,208,1,2,1,3,2,111,110,98,98,12
"1008",7,"[40]BIzHoIFprBkDjkHqfIdfdvbKDeeeAHwnJHqvbGqa",195,0.989899,40,198,2,196,1,2,1,3,2,94,93,103,103,12
"1009",8,"[40]BIzHoIFprBkDjkHqfIdfdvbKDeeeAHwnJHqvbGqa",192,0.989744,40,195,2,193,1,2,1,3,2,90,89,104,104,12
"1010",9,"[40]BIzHoIFprBkDjkHqfIdfdvbKDeeeAHwnJHqvbGqa",194,0.989848,40,197,2,195,1,2,1,3,2,93,92,103,103,12
"1011",10,"[40]BIzHoIFprBkDjkHqfIdfdvbKDeeeAHwnJHqvbGqa",201,0.990196,40,204,2,202,1,2,1,3,2,102,101,101,101,12
"1012",11,"[40]BIzHoIFprBkDjkHqfIdfdvbKDeeeAHwnJHqvbGqa",199,0.990099,40,202,2,200,1,2,1,3,2,100,99,101,101,12
"1013",12,"[40]BIzHoIFprBkDjkHqfIdfdvbKDeeeAHwnJHqvbGqa",202,0.990244,40,205,2,203,1,2,1,3,2,104,103,100,100,12
"1014",13,"[40]BIzHoIFprBkDjkHqfIdfdvbKDeeeAHwnJHqvbGqa",194,0.989848,40,197,2,195,1,2,1,3,2,95,94,101,101,12
"1015",14,"[40]BIzHoIFprBkDjkHqfIdfdvbKDeeeAHwnJHqvbGqa",193,0.989796,40,196,2,194,1,2,1,3,2,91,90,104,104,12
"1016",15,"[40]BIzHoIFprBkDjkHqfIdfdvbKDeeeAHwnJHqvbGqa",194,0.989848,40,197,2,195,1,2,1,3,2,92,91,104,104,12
"1017",16,"[40]BIzHoIFprBkDjkHqfIdfdvbKDeeeAHwnJHqvbGqa",209,0.990566,40,212,2,210,1,2,1,3,2,114,113,97,97,12
"1018",17,"[40]BIzHoIFprBkDjkHqfIdfdvbKDeeeAHwnJHqvbGqa",193,0.989796,40,196,2,194,1,2,1,3,2,91,90,104,104,12
"1019",18,"[40]BIzHoIFprBkDjkHqfIdfdvbKDeeeAHwnJHqvbGqa",196,0.98995,40,199,2,197,1,2,1,3,2,96,95,102,102,12
"1020",19,"[40]BIzHoIFprBkDjkHqfIdfdvbKDeeeAHwnJHqvbGqa",197,0.99,40,200,2,198,1,2,1,3,2,97,96,102,102,12
"1021",20,"[40]BIzHoIFprBkDjkHqfIdfdvbKDeeeAHwnJHqvbGqa",200,0.990148,40,203,2,201,1,2,1,3,2,100,99,102,102,12
"1022",21,"[40]BIzHoIFprBkDjkHqfIdfdvbKDeeeAHwnJHqvbGqa",212,0.990698,40,215,2,213,1,2,1,3,2,117,116,97,97,12
"1023",22,"[40]BIzHoIFprBkDjkHqfIdfdvbKDeeeAHwnJHqvbGqa",211,0.990654,40,214,2,212,1,2,1,3,2,116,115,97,97,12
"1024",23,"[40]BIzHoIFprBkDjkHqfIdfdvbKDeeeAHwnJHqvbGqa",197,0.99,40,200,2,198,1,2,1,3,2,96,95,103,103,12
"1025",24,"[40]BIzHoIFprBkDjkHqfIdfdvbKDeeeAHwnJHqvbGqa",198,0.99005,40,201,2,199,1,2,1,3,2,96,95,104,104,12
"1026",25,"[40]BIzHoIFprBkDjkHqfIdfdvbKDeeeAHwnJHqvbGqa",224,0.991189,40,227,2,225,1,2,1,3,2,132,131,94,94,12
"1027",26,"[40]BIzHoIFprBkDjkHqfIdfdvbKDeeeAHwnJHqvbGqa",208,0.990521,40,211,2,209,1,2,1,3,2,111,110,99,99,12
"1028",27,"[40]BIzHoIFprBkDjkHqfIdfdvbKDeeeAHwnJHqvbGqa",197,0.99,40,200,2,198,1,2,1,3,2,99,98,100,100,12
"1029",28,"[40]BIzHoIFprBkDjkHqfIdfdvbKDeeeAHwnJHqvbGqa",199,0.990099,40,202,2,200,1,2,1,3,2,99,98,102,102,12
"1030",29,"[40]BIzHoIFprBkDjkHqfIdfdvbKDeeeAHwnJHqvbGqa",198,0.99005,40,201,2,199,1,2,1,3,2,97,96,103,103,12
"1031",30,"[40]BIzHoIFprBkDjkHqfIdfdvbKDeeeAHwnJHqvbGqa",206,0.990431,40,209,2,207,1,2,1,3,2,110,109,98,98,12
"1032",31,"[40]BIzHoIFprBkDjkHqfIdfdvbKDeeeAHwnJHqvbGqa",205,0.990385,40,208,2,206,1,2,1,3,2,107,106,100,100,12
"1033",32,"[40]BIzHoIFprBkDjkHqfIdfdvbKDeeeAHwnJHqvbGqa",202,0.990244,40,205,2,203,1,2,1,3,2,104,103,100,100,12
"1034",33,"[40]BIzHoIFprBkDjkHqfIdfdvbKDeeeAHwnJHqvbGqa",208,0.990521,40,211,2,209,1,2,1,3,2,110,109,100,100,12
"1035",34,"[40]BIzHoIFprBkDjkHqfIdfdvbKDeeeAHwnJHqvbGqa",202,0.990244,40,205,2,203,1,2,1,3,2,104,103,100,100,12
"1036",35,"[40]BIzHoIFprBkDjkHqfIdfdvbKDeeeAHwnJHqvbGqa",197,0.99,40,200,2,198,1,2,1,3,2,95,94,104,104,12
"1037",36,"[40]BIzHoIFprBkDjkHqfIdfdvbKDeeeAHwnJHqvbGqa",194,0.989848,40,197,2,195,1,2,1,3,2,92,91,104,104,12
"1038",37,"[40]BIzHoIFprBkDjkHqfIdfdvbKDeeeAHwnJHqvbGqa",193,0.989796,40,196,2,194,1,2,1,3,2,89,88,106,106,12
"1039",38,"[40]BIzHoIFprBkDjkHqfIdfdvbKDeeeAHwnJHqvbGqa",195,0.989899,40,198,2,196,1,2,1,3,2,94,93,103,103,12
"1040",39,"[40]BIzHoIFprBkDjkHqfIdfdvbKDeeeAHwnJHqvbGqa",203,0.990291,40,206,2,204,1,2,1,3,2,109,108,96,96,12
"1041",40,"[40]BIzHoIFprBkDjkHqfIdfdvbKDeeeAHwnJHqvbGqa",186,0.989418,40,189,2,187,1,2,1,3,2,82,81,106,106,12
"1042",41,"[40]BIzHoIFprBkDjkHqfIdfdvbKDeeeAHwnJHqvbGqa",203,0.990291,40,206,2,204,1,2,1,3,2,107,106,98,98,12
"1043",42,"[40]BIzHoIFprBkDjkHqfIdfdvbKDeeeAHwnJHqvbGqa",196,0.98995,40,199,2,197,1,2,1,3,2,94,93,104,104,12
"1044",43,"[40]BIzHoIFprBkDjkHqfIdfdvbKDeeeAHwnJHqvbGqa",209,0.990566,40,212,2,210,1,2,1,3,2,112,111,99,99,12
"1045",44,"[40]BIzHoIFprBkDjkHqfIdfdvbKDeeeAHwnJHqvbGqa",202,0.990244,40,205,2,203,1,2,1,3,2,103,102,101,101,12
"1046",45,"[40]BIzHoIFprBkDjkHqfIdfdvbKDeeeAHwnJHqvbGqa",197,0.99,40,200,2,198,1,2,1,3,2,95,94,104,104,12
"1047",46,"[40]BIzHoIFprBkDjkHqfIdfdvbKDeeeAHwnJHqvbGqa",207,0.990476,40,210,2,208,1,2,1,3,2,109,108,100,100,12
"1048",47,"[40]BIzHoIFprBkDjkHqfIdfdvbKDeeeAHwnJHqvbGqa",197,0.99,40,200,2,198,1,2,1,3,2,97,96,102,102,12
"1049",48,"[40]BIzHoIFprBkDjkHqfIdfdvbKDeeeAHwnJHqvbGqa",200,0.990148,40,203,2,201,1,2,1,3,2,102,101,100,100,12
"1050",49,"[40]BIzHoIFprBkDjkHqfIdfdvbKDeeeAHwnJHqvbGqa",203,0.990291,40,206,2,204,1,2,1,3,2,105,104,100,100,12
"1051",50,"[40]BIzHoIFprBkDjkHqfIdfdvbKDeeeAHwnJHqvbGqa",200,0.990148,40,203,2,201,1,2,1,3,2,100,99,102,102,12
"1052",51,"[40]BIzHoIFprBkDjkHqfIdfdvbKDeeeAHwnJHqvbGqa",200,0.990148,40,203,2,201,1,2,1,3,2,100,99,102,102,12
"1053",52,"[40]BIzHoIFprBkDjkHqfIdfdvbKDeeeAHwnJHqvbGqa",204,0.990338,40,207,2,205,1,2,1,3,2,105,104,101,101,12
"1054",53,"[40]BIzHoIFprBkDjkHqfIdfdvbKDeeeAHwnJHqvbGqa",214,0.990783,40,217,2,215,1,2,1,3,2,123,122,93,93,12
"1055",54,"[40]BIzHoIFprBkDjkHqfIdfdvbKDeeeAHwnJHqvbGqa",193,0.989796,40,196,2,194,1,2,1,3,2,93,92,102,102,12
"1056",55,"[40]BIzHoIFprBkDjkHqfIdfdvbKDeeeAHwnJHqvbGqa",200,0.990148,40,203,2,201,1,2,1,3,2,99,98,103,103,12
"1057",56,"[40]BIzHoIFprBkDjkHqfIdfdvbKDeeeAHwnJHqvbGqa",197,0.99,40,200,2,198,1,2,1,3,2,96,95,103,103,12
"1058",57,"[40]BIzHoIFprBkDjkHqfIdfdvbKDeeeAHwnJHqvbGqa",204,0.990338,40,207,2,205,1,2,1,3,2,106,105,100,100,12
"1059",58,"[40]BIzHoIFprBkDjkHqfIdfdvbKDeeeAHwnJHqvbGqa",191,0.989691,40,194,2,192,1,2,1,3,2,90,89,103,103,12
"1060",59,"[40]BIzHoIFprBkDjkHqfIdfdvbKDeeeAHwnJHqvbGqa",209,0.990566,40,212,2,210,1,2,1,3,2,114,113,97,97,12
"1061",60,"[40]BIzHoIFprBkDjkHqfIdfdvbKDeeeAHwnJHqvbGqa",191,0.989691,40,194,2,192,1,2,1,3,2,87,86,106,106,12
"1062",61,"[40]BIzHoIFprBkDjkHqfIdfdvbKDeeeAHwnJHqvbGqa",204,0.990338,40,207,2,205,1,2,1,3,2,104,103,102,102,12
"1063",62,"[40]BIzHoIFprBkDjkHqfIdfdvbKDeeeAHwnJHqvbGqa",201,0.990196,40,204,2,202,1,2,1,3,2,101,100,102,102,12
"1064",63,"[40]BIzHoIFprBkDjkHqfIdfdvbKDeeeAHwnJHqvbGqa",196,0.98995,40,199,2,197,1,2,1,3,2,95,94,103,103,12
"1065",64,"[40]BIzHoIFprBkDjkHqfIdfdvbKDeeeAHwnJHqvbGqa",206,0.990431,40,209,2,207,1,2,1,3,2,109,108,99,99,12
"1066",65,"[40]BIzHoIFprBkDjkHqfIdfdvbKDeeeAHwnJHqvbGqa",199,0.990099,40,202,2,200,1,2,1,3,2,100,99,101,101,12
"1067",66,"[40]BIzHoIFprBkDjkHqfIdfdvbKDeeeAHwnJHqvbGqa",198,0.99005,40,201,2,199,1,2,1,3,2,96,95,104,104,12
"1068",67,"[40]BIzHoIFprBkDjkHqfIdfdvbKDeeeAHwnJHqvbGqa",211,0.990654,40,214,2,212,1,2,1,3,2,113,112,100,100,12
"1069",68,"[40]BIzHoIFprBkDjkHqfIdfdvbKDeeeAHwnJHqvbGqa",192,0.989744,40,195,2,193,1,2,1,3,2,93,92,101,101,12
"1070",69,"[40]BIzHoIFprBkDjkHqfIdfdvbKDeeeAHwnJHqvbGqa",204,0.990338,40,207,2,205,1,2,1,3,2,103,102,103,103,12
"1071",70,"[40]BIzHoIFprBkDjkHqfIdfdvbKDeeeAHwnJHqvbGqa",197,0.99,40,200,2,198,1,2,1,3,2,96,95,103,103,12
"1072",71,"[40]BIzHoIFprBkDjkHqfIdfdvbKDeeeAHwnJHqvbGqa",195,0.989899,40,198,2,196,1,2,1,3,2,94,93,103,103,12
"1073",72,"[40]BIzHoIFprBkDjkHqfIdfdvbKDeeeAHwnJHqvbGqa",197,0.99,40,200,2,198,1,2,1,3,2,95,94,104,104,12
"1074",73,"[40]BIzHoIFprBkDjkHqfIdfdvbKDeeeAHwnJHqvbGqa",196,0.98995,40,199,2,197,1,2,1,3,2,96,95,102,102,12
"1075",74,"[40]BIzHoIFprBkDjkHqfIdfdvbKDeeeAHwnJHqvbGqa",201,0.990196,40,204,2,202,1,2,1,3,2,102,101,101,101,12
"1076",75,"[40]BIzHoIFprBkDjkHqfIdfdvbKDeeeAHwnJHqvbGqa",208,0.990521,40,211,2,209,1,2,1,3,2,109,108,101,101,12
"1077",76,"[40]BIzHoIFprBkDjkHqfIdfdvbKDeeeAHwnJHqvbGqa",192,0.989744,40,195,2,193,1,2,1,3,2,90,89,104,104,12
"1078",77,"[40]BIzHoIFprBkDjkHqfIdfdvbKDeeeAHwnJHqvbGqa",193,0.989796,40,196,2,194,1,2,1,3,2,92,91,103,103,12
"1079",78,"[40]BIzHoIFprBkDjkHqfIdfdvbKDeeeAHwnJHqvbGqa",214,0.990783,40,217,2,215,1,2,1,3,2,117,116,99,99,12
"1080",79,"[40]BIzHoIFprBkDjkHqfIdfdvbKDeeeAHwnJHqvbGqa",195,0.989899,40,198,2,196,1,2,1,3,2,96,95,101,101,12
"1081",80,"[40]BIzHoIFprBkDjkHqfIdfdvbKDeeeAHwnJHqvbGqa",206,0.990431,40,209,2,207,1,2,1,3,2,106,105,102,102,12
"1082",81,"[40]BIzHoIFprBkDjkHqfIdfdvbKDeeeAHwnJHqvbGqa",199,0.990099,40,202,2,200,1,2,1,3,2,100,99,101,101,12
"1083",82,"[40]BIzHoIFprBkDjkHqfIdfdvbKDeeeAHwnJHqvbGqa",206,0.990431,40,209,2,207,1,2,1,3,2,111,110,97,97,12
"1084",83,"[40]BIzHoIFprBkDjkHqfIdfdvbKDeeeAHwnJHqvbGqa",200,0.990148,40,203,2,201,1,2,1,3,2,101,100,101,101,12
"1085",84,"[40]BIzHoIFprBkDjkHqfIdfdvbKDeeeAHwnJHqvbGqa",208,0.990521,40,211,2,209,1,2,1,3,2,113,112,97,97,12
"1086",85,"[40]BIzHoIFprBkDjkHqfIdfdvbKDeeeAHwnJHqvbGqa",208,0.990521,40,211,2,209,1,2,1,3,2,115,114,95,95,12
"1087",86,"[40]BIzHoIFprBkDjkHqfIdfdvbKDeeeAHwnJHqvbGqa",190,0.989637,40,193,2,191,1,2,1,3,2,88,87,104,104,12
"1088",87,"[40]BIzHoIFprBkDjkHqfIdfdvbKDeeeAHwnJHqvbGqa",213,0.990741,40,216,2,214,1,2,1,3,2,120,119,95,95,12
"1089",88,"[40]BIzHoIFprBkDjkHqfIdfdvbKDeeeAHwnJHqvbGqa",200,0.990148,40,203,2,201,1,2,1,3,2,103,102,99,99,12
"1090",89,"[40]BIzHoIFprBkDjkHqfIdfdvbKDeeeAHwnJHqvbGqa",207,0.990476,40,210,2,208,1,2,1,3,2,110,109,99,99,12
"1091",90,"[40]BIzHoIFprBkDjkHqfIdfdvbKDeeeAHwnJHqvbGqa",205,0.990385,40,208,2,206,1,2,1,3,2,107,106,100,100,12
"1092",91,"[40]BIzHoIFprBkDjkHqfIdfdvbKDeeeAHwnJHqvbGqa",213,0.990741,40,216,2,214,1,2,1,3,2,120,119,95,95,12
"1093",92,"[40]BIzHoIFprBkDjkHqfIdfdvbKDeeeAHwnJHqvbGqa",204,0.990338,40,207,2,205,1,2,1,3,2,108,107,98,98,12
"1094",93,"[40]BIzHoIFprBkDjkHqfIdfdvbKDeeeAHwnJHqvbGqa",224,0.991189,40,227,2,225,1,2,1,3,2,131,130,95,95,12
"1095",94,"[40]BIzHoIFprBkDjkHqfIdfdvbKDeeeAHwnJHqvbGqa",198,0.99005,40,201,2,199,1,2,1,3,2,95,94,105,105,12
"1096",95,"[40]BIzHoIFprBkDjkHqfIdfdvbKDeeeAHwnJHqvbGqa",201,0.990196,40,204,2,202,1,2,1,3,2,102,101,101,101,12
"1097",96,"[40]BIzHoIFprBkDjkHqfIdfdvbKDeeeAHwnJHqvbGqa",195,0.989899,40,198,2,196,1,2,1,3,2,94,93,103,103,12
"1098",97,"[40]BIzHoIFprBkDjkHqfIdfdvbKDeeeAHwnJHqvbGqa",186,0.989418,40,189,2,187,1,2,1,3,2,82,81,106,106,12
"1099",98,"[40]BIzHoIFprBkDjkHqfIdfdvbKDeeeAHwnJHqvbGqa",210,0.99061,40,213,2,211,1,2,1,3,2,116,115,96,96,12
"1100",99,"[40]BIzHoIFprBkDjkHqfIdfdvbKDeeeAHwnJHqvbGqa",202,0.990244,40,205,2,203,1,2,1,3,2,105,104,99,99,12
"1101",0,"[40]cIdHoIAueBkDkrDEvAItElbKDeewyHwnJHqvbGqa",217,0.990909,40,220,2,218,1,2,1,3,2,123,122,96,96,13
"1102",1,"[40]cIdHoIAueBkDkrDEvAItElbKDeewyHwnJHqvbGqa",211,0.990654,40,214,2,212,1,2,1,3,2,116,115,97,97,13
"1103",2,"[40]cIdHoIAueBkDkrDEvAItElbKDeewyHwnJHqvbGqa",190,0.989637,40,193,2,191,1,2,1,3,2,87,86,105,105,13
"1104",3,"[40]cIdHoIAueBkDkrDEvAItElbKDeewyHwnJHqvbGqa",208,0.990521,40,211,2,209,1,2,1,3,2,111,110,99,99,13
"1105",4,"[40]cIdHoIAueBkDkrDEvAItElbKDeewyHwnJHqvbGqa",205,0.990385,40,208,2,206,1,2,1,3,2,112,111,95,95,13
"1106",5,"[40]cIdHoIAueBkDkrDEvAItElbKDeewyHwnJHqvbGqa",186,0.989418,40,189,2,187,1,2,1,3,2,82,81,106,106,13
"1107",6,"[40]cIdHoIAueBkDkrDEvAItElbKDeewyHwnJHqvbGqa",213,0.990741,40,216,2,214,1,2,1,3,2,118,117,97,97,13
"1108",7,"[40]cIdHoIAueBkDkrDEvAItElbKDeewyHwnJHqvbGqa",212,0.990698,40,215,2,213,1,2,1,3,2,115,114,99,99,13
"1109",8,"[40]cIdHoIAueBkDkrDEvAItElbKDeewyHwnJHqvbGqa",200,0.990148,40,203,2,201,1,2,1,3,2,100,99,102,102,13
"1110",9,"[40]cIdHoIAueBkDkrDEvAItElbKDeewyHwnJHqvbGqa",199,0.990099,40,202,2,200,1,2,1,3,2,100,99,101,101,13
"1111",10,"[40]cIdHoIAueBkDkrDEvAItElbKDeewyHwnJHqvbGqa",204,0.990338,40,207,2,205,1,2,1,3,2,104,103,102,102,13
"1112",11,"[40]cIdHoIAueBkDkrDEvAItElbKDeewyHwnJHqvbGqa",193,0.989796,40,196,2,194,1,2,1,3,2,91,90,104,104,13
"1113",12,"[40]cIdHoIAueBkDkrDEvAItElbKDeewyHwnJHqvbGqa",201,0.990196,40,204,2,202,1,2,1,3,2,103,102,100,100,13
"1114",13,"[40]cIdHoIAueBkDkrDEvAItElbKDeewyHwnJHqvbGqa",204,0.990338,40,207,2,205,1,2,1,3,2,107,106,99,99,13
"1115",14,"[40]cIdHoIAueBkDkrDEvAItElbKDeewyHwnJHqvbGqa",209,0.990566,40,212,2,210,1,2,1,3,2,112,111,99,99,13
"1116",15,"[40]cIdHoIAueBkDkrDEvAItElbKDeewyHwnJHqvbGqa",201,0.990196,40,204,2,202,1,2,1,3,2,102,101,101,101,13
"1117",16,"[40]cIdHoIAueBkDkrDEvAItElbKDeewyHwnJHqvbGqa",204,0.990338,40,207,2,205,1,2,1,3,2,106,105,100,100,13
"1118",17,"[40]cIdHoIAueBkDkrDEvAItElbKDeewyHwnJHqvbGqa",202,0.990244,40,205,2,203,1,2,1,3,2,104,103,100,100,13
"1119",18,"[40]cIdHoIAueBkDkrDEvAItElbKDeewyHwnJHqvbGqa",206,0.990431,40,209,2,207,1,2,1,3,2,108,107,100,100,13
"1120",19,"[40]cIdHoIAueBkDkrDEvAItElbKDeewyHwnJHqvbGqa",211,0.990654,40,214,2,212,1,2,1,3,2,117,116,96,96,13
"1121",20,"[40]cIdHoIAueBkDkrDEvAItElbKDeewyHwnJHqvbGqa",203,0.990291,40,206,2,204,1,2,1,3,2,107,106,98,98,13
"1122",21,"[40]cIdHoIAueBkDkrDEvAItElbKDeewyHwnJHqvbGqa",200,0.990148,40,203,2,201,1,2,1,3,2,100,99,102,102,13
"1123",22,"[40]cIdHoIAueBkDkrDEvAItElbKDeewyHwnJHqvbGqa",184,0.989305,40,187,2,185,1,2,1,3,2,79,78,107,107,13
"1124",23,"[40]cIdHoIAueBkDkrDEvAItElbKDeewyHwnJHqvbGqa",208,0.990521,40,211,2,209,1,2,1,3,2,114,113,96,96,13
"1125",24,"[40]cIdHoIAueBkDkrDEvAItElbKDeewyHwnJHqvbGqa",205,0.990385,40,208,2,206,1,2,1,3,2,109,108,98,98,13
"1126",25,"[40]cIdHoIAueBkDkrDEvAItElbKDeewyHwnJHqvbGqa",200,0.990148,40,203,2,201,1,2,1,3,2,100,99,102,102,13
"1127",26,"[40]cIdHoIAueBkDkrDEvAItElbKDeewyHwnJHqvbGqa",199,0.990099,40,202,2,200,1,2,1,3,2,101,100,100,100,13
"1128",27,"[40]cIdHoIAueBkDkrDEvAItElbKDeewyHwnJHqvbGqa",195,0.989899,40,198,2,196,1,2,1,3,2,92,91,105,105,13
"1129",28,"[40]cIdHoIAueBkDkrDEvAItElbKDeewyHwnJHqvbGqa",205,0.990385,40,208,2,206,1,2,1,3,2,108,107,99,99,13
"1130",29,"[40]cIdHoIAueBkDkrDEvAItElbKDeewyHwnJHqvbGqa",204,0.990338,40,207,2,205,1,2,1,3,2,106,105,100,100,13
"1131",30,"[40]cIdHoIAueBkDkrDEvAItElbKDeewyHwnJHqvbGqa",204,0.990338,40,207,2,205,1,2,1,3,2,106,105,100,100,13
"1132",31,"[40]cIdHoIAueBkDkrDEvAItElbKDeewyHwnJHqvbGqa",210,0.99061,40,213,2,211,1,2,1,3,2,116,115,96,96,13
"1133",32,"[40]cIdHoIAueBkDkrDEvAItElbKDeewyHwnJHqvbGqa",209,0.990566,40,212,2,210,1,2,1,3,2,112,111,99,99,13
"1134",33,"[40]cIdHoIAueBkDkrDEvAItElbKDeewyHwnJHqvbGqa",200,0.990148,40,203,2,201,1,2,1,3,2,100,99,102,102,13
"1135",34,"[40]cIdHoIAueBkDkrDEvAItElbKDeewyHwnJHqvbGqa",201,0.990196,40,204,2,202,1,2,1,3,2,102,101,101,101,13
"1136",35,"[40]cIdHoIAueBkDkrDEvAItElbKDeewyHwnJHqvbGqa",204,0.990338,40,207,2,205,1,2,1,3,2,107,106,99,99,13
"1137",36,"[40]cIdHoIAueBkDkrDEvAItElbKDeewyHwnJHqvbGqa",209,0.990566,40,212,2,210,1,2,1,3,2,115,114,96,96,13
"1138",37,"[40]cIdHoIAueBkDkrDEvAItElbKDeewyHwnJHqvbGqa",212,0.990698,40,215,2,213,1,2,1,3,2,114,113,100,100,13
"1139",38,"[40]cIdHoIAueBkDkrDEvAItElbKDeewyHwnJHqvbGqa",202,0.990244,40,205,2,203,1,2,1,3,2,102,101,102,102,13
"1140",39,"[40]cIdHoIAueBkDkrDEvAItElbKDeewyHwnJHqvbGqa",212,0.990698,40,215,2,213,1,2,1,3,2,117,116,97,97,13
"1141",40,"[40]cIdHoIAueBkDkrDEvAItElbKDeewyHwnJHqvbGqa",197,0.99,40,200,2,198,1,2,1,3,2,97,96,102,102,13
"1142",41,"[40]cIdHoIAueBkDkrDEvAItElbKDeewyHwnJHqvbGqa",199,0.990099,40,202,2,200,1,2,1,3,2,101,100,100,100,13
"1143",42,"[40]cIdHoIAueBkDkrDEvAItElbKDeewyHwnJHqvbGqa",204,0.990338,40,207,2,205,1,2,1,3,2,107,106,99,99,13
"1144",43,"[40]cIdHoIAueBkDkrDEvAItElbKDeewyHwnJHqvbGqa",186,0.989418,40,189,2,187,1,2,1,3,2,83,82,105,105,13
"1145",44,"[40]cIdHoIAueBkDkrDEvAItElbKDeewyHwnJHqvbGqa",194,0.989848,40,197,2,195,1,2,1,3,2,93,92,103,103,13
"1146",45,"[40]cIdHoIAueBkDkrDEvAItElbKDeewyHwnJHqvbGqa",198,0.99005,40,201,2,199,1,2,1,3,2,98,97,102,102,13
"1147",46,"[40]cIdHoIAueBkDkrDEvAItElbKDeewyHwnJHqvbGqa",194,0.989848,40,197,2,195,1,2,1,3,2,94,93,102,102,13
"1148",47,"[40]cIdHoIAueBkDkrDEvAItElbKDeewyHwnJHqvbGqa",200,0.990148,40,203,2,201,1,2,1,3,2,102,101,100,100,13
"1149",48,"[40]cIdHoIAueBkDkrDEvAItElbKDeewyHwnJHqvbGqa",206,0.990431,40,209,2,207,1,2,1,3,2,110,109,98,98,13
"1150",49,"[40]cIdHoIAueBkDkrDEvAItElbKDeewyHwnJHqvbGqa",192,0.989744,40,195,2,193,1,2,1,3,2,89,88,105,105,13
"1151",50,"[40]cIdHoIAueBkDkrDEvAItElbKDeewyHwnJHqvbGqa",209,0.990566,40,212,2,210,1,2,1,3,2,113,112,98,98,13
"1152",51,"[40]cIdHoIAueBkDkrDEvAItElbKDeewyHwnJHqvbGqa",194,0.989848,40,197,2,195,1,2,1,3,2,93,92,103,103,13
"1153",52,"[40]cIdHoIAueBkDkrDEvAItElbKDeewyHwnJHqvbGqa",200,0.990148,40,203,2,201,1,2,1,3,2,103,102,99,99,13
"1154",53,"[40]cIdHoIAueBkDkrDEvAItElbKDeewyHwnJHqvbGqa",191,0.989691,40,194,2,192,1,2,1,3,2,88,87,105,105,13
"1155",54,"[40]cIdHoIAueBkDkrDEvAItElbKDeewyHwnJHqvbGqa",194,0.989848,40,197,2,195,1,2,1,3,2,93,92,103,103,13
"1156",55,"[40]cIdHoIAueBkDkrDEvAItElbKDeewyHwnJHqvbGqa",198,0.99005,40,201,2,199,1,2,1,3,2,96,95,104,104,13
"1157",56,"[40]cIdHoIAueBkDkrDEvAItElbKDeewyHwnJHqvbGqa",212,0.990698,40,215,2,213,1,2,1,3,2,118,117,96,96,13
"1158",57,"[40]cIdHoIAueBkDkrDEvAItElbKDeewyHwnJHqvbGqa",186,0.989418,40,189,2,187,1,2,1,3,2,82,81,106,106,13
"1159",58,"[40]cIdHoIAueBkDkrDEvAItElbKDeewyHwnJHqvbGqa",208,0.990521,40,211,2,209,1,2,1,3,2,112,111,98,98,13
"1160",59,"[40]cIdHoIAueBkDkrDEvAItElbKDeewyHwnJHqvbGqa",201,0.990196,40,204,2,202,1,2,1,3,2,103,102,100,100,13
"1161",60,"[40]cIdHoIAueBkDkrDEvAItElbKDeewyHwnJHqvbGqa",202,0.990244,40,205,2,203,1,2,1,3,2,103,102,101,101,13
"1162",61,"[40]cIdHoIAueBkDkrDEvAItElbKDeewyHwnJHqvbGqa",198,0.99005,40,201,2,199,1,2,1,3,2,100,99,100,100,13
"1163",62,"[40]cIdHoIAueBkDkrDEvAItElbKDeewyHwnJHqvbGqa",197,0.99,40,200,2,198,1,2,1,3,2,95,94,104,104,13
"1164",63,"[40]cIdHoIAueBkDkrDEvAItElbKDeewyHwnJHqvbGqa",196,0.98995,40,199,2,197,1,2,1,3,2,98,97,100,100,13
"1165",64,"[40]cIdHoIAueBkDkrDEvAItElbKDeewyHwnJHqvbGqa",204,0.990338,40,207,2,205,1,2,1,3,2,107,106,99,99,13
"1166",65,"[40]cIdHoIAueBkDkrDEvAItElbKDeewyHwnJHqvbGqa",200,0.990148,40,203,2,201,1,2,1,3,2,101,100,101,101,13
"1167",66,"[40]cIdHoIAueBkDkrDEvAItElbKDeewyHwnJHqvbGqa",199,0.990099,40,202,2,200,1,2,1,3,2,99,98,102,102,13
"1168",67,"[40]cIdHoIAueBkDkrDEvAItElbKDeewyHwnJHqvbGqa",199,0.990099,40,202,2,200,1,2,1,3,2,100,99,101,101,13
"1169",68,"[40]cIdHoIAueBkDkrDEvAItElbKDeewyHwnJHqvbGqa",204,0.990338,40,207,2,205,1,2,1,3,2,108,107,98,98,13
"1170",69,"[40]cIdHoIAueBkDkrDEvAItElbKDeewyHwnJHqvbGqa",184,0.989305,40,187,2,185,1,2,1,3,2,80,79,106,106,13
"1171",70,"[40]cIdHoIAueBkDkrDEvAItElbKDeewyHwnJHqvbGqa",203,0.990291,40,206,2,204,1,2,1,3,2,105,104,100,100,13
"1172",71,"[40]cIdHoIAueBkDkrDEvAItElbKDeewyHwnJHqvbGqa",192,0.989744,40,195,2,193,1,2,1,3,2,90,89,104,104,13
"1173",72,"[40]cIdHoIAueBkDkrDEvAItElbKDeewyHwnJHqvbGqa",191,0.989691,40,194,2,192,1,2,1,3,2,87,86,106,106,13
"1174",73,"[40]cIdHoIAueBkDkrDEvAItElbKDeewyHwnJHqvbGqa",207,0.990476,40,210,2,208,1,2,1,3,2,112,111,97,97,13
"1175",74,"[40]cIdHoIAueBkDkrDEvAItElbKDeewyHwnJHqvbGqa",206,0.990431,40,209,2,207,1,2,1,3,2,109,108,99,99,13
"1176",75,"[40]cIdHoIAueBkDkrDEvAItElbKDeewyHwnJHqvbGqa",197,0.99,40,200,2,198,1,2,1,3,2,98,97,101,101,13
"1177",76,"[40]cIdHoIAueBkDkrDEvAItElbKDeewyHwnJHqvbGqa",185,0.989362,40,188,2,186,1,2,1,3,2,82,81,105,105,13
"1178",77,"[40]cIdHoIAueBkDkrDEvAItElbKDeewyHwnJHqvbGqa",179,0.989011,40,182,2,180,1,2,1,3,2,72,71,109,109,13
"1179",78,"[40]cIdHoIAueBkDkrDEvAItElbKDeewyHwnJHqvbGqa",194,0.989848,40,197,2,195,1,2,1,3,2,95,94,101,101,13
"1180",79,"[40]cIdHoIAueBkDkrDEvAItElbKDeewyHwnJHqvbGqa",198,0.99005,40,201,2,199,1,2,1,3,2,98,97,102,102,13
"1181",80,"[40]cIdHoIAueBkDkrDEvAItElbKDeewyHwnJHqvbGqa",194,0.989848,40,197,2,195,1,2,1,3,2,94,93,102,102,13
"1182",81,"[40]cIdHoIAueBkDkrDEvAItElbKDeewyHwnJHqvbGqa",189,0.989583,40,192,2,190,1,2,1,3,2,88,87,103,103,13
"1183",82,"[40]cIdHoIAueBkDkrDEvAItElbKDeewyHwnJHqvbGqa",199,0.990099,40,202,2,200,1,2,1,3,2,101,100,100,100,13
"1184",83,"[40]cIdHoIAueBkDkrDEvAItElbKDeewyHwnJHqvbGqa",199,0.990099,40,202,2,200,1,2,1,3,2,100,99,101,101,13
"1185",84,"[40]cIdHoIAueBkDkrDEvAItElbKDeewyHwnJHqvbGqa",199,0.990099,40,202,2,200,1,2,1,3,2,98,97,103,103,13
"1186",85,"[40]cIdHoIAueBkDkrDEvAItElbKDeewyHwnJHqvbGqa",193,0.989796,40,196,2,194,1,2,1,3,2,92,91,103,103,13
"1187",86,"[40]cIdHoIAueBkDkrDEvAItElbKDeewyHwnJHqvbGqa",205,0.990385,40,208,2,206,1,2,1,3,2,109,108,98,98,13
"1188",87,"[40]cIdHoIAueBkDkrDEvAItElbKDeewyHwnJHqvbGqa",186,0.989418,40,189,2,187,1,2,1,3,2,83,82,105,105,13
"1189",88,"[40]cIdHoIAueBkDkrDEvAItElbKDeewyHwnJHqvbGqa",201,0.990196,40,204,2,202,1,2,1,3,2,104,103,99,99,13
"1190",89,"[40]cIdHoIAueBkDkrDEvAItElbKDeewyHwnJHqvbGqa",212,0.990698,40,215,2,213,1,2,1,3,2,117,116,97,97,13
"1191",90,"[40]cIdHoIAueBkDkrDEvAItElbKDeewyHwnJHqvbGqa",197,0.99,40,200,2,198,1,2,1,3,2,96,95,103,103,13
"1192",91,"[40]cIdHoIAueBkDkrDEvAItElbKDeewyHwnJHqvbGqa",202,0.990244,40,205,2,203,1,2,1,3,2,104,103,100,100,13
"1193",92,"[40]cIdHoIAueBkDkrDEvAItElbKDeewyHwnJHqvbGqa",207,0.990476,40,210,2,208,1,2,1,3,2,110,109,99,99,13
"1194",93,"[40]cIdHoIAueBkDkrDEvAItElbKDeewyHwnJHqvbGqa",204,0.990338,40,207,2,205,1,2,1,3,2,105,104,101,101,13
"1195",94,"[40]cIdHoIAueBkDkrDEvAItElbKDeewyHwnJHqvbGqa",192,0.989744,40,195,2,193,1,2,1,3,2,91,90,103,103,13
"1196",95,"[40]cIdHoIAueBkDkrDEvAItElbKDeewyHwnJHqvbGqa",209,0.990566,40,212,2,210,1,2,1,3,2,110,109,101,101,13
"1197",96,"[40]cIdHoIAueBkDkrDEvAItElbKDeewyHwnJHqvbGqa",195,0.989899,40,198,2,196,1,2,1,3,2,95,94,102,102,13
"1198",97,"[40]cIdHoIAueBkDkrDEvAItElbKDeewyHwnJHqvbGqa",215,0.990826,40,218,2,216,1,2,1,3,2,121,120,96,96,13
"1199",98,"[40]cIdHoIAueBkDkrDEvAItElbKDeewyHwnJHqvbGqa",201,0.990196,40,204,2,202,1,2,1,3,2,104,103,99,99,13
"1200",99,"[40]cIdHoIAueBkDkrDEvAItElbKDeewyHwnJHqvbGqa",196,0.98995,40,199,2,197,1,2,1,3,2,95,94,103,103,13
"1201",0,"[39]iIyHoIAnEBlDiyscduzmnvxeaobKHvnJHqvbGqa",221,0.991071,39,224,2,222,1,2,1,3,2,119,118,104,104,14
"1202",1,"[39]iIyHoIAnEBlDiyscduzmnvxeaobKHvnJHqvbGqa",210,0.99061,39,213,2,211,1,2,1,3,2,102,101,110,110,14
"1203",2,"[39]iIyHoIAnEBlDiyscduzmnvxeaobKHvnJHqvbGqa",217,0.990909,39,220,2,218,1,2,1,3,2,111,110,108,108,14
"1204",3,"[39]iIyHoIAnEBlDiyscduzmnvxeaobKHvnJHqvbGqa",219,0.990991,39,222,2,220,1,2,1,3,2,115,114,106,106,14
"1205",4,"[39]iIyHoIAnEBlDiyscduzmnvxeaobKHvnJHqvbGqa",236,0.991632,39,239,2,237,1,2,1,3,2,139,138,99,99,14
"1206",5,"[39]iIyHoIAnEBlDiyscduzmnvxeaobKHvnJHqvbGqa",214,0.990783,39,217,2,215,1,2,1,3,2,104,103,112,112,14
"1207",6,"[39]iIyHoIAnEBlDiyscduzmnvxeaobKHvnJHqvbGqa",216,0.990868,39,219,2,217,1,2,1,3,2,108,107,110,110,14
"1208",7,"[39]iIyHoIAnEBlDiyscduzmnvxeaobKHvnJHqvbGqa",217,0.990909,39,220,2,218,1,2,1,3,2,108,107,111,111,14
"1209",8,"[39]iIyHoIAnEBlDiyscduzmnvxeaobKHvnJHqvbGqa",221,0.991071,39,224,2,222,1,2,1,3,2,119,118,104,104,14
"1210",9,"[39]iIyHoIAnEBlDiyscduzmnvxeaobKHvnJHqvbGqa",200,0.990148,39,203,2,201,1,2,1,3,2,89,88,113,113,14
"1211",10,"[39]iIyHoIAnEBlDiyscduzmnvxeaobKHvnJHqvbGqa",230,0.991416,39,233,2,231,1,2,1,3,2,129,128,103,103,14
"1212",11,"[39]iIyHoIAnEBlDiyscduzmnvxeaobKHvnJHqvbGqa",212,0.990698,39,215,2,213,1,2,1,3,2,102,101,112,112,14
"1213",12,"[39]iIyHoIAnEBlDiyscduzmnvxeaobKHvnJHqvbGqa",202,0.990244,39,205,2,203,1,2,1,3,2,92,91,112,112,14
"1214",13,"[39]iIyHoIAnEBlDiyscduzmnvxeaobKHvnJHqvbGqa",212,0.990698,39,215,2,213,1,2,1,3,2,103,102,111,111,14
"1215",14,"[39]iIyHoIAnEBlDiyscduzmnvxeaobKHvnJHqvbGqa",210,0.99061,39,213,2,211,1,2,1,3,2,101,100,111,111,14
"1216",15,"[39]iIyHoIAnEBlDiyscduzmnvxeaobKHvnJHqvbGqa",209,0.990566,39,212,2,210,1,2,1,3,2,100,99,111,111,14
"1217",16,"[39]iIyHoIAnEBlDiyscduzmnvxeaobKHvnJHqvbGqa",211,0.990654,39,214,2,212,1,2,1,3,2,102,101,111,111,14
"1218",17,"[39]iIyHoIAnEBlDiyscduzmnvxeaobKHvnJHqvbGqa",217,0.990909,39,220,2,218,1,2,1,3,2,111,110,108,108,14
"1219",18,"[39]iIyHoIAnEBlDiyscduzmnvxeaobKHvnJHqvbGqa",215,0.990826,39,218,2,216,1,2,1,3,2,107,106,110,110,14
"1220",19,"[39]iIyHoIAnEBlDiyscduzmnvxeaobKHvnJHqvbGqa",213,0.990741,39,216,2,214,1,2,1,3,2,105,104,110,110,14
"1221",20,"[39]iIyHoIAnEBlDiyscduzmnvxeaobKHvnJHqvbGqa",220,0.991031,39,223,2,221,1,2,1,3,2,113,112,109,109,14
"1222",21,"[39]iIyHoIAnEBlDiyscduzmnvxeaobKHvnJHqvbGqa",202,0.990244,39,205,2,203,1,2,1,3,2,86,85,118,118,14
"1223",22,"[39]iIyHoIAnEBlDiyscduzmnvxeaobKHvnJHqvbGqa",201,0.990196,39,204,2,202,1,2,1,3,2,89,88,114,114,14
"1224",23,"[39]iIyHoIAnEBlDiyscduzmnvxeaobKHvnJHqvbGqa",212,0.990698,39,215,2,213,1,2,1,3,2,102,101,112,112,14
"1225",24,"[39]iIyHoIAnEBlDiyscduzmnvxeaobKHvnJHqvbGqa",221,0.991071,39,224,2,222,1,2,1,3,2,114,113,109,109,14
"1226",25,"[39]iIyHoIAnEBlDiyscduzmnvxeaobKHvnJHqvbGqa",211,0.990654,39,214,2,212,1,2,1,3,2,99,98,114,114,14
"1227",26,"[39]iIyHoIAnEBlDiyscduzmnvxeaobKHvnJHqvbGqa",221,0.991071,39,224,2,222,1,2,1,3,2,116,115,107,107,14
"1228",27,"[39]iIyHoIAnEBlDiyscduzmnvxeaobKHvnJHqvbGqa",203,0.990291,39,206,2,204,1,2,1,3,2,91,90,114,114,14
"1229",28,"[39]iIyHoIAnEBlDiyscduzmnvxeaobKHvnJHqvbGqa",217,0.990909,39,220,2,218,1,2,1,3,2,113,112,106,106,14
"1230",29,"[39]iIyHoIAnEBlDiyscduzmnvxeaobKHvnJHqvbGqa",233,0.991525,39,236,2,234,1,2,1,3,2,136,135,99,99,14
"1231",30,"[39]iIyHoIAnEBlDiyscduzmnvxeaobKHvnJHqvbGqa",227,0.991304,39,230,2,228,1,2,1,3,2,124,123,105,105,14
"1232",31,"[39]iIyHoIAnEBlDiyscduzmnvxeaobKHvnJHqvbGqa",213,0.990741,39,216,2,214,1,2,1,3,2,104,103,111,111,14
"1233",32,"[39]iIyHoIAnEBlDiyscduzmnvxeaobKHvnJHqvbGqa",207,0.990476,39,210,2,208,1,2,1,3,2,96,95,113,113,14
"1234",33,"[39]iIyHoIAnEBlDiyscduzmnvxeaobKHvnJHqvbGqa",219,0.990991,39,222,2,220,1,2,1,3,2,114,113,107,107,14
"1235",34,"[39]iIyHoIAnEBlDiyscduzmnvxeaobKHvnJHqvbGqa",219,0.990991,39,222,2,220,1,2,1,3,2,116,115,105,105,14
"1236",35,"[39]iIyHoIAnEBlDiyscduzmnvxeaobKHvnJHqvbGqa",211,0.990654,39,214,2,212,1,2,1,3,2,105,104,108,108,14
"1237",36,"[39]iIyHoIAnEBlDiyscduzmnvxeaobKHvnJHqvbGqa",214,0.990783,39,217,2,215,1,2,1,3,2,108,107,108,108,14
"1238",37,"[39]iIyHoIAnEBlDiyscduzmnvxeaobKHvnJHqvbGqa",216,0.990868,39,219,2,217,1,2,1,3,2,110,109,108,108,14
"1239",38,"[39]iIyHoIAnEBlDiyscduzmnvxeaobKHvnJHqvbGqa",207,0.990476,39,210,2,208,1,2,1,3,2,96,95,113,113,14
"1240",39,"[39]iIyHoIAnEBlDiyscduzmnvxeaobKHvnJHqvbGqa",222,0.991111,39,225,2,223,1,2,1,3,2,118,117,106,106,14
"1241",40,"[39]iIyHoIAnEBlDiyscduzmnvxeaobKHvnJHqvbGqa",229,0.991379,39,232,2,230,1,2,1,3,2,131,130,100,100,14
"1242",41,"[39]iIyHoIAnEBlDiyscduzmnvxeaobKHvnJHqvbGqa",224,0.991189,39,227,2,225,1,2,1,3,2,119,118,107,107,14
"1243",42,"[39]iIyHoIAnEBlDiyscduzmnvxeaobKHvnJHqvbGqa",236,0.991632,39,239,2,237,1,2,1,3,2,138,137,100,100,14
"1244",43,"[39]iIyHoIAnEBlDiyscduzmnvxeaobKHvnJHqvbGqa",221,0.991071,39,224,2,222,1,2,1,3,2,118,117,105,105,14
"1245",44,"[39]iIyHoIAnEBlDiyscduzmnvxeaobKHvnJHqvbGqa",225,0.991228,39,228,2,226,1,2,1,3,2,123,122,104,104,14
"1246",45,"[39]iIyHoIAnEBlDiyscduzmnvxeaobKHvnJHqvbGqa",225,0.991228,39,228,2,226,1,2,1,3,2,123,122,104,104,14
"1247",46,"[39]iIyHoIAnEBlDiyscduzmnvxeaobKHvnJHqvbGqa",226,0.991266,39,229,2,227,1,2,1,3,2,125,124,103,103,14
"1248",47,"[39]iIyHoIAnEBlDiyscduzmnvxeaobKHvnJHqvbGqa",195,0.989899,39,198,2,196,1,2,1,3,2,80,79,117,117,14
"1249",48,"[39]iIyHoIAnEBlDiyscduzmnvxeaobKHvnJHqvbGqa",225,0.991228,39,228,2,226,1,2,1,3,2,121,120,106,106,14
"1250",49,"[39]iIyHoIAnEBlDiyscduzmnvxeaobKHvnJHqvbGqa",224,0.991189,39,227,2,225,1,2,1,3,2,121,120,105,105,14
"1251",50,"[39]iIyHoIAnEBlDiyscduzmnvxeaobKHvnJHqvbGqa",206,0.990431,39,209,2,207,1,2,1,3,2,96,95,112,112,14
"1252",51,"[39]iIyHoIAnEBlDiyscduzmnvxeaobKHvnJHqvbGqa",227,0.991304,39,230,2,228,1,2,1,3,2,124,123,105,105,14
"1253",52,"[39]iIyHoIAnEBlDiyscduzmnvxeaobKHvnJHqvbGqa",204,0.990338,39,207,2,205,1,2,1,3,2,92,91,114,114,14
"1254",53,"[39]iIyHoIAnEBlDiyscduzmnvxeaobKHvnJHqvbGqa",208,0.990521,39,211,2,209,1,2,1,3,2,101,100,109,109,14
"1255",54,"[39]iIyHoIAnEBlDiyscduzmnvxeaobKHvnJHqvbGqa",222,0.991111,39,225,2,223,1,2,1,3,2,119,118,105,105,14
"1256",55,"[39]iIyHoIAnEBlDiyscduzmnvxeaobKHvnJHqvbGqa",223,0.99115,39,226,2,224,1,2,1,3,2,120,119,105,105,14
"1257",56,"[39]iIyHoIAnEBlDiyscduzmnvxeaobKHvnJHqvbGqa",232,0.991489,39,235,2,233,1,2,1,3,2,130,129,104,104,14
"1258",57,"[39]iIyHoIAnEBlDiyscduzmnvxeaobKHvnJHqvbGqa",224,0.991189,39,227,2,225,1,2,1,3,2,122,121,104,104,14
"1259",58,"[39]iIyHoIAnEBlDiyscduzmnvxeaobKHvnJHqvbGqa",211,0.990654,39,214,2,212,1,2,1,3,2,103,102,110,110,14
"1260",59,"[39]iIyHoIAnEBlDiyscduzmnvxeaobKHvnJHqvbGqa",231,0.991453,39,234,2,232,1,2,1,3,2,133,132,100,100,14
"1261",60,"[39]iIyHoIAnEBlDiyscduzmnvxeaobKHvnJHqvbGqa",222,0.991111,39,225,2,223,1,2,1,3,2,118,117,106,106,14
"1262",61,"[39]iIyHoIAnEBlDiyscduzmnvxeaobKHvnJHqvbGqa",221,0.991071,39,224,2,222,1,2,1,3,2,115,114,108,108,14
"1263",62,"[39]iIyHoIAnEBlDiyscduzmnvxeaobKHvnJHqvbGqa",216,0.990868,39,219,2,217,1,2,1,3,2,110,109,108,108,14
"1264",63,"[39]iIyHoIAnEBlDiyscduzmnvxeaobKHvnJHqvbGqa",199,0.990099,39,202,2,200,1,2,1,3,2,86,85,115,115,14
"1265",64,"[39]iIyHoIAnEBlDiyscduzmnvxeaobKHvnJHqvbGqa",208,0.990521,39,211,2,209,1,2,1,3,2,99,98,111,111,14
"1266",65,"[39]iIyHoIAnEBlDiyscduzmnvxeaobKHvnJHqvbGqa",213,0.990741,39,216,2,214,1,2,1,3,2,108,107,107,107,14
"1267",66,"[39]iIyHoIAnEBlDiyscduzmnvxeaobKHvnJHqvbGqa",212,0.990698,39,215,2,213,1,2,1,3,2,105,104,109,109,14
"1268",67,"[39]iIyHoIAnEBlDiyscduzmnvxeaobKHvnJHqvbGqa",222,0.991111,39,225,2,223,1,2,1,3,2,121,120,103,103,14
"1269",68,"[39]iIyHoIAnEBlDiyscduzmnvxeaobKHvnJHqvbGqa",216,0.990868,39,219,2,217,1,2,1,3,2,107,106,111,111,14
"1270",69,"[39]iIyHoIAnEBlDiyscduzmnvxeaobKHvnJHqvbGqa",225,0.991228,39,228,2,226,1,2,1,3,2,122,121,105,105,14
"1271",70,"[39]iIyHoIAnEBlDiyscduzmnvxeaobKHvnJHqvbGqa",215,0.990826,39,218,2,216,1,2,1,3,2,108,107,109,109,14
"1272",71,"[39]iIyHoIAnEBlDiyscduzmnvxeaobKHvnJHqvbGqa",214,0.990783,39,217,2,215,1,2,1,3,2,110,109,106,106,14
"1273",72,"[39]iIyHoIAnEBlDiyscduzmnvxeaobKHvnJHqvbGqa",210,0.99061,39,213,2,211,1,2,1,3,2,103,102,109,109,14
"1274",73,"[39]iIyHoIAnEBlDiyscduzmnvxeaobKHvnJHqvbGqa",225,0.991228,39,228,2,226,1,2,1,3,2,119,118,108,108,14
"1275",74,"[39]iIyHoIAnEBlDiyscduzmnvxeaobKHvnJHqvbGqa",215,0.990826,39,218,2,216,1,2,1,3,2,106,105,111,111,14
"1276",75,"[39]iIyHoIAnEBlDiyscduzmnvxeaobKHvnJHqvbGqa",224,0.991189,39,227,2,225,1,2,1,3,2,121,120,105,105,14
"1277",76,"[39]iIyHoIAnEBlDiyscduzmnvxeaobKHvnJHqvbGqa",223,0.99115,39,226,2,224,1,2,1,3,2,119,118,106,106,14
"1278",77,"[39]iIyHoIAnEBlDiyscduzmnvxeaobKHvnJHqvbGqa",215,0.990826,39,218,2,216,1,2,1,3,2,108,107,109,109,14
"1279",78,"[39]iIyHoIAnEBlDiyscduzmnvxeaobKHvnJHqvbGqa",223,0.99115,39,226,2,224,1,2,1,3,2,122,121,103,103,14
"1280",79,"[39]iIyHoIAnEBlDiyscduzmnvxeaobKHvnJHqvbGqa",213,0.990741,39,216,2,214,1,2,1,3,2,103,102,112,112,14
"1281",80,"[39]iIyHoIAnEBlDiyscduzmnvxeaobKHvnJHqvbGqa",203,0.990291,39,206,2,204,1,2,1,3,2,90,89,115,115,14
"1282",81,"[39]iIyHoIAnEBlDiyscduzmnvxeaobKHvnJHqvbGqa",209,0.990566,39,212,2,210,1,2,1,3,2,102,101,109,109,14
"1283",82,"[39]iIyHoIAnEBlDiyscduzmnvxeaobKHvnJHqvbGqa",212,0.990698,39,215,2,213,1,2,1,3,2,103,102,111,111,14
"1284",83,"[39]iIyHoIAnEBlDiyscduzmnvxeaobKHvnJHqvbGqa",210,0.99061,39,213,2,211,1,2,1,3,2,102,101,110,110,14
"1285",84,"[39]iIyHoIAnEBlDiyscduzmnvxeaobKHvnJHqvbGqa",207,0.990476,39,210,2,208,1,2,1,3,2,95,94,114,114,14
"1286",85,"[39]iIyHoIAnEBlDiyscduzmnvxeaobKHvnJHqvbGqa",217,0.990909,39,220,2,218,1,2,1,3,2,109,108,110,110,14
"1287",86,"[39]iIyHoIAnEBlDiyscduzmnvxeaobKHvnJHqvbGqa",208,0.990521,39,211,2,209,1,2,1,3,2,97,96,113,113,14
"1288",87,"[39]iIyHoIAnEBlDiyscduzmnvxeaobKHvnJHqvbGqa",218,0.99095,39,221,2,219,1,2,1,3,2,110,109,110,110,14
"1289",88,"[39]iIyHoIAnEBlDiyscduzmnvxeaobKHvnJHqvbGqa",210,0.99061,39,213,2,211,1,2,1,3,2,99,98,113,113,14
"1290",89,"[39]iIyHoIAnEBlDiyscduzmnvxeaobKHvnJHqvbGqa",222,0.991111,39,225,2,223,1,2,1,3,2,120,119,104,104,14
"1291",90,"[39]iIyHoIAnEBlDiyscduzmnvxeaobKHvnJHqvbGqa",219,0.990991,39,222,2,220,1,2,1,3,2,114,113,107,107,14
"1292",91,"[39]iIyHoIAnEBlDiyscduzmnvxeaobKHvnJHqvbGqa",210,0.99061,39,213,2,211,1,2,1,3,2,101,100,111,111,14
"1293",92,"[39]iIyHoIAnEBlDiyscduzmnvxeaobKHvnJHqvbGqa",212,0.990698,39,215,2,213,1,2,1,3,2,102,101,112,112,14
"1294",93,"[39]iIyHoIAnEBlDiyscduzmnvxeaobKHvnJHqvbGqa",218,0.99095,39,221,2,219,1,2,1,3,2,114,113,106,106,14
"1295",94,"[39]iIyHoIAnEBlDiyscduzmnvxeaobKHvnJHqvbGqa",204,0.990338,39,207,2,205,1,2,1,3,2,93,92,113,113,14
"1296",95,"[39]iIyHoIAnEBlDiyscduzmnvxeaobKHvnJHqvbGqa",227,0.991304,39,230,2,228,1,2,1,3,2,123,122,106,106,14
"1297",96,"[39]iIyHoIAnEBlDiyscduzmnvxeaobKHvnJHqvbGqa",220,0.991031,39,223,2,221,1,2,1,3,2,117,116,105,105,14
"1298",97,"[39]iIyHoIAnEBlDiyscduzmnvxeaobKHvnJHqvbGqa",217,0.990909,39,220,2,218,1,2,1,3,2,111,110,108,108,14
"1299",98,"[39]iIyHoIAnEBlDiyscduzmnvxeaobKHvnJHqvbGqa",221,0.991071,39,224,2,222,1,2,1,3,2,116,115,107,107,14
"1300",99,"[39]iIyHoIAnEBlDiyscduzmnvxeaobKHvnJHqvbGqa",211,0.990654,39,214,2,212,1,2,1,3,2,105,104,108,108,14
"1301",0,"[40]CIzHoIkeBoDEJCwtBcEoDbhHyelxdHunJHqKHGqK",351,0.991573,40,356,3,353,1,3,2,5,3,169,168,185,185,15
"1302",1,"[40]CIzHoIkeBoDEJCwtBcEoDbhHyelxdHunJHqKHGqK",357,0.994444,40,360,2,358,1,2,1,3,2,193,192,166,166,15
"1303",2,"[40]CIzHoIkeBoDEJCwtBcEoDbhHyelxdHunJHqKHGqK",352,0.994366,40,355,2,353,1,2,1,3,2,170,169,184,184,15
"1304",3,"[40]CIzHoIkeBoDEJCwtBcEoDbhHyelxdHunJHqKHGqK",351,0.991573,40,356,3,353,1,3,2,5,3,169,168,185,185,15
"1305",4,"[40]CIzHoIkeBoDEJCwtBcEoDbhHyelxdHunJHqKHGqK",356,0.994429,40,359,2,357,1,2,1,3,2,178,177,180,180,15
"1306",5,"[40]CIzHoIkeBoDEJCwtBcEoDbhHyelxdHunJHqKHGqK",350,0.991549,40,355,3,352,1,3,2,5,3,179,178,174,174,15
"1307",6,"[40]CIzHoIkeBoDEJCwtBcEoDbhHyelxdHunJHqKHGqK",344,0.983099,40,355,6,349,1,6,5,11,6,186,185,164,164,15
"1308",7,"[40]CIzHoIkeBoDEJCwtBcEoDbhHyelxdHunJHqKHGqK",355,0.994413,40,358,2,356,1,2,1,3,2,198,197,159,159,15
"1309",8,"[40]CIzHoIkeBoDEJCwtBcEoDbhHyelxdHunJHqKHGqK",351,0.991573,40,356,3,353,1,3,2,5,3,175,174,179,179,15
"1310",9,"[40]CIzHoIkeBoDEJCwtBcEoDbhHyelxdHunJHqKHGqK",353,0.994382,40,356,2,354,1,2,1,3,2,191,190,164,164,15
"1311",10,"[40]CIzHoIkeBoDEJCwtBcEoDbhHyelxdHunJHqKHGqK",353,0.994382,40,356,2,354,1,2,1,3,2,165,164,190,190,15
"1312",11,"[40]CIzHoIkeBoDEJCwtBcEoDbhHyelxdHunJHqKHGqK",355,0.994413,40,358,2,356,1,2,1,3,2,190,189,167,167,15
"1313",12,"[40]CIzHoIkeBoDEJCwtBcEoDbhHyelxdHunJHqKHGqK",344,0.985836,40,353,5,348,1,5,4,9,5,174,173,175,175,15
"1314",13,"[40]CIzHoIkeBoDEJCwtBcEoDbhHyelxdHunJHqKHGqK",349,0.991525,40,354,3,351,1,3,2,5,3,175,174,177,177,15
"1315",14,"[40]CIzHoIkeBoDEJCwtBcEoDbhHyelxdHunJHqKHGqK",342,0.983003,40,353,6,347,1,6,5,11,6,183,182,165,165,15
"1316",15,"[40]CIzHoIkeBoDEJCwtBcEoDbhHyelxdHunJHqKHGqK",354,0.994398,40,357,2,355,1,2,1,3,2,182,181,174,174,15
"1317",16,"[40]CIzHoIkeBoDEJCwtBcEoDbhHyelxdHunJHqKHGqK",351,0.99435,40,354,2,352,1,2,1,3,2,168,167,185,185,15
"1318",17,"[40]CIzHoIkeBoDEJCwtBcEoDbhHyelxdHunJHqKHGqK",350,0.991549,40,355,3,352,1,3,2,5,3,181,180,172,172,15
"1319",18,"[40]CIzHoIkeBoDEJCwtBcEoDbhHyelxdHunJHqKHGqK",356,0.994429,40,359,2,357,1,2,1,3,2,174,173,184,184,15
"1320",19,"[40]CIzHoIkeBoDEJCwtBcEoDbhHyelxdHunJHqKHGqK",354,0.994398,40,357,2,355,1,2,1,3,2,186,185,170,170,15
"1321",20,"[40]CIzHoIkeBoDEJCwtBcEoDbhHyelxdHunJHqKHGqK",348,0.988732,40,355,4,351,1,4,3,7,4,179,178,173,173,15
"1322",21,"[40]CIzHoIkeBoDEJCwtBcEoDbhHyelxdHunJHqKHGqK",335,0.971751,40,354,10,344,1,10,9,19,10,171,170,174,174,15
"1323",22,"[40]CIzHoIkeBoDEJCwtBcEoDbhHyelxdHunJHqKHGqK",350,0.994334,40,353,2,351,1,2,1,3,2,162,161,190,190,15
"1324",23,"[40]CIzHoIkeBoDEJCwtBcEoDbhHyelxdHunJHqKHGqK",353,0.994382,40,356,2,354,1,2,1,3,2,179,178,176,176,15
"1325",24,"[40]CIzHoIkeBoDEJCwtBcEoDbhHyelxdHunJHqKHGqK",355,0.994413,40,358,2,356,1,2,1,3,2,205,204,152,152,15
"1326",25,"[40]CIzHoIkeBoDEJCwtBcEoDbhHyelxdHunJHqKHGqK",355,0.994413,40,358,2,356,1,2,1,3,2,191,190,166,166,15
"1327",26,"[40]CIzHoIkeBoDEJCwtBcEoDbhHyelxdHunJHqKHGqK",348,0.991501,40,353,3,350,1,3,2,5,3,166,165,185,185,15
"1328",27,"[40]CIzHoIkeBoDEJCwtBcEoDbhHyelxdHunJHqKHGqK",348,0.988732,40,355,4,351,1,4,3,7,4,175,174,177,177,15
"1329",28,"[40]CIzHoIkeBoDEJCwtBcEoDbhHyelxdHunJHqKHGqK",356,0.99169,40,361,3,358,1,3,2,5,3,185,184,174,174,15
"1330",29,"[40]CIzHoIkeBoDEJCwtBcEoDbhHyelxdHunJHqKHGqK",352,0.988858,40,359,4,355,1,4,3,7,4,195,194,161,161,15
"1331",30,"[40]CIzHoIkeBoDEJCwtBcEoDbhHyelxdHunJHqKHGqK",352,0.994366,40,355,2,353,1,2,1,3,2,171,170,183,183,15
"1332",31,"[40]CIzHoIkeBoDEJCwtBcEoDbhHyelxdHunJHqKHGqK",351,0.991573,40,356,3,353,1,3,2,5,3,180,179,174,174,15
"1333",32,"[40]CIzHoIkeBoDEJCwtBcEoDbhHyelxdHunJHqKHGqK",349,0.991525,40,354,3,351,1,3,2,5,3,169,168,183,183,15
"1334",33,"[40]CIzHoIkeBoDEJCwtBcEoDbhHyelxdHunJHqKHGqK",357,0.994444,40,360,2,358,1,2,1,3,2,169,168,190,190,15
"1335",34,"[40]CIzHoIkeBoDEJCwtBcEoDbhHyelxdHunJHqKHGqK",353,0.994382,40,356,2,354,1,2,1,3,2,167,166,188,188,15
"1336",35,"[40]CIzHoIkeBoDEJCwtBcEoDbhHyelxdHunJHqKHGqK",345,0.988636,40,352,4,348,1,4,3,7,4,170,169,179,179,15
"1337",36,"[40]CIzHoIkeBoDEJCwtBcEoDbhHyelxdHunJHqKHGqK",350,0.991549,40,355,3,352,1,3,2,5,3,181,180,172,172,15
"1338",37,"[40]CIzHoIkeBoDEJCwtBcEoDbhHyelxdHunJHqKHGqK",350,0.994334,40,353,2,351,1,2,1,3,2,161,160,191,191,15
"1339",38,"[40]CIzHoIkeBoDEJCwtBcEoDbhHyelxdHunJHqKHGqK",348,0.988732,40,355,4,351,1,4,3,7,4,180,179,172,172,15
"1340",39,"[40]CIzHoIkeBoDEJCwtBcEoDbhHyelxdHunJHqKHGqK",354,0.994398,40,357,2,355,1,2,1,3,2,182,181,174,174,15
"1341",40,"[40]CIzHoIkeBoDEJCwtBcEoDbhHyelxdHunJHqKHGqK",351,0.99435,40,354,2,352,1,2,1,3,2,174,173,179,179,15
"1342",41,"[40]CIzHoIkeBoDEJCwtBcEoDbhHyelxdHunJHqKHGqK",348,0.991501,40,353,3,350,1,3,2,5,3,167,166,184,184,15
"1343",42,"[40]CIzHoIkeBoDEJCwtBcEoDbhHyelxdHunJHqKHGqK",349,0.994318,40,352,2,350,1,2,1,3,2,161,160,190,190,15
"1344",43,"[40]CIzHoIkeBoDEJCwtBcEoDbhHyelxdHunJHqKHGqK",347,0.985955,40,356,5,351,1,5,4,9,5,178,177,174,174,15
"1345",44,"[40]CIzHoIkeBoDEJCwtBcEoDbhHyelxdHunJHqKHGqK",351,0.99435,40,354,2,352,1,2,1,3,2,167,166,186,186,15
"1346",45,"[40]CIzHoIkeBoDEJCwtBcEoDbhHyelxdHunJHqKHGqK",344,0.985836,40,353,5,348,1,5,4,9,5,189,188,160,160,15
"1347",46,"[40]CIzHoIkeBoDEJCwtBcEoDbhHyelxdHunJHqKHGqK",348,0.988732,40,355,4,351,1,4,3,7,4,185,184,167,167,15
"1348",47,"[40]CIzHoIkeBoDEJCwtBcEoDbhHyelxdHunJHqKHGqK",347,0.991477,40,352,3,349,1,3,2,5,3,157,156,193,193,15
"1349",48,"[40]CIzHoIkeBoDEJCwtBcEoDbhHyelxdHunJHqKHGqK",354,0.994398,40,357,2,355,1,2,1,3,2,172,171,184,184,15
"1350",49,"[40]CIzHoIkeBoDEJCwtBcEoDbhHyelxdHunJHqKHGqK",354,0.994398,40,357,2,355,1,2,1,3,2,177,176,179,179,15
"1351",50,"[40]CIzHoIkeBoDEJCwtBcEoDbhHyelxdHunJHqKHGqK",354,0.994398,40,357,2,355,1,2,1,3,2,177,176,179,179,15
"1352",51,"[40]CIzHoIkeBoDEJCwtBcEoDbhHyelxdHunJHqKHGqK",348,0.988732,40,355,4,351,1,4,3,7,4,166,165,186,186,15
"1353",52,"[40]CIzHoIkeBoDEJCwtBcEoDbhHyelxdHunJHqKHGqK",355,0.994413,40,358,2,356,1,2,1,3,2,186,185,171,171,15
"1354",53,"[40]CIzHoIkeBoDEJCwtBcEoDbhHyelxdHunJHqKHGqK",352,0.994366,40,355,2,353,1,2,1,3,2,175,174,179,179,15
"1355",54,"[40]CIzHoIkeBoDEJCwtBcEoDbhHyelxdHunJHqKHGqK",342,0.980282,40,355,7,348,1,7,6,13,7,188,187,161,161,15
"1356",55,"[40]CIzHoIkeBoDEJCwtBcEoDbhHyelxdHunJHqKHGqK",348,0.991501,40,353,3,350,1,3,2,5,3,172,171,179,179,15
"1357",56,"[40]CIzHoIkeBoDEJCwtBcEoDbhHyelxdHunJHqKHGqK",350,0.991549,40,355,3,352,1,3,2,5,3,176,175,177,177,15
"1358",57,"[40]CIzHoIkeBoDEJCwtBcEoDbhHyelxdHunJHqKHGqK",353,0.994382,40,356,2,354,1,2,1,3,2,170,169,185,185,15
"1359",58,"[40]CIzHoIkeBoDEJCwtBcEoDbhHyelxdHunJHqKHGqK",352,0.991597,40,357,3,354,1,3,2,5,3,192,191,163,163,15
"1360",59,"[40]CIzHoIkeBoDEJCwtBcEoDbhHyelxdHunJHqKHGqK",354,0.994398,40,357,2,355,1,2,1,3,2,187,186,169,169,15
"1361",60,"[40]CIzHoIkeBoDEJCwtBcEoDbhHyelxdHunJHqKHGqK",351,0.99435,40,354,2,352,1,2,1,3,2,169,168,184,184,15
"1362",61,"[40]CIzHoIkeBoDEJCwtBcEoDbhHyelxdHunJHqKHGqK",356,0.994429,40,359,2,357,1,2,1,3,2,190,189,168,168,15
"1363",62,"[40]CIzHoIkeBoDEJCwtBcEoDbhHyelxdHunJHqKHGqK",352,0.994366,40,355,2,353,1,2,1,3,2,174,173,180,180,15
"1364",63,"[40]CIzHoIkeBoDEJCwtBcEoDbhHyelxdHunJHqKHGqK",354,0.994398,40,357,2,355,1,2,1,3,2,190,189,166,166,15
"1365",64,"[40]CIzHoIkeBoDEJCwtBcEoDbhHyelxdHunJHqKHGqK",355,0.994413,40,358,2,356,1,2,1,3,2,191,190,166,166,15
"1366",65,"[40]CIzHoIkeBoDEJCwtBcEoDbhHyelxdHunJHqKHGqK",354,0.991643,40,359,3,356,1,3,2,5,3,186,185,171,171,15
"1367",66,"[40]CIzHoIkeBoDEJCwtBcEoDbhHyelxdHunJHqKHGqK",353,0.994382,40,356,2,354,1,2,1,3,2,180,179,175,175,15
"1368",67,"[40]CIzHoIkeBoDEJCwtBcEoDbhHyelxdHunJHqKHGqK",352,0.994366,40,355,2,353,1,2,1,3,2,168,167,186,186,15
"1369",68,"[40]CIzHoIkeBoDEJCwtBcEoDbhHyelxdHunJHqKHGqK",347,0.988701,40,354,4,350,1,4,3,7,4,179,178,172,172,15
"1370",69,"[40]CIzHoIkeBoDEJCwtBcEoDbhHyelxdHunJHqKHGqK",355,0.994413,40,358,2,356,1,2,1,3,2,173,172,184,184,15
"1371",70,"[40]CIzHoIkeBoDEJCwtBcEoDbhHyelxdHunJHqKHGqK",350,0.994334,40,353,2,351,1,2,1,3,2,160,159,192,192,15
"1372",71,"[40]CIzHoIkeBoDEJCwtBcEoDbhHyelxdHunJHqKHGqK",346,0.985915,40,355,5,350,1,5,4,9,5,195,194,156,156,15
"1373",72,"[40]CIzHoIkeBoDEJCwtBcEoDbhHyelxdHunJHqKHGqK",347,0.991477,40,352,3,349,1,3,2,5,3,151,150,199,199,15
"1374",73,"[40]CIzHoIkeBoDEJCwtBcEoDbhHyelxdHunJHqKHGqK",353,0.994382,40,356,2,354,1,2,1,3,2,178,177,177,177,15
"1375",74,"[40]CIzHoIkeBoDEJCwtBcEoDbhHyelxdHunJHqKHGqK",350,0.991549,40,355,3,352,1,3,2,5,3,181,180,172,172,15
"1376",75,"[40]CIzHoIkeBoDEJCwtBcEoDbhHyelxdHunJHqKHGqK",353,0.99162,40,358,3,355,1,3,2,5,3,182,181,174,174,15
"1377",76,"[40]CIzHoIkeBoDEJCwtBcEoDbhHyelxdHunJHqKHGqK",352,0.994366,40,355,2,353,1,2,1,3,2,180,179,174,174,15
"1378",77,"[40]CIzHoIkeBoDEJCwtBcEoDbhHyelxdHunJHqKHGqK",355,0.994413,40,358,2,356,1,2,1,3,2,197,196,160,160,15
"1379",78,"[40]CIzHoIkeBoDEJCwtBcEoDbhHyelxdHunJHqKHGqK",348,0.991501,40,353,3,350,1,3,2,5,3,165,164,186,186,15
"1380",79,"[40]CIzHoIkeBoDEJCwtBcEoDbhHyelxdHunJHqKHGqK",350,0.991549,40,355,3,352,1,3,2,5,3,168,167,185,185,15
"1381",80,"[40]CIzHoIkeBoDEJCwtBcEoDbhHyelxdHunJHqKHGqK",351,0.991573,40,356,3,353,1,3,2,5,3,183,182,171,171,15
"1382",81,"[40]CIzHoIkeBoDEJCwtBcEoDbhHyelxdHunJHqKHGqK",353,0.994382,40,356,2,354,1,2,1,3,2,170,169,185,185,15
"1383",82,"[40]CIzHoIkeBoDEJCwtBcEoDbhHyelxdHunJHqKHGqK",354,0.994398,40,357,2,355,1,2,1,3,2,178,177,178,178,15
"1384",83,"[40]CIzHoIkeBoDEJCwtBcEoDbhHyelxdHunJHqKHGqK",354,0.994398,40,357,2,355,1,2,1,3,2,183,182,173,173,15
"1385",84,"[40]CIzHoIkeBoDEJCwtBcEoDbhHyelxdHunJHqKHGqK",351,0.991573,40,356,3,353,1,3,2,5,3,187,186,167,167,15
"1386",85,"[40]CIzHoIkeBoDEJCwtBcEoDbhHyelxdHunJHqKHGqK",351,0.99435,40,354,2,352,1,2,1,3,2,170,169,183,183,15
"1387",86,"[40]CIzHoIkeBoDEJCwtBcEoDbhHyelxdHunJHqKHGqK",342,0.985755,40,351,5,346,1,5,4,9,5,172,171,175,175,15
"1388",87,"[40]CIzHoIkeBoDEJCwtBcEoDbhHyelxdHunJHqKHGqK",349,0.991525,40,354,3,351,1,3,2,5,3,171,170,181,181,15
"1389",88,"[40]CIzHoIkeBoDEJCwtBcEoDbhHyelxdHunJHqKHGqK",353,0.994382,40,356,2,354,1,2,1,3,2,169,168,186,186,15
"1390",89,"[40]CIzHoIkeBoDEJCwtBcEoDbhHyelxdHunJHqKHGqK",352,0.994366,40,355,2,353,1,2,1,3,2,173,172,181,181,15
"1391",90,"[40]CIzHoIkeBoDEJCwtBcEoDbhHyelxdHunJHqKHGqK",353,0.994382,40,356,2,354,1,2,1,3,2,178,177,177,177,15
"1392",91,"[40]CIzHoIkeBoDEJCwtBcEoDbhHyelxdHunJHqKHGqK",353,0.994382,40,356,2,354,1,2,1,3,2,183,182,172,172,15
"1393",92,"[40]CIzHoIkeBoDEJCwtBcEoDbhHyelxdHunJHqKHGqK",354,0.994398,40,357,2,355,1,2,1,3,2,184,183,172,172,15
"1394",93,"[40]CIzHoIkeBoDEJCwtBcEoDbhHyelxdHunJHqKHGqK",348,0.991501,40,353,3,350,1,3,2,5,3,164,163,187,187,15
"1395",94,"[40]CIzHoIkeBoDEJCwtBcEoDbhHyelxdHunJHqKHGqK",351,0.99435,40,354,2,352,1,2,1,3,2,162,161,191,191,15
"1396",95,"[40]CIzHoIkeBoDEJCwtBcEoDbhHyelxdHunJHqKHGqK",351,0.991573,40,356,3,353,1,3,2,5,3,193,192,161,161,15
"1397",96,"[40]CIzHoIkeBoDEJCwtBcEoDbhHyelxdHunJHqKHGqK",353,0.994382,40,356,2,354,1,2,1,3,2,170,169,185,185,15
"1398",97,"[40]CIzHoIkeBoDEJCwtBcEoDbhHyelxdHunJHqKHGqK",357,0.991713,40,362,3,359,1,3,2,5,3,191,190,169,169,15
"1399",98,"[40]CIzHoIkeBoDEJCwtBcEoDbhHyelxdHunJHqKHGqK",355,0.994413,40,358,2,356,1,2,1,3,2,186,185,171,171,15
"1400",99,"[40]CIzHoIkeBoDEJCwtBcEoDbhHyelxdHunJHqKHGqK",345,0.988636,40,352,4,348,1,4,3,7,4,164,163,185,185,15
"1401",0,"[40]yIzHoIaxGBkDwoCBiddyiHbKDeepyHtnJHqwbGqa",225,0.991228,40,228,2,226,1,2,1,3,2,134,133,93,93,17
"1402",1,"[40]yIzHoIaxGBkDwoCBiddyiHbKDeepyHtnJHqwbGqa",209,0.990566,40,212,2,210,1,2,1,3,2,114,113,97,97,17
"1403",2,"[40]yIzHoIaxGBkDwoCBiddyiHbKDeepyHtnJHqwbGqa",204,0.990338,40,207,2,205,1,2,1,3,2,109,108,97,97,17
"1404",3,"[40]yIzHoIaxGBkDwoCBiddyiHbKDeepyHtnJHqwbGqa",200,0.990148,40,203,2,201,1,2,1,3,2,101,100,101,101,17
"1405",4,"[40]yIzHoIaxGBkDwoCBiddyiHbKDeepyHtnJHqwbGqa",203,0.990291,40,206,2,204,1,2,1,3,2,105,104,100,100,17
"1406",5,"[40]yIzHoIaxGBkDwoCBiddyiHbKDeepyHtnJHqwbGqa",200,0.990148,40,203,2,201,1,2,1,3,2,104,103,98,98,17
"1407",6,"[40]yIzHoIaxGBkDwoCBiddyiHbKDeepyHtnJHqwbGqa",203,0.990291,40,206,2,204,1,2,1,3,2,106,105,99,99,17
"1408",7,"[40]yIzHoIaxGBkDwoCBiddyiHbKDeepyHtnJHqwbGqa",204,0.990338,40,207,2,205,1,2,1,3,2,106,105,100,100,17
"1409",8,"[40]yIzHoIaxGBkDwoCBiddyiHbKDeepyHtnJHqwbGqa",179,0.989011,40,182,2,180,1,2,1,3,2,72,71,109,109,17
"1410",9,"[40]yIzHoIaxGBkDwoCBiddyiHbKDeepyHtnJHqwbGqa",188,0.989529,40,191,2,189,1,2,1,3,2,85,84,105,105,17
"1411",10,"[40]yIzHoIaxGBkDwoCBiddyiHbKDeepyHtnJHqwbGqa",208,0.990521,40,211,2,209,1,2,1,3,2,113,112,97,97,17
"1412",11,"[40]yIzHoIaxGBkDwoCBiddyiHbKDeepyHtnJHqwbGqa",199,0.990099,40,202,2,200,1,2,1,3,2,97,96,104,104,17
"1413",12,"[40]yIzHoIaxGBkDwoCBiddyiHbKDeepyHtnJHqwbGqa",203,0.990291,40,206,2,204,1,2,1,3,2,106,105,99,99,17
"1414",13,"[40]yIzHoIaxGBkDwoCBiddyiHbKDeepyHtnJHqwbGqa",203,0.990291,40,206,2,204,1,2,1,3,2,104,103,101,101,17
"1415",14,"[40]yIzHoIaxGBkDwoCBiddyiHbKDeepyHtnJHqwbGqa",211,0.990654,40,214,2,212,1,2,1,3,2,116,115,97,97,17
"1416",15,"[40]yIzHoIaxGBkDwoCBiddyiHbKDeepyHtnJHqwbGqa",210,0.99061,40,213,2,211,1,2,1,3,2,115,114,97,97,17
"1417",16,"[40]yIzHoIaxGBkDwoCBiddyiHbKDeepyHtnJHqwbGqa",206,0.990431,40,209,2,207,1,2,1,3,2,109,108,99,99,17
"1418",17,"[40]yIzHoIaxGBkDwoCBiddyiHbKDeepyHtnJHqwbGqa",194,0.989848,40,197,2,195,1,2,1,3,2,94,93,102,102,17
"1419",18,"[40]yIzHoIaxGBkDwoCBiddyiHbKDeepyHtnJHqwbGqa",206,0.990431,40,209,2,207,1,2,1,3,2,110,109,98,98,17
"1420",19,"[40]yIzHoIaxGBkDwoCBiddyiHbKDeepyHtnJHqwbGqa",209,0.990566,40,212,2,210,1,2,1,3,2,114,113,97,97,17
"1421",20,"[40]yIzHoIaxGBkDwoCBiddyiHbKDeepyHtnJHqwbGqa",198,0.99005,40,201,2,199,1,2,1,3,2,97,96,103,103,17
"1422",21,"[40]yIzHoIaxGBkDwoCBiddyiHbKDeepyHtnJHqwbGqa",185,0.989362,40,188,2,186,1,2,1,3,2,81,80,106,106,17
"1423",22,"[40]yIzHoIaxGBkDwoCBiddyiHbKDeepyHtnJHqwbGqa",204,0.990338,40,207,2,205,1,2,1,3,2,108,107,98,98,17
"1424",23,"[40]yIzHoIaxGBkDwoCBiddyiHbKDeepyHtnJHqwbGqa",210,0.99061,40,213,2,211,1,2,1,3,2,113,112,99,99,17
"1425",24,"[40]yIzHoIaxGBkDwoCBiddyiHbKDeepyHtnJHqwbGqa",211,0.990654,40,214,2,212,1,2,1,3,2,117,116,96,96,17
"1426",25,"[40]yIzHoIaxGBkDwoCBiddyiHbKDeepyHtnJHqwbGqa",201,0.990196,40,204,2,202,1,2,1,3,2,103,102,100,100,17
"1427",26,"[40]yIzHoIaxGBkDwoCBiddyiHbKDeepyHtnJHqwbGqa",209,0.990566,40,212,2,210,1,2,1,3,2,114,113,97,97,17
"1428",27,"[40]yIzHoIaxGBkDwoCBiddyiHbKDeepyHtnJHqwbGqa",197,0.99,40,200,2,198,1,2,1,3,2,98,97,101,101,17
"1429",28,"[40]yIzHoIaxGBkDwoCBiddyiHbKDeepyHtnJHqwbGqa",198,0.99005,40,201,2,199,1,2,1,3,2,99,98,101,101,17
"1430",29,"[40]yIzHoIaxGBkDwoCBiddyiHbKDeepyHtnJHqwbGqa",201,0.990196,40,204,2,202,1,2,1,3,2,102,101,101,101,17
"1431",30,"[40]yIzHoIaxGBkDwoCBiddyiHbKDeepyHtnJHqwbGqa",216,0.990868,40,219,2,217,1,2,1,3,2,123,122,95,95,17
"1432",31,"[40]yIzHoIaxGBkDwoCBiddyiHbKDeepyHtnJHqwbGqa",202,0.990244,40,205,2,203,1,2,1,3,2,107,106,97,97,17
"1433",32,"[40]yIzHoIaxGBkDwoCBiddyiHbKDeepyHtnJHqwbGqa",192,0.989744,40,195,2,193,1,2,1,3,2,90,89,104,104,17
"1434",33,"[40]yIzHoIaxGBkDwoCBiddyiHbKDeepyHtnJHqwbGqa",206,0.990431,40,209,2,207,1,2,1,3,2,107,106,101,101,17
"1435",34,"[40]yIzHoIaxGBkDwoCBiddyiHbKDeepyHtnJHqwbGqa",209,0.990566,40,212,2,210,1,2,1,3,2,116,115,95,95,17
"1436",35,"[40]yIzHoIaxGBkDwoCBiddyiHbKDeepyHtnJHqwbGqa",195,0.989899,40,198,2,196,1,2,1,3,2,93,92,104,104,17
"1437",36,"[40]yIzHoIaxGBkDwoCBiddyiHbKDeepyHtnJHqwbGqa",198,0.99005,40,201,2,199,1,2,1,3,2,97,96,103,103,17
"1438",37,"[40]yIzHoIaxGBkDwoCBiddyiHbKDeepyHtnJHqwbGqa",209,0.990566,40,212,2,210,1,2,1,3,2,115,114,96,96,17
"1439",38,"[40]yIzHoIaxGBkDwoCBiddyiHbKDeepyHtnJHqwbGqa",207,0.990476,40,210,2,208,1,2,1,3,2,112,111,97,97,17
"1440",39,"[40]yIzHoIaxGBkDwoCBiddyiHbKDeepyHtnJHqwbGqa",206,0.990431,40,209,2,207,1,2,1,3,2,109,108,99,99,17
"1441",40,"[40]yIzHoIaxGBkDwoCBiddyiHbKDeepyHtnJHqwbGqa",189,0.989583,40,192,2,190,1,2,1,3,2,84,83,107,107,17
"1442",41,"[40]yIzHoIaxGBkDwoCBiddyiHbKDeepyHtnJHqwbGqa",184,0.989305,40,187,2,185,1,2,1,3,2,80,79,106,106,17
"1443",42,"[40]yIzHoIaxGBkDwoCBiddyiHbKDeepyHtnJHqwbGqa",210,0.99061,40,213,2,211,1,2,1,3,2,114,113,98,98,17
"1444",43,"[40]yIzHoIaxGBkDwoCBiddyiHbKDeepyHtnJHqwbGqa",202,0.990244,40,205,2,203,1,2,1,3,2,104,103,100,100,17
"1445",44,"[40]yIzHoIaxGBkDwoCBiddyiHbKDeepyHtnJHqwbGqa",201,0.990196,40,204,2,202,1,2,1,3,2,105,104,98,98,17
"1446",45,"[40]yIzHoIaxGBkDwoCBiddyiHbKDeepyHtnJHqwbGqa",209,0.990566,40,212,2,210,1,2,1,3,2,111,110,100,100,17
"1447",46,"[40]yIzHoIaxGBkDwoCBiddyiHbKDeepyHtnJHqwbGqa",197,0.99,40,200,2,198,1,2,1,3,2,98,97,101,101,17
"1448",47,"[40]yIzHoIaxGBkDwoCBiddyiHbKDeepyHtnJHqwbGqa",203,0.990291,40,206,2,204,1,2,1,3,2,106,105,99,99,17
"1449",48,"[40]yIzHoIaxGBkDwoCBiddyiHbKDeepyHtnJHqwbGqa",208,0.990521,40,211,2,209,1,2,1,3,2,113,112,97,97,17
"1450",49,"[40]yIzHoIaxGBkDwoCBiddyiHbKDeepyHtnJHqwbGqa",207,0.990476,40,210,2,208,1,2,1,3,2,109,108,100,100,17
"1451",50,"[40]yIzHoIaxGBkDwoCBiddyiHbKDeepyHtnJHqwbGqa",188,0.989529,40,191,2,189,1,2,1,3,2,82,81,108,108,17
"1452",51,"[40]yIzHoIaxGBkDwoCBiddyiHbKDeepyHtnJHqwbGqa",213,0.990741,40,216,2,214,1,2,1,3,2,118,117,97,97,17
"1453",52,"[40]yIzHoIaxGBkDwoCBiddyiHbKDeepyHtnJHqwbGqa",202,0.990244,40,205,2,203,1,2,1,3,2,105,104,99,99,17
"1454",53,"[40]yIzHoIaxGBkDwoCBiddyiHbKDeepyHtnJHqwbGqa",200,0.990148,40,203,2,201,1,2,1,3,2,101,100,101,101,17
"1455",54,"[40]yIzHoIaxGBkDwoCBiddyiHbKDeepyHtnJHqwbGqa",202,0.990244,40,205,2,203,1,2,1,3,2,105,104,99,99,17
"1456",55,"[40]yIzHoIaxGBkDwoCBiddyiHbKDeepyHtnJHqwbGqa",189,0.989583,40,192,2,190,1,2,1,3,2,84,83,107,107,17
"1457",56,"[40]yIzHoIaxGBkDwoCBiddyiHbKDeepyHtnJHqwbGqa",203,0.990291,40,206,2,204,1,2,1,3,2,106,105,99,99,17
"1458",57,"[40]yIzHoIaxGBkDwoCBiddyiHbKDeepyHtnJHqwbGqa",202,0.990244,40,205,2,203,1,2,1,3,2,102,101,102,102,17
"1459",58,"[40]yIzHoIaxGBkDwoCBiddyiHbKDeepyHtnJHqwbGqa",195,0.989899,40,198,2,196,1,2,1,3,2,96,95,101,101,17
"1460",59,"[40]yIzHoIaxGBkDwoCBiddyiHbKDeepyHtnJHqwbGqa",200,0.990148,40,203,2,201,1,2,1,3,2,100,99,102,102,17
"1461",60,"[40]yIzHoIaxGBkDwoCBiddyiHbKDeepyHtnJHqwbGqa",202,0.990244,40,205,2,203,1,2,1,3,2,104,103,100,100,17
"1462",61,"[40]yIzHoIaxGBkDwoCBiddyiHbKDeepyHtnJHqwbGqa",196,0.98995,40,199,2,197,1,2,1,3,2,95,94,103,103,17
"1463",62,"[40]yIzHoIaxGBkDwoCBiddyiHbKDeepyHtnJHqwbGqa",198,0.99005,40,201,2,199,1,2,1,3,2,96,95,104,104,17
"1464",63,"[40]yIzHoIaxGBkDwoCBiddyiHbKDeepyHtnJHqwbGqa",179,0.989011,40,182,2,180,1,2,1,3,2,73,72,108,108,17
"1465",64,"[40]yIzHoIaxGBkDwoCBiddyiHbKDeepyHtnJHqwbGqa",204,0.990338,40,207,2,205,1,2,1,3,2,106,105,100,100,17
"1466",65,"[40]yIzHoIaxGBkDwoCBiddyiHbKDeepyHtnJHqwbGqa",210,0.99061,40,213,2,211,1,2,1,3,2,113,112,99,99,17
"1467",66,"[40]yIzHoIaxGBkDwoCBiddyiHbKDeepyHtnJHqwbGqa",196,0.98995,40,199,2,197,1,2,1,3,2,95,94,103,103,17
"1468",67,"[40]yIzHoIaxGBkDwoCBiddyiHbKDeepyHtnJHqwbGqa",197,0.99,40,200,2,198,1,2,1,3,2,96,95,103,103,17
"1469",68,"[40]yIzHoIaxGBkDwoCBiddyiHbKDeepyHtnJHqwbGqa",192,0.989744,40,195,2,193,1,2,1,3,2,89,88,105,105,17
"1470",69,"[40]yIzHoIaxGBkDwoCBiddyiHbKDeepyHtnJHqwbGqa",201,0.990196,40,204,2,202,1,2,1,3,2,102,101,101,101,17
"1471",70,"[40]yIzHoIaxGBkDwoCBiddyiHbKDeepyHtnJHqwbGqa",199,0.990099,40,202,2,200,1,2,1,3,2,98,97,103,103,17
"1472",71,"[40]yIzHoIaxGBkDwoCBiddyiHbKDeepyHtnJHqwbGqa",197,0.99,40,200,2,198,1,2,1,3,2,96,95,103,103,17
"1473",72,"[40]yIzHoIaxGBkDwoCBiddyiHbKDeepyHtnJHqwbGqa",188,0.989529,40,191,2,189,1,2,1,3,2,84,83,106,106,17
"1474",73,"[40]yIzHoIaxGBkDwoCBiddyiHbKDeepyHtnJHqwbGqa",197,0.99,40,200,2,198,1,2,1,3,2,95,94,104,104,17
"1475",74,"[40]yIzHoIaxGBkDwoCBiddyiHbKDeepyHtnJHqwbGqa",193,0.989796,40,196,2,194,1,2,1,3,2,92,91,103,103,17
"1476",75,"[40]yIzHoIaxGBkDwoCBiddyiHbKDeepyHtnJHqwbGqa",208,0.990521,40,211,2,209,1,2,1,3,2,115,114,95,95,17
"1477",76,"[40]yIzHoIaxGBkDwoCBiddyiHbKDeepyHtnJHqwbGqa",190,0.989637,40,193,2,191,1,2,1,3,2,88,87,104,104,17
"1478",77,"[40]yIzHoIaxGBkDwoCBiddyiHbKDeepyHtnJHqwbGqa",202,0.990244,40,205,2,203,1,2,1,3,2,106,105,98,98,17
"1479",78,"[40]yIzHoIaxGBkDwoCBiddyiHbKDeepyHtnJHqwbGqa",199,0.990099,40,202,2,200,1,2,1,3,2,98,97,103,103,17
"1480",79,"[40]yIzHoIaxGBkDwoCBiddyiHbKDeepyHtnJHqwbGqa",209,0.990566,40,212,2,210,1,2,1,3,2,114,113,97,97,17
"1481",80,"[40]yIzHoIaxGBkDwoCBiddyiHbKDeepyHtnJHqwbGqa",210,0.99061,40,213,2,211,1,2,1,3,2,116,115,96,96,17
"1482",81,"[40]yIzHoIaxGBkDwoCBiddyiHbKDeepyHtnJHqwbGqa",200,0.990148,40,203,2,201,1,2,1,3,2,103,102,99,99,17
"1483",82,"[40]yIzHoIaxGBkDwoCBiddyiHbKDeepyHtnJHqwbGqa",210,0.99061,40,213,2,211,1,2,1,3,2,113,112,99,99,17
"1484",83,"[40]yIzHoIaxGBkDwoCBiddyiHbKDeepyHtnJHqwbGqa",202,0.990244,40,205,2,203,1,2,1,3,2,101,100,103,103,17
"1485",84,"[40]yIzHoIaxGBkDwoCBiddyiHbKDeepyHtnJHqwbGqa",189,0.989583,40,192,2,190,1,2,1,3,2,85,84,106,106,17
"1486",85,"[40]yIzHoIaxGBkDwoCBiddyiHbKDeepyHtnJHqwbGqa",206,0.990431,40,209,2,207,1,2,1,3,2,108,107,100,100,17
"1487",86,"[40]yIzHoIaxGBkDwoCBiddyiHbKDeepyHtnJHqwbGqa",188,0.989529,40,191,2,189,1,2,1,3,2,86,85,104,104,17
"1488",87,"[40]yIzHoIaxGBkDwoCBiddyiHbKDeepyHtnJHqwbGqa",201,0.990196,40,204,2,202,1,2,1,3,2,104,103,99,99,17
"1489",88,"[40]yIzHoIaxGBkDwoCBiddyiHbKDeepyHtnJHqwbGqa",192,0.989744,40,195,2,193,1,2,1,3,2,93,92,101,101,17
"1490",89,"[40]yIzHoIaxGBkDwoCBiddyiHbKDeepyHtnJHqwbGqa",206,0.990431,40,209,2,207,1,2,1,3,2,109,108,99,99,17
"1491",90,"[40]yIzHoIaxGBkDwoCBiddyiHbKDeepyHtnJHqwbGqa",192,0.989744,40,195,2,193,1,2,1,3,2,91,90,103,103,17
"1492",91,"[40]yIzHoIaxGBkDwoCBiddyiHbKDeepyHtnJHqwbGqa",203,0.990291,40,206,2,204,1,2,1,3,2,106,105,99,99,17
"1493",92,"[40]yIzHoIaxGBkDwoCBiddyiHbKDeepyHtnJHqwbGqa",189,0.989583,40,192,2,190,1,2,1,3,2,86,85,105,105,17
"1494",93,"[40]yIzHoIaxGBkDwoCBiddyiHbKDeepyHtnJHqwbGqa",189,0.989583,40,192,2,190,1,2,1,3,2,85,84,106,106,17
"1495",94,"[40]yIzHoIaxGBkDwoCBiddyiHbKDeepyHtnJHqwbGqa",192,0.989744,40,195,2,193,1,2,1,3,2,93,92,101,101,17
"1496",95,"[40]yIzHoIaxGBkDwoCBiddyiHbKDeepyHtnJHqwbGqa",202,0.990244,40,205,2,203,1,2,1,3,2,103,102,101,101,17
"1497",96,"[40]yIzHoIaxGBkDwoCBiddyiHbKDeepyHtnJHqwbGqa",205,0.990385,40,208,2,206,1,2,1,3,2,111,110,96,96,17
"1498",97,"[40]yIzHoIaxGBkDwoCBiddyiHbKDeepyHtnJHqwbGqa",201,0.990196,40,204,2,202,1,2,1,3,2,101,100,102,102,17
"1499",98,"[40]yIzHoIaxGBkDwoCBiddyiHbKDeepyHtnJHqwbGqa",213,0.990741,40,216,2,214,1,2,1,3,2,120,119,95,95,17
"1500",99,"[40]yIzHoIaxGBkDwoCBiddyiHbKDeepyHtnJHqwbGqa",210,0.99061,40,213,2,211,1,2,1,3,2,115,114,97,97,17
"1501",0,"[35]IefHoIExvBDtpBlEKDwagBbKHtnJHqvbGqa",222,0.991111,35,225,2,223,1,2,1,3,2,120,119,104,104,18
"1502",1,"[35]IefHoIExvBDtpBlEKDwagBbKHtnJHqvbGqa",234,0.991561,35,237,2,235,1,2,1,3,2,136,135,100,100,18
"1503",2,"[35]IefHoIExvBDtpBlEKDwagBbKHtnJHqvbGqa",213,0.990741,35,216,2,214,1,2,1,3,2,101,100,114,114,18
"1504",3,"[35]IefHoIExvBDtpBlEKDwagBbKHtnJHqvbGqa",223,0.99115,35,226,2,224,1,2,1,3,2,119,118,106,106,18
"1505",4,"[35]IefHoIExvBDtpBlEKDwagBbKHtnJHqvbGqa",222,0.991111,35,225,2,223,1,2,1,3,2,120,119,104,104,18
"1506",5,"[35]IefHoIExvBDtpBlEKDwagBbKHtnJHqvbGqa",230,0.991416,35,233,2,231,1,2,1,3,2,132,131,100,100,18
"1507",6,"[35]IefHoIExvBDtpBlEKDwagBbKHtnJHqvbGqa",217,0.990909,35,220,2,218,1,2,1,3,2,112,111,107,107,18
"1508",7,"[35]IefHoIExvBDtpBlEKDwagBbKHtnJHqvbGqa",213,0.990741,35,216,2,214,1,2,1,3,2,106,105,109,109,18
"1509",8,"[35]IefHoIExvBDtpBlEKDwagBbKHtnJHqvbGqa",215,0.990826,35,218,2,216,1,2,1,3,2,107,106,110,110,18
"1510",9,"[35]IefHoIExvBDtpBlEKDwagBbKHtnJHqvbGqa",223,0.99115,35,226,2,224,1,2,1,3,2,122,121,103,103,18
"1511",10,"[35]IefHoIExvBDtpBlEKDwagBbKHtnJHqvbGqa",216,0.990868,35,219,2,217,1,2,1,3,2,110,109,108,108,18
"1512",11,"[35]IefHoIExvBDtpBlEKDwagBbKHtnJHqvbGqa",202,0.990244,35,205,2,203,1,2,1,3,2,90,89,114,114,18
"1513",12,"[35]IefHoIExvBDtpBlEKDwagBbKHtnJHqvbGqa",210,0.99061,35,213,2,211,1,2,1,3,2,99,98,113,113,18
"1514",13,"[35]IefHoIExvBDtpBlEKDwagBbKHtnJHqvbGqa",208,0.990521,35,211,2,209,1,2,1,3,2,97,96,113,113,18
"1515",14,"[35]IefHoIExvBDtpBlEKDwagBbKHtnJHqvbGqa",212,0.990698,35,215,2,213,1,2,1,3,2,105,104,109,109,18
"1516",15,"[35]IefHoIExvBDtpBlEKDwagBbKHtnJHqvbGqa",217,0.990909,35,220,2,218,1,2,1,3,2,112,111,107,107,18
"1517",16,"[35]IefHoIExvBDtpBlEKDwagBbKHtnJHqvbGqa",216,0.990868,35,219,2,217,1,2,1,3,2,110,109,108,108,18
"1518",17,"[35]IefHoIExvBDtpBlEKDwagBbKHtnJHqvbGqa",210,0.99061,35,213,2,211,1,2,1,3,2,103,102,109,109,18
"1519",18,"[35]IefHoIExvBDtpBlEKDwagBbKHtnJHqvbGqa",214,0.990783,35,217,2,215,1,2,1,3,2,108,107,108,108,18
"1520",19,"[35]IefHoIExvBDtpBlEKDwagBbKHtnJHqvbGqa",211,0.990654,35,214,2,212,1,2,1,3,2,102,101,111,111,18
"1521",20,"[35]IefHoIExvBDtpBlEKDwagBbKHtnJHqvbGqa",221,0.991071,35,224,2,222,1,2,1,3,2,116,115,107,107,18
"1522",21,"[35]IefHoIExvBDtpBlEKDwagBbKHtnJHqvbGqa",214,0.990783,35,217,2,215,1,2,1,3,2,104,103,112,112,18
"1523",22,"[35]IefHoIExvBDtpBlEKDwagBbKHtnJHqvbGqa",216,0.990868,35,219,2,217,1,2,1,3,2,109,108,109,109,18
"1524",23,"[35]IefHoIExvBDtpBlEKDwagBbKHtnJHqvbGqa",225,0.991228,35,228,2,226,1,2,1,3,2,122,121,105,105,18
"1525",24,"[35]IefHoIExvBDtpBlEKDwagBbKHtnJHqvbGqa",213,0.990741,35,216,2,214,1,2,1,3,2,104,103,111,111,18
"1526",25,"[35]IefHoIExvBDtpBlEKDwagBbKHtnJHqvbGqa",204,0.990338,35,207,2,205,1,2,1,3,2,93,92,113,113,18
"1527",26,"[35]IefHoIExvBDtpBlEKDwagBbKHtnJHqvbGqa",209,0.990566,35,212,2,210,1,2,1,3,2,100,99,111,111,18
"1528",27,"[35]IefHoIExvBDtpBlEKDwagBbKHtnJHqvbGqa",208,0.990521,35,211,2,209,1,2,1,3,2,99,98,111,111,18
"1529",28,"[35]IefHoIExvBDtpBlEKDwagBbKHtnJHqvbGqa",208,0.990521,35,211,2,209,1,2,1,3,2,99,98,111,111,18
"1530",29,"[35]IefHoIExvBDtpBlEKDwagBbKHtnJHqvbGqa",219,0.990991,35,222,2,220,1,2,1,3,2,116,115,105,105,18
"1531",30,"[35]IefHoIExvBDtpBlEKDwagBbKHtnJHqvbGqa",203,0.990291,35,206,2,204,1,2,1,3,2,94,93,111,111,18
"1532",31,"[35]IefHoIExvBDtpBlEKDwagBbKHtnJHqvbGqa",209,0.990566,35,212,2,210,1,2,1,3,2,101,100,110,110,18
"1533",32,"[35]IefHoIExvBDtpBlEKDwagBbKHtnJHqvbGqa",215,0.990826,35,218,2,216,1,2,1,3,2,108,107,109,109,18
"1534",33,"[35]IefHoIExvBDtpBlEKDwagBbKHtnJHqvbGqa",208,0.990521,35,211,2,209,1,2,1,3,2,97,96,113,113,18
"1535",34,"[35]IefHoIExvBDtpBlEKDwagBbKHtnJHqvbGqa",201,0.990196,35,204,2,202,1,2,1,3,2,85,84,118,118,18
"1536",35,"[35]IefHoIExvBDtpBlEKDwagBbKHtnJHqvbGqa",211,0.990654,35,214,2,212,1,2,1,3,2,103,102,110,110,18
"1537",36,"[35]IefHoIExvBDtpBlEKDwagBbKHtnJHqvbGqa",208,0.990521,35,211,2,209,1,2,1,3,2,99,98,111,111,18
"1538",37,"[35]IefHoIExvBDtpBlEKDwagBbKHtnJHqvbGqa",218,0.99095,35,221,2,219,1,2,1,3,2,111,110,109,109,18
"1539",38,"[35]IefHoIExvBDtpBlEKDwagBbKHtnJHqvbGqa",223,0.99115,35,226,2,224,1,2,1,3,2,119,118,106,106,18
"1540",39,"[35]IefHoIExvBDtpBlEKDwagBbKHtnJHqvbGqa",211,0.990654,35,214,2,212,1,2,1,3,2,102,101,111,111,18
"1541",40,"[35]IefHoIExvBDtpBlEKDwagBbKHtnJHqvbGqa",215,0.990826,35,218,2,216,1,2,1,3,2,110,109,107,107,18
"1542",41,"[35]IefHoIExvBDtpBlEKDwagBbKHtnJHqvbGqa",229,0.991379,35,232,2,230,1,2,1,3,2,129,128,102,102,18
"1543",42,"[35]IefHoIExvBDtpBlEKDwagBbKHtnJHqvbGqa",198,0.99005,35,201,2,199,1,2,1,3,2,82,81,118,118,18
"1544",43,"[35]IefHoIExvBDtpBlEKDwagBbKHtnJHqvbGqa",219,0.990991,35,222,2,220,1,2,1,3,2,114,113,107,107,18
"1545",44,"[35]IefHoIExvBDtpBlEKDwagBbKHtnJHqvbGqa",217,0.990909,35,220,2,218,1,2,1,3,2,112,111,107,107,18
"1546",45,"[35]IefHoIExvBDtpBlEKDwagBbKHtnJHqvbGqa",225,0.991228,35,228,2,226,1,2,1,3,2,120,119,107,107,18
"1547",46,"[35]IefHoIExvBDtpBlEKDwagBbKHtnJHqvbGqa",212,0.990698,35,215,2,213,1,2,1,3,2,102,101,112,112,18
"1548",47,"[35]IefHoIExvBDtpBlEKDwagBbKHtnJHqvbGqa",207,0.990476,35,210,2,208,1,2,1,3,2,98,97,111,111,18
"1549",48,"[35]IefHoIExvBDtpBlEKDwagBbKHtnJHqvbGqa",227,0.991304,35,230,2,228,1,2,1,3,2,128,127,101,101,18
"1550",49,"[35]IefHoIExvBDtpBlEKDwagBbKHtnJHqvbGqa",230,0.991416,35,233,2,231,1,2,1,3,2,126,125,106,106,18
"1551",50,"[35]IefHoIExvBDtpBlEKDwagBbKHtnJHqvbGqa",222,0.991111,35,225,2,223,1,2,1,3,2,119,118,105,105,18
"1552",51,"[35]IefHoIExvBDtpBlEKDwagBbKHtnJHqvbGqa",209,0.990566,35,212,2,210,1,2,1,3,2,99,98,112,112,18
"1553",52,"[35]IefHoIExvBDtpBlEKDwagBbKHtnJHqvbGqa",207,0.990476,35,210,2,208,1,2,1,3,2,98,97,111,111,18
"1554",53,"[35]IefHoIExvBDtpBlEKDwagBbKHtnJHqvbGqa",215,0.990826,35,218,2,216,1,2,1,3,2,109,108,108,108,18
"1555",54,"[35]IefHoIExvBDtpBlEKDwagBbKHtnJHqvbGqa",228,0.991342,35,231,2,229,1,2,1,3,2,128,127,102,102,18
"1556",55,"[35]IefHoIExvBDtpBlEKDwagBbKHtnJHqvbGqa",219,0.990991,35,222,2,220,1,2,1,3,2,116,115,105,105,18
"1557",56,"[35]IefHoIExvBDtpBlEKDwagBbKHtnJHqvbGqa",214,0.990783,35,217,2,215,1,2,1,3,2,108,107,108,108,18
"1558",57,"[35]IefHoIExvBDtpBlEKDwagBbKHtnJHqvbGqa",201,0.990196,35,204,2,202,1,2,1,3,2,85,84,118,118,18
"1559",58,"[35]IefHoIExvBDtpBlEKDwagBbKHtnJHqvbGqa",220,0.991031,35,223,2,221,1,2,1,3,2,114,113,108,108,18
"1560",59,"[35]IefHoIExvBDtpBlEKDwagBbKHtnJHqvbGqa",220,0.991031,35,223,2,221,1,2,1,3,2,113,112,109,109,18
"1561",60,"[35]IefHoIExvBDtpBlEKDwagBbKHtnJHqvbGqa",218,0.99095,35,221,2,219,1,2,1,3,2,112,111,108,108,18
"1562",61,"[35]IefHoIExvBDtpBlEKDwagBbKHtnJHqvbGqa",220,0.991031,35,223,2,221,1,2,1,3,2,114,113,108,108,18
"1563",62,"[35]IefHoIExvBDtpBlEKDwagBbKHtnJHqvbGqa",199,0.990099,35,202,2,200,1,2,1,3,2,88,87,113,113,18
"1564",63,"[35]IefHoIExvBDtpBlEKDwagBbKHtnJHqvbGqa",216,0.990868,35,219,2,217,1,2,1,3,2,108,107,110,110,18
"1565",64,"[35]IefHoIExvBDtpBlEKDwagBbKHtnJHqvbGqa",212,0.990698,35,215,2,213,1,2,1,3,2,105,104,109,109,18
"1566",65,"[35]IefHoIExvBDtpBlEKDwagBbKHtnJHqvbGqa",228,0.991342,35,231,2,229,1,2,1,3,2,128,127,102,102,18
"1567",66,"[35]IefHoIExvBDtpBlEKDwagBbKHtnJHqvbGqa",214,0.990783,35,217,2,215,1,2,1,3,2,109,108,107,107,18
"1568",67,"[35]IefHoIExvBDtpBlEKDwagBbKHtnJHqvbGqa",217,0.990909,35,220,2,218,1,2,1,3,2,110,109,109,109,18
"1569",68,"[35]IefHoIExvBDtpBlEKDwagBbKHtnJHqvbGqa",218,0.99095,35,221,2,219,1,2,1,3,2,112,111,108,108,18
"1570",69,"[35]IefHoIExvBDtpBlEKDwagBbKHtnJHqvbGqa",213,0.990741,35,216,2,214,1,2,1,3,2,108,107,107,107,18
"1571",70,"[35]IefHoIExvBDtpBlEKDwagBbKHtnJHqvbGqa",210,0.99061,35,213,2,211,1,2,1,3,2,101,100,111,111,18
"1572",71,"[35]IefHoIExvBDtpBlEKDwagBbKHtnJHqvbGqa",207,0.990476,35,210,2,208,1,2,1,3,2,96,95,113,113,18
"1573",72,"[35]IefHoIExvBDtpBlEKDwagBbKHtnJHqvbGqa",208,0.990521,35,211,2,209,1,2,1,3,2,99,98,111,111,18
"1574",73,"[35]IefHoIExvBDtpBlEKDwagBbKHtnJHqvbGqa",202,0.990244,35,205,2,203,1,2,1,3,2,89,88,115,115,18
"1575",74,"[35]IefHoIExvBDtpBlEKDwagBbKHtnJHqvbGqa",203,0.990291,35,206,2,204,1,2,1,3,2,95,94,110,110,18
"1576",75,"[35]IefHoIExvBDtpBlEKDwagBbKHtnJHqvbGqa",224,0.991189,35,227,2,225,1,2,1,3,2,120,119,106,106,18
"1577",76,"[35]IefHoIExvBDtpBlEKDwagBbKHtnJHqvbGqa",209,0.990566,35,212,2,210,1,2,1,3,2,99,98,112,112,18
"1578",77,"[35]IefHoIExvBDtpBlEKDwagBbKHtnJHqvbGqa",214,0.990783,35,217,2,215,1,2,1,3,2,108,107,108,108,18
"1579",78,"[35]IefHoIExvBDtpBlEKDwagBbKHtnJHqvbGqa",219,0.990991,35,222,2,220,1,2,1,3,2,113,112,108,108,18
"1580",79,"[35]IefHoIExvBDtpBlEKDwagBbKHtnJHqvbGqa",210,0.99061,35,213,2,211,1,2,1,3,2,102,101,110,110,18
"1581",80,"[35]IefHoIExvBDtpBlEKDwagBbKHtnJHqvbGqa",217,0.990909,35,220,2,218,1,2,1,3,2,113,112,106,106,18
"1582",81,"[35]IefHoIExvBDtpBlEKDwagBbKHtnJHqvbGqa",214,0.990783,35,217,2,215,1,2,1,3,2,103,102,113,113,18
"1583",82,"[35]IefHoIExvBDtpBlEKDwagBbKHtnJHqvbGqa",216,0.990868,35,219,2,217,1,2,1,3,2,108,107,110,110,18
"1584",83,"[35]IefHoIExvBDtpBlEKDwagBbKHtnJHqvbGqa",218,0.99095,35,221,2,219,1,2,1,3,2,112,111,108,108,18
"1585",84,"[35]IefHoIExvBDtpBlEKDwagBbKHtnJHqvbGqa",211,0.990654,35,214,2,212,1,2,1,3,2,102,101,111,111,18
"1586",85,"[35]IefHoIExvBDtpBlEKDwagBbKHtnJHqvbGqa",230,0.991416,35,233,2,231,1,2,1,3,2,128,127,104,104,18
"1587",86,"[35]IefHoIExvBDtpBlEKDwagBbKHtnJHqvbGqa",229,0.991379,35,232,2,230,1,2,1,3,2,128,127,103,103,18
"1588",87,"[35]IefHoIExvBDtpBlEKDwagBbKHtnJHqvbGqa",207,0.990476,35,210,2,208,1,2,1,3,2,97,96,112,112,18
"1589",88,"[35]IefHoIExvBDtpBlEKDwagBbKHtnJHqvbGqa",221,0.991071,35,224,2,222,1,2,1,3,2,112,111,111,111,18
"1590",89,"[35]IefHoIExvBDtpBlEKDwagBbKHtnJHqvbGqa",220,0.991031,35,223,2,221,1,2,1,3,2,115,114,107,107,18
"1591",90,"[35]IefHoIExvBDtpBlEKDwagBbKHtnJHqvbGqa",238,0.991701,35,241,2,239,1,2,1,3,2,141,140,99,99,18
"1592",91,"[35]IefHoIExvBDtpBlEKDwagBbKHtnJHqvbGqa",218,0.99095,35,221,2,219,1,2,1,3,2,114,113,106,106,18
"1593",92,"[35]IefHoIExvBDtpBlEKDwagBbKHtnJHqvbGqa",205,0.990385,35,208,2,206,1,2,1,3,2,97,96,110,110,18
"1594",93,"[35]IefHoIExvBDtpBlEKDwagBbKHtnJHqvbGqa",223,0.99115,35,226,2,224,1,2,1,3,2,121,120,104,104,18
"1595",94,"[35]IefHoIExvBDtpBlEKDwagBbKHtnJHqvbGqa",220,0.991031,35,223,2,221,1,2,1,3,2,119,118,103,103,18
"1596",95,"[35]IefHoIExvBDtpBlEKDwagBbKHtnJHqvbGqa",219,0.990991,35,222,2,220,1,2,1,3,2,115,114,106,106,18
"1597",96,"[35]IefHoIExvBDtpBlEKDwagBbKHtnJHqvbGqa",203,0.990291,35,206,2,204,1,2,1,3,2,93,92,112,112,18
"1598",97,"[35]IefHoIExvBDtpBlEKDwagBbKHtnJHqvbGqa",221,0.991071,35,224,2,222,1,2,1,3,2,115,114,108,108,18
"1599",98,"[35]IefHoIExvBDtpBlEKDwagBbKHtnJHqvbGqa",230,0.991416,35,233,2,231,1,2,1,3,2,130,129,102,102,18
"1600",99,"[35]IefHoIExvBDtpBlEKDwagBbKHtnJHqvbGqa",214,0.990783,35,217,2,215,1,2,1,3,2,104,103,112,112,18
"1601",0,"[40]GIEHoIpntBkzFDCpkvxfygzawzJbKHvnJHqvbGqa",215,0.990826,40,218,2,216,1,2,1,3,2,108,107,109,109,19
"1602",1,"[40]GIEHoIpntBkzFDCpkvxfygzawzJbKHvnJHqvbGqa",230,0.991416,40,233,2,231,1,2,1,3,2,127,126,105,105,19
"1603",2,"[40]GIEHoIpntBkzFDCpkvxfygzawzJbKHvnJHqvbGqa",223,0.99115,40,226,2,224,1,2,1,3,2,117,116,108,108,19
"1604",3,"[40]GIEHoIpntBkzFDCpkvxfygzawzJbKHvnJHqvbGqa",219,0.990991,40,222,2,220,1,2,1,3,2,113,112,108,108,19
"1605",4,"[40]GIEHoIpntBkzFDCpkvxfygzawzJbKHvnJHqvbGqa",228,0.991342,40,231,2,229,1,2,1,3,2,125,124,105,105,19
"1606",5,"[40]GIEHoIpntBkzFDCpkvxfygzawzJbKHvnJHqvbGqa",222,0.991111,40,225,2,223,1,2,1,3,2,120,119,104,104,19
"1607",6,"[40]GIEHoIpntBkzFDCpkvxfygzawzJbKHvnJHqvbGqa",213,0.990741,40,216,2,214,1,2,1,3,2,105,104,110,110,19
"1608",7,"[40]GIEHoIpntBkzFDCpkvxfygzawzJbKHvnJHqvbGqa",211,0.990654,40,214,2,212,1,2,1,3,2,101,100,112,112,19
"1609",8,"[40]GIEHoIpntBkzFDCpkvxfygzawzJbKHvnJHqvbGqa",217,0.990909,40,220,2,218,1,2,1,3,2,111,110,108,108,19
"1610",9,"[40]GIEHoIpntBkzFDCpkvxfygzawzJbKHvnJHqvbGqa",233,0.991525,40,236,2,234,1,2,1,3,2,132,131,103,103,19
"1611",10,"[40]GIEHoIpntBkzFDCpkvxfygzawzJbKHvnJHqvbGqa",222,0.991111,40,225,2,223,1,2,1,3,2,116,115,108,108,19
"1612",11,"[40]GIEHoIpntBkzFDCpkvxfygzawzJbKHvnJHqvbGqa",225,0.991228,40,228,2,226,1,2,1,3,2,124,123,103,103,19
"1613",12,"[40]GIEHoIpntBkzFDCpkvxfygzawzJbKHvnJHqvbGqa",213,0.990741,40,216,2,214,1,2,1,3,2,101,100,114,114,19
"1614",13,"[40]GIEHoIpntBkzFDCpkvxfygzawzJbKHvnJHqvbGqa",219,0.990991,40,222,2,220,1,2,1,3,2,113,112,108,108,19
"1615",14,"[40]GIEHoIpntBkzFDCpkvxfygzawzJbKHvnJHqvbGqa",218,0.99095,40,221,2,219,1,2,1,3,2,112,111,108,108,19
"1616",15,"[40]GIEHoIpntBkzFDCpkvxfygzawzJbKHvnJHqvbGqa",222,0.991111,40,225,2,223,1,2,1,3,2,116,115,108,108,19
"1617",16,"[40]GIEHoIpntBkzFDCpkvxfygzawzJbKHvnJHqvbGqa",215,0.990826,40,218,2,216,1,2,1,3,2,107,106,110,110,19
"1618",17,"[40]GIEHoIpntBkzFDCpkvxfygzawzJbKHvnJHqvbGqa",223,0.99115,40,226,2,224,1,2,1,3,2,118,117,107,107,19
"1619",18,"[40]GIEHoIpntBkzFDCpkvxfygzawzJbKHvnJHqvbGqa",223,0.99115,40,226,2,224,1,2,1,3,2,120,119,105,105,19
"1620",19,"[40]GIEHoIpntBkzFDCpkvxfygzawzJbKHvnJHqvbGqa",220,0.991031,40,223,2,221,1,2,1,3,2,114,113,108,108,19
"1621",20,"[40]GIEHoIpntBkzFDCpkvxfygzawzJbKHvnJHqvbGqa",208,0.990521,40,211,2,209,1,2,1,3,2,97,96,113,113,19
"1622",21,"[40]GIEHoIpntBkzFDCpkvxfygzawzJbKHvnJHqvbGqa",227,0.991304,40,230,2,228,1,2,1,3,2,124,123,105,105,19
"1623",22,"[40]GIEHoIpntBkzFDCpkvxfygzawzJbKHvnJHqvbGqa",217,0.990909,40,220,2,218,1,2,1,3,2,115,114,104,104,19
"1624",23,"[40]GIEHoIpntBkzFDCpkvxfygzawzJbKHvnJHqvbGqa",203,0.990291,40,206,2,204,1,2,1,3,2,92,91,113,113,19
"1625",24,"[40]GIEHoIpntBkzFDCpkvxfygzawzJbKHvnJHqvbGqa",216,0.990868,40,219,2,217,1,2,1,3,2,110,109,108,108,19
"1626",25,"[40]GIEHoIpntBkzFDCpkvxfygzawzJbKHvnJHqvbGqa",218,0.99095,40,221,2,219,1,2,1,3,2,111,110,109,109,19
"1627",26,"[40]GIEHoIpntBkzFDCpkvxfygzawzJbKHvnJHqvbGqa",210,0.99061,40,213,2,211,1,2,1,3,2,104,103,108,108,19
"1628",27,"[40]GIEHoIpntBkzFDCpkvxfygzawzJbKHvnJHqvbGqa",203,0.990291,40,206,2,204,1,2,1,3,2,92,91,113,113,19
"1629",28,"[40]GIEHoIpntBkzFDCpkvxfygzawzJbKHvnJHqvbGqa",219,0.990991,40,222,2,220,1,2,1,3,2,114,113,107,107,19
"1630",29,"[40]GIEHoIpntBkzFDCpkvxfygzawzJbKHvnJHqvbGqa",224,0.991189,40,227,2,225,1,2,1,3,2,116,115,110,110,19
"1631",30,"[40]GIEHoIpntBkzFDCpkvxfygzawzJbKHvnJHqvbGqa",213,0.990741,40,216,2,214,1,2,1,3,2,105,104,110,110,19
"1632",31,"[40]GIEHoIpntBkzFDCpkvxfygzawzJbKHvnJHqvbGqa",220,0.991031,40,223,2,221,1,2,1,3,2,115,114,107,107,19
"1633",32,"[40]GIEHoIpntBkzFDCpkvxfygzawzJbKHvnJHqvbGqa",208,0.990521,40,211,2,209,1,2,1,3,2,100,99,110,110,19
"1634",33,"[40]GIEHoIpntBkzFDCpkvxfygzawzJbKHvnJHqvbGqa",223,0.99115,40,226,2,224,1,2,1,3,2,118,117,107,107,19
"1635",34,"[40]GIEHoIpntBkzFDCpkvxfygzawzJbKHvnJHqvbGqa",222,0.991111,40,225,2,223,1,2,1,3,2,115,114,109,109,19
"1636",35,"[40]GIEHoIpntBkzFDCpkvxfygzawzJbKHvnJHqvbGqa",220,0.991031,40,223,2,221,1,2,1,3,2,114,113,108,108,19
"1637",36,"[40]GIEHoIpntBkzFDCpkvxfygzawzJbKHvnJHqvbGqa",215,0.990826,40,218,2,216,1,2,1,3,2,110,109,107,107,19
"1638",37,"[40]GIEHoIpntBkzFDCpkvxfygzawzJbKHvnJHqvbGqa",215,0.990826,40,218,2,216,1,2,1,3,2,106,105,111,111,19
"1639",38,"[40]GIEHoIpntBkzFDCpkvxfygzawzJbKHvnJHqvbGqa",217,0.990909,40,220,2,218,1,2,1,3,2,107,106,112,112,19
"1640",39,"[40]GIEHoIpntBkzFDCpkvxfygzawzJbKHvnJHqvbGqa",212,0.990698,40,215,2,213,1,2,1,3,2,103,102,111,111,19
"1641",40,"[40]GIEHoIpntBkzFDCpkvxfygzawzJbKHvnJHqvbGqa",209,0.990566,40,212,2,210,1,2,1,3,2,99,98,112,112,19
"1642",41,"[40]GIEHoIpntBkzFDCpkvxfygzawzJbKHvnJHqvbGqa",218,0.99095,40,221,2,219,1,2,1,3,2,113,112,107,107,19
"1643",42,"[40]GIEHoIpntBkzFDCpkvxfygzawzJbKHvnJHqvbGqa",204,0.990338,40,207,2,205,1,2,1,3,2,93,92,113,113,19
"1644",43,"[40]GIEHoIpntBkzFDCpkvxfygzawzJbKHvnJHqvbGqa",227,0.991304,40,230,2,228,1,2,1,3,2,125,124,104,104,19
"1645",44,"[40]GIEHoIpntBkzFDCpkvxfygzawzJbKHvnJHqvbGqa",212,0.990698,40,215,2,213,1,2,1,3,2,106,105,108,108,19
"1646",45,"[40]GIEHoIpntBkzFDCpkvxfygzawzJbKHvnJHqvbGqa",211,0.990654,40,214,2,212,1,2,1,3,2,101,100,112,112,19
"1647",46,"[40]GIEHoIpntBkzFDCpkvxfygzawzJbKHvnJHqvbGqa",212,0.990698,40,215,2,213,1,2,1,3,2,100,99,114,114,19
"1648",47,"[40]GIEHoIpntBkzFDCpkvxfygzawzJbKHvnJHqvbGqa",201,0.990196,40,204,2,202,1,2,1,3,2,86,85,117,117,19
"1649",48,"[40]GIEHoIpntBkzFDCpkvxfygzawzJbKHvnJHqvbGqa",208,0.990521,40,211,2,209,1,2,1,3,2,99,98,111,111,19
"1650",49,"[40]GIEHoIpntBkzFDCpkvxfygzawzJbKHvnJHqvbGqa",227,0.991304,40,230,2,228,1,2,1,3,2,125,124,104,104,19
"1651",50,"[40]GIEHoIpntBkzFDCpkvxfygzawzJbKHvnJHqvbGqa",218,0.99095,40,221,2,219,1,2,1,3,2,110,109,110,110,19
"1652",51,"[40]GIEHoIpntBkzFDCpkvxfygzawzJbKHvnJHqvbGqa",225,0.991228,40,228,2,226,1,2,1,3,2,123,122,104,104,19
"1653",52,"[40]GIEHoIpntBkzFDCpkvxfygzawzJbKHvnJHqvbGqa",214,0.990783,40,217,2,215,1,2,1,3,2,108,107,108,108,19
"1654",53,"[40]GIEHoIpntBkzFDCpkvxfygzawzJbKHvnJHqvbGqa",210,0.99061,40,213,2,211,1,2,1,3,2,98,97,114,114,19
"1655",54,"[40]GIEHoIpntBkzFDCpkvxfygzawzJbKHvnJHqvbGqa",224,0.991189,40,227,2,225,1,2,1,3,2,119,118,107,107,19
"1656",55,"[40]GIEHoIpntBkzFDCpkvxfygzawzJbKHvnJHqvbGqa",210,0.99061,40,213,2,211,1,2,1,3,2,100,99,112,112,19
"1657",56,"[40]GIEHoIpntBkzFDCpkvxfygzawzJbKHvnJHqvbGqa",231,0.991453,40,234,2,232,1,2,1,3,2,131,130,102,102,19
"1658",57,"[40]GIEHoIpntBkzFDCpkvxfygzawzJbKHvnJHqvbGqa",229,0.991379,40,232,2,230,1,2,1,3,2,129,128,102,102,19
"1659",58,"[40]GIEHoIpntBkzFDCpkvxfygzawzJbKHvnJHqvbGqa",214,0.990783,40,217,2,215,1,2,1,3,2,105,104,111,111,19
"1660",59,"[40]GIEHoIpntBkzFDCpkvxfygzawzJbKHvnJHqvbGqa",209,0.990566,40,212,2,210,1,2,1,3,2,101,100,110,110,19
"1661",60,"[40]GIEHoIpntBkzFDCpkvxfygzawzJbKHvnJHqvbGqa",215,0.990826,40,218,2,216,1,2,1,3,2,104,103,113,113,19
"1662",61,"[40]GIEHoIpntBkzFDCpkvxfygzawzJbKHvnJHqvbGqa",214,0.990783,40,217,2,215,1,2,1,3,2,106,105,110,110,19
"1663",62,"[40]GIEHoIpntBkzFDCpkvxfygzawzJbKHvnJHqvbGqa",208,0.990521,40,211,2,209,1,2,1,3,2,100,99,110,110,19
"1664",63,"[40]GIEHoIpntBkzFDCpkvxfygzawzJbKHvnJHqvbGqa",220,0.991031,40,223,2,221,1,2,1,3,2,116,115,106,106,19
"1665",64,"[40]GIEHoIpntBkzFDCpkvxfygzawzJbKHvnJHqvbGqa",206,0.990431,40,209,2,207,1,2,1,3,2,96,95,112,112,19
"1666",65,"[40]GIEHoIpntBkzFDCpkvxfygzawzJbKHvnJHqvbGqa",218,0.99095,40,221,2,219,1,2,1,3,2,112,111,108,108,19
"1667",66,"[40]GIEHoIpntBkzFDCpkvxfygzawzJbKHvnJHqvbGqa",227,0.991304,40,230,2,228,1,2,1,3,2,125,124,104,104,19
"1668",67,"[40]GIEHoIpntBkzFDCpkvxfygzawzJbKHvnJHqvbGqa",213,0.990741,40,216,2,214,1,2,1,3,2,107,106,108,108,19
"1669",68,"[40]GIEHoIpntBkzFDCpkvxfygzawzJbKHvnJHqvbGqa",219,0.990991,40,222,2,220,1,2,1,3,2,115,114,106,106,19
"1670",69,"[40]GIEHoIpntBkzFDCpkvxfygzawzJbKHvnJHqvbGqa",212,0.990698,40,215,2,213,1,2,1,3,2,101,100,113,113,19
"1671",70,"[40]GIEHoIpntBkzFDCpkvxfygzawzJbKHvnJHqvbGqa",219,0.990991,40,222,2,220,1,2,1,3,2,111,110,110,110,19
"1672",71,"[40]GIEHoIpntBkzFDCpkvxfygzawzJbKHvnJHqvbGqa",220,0.991031,40,223,2,221,1,2,1,3,2,112,111,110,110,19
"1673",72,"[40]GIEHoIpntBkzFDCpkvxfygzawzJbKHvnJHqvbGqa",216,0.990868,40,219,2,217,1,2,1,3,2,109,108,109,109,19
"1674",73,"[40]GIEHoIpntBkzFDCpkvxfygzawzJbKHvnJHqvbGqa",218,0.99095,40,221,2,219,1,2,1,3,2,114,113,106,106,19
"1675",74,"[40]GIEHoIpntBkzFDCpkvxfygzawzJbKHvnJHqvbGqa",212,0.990698,40,215,2,213,1,2,1,3,2,103,102,111,111,19
"1676",75,"[40]GIEHoIpntBkzFDCpkvxfygzawzJbKHvnJHqvbGqa",193,0.989796,40,196,2,194,1,2,1,3,2,78,77,117,117,19
"1677",76,"[40]GIEHoIpntBkzFDCpkvxfygzawzJbKHvnJHqvbGqa",217,0.990909,40,220,2,218,1,2,1,3,2,111,110,108,108,19
"1678",77,"[40]GIEHoIpntBkzFDCpkvxfygzawzJbKHvnJHqvbGqa",222,0.991111,40,225,2,223,1,2,1,3,2,118,117,106,106,19
"1679",78,"[40]GIEHoIpntBkzFDCpkvxfygzawzJbKHvnJHqvbGqa",207,0.990476,40,210,2,208,1,2,1,3,2,100,99,109,109,19
"1680",79,"[40]GIEHoIpntBkzFDCpkvxfygzawzJbKHvnJHqvbGqa",211,0.990654,40,214,2,212,1,2,1,3,2,101,100,112,112,19
"1681",80,"[40]GIEHoIpntBkzFDCpkvxfygzawzJbKHvnJHqvbGqa",205,0.990385,40,208,2,206,1,2,1,3,2,95,94,112,112,19
"1682",81,"[40]GIEHoIpntBkzFDCpkvxfygzawzJbKHvnJHqvbGqa",222,0.991111,40,225,2,223,1,2,1,3,2,115,114,109,109,19
"1683",82,"[40]GIEHoIpntBkzFDCpkvxfygzawzJbKHvnJHqvbGqa",218,0.99095,40,221,2,219,1,2,1,3,2,111,110,109,109,19
"1684",83,"[40]GIEHoIpntBkzFDCpkvxfygzawzJbKHvnJHqvbGqa",209,0.990566,40,212,2,210,1,2,1,3,2,102,101,109,109,19
"1685",84,"[40]GIEHoIpntBkzFDCpkvxfygzawzJbKHvnJHqvbGqa",222,0.991111,40,225,2,223,1,2,1,3,2,114,113,110,110,19
"1686",85,"[40]GIEHoIpntBkzFDCpkvxfygzawzJbKHvnJHqvbGqa",222,0.991111,40,225,2,223,1,2,1,3,2,117,116,107,107,19
"1687",86,"[40]GIEHoIpntBkzFDCpkvxfygzawzJbKHvnJHqvbGqa",215,0.990826,40,218,2,216,1,2,1,3,2,110,109,107,107,19
"1688",87,"[40]GIEHoIpntBkzFDCpkvxfygzawzJbKHvnJHqvbGqa",210,0.99061,40,213,2,211,1,2,1,3,2,99,98,113,113,19
"1689",88,"[40]GIEHoIpntBkzFDCpkvxfygzawzJbKHvnJHqvbGqa",217,0.990909,40,220,2,218,1,2,1,3,2,111,110,108,108,19
"1690",89,"[40]GIEHoIpntBkzFDCpkvxfygzawzJbKHvnJHqvbGqa",207,0.990476,40,210,2,208,1,2,1,3,2,93,92,116,116,19
"1691",90,"[40]GIEHoIpntBkzFDCpkvxfygzawzJbKHvnJHqvbGqa",214,0.990783,40,217,2,215,1,2,1,3,2,106,105,110,110,19
"1692",91,"[40]GIEHoIpntBkzFDCpkvxfygzawzJbKHvnJHqvbGqa",214,0.990783,40,217,2,215,1,2,1,3,2,108,107,108,108,19
"1693",92,"[40]GIEHoIpntBkzFDCpkvxfygzawzJbKHvnJHqvbGqa",217,0.990909,40,220,2,218,1,2,1,3,2,109,108,110,110,19
"1694",93,"[40]GIEHoIpntBkzFDCpkvxfygzawzJbKHvnJHqvbGqa",208,0.990521,40,211,2,209,1,2,1,3,2,96,95,114,114,19
"1695",94,"[40]GIEHoIpntBkzFDCpkvxfygzawzJbKHvnJHqvbGqa",207,0.990476,40,210,2,208,1,2,1,3,2,97,96,112,112,19
"1696",95,"[40]GIEHoIpntBkzFDCpkvxfygzawzJbKHvnJHqvbGqa",225,0.991228,40,228,2,226,1,2,1,3,2,123,122,104,104,19
"1697",96,"[40]GIEHoIpntBkzFDCpkvxfygzawzJbKHvnJHqvbGqa",226,0.991266,40,229,2,227,1,2,1,3,2,125,124,103,103,19
"1698",97,"[40]GIEHoIpntBkzFDCpkvxfygzawzJbKHvnJHqvbGqa",234,0.991561,40,237,2,235,1,2,1,3,2,132,131,104,104,19
"1699",98,"[40]GIEHoIpntBkzFDCpkvxfygzawzJbKHvnJHqvbGqa",208,0.990521,40,211,2,209,1,2,1,3,2,95,94,115,115,19
"1700",99,"[40]GIEHoIpntBkzFDCpkvxfygzawzJbKHvnJHqvbGqa",213,0.990741,40,216,2,214,1,2,1,3,2,104,103,111,111,19
"1701",0,"[33]IvHoIeuBwlmwvtobKDeeenHsnJHqxbGqa",192,0.989744,33,195,2,193,1,2,1,3,2,88,87,106,106,20
"1702",1,"[33]IvHoIeuBwlmwvtobKDeeenHsnJHqxbGqa",182,0.989189,33,185,2,183,1,2,1,3,2,75,74,109,109,20
"1703",2,"[33]IvHoIeuBwlmwvtobKDeeenHsnJHqxbGqa",215,0.990826,33,218,2,216,1,2,1,3,2,119,118,98,98,20
"1704",3,"[33]IvHoIeuBwlmwvtobKDeeenHsnJHqxbGqa",217,0.990909,33,220,2,218,1,2,1,3,2,124,123,95,95,20
"1705",4,"[33]IvHoIeuBwlmwvtobKDeeenHsnJHqxbGqa",203,0.990291,33,206,2,204,1,2,1,3,2,103,102,102,102,20
"1706",5,"[33]IvHoIeuBwlmwvtobKDeeenHsnJHqxbGqa",204,0.990338,33,207,2,205,1,2,1,3,2,103,102,103,103,20
"1707",6,"[33]IvHoIeuBwlmwvtobKDeeenHsnJHqxbGqa",205,0.990385,33,208,2,206,1,2,1,3,2,107,106,100,100,20
"1708",7,"[33]IvHoIeuBwlmwvtobKDeeenHsnJHqxbGqa",193,0.989796,33,196,2,194,1,2,1,3,2,90,89,105,105,20
"1709",8,"[33]IvHoIeuBwlmwvtobKDeeenHsnJHqxbGqa",211,0.990654,33,214,2,212,1,2,1,3,2,115,114,98,98,20
"1710",9,"[33]IvHoIeuBwlmwvtobKDeeenHsnJHqxbGqa",197,0.99,33,200,2,198,1,2,1,3,2,96,95,103,103,20
"1711",10,"[33]IvHoIeuBwlmwvtobKDeeenHsnJHqxbGqa",207,0.990476,33,210,2,208,1,2,1,3,2,107,106,102,102,20
"1712",11,"[33]IvHoIeuBwlmwvtobKDeeenHsnJHqxbGqa",183,0.989247,33,186,2,184,1,2,1,3,2,77,76,108,108,20
"1713",12,"[33]IvHoIeuBwlmwvtobKDeeenHsnJHqxbGqa",205,0.990385,33,208,2,206,1,2,1,3,2,108,107,99,99,20
"1714",13,"[33]IvHoIeuBwlmwvtobKDeeenHsnJHqxbGqa",210,0.99061,33,213,2,211,1,2,1,3,2,113,112,99,99,20
"1715",14,"[33]IvHoIeuBwlmwvtobKDeeenHsnJHqxbGqa",221,0.991071,33,224,2,222,1,2,1,3,2,127,126,96,96,20
"1716",15,"[33]IvHoIeuBwlmwvtobKDeeenHsnJHqxbGqa",196,0.98995,33,199,2,197,1,2,1,3,2,95,94,103,103,20
"1717",16,"[33]IvHoIeuBwlmwvtobKDeeenHsnJHqxbGqa",212,0.990698,33,215,2,213,1,2,1,3,2,118,117,96,96,20
"1718",17,"[33]IvHoIeuBwlmwvtobKDeeenHsnJHqxbGqa",208,0.990521,33,211,2,209,1,2,1,3,2,110,109,100,100,20
"1719",18,"[33]IvHoIeuBwlmwvtobKDeeenHsnJHqxbGqa",208,0.990521,33,211,2,209,1,2,1,3,2,111,110,99,99,20
"1720",19,"[33]IvHoIeuBwlmwvtobKDeeenHsnJHqxbGqa",191,0.989691,33,194,2,192,1,2,1,3,2,89,88,104,104,20
"1721",20,"[33]IvHoIeuBwlmwvtobKDeeenHsnJHqxbGqa",189,0.989583,33,192,2,190,1,2,1,3,2,84,83,107,107,20
"1722",21,"[33]IvHoIeuBwlmwvtobKDeeenHsnJHqxbGqa",206,0.990431,33,209,2,207,1,2,1,3,2,107,106,101,101,20
"1723",22,"[33]IvHoIeuBwlmwvtobKDeeenHsnJHqxbGqa",200,0.990148,33,203,2,201,1,2,1,3,2,99,98,103,103,20
"1724",23,"[33]IvHoIeuBwlmwvtobKDeeenHsnJHqxbGqa",212,0.990698,33,215,2,213,1,2,1,3,2,117,116,97,97,20
"1725",24,"[33]IvHoIeuBwlmwvtobKDeeenHsnJHqxbGqa",211,0.990654,33,214,2,212,1,2,1,3,2,112,111,101,101,20
"1726",25,"[33]IvHoIeuBwlmwvtobKDeeenHsnJHqxbGqa",204,0.990338,33,207,2,205,1,2,1,3,2,105,104,101,101,20
"1727",26,"[33]IvHoIeuBwlmwvtobKDeeenHsnJHqxbGqa",204,0.990338,33,207,2,205,1,2,1,3,2,106,105,100,100,20
"1728",27,"[33]IvHoIeuBwlmwvtobKDeeenHsnJHqxbGqa",206,0.990431,33,209,2,207,1,2,1,3,2,107,106,101,101,20
"1729",28,"[33]IvHoIeuBwlmwvtobKDeeenHsnJHqxbGqa",193,0.989796,33,196,2,194,1,2,1,3,2,92,91,103,103,20
"1730",29,"[33]IvHoIeuBwlmwvtobKDeeenHsnJHqxbGqa",194,0.989848,33,197,2,195,1,2,1,3,2,95,94,101,101,20
"1731",30,"[33]IvHoIeuBwlmwvtobKDeeenHsnJHqxbGqa",195,0.989899,33,198,2,196,1,2,1,3,2,92,91,105,105,20
"1732",31,"[33]IvHoIeuBwlmwvtobKDeeenHsnJHqxbGqa",204,0.990338,33,207,2,205,1,2,1,3,2,106,105,100,100,20
"1733",32,"[33]IvHoIeuBwlmwvtobKDeeenHsnJHqxbGqa",206,0.990431,33,209,2,207,1,2,1,3,2,108,107,100,100,20
"1734",33,"[33]IvHoIeuBwlmwvtobKDeeenHsnJHqxbGqa",199,0.990099,33,202,2,200,1,2,1,3,2,98,97,103,103,20
"1735",34,"[33]IvHoIeuBwlmwvtobKDeeenHsnJHqxbGqa",195,0.989899,33,198,2,196,1,2,1,3,2,93,92,104,104,20
"1736",35,"[33]IvHoIeuBwlmwvtobKDeeenHsnJHqxbGqa",200,0.990148,33,203,2,201,1,2,1,3,2,101,100,101,101,20
"1737",36,"[33]IvHoIeuBwlmwvtobKDeeenHsnJHqxbGqa",219,0.990991,33,222,2,220,1,2,1,3,2,129,128,92,92,20
"1738",37,"[33]IvHoIeuBwlmwvtobKDeeenHsnJHqxbGqa",189,0.989583,33,192,2,190,1,2,1,3,2,86,85,105,105,20
"1739",38,"[33]IvHoIeuBwlmwvtobKDeeenHsnJHqxbGqa",205,0.990385,33,208,2,206,1,2,1,3,2,108,107,99,99,20
"1740",39,"[33]IvHoIeuBwlmwvtobKDeeenHsnJHqxbGqa",201,0.990196,33,204,2,202,1,2,1,3,2,101,100,102,102,20
"1741",40,"[33]IvHoIeuBwlmwvtobKDeeenHsnJHqxbGqa",197,0.99,33,200,2,198,1,2,1,3,2,95,94,104,104,20
"1742",41,"[33]IvHoIeuBwlmwvtobKDeeenHsnJHqxbGqa",202,0.990244,33,205,2,203,1,2,1,3,2,103,102,101,101,20
"1743",42,"[33]IvHoIeuBwlmwvtobKDeeenHsnJHqxbGqa",198,0.99005,33,201,2,199,1,2,1,3,2,97,96,103,103,20
"1744",43,"[33]IvHoIeuBwlmwvtobKDeeenHsnJHqxbGqa",211,0.990654,33,214,2,212,1,2,1,3,2,115,114,98,98,20
"1745",44,"[33]IvHoIeuBwlmwvtobKDeeenHsnJHqxbGqa",203,0.990291,33,206,2,204,1,2,1,3,2,104,103,101,101,20
"1746",45,"[33]IvHoIeuBwlmwvtobKDeeenHsnJHqxbGqa",204,0.990338,33,207,2,205,1,2,1,3,2,107,106,99,99,20
"1747",46,"[33]IvHoIeuBwlmwvtobKDeeenHsnJHqxbGqa",196,0.98995,33,199,2,197,1,2,1,3,2,96,95,102,102,20
"1748",47,"[33]IvHoIeuBwlmwvtobKDeeenHsnJHqxbGqa",210,0.99061,33,213,2,211,1,2,1,3,2,112,111,100,100,20
"1749",48,"[33]IvHoIeuBwlmwvtobKDeeenHsnJHqxbGqa",188,0.989529,33,191,2,189,1,2,1,3,2,83,82,107,107,20
"1750",49,"[33]IvHoIeuBwlmwvtobKDeeenHsnJHqxbGqa",204,0.990338,33,207,2,205,1,2,1,3,2,107,106,99,99,20
"1751",50,"[33]IvHoIeuBwlmwvtobKDeeenHsnJHqxbGqa",219,0.990991,33,222,2,220,1,2,1,3,2,125,124,96,96,20
"1752",51,"[33]IvHoIeuBwlmwvtobKDeeenHsnJHqxbGqa",200,0.990148,33,203,2,201,1,2,1,3,2,100,99,102,102,20
"1753",52,"[33]IvHoIeuBwlmwvtobKDeeenHsnJHqxbGqa",204,0.990338,33,207,2,205,1,2,1,3,2,105,104,101,101,20
"1754",53,"[33]IvHoIeuBwlmwvtobKDeeenHsnJHqxbGqa",183,0.989247,33,186,2,184,1,2,1,3,2,77,76,108,108,20
"1755",54,"[33]IvHoIeuBwlmwvtobKDeeenHsnJHqxbGqa",205,0.990385,33,208,2,206,1,2,1,3,2,108,107,99,99,20
"1756",55,"[33]IvHoIeuBwlmwvtobKDeeenHsnJHqxbGqa",200,0.990148,33,203,2,201,1,2,1,3,2,100,99,102,102,20
"1757",56,"[33]IvHoIeuBwlmwvtobKDeeenHsnJHqxbGqa",200,0.990148,33,203,2,201,1,2,1,3,2,101,100,101,101,20
"1758",57,"[33]IvHoIeuBwlmwvtobKDeeenHsnJHqxbGqa",198,0.99005,33,201,2,199,1,2,1,3,2,97,96,103,103,20
"1759",58,"[33]IvHoIeuBwlmwvtobKDeeenHsnJHqxbGqa",207,0.990476,33,210,2,208,1,2,1,3,2,110,109,99,99,20
"1760",59,"[33]IvHoIeuBwlmwvtobKDeeenHsnJHqxbGqa",204,0.990338,33,207,2,205,1,2,1,3,2,107,106,99,99,20
"1761",60,"[33]IvHoIeuBwlmwvtobKDeeenHsnJHqxbGqa",214,0.990783,33,217,2,215,1,2,1,3,2,121,120,95,95,20
"1762",61,"[33]IvHoIeuBwlmwvtobKDeeenHsnJHqxbGqa",208,0.990521,33,211,2,209,1,2,1,3,2,111,110,99,99,20
"1763",62,"[33]IvHoIeuBwlmwvtobKDeeenHsnJHqxbGqa",202,0.990244,33,205,2,203,1,2,1,3,2,102,101,102,102,20
"1764",63,"[33]IvHoIeuBwlmwvtobKDeeenHsnJHqxbGqa",206,0.990431,33,209,2,207,1,2,1,3,2,107,106,101,101,20
"1765",64,"[33]IvHoIeuBwlmwvtobKDeeenHsnJHqxbGqa",191,0.989691,33,194,2,192,1,2,1,3,2,89,88,104,104,20
"1766",65,"[33]IvHoIeuBwlmwvtobKDeeenHsnJHqxbGqa",198,0.99005,33,201,2,199,1,2,1,3,2,96,95,104,104,20
"1767",66,"[33]IvHoIeuBwlmwvtobKDeeenHsnJHqxbGqa",202,0.990244,33,205,2,203,1,2,1,3,2,102,101,102,102,20
"1768",67,"[33]IvHoIeuBwlmwvtobKDeeenHsnJHqxbGqa",198,0.99005,33,201,2,199,1,2,1,3,2,97,96,103,103,20
"1769",68,"[33]IvHoIeuBwlmwvtobKDeeenHsnJHqxbGqa",215,0.990826,33,218,2,216,1,2,1,3,2,118,117,99,99,20
"1770",69,"[33]IvHoIeuBwlmwvtobKDeeenHsnJHqxbGqa",188,0.989529,33,191,2,189,1,2,1,3,2,83,82,107,107,20
"1771",70,"[33]IvHoIeuBwlmwvtobKDeeenHsnJHqxbGqa",205,0.990385,33,208,2,206,1,2,1,3,2,109,108,98,98,20
"1772",71,"[33]IvHoIeuBwlmwvtobKDeeenHsnJHqxbGqa",195,0.989899,33,198,2,196,1,2,1,3,2,93,92,104,104,20
"1773",72,"[33]IvHoIeuBwlmwvtobKDeeenHsnJHqxbGqa",198,0.99005,33,201,2,199,1,2,1,3,2,96,95,104,104,20
"1774",73,"[33]IvHoIeuBwlmwvtobKDeeenHsnJHqxbGqa",207,0.990476,33,210,2,208,1,2,1,3,2,110,109,99,99,20
"1775",74,"[33]IvHoIeuBwlmwvtobKDeeenHsnJHqxbGqa",201,0.990196,33,204,2,202,1,2,1,3,2,103,102,100,100,20
"1776",75,"[33]IvHoIeuBwlmwvtobKDeeenHsnJHqxbGqa",212,0.990698,33,215,2,213,1,2,1,3,2,115,114,99,99,20
"1777",76,"[33]IvHoIeuBwlmwvtobKDeeenHsnJHqxbGqa",196,0.98995,33,199,2,197,1,2,1,3,2,92,91,106,106,20
"1778",77,"[33]IvHoIeuBwlmwvtobKDeeenHsnJHqxbGqa",215,0.990826,33,218,2,216,1,2,1,3,2,122,121,95,95,20
"1779",78,"[33]IvHoIeuBwlmwvtobKDeeenHsnJHqxbGqa",196,0.98995,33,199,2,197,1,2,1,3,2,94,93,104,104,20
"1780",79,"[33]IvHoIeuBwlmwvtobKDeeenHsnJHqxbGqa",213,0.990741,33,216,2,214,1,2,1,3,2,117,116,98,98,20
"1781",80,"[33]IvHoIeuBwlmwvtobKDeeenHsnJHqxbGqa",213,0.990741,33,216,2,214,1,2,1,3,2,119,118,96,96,20
"1782",81,"[33]IvHoIeuBwlmwvtobKDeeenHsnJHqxbGqa",190,0.989637,33,193,2,191,1,2,1,3,2,87,86,105,105,20
"1783",82,"[33]IvHoIeuBwlmwvtobKDeeenHsnJHqxbGqa",203,0.990291,33,206,2,204,1,2,1,3,2,104,103,101,101,20
"1784",83,"[33]IvHoIeuBwlmwvtobKDeeenHsnJHqxbGqa",208,0.990521,33,211,2,209,1,2,1,3,2,112,111,98,98,20
"1785",84,"[33]IvHoIeuBwlmwvtobKDeeenHsnJHqxbGqa",209,0.990566,33,212,2,210,1,2,1,3,2,112,111,99,99,20
"1786",85,"[33]IvHoIeuBwlmwvtobKDeeenHsnJHqxbGqa",201,0.990196,33,204,2,202,1,2,1,3,2,103,102,100,100,20
"1787",86,"[33]IvHoIeuBwlmwvtobKDeeenHsnJHqxbGqa",196,0.98995,33,199,2,197,1,2,1,3,2,99,98,99,99,20
"1788",87,"[33]IvHoIeuBwlmwvtobKDeeenHsnJHqxbGqa",204,0.990338,33,207,2,205,1,2,1,3,2,107,106,99,99,20
"1789",88,"[33]IvHoIeuBwlmwvtobKDeeenHsnJHqxbGqa",201,0.990196,33,204,2,202,1,2,1,3,2,102,101,101,101,20
"1790",89,"[33]IvHoIeuBwlmwvtobKDeeenHsnJHqxbGqa",217,0.990909,33,220,2,218,1,2,1,3,2,124,123,95,95,20
"1791",90,"[33]IvHoIeuBwlmwvtobKDeeenHsnJHqxbGqa",195,0.989899,33,198,2,196,1,2,1,3,2,94,93,103,103,20
"1792",91,"[33]IvHoIeuBwlmwvtobKDeeenHsnJHqxbGqa",205,0.990385,33,208,2,206,1,2,1,3,2,106,105,101,101,20
"1793",92,"[33]IvHoIeuBwlmwvtobKDeeenHsnJHqxbGqa",214,0.990783,33,217,2,215,1,2,1,3,2,119,118,97,97,20
"1794",93,"[33]IvHoIeuBwlmwvtobKDeeenHsnJHqxbGqa",209,0.990566,33,212,2,210,1,2,1,3,2,111,110,100,100,20
"1795",94,"[33]IvHoIeuBwlmwvtobKDeeenHsnJHqxbGqa",198,0.99005,33,201,2,199,1,2,1,3,2,99,98,101,101,20
"1796",95,"[33]IvHoIeuBwlmwvtobKDeeenHsnJHqxbGqa",211,0.990654,33,214,2,212,1,2,1,3,2,116,115,97,97,20
"1797",96,"[33]IvHoIeuBwlmwvtobKDeeenHsnJHqxbGqa",218,0.99095,33,221,2,219,1,2,1,3,2,122,121,98,98,20
"1798",97,"[33]IvHoIeuBwlmwvtobKDeeenHsnJHqxbGqa",207,0.990476,33,210,2,208,1,2,1,3,2,109,108,100,100,20
"1799",98,"[33]IvHoIeuBwlmwvtobKDeeenHsnJHqxbGqa",196,0.98995,33,199,2,197,1,2,1,3,2,96,95,102,102,20
"1800",99,"[33]IvHoIeuBwlmwvtobKDeeenHsnJHqxbGqa",197,0.99,33,200,2,198,1,2,1,3,2,96,95,103,103,20
"1801",0,"[40]vIHHoIpCtBkDnxqCBBuFBebKDeekzHxnJHqvbGqa",196,0.98995,40,199,2,197,1,2,1,3,2,94,93,104,104,21
"1802",1,"[40]vIHHoIpCtBkDnxqCBBuFBebKDeekzHxnJHqvbGqa",196,0.98995,40,199,2,197,1,2,1,3,2,94,93,104,104,21
"1803",2,"[40]vIHHoIpCtBkDnxqCBBuFBebKDeekzHxnJHqvbGqa",208,0.990521,40,211,2,209,1,2,1,3,2,111,110,99,99,21
"1804",3,"[40]vIHHoIpCtBkDnxqCBBuFBebKDeekzHxnJHqvbGqa",197,0.99,40,200,2,198,1,2,1,3,2,96,95,103,103,21
"1805",4,"[40]vIHHoIpCtBkDnxqCBBuFBebKDeekzHxnJHqvbGqa",217,0.990909,40,220,2,218,1,2,1,3,2,122,121,97,97,21
"1806",5,"[40]vIHHoIpCtBkDnxqCBBuFBebKDeekzHxnJHqvbGqa",198,0.99005,40,201,2,199,1,2,1,3,2,97,96,103,103,21
"1807",6,"[40]vIHHoIpCtBkDnxqCBBuFBebKDeekzHxnJHqvbGqa",206,0.990431,40,209,2,207,1,2,1,3,2,111,110,97,97,21
"1808",7,"[40]vIHHoIpCtBkDnxqCBBuFBebKDeekzHxnJHqvbGqa",203,0.990291,40,206,2,204,1,2,1,3,2,106,105,99,99,21
"1809",8,"[40]vIHHoIpCtBkDnxqCBBuFBebKDeekzHxnJHqvbGqa",186,0.989418,40,189,2,187,1,2,1,3,2,81,80,107,107,21
"1810",9,"[40]vIHHoIpCtBkDnxqCBBuFBebKDeekzHxnJHqvbGqa",192,0.989744,40,195,2,193,1,2,1,3,2,91,90,103,103,21
"1811",10,"[40]vIHHoIpCtBkDnxqCBBuFBebKDeekzHxnJHqvbGqa",198,0.99005,40,201,2,199,1,2,1,3,2,99,98,101,101,21
"1812",11,"[40]vIHHoIpCtBkDnxqCBBuFBebKDeekzHxnJHqvbGqa",205,0.990385,40,208,2,206,1,2,1,3,2,109,108,98,98,21
"1813",12,"[40]vIHHoIpCtBkDnxqCBBuFBebKDeekzHxnJHqvbGqa",204,0.990338,40,207,2,205,1,2,1,3,2,104,103,102,102,21
"1814",13,"[40]vIHHoIpCtBkDnxqCBBuFBebKDeekzHxnJHqvbGqa",213,0.990741,40,216,2,214,1,2,1,3,2,117,116,98,98,21
"1815",14,"[40]vIHHoIpCtBkDnxqCBBuFBebKDeekzHxnJHqvbGqa",198,0.99005,40,201,2,199,1,2,1,3,2,98,97,102,102,21
"1816",15,"[40]vIHHoIpCtBkDnxqCBBuFBebKDeekzHxnJHqvbGqa",208,0.990521,40,211,2,209,1,2,1,3,2,113,112,97,97,21
"1817",16,"[40]vIHHoIpCtBkDnxqCBBuFBebKDeekzHxnJHqvbGqa",212,0.990698,40,215,2,213,1,2,1,3,2,117,116,97,97,21
"1818",17,"[40]vIHHoIpCtBkDnxqCBBuFBebKDeekzHxnJHqvbGqa",204,0.990338,40,207,2,205,1,2,1,3,2,107,106,99,99,21
"1819",18,"[40]vIHHoIpCtBkDnxqCBBuFBebKDeekzHxnJHqvbGqa",203,0.990291,40,206,2,204,1,2,1,3,2,106,105,99,99,21
"1820",19,"[40]vIHHoIpCtBkDnxqCBBuFBebKDeekzHxnJHqvbGqa",194,0.989848,40,197,2,195,1,2,1,3,2,92,91,104,104,21
"1821",20,"[40]vIHHoIpCtBkDnxqCBBuFBebKDeekzHxnJHqvbGqa",197,0.99,40,200,2,198,1,2,1,3,2,95,94,104,104,21
"1822",21,"[40]vIHHoIpCtBkDnxqCBBuFBebKDeekzHxnJHqvbGqa",199,0.990099,40,202,2,200,1,2,1,3,2,98,97,103,103,21
"1823",22,"[40]vIHHoIpCtBkDnxqCBBuFBebKDeekzHxnJHqvbGqa",215,0.990826,40,218,2,216,1,2,1,3,2,119,118,98,98,21
"1824",23,"[40]vIHHoIpCtBkDnxqCBBuFBebKDeekzHxnJHqvbGqa",209,0.990566,40,212,2,210,1,2,1,3,2,116,115,95,95,21
"1825",24,"[40]vIHHoIpCtBkDnxqCBBuFBebKDeekzHxnJHqvbGqa",205,0.990385,40,208,2,206,1,2,1,3,2,108,107,99,99,21
"1826",25,"[40]vIHHoIpCtBkDnxqCBBuFBebKDeekzHxnJHqvbGqa",214,0.990783,40,217,2,215,1,2,1,3,2,120,119,96,96,21
"1827",26,"[40]vIHHoIpCtBkDnxqCBBuFBebKDeekzHxnJHqvbGqa",199,0.990099,40,202,2,200,1,2,1,3,2,99,98,102,102,21
"1828",27,"[40]vIHHoIpCtBkDnxqCBBuFBebKDeekzHxnJHqvbGqa",209,0.990566,40,212,2,210,1,2,1,3,2,114,113,97,97,21
"1829",28,"[40]vIHHoIpCtBkDnxqCBBuFBebKDeekzHxnJHqvbGqa",191,0.989691,40,194,2,192,1,2,1,3,2,89,88,104,104,21
"1830",29,"[40]vIHHoIpCtBkDnxqCBBuFBebKDeekzHxnJHqvbGqa",210,0.99061,40,213,2,211,1,2,1,3,2,113,112,99,99,21
"1831",30,"[40]vIHHoIpCtBkDnxqCBBuFBebKDeekzHxnJHqvbGqa",204,0.990338,40,207,2,205,1,2,1,3,2,105,104,101,101,21
"1832",31,"[40]vIHHoIpCtBkDnxqCBBuFBebKDeekzHxnJHqvbGqa",202,0.990244,40,205,2,203,1,2,1,3,2,104,103,100,100,21
"1833",32,"[40]vIHHoIpCtBkDnxqCBBuFBebKDeekzHxnJHqvbGqa",193,0.989796,40,196,2,194,1,2,1,3,2,89,88,106,106,21
"1834",33,"[40]vIHHoIpCtBkDnxqCBBuFBebKDeekzHxnJHqvbGqa",195,0.989899,40,198,2,196,1,2,1,3,2,91,90,106,106,21
"1835",34,"[40]vIHHoIpCtBkDnxqCBBuFBebKDeekzHxnJHqvbGqa",196,0.98995,40,199,2,197,1,2,1,3,2,94,93,104,104,21
"1836",35,"[40]vIHHoIpCtBkDnxqCBBuFBebKDeekzHxnJHqvbGqa",198,0.99005,40,201,2,199,1,2,1,3,2,98,97,102,102,21
"1837",36,"[40]vIHHoIpCtBkDnxqCBBuFBebKDeekzHxnJHqvbGqa",200,0.990148,40,203,2,201,1,2,1,3,2,101,100,101,101,21
"1838",37,"[40]vIHHoIpCtBkDnxqCBBuFBebKDeekzHxnJHqvbGqa",198,0.99005,40,201,2,199,1,2,1,3,2,98,97,102,102,21
"1839",38,"[40]vIHHoIpCtBkDnxqCBBuFBebKDeekzHxnJHqvbGqa",198,0.99005,40,201,2,199,1,2,1,3,2,97,96,103,103,21
"1840",39,"[40]vIHHoIpCtBkDnxqCBBuFBebKDeekzHxnJHqvbGqa",201,0.990196,40,204,2,202,1,2,1,3,2,103,102,100,100,21
"1841",40,"[40]vIHHoIpCtBkDnxqCBBuFBebKDeekzHxnJHqvbGqa",207,0.990476,40,210,2,208,1,2,1,3,2,112,111,97,97,21
"1842",41,"[40]vIHHoIpCtBkDnxqCBBuFBebKDeekzHxnJHqvbGqa",193,0.989796,40,196,2,194,1,2,1,3,2,91,90,104,104,21
"1843",42,"[40]vIHHoIpCtBkDnxqCBBuFBebKDeekzHxnJHqvbGqa",209,0.990566,40,212,2,210,1,2,1,3,2,111,110,100,100,21
"1844",43,"[40]vIHHoIpCtBkDnxqCBBuFBebKDeekzHxnJHqvbGqa",195,0.989899,40,198,2,196,1,2,1,3,2,96,95,101,101,21
"1845",44,"[40]vIHHoIpCtBkDnxqCBBuFBebKDeekzHxnJHqvbGqa",202,0.990244,40,205,2,203,1,2,1,3,2,104,103,100,100,21
"1846",45,"[40]vIHHoIpCtBkDnxqCBBuFBebKDeekzHxnJHqvbGqa",198,0.99005,40,201,2,199,1,2,1,3,2,97,96,103,103,21
"1847",46,"[40]vIHHoIpCtBkDnxqCBBuFBebKDeekzHxnJHqvbGqa",191,0.989691,40,194,2,192,1,2,1,3,2,91,90,102,102,21
"1848",47,"[40]vIHHoIpCtBkDnxqCBBuFBebKDeekzHxnJHqvbGqa",201,0.990196,40,204,2,202,1,2,1,3,2,103,102,100,100,21
"1849",48,"[40]vIHHoIpCtBkDnxqCBBuFBebKDeekzHxnJHqvbGqa",192,0.989744,40,195,2,193,1,2,1,3,2,86,85,108,108,21
"1850",49,"[40]vIHHoIpCtBkDnxqCBBuFBebKDeekzHxnJHqvbGqa",201,0.990196,40,204,2,202,1,2,1,3,2,100,99,103,103,21
"1851",50,"[40]vIHHoIpCtBkDnxqCBBuFBebKDeekzHxnJHqvbGqa",218,0.99095,40,221,2,219,1,2,1,3,2,124,123,96,96,21
"1852",51,"[40]vIHHoIpCtBkDnxqCBBuFBebKDeekzHxnJHqvbGqa",201,0.990196,40,204,2,202,1,2,1,3,2,104,103,99,99,21
"1853",52,"[40]vIHHoIpCtBkDnxqCBBuFBebKDeekzHxnJHqvbGqa",199,0.990099,40,202,2,200,1,2,1,3,2,100,99,101,101,21
"1854",53,"[40]vIHHoIpCtBkDnxqCBBuFBebKDeekzHxnJHqvbGqa",200,0.990148,40,203,2,201,1,2,1,3,2,99,98,103,103,21
"1855",54,"[40]vIHHoIpCtBkDnxqCBBuFBebKDeekzHxnJHqvbGqa",204,0.990338,40,207,2,205,1,2,1,3,2,105,104,101,101,21
"1856",55,"[40]vIHHoIpCtBkDnxqCBBuFBebKDeekzHxnJHqvbGqa",192,0.989744,40,195,2,193,1,2,1,3,2,90,89,104,104,21
"1857",56,"[40]vIHHoIpCtBkDnxqCBBuFBebKDeekzHxnJHqvbGqa",203,0.990291,40,206,2,204,1,2,1,3,2,108,107,97,97,21
"1858",57,"[40]vIHHoIpCtBkDnxqCBBuFBebKDeekzHxnJHqvbGqa",206,0.990431,40,209,2,207,1,2,1,3,2,109,108,99,99,21
"1859",58,"[40]vIHHoIpCtBkDnxqCBBuFBebKDeekzHxnJHqvbGqa",208,0.990521,40,211,2,209,1,2,1,3,2,111,110,99,99,21
"1860",59,"[40]vIHHoIpCtBkDnxqCBBuFBebKDeekzHxnJHqvbGqa",201,0.990196,40,204,2,202,1,2,1,3,2,104,103,99,99,21
"1861",60,"[40]vIHHoIpCtBkDnxqCBBuFBebKDeekzHxnJHqvbGqa",200,0.990148,40,203,2,201,1,2,1,3,2,100,99,102,102,21
"1862",61,"[40]vIHHoIpCtBkDnxqCBBuFBebKDeekzHxnJHqvbGqa",197,0.99,40,200,2,198,1,2,1,3,2,95,94,104,104,21
"1863",62,"[40]vIHHoIpCtBkDnxqCBBuFBebKDeekzHxnJHqvbGqa",202,0.990244,40,205,2,203,1,2,1,3,2,105,104,99,99,21
"1864",63,"[40]vIHHoIpCtBkDnxqCBBuFBebKDeekzHxnJHqvbGqa",208,0.990521,40,211,2,209,1,2,1,3,2,113,112,97,97,21
"1865",64,"[40]vIHHoIpCtBkDnxqCBBuFBebKDeekzHxnJHqvbGqa",201,0.990196,40,204,2,202,1,2,1,3,2,105,104,98,98,21
"1866",65,"[40]vIHHoIpCtBkDnxqCBBuFBebKDeekzHxnJHqvbGqa",210,0.99061,40,213,2,211,1,2,1,3,2,118,117,94,94,21
"1867",66,"[40]vIHHoIpCtBkDnxqCBBuFBebKDeekzHxnJHqvbGqa",199,0.990099,40,202,2,200,1,2,1,3,2,100,99,101,101,21
"1868",67,"[40]vIHHoIpCtBkDnxqCBBuFBebKDeekzHxnJHqvbGqa",197,0.99,40,200,2,198,1,2,1,3,2,96,95,103,103,21
"1869",68,"[40]vIHHoIpCtBkDnxqCBBuFBebKDeekzHxnJHqvbGqa",208,0.990521,40,211,2,209,1,2,1,3,2,113,112,97,97,21
"1870",69,"[40]vIHHoIpCtBkDnxqCBBuFBebKDeekzHxnJHqvbGqa",206,0.990431,40,209,2,207,1,2,1,3,2,108,107,100,100,21
"1871",70,"[40]vIHHoIpCtBkDnxqCBBuFBebKDeekzHxnJHqvbGqa",190,0.989637,40,193,2,191,1,2,1,3,2,88,87,104,104,21
"1872",71,"[40]vIHHoIpCtBkDnxqCBBuFBebKDeekzHxnJHqvbGqa",186,0.989418,40,189,2,187,1,2,1,3,2,81,80,107,107,21
"1873",72,"[40]vIHHoIpCtBkDnxqCBBuFBebKDeekzHxnJHqvbGqa",198,0.99005,40,201,2,199,1,2,1,3,2,97,96,103,103,21
"1874",73,"[40]vIHHoIpCtBkDnxqCBBuFBebKDeekzHxnJHqvbGqa",204,0.990338,40,207,2,205,1,2,1,3,2,104,103,102,102,21
"1875",74,"[40]vIHHoIpCtBkDnxqCBBuFBebKDeekzHxnJHqvbGqa",196,0.98995,40,199,2,197,1,2,1,3,2,97,96,101,101,21
"1876",75,"[40]vIHHoIpCtBkDnxqCBBuFBebKDeekzHxnJHqvbGqa",221,0.991071,40,224,2,222,1,2,1,3,2,128,127,95,95,21
"1877",76,"[40]vIHHoIpCtBkDnxqCBBuFBebKDeekzHxnJHqvbGqa",201,0.990196,40,204,2,202,1,2,1,3,2,102,101,101,101,21
"1878",77,"[40]vIHHoIpCtBkDnxqCBBuFBebKDeekzHxnJHqvbGqa",203,0.990291,40,206,2,204,1,2,1,3,2,103,102,102,102,21
"1879",78,"[40]vIHHoIpCtBkDnxqCBBuFBebKDeekzHxnJHqvbGqa",205,0.990385,40,208,2,206,1,2,1,3,2,106,105,101,101,21
"1880",79,"[40]vIHHoIpCtBkDnxqCBBuFBebKDeekzHxnJHqvbGqa",209,0.990566,40,212,2,210,1,2,1,3,2,114,113,97,97,21
"1881",80,"[40]vIHHoIpCtBkDnxqCBBuFBebKDeekzHxnJHqvbGqa",194,0.989848,40,197,2,195,1,2,1,3,2,92,91,104,104,21
"1882",81,"[40]vIHHoIpCtBkDnxqCBBuFBebKDeekzHxnJHqvbGqa",198,0.99005,40,201,2,199,1,2,1,3,2,99,98,101,101,21
"1883",82,"[40]vIHHoIpCtBkDnxqCBBuFBebKDeekzHxnJHqvbGqa",178,0.98895,40,181,2,179,1,2,1,3,2,70,69,110,110,21
"1884",83,"[40]vIHHoIpCtBkDnxqCBBuFBebKDeekzHxnJHqvbGqa",209,0.990566,40,212,2,210,1,2,1,3,2,113,112,98,98,21
"1885",84,"[40]vIHHoIpCtBkDnxqCBBuFBebKDeekzHxnJHqvbGqa",191,0.989691,40,194,2,192,1,2,1,3,2,88,87,105,105,21
"1886",85,"[40]vIHHoIpCtBkDnxqCBBuFBebKDeekzHxnJHqvbGqa",205,0.990385,40,208,2,206,1,2,1,3,2,108,107,99,99,21
"1887",86,"[40]vIHHoIpCtBkDnxqCBBuFBebKDeekzHxnJHqvbGqa",203,0.990291,40,206,2,204,1,2,1,3,2,105,104,100,100,21
"1888",87,"[40]vIHHoIpCtBkDnxqCBBuFBebKDeekzHxnJHqvbGqa",213,0.990741,40,216,2,214,1,2,1,3,2,120,119,95,95,21
"1889",88,"[40]vIHHoIpCtBkDnxqCBBuFBebKDeekzHxnJHqvbGqa",210,0.99061,40,213,2,211,1,2,1,3,2,115,114,97,97,21
"1890",89,"[40]vIHHoIpCtBkDnxqCBBuFBebKDeekzHxnJHqvbGqa",200,0.990148,40,203,2,201,1,2,1,3,2,101,100,101,101,21
"1891",90,"[40]vIHHoIpCtBkDnxqCBBuFBebKDeekzHxnJHqvbGqa",192,0.989744,40,195,2,193,1,2,1,3,2,90,89,104,104,21
"1892",91,"[40]vIHHoIpCtBkDnxqCBBuFBebKDeekzHxnJHqvbGqa",209,0.990566,40,212,2,210,1,2,1,3,2,113,112,98,98,21
"1893",92,"[40]vIHHoIpCtBkDnxqCBBuFBebKDeekzHxnJHqvbGqa",207,0.990476,40,210,2,208,1,2,1,3,2,110,109,99,99,21
"1894",93,"[40]vIHHoIpCtBkDnxqCBBuFBebKDeekzHxnJHqvbGqa",195,0.989899,40,198,2,196,1,2,1,3,2,94,93,103,103,21
"1895",94,"[40]vIHHoIpCtBkDnxqCBBuFBebKDeekzHxnJHqvbGqa",187,0.989474,40,190,2,188,1,2,1,3,2,84,83,105,105,21
"1896",95,"[40]vIHHoIpCtBkDnxqCBBuFBebKDeekzHxnJHqvbGqa",198,0.99005,40,201,2,199,1,2,1,3,2,99,98,101,101,21
"1897",96,"[40]vIHHoIpCtBkDnxqCBBuFBebKDeekzHxnJHqvbGqa",199,0.990099,40,202,2,200,1,2,1,3,2,97,96,104,104,21
"1898",97,"[40]vIHHoIpCtBkDnxqCBBuFBebKDeekzHxnJHqvbGqa",195,0.989899,40,198,2,196,1,2,1,3,2,95,94,102,102,21
"1899",98,"[40]vIHHoIpCtBkDnxqCBBuFBebKDeekzHxnJHqvbGqa",198,0.99005,40,201,2,199,1,2,1,3,2,98,97,102,102,21
"1900",99,"[40]vIHHoIpCtBkDnxqCBBuFBebKDeekzHxnJHqvbGqa",197,0.99,40,200,2,198,1,2,1,3,2,96,95,103,103,21
"1901",0,"[40]hIlHoIAocBkppDlateEdAsbKDaermHunJHqvbGqa",201,0.990196,40,204,2,202,1,2,1,3,2,102,101,101,101,23
"1902",1,"[40]hIlHoIAocBkppDlateEdAsbKDaermHunJHqvbGqa",209,0.990566,40,212,2,210,1,2,1,3,2,114,113,97,97,23
"1903",2,"[40]hIlHoIAocBkppDlateEdAsbKDaermHunJHqvbGqa",197,0.99,40,200,2,198,1,2,1,3,2,96,95,103,103,23
"1904",3,"[40]hIlHoIAocBkppDlateEdAsbKDaermHunJHqvbGqa",214,0.990783,40,217,2,215,1,2,1,3,2,121,120,95,95,23
"1905",4,"[40]hIlHoIAocBkppDlateEdAsbKDaermHunJHqvbGqa",203,0.990291,40,206,2,204,1,2,1,3,2,104,103,101,101,23
"1906",5,"[40]hIlHoIAocBkppDlateEdAsbKDaermHunJHqvbGqa",203,0.990291,40,206,2,204,1,2,1,3,2,104,103,101,101,23
"1907",6,"[40]hIlHoIAocBkppDlateEdAsbKDaermHunJHqvbGqa",201,0.990196,40,204,2,202,1,2,1,3,2,102,101,101,101,23
"1908",7,"[40]hIlHoIAocBkppDlateEdAsbKDaermHunJHqvbGqa",186,0.989418,40,189,2,187,1,2,1,3,2,81,80,107,107,23
"1909",8,"[40]hIlHoIAocBkppDlateEdAsbKDaermHunJHqvbGqa",205,0.990385,40,208,2,206,1,2,1,3,2,108,107,99,99,23
"1910",9,"[40]hIlHoIAocBkppDlateEdAsbKDaermHunJHqvbGqa",198,0.99005,40,201,2,199,1,2,1,3,2,101,100,99,99,23
"1911",10,"[40]hIlHoIAocBkppDlateEdAsbKDaermHunJHqvbGqa",196,0.98995,40,199,2,197,1,2,1,3,2,96,95,102,102,23
"1912",11,"[40]hIlHoIAocBkppDlateEdAsbKDaermHunJHqvbGqa",224,0.991189,40,227,2,225,1,2,1,3,2,134,133,92,92,23
"1913",12,"[40]hIlHoIAocBkppDlateEdAsbKDaermHunJHqvbGqa",207,0.990476,40,210,2,208,1,2,1,3,2,110,109,99,99,23
"1914",13,"[40]hIlHoIAocBkppDlateEdAsbKDaermHunJHqvbGqa",195,0.989899,40,198,2,196,1,2,1,3,2,93,92,104,104,23
"1915",14,"[40]hIlHoIAocBkppDlateEdAsbKDaermHunJHqvbGqa",190,0.989637,40,193,2,191,1,2,1,3,2,88,87,104,104,23
"1916",15,"[40]hIlHoIAocBkppDlateEdAsbKDaermHunJHqvbGqa",191,0.989691,40,194,2,192,1,2,1,3,2,85,84,108,108,23
"1917",16,"[40]hIlHoIAocBkppDlateEdAsbKDaermHunJHqvbGqa",204,0.990338,40,207,2,205,1,2,1,3,2,106,105,100,100,23
"1918",17,"[40]hIlHoIAocBkppDlateEdAsbKDaermHunJHqvbGqa",183,0.989247,40,186,2,184,1,2,1,3,2,80,79,105,105,23
"1919",18,"[40]hIlHoIAocBkppDlateEdAsbKDaermHunJHqvbGqa",188,0.989529,40,191,2,189,1,2,1,3,2,85,84,105,105,23
"1920",19,"[40]hIlHoIAocBkppDlateEdAsbKDaermHunJHqvbGqa",195,0.989899,40,198,2,196,1,2,1,3,2,96,95,101,101,23
"1921",20,"[40]hIlHoIAocBkppDlateEdAsbKDaermHunJHqvbGqa",196,0.98995,40,199,2,197,1,2,1,3,2,94,93,104,104,23
"1922",21,"[40]hIlHoIAocBkppDlateEdAsbKDaermHunJHqvbGqa",209,0.990566,40,212,2,210,1,2,1,3,2,111,110,100,100,23
"1923",22,"[40]hIlHoIAocBkppDlateEdAsbKDaermHunJHqvbGqa",189,0.989583,40,192,2,190,1,2,1,3,2,87,86,104,104,23
"1924",23,"[40]hIlHoIAocBkppDlateEdAsbKDaermHunJHqvbGqa",192,0.989744,40,195,2,193,1,2,1,3,2,88,87,106,106,23
"1925",24,"[40]hIlHoIAocBkppDlateEdAsbKDaermHunJHqvbGqa",196,0.98995,40,199,2,197,1,2,1,3,2,94,93,104,104,23
"1926",25,"[40]hIlHoIAocBkppDlateEdAsbKDaermHunJHqvbGqa",211,0.990654,40,214,2,212,1,2,1,3,2,116,115,97,97,23
"1927",26,"[40]hIlHoIAocBkppDlateEdAsbKDaermHunJHqvbGqa",203,0.990291,40,206,2,204,1,2,1,3,2,105,104,100,100,23
"1928",27,"[40]hIlHoIAocBkppDlateEdAsbKDaermHunJHqvbGqa",209,0.990566,40,212,2,210,1,2,1,3,2,114,113,97,97,23
"1929",28,"[40]hIlHoIAocBkppDlateEdAsbKDaermHunJHqvbGqa",208,0.990521,40,211,2,209,1,2,1,3,2,110,109,100,100,23
"1930",29,"[40]hIlHoIAocBkppDlateEdAsbKDaermHunJHqvbGqa",205,0.990385,40,208,2,206,1,2,1,3,2,104,103,103,103,23
"1931",30,"[40]hIlHoIAocBkppDlateEdAsbKDaermHunJHqvbGqa",198,0.99005,40,201,2,199,1,2,1,3,2,96,95,104,104,23
"1932",31,"[40]hIlHoIAocBkppDlateEdAsbKDaermHunJHqvbGqa",199,0.990099,40,202,2,200,1,2,1,3,2,99,98,102,102,23
"1933",32,"[40]hIlHoIAocBkppDlateEdAsbKDaermHunJHqvbGqa",207,0.990476,40,210,2,208,1,2,1,3,2,108,107,101,101,23
"1934",33,"[40]hIlHoIAocBkppDlateEdAsbKDaermHunJHqvbGqa",203,0.990291,40,206,2,204,1,2,1,3,2,106,105,99,99,23
"1935",34,"[40]hIlHoIAocBkppDlateEdAsbKDaermHunJHqvbGqa",200,0.990148,40,203,2,201,1,2,1,3,2,98,97,104,104,23
"1936",35,"[40]hIlHoIAocBkppDlateEdAsbKDaermHunJHqvbGqa",203,0.990291,40,206,2,204,1,2,1,3,2,106,105,99,99,23
"1937",36,"[40]hIlHoIAocBkppDlateEdAsbKDaermHunJHqvbGqa",221,0.991071,40,224,2,222,1,2,1,3,2,127,126,96,96,23
"1938",37,"[40]hIlHoIAocBkppDlateEdAsbKDaermHunJHqvbGqa",197,0.99,40,200,2,198,1,2,1,3,2,94,93,105,105,23
"1939",38,"[40]hIlHoIAocBkppDlateEdAsbKDaermHunJHqvbGqa",207,0.990476,40,210,2,208,1,2,1,3,2,109,108,100,100,23
"1940",39,"[40]hIlHoIAocBkppDlateEdAsbKDaermHunJHqvbGqa",212,0.990698,40,215,2,213,1,2,1,3,2,118,117,96,96,23
"1941",40,"[40]hIlHoIAocBkppDlateEdAsbKDaermHunJHqvbGqa",202,0.990244,40,205,2,203,1,2,1,3,2,106,105,98,98,23
"1942",41,"[40]hIlHoIAocBkppDlateEdAsbKDaermHunJHqvbGqa",196,0.98995,40,199,2,197,1,2,1,3,2,95,94,103,103,23
"1943",42,"[40]hIlHoIAocBkppDlateEdAsbKDaermHunJHqvbGqa",198,0.99005,40,201,2,199,1,2,1,3,2,99,98,101,101,23
"1944",43,"[40]hIlHoIAocBkppDlateEdAsbKDaermHunJHqvbGqa",208,0.990521,40,211,2,209,1,2,1,3,2,112,111,98,98,23
"1945",44,"[40]hIlHoIAocBkppDlateEdAsbKDaermHunJHqvbGqa",192,0.989744,40,195,2,193,1,2,1,3,2,92,91,102,102,23
"1946",45,"[40]hIlHoIAocBkppDlateEdAsbKDaermHunJHqvbGqa",188,0.989529,40,191,2,189,1,2,1,3,2,83,82,107,107,23
"1947",46,"[40]hIlHoIAocBkppDlateEdAsbKDaermHunJHqvbGqa",179,0.989011,40,182,2,180,1,2,1,3,2,71,70,110,110,23
"1948",47,"[40]hIlHoIAocBkppDlateEdAsbKDaermHunJHqvbGqa",206,0.990431,40,209,2,207,1,2,1,3,2,110,109,98,98,23
"1949",48,"[40]hIlHoIAocBkppDlateEdAsbKDaermHunJHqvbGqa",203,0.990291,40,206,2,204,1,2,1,3,2,105,104,100,100,23
"1950",49,"[40]hIlHoIAocBkppDlateEdAsbKDaermHunJHqvbGqa",203,0.990291,40,206,2,204,1,2,1,3,2,101,100,104,104,23
"1951",50,"[40]hIlHoIAocBkppDlateEdAsbKDaermHunJHqvbGqa",201,0.990196,40,204,2,202,1,2,1,3,2,102,101,101,101,23
"1952",51,"[40]hIlHoIAocBkppDlateEdAsbKDaermHunJHqvbGqa",201,0.990196,40,204,2,202,1,2,1,3,2,101,100,102,102,23
"1953",52,"[40]hIlHoIAocBkppDlateEdAsbKDaermHunJHqvbGqa",196,0.98995,40,199,2,197,1,2,1,3,2,96,95,102,102,23
"1954",53,"[40]hIlHoIAocBkppDlateEdAsbKDaermHunJHqvbGqa",193,0.989796,40,196,2,194,1,2,1,3,2,92,91,103,103,23
"1955",54,"[40]hIlHoIAocBkppDlateEdAsbKDaermHunJHqvbGqa",203,0.990291,40,206,2,204,1,2,1,3,2,103,102,102,102,23
"1956",55,"[40]hIlHoIAocBkppDlateEdAsbKDaermHunJHqvbGqa",212,0.990698,40,215,2,213,1,2,1,3,2,115,114,99,99,23
"1957",56,"[40]hIlHoIAocBkppDlateEdAsbKDaermHunJHqvbGqa",201,0.990196,40,204,2,202,1,2,1,3,2,103,102,100,100,23
"1958",57,"[40]hIlHoIAocBkppDlateEdAsbKDaermHunJHqvbGqa",198,0.99005,40,201,2,199,1,2,1,3,2,98,97,102,102,23
"1959",58,"[40]hIlHoIAocBkppDlateEdAsbKDaermHunJHqvbGqa",195,0.989899,40,198,2,196,1,2,1,3,2,94,93,103,103,23
"1960",59,"[40]hIlHoIAocBkppDlateEdAsbKDaermHunJHqvbGqa",209,0.990566,40,212,2,210,1,2,1,3,2,111,110,100,100,23
"1961",60,"[40]hIlHoIAocBkppDlateEdAsbKDaermHunJHqvbGqa",195,0.989899,40,198,2,196,1,2,1,3,2,92,91,105,105,23
"1962",61,"[40]hIlHoIAocBkppDlateEdAsbKDaermHunJHqvbGqa",196,0.98995,40,199,2,197,1,2,1,3,2,95,94,103,103,23
"1963",62,"[40]hIlHoIAocBkppDlateEdAsbKDaermHunJHqvbGqa",201,0.990196,40,204,2,202,1,2,1,3,2,101,100,102,102,23
"1964",63,"[40]hIlHoIAocBkppDlateEdAsbKDaermHunJHqvbGqa",208,0.990521,40,211,2,209,1,2,1,3,2,111,110,99,99,23
"1965",64,"[40]hIlHoIAocBkppDlateEdAsbKDaermHunJHqvbGqa",214,0.990783,40,217,2,215,1,2,1,3,2,117,116,99,99,23
"1966",65,"[40]hIlHoIAocBkppDlateEdAsbKDaermHunJHqvbGqa",194,0.989848,40,197,2,195,1,2,1,3,2,95,94,101,101,23
"1967",66,"[40]hIlHoIAocBkppDlateEdAsbKDaermHunJHqvbGqa",206,0.990431,40,209,2,207,1,2,1,3,2,107,106,101,101,23
"1968",67,"[40]hIlHoIAocBkppDlateEdAsbKDaermHunJHqvbGqa",223,0.99115,40,226,2,224,1,2,1,3,2,132,131,93,93,23
"1969",68,"[40]hIlHoIAocBkppDlateEdAsbKDaermHunJHqvbGqa",207,0.990476,40,210,2,208,1,2,1,3,2,112,111,97,97,23
"1970",69,"[40]hIlHoIAocBkppDlateEdAsbKDaermHunJHqvbGqa",197,0.99,40,200,2,198,1,2,1,3,2,96,95,103,103,23
"1971",70,"[40]hIlHoIAocBkppDlateEdAsbKDaermHunJHqvbGqa",203,0.990291,40,206,2,204,1,2,1,3,2,103,102,102,102,23
"1972",71,"[40]hIlHoIAocBkppDlateEdAsbKDaermHunJHqvbGqa",196,0.98995,40,199,2,197,1,2,1,3,2,98,97,100,100,23
"1973",72,"[40]hIlHoIAocBkppDlateEdAsbKDaermHunJHqvbGqa",210,0.99061,40,213,2,211,1,2,1,3,2,114,113,98,98,23
"1974",73,"[40]hIlHoIAocBkppDlateEdAsbKDaermHunJHqvbGqa",206,0.990431,40,209,2,207,1,2,1,3,2,108,107,100,100,23
"1975",74,"[40]hIlHoIAocBkppDlateEdAsbKDaermHunJHqvbGqa",197,0.99,40,200,2,198,1,2,1,3,2,94,93,105,105,23
"1976",75,"[40]hIlHoIAocBkppDlateEdAsbKDaermHunJHqvbGqa",210,0.99061,40,213,2,211,1,2,1,3,2,115,114,97,97,23
"1977",76,"[40]hIlHoIAocBkppDlateEdAsbKDaermHunJHqvbGqa",198,0.99005,40,201,2,199,1,2,1,3,2,98,97,102,102,23
"1978",77,"[40]hIlHoIAocBkppDlateEdAsbKDaermHunJHqvbGqa",190,0.989637,40,193,2,191,1,2,1,3,2,89,88,103,103,23
"1979",78,"[40]hIlHoIAocBkppDlateEdAsbKDaermHunJHqvbGqa",193,0.989796,40,196,2,194,1,2,1,3,2,92,91,103,103,23
"1980",79,"[40]hIlHoIAocBkppDlateEdAsbKDaermHunJHqvbGqa",194,0.989848,40,197,2,195,1,2,1,3,2,92,91,104,104,23
"1981",80,"[40]hIlHoIAocBkppDlateEdAsbKDaermHunJHqvbGqa",199,0.990099,40,202,2,200,1,2,1,3,2,99,98,102,102,23
"1982",81,"[40]hIlHoIAocBkppDlateEdAsbKDaermHunJHqvbGqa",206,0.990431,40,209,2,207,1,2,1,3,2,111,110,97,97,23
"1983",82,"[40]hIlHoIAocBkppDlateEdAsbKDaermHunJHqvbGqa",197,0.99,40,200,2,198,1,2,1,3,2,95,94,104,104,23
"1984",83,"[40]hIlHoIAocBkppDlateEdAsbKDaermHunJHqvbGqa",198,0.99005,40,201,2,199,1,2,1,3,2,96,95,104,104,23
"1985",84,"[40]hIlHoIAocBkppDlateEdAsbKDaermHunJHqvbGqa",207,0.990476,40,210,2,208,1,2,1,3,2,109,108,100,100,23
"1986",85,"[40]hIlHoIAocBkppDlateEdAsbKDaermHunJHqvbGqa",202,0.990244,40,205,2,203,1,2,1,3,2,106,105,98,98,23
"1987",86,"[40]hIlHoIAocBkppDlateEdAsbKDaermHunJHqvbGqa",198,0.99005,40,201,2,199,1,2,1,3,2,100,99,100,100,23
"1988",87,"[40]hIlHoIAocBkppDlateEdAsbKDaermHunJHqvbGqa",197,0.99,40,200,2,198,1,2,1,3,2,93,92,106,106,23
"1989",88,"[40]hIlHoIAocBkppDlateEdAsbKDaermHunJHqvbGqa",202,0.990244,40,205,2,203,1,2,1,3,2,103,102,101,101,23
"1990",89,"[40]hIlHoIAocBkppDlateEdAsbKDaermHunJHqvbGqa",204,0.990338,40,207,2,205,1,2,1,3,2,106,105,100,100,23
"1991",90,"[40]hIlHoIAocBkppDlateEdAsbKDaermHunJHqvbGqa",191,0.989691,40,194,2,192,1,2,1,3,2,90,89,103,103,23
"1992",91,"[40]hIlHoIAocBkppDlateEdAsbKDaermHunJHqvbGqa",191,0.989691,40,194,2,192,1,2,1,3,2,88,87,105,105,23
"1993",92,"[40]hIlHoIAocBkppDlateEdAsbKDaermHunJHqvbGqa",201,0.990196,40,204,2,202,1,2,1,3,2,103,102,100,100,23
"1994",93,"[40]hIlHoIAocBkppDlateEdAsbKDaermHunJHqvbGqa",199,0.990099,40,202,2,200,1,2,1,3,2,100,99,101,101,23
"1995",94,"[40]hIlHoIAocBkppDlateEdAsbKDaermHunJHqvbGqa",192,0.989744,40,195,2,193,1,2,1,3,2,86,85,108,108,23
"1996",95,"[40]hIlHoIAocBkppDlateEdAsbKDaermHunJHqvbGqa",206,0.990431,40,209,2,207,1,2,1,3,2,111,110,97,97,23
"1997",96,"[40]hIlHoIAocBkppDlateEdAsbKDaermHunJHqvbGqa",194,0.989848,40,197,2,195,1,2,1,3,2,92,91,104,104,23
"1998",97,"[40]hIlHoIAocBkppDlateEdAsbKDaermHunJHqvbGqa",190,0.989637,40,193,2,191,1,2,1,3,2,87,86,105,105,23
"1999",98,"[40]hIlHoIAocBkppDlateEdAsbKDaermHunJHqvbGqa",199,0.990099,40,202,2,200,1,2,1,3,2,98,97,103,103,23
"2000",99,"[40]hIlHoIAocBkppDlateEdAsbKDaermHunJHqvbGqa",200,0.990148,40,203,2,201,1,2,1,3,2,99,98,103,103,23
"2001",0,"[40]iIdHoIprxBkDzsjfJcwmcxbKDeepwHtnJHqvbGqa",206,0.990431,40,209,2,207,1,2,1,3,2,110,109,98,98,25
"2002",1,"[40]iIdHoIprxBkDzsjfJcwmcxbKDeepwHtnJHqvbGqa",190,0.989637,40,193,2,191,1,2,1,3,2,85,84,107,107,25
"2003",2,"[40]iIdHoIprxBkDzsjfJcwmcxbKDeepwHtnJHqvbGqa",200,0.990148,40,203,2,201,1,2,1,3,2,100,99,102,102,25
"2004",3,"[40]iIdHoIprxBkDzsjfJcwmcxbKDeepwHtnJHqvbGqa",197,0.99,40,200,2,198,1,2,1,3,2,96,95,103,103,25
"2005",4,"[40]iIdHoIprxBkDzsjfJcwmcxbKDeepwHtnJHqvbGqa",209,0.990566,40,212,2,210,1,2,1,3,2,114,113,97,97,25
"2006",5,"[40]iIdHoIprxBkDzsjfJcwmcxbKDeepwHtnJHqvbGqa",188,0.989529,40,191,2,189,1,2,1,3,2,83,82,107,107,25
"2007",6,"[40]iIdHoIprxBkDzsjfJcwmcxbKDeepwHtnJHqvbGqa",205,0.990385,40,208,2,206,1,2,1,3,2,108,107,99,99,25
"2008",7,"[40]iIdHoIprxBkDzsjfJcwmcxbKDeepwHtnJHqvbGqa",183,0.989247,40,186,2,184,1,2,1,3,2,76,75,109,109,25
"2009",8,"[40]iIdHoIprxBkDzsjfJcwmcxbKDeepwHtnJHqvbGqa",207,0.990476,40,210,2,208,1,2,1,3,2,110,109,99,99,25
"2010",9,"[40]iIdHoIprxBkDzsjfJcwmcxbKDeepwHtnJHqvbGqa",225,0.991228,40,228,2,226,1,2,1,3,2,134,133,93,93,25
"2011",10,"[40]iIdHoIprxBkDzsjfJcwmcxbKDeepwHtnJHqvbGqa",206,0.990431,40,209,2,207,1,2,1,3,2,108,107,100,100,25
"2012",11,"[40]iIdHoIprxBkDzsjfJcwmcxbKDeepwHtnJHqvbGqa",217,0.990909,40,220,2,218,1,2,1,3,2,124,123,95,95,25
"2013",12,"[40]iIdHoIprxBkDzsjfJcwmcxbKDeepwHtnJHqvbGqa",196,0.98995,40,199,2,197,1,2,1,3,2,96,95,102,102,25
"2014",13,"[40]iIdHoIprxBkDzsjfJcwmcxbKDeepwHtnJHqvbGqa",220,0.991031,40,223,2,221,1,2,1,3,2,129,128,93,93,25
"2015",14,"[40]iIdHoIprxBkDzsjfJcwmcxbKDeepwHtnJHqvbGqa",199,0.990099,40,202,2,200,1,2,1,3,2,102,101,99,99,25
"2016",15,"[40]iIdHoIprxBkDzsjfJcwmcxbKDeepwHtnJHqvbGqa",206,0.990431,40,209,2,207,1,2,1,3,2,109,108,99,99,25
"2017",16,"[40]iIdHoIprxBkDzsjfJcwmcxbKDeepwHtnJHqvbGqa",218,0.99095,40,221,2,219,1,2,1,3,2,126,125,94,94,25
"2018",17,"[40]iIdHoIprxBkDzsjfJcwmcxbKDeepwHtnJHqvbGqa",207,0.990476,40,210,2,208,1,2,1,3,2,112,111,97,97,25
"2019",18,"[40]iIdHoIprxBkDzsjfJcwmcxbKDeepwHtnJHqvbGqa",212,0.990698,40,215,2,213,1,2,1,3,2,118,117,96,96,25
"2020",19,"[40]iIdHoIprxBkDzsjfJcwmcxbKDeepwHtnJHqvbGqa",195,0.989899,40,198,2,196,1,2,1,3,2,92,91,105,105,25
"2021",20,"[40]iIdHoIprxBkDzsjfJcwmcxbKDeepwHtnJHqvbGqa",194,0.989848,40,197,2,195,1,2,1,3,2,91,90,105,105,25
"2022",21,"[40]iIdHoIprxBkDzsjfJcwmcxbKDeepwHtnJHqvbGqa",193,0.989796,40,196,2,194,1,2,1,3,2,93,92,102,102,25
"2023",22,"[40]iIdHoIprxBkDzsjfJcwmcxbKDeepwHtnJHqvbGqa",197,0.99,40,200,2,198,1,2,1,3,2,95,94,104,104,25
"2024",23,"[40]iIdHoIprxBkDzsjfJcwmcxbKDeepwHtnJHqvbGqa",202,0.990244,40,205,2,203,1,2,1,3,2,104,103,100,100,25
"2025",24,"[40]iIdHoIprxBkDzsjfJcwmcxbKDeepwHtnJHqvbGqa",211,0.990654,40,214,2,212,1,2,1,3,2,115,114,98,98,25
"2026",25,"[40]iIdHoIprxBkDzsjfJcwmcxbKDeepwHtnJHqvbGqa",212,0.990698,40,215,2,213,1,2,1,3,2,118,117,96,96,25
"2027",26,"[40]iIdHoIprxBkDzsjfJcwmcxbKDeepwHtnJHqvbGqa",204,0.990338,40,207,2,205,1,2,1,3,2,106,105,100,100,25
"2028",27,"[40]iIdHoIprxBkDzsjfJcwmcxbKDeepwHtnJHqvbGqa",219,0.990991,40,222,2,220,1,2,1,3,2,125,124,96,96,25
"2029",28,"[40]iIdHoIprxBkDzsjfJcwmcxbKDeepwHtnJHqvbGqa",207,0.990476,40,210,2,208,1,2,1,3,2,113,112,96,96,25
"2030",29,"[40]iIdHoIprxBkDzsjfJcwmcxbKDeepwHtnJHqvbGqa",197,0.99,40,200,2,198,1,2,1,3,2,97,96,102,102,25
"2031",30,"[40]iIdHoIprxBkDzsjfJcwmcxbKDeepwHtnJHqvbGqa",204,0.990338,40,207,2,205,1,2,1,3,2,106,105,100,100,25
"2032",31,"[40]iIdHoIprxBkDzsjfJcwmcxbKDeepwHtnJHqvbGqa",210,0.99061,40,213,2,211,1,2,1,3,2,113,112,99,99,25
"2033",32,"[40]iIdHoIprxBkDzsjfJcwmcxbKDeepwHtnJHqvbGqa",209,0.990566,40,212,2,210,1,2,1,3,2,113,112,98,98,25
"2034",33,"[40]iIdHoIprxBkDzsjfJcwmcxbKDeepwHtnJHqvbGqa",218,0.99095,40,221,2,219,1,2,1,3,2,121,120,99,99,25
"2035",34,"[40]iIdHoIprxBkDzsjfJcwmcxbKDeepwHtnJHqvbGqa",199,0.990099,40,202,2,200,1,2,1,3,2,98,97,103,103,25
"2036",35,"[40]iIdHoIprxBkDzsjfJcwmcxbKDeepwHtnJHqvbGqa",207,0.990476,40,210,2,208,1,2,1,3,2,110,109,99,99,25
"2037",36,"[40]iIdHoIprxBkDzsjfJcwmcxbKDeepwHtnJHqvbGqa",199,0.990099,40,202,2,200,1,2,1,3,2,101,100,100,100,25
"2038",37,"[40]iIdHoIprxBkDzsjfJcwmcxbKDeepwHtnJHqvbGqa",204,0.990338,40,207,2,205,1,2,1,3,2,109,108,97,97,25
"2039",38,"[40]iIdHoIprxBkDzsjfJcwmcxbKDeepwHtnJHqvbGqa",194,0.989848,40,197,2,195,1,2,1,3,2,91,90,105,105,25
"2040",39,"[40]iIdHoIprxBkDzsjfJcwmcxbKDeepwHtnJHqvbGqa",190,0.989637,40,193,2,191,1,2,1,3,2,88,87,104,104,25
"2041",40,"[40]iIdHoIprxBkDzsjfJcwmcxbKDeepwHtnJHqvbGqa",202,0.990244,40,205,2,203,1,2,1,3,2,103,102,101,101,25
"2042",41,"[40]iIdHoIprxBkDzsjfJcwmcxbKDeepwHtnJHqvbGqa",189,0.989583,40,192,2,190,1,2,1,3,2,87,86,104,104,25
"2043",42,"[40]iIdHoIprxBkDzsjfJcwmcxbKDeepwHtnJHqvbGqa",199,0.990099,40,202,2,200,1,2,1,3,2,100,99,101,101,25
"2044",43,"[40]iIdHoIprxBkDzsjfJcwmcxbKDeepwHtnJHqvbGqa",205,0.990385,40,208,2,206,1,2,1,3,2,106,105,101,101,25
"2045",44,"[40]iIdHoIprxBkDzsjfJcwmcxbKDeepwHtnJHqvbGqa",196,0.98995,40,199,2,197,1,2,1,3,2,93,92,105,105,25
"2046",45,"[40]iIdHoIprxBkDzsjfJcwmcxbKDeepwHtnJHqvbGqa",190,0.989637,40,193,2,191,1,2,1,3,2,86,85,106,106,25
"2047",46,"[40]iIdHoIprxBkDzsjfJcwmcxbKDeepwHtnJHqvbGqa",209,0.990566,40,212,2,210,1,2,1,3,2,112,111,99,99,25
"2048",47,"[40]iIdHoIprxBkDzsjfJcwmcxbKDeepwHtnJHqvbGqa",213,0.990741,40,216,2,214,1,2,1,3,2,118,117,97,97,25
"2049",48,"[40]iIdHoIprxBkDzsjfJcwmcxbKDeepwHtnJHqvbGqa",202,0.990244,40,205,2,203,1,2,1,3,2,104,103,100,100,25
"2050",49,"[40]iIdHoIprxBkDzsjfJcwmcxbKDeepwHtnJHqvbGqa",198,0.99005,40,201,2,199,1,2,1,3,2,99,98,101,101,25
"2051",50,"[40]iIdHoIprxBkDzsjfJcwmcxbKDeepwHtnJHqvbGqa",196,0.98995,40,199,2,197,1,2,1,3,2,94,93,104,104,25
"2052",51,"[40]iIdHoIprxBkDzsjfJcwmcxbKDeepwHtnJHqvbGqa",201,0.990196,40,204,2,202,1,2,1,3,2,100,99,103,103,25
"2053",52,"[40]iIdHoIprxBkDzsjfJcwmcxbKDeepwHtnJHqvbGqa",202,0.990244,40,205,2,203,1,2,1,3,2,103,102,101,101,25
"2054",53,"[40]iIdHoIprxBkDzsjfJcwmcxbKDeepwHtnJHqvbGqa",200,0.990148,40,203,2,201,1,2,1,3,2,100,99,102,102,25
"2055",54,"[40]iIdHoIprxBkDzsjfJcwmcxbKDeepwHtnJHqvbGqa",206,0.990431,40,209,2,207,1,2,1,3,2,108,107,100,100,25
"2056",55,"[40]iIdHoIprxBkDzsjfJcwmcxbKDeepwHtnJHqvbGqa",206,0.990431,40,209,2,207,1,2,1,3,2,108,107,100,100,25
"2057",56,"[40]iIdHoIprxBkDzsjfJcwmcxbKDeepwHtnJHqvbGqa",187,0.989474,40,190,2,188,1,2,1,3,2,84,83,105,105,25
"2058",57,"[40]iIdHoIprxBkDzsjfJcwmcxbKDeepwHtnJHqvbGqa",200,0.990148,40,203,2,201,1,2,1,3,2,100,99,102,102,25
"2059",58,"[40]iIdHoIprxBkDzsjfJcwmcxbKDeepwHtnJHqvbGqa",208,0.990521,40,211,2,209,1,2,1,3,2,112,111,98,98,25
"2060",59,"[40]iIdHoIprxBkDzsjfJcwmcxbKDeepwHtnJHqvbGqa",189,0.989583,40,192,2,190,1,2,1,3,2,85,84,106,106,25
"2061",60,"[40]iIdHoIprxBkDzsjfJcwmcxbKDeepwHtnJHqvbGqa",196,0.98995,40,199,2,197,1,2,1,3,2,96,95,102,102,25
"2062",61,"[40]iIdHoIprxBkDzsjfJcwmcxbKDeepwHtnJHqvbGqa",203,0.990291,40,206,2,204,1,2,1,3,2,105,104,100,100,25
"2063",62,"[40]iIdHoIprxBkDzsjfJcwmcxbKDeepwHtnJHqvbGqa",210,0.99061,40,213,2,211,1,2,1,3,2,115,114,97,97,25
"2064",63,"[40]iIdHoIprxBkDzsjfJcwmcxbKDeepwHtnJHqvbGqa",200,0.990148,40,203,2,201,1,2,1,3,2,100,99,102,102,25
"2065",64,"[40]iIdHoIprxBkDzsjfJcwmcxbKDeepwHtnJHqvbGqa",194,0.989848,40,197,2,195,1,2,1,3,2,90,89,106,106,25
"2066",65,"[40]iIdHoIprxBkDzsjfJcwmcxbKDeepwHtnJHqvbGqa",191,0.989691,40,194,2,192,1,2,1,3,2,88,87,105,105,25
"2067",66,"[40]iIdHoIprxBkDzsjfJcwmcxbKDeepwHtnJHqvbGqa",211,0.990654,40,214,2,212,1,2,1,3,2,117,116,96,96,25
"2068",67,"[40]iIdHoIprxBkDzsjfJcwmcxbKDeepwHtnJHqvbGqa",213,0.990741,40,216,2,214,1,2,1,3,2,120,119,95,95,25
"2069",68,"[40]iIdHoIprxBkDzsjfJcwmcxbKDeepwHtnJHqvbGqa",194,0.989848,40,197,2,195,1,2,1,3,2,94,93,102,102,25
"2070",69,"[40]iIdHoIprxBkDzsjfJcwmcxbKDeepwHtnJHqvbGqa",205,0.990385,40,208,2,206,1,2,1,3,2,107,106,100,100,25
"2071",70,"[40]iIdHoIprxBkDzsjfJcwmcxbKDeepwHtnJHqvbGqa",208,0.990521,40,211,2,209,1,2,1,3,2,110,109,100,100,25
"2072",71,"[40]iIdHoIprxBkDzsjfJcwmcxbKDeepwHtnJHqvbGqa",188,0.989529,40,191,2,189,1,2,1,3,2,84,83,106,106,25
"2073",72,"[40]iIdHoIprxBkDzsjfJcwmcxbKDeepwHtnJHqvbGqa",208,0.990521,40,211,2,209,1,2,1,3,2,113,112,97,97,25
"2074",73,"[40]iIdHoIprxBkDzsjfJcwmcxbKDeepwHtnJHqvbGqa",201,0.990196,40,204,2,202,1,2,1,3,2,103,102,100,100,25
"2075",74,"[40]iIdHoIprxBkDzsjfJcwmcxbKDeepwHtnJHqvbGqa",186,0.989418,40,189,2,187,1,2,1,3,2,84,83,104,104,25
"2076",75,"[40]iIdHoIprxBkDzsjfJcwmcxbKDeepwHtnJHqvbGqa",205,0.990385,40,208,2,206,1,2,1,3,2,109,108,98,98,25
"2077",76,"[40]iIdHoIprxBkDzsjfJcwmcxbKDeepwHtnJHqvbGqa",195,0.989899,40,198,2,196,1,2,1,3,2,97,96,100,100,25
"2078",77,"[40]iIdHoIprxBkDzsjfJcwmcxbKDeepwHtnJHqvbGqa",179,0.989011,40,182,2,180,1,2,1,3,2,73,72,108,108,25
"2079",78,"[40]iIdHoIprxBkDzsjfJcwmcxbKDeepwHtnJHqvbGqa",195,0.989899,40,198,2,196,1,2,1,3,2,95,94,102,102,25
"2080",79,"[40]iIdHoIprxBkDzsjfJcwmcxbKDeepwHtnJHqvbGqa",222,0.991111,40,225,2,223,1,2,1,3,2,131,130,93,93,25
"2081",80,"[40]iIdHoIprxBkDzsjfJcwmcxbKDeepwHtnJHqvbGqa",212,0.990698,40,215,2,213,1,2,1,3,2,118,117,96,96,25
"2082",81,"[40]iIdHoIprxBkDzsjfJcwmcxbKDeepwHtnJHqvbGqa",200,0.990148,40,203,2,201,1,2,1,3,2,101,100,101,101,25
"2083",82,"[40]iIdHoIprxBkDzsjfJcwmcxbKDeepwHtnJHqvbGqa",200,0.990148,40,203,2,201,1,2,1,3,2,103,102,99,99,25
"2084",83,"[40]iIdHoIprxBkDzsjfJcwmcxbKDeepwHtnJHqvbGqa",200,0.990148,40,203,2,201,1,2,1,3,2,100,99,102,102,25
"2085",84,"[40]iIdHoIprxBkDzsjfJcwmcxbKDeepwHtnJHqvbGqa",194,0.989848,40,197,2,195,1,2,1,3,2,92,91,104,104,25
"2086",85,"[40]iIdHoIprxBkDzsjfJcwmcxbKDeepwHtnJHqvbGqa",202,0.990244,40,205,2,203,1,2,1,3,2,101,100,103,103,25
"2087",86,"[40]iIdHoIprxBkDzsjfJcwmcxbKDeepwHtnJHqvbGqa",196,0.98995,40,199,2,197,1,2,1,3,2,95,94,103,103,25
"2088",87,"[40]iIdHoIprxBkDzsjfJcwmcxbKDeepwHtnJHqvbGqa",191,0.989691,40,194,2,192,1,2,1,3,2,87,86,106,106,25
"2089",88,"[40]iIdHoIprxBkDzsjfJcwmcxbKDeepwHtnJHqvbGqa",197,0.99,40,200,2,198,1,2,1,3,2,96,95,103,103,25
"2090",89,"[40]iIdHoIprxBkDzsjfJcwmcxbKDeepwHtnJHqvbGqa",207,0.990476,40,210,2,208,1,2,1,3,2,110,109,99,99,25
"2091",90,"[40]iIdHoIprxBkDzsjfJcwmcxbKDeepwHtnJHqvbGqa",204,0.990338,40,207,2,205,1,2,1,3,2,108,107,98,98,25
"2092",91,"[40]iIdHoIprxBkDzsjfJcwmcxbKDeepwHtnJHqvbGqa",196,0.98995,40,199,2,197,1,2,1,3,2,98,97,100,100,25
"2093",92,"[40]iIdHoIprxBkDzsjfJcwmcxbKDeepwHtnJHqvbGqa",203,0.990291,40,206,2,204,1,2,1,3,2,106,105,99,99,25
"2094",93,"[40]iIdHoIprxBkDzsjfJcwmcxbKDeepwHtnJHqvbGqa",197,0.99,40,200,2,198,1,2,1,3,2,99,98,100,100,25
"2095",94,"[40]iIdHoIprxBkDzsjfJcwmcxbKDeepwHtnJHqvbGqa",215,0.990826,40,218,2,216,1,2,1,3,2,120,119,97,97,25
"2096",95,"[40]iIdHoIprxBkDzsjfJcwmcxbKDeepwHtnJHqvbGqa",201,0.990196,40,204,2,202,1,2,1,3,2,100,99,103,103,25
"2097",96,"[40]iIdHoIprxBkDzsjfJcwmcxbKDeepwHtnJHqvbGqa",211,0.990654,40,214,2,212,1,2,1,3,2,116,115,97,97,25
"2098",97,"[40]iIdHoIprxBkDzsjfJcwmcxbKDeepwHtnJHqvbGqa",198,0.99005,40,201,2,199,1,2,1,3,2,97,96,103,103,25
"2099",98,"[40]iIdHoIprxBkDzsjfJcwmcxbKDeepwHtnJHqvbGqa",206,0.990431,40,209,2,207,1,2,1,3,2,109,108,99,99,25
"2100",99,"[40]iIdHoIprxBkDzsjfJcwmcxbKDeepwHtnJHqvbGqa",201,0.990196,40,204,2,202,1,2,1,3,2,102,101,101,101,25
"2101",0,"[35]IHoIwfEBDhtgpprjobKDaeGoHunJHqxbGqa",204,0.990338,35,207,2,205,1,2,1,3,2,107,106,99,99,26
"2102",1,"[35]IHoIwfEBDhtgpprjobKDaeGoHunJHqxbGqa",199,0.990099,35,202,2,200,1,2,1,3,2,100,99,101,101,26
"2103",2,"[35]IHoIwfEBDhtgpprjobKDaeGoHunJHqxbGqa",205,0.990385,35,208,2,206,1,2,1,3,2,107,106,100,100,26
"2104",3,"[35]IHoIwfEBDhtgpprjobKDaeGoHunJHqxbGqa",204,0.990338,35,207,2,205,1,2,1,3,2,105,104,101,101,26
"2105",4,"[35]IHoIwfEBDhtgpprjobKDaeGoHunJHqxbGqa",207,0.990476,35,210,2,208,1,2,1,3,2,108,107,101,101,26
"2106",5,"[35]IHoIwfEBDhtgpprjobKDaeGoHunJHqxbGqa",196,0.98995,35,199,2,197,1,2,1,3,2,94,93,104,104,26
"2107",6,"[35]IHoIwfEBDhtgpprjobKDaeGoHunJHqxbGqa",207,0.990476,35,210,2,208,1,2,1,3,2,109,108,100,100,26
"2108",7,"[35]IHoIwfEBDhtgpprjobKDaeGoHunJHqxbGqa",201,0.990196,35,204,2,202,1,2,1,3,2,103,102,100,100,26
"2109",8,"[35]IHoIwfEBDhtgpprjobKDaeGoHunJHqxbGqa",213,0.990741,35,216,2,214,1,2,1,3,2,116,115,99,99,26
"2110",9,"[35]IHoIwfEBDhtgpprjobKDaeGoHunJHqxbGqa",207,0.990476,35,210,2,208,1,2,1,3,2,106,105,103,103,26
"2111",10,"[35]IHoIwfEBDhtgpprjobKDaeGoHunJHqxbGqa",199,0.990099,35,202,2,200,1,2,1,3,2,99,98,102,102,26
"2112",11,"[35]IHoIwfEBDhtgpprjobKDaeGoHunJHqxbGqa",197,0.99,35,200,2,198,1,2,1,3,2,97,96,102,102,26
"2113",12,"[35]IHoIwfEBDhtgpprjobKDaeGoHunJHqxbGqa",203,0.990291,35,206,2,204,1,2,1,3,2,107,106,98,98,26
"2114",13,"[35]IHoIwfEBDhtgpprjobKDaeGoHunJHqxbGqa",184,0.989305,35,187,2,185,1,2,1,3,2,78,77,108,108,26
"2115",14,"[35]IHoIwfEBDhtgpprjobKDaeGoHunJHqxbGqa",207,0.990476,35,210,2,208,1,2,1,3,2,110,109,99,99,26
"2116",15,"[35]IHoIwfEBDhtgpprjobKDaeGoHunJHqxbGqa",201,0.990196,35,204,2,202,1,2,1,3,2,102,101,101,101,26
"2117",16,"[35]IHoIwfEBDhtgpprjobKDaeGoHunJHqxbGqa",195,0.989899,35,198,2,196,1,2,1,3,2,91,90,106,106,26
"2118",17,"[35]IHoIwfEBDhtgpprjobKDaeGoHunJHqxbGqa",201,0.990196,35,204,2,202,1,2,1,3,2,101,100,102,102,26
"2119",18,"[35]IHoIwfEBDhtgpprjobKDaeGoHunJHqxbGqa",199,0.990099,35,202,2,200,1,2,1,3,2,98,97,103,103,26
"2120",19,"[35]IHoIwfEBDhtgpprjobKDaeGoHunJHqxbGqa",208,0.990521,35,211,2,209,1,2,1,3,2,111,110,99,99,26
"2121",20,"[35]IHoIwfEBDhtgpprjobKDaeGoHunJHqxbGqa",215,0.990826,35,218,2,216,1,2,1,3,2,119,118,98,98,26
"2122",21,"[35]IHoIwfEBDhtgpprjobKDaeGoHunJHqxbGqa",210,0.99061,35,213,2,211,1,2,1,3,2,116,115,96,96,26
"2123",22,"[35]IHoIwfEBDhtgpprjobKDaeGoHunJHqxbGqa",217,0.990909,35,220,2,218,1,2,1,3,2,124,123,95,95,26
"2124",23,"[35]IHoIwfEBDhtgpprjobKDaeGoHunJHqxbGqa",199,0.990099,35,202,2,200,1,2,1,3,2,97,96,104,104,26
"2125",24,"[35]IHoIwfEBDhtgpprjobKDaeGoHunJHqxbGqa",223,0.99115,35,226,2,224,1,2,1,3,2,131,130,94,94,26
"2126",25,"[35]IHoIwfEBDhtgpprjobKDaeGoHunJHqxbGqa",208,0.990521,35,211,2,209,1,2,1,3,2,110,109,100,100,26
"2127",26,"[35]IHoIwfEBDhtgpprjobKDaeGoHunJHqxbGqa",218,0.99095,35,221,2,219,1,2,1,3,2,125,124,95,95,26
"2128",27,"[35]IHoIwfEBDhtgpprjobKDaeGoHunJHqxbGqa",198,0.99005,35,201,2,199,1,2,1,3,2,97,96,103,103,26
"2129",28,"[35]IHoIwfEBDhtgpprjobKDaeGoHunJHqxbGqa",209,0.990566,35,212,2,210,1,2,1,3,2,110,109,101,101,26
"2130",29,"[35]IHoIwfEBDhtgpprjobKDaeGoHunJHqxbGqa",207,0.990476,35,210,2,208,1,2,1,3,2,108,107,101,101,26
"2131",30,"[35]IHoIwfEBDhtgpprjobKDaeGoHunJHqxbGqa",212,0.990698,35,215,2,213,1,2,1,3,2,117,116,97,97,26
"2132",31,"[35]IHoIwfEBDhtgpprjobKDaeGoHunJHqxbGqa",199,0.990099,35,202,2,200,1,2,1,3,2,101,100,100,100,26
"2133",32,"[35]IHoIwfEBDhtgpprjobKDaeGoHunJHqxbGqa",221,0.991071,35,224,2,222,1,2,1,3,2,128,127,95,95,26
"2134",33,"[35]IHoIwfEBDhtgpprjobKDaeGoHunJHqxbGqa",196,0.98995,35,199,2,197,1,2,1,3,2,95,94,103,103,26
"2135",34,"[35]IHoIwfEBDhtgpprjobKDaeGoHunJHqxbGqa",190,0.989637,35,193,2,191,1,2,1,3,2,88,87,104,104,26
"2136",35,"[35]IHoIwfEBDhtgpprjobKDaeGoHunJHqxbGqa",198,0.99005,35,201,2,199,1,2,1,3,2,98,97,102,102,26
"2137",36,"[35]IHoIwfEBDhtgpprjobKDaeGoHunJHqxbGqa",215,0.990826,35,218,2,216,1,2,1,3,2,122,121,95,95,26
"2138",37,"[35]IHoIwfEBDhtgpprjobKDaeGoHunJHqxbGqa",208,0.990521,35,211,2,209,1,2,1,3,2,109,108,101,101,26
"2139",38,"[35]IHoIwfEBDhtgpprjobKDaeGoHunJHqxbGqa",209,0.990566,35,212,2,210,1,2,1,3,2,114,113,97,97,26
"2140",39,"[35]IHoIwfEBDhtgpprjobKDaeGoHunJHqxbGqa",198,0.99005,35,201,2,199,1,2,1,3,2,97,96,103,103,26
"2141",40,"[35]IHoIwfEBDhtgpprjobKDaeGoHunJHqxbGqa",198,0.99005,35,201,2,199,1,2,1,3,2,96,95,104,104,26
"2142",41,"[35]IHoIwfEBDhtgpprjobKDaeGoHunJHqxbGqa",201,0.990196,35,204,2,202,1,2,1,3,2,102,101,101,101,26
"2143",42,"[35]IHoIwfEBDhtgpprjobKDaeGoHunJHqxbGqa",206,0.990431,35,209,2,207,1,2,1,3,2,106,105,102,102,26
"2144",43,"[35]IHoIwfEBDhtgpprjobKDaeGoHunJHqxbGqa",204,0.990338,35,207,2,205,1,2,1,3,2,107,106,99,99,26
"2145",44,"[35]IHoIwfEBDhtgpprjobKDaeGoHunJHqxbGqa",200,0.990148,35,203,2,201,1,2,1,3,2,100,99,102,102,26
"2146",45,"[35]IHoIwfEBDhtgpprjobKDaeGoHunJHqxbGqa",216,0.990868,35,219,2,217,1,2,1,3,2,123,122,95,95,26
"2147",46,"[35]IHoIwfEBDhtgpprjobKDaeGoHunJHqxbGqa",210,0.99061,35,213,2,211,1,2,1,3,2,116,115,96,96,26
"2148",47,"[35]IHoIwfEBDhtgpprjobKDaeGoHunJHqxbGqa",210,0.99061,35,213,2,211,1,2,1,3,2,114,113,98,98,26
"2149",48,"[35]IHoIwfEBDhtgpprjobKDaeGoHunJHqxbGqa",204,0.990338,35,207,2,205,1,2,1,3,2,106,105,100,100,26
"2150",49,"[35]IHoIwfEBDhtgpprjobKDaeGoHunJHqxbGqa",194,0.989848,35,197,2,195,1,2,1,3,2,91,90,105,105,26
"2151",50,"[35]IHoIwfEBDhtgpprjobKDaeGoHunJHqxbGqa",215,0.990826,35,218,2,216,1,2,1,3,2,120,119,97,97,26
"2152",51,"[35]IHoIwfEBDhtgpprjobKDaeGoHunJHqxbGqa",211,0.990654,35,214,2,212,1,2,1,3,2,114,113,99,99,26
"2153",52,"[35]IHoIwfEBDhtgpprjobKDaeGoHunJHqxbGqa",206,0.990431,35,209,2,207,1,2,1,3,2,105,104,103,103,26
"2154",53,"[35]IHoIwfEBDhtgpprjobKDaeGoHunJHqxbGqa",209,0.990566,35,212,2,210,1,2,1,3,2,110,109,101,101,26
"2155",54,"[35]IHoIwfEBDhtgpprjobKDaeGoHunJHqxbGqa",203,0.990291,35,206,2,204,1,2,1,3,2,107,106,98,98,26
"2156",55,"[35]IHoIwfEBDhtgpprjobKDaeGoHunJHqxbGqa",193,0.989796,35,196,2,194,1,2,1,3,2,91,90,104,104,26
"2157",56,"[35]IHoIwfEBDhtgpprjobKDaeGoHunJHqxbGqa",201,0.990196,35,204,2,202,1,2,1,3,2,103,102,100,100,26
"2158",57,"[35]IHoIwfEBDhtgpprjobKDaeGoHunJHqxbGqa",216,0.990868,35,219,2,217,1,2,1,3,2,123,122,95,95,26
"2159",58,"[35]IHoIwfEBDhtgpprjobKDaeGoHunJHqxbGqa",191,0.989691,35,194,2,192,1,2,1,3,2,87,86,106,106,26
"2160",59,"[35]IHoIwfEBDhtgpprjobKDaeGoHunJHqxbGqa",206,0.990431,35,209,2,207,1,2,1,3,2,106,105,102,102,26
"2161",60,"[35]IHoIwfEBDhtgpprjobKDaeGoHunJHqxbGqa",205,0.990385,35,208,2,206,1,2,1,3,2,109,108,98,98,26
"2162",61,"[35]IHoIwfEBDhtgpprjobKDaeGoHunJHqxbGqa",193,0.989796,35,196,2,194,1,2,1,3,2,89,88,106,106,26
"2163",62,"[35]IHoIwfEBDhtgpprjobKDaeGoHunJHqxbGqa",187,0.989474,35,190,2,188,1,2,1,3,2,81,80,108,108,26
"2164",63,"[35]IHoIwfEBDhtgpprjobKDaeGoHunJHqxbGqa",200,0.990148,35,203,2,201,1,2,1,3,2,101,100,101,101,26
"2165",64,"[35]IHoIwfEBDhtgpprjobKDaeGoHunJHqxbGqa",193,0.989796,35,196,2,194,1,2,1,3,2,87,86,108,108,26
"2166",65,"[35]IHoIwfEBDhtgpprjobKDaeGoHunJHqxbGqa",209,0.990566,35,212,2,210,1,2,1,3,2,112,111,99,99,26
"2167",66,"[35]IHoIwfEBDhtgpprjobKDaeGoHunJHqxbGqa",207,0.990476,35,210,2,208,1,2,1,3,2,108,107,101,101,26
"2168",67,"[35]IHoIwfEBDhtgpprjobKDaeGoHunJHqxbGqa",195,0.989899,35,198,2,196,1,2,1,3,2,93,92,104,104,26
"2169",68,"[35]IHoIwfEBDhtgpprjobKDaeGoHunJHqxbGqa",212,0.990698,35,215,2,213,1,2,1,3,2,119,118,95,95,26
"2170",69,"[35]IHoIwfEBDhtgpprjobKDaeGoHunJHqxbGqa",204,0.990338,35,207,2,205,1,2,1,3,2,104,103,102,102,26
"2171",70,"[35]IHoIwfEBDhtgpprjobKDaeGoHunJHqxbGqa",209,0.990566,35,212,2,210,1,2,1,3,2,113,112,98,98,26
"2172",71,"[35]IHoIwfEBDhtgpprjobKDaeGoHunJHqxbGqa",198,0.99005,35,201,2,199,1,2,1,3,2,96,95,104,104,26
"2173",72,"[35]IHoIwfEBDhtgpprjobKDaeGoHunJHqxbGqa",209,0.990566,35,212,2,210,1,2,1,3,2,110,109,101,101,26
"2174",73,"[35]IHoIwfEBDhtgpprjobKDaeGoHunJHqxbGqa",212,0.990698,35,215,2,213,1,2,1,3,2,116,115,98,98,26
"2175",74,"[35]IHoIwfEBDhtgpprjobKDaeGoHunJHqxbGqa",192,0.989744,35,195,2,193,1,2,1,3,2,88,87,106,106,26
"2176",75,"[35]IHoIwfEBDhtgpprjobKDaeGoHunJHqxbGqa",202,0.990244,35,205,2,203,1,2,1,3,2,104,103,100,100,26
"2177",76,"[35]IHoIwfEBDhtgpprjobKDaeGoHunJHqxbGqa",209,0.990566,35,212,2,210,1,2,1,3,2,113,112,98,98,26
"2178",77,"[35]IHoIwfEBDhtgpprjobKDaeGoHunJHqxbGqa",202,0.990244,35,205,2,203,1,2,1,3,2,103,102,101,101,26
"2179",78,"[35]IHoIwfEBDhtgpprjobKDaeGoHunJHqxbGqa",194,0.989848,35,197,2,195,1,2,1,3,2,93,92,103,103,26
"2180",79,"[35]IHoIwfEBDhtgpprjobKDaeGoHunJHqxbGqa",199,0.990099,35,202,2,200,1,2,1,3,2,97,96,104,104,26
"2181",80,"[35]IHoIwfEBDhtgpprjobKDaeGoHunJHqxbGqa",211,0.990654,35,214,2,212,1,2,1,3,2,113,112,100,100,26
"2182",81,"[35]IHoIwfEBDhtgpprjobKDaeGoHunJHqxbGqa",203,0.990291,35,206,2,204,1,2,1,3,2,103,102,102,102,26
"2183",82,"[35]IHoIwfEBDhtgpprjobKDaeGoHunJHqxbGqa",194,0.989848,35,197,2,195,1,2,1,3,2,92,91,104,104,26
"2184",83,"[35]IHoIwfEBDhtgpprjobKDaeGoHunJHqxbGqa",202,0.990244,35,205,2,203,1,2,1,3,2,102,101,102,102,26
"2185",84,"[35]IHoIwfEBDhtgpprjobKDaeGoHunJHqxbGqa",193,0.989796,35,196,2,194,1,2,1,3,2,91,90,104,104,26
"2186",85,"[35]IHoIwfEBDhtgpprjobKDaeGoHunJHqxbGqa",208,0.990521,35,211,2,209,1,2,1,3,2,113,112,97,97,26
"2187",86,"[35]IHoIwfEBDhtgpprjobKDaeGoHunJHqxbGqa",198,0.99005,35,201,2,199,1,2,1,3,2,99,98,101,101,26
"2188",87,"[35]IHoIwfEBDhtgpprjobKDaeGoHunJHqxbGqa",208,0.990521,35,211,2,209,1,2,1,3,2,111,110,99,99,26
"2189",88,"[35]IHoIwfEBDhtgpprjobKDaeGoHunJHqxbGqa",196,0.98995,35,199,2,197,1,2,1,3,2,95,94,103,103,26
"2190",89,"[35]IHoIwfEBDhtgpprjobKDaeGoHunJHqxbGqa",209,0.990566,35,212,2,210,1,2,1,3,2,111,110,100,100,26
"2191",90,"[35]IHoIwfEBDhtgpprjobKDaeGoHunJHqxbGqa",202,0.990244,35,205,2,203,1,2,1,3,2,104,103,100,100,26
"2192",91,"[35]IHoIwfEBDhtgpprjobKDaeGoHunJHqxbGqa",211,0.990654,35,214,2,212,1,2,1,3,2,114,113,99,99,26
"2193",92,"[35]IHoIwfEBDhtgpprjobKDaeGoHunJHqxbGqa",190,0.989637,35,193,2,191,1,2,1,3,2,87,86,105,105,26
"2194",93,"[35]IHoIwfEBDhtgpprjobKDaeGoHunJHqxbGqa",200,0.990148,35,203,2,201,1,2,1,3,2,100,99,102,102,26
"2195",94,"[35]IHoIwfEBDhtgpprjobKDaeGoHunJHqxbGqa",205,0.990385,35,208,2,206,1,2,1,3,2,105,104,102,102,26
"2196",95,"[35]IHoIwfEBDhtgpprjobKDaeGoHunJHqxbGqa",204,0.990338,35,207,2,205,1,2,1,3,2,105,104,101,101,26
"2197",96,"[35]IHoIwfEBDhtgpprjobKDaeGoHunJHqxbGqa",209,0.990566,35,212,2,210,1,2,1,3,2,110,109,101,101,26
"2198",97,"[35]IHoIwfEBDhtgpprjobKDaeGoHunJHqxbGqa",211,0.990654,35,214,2,212,1,2,1,3,2,116,115,97,97,26
"2199",98,"[35]IHoIwfEBDhtgpprjobKDaeGoHunJHqxbGqa",191,0.989691,35,194,2,192,1,2,1,3,2,88,87,105,105,26
"2200",99,"[35]IHoIwfEBDhtgpprjobKDaeGoHunJHqxbGqa",195,0.989899,35,198,2,196,1,2,1,3,2,94,93,103,103,26
"2201",0,"[40]qIkHoIplvBkDlzGafJdJFGbKDaenrHsnJHqvbGqa",191,0.989691,40,194,2,192,1,2,1,3,2,90,89,103,103,27
"2202",1,"[40]qIkHoIplvBkDlzGafJdJFGbKDaenrHsnJHqvbGqa",199,0.990099,40,202,2,200,1,2,1,3,2,100,99,101,101,27
"2203",2,"[40]qIkHoIplvBkDlzGafJdJFGbKDaenrHsnJHqvbGqa",199,0.990099,40,202,2,200,1,2,1,3,2,99,98,102,102,27
"2204",3,"[40]qIkHoIplvBkDlzGafJdJFGbKDaenrHsnJHqvbGqa",204,0.990338,40,207,2,205,1,2,1,3,2,105,104,101,101,27
"2205",4,"[40]qIkHoIplvBkDlzGafJdJFGbKDaenrHsnJHqvbGqa",198,0.99005,40,201,2,199,1,2,1,3,2,99,98,101,101,27
"2206",5,"[40]qIkHoIplvBkDlzGafJdJFGbKDaenrHsnJHqvbGqa",180,0.989071,40,183,2,181,1,2,1,3,2,72,71,110,110,27
"2207",6,"[40]qIkHoIplvBkDlzGafJdJFGbKDaenrHsnJHqvbGqa",189,0.989583,40,192,2,190,1,2,1,3,2,85,84,106,106,27
"2208",7,"[40]qIkHoIplvBkDlzGafJdJFGbKDaenrHsnJHqvbGqa",203,0.990291,40,206,2,204,1,2,1,3,2,103,102,102,102,27
"2209",8,"[40]qIkHoIplvBkDlzGafJdJFGbKDaenrHsnJHqvbGqa",198,0.99005,40,201,2,199,1,2,1,3,2,97,96,103,103,27
"2210",9,"[40]qIkHoIplvBkDlzGafJdJFGbKDaenrHsnJHqvbGqa",206,0.990431,40,209,2,207,1,2,1,3,2,108,107,100,100,27
"2211",10,"[40]qIkHoIplvBkDlzGafJdJFGbKDaenrHsnJHqvbGqa",200,0.990148,40,203,2,201,1,2,1,3,2,100,99,102,102,27
"2212",11,"[40]qIkHoIplvBkDlzGafJdJFGbKDaenrHsnJHqvbGqa",200,0.990148,40,203,2,201,1,2,1,3,2,101,100,101,101,27
"2213",12,"[40]qIkHoIplvBkDlzGafJdJFGbKDaenrHsnJHqvbGqa",200,0.990148,40,203,2,201,1,2,1,3,2,100,99,102,102,27
"2214",13,"[40]qIkHoIplvBkDlzGafJdJFGbKDaenrHsnJHqvbGqa",202,0.990244,40,205,2,203,1,2,1,3,2,103,102,101,101,27
"2215",14,"[40]qIkHoIplvBkDlzGafJdJFGbKDaenrHsnJHqvbGqa",205,0.990385,40,208,2,206,1,2,1,3,2,108,107,99,99,27
"2216",15,"[40]qIkHoIplvBkDlzGafJdJFGbKDaenrHsnJHqvbGqa",200,0.990148,40,203,2,201,1,2,1,3,2,102,101,100,100,27
"2217",16,"[40]qIkHoIplvBkDlzGafJdJFGbKDaenrHsnJHqvbGqa",202,0.990244,40,205,2,203,1,2,1,3,2,103,102,101,101,27
"2218",17,"[40]qIkHoIplvBkDlzGafJdJFGbKDaenrHsnJHqvbGqa",206,0.990431,40,209,2,207,1,2,1,3,2,110,109,98,98,27
"2219",18,"[40]qIkHoIplvBkDlzGafJdJFGbKDaenrHsnJHqvbGqa",199,0.990099,40,202,2,200,1,2,1,3,2,98,97,103,103,27
"2220",19,"[40]qIkHoIplvBkDlzGafJdJFGbKDaenrHsnJHqvbGqa",200,0.990148,40,203,2,201,1,2,1,3,2,98,97,104,104,27
"2221",20,"[40]qIkHoIplvBkDlzGafJdJFGbKDaenrHsnJHqvbGqa",210,0.99061,40,213,2,211,1,2,1,3,2,114,113,98,98,27
"2222",21,"[40]qIkHoIplvBkDlzGafJdJFGbKDaenrHsnJHqvbGqa",194,0.989848,40,197,2,195,1,2,1,3,2,92,91,104,104,27
"2223",22,"[40]qIkHoIplvBkDlzGafJdJFGbKDaenrHsnJHqvbGqa",196,0.98995,40,199,2,197,1,2,1,3,2,95,94,103,103,27
"2224",23,"[40]qIkHoIplvBkDlzGafJdJFGbKDaenrHsnJHqvbGqa",201,0.990196,40,204,2,202,1,2,1,3,2,101,100,102,102,27
"2225",24,"[40]qIkHoIplvBkDlzGafJdJFGbKDaenrHsnJHqvbGqa",204,0.990338,40,207,2,205,1,2,1,3,2,107,106,99,99,27
"2226",25,"[40]qIkHoIplvBkDlzGafJdJFGbKDaenrHsnJHqvbGqa",213,0.990741,40,216,2,214,1,2,1,3,2,120,119,95,95,27
"2227",26,"[40]qIkHoIplvBkDlzGafJdJFGbKDaenrHsnJHqvbGqa",202,0.990244,40,205,2,203,1,2,1,3,2,105,104,99,99,27
"2228",27,"[40]qIkHoIplvBkDlzGafJdJFGbKDaenrHsnJHqvbGqa",217,0.990909,40,220,2,218,1,2,1,3,2,123,122,96,96,27
"2229",28,"[40]qIkHoIplvBkDlzGafJdJFGbKDaenrHsnJHqvbGqa",217,0.990909,40,220,2,218,1,2,1,3,2,125,124,94,94,27
"2230",29,"[40]qIkHoIplvBkDlzGafJdJFGbKDaenrHsnJHqvbGqa",190,0.989637,40,193,2,191,1,2,1,3,2,88,87,104,104,27
"2231",30,"[40]qIkHoIplvBkDlzGafJdJFGbKDaenrHsnJHqvbGqa",201,0.990196,40,204,2,202,1,2,1,3,2,103,102,100,100,27
"2232",31,"[40]qIkHoIplvBkDlzGafJdJFGbKDaenrHsnJHqvbGqa",197,0.99,40,200,2,198,1,2,1,3,2,97,96,102,102,27
"2233",32,"[40]qIkHoIplvBkDlzGafJdJFGbKDaenrHsnJHqvbGqa",208,0.990521,40,211,2,209,1,2,1,3,2,111,110,99,99,27
"2234",33,"[40]qIkHoIplvBkDlzGafJdJFGbKDaenrHsnJHqvbGqa",209,0.990566,40,212,2,210,1,2,1,3,2,112,111,99,99,27
"2235",34,"[40]qIkHoIplvBkDlzGafJdJFGbKDaenrHsnJHqvbGqa",209,0.990566,40,212,2,210,1,2,1,3,2,114,113,97,97,27
"2236",35,"[40]qIkHoIplvBkDlzGafJdJFGbKDaenrHsnJHqvbGqa",197,0.99,40,200,2,198,1,2,1,3,2,96,95,103,103,27
"2237",36,"[40]qIkHoIplvBkDlzGafJdJFGbKDaenrHsnJHqvbGqa",205,0.990385,40,208,2,206,1,2,1,3,2,107,106,100,100,27
"2238",37,"[40]qIkHoIplvBkDlzGafJdJFGbKDaenrHsnJHqvbGqa",204,0.990338,40,207,2,205,1,2,1,3,2,109,108,97,97,27
"2239",38,"[40]qIkHoIplvBkDlzGafJdJFGbKDaenrHsnJHqvbGqa",195,0.989899,40,198,2,196,1,2,1,3,2,95,94,102,102,27
"2240",39,"[40]qIkHoIplvBkDlzGafJdJFGbKDaenrHsnJHqvbGqa",203,0.990291,40,206,2,204,1,2,1,3,2,105,104,100,100,27
"2241",40,"[40]qIkHoIplvBkDlzGafJdJFGbKDaenrHsnJHqvbGqa",213,0.990741,40,216,2,214,1,2,1,3,2,116,115,99,99,27
"2242",41,"[40]qIkHoIplvBkDlzGafJdJFGbKDaenrHsnJHqvbGqa",192,0.989744,40,195,2,193,1,2,1,3,2,90,89,104,104,27
"2243",42,"[40]qIkHoIplvBkDlzGafJdJFGbKDaenrHsnJHqvbGqa",206,0.990431,40,209,2,207,1,2,1,3,2,111,110,97,97,27
"2244",43,"[40]qIkHoIplvBkDlzGafJdJFGbKDaenrHsnJHqvbGqa",192,0.989744,40,195,2,193,1,2,1,3,2,90,89,104,104,27
"2245",44,"[40]qIkHoIplvBkDlzGafJdJFGbKDaenrHsnJHqvbGqa",198,0.99005,40,201,2,199,1,2,1,3,2,99,98,101,101,27
"2246",45,"[40]qIkHoIplvBkDlzGafJdJFGbKDaenrHsnJHqvbGqa",205,0.990385,40,208,2,206,1,2,1,3,2,107,106,100,100,27
"2247",46,"[40]qIkHoIplvBkDlzGafJdJFGbKDaenrHsnJHqvbGqa",202,0.990244,40,205,2,203,1,2,1,3,2,103,102,101,101,27
"2248",47,"[40]qIkHoIplvBkDlzGafJdJFGbKDaenrHsnJHqvbGqa",220,0.991031,40,223,2,221,1,2,1,3,2,125,124,97,97,27
"2249",48,"[40]qIkHoIplvBkDlzGafJdJFGbKDaenrHsnJHqvbGqa",195,0.989899,40,198,2,196,1,2,1,3,2,93,92,104,104,27
"2250",49,"[40]qIkHoIplvBkDlzGafJdJFGbKDaenrHsnJHqvbGqa",198,0.99005,40,201,2,199,1,2,1,3,2,95,94,105,105,27
"2251",50,"[40]qIkHoIplvBkDlzGafJdJFGbKDaenrHsnJHqvbGqa",192,0.989744,40,195,2,193,1,2,1,3,2,87,86,107,107,27
"2252",51,"[40]qIkHoIplvBkDlzGafJdJFGbKDaenrHsnJHqvbGqa",196,0.98995,40,199,2,197,1,2,1,3,2,96,95,102,102,27
"2253",52,"[40]qIkHoIplvBkDlzGafJdJFGbKDaenrHsnJHqvbGqa",191,0.989691,40,194,2,192,1,2,1,3,2,86,85,107,107,27
"2254",53,"[40]qIkHoIplvBkDlzGafJdJFGbKDaenrHsnJHqvbGqa",206,0.990431,40,209,2,207,1,2,1,3,2,109,108,99,99,27
"2255",54,"[40]qIkHoIplvBkDlzGafJdJFGbKDaenrHsnJHqvbGqa",208,0.990521,40,211,2,209,1,2,1,3,2,110,109,100,100,27
"2256",55,"[40]qIkHoIplvBkDlzGafJdJFGbKDaenrHsnJHqvbGqa",207,0.990476,40,210,2,208,1,2,1,3,2,111,110,98,98,27
"2257",56,"[40]qIkHoIplvBkDlzGafJdJFGbKDaenrHsnJHqvbGqa",202,0.990244,40,205,2,203,1,2,1,3,2,105,104,99,99,27
"2258",57,"[40]qIkHoIplvBkDlzGafJdJFGbKDaenrHsnJHqvbGqa",194,0.989848,40,197,2,195,1,2,1,3,2,92,91,104,104,27
"2259",58,"[40]qIkHoIplvBkDlzGafJdJFGbKDaenrHsnJHqvbGqa",206,0.990431,40,209,2,207,1,2,1,3,2,110,109,98,98,27
"2260",59,"[40]qIkHoIplvBkDlzGafJdJFGbKDaenrHsnJHqvbGqa",207,0.990476,40,210,2,208,1,2,1,3,2,108,107,101,101,27
"2261",60,"[40]qIkHoIplvBkDlzGafJdJFGbKDaenrHsnJHqvbGqa",204,0.990338,40,207,2,205,1,2,1,3,2,104,103,102,102,27
"2262",61,"[40]qIkHoIplvBkDlzGafJdJFGbKDaenrHsnJHqvbGqa",192,0.989744,40,195,2,193,1,2,1,3,2,88,87,106,106,27
"2263",62,"[40]qIkHoIplvBkDlzGafJdJFGbKDaenrHsnJHqvbGqa",206,0.990431,40,209,2,207,1,2,1,3,2,109,108,99,99,27
"2264",63,"[40]qIkHoIplvBkDlzGafJdJFGbKDaenrHsnJHqvbGqa",198,0.99005,40,201,2,199,1,2,1,3,2,100,99,100,100,27
"2265",64,"[40]qIkHoIplvBkDlzGafJdJFGbKDaenrHsnJHqvbGqa",206,0.990431,40,209,2,207,1,2,1,3,2,111,110,97,97,27
"2266",65,"[40]qIkHoIplvBkDlzGafJdJFGbKDaenrHsnJHqvbGqa",201,0.990196,40,204,2,202,1,2,1,3,2,105,104,98,98,27
"2267",66,"[40]qIkHoIplvBkDlzGafJdJFGbKDaenrHsnJHqvbGqa",194,0.989848,40,197,2,195,1,2,1,3,2,92,91,104,104,27
"2268",67,"[40]qIkHoIplvBkDlzGafJdJFGbKDaenrHsnJHqvbGqa",208,0.990521,40,211,2,209,1,2,1,3,2,116,115,94,94,27
"2269",68,"[40]qIkHoIplvBkDlzGafJdJFGbKDaenrHsnJHqvbGqa",201,0.990196,40,204,2,202,1,2,1,3,2,101,100,102,102,27
"2270",69,"[40]qIkHoIplvBkDlzGafJdJFGbKDaenrHsnJHqvbGqa",197,0.99,40,200,2,198,1,2,1,3,2,98,97,101,101,27
"2271",70,"[40]qIkHoIplvBkDlzGafJdJFGbKDaenrHsnJHqvbGqa",183,0.989247,40,186,2,184,1,2,1,3,2,80,79,105,105,27
"2272",71,"[40]qIkHoIplvBkDlzGafJdJFGbKDaenrHsnJHqvbGqa",214,0.990783,40,217,2,215,1,2,1,3,2,120,119,96,96,27
"2273",72,"[40]qIkHoIplvBkDlzGafJdJFGbKDaenrHsnJHqvbGqa",208,0.990521,40,211,2,209,1,2,1,3,2,114,113,96,96,27
"2274",73,"[40]qIkHoIplvBkDlzGafJdJFGbKDaenrHsnJHqvbGqa",194,0.989848,40,197,2,195,1,2,1,3,2,95,94,101,101,27
"2275",74,"[40]qIkHoIplvBkDlzGafJdJFGbKDaenrHsnJHqvbGqa",210,0.99061,40,213,2,211,1,2,1,3,2,112,111,100,100,27
"2276",75,"[40]qIkHoIplvBkDlzGafJdJFGbKDaenrHsnJHqvbGqa",207,0.990476,40,210,2,208,1,2,1,3,2,110,109,99,99,27
"2277",76,"[40]qIkHoIplvBkDlzGafJdJFGbKDaenrHsnJHqvbGqa",207,0.990476,40,210,2,208,1,2,1,3,2,113,112,96,96,27
"2278",77,"[40]qIkHoIplvBkDlzGafJdJFGbKDaenrHsnJHqvbGqa",209,0.990566,40,212,2,210,1,2,1,3,2,113,112,98,98,27
"2279",78,"[40]qIkHoIplvBkDlzGafJdJFGbKDaenrHsnJHqvbGqa",191,0.989691,40,194,2,192,1,2,1,3,2,89,88,104,104,27
"2280",79,"[40]qIkHoIplvBkDlzGafJdJFGbKDaenrHsnJHqvbGqa",201,0.990196,40,204,2,202,1,2,1,3,2,100,99,103,103,27
"2281",80,"[40]qIkHoIplvBkDlzGafJdJFGbKDaenrHsnJHqvbGqa",202,0.990244,40,205,2,203,1,2,1,3,2,104,103,100,100,27
"2282",81,"[40]qIkHoIplvBkDlzGafJdJFGbKDaenrHsnJHqvbGqa",212,0.990698,40,215,2,213,1,2,1,3,2,120,119,94,94,27
"2283",82,"[40]qIkHoIplvBkDlzGafJdJFGbKDaenrHsnJHqvbGqa",206,0.990431,40,209,2,207,1,2,1,3,2,109,108,99,99,27
"2284",83,"[40]qIkHoIplvBkDlzGafJdJFGbKDaenrHsnJHqvbGqa",207,0.990476,40,210,2,208,1,2,1,3,2,107,106,102,102,27
"2285",84,"[40]qIkHoIplvBkDlzGafJdJFGbKDaenrHsnJHqvbGqa",200,0.990148,40,203,2,201,1,2,1,3,2,101,100,101,101,27
"2286",85,"[40]qIkHoIplvBkDlzGafJdJFGbKDaenrHsnJHqvbGqa",209,0.990566,40,212,2,210,1,2,1,3,2,112,111,99,99,27
"2287",86,"[40]qIkHoIplvBkDlzGafJdJFGbKDaenrHsnJHqvbGqa",189,0.989583,40,192,2,190,1,2,1,3,2,88,87,103,103,27
"2288",87,"[40]qIkHoIplvBkDlzGafJdJFGbKDaenrHsnJHqvbGqa",207,0.990476,40,210,2,208,1,2,1,3,2,111,110,98,98,27
"2289",88,"[40]qIkHoIplvBkDlzGafJdJFGbKDaenrHsnJHqvbGqa",204,0.990338,40,207,2,205,1,2,1,3,2,104,103,102,102,27
"2290",89,"[40]qIkHoIplvBkDlzGafJdJFGbKDaenrHsnJHqvbGqa",193,0.989796,40,196,2,194,1,2,1,3,2,93,92,102,102,27
"2291",90,"[40]qIkHoIplvBkDlzGafJdJFGbKDaenrHsnJHqvbGqa",218,0.99095,40,221,2,219,1,2,1,3,2,126,125,94,94,27
"2292",91,"[40]qIkHoIplvBkDlzGafJdJFGbKDaenrHsnJHqvbGqa",199,0.990099,40,202,2,200,1,2,1,3,2,99,98,102,102,27
"2293",92,"[40]qIkHoIplvBkDlzGafJdJFGbKDaenrHsnJHqvbGqa",210,0.99061,40,213,2,211,1,2,1,3,2,114,113,98,98,27
"2294",93,"[40]qIkHoIplvBkDlzGafJdJFGbKDaenrHsnJHqvbGqa",213,0.990741,40,216,2,214,1,2,1,3,2,119,118,96,96,27
"2295",94,"[40]qIkHoIplvBkDlzGafJdJFGbKDaenrHsnJHqvbGqa",195,0.989899,40,198,2,196,1,2,1,3,2,94,93,103,103,27
"2296",95,"[40]qIkHoIplvBkDlzGafJdJFGbKDaenrHsnJHqvbGqa",205,0.990385,40,208,2,206,1,2,1,3,2,108,107,99,99,27
"2297",96,"[40]qIkHoIplvBkDlzGafJdJFGbKDaenrHsnJHqvbGqa",198,0.99005,40,201,2,199,1,2,1,3,2,97,96,103,103,27
"2298",97,"[40]qIkHoIplvBkDlzGafJdJFGbKDaenrHsnJHqvbGqa",204,0.990338,40,207,2,205,1,2,1,3,2,106,105,100,100,27
"2299",98,"[40]qIkHoIplvBkDlzGafJdJFGbKDaenrHsnJHqvbGqa",196,0.98995,40,199,2,197,1,2,1,3,2,97,96,101,101,27
"2300",99,"[40]qIkHoIplvBkDlzGafJdJFGbKDaenrHsnJHqvbGqa",196,0.98995,40,199,2,197,1,2,1,3,2,96,95,102,102,27
"2301",0,"[40]lIGHoIofyBkDpsuDyCbomrbKDaeAgHtnJHqtbGqa",209,0.990566,40,212,2,210,1,2,1,3,2,112,111,99,99,28
"2302",1,"[40]lIGHoIofyBkDpsuDyCbomrbKDaeAgHtnJHqtbGqa",206,0.990431,40,209,2,207,1,2,1,3,2,109,108,99,99,28
"2303",2,"[40]lIGHoIofyBkDpsuDyCbomrbKDaeAgHtnJHqtbGqa",198,0.99005,40,201,2,199,1,2,1,3,2,97,96,103,103,28
"2304",3,"[40]lIGHoIofyBkDpsuDyCbomrbKDaeAgHtnJHqtbGqa",206,0.990431,40,209,2,207,1,2,1,3,2,110,109,98,98,28
"2305",4,"[40]lIGHoIofyBkDpsuDyCbomrbKDaeAgHtnJHqtbGqa",207,0.990476,40,210,2,208,1,2,1,3,2,108,107,101,101,28
"2306",5,"[40]lIGHoIofyBkDpsuDyCbomrbKDaeAgHtnJHqtbGqa",206,0.990431,40,209,2,207,1,2,1,3,2,109,108,99,99,28
"2307",6,"[40]lIGHoIofyBkDpsuDyCbomrbKDaeAgHtnJHqtbGqa",208,0.990521,40,211,2,209,1,2,1,3,2,114,113,96,96,28
"2308",7,"[40]lIGHoIofyBkDpsuDyCbomrbKDaeAgHtnJHqtbGqa",186,0.989418,40,189,2,187,1,2,1,3,2,81,80,107,107,28
"2309",8,"[40]lIGHoIofyBkDpsuDyCbomrbKDaeAgHtnJHqtbGqa",202,0.990244,40,205,2,203,1,2,1,3,2,103,102,101,101,28
"2310",9,"[40]lIGHoIofyBkDpsuDyCbomrbKDaeAgHtnJHqtbGqa",193,0.989796,40,196,2,194,1,2,1,3,2,90,89,105,105,28
"2311",10,"[40]lIGHoIofyBkDpsuDyCbomrbKDaeAgHtnJHqtbGqa",194,0.989848,40,197,2,195,1,2,1,3,2,92,91,104,104,28
"2312",11,"[40]lIGHoIofyBkDpsuDyCbomrbKDaeAgHtnJHqtbGqa",202,0.990244,40,205,2,203,1,2,1,3,2,104,103,100,100,28
"2313",12,"[40]lIGHoIofyBkDpsuDyCbomrbKDaeAgHtnJHqtbGqa",209,0.990566,40,212,2,210,1,2,1,3,2,114,113,97,97,28
"2314",13,"[40]lIGHoIofyBkDpsuDyCbomrbKDaeAgHtnJHqtbGqa",196,0.98995,40,199,2,197,1,2,1,3,2,96,95,102,102,28
"2315",14,"[40]lIGHoIofyBkDpsuDyCbomrbKDaeAgHtnJHqtbGqa",198,0.99005,40,201,2,199,1,2,1,3,2,98,97,102,102,28
"2316",15,"[40]lIGHoIofyBkDpsuDyCbomrbKDaeAgHtnJHqtbGqa",209,0.990566,40,212,2,210,1,2,1,3,2,114,113,97,97,28
"2317",16,"[40]lIGHoIofyBkDpsuDyCbomrbKDaeAgHtnJHqtbGqa",211,0.990654,40,214,2,212,1,2,1,3,2,115,114,98,98,28
"2318",17,"[40]lIGHoIofyBkDpsuDyCbomrbKDaeAgHtnJHqtbGqa",218,0.99095,40,221,2,219,1,2,1,3,2,122,121,98,98,28
"2319",18,"[40]lIGHoIofyBkDpsuDyCbomrbKDaeAgHtnJHqtbGqa",219,0.990991,40,222,2,220,1,2,1,3,2,125,124,96,96,28
"2320",19,"[40]lIGHoIofyBkDpsuDyCbomrbKDaeAgHtnJHqtbGqa",218,0.99095,40,221,2,219,1,2,1,3,2,124,123,96,96,28
"2321",20,"[40]lIGHoIofyBkDpsuDyCbomrbKDaeAgHtnJHqtbGqa",201,0.990196,40,204,2,202,1,2,1,3,2,102,101,101,101,28
"2322",21,"[40]lIGHoIofyBkDpsuDyCbomrbKDaeAgHtnJHqtbGqa",198,0.99005,40,201,2,199,1,2,1,3,2,97,96,103,103,28
"2323",22,"[40]lIGHoIofyBkDpsuDyCbomrbKDaeAgHtnJHqtbGqa",199,0.990099,40,202,2,200,1,2,1,3,2,100,99,101,101,28
"2324",23,"[40]lIGHoIofyBkDpsuDyCbomrbKDaeAgHtnJHqtbGqa",186,0.989418,40,189,2,187,1,2,1,3,2,83,82,105,105,28
"2325",24,"[40]lIGHoIofyBkDpsuDyCbomrbKDaeAgHtnJHqtbGqa",192,0.989744,40,195,2,193,1,2,1,3,2,89,88,105,105,28
"2326",25,"[40]lIGHoIofyBkDpsuDyCbomrbKDaeAgHtnJHqtbGqa",206,0.990431,40,209,2,207,1,2,1,3,2,110,109,98,98,28
"2327",26,"[40]lIGHoIofyBkDpsuDyCbomrbKDaeAgHtnJHqtbGqa",196,0.98995,40,199,2,197,1,2,1,3,2,96,95,102,102,28
"2328",27,"[40]lIGHoIofyBkDpsuDyCbomrbKDaeAgHtnJHqtbGqa",193,0.989796,40,196,2,194,1,2,1,3,2,93,92,102,102,28
"2329",28,"[40]lIGHoIofyBkDpsuDyCbomrbKDaeAgHtnJHqtbGqa",204,0.990338,40,207,2,205,1,2,1,3,2,104,103,102,102,28
"2330",29,"[40]lIGHoIofyBkDpsuDyCbomrbKDaeAgHtnJHqtbGqa",202,0.990244,40,205,2,203,1,2,1,3,2,105,104,99,99,28
"2331",30,"[40]lIGHoIofyBkDpsuDyCbomrbKDaeAgHtnJHqtbGqa",205,0.990385,40,208,2,206,1,2,1,3,2,110,109,97,97,28
"2332",31,"[40]lIGHoIofyBkDpsuDyCbomrbKDaeAgHtnJHqtbGqa",201,0.990196,40,204,2,202,1,2,1,3,2,104,103,99,99,28
"2333",32,"[40]lIGHoIofyBkDpsuDyCbomrbKDaeAgHtnJHqtbGqa",196,0.98995,40,199,2,197,1,2,1,3,2,95,94,103,103,28
"2334",33,"[40]lIGHoIofyBkDpsuDyCbomrbKDaeAgHtnJHqtbGqa",192,0.989744,40,195,2,193,1,2,1,3,2,88,87,106,106,28
"2335",34,"[40]lIGHoIofyBkDpsuDyCbomrbKDaeAgHtnJHqtbGqa",210,0.99061,40,213,2,211,1,2,1,3,2,113,112,99,99,28
"2336",35,"[40]lIGHoIofyBkDpsuDyCbomrbKDaeAgHtnJHqtbGqa",191,0.989691,40,194,2,192,1,2,1,3,2,89,88,104,104,28
"2337",36,"[40]lIGHoIofyBkDpsuDyCbomrbKDaeAgHtnJHqtbGqa",203,0.990291,40,206,2,204,1,2,1,3,2,105,104,100,100,28
"2338",37,"[40]lIGHoIofyBkDpsuDyCbomrbKDaeAgHtnJHqtbGqa",196,0.98995,40,199,2,197,1,2,1,3,2,91,90,107,107,28
"2339",38,"[40]lIGHoIofyBkDpsuDyCbomrbKDaeAgHtnJHqtbGqa",199,0.990099,40,202,2,200,1,2,1,3,2,99,98,102,102,28
"2340",39,"[40]lIGHoIofyBkDpsuDyCbomrbKDaeAgHtnJHqtbGqa",196,0.98995,40,199,2,197,1,2,1,3,2,96,95,102,102,28
"2341",40,"[40]lIGHoIofyBkDpsuDyCbomrbKDaeAgHtnJHqtbGqa",202,0.990244,40,205,2,203,1,2,1,3,2,106,105,98,98,28
"2342",41,"[40]lIGHoIofyBkDpsuDyCbomrbKDaeAgHtnJHqtbGqa",206,0.990431,40,209,2,207,1,2,1,3,2,109,108,99,99,28
"2343",42,"[40]lIGHoIofyBkDpsuDyCbomrbKDaeAgHtnJHqtbGqa",209,0.990566,40,212,2,210,1,2,1,3,2,113,112,98,98,28
"2344",43,"[40]lIGHoIofyBkDpsuDyCbomrbKDaeAgHtnJHqtbGqa",196,0.98995,40,199,2,197,1,2,1,3,2,97,96,101,101,28
"2345",44,"[40]lIGHoIofyBkDpsuDyCbomrbKDaeAgHtnJHqtbGqa",218,0.99095,40,221,2,219,1,2,1,3,2,126,125,94,94,28
"2346",45,"[40]lIGHoIofyBkDpsuDyCbomrbKDaeAgHtnJHqtbGqa",210,0.99061,40,213,2,211,1,2,1,3,2,114,113,98,98,28
"2347",46,"[40]lIGHoIofyBkDpsuDyCbomrbKDaeAgHtnJHqtbGqa",208,0.990521,40,211,2,209,1,2,1,3,2,111,110,99,99,28
"2348",47,"[40]lIGHoIofyBkDpsuDyCbomrbKDaeAgHtnJHqtbGqa",191,0.989691,40,194,2,192,1,2,1,3,2,91,90,102,102,28
"2349",48,"[40]lIGHoIofyBkDpsuDyCbomrbKDaeAgHtnJHqtbGqa",202,0.990244,40,205,2,203,1,2,1,3,2,105,104,99,99,28
"2350",49,"[40]lIGHoIofyBkDpsuDyCbomrbKDaeAgHtnJHqtbGqa",210,0.99061,40,213,2,211,1,2,1,3,2,114,113,98,98,28
"2351",50,"[40]lIGHoIofyBkDpsuDyCbomrbKDaeAgHtnJHqtbGqa",210,0.99061,40,213,2,211,1,2,1,3,2,115,114,97,97,28
"2352",51,"[40]lIGHoIofyBkDpsuDyCbomrbKDaeAgHtnJHqtbGqa",196,0.98995,40,199,2,197,1,2,1,3,2,96,95,102,102,28
"2353",52,"[40]lIGHoIofyBkDpsuDyCbomrbKDaeAgHtnJHqtbGqa",186,0.989418,40,189,2,187,1,2,1,3,2,80,79,108,108,28
"2354",53,"[40]lIGHoIofyBkDpsuDyCbomrbKDaeAgHtnJHqtbGqa",197,0.99,40,200,2,198,1,2,1,3,2,97,96,102,102,28
"2355",54,"[40]lIGHoIofyBkDpsuDyCbomrbKDaeAgHtnJHqtbGqa",209,0.990566,40,212,2,210,1,2,1,3,2,110,109,101,101,28
"2356",55,"[40]lIGHoIofyBkDpsuDyCbomrbKDaeAgHtnJHqtbGqa",211,0.990654,40,214,2,212,1,2,1,3,2,116,115,97,97,28
"2357",56,"[40]lIGHoIofyBkDpsuDyCbomrbKDaeAgHtnJHqtbGqa",200,0.990148,40,203,2,201,1,2,1,3,2,100,99,102,102,28
"2358",57,"[40]lIGHoIofyBkDpsuDyCbomrbKDaeAgHtnJHqtbGqa",198,0.99005,40,201,2,199,1,2,1,3,2,98,97,102,102,28
"2359",58,"[40]lIGHoIofyBkDpsuDyCbomrbKDaeAgHtnJHqtbGqa",199,0.990099,40,202,2,200,1,2,1,3,2,98,97,103,103,28
"2360",59,"[40]lIGHoIofyBkDpsuDyCbomrbKDaeAgHtnJHqtbGqa",208,0.990521,40,211,2,209,1,2,1,3,2,113,112,97,97,28
"2361",60,"[40]lIGHoIofyBkDpsuDyCbomrbKDaeAgHtnJHqtbGqa",191,0.989691,40,194,2,192,1,2,1,3,2,90,89,103,103,28
"2362",61,"[40]lIGHoIofyBkDpsuDyCbomrbKDaeAgHtnJHqtbGqa",207,0.990476,40,210,2,208,1,2,1,3,2,110,109,99,99,28
"2363",62,"[40]lIGHoIofyBkDpsuDyCbomrbKDaeAgHtnJHqtbGqa",205,0.990385,40,208,2,206,1,2,1,3,2,110,109,97,97,28
"2364",63,"[40]lIGHoIofyBkDpsuDyCbomrbKDaeAgHtnJHqtbGqa",193,0.989796,40,196,2,194,1,2,1,3,2,94,93,101,101,28
"2365",64,"[40]lIGHoIofyBkDpsuDyCbomrbKDaeAgHtnJHqtbGqa",191,0.989691,40,194,2,192,1,2,1,3,2,86,85,107,107,28
"2366",65,"[40]lIGHoIofyBkDpsuDyCbomrbKDaeAgHtnJHqtbGqa",202,0.990244,40,205,2,203,1,2,1,3,2,100,99,104,104,28
"2367",66,"[40]lIGHoIofyBkDpsuDyCbomrbKDaeAgHtnJHqtbGqa",203,0.990291,40,206,2,204,1,2,1,3,2,104,103,101,101,28
"2368",67,"[40]lIGHoIofyBkDpsuDyCbomrbKDaeAgHtnJHqtbGqa",195,0.989899,40,198,2,196,1,2,1,3,2,92,91,105,105,28
"2369",68,"[40]lIGHoIofyBkDpsuDyCbomrbKDaeAgHtnJHqtbGqa",211,0.990654,40,214,2,212,1,2,1,3,2,115,114,98,98,28
"2370",69,"[40]lIGHoIofyBkDpsuDyCbomrbKDaeAgHtnJHqtbGqa",213,0.990741,40,216,2,214,1,2,1,3,2,119,118,96,96,28
"2371",70,"[40]lIGHoIofyBkDpsuDyCbomrbKDaeAgHtnJHqtbGqa",216,0.990868,40,219,2,217,1,2,1,3,2,122,121,96,96,28
"2372",71,"[40]lIGHoIofyBkDpsuDyCbomrbKDaeAgHtnJHqtbGqa",206,0.990431,40,209,2,207,1,2,1,3,2,109,108,99,99,28
"2373",72,"[40]lIGHoIofyBkDpsuDyCbomrbKDaeAgHtnJHqtbGqa",193,0.989796,40,196,2,194,1,2,1,3,2,92,91,103,103,28
"2374",73,"[40]lIGHoIofyBkDpsuDyCbomrbKDaeAgHtnJHqtbGqa",189,0.989583,40,192,2,190,1,2,1,3,2,84,83,107,107,28
"2375",74,"[40]lIGHoIofyBkDpsuDyCbomrbKDaeAgHtnJHqtbGqa",211,0.990654,40,214,2,212,1,2,1,3,2,113,112,100,100,28
"2376",75,"[40]lIGHoIofyBkDpsuDyCbomrbKDaeAgHtnJHqtbGqa",189,0.989583,40,192,2,190,1,2,1,3,2,86,85,105,105,28
"2377",76,"[40]lIGHoIofyBkDpsuDyCbomrbKDaeAgHtnJHqtbGqa",191,0.989691,40,194,2,192,1,2,1,3,2,88,87,105,105,28
"2378",77,"[40]lIGHoIofyBkDpsuDyCbomrbKDaeAgHtnJHqtbGqa",213,0.990741,40,216,2,214,1,2,1,3,2,119,118,96,96,28
"2379",78,"[40]lIGHoIofyBkDpsuDyCbomrbKDaeAgHtnJHqtbGqa",193,0.989796,40,196,2,194,1,2,1,3,2,89,88,106,106,28
"2380",79,"[40]lIGHoIofyBkDpsuDyCbomrbKDaeAgHtnJHqtbGqa",192,0.989744,40,195,2,193,1,2,1,3,2,90,89,104,104,28
"2381",80,"[40]lIGHoIofyBkDpsuDyCbomrbKDaeAgHtnJHqtbGqa",188,0.989529,40,191,2,189,1,2,1,3,2,86,85,104,104,28
"2382",81,"[40]lIGHoIofyBkDpsuDyCbomrbKDaeAgHtnJHqtbGqa",201,0.990196,40,204,2,202,1,2,1,3,2,104,103,99,99,28
"2383",82,"[40]lIGHoIofyBkDpsuDyCbomrbKDaeAgHtnJHqtbGqa",201,0.990196,40,204,2,202,1,2,1,3,2,100,99,103,103,28
"2384",83,"[40]lIGHoIofyBkDpsuDyCbomrbKDaeAgHtnJHqtbGqa",209,0.990566,40,212,2,210,1,2,1,3,2,113,112,98,98,28
"2385",84,"[40]lIGHoIofyBkDpsuDyCbomrbKDaeAgHtnJHqtbGqa",198,0.99005,40,201,2,199,1,2,1,3,2,99,98,101,101,28
"2386",85,"[40]lIGHoIofyBkDpsuDyCbomrbKDaeAgHtnJHqtbGqa",192,0.989744,40,195,2,193,1,2,1,3,2,89,88,105,105,28
"2387",86,"[40]lIGHoIofyBkDpsuDyCbomrbKDaeAgHtnJHqtbGqa",215,0.990826,40,218,2,216,1,2,1,3,2,123,122,94,94,28
"2388",87,"[40]lIGHoIofyBkDpsuDyCbomrbKDaeAgHtnJHqtbGqa",205,0.990385,40,208,2,206,1,2,1,3,2,108,107,99,99,28
"2389",88,"[40]lIGHoIofyBkDpsuDyCbomrbKDaeAgHtnJHqtbGqa",204,0.990338,40,207,2,205,1,2,1,3,2,108,107,98,98,28
"2390",89,"[40]lIGHoIofyBkDpsuDyCbomrbKDaeAgHtnJHqtbGqa",202,0.990244,40,205,2,203,1,2,1,3,2,102,101,102,102,28
"2391",90,"[40]lIGHoIofyBkDpsuDyCbomrbKDaeAgHtnJHqtbGqa",206,0.990431,40,209,2,207,1,2,1,3,2,107,106,101,101,28
"2392",91,"[40]lIGHoIofyBkDpsuDyCbomrbKDaeAgHtnJHqtbGqa",203,0.990291,40,206,2,204,1,2,1,3,2,104,103,101,101,28
"2393",92,"[40]lIGHoIofyBkDpsuDyCbomrbKDaeAgHtnJHqtbGqa",206,0.990431,40,209,2,207,1,2,1,3,2,106,105,102,102,28
"2394",93,"[40]lIGHoIofyBkDpsuDyCbomrbKDaeAgHtnJHqtbGqa",193,0.989796,40,196,2,194,1,2,1,3,2,91,90,104,104,28
"2395",94,"[40]lIGHoIofyBkDpsuDyCbomrbKDaeAgHtnJHqtbGqa",203,0.990291,40,206,2,204,1,2,1,3,2,106,105,99,99,28
"2396",95,"[40]lIGHoIofyBkDpsuDyCbomrbKDaeAgHtnJHqtbGqa",196,0.98995,40,199,2,197,1,2,1,3,2,95,94,103,103,28
"2397",96,"[40]lIGHoIofyBkDpsuDyCbomrbKDaeAgHtnJHqtbGqa",200,0.990148,40,203,2,201,1,2,1,3,2,101,100,101,101,28
"2398",97,"[40]lIGHoIofyBkDpsuDyCbomrbKDaeAgHtnJHqtbGqa",206,0.990431,40,209,2,207,1,2,1,3,2,111,110,97,97,28
"2399",98,"[40]lIGHoIofyBkDpsuDyCbomrbKDaeAgHtnJHqtbGqa",209,0.990566,40,212,2,210,1,2,1,3,2,111,110,100,100,28
"2400",99,"[40]lIGHoIofyBkDpsuDyCbomrbKDaeAgHtnJHqtbGqa",185,0.989362,40,188,2,186,1,2,1,3,2,79,78,108,108,28
"2401",0,"[40]FIjHoIzxGtBkFDBjDtvzhpbKDeeJGHvnJHqvbGqa",202,0.990244,40,205,2,203,1,2,1,3,2,103,102,101,101,29
"2402",1,"[40]FIjHoIzxGtBkFDBjDtvzhpbKDeeJGHvnJHqvbGqa",188,0.989529,40,191,2,189,1,2,1,3,2,82,81,108,108,29
"2403",2,"[40]FIjHoIzxGtBkFDBjDtvzhpbKDeeJGHvnJHqvbGqa",204,0.990338,40,207,2,205,1,2,1,3,2,108,107,98,98,29
"2404",3,"[40]FIjHoIzxGtBkFDBjDtvzhpbKDeeJGHvnJHqvbGqa",217,0.990909,40,220,2,218,1,2,1,3,2,126,125,93,93,29
"2405",4,"[40]FIjHoIzxGtBkFDBjDtvzhpbKDeeJGHvnJHqvbGqa",196,0.98995,40,199,2,197,1,2,1,3,2,95,94,103,103,29
"2406",5,"[40]FIjHoIzxGtBkFDBjDtvzhpbKDeeJGHvnJHqvbGqa",195,0.989899,40,198,2,196,1,2,1,3,2,96,95,101,101,29
"2407",6,"[40]FIjHoIzxGtBkFDBjDtvzhpbKDeeJGHvnJHqvbGqa",195,0.989899,40,198,2,196,1,2,1,3,2,96,95,101,101,29
"2408",7,"[40]FIjHoIzxGtBkFDBjDtvzhpbKDeeJGHvnJHqvbGqa",200,0.990148,40,203,2,201,1,2,1,3,2,101,100,101,101,29
"2409",8,"[40]FIjHoIzxGtBkFDBjDtvzhpbKDeeJGHvnJHqvbGqa",194,0.989848,40,197,2,195,1,2,1,3,2,92,91,104,104,29
"2410",9,"[40]FIjHoIzxGtBkFDBjDtvzhpbKDeeJGHvnJHqvbGqa",196,0.98995,40,199,2,197,1,2,1,3,2,95,94,103,103,29
"2411",10,"[40]FIjHoIzxGtBkFDBjDtvzhpbKDeeJGHvnJHqvbGqa",211,0.990654,40,214,2,212,1,2,1,3,2,116,115,97,97,29
"2412",11,"[40]FIjHoIzxGtBkFDBjDtvzhpbKDeeJGHvnJHqvbGqa",201,0.990196,40,204,2,202,1,2,1,3,2,103,102,100,100,29
"2413",12,"[40]FIjHoIzxGtBkFDBjDtvzhpbKDeeJGHvnJHqvbGqa",187,0.989474,40,190,2,188,1,2,1,3,2,83,82,106,106,29
"2414",13,"[40]FIjHoIzxGtBkFDBjDtvzhpbKDeeJGHvnJHqvbGqa",188,0.989529,40,191,2,189,1,2,1,3,2,85,84,105,105,29
"2415",14,"[40]FIjHoIzxGtBkFDBjDtvzhpbKDeeJGHvnJHqvbGqa",200,0.990148,40,203,2,201,1,2,1,3,2,100,99,102,102,29
"2416",15,"[40]FIjHoIzxGtBkFDBjDtvzhpbKDeeJGHvnJHqvbGqa",205,0.990385,40,208,2,206,1,2,1,3,2,106,105,101,101,29
"2417",16,"[40]FIjHoIzxGtBkFDBjDtvzhpbKDeeJGHvnJHqvbGqa",204,0.990338,40,207,2,205,1,2,1,3,2,107,106,99,99,29
"2418",17,"[40]FIjHoIzxGtBkFDBjDtvzhpbKDeeJGHvnJHqvbGqa",205,0.990385,40,208,2,206,1,2,1,3,2,108,107,99,99,29
"2419",18,"[40]FIjHoIzxGtBkFDBjDtvzhpbKDeeJGHvnJHqvbGqa",196,0.98995,40,199,2,197,1,2,1,3,2,95,94,103,103,29
"2420",19,"[40]FIjHoIzxGtBkFDBjDtvzhpbKDeeJGHvnJHqvbGqa",186,0.989418,40,189,2,187,1,2,1,3,2,84,83,104,104,29
"2421",20,"[40]FIjHoIzxGtBkFDBjDtvzhpbKDeeJGHvnJHqvbGqa",192,0.989744,40,195,2,193,1,2,1,3,2,91,90,103,103,29
"2422",21,"[40]FIjHoIzxGtBkFDBjDtvzhpbKDeeJGHvnJHqvbGqa",207,0.990476,40,210,2,208,1,2,1,3,2,112,111,97,97,29
"2423",22,"[40]FIjHoIzxGtBkFDBjDtvzhpbKDeeJGHvnJHqvbGqa",190,0.989637,40,193,2,191,1,2,1,3,2,88,87,104,104,29
"2424",23,"[40]FIjHoIzxGtBkFDBjDtvzhpbKDeeJGHvnJHqvbGqa",208,0.990521,40,211,2,209,1,2,1,3,2,110,109,100,100,29
"2425",24,"[40]FIjHoIzxGtBkFDBjDtvzhpbKDeeJGHvnJHqvbGqa",199,0.990099,40,202,2,200,1,2,1,3,2,99,98,102,102,29
"2426",25,"[40]FIjHoIzxGtBkFDBjDtvzhpbKDeeJGHvnJHqvbGqa",214,0.990783,40,217,2,215,1,2,1,3,2,120,119,96,96,29
"2427",26,"[40]FIjHoIzxGtBkFDBjDtvzhpbKDeeJGHvnJHqvbGqa",198,0.99005,40,201,2,199,1,2,1,3,2,96,95,104,104,29
"2428",27,"[40]FIjHoIzxGtBkFDBjDtvzhpbKDeeJGHvnJHqvbGqa",200,0.990148,40,203,2,201,1,2,1,3,2,103,102,99,99,29
"2429",28,"[40]FIjHoIzxGtBkFDBjDtvzhpbKDeeJGHvnJHqvbGqa",194,0.989848,40,197,2,195,1,2,1,3,2,93,92,103,103,29
"2430",29,"[40]FIjHoIzxGtBkFDBjDtvzhpbKDeeJGHvnJHqvbGqa",206,0.990431,40,209,2,207,1,2,1,3,2,108,107,100,100,29
"2431",30,"[40]FIjHoIzxGtBkFDBjDtvzhpbKDeeJGHvnJHqvbGqa",204,0.990338,40,207,2,205,1,2,1,3,2,106,105,100,100,29
"2432",31,"[40]FIjHoIzxGtBkFDBjDtvzhpbKDeeJGHvnJHqvbGqa",209,0.990566,40,212,2,210,1,2,1,3,2,113,112,98,98,29
"2433",32,"[40]FIjHoIzxGtBkFDBjDtvzhpbKDeeJGHvnJHqvbGqa",186,0.989418,40,189,2,187,1,2,1,3,2,82,81,106,106,29
"2434",33,"[40]FIjHoIzxGtBkFDBjDtvzhpbKDeeJGHvnJHqvbGqa",200,0.990148,40,203,2,201,1,2,1,3,2,98,97,104,104,29
"2435",34,"[40]FIjHoIzxGtBkFDBjDtvzhpbKDeeJGHvnJHqvbGqa",209,0.990566,40,212,2,210,1,2,1,3,2,111,110,100,100,29
"2436",35,"[40]FIjHoIzxGtBkFDBjDtvzhpbKDeeJGHvnJHqvbGqa",197,0.99,40,200,2,198,1,2,1,3,2,95,94,104,104,29
"2437",36,"[40]FIjHoIzxGtBkFDBjDtvzhpbKDeeJGHvnJHqvbGqa",192,0.989744,40,195,2,193,1,2,1,3,2,90,89,104,104,29
"2438",37,"[40]FIjHoIzxGtBkFDBjDtvzhpbKDeeJGHvnJHqvbGqa",196,0.98995,40,199,2,197,1,2,1,3,2,96,95,102,102,29
"2439",38,"[40]FIjHoIzxGtBkFDBjDtvzhpbKDeeJGHvnJHqvbGqa",217,0.990909,40,220,2,218,1,2,1,3,2,124,123,95,95,29
"2440",39,"[40]FIjHoIzxGtBkFDBjDtvzhpbKDeeJGHvnJHqvbGqa",202,0.990244,40,205,2,203,1,2,1,3,2,102,101,102,102,29
"2441",40,"[40]FIjHoIzxGtBkFDBjDtvzhpbKDeeJGHvnJHqvbGqa",190,0.989637,40,193,2,191,1,2,1,3,2,89,88,103,103,29
"2442",41,"[40]FIjHoIzxGtBkFDBjDtvzhpbKDeeJGHvnJHqvbGqa",186,0.989418,40,189,2,187,1,2,1,3,2,81,80,107,107,29
"2443",42,"[40]FIjHoIzxGtBkFDBjDtvzhpbKDeeJGHvnJHqvbGqa",208,0.990521,40,211,2,209,1,2,1,3,2,112,111,98,98,29
"2444",43,"[40]FIjHoIzxGtBkFDBjDtvzhpbKDeeJGHvnJHqvbGqa",209,0.990566,40,212,2,210,1,2,1,3,2,114,113,97,97,29
"2445",44,"[40]FIjHoIzxGtBkFDBjDtvzhpbKDeeJGHvnJHqvbGqa",189,0.989583,40,192,2,190,1,2,1,3,2,85,84,106,106,29
"2446",45,"[40]FIjHoIzxGtBkFDBjDtvzhpbKDeeJGHvnJHqvbGqa",212,0.990698,40,215,2,213,1,2,1,3,2,118,117,96,96,29
"2447",46,"[40]FIjHoIzxGtBkFDBjDtvzhpbKDeeJGHvnJHqvbGqa",192,0.989744,40,195,2,193,1,2,1,3,2,91,90,103,103,29
"2448",47,"[40]FIjHoIzxGtBkFDBjDtvzhpbKDeeJGHvnJHqvbGqa",209,0.990566,40,212,2,210,1,2,1,3,2,113,112,98,98,29
"2449",48,"[40]FIjHoIzxGtBkFDBjDtvzhpbKDeeJGHvnJHqvbGqa",204,0.990338,40,207,2,205,1,2,1,3,2,107,106,99,99,29
"2450",49,"[40]FIjHoIzxGtBkFDBjDtvzhpbKDeeJGHvnJHqvbGqa",193,0.989796,40,196,2,194,1,2,1,3,2,93,92,102,102,29
"2451",50,"[40]FIjHoIzxGtBkFDBjDtvzhpbKDeeJGHvnJHqvbGqa",196,0.98995,40,199,2,197,1,2,1,3,2,97,96,101,101,29
"2452",51,"[40]FIjHoIzxGtBkFDBjDtvzhpbKDeeJGHvnJHqvbGqa",209,0.990566,40,212,2,210,1,2,1,3,2,110,109,101,101,29
"2453",52,"[40]FIjHoIzxGtBkFDBjDtvzhpbKDeeJGHvnJHqvbGqa",198,0.99005,40,201,2,199,1,2,1,3,2,99,98,101,101,29
"2454",53,"[40]FIjHoIzxGtBkFDBjDtvzhpbKDeeJGHvnJHqvbGqa",192,0.989744,40,195,2,193,1,2,1,3,2,93,92,101,101,29
"2455",54,"[40]FIjHoIzxGtBkFDBjDtvzhpbKDeeJGHvnJHqvbGqa",192,0.989744,40,195,2,193,1,2,1,3,2,90,89,104,104,29
"2456",55,"[40]FIjHoIzxGtBkFDBjDtvzhpbKDeeJGHvnJHqvbGqa",216,0.990868,40,219,2,217,1,2,1,3,2,124,123,94,94,29
"2457",56,"[40]FIjHoIzxGtBkFDBjDtvzhpbKDeeJGHvnJHqvbGqa",196,0.98995,40,199,2,197,1,2,1,3,2,95,94,103,103,29
"2458",57,"[40]FIjHoIzxGtBkFDBjDtvzhpbKDeeJGHvnJHqvbGqa",190,0.989637,40,193,2,191,1,2,1,3,2,89,88,103,103,29
"2459",58,"[40]FIjHoIzxGtBkFDBjDtvzhpbKDeeJGHvnJHqvbGqa",202,0.990244,40,205,2,203,1,2,1,3,2,104,103,100,100,29
"2460",59,"[40]FIjHoIzxGtBkFDBjDtvzhpbKDeeJGHvnJHqvbGqa",192,0.989744,40,195,2,193,1,2,1,3,2,91,90,103,103,29
"2461",60,"[40]FIjHoIzxGtBkFDBjDtvzhpbKDeeJGHvnJHqvbGqa",193,0.989796,40,196,2,194,1,2,1,3,2,92,91,103,103,29
"2462",61,"[40]FIjHoIzxGtBkFDBjDtvzhpbKDeeJGHvnJHqvbGqa",220,0.991031,40,223,2,221,1,2,1,3,2,128,127,94,94,29
"2463",62,"[40]FIjHoIzxGtBkFDBjDtvzhpbKDeeJGHvnJHqvbGqa",211,0.990654,40,214,2,212,1,2,1,3,2,117,116,96,96,29
"2464",63,"[40]FIjHoIzxGtBkFDBjDtvzhpbKDeeJGHvnJHqvbGqa",204,0.990338,40,207,2,205,1,2,1,3,2,108,107,98,98,29
"2465",64,"[40]FIjHoIzxGtBkFDBjDtvzhpbKDeeJGHvnJHqvbGqa",195,0.989899,40,198,2,196,1,2,1,3,2,94,93,103,103,29
"2466",65,"[40]FIjHoIzxGtBkFDBjDtvzhpbKDeeJGHvnJHqvbGqa",187,0.989474,40,190,2,188,1,2,1,3,2,83,82,106,106,29
"2467",66,"[40]FIjHoIzxGtBkFDBjDtvzhpbKDeeJGHvnJHqvbGqa",184,0.989305,40,187,2,185,1,2,1,3,2,81,80,105,105,29
"2468",67,"[40]FIjHoIzxGtBkFDBjDtvzhpbKDeeJGHvnJHqvbGqa",208,0.990521,40,211,2,209,1,2,1,3,2,112,111,98,98,29
"2469",68,"[40]FIjHoIzxGtBkFDBjDtvzhpbKDeeJGHvnJHqvbGqa",194,0.989848,40,197,2,195,1,2,1,3,2,93,92,103,103,29
"2470",69,"[40]FIjHoIzxGtBkFDBjDtvzhpbKDeeJGHvnJHqvbGqa",194,0.989848,40,197,2,195,1,2,1,3,2,93,92,103,103,29
"2471",70,"[40]FIjHoIzxGtBkFDBjDtvzhpbKDeeJGHvnJHqvbGqa",198,0.99005,40,201,2,199,1,2,1,3,2,99,98,101,101,29
"2472",71,"[40]FIjHoIzxGtBkFDBjDtvzhpbKDeeJGHvnJHqvbGqa",216,0.990868,40,219,2,217,1,2,1,3,2,120,119,98,98,29
"2473",72,"[40]FIjHoIzxGtBkFDBjDtvzhpbKDeeJGHvnJHqvbGqa",191,0.989691,40,194,2,192,1,2,1,3,2,88,87,105,105,29
"2474",73,"[40]FIjHoIzxGtBkFDBjDtvzhpbKDeeJGHvnJHqvbGqa",197,0.99,40,200,2,198,1,2,1,3,2,97,96,102,102,29
"2475",74,"[40]FIjHoIzxGtBkFDBjDtvzhpbKDeeJGHvnJHqvbGqa",208,0.990521,40,211,2,209,1,2,1,3,2,112,111,98,98,29
"2476",75,"[40]FIjHoIzxGtBkFDBjDtvzhpbKDeeJGHvnJHqvbGqa",192,0.989744,40,195,2,193,1,2,1,3,2,92,91,102,102,29
"2477",76,"[40]FIjHoIzxGtBkFDBjDtvzhpbKDeeJGHvnJHqvbGqa",212,0.990698,40,215,2,213,1,2,1,3,2,120,119,94,94,29
"2478",77,"[40]FIjHoIzxGtBkFDBjDtvzhpbKDeeJGHvnJHqvbGqa",194,0.989848,40,197,2,195,1,2,1,3,2,91,90,105,105,29
"2479",78,"[40]FIjHoIzxGtBkFDBjDtvzhpbKDeeJGHvnJHqvbGqa",189,0.989583,40,192,2,190,1,2,1,3,2,85,84,106,106,29
"2480",79,"[40]FIjHoIzxGtBkFDBjDtvzhpbKDeeJGHvnJHqvbGqa",208,0.990521,40,211,2,209,1,2,1,3,2,112,111,98,98,29
"2481",80,"[40]FIjHoIzxGtBkFDBjDtvzhpbKDeeJGHvnJHqvbGqa",199,0.990099,40,202,2,200,1,2,1,3,2,98,97,103,103,29
"2482",81,"[40]FIjHoIzxGtBkFDBjDtvzhpbKDeeJGHvnJHqvbGqa",202,0.990244,40,205,2,203,1,2,1,3,2,107,106,97,97,29
"2483",82,"[40]FIjHoIzxGtBkFDBjDtvzhpbKDeeJGHvnJHqvbGqa",196,0.98995,40,199,2,197,1,2,1,3,2,96,95,102,102,29
"2484",83,"[40]FIjHoIzxGtBkFDBjDtvzhpbKDeeJGHvnJHqvbGqa",193,0.989796,40,196,2,194,1,2,1,3,2,91,90,104,104,29
"2485",84,"[40]FIjHoIzxGtBkFDBjDtvzhpbKDeeJGHvnJHqvbGqa",206,0.990431,40,209,2,207,1,2,1,3,2,112,111,96,96,29
"2486",85,"[40]FIjHoIzxGtBkFDBjDtvzhpbKDeeJGHvnJHqvbGqa",194,0.989848,40,197,2,195,1,2,1,3,2,93,92,103,103,29
"2487",86,"[40]FIjHoIzxGtBkFDBjDtvzhpbKDeeJGHvnJHqvbGqa",202,0.990244,40,205,2,203,1,2,1,3,2,104,103,100,100,29
"2488",87,"[40]FIjHoIzxGtBkFDBjDtvzhpbKDeeJGHvnJHqvbGqa",198,0.99005,40,201,2,199,1,2,1,3,2,101,100,99,99,29
"2489",88,"[40]FIjHoIzxGtBkFDBjDtvzhpbKDeeJGHvnJHqvbGqa",210,0.99061,40,213,2,211,1,2,1,3,2,117,116,95,95,29
"2490",89,"[40]FIjHoIzxGtBkFDBjDtvzhpbKDeeJGHvnJHqvbGqa",204,0.990338,40,207,2,205,1,2,1,3,2,106,105,100,100,29
"2491",90,"[40]FIjHoIzxGtBkFDBjDtvzhpbKDeeJGHvnJHqvbGqa",202,0.990244,40,205,2,203,1,2,1,3,2,103,102,101,101,29
"2492",91,"[40]FIjHoIzxGtBkFDBjDtvzhpbKDeeJGHvnJHqvbGqa",212,0.990698,40,215,2,213,1,2,1,3,2,117,116,97,97,29
"2493",92,"[40]FIjHoIzxGtBkFDBjDtvzhpbKDeeJGHvnJHqvbGqa",198,0.99005,40,201,2,199,1,2,1,3,2,99,98,101,101,29
"2494",93,"[40]FIjHoIzxGtBkFDBjDtvzhpbKDeeJGHvnJHqvbGqa",187,0.989474,40,190,2,188,1,2,1,3,2,83,82,106,106,29
"2495",94,"[40]FIjHoIzxGtBkFDBjDtvzhpbKDeeJGHvnJHqvbGqa",198,0.99005,40,201,2,199,1,2,1,3,2,98,97,102,102,29
"2496",95,"[40]FIjHoIzxGtBkFDBjDtvzhpbKDeeJGHvnJHqvbGqa",207,0.990476,40,210,2,208,1,2,1,3,2,110,109,99,99,29
"2497",96,"[40]FIjHoIzxGtBkFDBjDtvzhpbKDeeJGHvnJHqvbGqa",195,0.989899,40,198,2,196,1,2,1,3,2,96,95,101,101,29
"2498",97,"[40]FIjHoIzxGtBkFDBjDtvzhpbKDeeJGHvnJHqvbGqa",206,0.990431,40,209,2,207,1,2,1,3,2,109,108,99,99,29
"2499",98,"[40]FIjHoIzxGtBkFDBjDtvzhpbKDeeJGHvnJHqvbGqa",209,0.990566,40,212,2,210,1,2,1,3,2,114,113,97,97,29
"2500",99,"[40]FIjHoIzxGtBkFDBjDtvzhpbKDeeJGHvnJHqvbGqa",193,0.989796,40,196,2,194,1,2,1,3,2,93,92,102,102,29
"2501",0,"[34]uIzHoIEBlDknFqkiyebKpaGHsnJHqwbGqa",206,0.990431,34,209,2,207,1,2,1,3,2,107,106,101,101,30
"2502",1,"[34]uIzHoIEBlDknFqkiyebKpaGHsnJHqwbGqa",191,0.989691,34,194,2,192,1,2,1,3,2,90,89,103,103,30
"2503",2,"[34]uIzHoIEBlDknFqkiyebKpaGHsnJHqwbGqa",190,0.989637,34,193,2,191,1,2,1,3,2,87,86,105,105,30
"2504",3,"[34]uIzHoIEBlDknFqkiyebKpaGHsnJHqwbGqa",196,0.98995,34,199,2,197,1,2,1,3,2,92,91,106,106,30
"2505",4,"[34]uIzHoIEBlDknFqkiyebKpaGHsnJHqwbGqa",213,0.990741,34,216,2,214,1,2,1,3,2,115,114,100,100,30
"2506",5,"[34]uIzHoIEBlDknFqkiyebKpaGHsnJHqwbGqa",199,0.990099,34,202,2,200,1,2,1,3,2,100,99,101,101,30
"2507",6,"[34]uIzHoIEBlDknFqkiyebKpaGHsnJHqwbGqa",222,0.991111,34,225,2,223,1,2,1,3,2,130,129,94,94,30
"2508",7,"[34]uIzHoIEBlDknFqkiyebKpaGHsnJHqwbGqa",204,0.990338,34,207,2,205,1,2,1,3,2,104,103,102,102,30
"2509",8,"[34]uIzHoIEBlDknFqkiyebKpaGHsnJHqwbGqa",204,0.990338,34,207,2,205,1,2,1,3,2,105,104,101,101,30
"2510",9,"[34]uIzHoIEBlDknFqkiyebKpaGHsnJHqwbGqa",200,0.990148,34,203,2,201,1,2,1,3,2,102,101,100,100,30
"2511",10,"[34]uIzHoIEBlDknFqkiyebKpaGHsnJHqwbGqa",204,0.990338,34,207,2,205,1,2,1,3,2,107,106,99,99,30
"2512",11,"[34]uIzHoIEBlDknFqkiyebKpaGHsnJHqwbGqa",198,0.99005,34,201,2,199,1,2,1,3,2,98,97,102,102,30
"2513",12,"[34]uIzHoIEBlDknFqkiyebKpaGHsnJHqwbGqa",194,0.989848,34,197,2,195,1,2,1,3,2,92,91,104,104,30
"2514",13,"[34]uIzHoIEBlDknFqkiyebKpaGHsnJHqwbGqa",199,0.990099,34,202,2,200,1,2,1,3,2,99,98,102,102,30
"2515",14,"[34]uIzHoIEBlDknFqkiyebKpaGHsnJHqwbGqa",197,0.99,34,200,2,198,1,2,1,3,2,94,93,105,105,30
"2516",15,"[34]uIzHoIEBlDknFqkiyebKpaGHsnJHqwbGqa",200,0.990148,34,203,2,201,1,2,1,3,2,100,99,102,102,30
"2517",16,"[34]uIzHoIEBlDknFqkiyebKpaGHsnJHqwbGqa",201,0.990196,34,204,2,202,1,2,1,3,2,101,100,102,102,30
"2518",17,"[34]uIzHoIEBlDknFqkiyebKpaGHsnJHqwbGqa",194,0.989848,34,197,2,195,1,2,1,3,2,94,93,102,102,30
"2519",18,"[34]uIzHoIEBlDknFqkiyebKpaGHsnJHqwbGqa",215,0.990826,34,218,2,216,1,2,1,3,2,119,118,98,98,30
"2520",19,"[34]uIzHoIEBlDknFqkiyebKpaGHsnJHqwbGqa",215,0.990826,34,218,2,216,1,2,1,3,2,119,118,98,98,30
"2521",20,"[34]uIzHoIEBlDknFqkiyebKpaGHsnJHqwbGqa",212,0.990698,34,215,2,213,1,2,1,3,2,118,117,96,96,30
"2522",21,"[34]uIzHoIEBlDknFqkiyebKpaGHsnJHqwbGqa",196,0.98995,34,199,2,197,1,2,1,3,2,94,93,104,104,30
"2523",22,"[34]uIzHoIEBlDknFqkiyebKpaGHsnJHqwbGqa",216,0.990868,34,219,2,217,1,2,1,3,2,125,124,93,93,30
"2524",23,"[34]uIzHoIEBlDknFqkiyebKpaGHsnJHqwbGqa",214,0.990783,34,217,2,215,1,2,1,3,2,120,119,96,96,30
"2525",24,"[34]uIzHoIEBlDknFqkiyebKpaGHsnJHqwbGqa",211,0.990654,34,214,2,212,1,2,1,3,2,115,114,98,98,30
"2526",25,"[34]uIzHoIEBlDknFqkiyebKpaGHsnJHqwbGqa",192,0.989744,34,195,2,193,1,2,1,3,2,90,89,104,104,30
"2527",26,"[34]uIzHoIEBlDknFqkiyebKpaGHsnJHqwbGqa",203,0.990291,34,206,2,204,1,2,1,3,2,103,102,102,102,30
"2528",27,"[34]uIzHoIEBlDknFqkiyebKpaGHsnJHqwbGqa",200,0.990148,34,203,2,201,1,2,1,3,2,100,99,102,102,30
"2529",28,"[34]uIzHoIEBlDknFqkiyebKpaGHsnJHqwbGqa",198,0.99005,34,201,2,199,1,2,1,3,2,97,96,103,103,30
"2530",29,"[34]uIzHoIEBlDknFqkiyebKpaGHsnJHqwbGqa",202,0.990244,34,205,2,203,1,2,1,3,2,104,103,100,100,30
"2531",30,"[34]uIzHoIEBlDknFqkiyebKpaGHsnJHqwbGqa",199,0.990099,34,202,2,200,1,2,1,3,2,99,98,102,102,30
"2532",31,"[34]uIzHoIEBlDknFqkiyebKpaGHsnJHqwbGqa",210,0.99061,34,213,2,211,1,2,1,3,2,111,110,101,101,30
"2533",32,"[34]uIzHoIEBlDknFqkiyebKpaGHsnJHqwbGqa",196,0.98995,34,199,2,197,1,2,1,3,2,95,94,103,103,30
"2534",33,"[34]uIzHoIEBlDknFqkiyebKpaGHsnJHqwbGqa",216,0.990868,34,219,2,217,1,2,1,3,2,122,121,96,96,30
"2535",34,"[34]uIzHoIEBlDknFqkiyebKpaGHsnJHqwbGqa",211,0.990654,34,214,2,212,1,2,1,3,2,114,113,99,99,30
"2536",35,"[34]uIzHoIEBlDknFqkiyebKpaGHsnJHqwbGqa",205,0.990385,34,208,2,206,1,2,1,3,2,108,107,99,99,30
"2537",36,"[34]uIzHoIEBlDknFqkiyebKpaGHsnJHqwbGqa",200,0.990148,34,203,2,201,1,2,1,3,2,100,99,102,102,30
"2538",37,"[34]uIzHoIEBlDknFqkiyebKpaGHsnJHqwbGqa",198,0.99005,34,201,2,199,1,2,1,3,2,97,96,103,103,30
"2539",38,"[34]uIzHoIEBlDknFqkiyebKpaGHsnJHqwbGqa",206,0.990431,34,209,2,207,1,2,1,3,2,108,107,100,100,30
"2540",39,"[34]uIzHoIEBlDknFqkiyebKpaGHsnJHqwbGqa",194,0.989848,34,197,2,195,1,2,1,3,2,92,91,104,104,30
"2541",40,"[34]uIzHoIEBlDknFqkiyebKpaGHsnJHqwbGqa",214,0.990783,34,217,2,215,1,2,1,3,2,122,121,94,94,30
"2542",41,"[34]uIzHoIEBlDknFqkiyebKpaGHsnJHqwbGqa",209,0.990566,34,212,2,210,1,2,1,3,2,113,112,98,98,30
"2543",42,"[34]uIzHoIEBlDknFqkiyebKpaGHsnJHqwbGqa",201,0.990196,34,204,2,202,1,2,1,3,2,103,102,100,100,30
"2544",43,"[34]uIzHoIEBlDknFqkiyebKpaGHsnJHqwbGqa",193,0.989796,34,196,2,194,1,2,1,3,2,91,90,104,104,30
"2545",44,"[34]uIzHoIEBlDknFqkiyebKpaGHsnJHqwbGqa",211,0.990654,34,214,2,212,1,2,1,3,2,114,113,99,99,30
"2546",45,"[34]uIzHoIEBlDknFqkiyebKpaGHsnJHqwbGqa",200,0.990148,34,203,2,201,1,2,1,3,2,100,99,102,102,30
"2547",46,"[34]uIzHoIEBlDknFqkiyebKpaGHsnJHqwbGqa",213,0.990741,34,216,2,214,1,2,1,3,2,120,119,95,95,30
"2548",47,"[34]uIzHoIEBlDknFqkiyebKpaGHsnJHqwbGqa",196,0.98995,34,199,2,197,1,2,1,3,2,94,93,104,104,30
"2549",48,"[34]uIzHoIEBlDknFqkiyebKpaGHsnJHqwbGqa",212,0.990698,34,215,2,213,1,2,1,3,2,117,116,97,97,30
"2550",49,"[34]uIzHoIEBlDknFqkiyebKpaGHsnJHqwbGqa",207,0.990476,34,210,2,208,1,2,1,3,2,107,106,102,102,30
"2551",50,"[34]uIzHoIEBlDknFqkiyebKpaGHsnJHqwbGqa",207,0.990476,34,210,2,208,1,2,1,3,2,111,110,98,98,30
"2552",51,"[34]uIzHoIEBlDknFqkiyebKpaGHsnJHqwbGqa",207,0.990476,34,210,2,208,1,2,1,3,2,109,108,100,100,30
"2553",52,"[34]uIzHoIEBlDknFqkiyebKpaGHsnJHqwbGqa",204,0.990338,34,207,2,205,1,2,1,3,2,104,103,102,102,30
"2554",53,"[34]uIzHoIEBlDknFqkiyebKpaGHsnJHqwbGqa",207,0.990476,34,210,2,208,1,2,1,3,2,111,110,98,98,30
"2555",54,"[34]uIzHoIEBlDknFqkiyebKpaGHsnJHqwbGqa",195,0.989899,34,198,2,196,1,2,1,3,2,95,94,102,102,30
"2556",55,"[34]uIzHoIEBlDknFqkiyebKpaGHsnJHqwbGqa",203,0.990291,34,206,2,204,1,2,1,3,2,103,102,102,102,30
"2557",56,"[34]uIzHoIEBlDknFqkiyebKpaGHsnJHqwbGqa",203,0.990291,34,206,2,204,1,2,1,3,2,105,104,100,100,30
"2558",57,"[34]uIzHoIEBlDknFqkiyebKpaGHsnJHqwbGqa",200,0.990148,34,203,2,201,1,2,1,3,2,99,98,103,103,30
"2559",58,"[34]uIzHoIEBlDknFqkiyebKpaGHsnJHqwbGqa",200,0.990148,34,203,2,201,1,2,1,3,2,100,99,102,102,30
"2560",59,"[34]uIzHoIEBlDknFqkiyebKpaGHsnJHqwbGqa",194,0.989848,34,197,2,195,1,2,1,3,2,92,91,104,104,30
"2561",60,"[34]uIzHoIEBlDknFqkiyebKpaGHsnJHqwbGqa",188,0.989529,34,191,2,189,1,2,1,3,2,84,83,106,106,30
"2562",61,"[34]uIzHoIEBlDknFqkiyebKpaGHsnJHqwbGqa",200,0.990148,34,203,2,201,1,2,1,3,2,102,101,100,100,30
"2563",62,"[34]uIzHoIEBlDknFqkiyebKpaGHsnJHqwbGqa",212,0.990698,34,215,2,213,1,2,1,3,2,117,116,97,97,30
"2564",63,"[34]uIzHoIEBlDknFqkiyebKpaGHsnJHqwbGqa",205,0.990385,34,208,2,206,1,2,1,3,2,106,105,101,101,30
"2565",64,"[34]uIzHoIEBlDknFqkiyebKpaGHsnJHqwbGqa",206,0.990431,34,209,2,207,1,2,1,3,2,107,106,101,101,30
"2566",65,"[34]uIzHoIEBlDknFqkiyebKpaGHsnJHqwbGqa",195,0.989899,34,198,2,196,1,2,1,3,2,94,93,103,103,30
"2567",66,"[34]uIzHoIEBlDknFqkiyebKpaGHsnJHqwbGqa",192,0.989744,34,195,2,193,1,2,1,3,2,90,89,104,104,30
"2568",67,"[34]uIzHoIEBlDknFqkiyebKpaGHsnJHqwbGqa",197,0.99,34,200,2,198,1,2,1,3,2,96,95,103,103,30
"2569",68,"[34]uIzHoIEBlDknFqkiyebKpaGHsnJHqwbGqa",197,0.99,34,200,2,198,1,2,1,3,2,96,95,103,103,30
"2570",69,"[34]uIzHoIEBlDknFqkiyebKpaGHsnJHqwbGqa",184,0.989305,34,187,2,185,1,2,1,3,2,78,77,108,108,30
"2571",70,"[34]uIzHoIEBlDknFqkiyebKpaGHsnJHqwbGqa",209,0.990566,34,212,2,210,1,2,1,3,2,113,112,98,98,30
"2572",71,"[34]uIzHoIEBlDknFqkiyebKpaGHsnJHqwbGqa",207,0.990476,34,210,2,208,1,2,1,3,2,109,108,100,100,30
"2573",72,"[34]uIzHoIEBlDknFqkiyebKpaGHsnJHqwbGqa",201,0.990196,34,204,2,202,1,2,1,3,2,101,100,102,102,30
"2574",73,"[34]uIzHoIEBlDknFqkiyebKpaGHsnJHqwbGqa",210,0.99061,34,213,2,211,1,2,1,3,2,113,112,99,99,30
"2575",74,"[34]uIzHoIEBlDknFqkiyebKpaGHsnJHqwbGqa",209,0.990566,34,212,2,210,1,2,1,3,2,115,114,96,96,30
"2576",75,"[34]uIzHoIEBlDknFqkiyebKpaGHsnJHqwbGqa",198,0.99005,34,201,2,199,1,2,1,3,2,96,95,104,104,30
"2577",76,"[34]uIzHoIEBlDknFqkiyebKpaGHsnJHqwbGqa",205,0.990385,34,208,2,206,1,2,1,3,2,105,104,102,102,30
"2578",77,"[34]uIzHoIEBlDknFqkiyebKpaGHsnJHqwbGqa",198,0.99005,34,201,2,199,1,2,1,3,2,98,97,102,102,30
"2579",78,"[34]uIzHoIEBlDknFqkiyebKpaGHsnJHqwbGqa",203,0.990291,34,206,2,204,1,2,1,3,2,104,103,101,101,30
"2580",79,"[34]uIzHoIEBlDknFqkiyebKpaGHsnJHqwbGqa",206,0.990431,34,209,2,207,1,2,1,3,2,107,106,101,101,30
"2581",80,"[34]uIzHoIEBlDknFqkiyebKpaGHsnJHqwbGqa",201,0.990196,34,204,2,202,1,2,1,3,2,103,102,100,100,30
"2582",81,"[34]uIzHoIEBlDknFqkiyebKpaGHsnJHqwbGqa",193,0.989796,34,196,2,194,1,2,1,3,2,92,91,103,103,30
"2583",82,"[34]uIzHoIEBlDknFqkiyebKpaGHsnJHqwbGqa",199,0.990099,34,202,2,200,1,2,1,3,2,101,100,100,100,30
"2584",83,"[34]uIzHoIEBlDknFqkiyebKpaGHsnJHqwbGqa",206,0.990431,34,209,2,207,1,2,1,3,2,108,107,100,100,30
"2585",84,"[34]uIzHoIEBlDknFqkiyebKpaGHsnJHqwbGqa",196,0.98995,34,199,2,197,1,2,1,3,2,95,94,103,103,30
"2586",85,"[34]uIzHoIEBlDknFqkiyebKpaGHsnJHqwbGqa",218,0.99095,34,221,2,219,1,2,1,3,2,125,124,95,95,30
"2587",86,"[34]uIzHoIEBlDknFqkiyebKpaGHsnJHqwbGqa",201,0.990196,34,204,2,202,1,2,1,3,2,102,101,101,101,30
"2588",87,"[34]uIzHoIEBlDknFqkiyebKpaGHsnJHqwbGqa",209,0.990566,34,212,2,210,1,2,1,3,2,110,109,101,101,30
"2589",88,"[34]uIzHoIEBlDknFqkiyebKpaGHsnJHqwbGqa",200,0.990148,34,203,2,201,1,2,1,3,2,100,99,102,102,30
"2590",89,"[34]uIzHoIEBlDknFqkiyebKpaGHsnJHqwbGqa",209,0.990566,34,212,2,210,1,2,1,3,2,110,109,101,101,30
"2591",90,"[34]uIzHoIEBlDknFqkiyebKpaGHsnJHqwbGqa",213,0.990741,34,216,2,214,1,2,1,3,2,120,119,95,95,30
"2592",91,"[34]uIzHoIEBlDknFqkiyebKpaGHsnJHqwbGqa",201,0.990196,34,204,2,202,1,2,1,3,2,103,102,100,100,30
"2593",92,"[34]uIzHoIEBlDknFqkiyebKpaGHsnJHqwbGqa",195,0.989899,34,198,2,196,1,2,1,3,2,95,94,102,102,30
"2594",93,"[34]uIzHoIEBlDknFqkiyebKpaGHsnJHqwbGqa",204,0.990338,34,207,2,205,1,2,1,3,2,107,106,99,99,30
"2595",94,"[34]uIzHoIEBlDknFqkiyebKpaGHsnJHqwbGqa",210,0.99061,34,213,2,211,1,2,1,3,2,113,112,99,99,30
"2596",95,"[34]uIzHoIEBlDknFqkiyebKpaGHsnJHqwbGqa",194,0.989848,34,197,2,195,1,2,1,3,2,90,89,106,106,30
"2597",96,"[34]uIzHoIEBlDknFqkiyebKpaGHsnJHqwbGqa",209,0.990566,34,212,2,210,1,2,1,3,2,115,114,96,96,30
"2598",97,"[34]uIzHoIEBlDknFqkiyebKpaGHsnJHqwbGqa",196,0.98995,34,199,2,197,1,2,1,3,2,95,94,103,103,30
"2599",98,"[34]uIzHoIEBlDknFqkiyebKpaGHsnJHqwbGqa",201,0.990196,34,204,2,202,1,2,1,3,2,100,99,103,103,30
"2600",99,"[34]uIzHoIEBlDknFqkiyebKpaGHsnJHqwbGqa",201,0.990196,34,204,2,202,1,2,1,3,2,104,103,99,99,30
"2601",0,"[36]IHEoIGEBlDyuweJzpGbKDaebaHwnJHqwbGqa",211,0.990654,36,214,2,212,1,2,1,3,2,119,118,94,94,31
"2602",1,"[36]IHEoIGEBlDyuweJzpGbKDaebaHwnJHqwbGqa",210,0.99061,36,213,2,211,1,2,1,3,2,113,112,99,99,31
"2603",2,"[36]IHEoIGEBlDyuweJzpGbKDaebaHwnJHqwbGqa",204,0.990338,36,207,2,205,1,2,1,3,2,106,105,100,100,31
"2604",3,"[36]IHEoIGEBlDyuweJzpGbKDaebaHwnJHqwbGqa",194,0.989848,36,197,2,195,1,2,1,3,2,94,93,102,102,31
"2605",4,"[36]IHEoIGEBlDyuweJzpGbKDaebaHwnJHqwbGqa",195,0.989899,36,198,2,196,1,2,1,3,2,96,95,101,101,31
"2606",5,"[36]IHEoIGEBlDyuweJzpGbKDaebaHwnJHqwbGqa",211,0.990654,36,214,2,212,1,2,1,3,2,115,114,98,98,31
"2607",6,"[36]IHEoIGEBlDyuweJzpGbKDaebaHwnJHqwbGqa",197,0.99,36,200,2,198,1,2,1,3,2,95,94,104,104,31
"2608",7,"[36]IHEoIGEBlDyuweJzpGbKDaebaHwnJHqwbGqa",204,0.990338,36,207,2,205,1,2,1,3,2,108,107,98,98,31
"2609",8,"[36]IHEoIGEBlDyuweJzpGbKDaebaHwnJHqwbGqa",212,0.990698,36,215,2,213,1,2,1,3,2,120,119,94,94,31
"2610",9,"[36]IHEoIGEBlDyuweJzpGbKDaebaHwnJHqwbGqa",207,0.990476,36,210,2,208,1,2,1,3,2,109,108,100,100,31
"2611",10,"[36]IHEoIGEBlDyuweJzpGbKDaebaHwnJHqwbGqa",204,0.990338,36,207,2,205,1,2,1,3,2,106,105,100,100,31
"2612",11,"[36]IHEoIGEBlDyuweJzpGbKDaebaHwnJHqwbGqa",211,0.990654,36,214,2,212,1,2,1,3,2,117,116,96,96,31
"2613",12,"[36]IHEoIGEBlDyuweJzpGbKDaebaHwnJHqwbGqa",197,0.99,36,200,2,198,1,2,1,3,2,99,98,100,100,31
"2614",13,"[36]IHEoIGEBlDyuweJzpGbKDaebaHwnJHqwbGqa",194,0.989848,36,197,2,195,1,2,1,3,2,94,93,102,102,31
"2615",14,"[36]IHEoIGEBlDyuweJzpGbKDaebaHwnJHqwbGqa",206,0.990431,36,209,2,207,1,2,1,3,2,110,109,98,98,31
"2616",15,"[36]IHEoIGEBlDyuweJzpGbKDaebaHwnJHqwbGqa",202,0.990244,36,205,2,203,1,2,1,3,2,105,104,99,99,31
"2617",16,"[36]IHEoIGEBlDyuweJzpGbKDaebaHwnJHqwbGqa",207,0.990476,36,210,2,208,1,2,1,3,2,110,109,99,99,31
"2618",17,"[36]IHEoIGEBlDyuweJzpGbKDaebaHwnJHqwbGqa",213,0.990741,36,216,2,214,1,2,1,3,2,116,115,99,99,31
"2619",18,"[36]IHEoIGEBlDyuweJzpGbKDaebaHwnJHqwbGqa",204,0.990338,36,207,2,205,1,2,1,3,2,106,105,100,100,31
"2620",19,"[36]IHEoIGEBlDyuweJzpGbKDaebaHwnJHqwbGqa",193,0.989796,36,196,2,194,1,2,1,3,2,91,90,104,104,31
"2621",20,"[36]IHEoIGEBlDyuweJzpGbKDaebaHwnJHqwbGqa",198,0.99005,36,201,2,199,1,2,1,3,2,99,98,101,101,31
"2622",21,"[36]IHEoIGEBlDyuweJzpGbKDaebaHwnJHqwbGqa",192,0.989744,36,195,2,193,1,2,1,3,2,90,89,104,104,31
"2623",22,"[36]IHEoIGEBlDyuweJzpGbKDaebaHwnJHqwbGqa",201,0.990196,36,204,2,202,1,2,1,3,2,102,101,101,101,31
"2624",23,"[36]IHEoIGEBlDyuweJzpGbKDaebaHwnJHqwbGqa",196,0.98995,36,199,2,197,1,2,1,3,2,94,93,104,104,31
"2625",24,"[36]IHEoIGEBlDyuweJzpGbKDaebaHwnJHqwbGqa",204,0.990338,36,207,2,205,1,2,1,3,2,103,102,103,103,31
"2626",25,"[36]IHEoIGEBlDyuweJzpGbKDaebaHwnJHqwbGqa",200,0.990148,36,203,2,201,1,2,1,3,2,102,101,100,100,31
"2627",26,"[36]IHEoIGEBlDyuweJzpGbKDaebaHwnJHqwbGqa",196,0.98995,36,199,2,197,1,2,1,3,2,92,91,106,106,31
"2628",27,"[36]IHEoIGEBlDyuweJzpGbKDaebaHwnJHqwbGqa",215,0.990826,36,218,2,216,1,2,1,3,2,121,120,96,96,31
"2629",28,"[36]IHEoIGEBlDyuweJzpGbKDaebaHwnJHqwbGqa",190,0.989637,36,193,2,191,1,2,1,3,2,88,87,104,104,31
"2630",29,"[36]IHEoIGEBlDyuweJzpGbKDaebaHwnJHqwbGqa",209,0.990566,36,212,2,210,1,2,1,3,2,114,113,97,97,31
"2631",30,"[36]IHEoIGEBlDyuweJzpGbKDaebaHwnJHqwbGqa",188,0.989529,36,191,2,189,1,2,1,3,2,84,83,106,106,31
"2632",31,"[36]IHEoIGEBlDyuweJzpGbKDaebaHwnJHqwbGqa",193,0.989796,36,196,2,194,1,2,1,3,2,91,90,104,104,31
"2633",32,"[36]IHEoIGEBlDyuweJzpGbKDaebaHwnJHqwbGqa",190,0.989637,36,193,2,191,1,2,1,3,2,88,87,104,104,31
"2634",33,"[36]IHEoIGEBlDyuweJzpGbKDaebaHwnJHqwbGqa",211,0.990654,36,214,2,212,1,2,1,3,2,117,116,96,96,31
"2635",34,"[36]IHEoIGEBlDyuweJzpGbKDaebaHwnJHqwbGqa",190,0.989637,36,193,2,191,1,2,1,3,2,89,88,103,103,31
"2636",35,"[36]IHEoIGEBlDyuweJzpGbKDaebaHwnJHqwbGqa",196,0.98995,36,199,2,197,1,2,1,3,2,96,95,102,102,31
"2637",36,"[36]IHEoIGEBlDyuweJzpGbKDaebaHwnJHqwbGqa",193,0.989796,36,196,2,194,1,2,1,3,2,93,92,102,102,31
"2638",37,"[36]IHEoIGEBlDyuweJzpGbKDaebaHwnJHqwbGqa",203,0.990291,36,206,2,204,1,2,1,3,2,107,106,98,98,31
"2639",38,"[36]IHEoIGEBlDyuweJzpGbKDaebaHwnJHqwbGqa",200,0.990148,36,203,2,201,1,2,1,3,2,101,100,101,101,31
"2640",39,"[36]IHEoIGEBlDyuweJzpGbKDaebaHwnJHqwbGqa",208,0.990521,36,211,2,209,1,2,1,3,2,111,110,99,99,31
"2641",40,"[36]IHEoIGEBlDyuweJzpGbKDaebaHwnJHqwbGqa",204,0.990338,36,207,2,205,1,2,1,3,2,104,103,102,102,31
"2642",41,"[36]IHEoIGEBlDyuweJzpGbKDaebaHwnJHqwbGqa",211,0.990654,36,214,2,212,1,2,1,3,2,119,118,94,94,31
"2643",42,"[36]IHEoIGEBlDyuweJzpGbKDaebaHwnJHqwbGqa",199,0.990099,36,202,2,200,1,2,1,3,2,99,98,102,102,31
"2644",43,"[36]IHEoIGEBlDyuweJzpGbKDaebaHwnJHqwbGqa",197,0.99,36,200,2,198,1,2,1,3,2,96,95,103,103,31
"2645",44,"[36]IHEoIGEBlDyuweJzpGbKDaebaHwnJHqwbGqa",199,0.990099,36,202,2,200,1,2,1,3,2,100,99,101,101,31
"2646",45,"[36]IHEoIGEBlDyuweJzpGbKDaebaHwnJHqwbGqa",193,0.989796,36,196,2,194,1,2,1,3,2,94,93,101,101,31
"2647",46,"[36]IHEoIGEBlDyuweJzpGbKDaebaHwnJHqwbGqa",193,0.989796,36,196,2,194,1,2,1,3,2,92,91,103,103,31
"2648",47,"[36]IHEoIGEBlDyuweJzpGbKDaebaHwnJHqwbGqa",213,0.990741,36,216,2,214,1,2,1,3,2,118,117,97,97,31
"2649",48,"[36]IHEoIGEBlDyuweJzpGbKDaebaHwnJHqwbGqa",201,0.990196,36,204,2,202,1,2,1,3,2,101,100,102,102,31
"2650",49,"[36]IHEoIGEBlDyuweJzpGbKDaebaHwnJHqwbGqa",190,0.989637,36,193,2,191,1,2,1,3,2,86,85,106,106,31
"2651",50,"[36]IHEoIGEBlDyuweJzpGbKDaebaHwnJHqwbGqa",200,0.990148,36,203,2,201,1,2,1,3,2,103,102,99,99,31
"2652",51,"[36]IHEoIGEBlDyuweJzpGbKDaebaHwnJHqwbGqa",207,0.990476,36,210,2,208,1,2,1,3,2,111,110,98,98,31
"2653",52,"[36]IHEoIGEBlDyuweJzpGbKDaebaHwnJHqwbGqa",208,0.990521,36,211,2,209,1,2,1,3,2,110,109,100,100,31
"2654",53,"[36]IHEoIGEBlDyuweJzpGbKDaebaHwnJHqwbGqa",201,0.990196,36,204,2,202,1,2,1,3,2,103,102,100,100,31
"2655",54,"[36]IHEoIGEBlDyuweJzpGbKDaebaHwnJHqwbGqa",206,0.990431,36,209,2,207,1,2,1,3,2,110,109,98,98,31
"2656",55,"[36]IHEoIGEBlDyuweJzpGbKDaebaHwnJHqwbGqa",193,0.989796,36,196,2,194,1,2,1,3,2,90,89,105,105,31
"2657",56,"[36]IHEoIGEBlDyuweJzpGbKDaebaHwnJHqwbGqa",199,0.990099,36,202,2,200,1,2,1,3,2,97,96,104,104,31
"2658",57,"[36]IHEoIGEBlDyuweJzpGbKDaebaHwnJHqwbGqa",199,0.990099,36,202,2,200,1,2,1,3,2,99,98,102,102,31
"2659",58,"[36]IHEoIGEBlDyuweJzpGbKDaebaHwnJHqwbGqa",212,0.990698,36,215,2,213,1,2,1,3,2,119,118,95,95,31
"2660",59,"[36]IHEoIGEBlDyuweJzpGbKDaebaHwnJHqwbGqa",202,0.990244,36,205,2,203,1,2,1,3,2,102,101,102,102,31
"2661",60,"[36]IHEoIGEBlDyuweJzpGbKDaebaHwnJHqwbGqa",199,0.990099,36,202,2,200,1,2,1,3,2,99,98,102,102,31
"2662",61,"[36]IHEoIGEBlDyuweJzpGbKDaebaHwnJHqwbGqa",202,0.990244,36,205,2,203,1,2,1,3,2,104,103,100,100,31
"2663",62,"[36]IHEoIGEBlDyuweJzpGbKDaebaHwnJHqwbGqa",202,0.990244,36,205,2,203,1,2,1,3,2,106,105,98,98,31
"2664",63,"[36]IHEoIGEBlDyuweJzpGbKDaebaHwnJHqwbGqa",213,0.990741,36,216,2,214,1,2,1,3,2,119,118,96,96,31
"2665",64,"[36]IHEoIGEBlDyuweJzpGbKDaebaHwnJHqwbGqa",202,0.990244,36,205,2,203,1,2,1,3,2,106,105,98,98,31
"2666",65,"[36]IHEoIGEBlDyuweJzpGbKDaebaHwnJHqwbGqa",198,0.99005,36,201,2,199,1,2,1,3,2,97,96,103,103,31
"2667",66,"[36]IHEoIGEBlDyuweJzpGbKDaebaHwnJHqwbGqa",204,0.990338,36,207,2,205,1,2,1,3,2,106,105,100,100,31
"2668",67,"[36]IHEoIGEBlDyuweJzpGbKDaebaHwnJHqwbGqa",202,0.990244,36,205,2,203,1,2,1,3,2,104,103,100,100,31
"2669",68,"[36]IHEoIGEBlDyuweJzpGbKDaebaHwnJHqwbGqa",211,0.990654,36,214,2,212,1,2,1,3,2,116,115,97,97,31
"2670",69,"[36]IHEoIGEBlDyuweJzpGbKDaebaHwnJHqwbGqa",195,0.989899,36,198,2,196,1,2,1,3,2,93,92,104,104,31
"2671",70,"[36]IHEoIGEBlDyuweJzpGbKDaebaHwnJHqwbGqa",212,0.990698,36,215,2,213,1,2,1,3,2,118,117,96,96,31
"2672",71,"[36]IHEoIGEBlDyuweJzpGbKDaebaHwnJHqwbGqa",219,0.990991,36,222,2,220,1,2,1,3,2,127,126,94,94,31
"2673",72,"[36]IHEoIGEBlDyuweJzpGbKDaebaHwnJHqwbGqa",203,0.990291,36,206,2,204,1,2,1,3,2,106,105,99,99,31
"2674",73,"[36]IHEoIGEBlDyuweJzpGbKDaebaHwnJHqwbGqa",204,0.990338,36,207,2,205,1,2,1,3,2,105,104,101,101,31
"2675",74,"[36]IHEoIGEBlDyuweJzpGbKDaebaHwnJHqwbGqa",212,0.990698,36,215,2,213,1,2,1,3,2,117,116,97,97,31
"2676",75,"[36]IHEoIGEBlDyuweJzpGbKDaebaHwnJHqwbGqa",206,0.990431,36,209,2,207,1,2,1,3,2,109,108,99,99,31
"2677",76,"[36]IHEoIGEBlDyuweJzpGbKDaebaHwnJHqwbGqa",204,0.990338,36,207,2,205,1,2,1,3,2,106,105,100,100,31
"2678",77,"[36]IHEoIGEBlDyuweJzpGbKDaebaHwnJHqwbGqa",200,0.990148,36,203,2,201,1,2,1,3,2,102,101,100,100,31
"2679",78,"[36]IHEoIGEBlDyuweJzpGbKDaebaHwnJHqwbGqa",194,0.989848,36,197,2,195,1,2,1,3,2,92,91,104,104,31
"2680",79,"[36]IHEoIGEBlDyuweJzpGbKDaebaHwnJHqwbGqa",193,0.989796,36,196,2,194,1,2,1,3,2,91,90,104,104,31
"2681",80,"[36]IHEoIGEBlDyuweJzpGbKDaebaHwnJHqwbGqa",195,0.989899,36,198,2,196,1,2,1,3,2,93,92,104,104,31
"2682",81,"[36]IHEoIGEBlDyuweJzpGbKDaebaHwnJHqwbGqa",197,0.99,36,200,2,198,1,2,1,3,2,99,98,100,100,31
"2683",82,"[36]IHEoIGEBlDyuweJzpGbKDaebaHwnJHqwbGqa",201,0.990196,36,204,2,202,1,2,1,3,2,105,104,98,98,31
"2684",83,"[36]IHEoIGEBlDyuweJzpGbKDaebaHwnJHqwbGqa",193,0.989796,36,196,2,194,1,2,1,3,2,91,90,104,104,31
"2685",84,"[36]IHEoIGEBlDyuweJzpGbKDaebaHwnJHqwbGqa",200,0.990148,36,203,2,201,1,2,1,3,2,101,100,101,101,31
"2686",85,"[36]IHEoIGEBlDyuweJzpGbKDaebaHwnJHqwbGqa",204,0.990338,36,207,2,205,1,2,1,3,2,104,103,102,102,31
"2687",86,"[36]IHEoIGEBlDyuweJzpGbKDaebaHwnJHqwbGqa",192,0.989744,36,195,2,193,1,2,1,3,2,91,90,103,103,31
"2688",87,"[36]IHEoIGEBlDyuweJzpGbKDaebaHwnJHqwbGqa",179,0.989011,36,182,2,180,1,2,1,3,2,69,68,112,112,31
"2689",88,"[36]IHEoIGEBlDyuweJzpGbKDaebaHwnJHqwbGqa",218,0.99095,36,221,2,219,1,2,1,3,2,126,125,94,94,31
"2690",89,"[36]IHEoIGEBlDyuweJzpGbKDaebaHwnJHqwbGqa",208,0.990521,36,211,2,209,1,2,1,3,2,111,110,99,99,31
"2691",90,"[36]IHEoIGEBlDyuweJzpGbKDaebaHwnJHqwbGqa",199,0.990099,36,202,2,200,1,2,1,3,2,99,98,102,102,31
"2692",91,"[36]IHEoIGEBlDyuweJzpGbKDaebaHwnJHqwbGqa",199,0.990099,36,202,2,200,1,2,1,3,2,98,97,103,103,31
"2693",92,"[36]IHEoIGEBlDyuweJzpGbKDaebaHwnJHqwbGqa",205,0.990385,36,208,2,206,1,2,1,3,2,106,105,101,101,31
"2694",93,"[36]IHEoIGEBlDyuweJzpGbKDaebaHwnJHqwbGqa",190,0.989637,36,193,2,191,1,2,1,3,2,88,87,104,104,31
"2695",94,"[36]IHEoIGEBlDyuweJzpGbKDaebaHwnJHqwbGqa",194,0.989848,36,197,2,195,1,2,1,3,2,94,93,102,102,31
"2696",95,"[36]IHEoIGEBlDyuweJzpGbKDaebaHwnJHqwbGqa",210,0.99061,36,213,2,211,1,2,1,3,2,116,115,96,96,31
"2697",96,"[36]IHEoIGEBlDyuweJzpGbKDaebaHwnJHqwbGqa",203,0.990291,36,206,2,204,1,2,1,3,2,106,105,99,99,31
"2698",97,"[36]IHEoIGEBlDyuweJzpGbKDaebaHwnJHqwbGqa",207,0.990476,36,210,2,208,1,2,1,3,2,111,110,98,98,31
"2699",98,"[36]IHEoIGEBlDyuweJzpGbKDaebaHwnJHqwbGqa",211,0.990654,36,214,2,212,1,2,1,3,2,117,116,96,96,31
"2700",99,"[36]IHEoIGEBlDyuweJzpGbKDaebaHwnJHqwbGqa",206,0.990431,36,209,2,207,1,2,1,3,2,109,108,99,99,31
"2701",0,"[38]HItHoIEBlDCAoyvlcxBibKDeeKeHsnJHqvbGqa",207,0.990476,38,210,2,208,1,2,1,3,2,109,108,100,100,32
"2702",1,"[38]HItHoIEBlDCAoyvlcxBibKDeeKeHsnJHqvbGqa",192,0.989744,38,195,2,193,1,2,1,3,2,89,88,105,105,32
"2703",2,"[38]HItHoIEBlDCAoyvlcxBibKDeeKeHsnJHqvbGqa",216,0.990868,38,219,2,217,1,2,1,3,2,123,122,95,95,32
"2704",3,"[38]HItHoIEBlDCAoyvlcxBibKDeeKeHsnJHqvbGqa",199,0.990099,38,202,2,200,1,2,1,3,2,100,99,101,101,32
"2705",4,"[38]HItHoIEBlDCAoyvlcxBibKDeeKeHsnJHqvbGqa",200,0.990148,38,203,2,201,1,2,1,3,2,100,99,102,102,32
"2706",5,"[38]HItHoIEBlDCAoyvlcxBibKDeeKeHsnJHqvbGqa",191,0.989691,38,194,2,192,1,2,1,3,2,89,88,104,104,32
"2707",6,"[38]HItHoIEBlDCAoyvlcxBibKDeeKeHsnJHqvbGqa",205,0.990385,38,208,2,206,1,2,1,3,2,106,105,101,101,32
"2708",7,"[38]HItHoIEBlDCAoyvlcxBibKDeeKeHsnJHqvbGqa",194,0.989848,38,197,2,195,1,2,1,3,2,92,91,104,104,32
"2709",8,"[38]HItHoIEBlDCAoyvlcxBibKDeeKeHsnJHqvbGqa",197,0.99,38,200,2,198,1,2,1,3,2,94,93,105,105,32
"2710",9,"[38]HItHoIEBlDCAoyvlcxBibKDeeKeHsnJHqvbGqa",201,0.990196,38,204,2,202,1,2,1,3,2,101,100,102,102,32
"2711",10,"[38]HItHoIEBlDCAoyvlcxBibKDeeKeHsnJHqvbGqa",196,0.98995,38,199,2,197,1,2,1,3,2,96,95,102,102,32
"2712",11,"[38]HItHoIEBlDCAoyvlcxBibKDeeKeHsnJHqvbGqa",193,0.989796,38,196,2,194,1,2,1,3,2,89,88,106,106,32
"2713",12,"[38]HItHoIEBlDCAoyvlcxBibKDeeKeHsnJHqvbGqa",188,0.989529,38,191,2,189,1,2,1,3,2,85,84,105,105,32
"2714",13,"[38]HItHoIEBlDCAoyvlcxBibKDeeKeHsnJHqvbGqa",192,0.989744,38,195,2,193,1,2,1,3,2,90,89,104,104,32
"2715",14,"[38]HItHoIEBlDCAoyvlcxBibKDeeKeHsnJHqvbGqa",208,0.990521,38,211,2,209,1,2,1,3,2,113,112,97,97,32
"2716",15,"[38]HItHoIEBlDCAoyvlcxBibKDeeKeHsnJHqvbGqa",199,0.990099,38,202,2,200,1,2,1,3,2,100,99,101,101,32
"2717",16,"[38]HItHoIEBlDCAoyvlcxBibKDeeKeHsnJHqvbGqa",213,0.990741,38,216,2,214,1,2,1,3,2,120,119,95,95,32
"2718",17,"[38]HItHoIEBlDCAoyvlcxBibKDeeKeHsnJHqvbGqa",203,0.990291,38,206,2,204,1,2,1,3,2,105,104,100,100,32
"2719",18,"[38]HItHoIEBlDCAoyvlcxBibKDeeKeHsnJHqvbGqa",199,0.990099,38,202,2,200,1,2,1,3,2,100,99,101,101,32
"2720",19,"[38]HItHoIEBlDCAoyvlcxBibKDeeKeHsnJHqvbGqa",206,0.990431,38,209,2,207,1,2,1,3,2,109,108,99,99,32
"2721",20,"[38]HItHoIEBlDCAoyvlcxBibKDeeKeHsnJHqvbGqa",211,0.990654,38,214,2,212,1,2,1,3,2,117,116,96,96,32
"2722",21,"[38]HItHoIEBlDCAoyvlcxBibKDeeKeHsnJHqvbGqa",191,0.989691,38,194,2,192,1,2,1,3,2,88,87,105,105,32
"2723",22,"[38]HItHoIEBlDCAoyvlcxBibKDeeKeHsnJHqvbGqa",204,0.990338,38,207,2,205,1,2,1,3,2,105,104,101,101,32
"2724",23,"[38]HItHoIEBlDCAoyvlcxBibKDeeKeHsnJHqvbGqa",205,0.990385,38,208,2,206,1,2,1,3,2,108,107,99,99,32
"2725",24,"[38]HItHoIEBlDCAoyvlcxBibKDeeKeHsnJHqvbGqa",198,0.99005,38,201,2,199,1,2,1,3,2,97,96,103,103,32
"2726",25,"[38]HItHoIEBlDCAoyvlcxBibKDeeKeHsnJHqvbGqa",199,0.990099,38,202,2,200,1,2,1,3,2,99,98,102,102,32
"2727",26,"[38]HItHoIEBlDCAoyvlcxBibKDeeKeHsnJHqvbGqa",195,0.989899,38,198,2,196,1,2,1,3,2,92,91,105,105,32
"2728",27,"[38]HItHoIEBlDCAoyvlcxBibKDeeKeHsnJHqvbGqa",198,0.99005,38,201,2,199,1,2,1,3,2,95,94,105,105,32
"2729",28,"[38]HItHoIEBlDCAoyvlcxBibKDeeKeHsnJHqvbGqa",201,0.990196,38,204,2,202,1,2,1,3,2,103,102,100,100,32
"2730",29,"[38]HItHoIEBlDCAoyvlcxBibKDeeKeHsnJHqvbGqa",208,0.990521,38,211,2,209,1,2,1,3,2,110,109,100,100,32
"2731",30,"[38]HItHoIEBlDCAoyvlcxBibKDeeKeHsnJHqvbGqa",206,0.990431,38,209,2,207,1,2,1,3,2,108,107,100,100,32
"2732",31,"[38]HItHoIEBlDCAoyvlcxBibKDeeKeHsnJHqvbGqa",206,0.990431,38,209,2,207,1,2,1,3,2,107,106,101,101,32
"2733",32,"[38]HItHoIEBlDCAoyvlcxBibKDeeKeHsnJHqvbGqa",218,0.99095,38,221,2,219,1,2,1,3,2,122,121,98,98,32
"2734",33,"[38]HItHoIEBlDCAoyvlcxBibKDeeKeHsnJHqvbGqa",210,0.99061,38,213,2,211,1,2,1,3,2,113,112,99,99,32
"2735",34,"[38]HItHoIEBlDCAoyvlcxBibKDeeKeHsnJHqvbGqa",199,0.990099,38,202,2,200,1,2,1,3,2,100,99,101,101,32
"2736",35,"[38]HItHoIEBlDCAoyvlcxBibKDeeKeHsnJHqvbGqa",209,0.990566,38,212,2,210,1,2,1,3,2,112,111,99,99,32
"2737",36,"[38]HItHoIEBlDCAoyvlcxBibKDeeKeHsnJHqvbGqa",204,0.990338,38,207,2,205,1,2,1,3,2,109,108,97,97,32
"2738",37,"[38]HItHoIEBlDCAoyvlcxBibKDeeKeHsnJHqvbGqa",201,0.990196,38,204,2,202,1,2,1,3,2,100,99,103,103,32
"2739",38,"[38]HItHoIEBlDCAoyvlcxBibKDeeKeHsnJHqvbGqa",204,0.990338,38,207,2,205,1,2,1,3,2,106,105,100,100,32
"2740",39,"[38]HItHoIEBlDCAoyvlcxBibKDeeKeHsnJHqvbGqa",211,0.990654,38,214,2,212,1,2,1,3,2,116,115,97,97,32
"2741",40,"[38]HItHoIEBlDCAoyvlcxBibKDeeKeHsnJHqvbGqa",203,0.990291,38,206,2,204,1,2,1,3,2,107,106,98,98,32
"2742",41,"[38]HItHoIEBlDCAoyvlcxBibKDeeKeHsnJHqvbGqa",199,0.990099,38,202,2,200,1,2,1,3,2,99,98,102,102,32
"2743",42,"[38]HItHoIEBlDCAoyvlcxBibKDeeKeHsnJHqvbGqa",183,0.989247,38,186,2,184,1,2,1,3,2,78,77,107,107,32
"2744",43,"[38]HItHoIEBlDCAoyvlcxBibKDeeKeHsnJHqvbGqa",208,0.990521,38,211,2,209,1,2,1,3,2,109,108,101,101,32
"2745",44,"[38]HItHoIEBlDCAoyvlcxBibKDeeKeHsnJHqvbGqa",202,0.990244,38,205,2,203,1,2,1,3,2,103,102,101,101,32
"2746",45,"[38]HItHoIEBlDCAoyvlcxBibKDeeKeHsnJHqvbGqa",199,0.990099,38,202,2,200,1,2,1,3,2,99,98,102,102,32
"2747",46,"[38]HItHoIEBlDCAoyvlcxBibKDeeKeHsnJHqvbGqa",204,0.990338,38,207,2,205,1,2,1,3,2,106,105,100,100,32
"2748",47,"[38]HItHoIEBlDCAoyvlcxBibKDeeKeHsnJHqvbGqa",208,0.990521,38,211,2,209,1,2,1,3,2,110,109,100,100,32
"2749",48,"[38]HItHoIEBlDCAoyvlcxBibKDeeKeHsnJHqvbGqa",191,0.989691,38,194,2,192,1,2,1,3,2,88,87,105,105,32
"2750",49,"[38]HItHoIEBlDCAoyvlcxBibKDeeKeHsnJHqvbGqa",206,0.990431,38,209,2,207,1,2,1,3,2,107,106,101,101,32
"2751",50,"[38]HItHoIEBlDCAoyvlcxBibKDeeKeHsnJHqvbGqa",205,0.990385,38,208,2,206,1,2,1,3,2,108,107,99,99,32
"2752",51,"[38]HItHoIEBlDCAoyvlcxBibKDeeKeHsnJHqvbGqa",189,0.989583,38,192,2,190,1,2,1,3,2,86,85,105,105,32
"2753",52,"[38]HItHoIEBlDCAoyvlcxBibKDeeKeHsnJHqvbGqa",211,0.990654,38,214,2,212,1,2,1,3,2,117,116,96,96,32
"2754",53,"[38]HItHoIEBlDCAoyvlcxBibKDeeKeHsnJHqvbGqa",199,0.990099,38,202,2,200,1,2,1,3,2,100,99,101,101,32
"2755",54,"[38]HItHoIEBlDCAoyvlcxBibKDeeKeHsnJHqvbGqa",214,0.990783,38,217,2,215,1,2,1,3,2,119,118,97,97,32
"2756",55,"[38]HItHoIEBlDCAoyvlcxBibKDeeKeHsnJHqvbGqa",205,0.990385,38,208,2,206,1,2,1,3,2,108,107,99,99,32
"2757",56,"[38]HItHoIEBlDCAoyvlcxBibKDeeKeHsnJHqvbGqa",220,0.991031,38,223,2,221,1,2,1,3,2,130,129,92,92,32
"2758",57,"[38]HItHoIEBlDCAoyvlcxBibKDeeKeHsnJHqvbGqa",187,0.989474,38,190,2,188,1,2,1,3,2,83,82,106,106,32
"2759",58,"[38]HItHoIEBlDCAoyvlcxBibKDeeKeHsnJHqvbGqa",203,0.990291,38,206,2,204,1,2,1,3,2,105,104,100,100,32
"2760",59,"[38]HItHoIEBlDCAoyvlcxBibKDeeKeHsnJHqvbGqa",209,0.990566,38,212,2,210,1,2,1,3,2,112,111,99,99,32
"2761",60,"[38]HItHoIEBlDCAoyvlcxBibKDeeKeHsnJHqvbGqa",196,0.98995,38,199,2,197,1,2,1,3,2,91,90,107,107,32
"2762",61,"[38]HItHoIEBlDCAoyvlcxBibKDeeKeHsnJHqvbGqa",204,0.990338,38,207,2,205,1,2,1,3,2,104,103,102,102,32
"2763",62,"[38]HItHoIEBlDCAoyvlcxBibKDeeKeHsnJHqvbGqa",198,0.99005,38,201,2,199,1,2,1,3,2,97,96,103,103,32
"2764",63,"[38]HItHoIEBlDCAoyvlcxBibKDeeKeHsnJHqvbGqa",208,0.990521,38,211,2,209,1,2,1,3,2,114,113,96,96,32
"2765",64,"[38]HItHoIEBlDCAoyvlcxBibKDeeKeHsnJHqvbGqa",206,0.990431,38,209,2,207,1,2,1,3,2,109,108,99,99,32
"2766",65,"[38]HItHoIEBlDCAoyvlcxBibKDeeKeHsnJHqvbGqa",190,0.989637,38,193,2,191,1,2,1,3,2,86,85,106,106,32
"2767",66,"[38]HItHoIEBlDCAoyvlcxBibKDeeKeHsnJHqvbGqa",194,0.989848,38,197,2,195,1,2,1,3,2,92,91,104,104,32
"2768",67,"[38]HItHoIEBlDCAoyvlcxBibKDeeKeHsnJHqvbGqa",198,0.99005,38,201,2,199,1,2,1,3,2,98,97,102,102,32
"2769",68,"[38]HItHoIEBlDCAoyvlcxBibKDeeKeHsnJHqvbGqa",210,0.99061,38,213,2,211,1,2,1,3,2,113,112,99,99,32
"2770",69,"[38]HItHoIEBlDCAoyvlcxBibKDeeKeHsnJHqvbGqa",200,0.990148,38,203,2,201,1,2,1,3,2,101,100,101,101,32
"2771",70,"[38]HItHoIEBlDCAoyvlcxBibKDeeKeHsnJHqvbGqa",194,0.989848,38,197,2,195,1,2,1,3,2,90,89,106,106,32
"2772",71,"[38]HItHoIEBlDCAoyvlcxBibKDeeKeHsnJHqvbGqa",206,0.990431,38,209,2,207,1,2,1,3,2,108,107,100,100,32
"2773",72,"[38]HItHoIEBlDCAoyvlcxBibKDeeKeHsnJHqvbGqa",196,0.98995,38,199,2,197,1,2,1,3,2,94,93,104,104,32
"2774",73,"[38]HItHoIEBlDCAoyvlcxBibKDeeKeHsnJHqvbGqa",207,0.990476,38,210,2,208,1,2,1,3,2,110,109,99,99,32
"2775",74,"[38]HItHoIEBlDCAoyvlcxBibKDeeKeHsnJHqvbGqa",195,0.989899,38,198,2,196,1,2,1,3,2,95,94,102,102,32
"2776",75,"[38]HItHoIEBlDCAoyvlcxBibKDeeKeHsnJHqvbGqa",188,0.989529,38,191,2,189,1,2,1,3,2,84,83,106,106,32
"2777",76,"[38]HItHoIEBlDCAoyvlcxBibKDeeKeHsnJHqvbGqa",215,0.990826,38,218,2,216,1,2,1,3,2,120,119,97,97,32
"2778",77,"[38]HItHoIEBlDCAoyvlcxBibKDeeKeHsnJHqvbGqa",210,0.99061,38,213,2,211,1,2,1,3,2,115,114,97,97,32
"2779",78,"[38]HItHoIEBlDCAoyvlcxBibKDeeKeHsnJHqvbGqa",197,0.99,38,200,2,198,1,2,1,3,2,99,98,100,100,32
"2780",79,"[38]HItHoIEBlDCAoyvlcxBibKDeeKeHsnJHqvbGqa",191,0.989691,38,194,2,192,1,2,1,3,2,91,90,102,102,32
"2781",80,"[38]HItHoIEBlDCAoyvlcxBibKDeeKeHsnJHqvbGqa",191,0.989691,38,194,2,192,1,2,1,3,2,90,89,103,103,32
"2782",81,"[38]HItHoIEBlDCAoyvlcxBibKDeeKeHsnJHqvbGqa",191,0.989691,38,194,2,192,1,2,1,3,2,88,87,105,105,32
"2783",82,"[38]HItHoIEBlDCAoyvlcxBibKDeeKeHsnJHqvbGqa",200,0.990148,38,203,2,201,1,2,1,3,2,100,99,102,102,32
"2784",83,"[38]HItHoIEBlDCAoyvlcxBibKDeeKeHsnJHqvbGqa",198,0.99005,38,201,2,199,1,2,1,3,2,99,98,101,101,32
"2785",84,"[38]HItHoIEBlDCAoyvlcxBibKDeeKeHsnJHqvbGqa",209,0.990566,38,212,2,210,1,2,1,3,2,113,112,98,98,32
"2786",85,"[38]HItHoIEBlDCAoyvlcxBibKDeeKeHsnJHqvbGqa",192,0.989744,38,195,2,193,1,2,1,3,2,88,87,106,106,32
"2787",86,"[38]HItHoIEBlDCAoyvlcxBibKDeeKeHsnJHqvbGqa",209,0.990566,38,212,2,210,1,2,1,3,2,111,110,100,100,32
"2788",87,"[38]HItHoIEBlDCAoyvlcxBibKDeeKeHsnJHqvbGqa",217,0.990909,38,220,2,218,1,2,1,3,2,124,123,95,95,32
"2789",88,"[38]HItHoIEBlDCAoyvlcxBibKDeeKeHsnJHqvbGqa",207,0.990476,38,210,2,208,1,2,1,3,2,111,110,98,98,32
"2790",89,"[38]HItHoIEBlDCAoyvlcxBibKDeeKeHsnJHqvbGqa",195,0.989899,38,198,2,196,1,2,1,3,2,95,94,102,102,32
"2791",90,"[38]HItHoIEBlDCAoyvlcxBibKDeeKeHsnJHqvbGqa",219,0.990991,38,222,2,220,1,2,1,3,2,127,126,94,94,32
"2792",91,"[38]HItHoIEBlDCAoyvlcxBibKDeeKeHsnJHqvbGqa",188,0.989529,38,191,2,189,1,2,1,3,2,83,82,107,107,32
"2793",92,"[38]HItHoIEBlDCAoyvlcxBibKDeeKeHsnJHqvbGqa",194,0.989848,38,197,2,195,1,2,1,3,2,92,91,104,104,32
"2794",93,"[38]HItHoIEBlDCAoyvlcxBibKDeeKeHsnJHqvbGqa",198,0.99005,38,201,2,199,1,2,1,3,2,96,95,104,104,32
"2795",94,"[38]HItHoIEBlDCAoyvlcxBibKDeeKeHsnJHqvbGqa",212,0.990698,38,215,2,213,1,2,1,3,2,119,118,95,95,32
"2796",95,"[38]HItHoIEBlDCAoyvlcxBibKDeeKeHsnJHqvbGqa",203,0.990291,38,206,2,204,1,2,1,3,2,106,105,99,99,32
"2797",96,"[38]HItHoIEBlDCAoyvlcxBibKDeeKeHsnJHqvbGqa",212,0.990698,38,215,2,213,1,2,1,3,2,116,115,98,98,32
"2798",97,"[38]HItHoIEBlDCAoyvlcxBibKDeeKeHsnJHqvbGqa",203,0.990291,38,206,2,204,1,2,1,3,2,104,103,101,101,32
"2799",98,"[38]HItHoIEBlDCAoyvlcxBibKDeeKeHsnJHqvbGqa",217,0.990909,38,220,2,218,1,2,1,3,2,123,122,96,96,32
"2800",99,"[38]HItHoIEBlDCAoyvlcxBibKDeeKeHsnJHqvbGqa",202,0.990244,38,205,2,203,1,2,1,3,2,99,98,105,105,32
"2801",0,"[40]qIcHoIeudBkvDqEuIBFElEbKDaecuHwnJHqwbGqa",195,0.989899,40,198,2,196,1,2,1,3,2,95,94,102,102,33
"2802",1,"[40]qIcHoIeudBkvDqEuIBFElEbKDaecuHwnJHqwbGqa",203,0.990291,40,206,2,204,1,2,1,3,2,105,104,100,100,33
"2803",2,"[40]qIcHoIeudBkvDqEuIBFElEbKDaecuHwnJHqwbGqa",205,0.990385,40,208,2,206,1,2,1,3,2,108,107,99,99,33
"2804",3,"[40]qIcHoIeudBkvDqEuIBFElEbKDaecuHwnJHqwbGqa",204,0.990338,40,207,2,205,1,2,1,3,2,104,103,102,102,33
"2805",4,"[40]qIcHoIeudBkvDqEuIBFElEbKDaecuHwnJHqwbGqa",196,0.98995,40,199,2,197,1,2,1,3,2,95,94,103,103,33
"2806",5,"[40]qIcHoIeudBkvDqEuIBFElEbKDaecuHwnJHqwbGqa",197,0.99,40,200,2,198,1,2,1,3,2,96,95,103,103,33
"2807",6,"[40]qIcHoIeudBkvDqEuIBFElEbKDaecuHwnJHqwbGqa",212,0.990698,40,215,2,213,1,2,1,3,2,115,114,99,99,33
"2808",7,"[40]qIcHoIeudBkvDqEuIBFElEbKDaecuHwnJHqwbGqa",206,0.990431,40,209,2,207,1,2,1,3,2,112,111,96,96,33
"2809",8,"[40]qIcHoIeudBkvDqEuIBFElEbKDaecuHwnJHqwbGqa",202,0.990244,40,205,2,203,1,2,1,3,2,105,104,99,99,33
"2810",9,"[40]qIcHoIeudBkvDqEuIBFElEbKDaecuHwnJHqwbGqa",200,0.990148,40,203,2,201,1,2,1,3,2,103,102,99,99,33
"2811",10,"[40]qIcHoIeudBkvDqEuIBFElEbKDaecuHwnJHqwbGqa",226,0.991266,40,229,2,227,1,2,1,3,2,139,138,89,89,33
"2812",11,"[40]qIcHoIeudBkvDqEuIBFElEbKDaecuHwnJHqwbGqa",218,0.99095,40,221,2,219,1,2,1,3,2,126,125,94,94,33
"2813",12,"[40]qIcHoIeudBkvDqEuIBFElEbKDaecuHwnJHqwbGqa",203,0.990291,40,206,2,204,1,2,1,3,2,104,103,101,101,33
"2814",13,"[40]qIcHoIeudBkvDqEuIBFElEbKDaecuHwnJHqwbGqa",197,0.99,40,200,2,198,1,2,1,3,2,98,97,101,101,33
"2815",14,"[40]qIcHoIeudBkvDqEuIBFElEbKDaecuHwnJHqwbGqa",207,0.990476,40,210,2,208,1,2,1,3,2,111,110,98,98,33
"2816",15,"[40]qIcHoIeudBkvDqEuIBFElEbKDaecuHwnJHqwbGqa",208,0.990521,40,211,2,209,1,2,1,3,2,109,108,101,101,33
"2817",16,"[40]qIcHoIeudBkvDqEuIBFElEbKDaecuHwnJHqwbGqa",185,0.989362,40,188,2,186,1,2,1,3,2,80,79,107,107,33
"2818",17,"[40]qIcHoIeudBkvDqEuIBFElEbKDaecuHwnJHqwbGqa",198,0.99005,40,201,2,199,1,2,1,3,2,96,95,104,104,33
"2819",18,"[40]qIcHoIeudBkvDqEuIBFElEbKDaecuHwnJHqwbGqa",193,0.989796,40,196,2,194,1,2,1,3,2,94,93,101,101,33
"2820",19,"[40]qIcHoIeudBkvDqEuIBFElEbKDaecuHwnJHqwbGqa",215,0.990826,40,218,2,216,1,2,1,3,2,124,123,93,93,33
"2821",20,"[40]qIcHoIeudBkvDqEuIBFElEbKDaecuHwnJHqwbGqa",185,0.989362,40,188,2,186,1,2,1,3,2,82,81,105,105,33
"2822",21,"[40]qIcHoIeudBkvDqEuIBFElEbKDaecuHwnJHqwbGqa",206,0.990431,40,209,2,207,1,2,1,3,2,110,109,98,98,33
"2823",22,"[40]qIcHoIeudBkvDqEuIBFElEbKDaecuHwnJHqwbGqa",195,0.989899,40,198,2,196,1,2,1,3,2,94,93,103,103,33
"2824",23,"[40]qIcHoIeudBkvDqEuIBFElEbKDaecuHwnJHqwbGqa",209,0.990566,40,212,2,210,1,2,1,3,2,113,112,98,98,33
"2825",24,"[40]qIcHoIeudBkvDqEuIBFElEbKDaecuHwnJHqwbGqa",195,0.989899,40,198,2,196,1,2,1,3,2,97,96,100,100,33
"2826",25,"[40]qIcHoIeudBkvDqEuIBFElEbKDaecuHwnJHqwbGqa",195,0.989899,40,198,2,196,1,2,1,3,2,94,93,103,103,33
"2827",26,"[40]qIcHoIeudBkvDqEuIBFElEbKDaecuHwnJHqwbGqa",188,0.989529,40,191,2,189,1,2,1,3,2,87,86,103,103,33
"2828",27,"[40]qIcHoIeudBkvDqEuIBFElEbKDaecuHwnJHqwbGqa",212,0.990698,40,215,2,213,1,2,1,3,2,116,115,98,98,33
"2829",28,"[40]qIcHoIeudBkvDqEuIBFElEbKDaecuHwnJHqwbGqa",189,0.989583,40,192,2,190,1,2,1,3,2,87,86,104,104,33
"2830",29,"[40]qIcHoIeudBkvDqEuIBFElEbKDaecuHwnJHqwbGqa",201,0.990196,40,204,2,202,1,2,1,3,2,104,103,99,99,33
"2831",30,"[40]qIcHoIeudBkvDqEuIBFElEbKDaecuHwnJHqwbGqa",193,0.989796,40,196,2,194,1,2,1,3,2,92,91,103,103,33
"2832",31,"[40]qIcHoIeudBkvDqEuIBFElEbKDaecuHwnJHqwbGqa",188,0.989529,40,191,2,189,1,2,1,3,2,84,83,106,106,33
"2833",32,"[40]qIcHoIeudBkvDqEuIBFElEbKDaecuHwnJHqwbGqa",193,0.989796,40,196,2,194,1,2,1,3,2,91,90,104,104,33
"2834",33,"[40]qIcHoIeudBkvDqEuIBFElEbKDaecuHwnJHqwbGqa",207,0.990476,40,210,2,208,1,2,1,3,2,110,109,99,99,33
"2835",34,"[40]qIcHoIeudBkvDqEuIBFElEbKDaecuHwnJHqwbGqa",208,0.990521,40,211,2,209,1,2,1,3,2,111,110,99,99,33
"2836",35,"[40]qIcHoIeudBkvDqEuIBFElEbKDaecuHwnJHqwbGqa",204,0.990338,40,207,2,205,1,2,1,3,2,106,105,100,100,33
"2837",36,"[40]qIcHoIeudBkvDqEuIBFElEbKDaecuHwnJHqwbGqa",198,0.99005,40,201,2,199,1,2,1,3,2,94,93,106,106,33
"2838",37,"[40]qIcHoIeudBkvDqEuIBFElEbKDaecuHwnJHqwbGqa",201,0.990196,40,204,2,202,1,2,1,3,2,103,102,100,100,33
"2839",38,"[40]qIcHoIeudBkvDqEuIBFElEbKDaecuHwnJHqwbGqa",194,0.989848,40,197,2,195,1,2,1,3,2,93,92,103,103,33
"2840",39,"[40]qIcHoIeudBkvDqEuIBFElEbKDaecuHwnJHqwbGqa",197,0.99,40,200,2,198,1,2,1,3,2,96,95,103,103,33
"2841",40,"[40]qIcHoIeudBkvDqEuIBFElEbKDaecuHwnJHqwbGqa",202,0.990244,40,205,2,203,1,2,1,3,2,104,103,100,100,33
"2842",41,"[40]qIcHoIeudBkvDqEuIBFElEbKDaecuHwnJHqwbGqa",192,0.989744,40,195,2,193,1,2,1,3,2,89,88,105,105,33
"2843",42,"[40]qIcHoIeudBkvDqEuIBFElEbKDaecuHwnJHqwbGqa",208,0.990521,40,211,2,209,1,2,1,3,2,110,109,100,100,33
"2844",43,"[40]qIcHoIeudBkvDqEuIBFElEbKDaecuHwnJHqwbGqa",212,0.990698,40,215,2,213,1,2,1,3,2,119,118,95,95,33
"2845",44,"[40]qIcHoIeudBkvDqEuIBFElEbKDaecuHwnJHqwbGqa",196,0.98995,40,199,2,197,1,2,1,3,2,93,92,105,105,33
"2846",45,"[40]qIcHoIeudBkvDqEuIBFElEbKDaecuHwnJHqwbGqa",193,0.989796,40,196,2,194,1,2,1,3,2,92,91,103,103,33
"2847",46,"[40]qIcHoIeudBkvDqEuIBFElEbKDaecuHwnJHqwbGqa",202,0.990244,40,205,2,203,1,2,1,3,2,103,102,101,101,33
"2848",47,"[40]qIcHoIeudBkvDqEuIBFElEbKDaecuHwnJHqwbGqa",216,0.990868,40,219,2,217,1,2,1,3,2,122,121,96,96,33
"2849",48,"[40]qIcHoIeudBkvDqEuIBFElEbKDaecuHwnJHqwbGqa",197,0.99,40,200,2,198,1,2,1,3,2,94,93,105,105,33
"2850",49,"[40]qIcHoIeudBkvDqEuIBFElEbKDaecuHwnJHqwbGqa",213,0.990741,40,216,2,214,1,2,1,3,2,118,117,97,97,33
"2851",50,"[40]qIcHoIeudBkvDqEuIBFElEbKDaecuHwnJHqwbGqa",203,0.990291,40,206,2,204,1,2,1,3,2,106,105,99,99,33
"2852",51,"[40]qIcHoIeudBkvDqEuIBFElEbKDaecuHwnJHqwbGqa",217,0.990909,40,220,2,218,1,2,1,3,2,123,122,96,96,33
"2853",52,"[40]qIcHoIeudBkvDqEuIBFElEbKDaecuHwnJHqwbGqa",195,0.989899,40,198,2,196,1,2,1,3,2,94,93,103,103,33
"2854",53,"[40]qIcHoIeudBkvDqEuIBFElEbKDaecuHwnJHqwbGqa",202,0.990244,40,205,2,203,1,2,1,3,2,105,104,99,99,33
"2855",54,"[40]qIcHoIeudBkvDqEuIBFElEbKDaecuHwnJHqwbGqa",185,0.989362,40,188,2,186,1,2,1,3,2,79,78,108,108,33
"2856",55,"[40]qIcHoIeudBkvDqEuIBFElEbKDaecuHwnJHqwbGqa",202,0.990244,40,205,2,203,1,2,1,3,2,106,105,98,98,33
"2857",56,"[40]qIcHoIeudBkvDqEuIBFElEbKDaecuHwnJHqwbGqa",199,0.990099,40,202,2,200,1,2,1,3,2,99,98,102,102,33
"2858",57,"[40]qIcHoIeudBkvDqEuIBFElEbKDaecuHwnJHqwbGqa",202,0.990244,40,205,2,203,1,2,1,3,2,104,103,100,100,33
"2859",58,"[40]qIcHoIeudBkvDqEuIBFElEbKDaecuHwnJHqwbGqa",219,0.990991,40,222,2,220,1,2,1,3,2,125,124,96,96,33
"2860",59,"[40]qIcHoIeudBkvDqEuIBFElEbKDaecuHwnJHqwbGqa",206,0.990431,40,209,2,207,1,2,1,3,2,110,109,98,98,33
"2861",60,"[40]qIcHoIeudBkvDqEuIBFElEbKDaecuHwnJHqwbGqa",202,0.990244,40,205,2,203,1,2,1,3,2,103,102,101,101,33
"2862",61,"[40]qIcHoIeudBkvDqEuIBFElEbKDaecuHwnJHqwbGqa",202,0.990244,40,205,2,203,1,2,1,3,2,106,105,98,98,33
"2863",62,"[40]qIcHoIeudBkvDqEuIBFElEbKDaecuHwnJHqwbGqa",209,0.990566,40,212,2,210,1,2,1,3,2,115,114,96,96,33
"2864",63,"[40]qIcHoIeudBkvDqEuIBFElEbKDaecuHwnJHqwbGqa",205,0.990385,40,208,2,206,1,2,1,3,2,107,106,100,100,33
"2865",64,"[40]qIcHoIeudBkvDqEuIBFElEbKDaecuHwnJHqwbGqa",218,0.99095,40,221,2,219,1,2,1,3,2,127,126,93,93,33
"2866",65,"[40]qIcHoIeudBkvDqEuIBFElEbKDaecuHwnJHqwbGqa",204,0.990338,40,207,2,205,1,2,1,3,2,108,107,98,98,33
"2867",66,"[40]qIcHoIeudBkvDqEuIBFElEbKDaecuHwnJHqwbGqa",176,0.988827,40,179,2,177,1,2,1,3,2,67,66,111,111,33
"2868",67,"[40]qIcHoIeudBkvDqEuIBFElEbKDaecuHwnJHqwbGqa",215,0.990826,40,218,2,216,1,2,1,3,2,124,123,93,93,33
"2869",68,"[40]qIcHoIeudBkvDqEuIBFElEbKDaecuHwnJHqwbGqa",191,0.989691,40,194,2,192,1,2,1,3,2,90,89,103,103,33
"2870",69,"[40]qIcHoIeudBkvDqEuIBFElEbKDaecuHwnJHqwbGqa",209,0.990566,40,212,2,210,1,2,1,3,2,115,114,96,96,33
"2871",70,"[40]qIcHoIeudBkvDqEuIBFElEbKDaecuHwnJHqwbGqa",215,0.990826,40,218,2,216,1,2,1,3,2,118,117,99,99,33
"2872",71,"[40]qIcHoIeudBkvDqEuIBFElEbKDaecuHwnJHqwbGqa",187,0.989474,40,190,2,188,1,2,1,3,2,83,82,106,106,33
"2873",72,"[40]qIcHoIeudBkvDqEuIBFElEbKDaecuHwnJHqwbGqa",205,0.990385,40,208,2,206,1,2,1,3,2,109,108,98,98,33
"2874",73,"[40]qIcHoIeudBkvDqEuIBFElEbKDaecuHwnJHqwbGqa",188,0.989529,40,191,2,189,1,2,1,3,2,86,85,104,104,33
"2875",74,"[40]qIcHoIeudBkvDqEuIBFElEbKDaecuHwnJHqwbGqa",192,0.989744,40,195,2,193,1,2,1,3,2,91,90,103,103,33
"2876",75,"[40]qIcHoIeudBkvDqEuIBFElEbKDaecuHwnJHqwbGqa",205,0.990385,40,208,2,206,1,2,1,3,2,107,106,100,100,33
"2877",76,"[40]qIcHoIeudBkvDqEuIBFElEbKDaecuHwnJHqwbGqa",197,0.99,40,200,2,198,1,2,1,3,2,96,95,103,103,33
"2878",77,"[40]qIcHoIeudBkvDqEuIBFElEbKDaecuHwnJHqwbGqa",192,0.989744,40,195,2,193,1,2,1,3,2,87,86,107,107,33
"2879",78,"[40]qIcHoIeudBkvDqEuIBFElEbKDaecuHwnJHqwbGqa",214,0.990783,40,217,2,215,1,2,1,3,2,121,120,95,95,33
"2880",79,"[40]qIcHoIeudBkvDqEuIBFElEbKDaecuHwnJHqwbGqa",199,0.990099,40,202,2,200,1,2,1,3,2,99,98,102,102,33
"2881",80,"[40]qIcHoIeudBkvDqEuIBFElEbKDaecuHwnJHqwbGqa",189,0.989583,40,192,2,190,1,2,1,3,2,85,84,106,106,33
"2882",81,"[40]qIcHoIeudBkvDqEuIBFElEbKDaecuHwnJHqwbGqa",195,0.989899,40,198,2,196,1,2,1,3,2,94,93,103,103,33
"2883",82,"[40]qIcHoIeudBkvDqEuIBFElEbKDaecuHwnJHqwbGqa",209,0.990566,40,212,2,210,1,2,1,3,2,111,110,100,100,33
"2884",83,"[40]qIcHoIeudBkvDqEuIBFElEbKDaecuHwnJHqwbGqa",193,0.989796,40,196,2,194,1,2,1,3,2,88,87,107,107,33
"2885",84,"[40]qIcHoIeudBkvDqEuIBFElEbKDaecuHwnJHqwbGqa",191,0.989691,40,194,2,192,1,2,1,3,2,87,86,106,106,33
"2886",85,"[40]qIcHoIeudBkvDqEuIBFElEbKDaecuHwnJHqwbGqa",206,0.990431,40,209,2,207,1,2,1,3,2,109,108,99,99,33
"2887",86,"[40]qIcHoIeudBkvDqEuIBFElEbKDaecuHwnJHqwbGqa",192,0.989744,40,195,2,193,1,2,1,3,2,88,87,106,106,33
"2888",87,"[40]qIcHoIeudBkvDqEuIBFElEbKDaecuHwnJHqwbGqa",213,0.990741,40,216,2,214,1,2,1,3,2,117,116,98,98,33
"2889",88,"[40]qIcHoIeudBkvDqEuIBFElEbKDaecuHwnJHqwbGqa",190,0.989637,40,193,2,191,1,2,1,3,2,86,85,106,106,33
"2890",89,"[40]qIcHoIeudBkvDqEuIBFElEbKDaecuHwnJHqwbGqa",199,0.990099,40,202,2,200,1,2,1,3,2,101,100,100,100,33
"2891",90,"[40]qIcHoIeudBkvDqEuIBFElEbKDaecuHwnJHqwbGqa",203,0.990291,40,206,2,204,1,2,1,3,2,106,105,99,99,33
"2892",91,"[40]qIcHoIeudBkvDqEuIBFElEbKDaecuHwnJHqwbGqa",204,0.990338,40,207,2,205,1,2,1,3,2,107,106,99,99,33
"2893",92,"[40]qIcHoIeudBkvDqEuIBFElEbKDaecuHwnJHqwbGqa",216,0.990868,40,219,2,217,1,2,1,3,2,122,121,96,96,33
"2894",93,"[40]qIcHoIeudBkvDqEuIBFElEbKDaecuHwnJHqwbGqa",184,0.989305,40,187,2,185,1,2,1,3,2,82,81,104,104,33
"2895",94,"[40]qIcHoIeudBkvDqEuIBFElEbKDaecuHwnJHqwbGqa",197,0.99,40,200,2,198,1,2,1,3,2,95,94,104,104,33
"2896",95,"[40]qIcHoIeudBkvDqEuIBFElEbKDaecuHwnJHqwbGqa",206,0.990431,40,209,2,207,1,2,1,3,2,110,109,98,98,33
"2897",96,"[40]qIcHoIeudBkvDqEuIBFElEbKDaecuHwnJHqwbGqa",200,0.990148,40,203,2,201,1,2,1,3,2,101,100,101,101,33
"2898",97,"[40]qIcHoIeudBkvDqEuIBFElEbKDaecuHwnJHqwbGqa",205,0.990385,40,208,2,206,1,2,1,3,2,108,107,99,99,33
"2899",98,"[40]qIcHoIeudBkvDqEuIBFElEbKDaecuHwnJHqwbGqa",220,0.991031,40,223,2,221,1,2,1,3,2,128,127,94,94,33
"2900",99,"[40]qIcHoIeudBkvDqEuIBFElEbKDaecuHwnJHqwbGqa",189,0.989583,40,192,2,190,1,2,1,3,2,84,83,107,107,33
"2901",0,"[38]yIisHoIweBquzkdwwlFDFJbKpeHHtnJHqwbGqa",214,0.990783,38,217,2,215,1,2,1,3,2,117,116,99,99,34
"2902",1,"[38]yIisHoIweBquzkdwwlFDFJbKpeHHtnJHqwbGqa",214,0.990783,38,217,2,215,1,2,1,3,2,122,121,94,94,34
"2903",2,"[38]yIisHoIweBquzkdwwlFDFJbKpeHHtnJHqwbGqa",204,0.990338,38,207,2,205,1,2,1,3,2,107,106,99,99,34
"2904",3,"[38]yIisHoIweBquzkdwwlFDFJbKpeHHtnJHqwbGqa",194,0.989848,38,197,2,195,1,2,1,3,2,91,90,105,105,34
"2905",4,"[38]yIisHoIweBquzkdwwlFDFJbKpeHHtnJHqwbGqa",204,0.990338,38,207,2,205,1,2,1,3,2,107,106,99,99,34
"2906",5,"[38]yIisHoIweBquzkdwwlFDFJbKpeHHtnJHqwbGqa",182,0.989189,38,185,2,183,1,2,1,3,2,76,75,108,108,34
"2907",6,"[38]yIisHoIweBquzkdwwlFDFJbKpeHHtnJHqwbGqa",197,0.99,38,200,2,198,1,2,1,3,2,99,98,100,100,34
"2908",7,"[38]yIisHoIweBquzkdwwlFDFJbKpeHHtnJHqwbGqa",206,0.990431,38,209,2,207,1,2,1,3,2,109,108,99,99,34
"2909",8,"[38]yIisHoIweBquzkdwwlFDFJbKpeHHtnJHqwbGqa",210,0.99061,38,213,2,211,1,2,1,3,2,115,114,97,97,34
"2910",9,"[38]yIisHoIweBquzkdwwlFDFJbKpeHHtnJHqwbGqa",189,0.989583,38,192,2,190,1,2,1,3,2,89,88,102,102,34
"2911",10,"[38]yIisHoIweBquzkdwwlFDFJbKpeHHtnJHqwbGqa",200,0.990148,38,203,2,201,1,2,1,3,2,101,100,101,101,34
"2912",11,"[38]yIisHoIweBquzkdwwlFDFJbKpeHHtnJHqwbGqa",203,0.990291,38,206,2,204,1,2,1,3,2,103,102,102,102,34
"2913",12,"[38]yIisHoIweBquzkdwwlFDFJbKpeHHtnJHqwbGqa",193,0.989796,38,196,2,194,1,2,1,3,2,93,92,102,102,34
"2914",13,"[38]yIisHoIweBquzkdwwlFDFJbKpeHHtnJHqwbGqa",207,0.990476,38,210,2,208,1,2,1,3,2,111,110,98,98,34
"2915",14,"[38]yIisHoIweBquzkdwwlFDFJbKpeHHtnJHqwbGqa",204,0.990338,38,207,2,205,1,2,1,3,2,104,103,102,102,34
"2916",15,"[38]yIisHoIweBquzkdwwlFDFJbKpeHHtnJHqwbGqa",199,0.990099,38,202,2,200,1,2,1,3,2,101,100,100,100,34
"2917",16,"[38]yIisHoIweBquzkdwwlFDFJbKpeHHtnJHqwbGqa",202,0.990244,38,205,2,203,1,2,1,3,2,105,104,99,99,34
"2918",17,"[38]yIisHoIweBquzkdwwlFDFJbKpeHHtnJHqwbGqa",197,0.99,38,200,2,198,1,2,1,3,2,98,97,101,101,34
"2919",18,"[38]yIisHoIweBquzkdwwlFDFJbKpeHHtnJHqwbGqa",190,0.989637,38,193,2,191,1,2,1,3,2,88,87,104,104,34
"2920",19,"[38]yIisHoIweBquzkdwwlFDFJbKpeHHtnJHqwbGqa",205,0.990385,38,208,2,206,1,2,1,3,2,106,105,101,101,34
"2921",20,"[38]yIisHoIweBquzkdwwlFDFJbKpeHHtnJHqwbGqa",198,0.99005,38,201,2,199,1,2,1,3,2,100,99,100,100,34
"2922",21,"[38]yIisHoIweBquzkdwwlFDFJbKpeHHtnJHqwbGqa",190,0.989637,38,193,2,191,1,2,1,3,2,85,84,107,107,34
"2923",22,"[38]yIisHoIweBquzkdwwlFDFJbKpeHHtnJHqwbGqa",198,0.99005,38,201,2,199,1,2,1,3,2,99,98,101,101,34
"2924",23,"[38]yIisHoIweBquzkdwwlFDFJbKpeHHtnJHqwbGqa",194,0.989848,38,197,2,195,1,2,1,3,2,93,92,103,103,34
"2925",24,"[38]yIisHoIweBquzkdwwlFDFJbKpeHHtnJHqwbGqa",184,0.989305,38,187,2,185,1,2,1,3,2,80,79,106,106,34
"2926",25,"[38]yIisHoIweBquzkdwwlFDFJbKpeHHtnJHqwbGqa",190,0.989637,38,193,2,191,1,2,1,3,2,87,86,105,105,34
"2927",26,"[38]yIisHoIweBquzkdwwlFDFJbKpeHHtnJHqwbGqa",214,0.990783,38,217,2,215,1,2,1,3,2,121,120,95,95,34
"2928",27,"[38]yIisHoIweBquzkdwwlFDFJbKpeHHtnJHqwbGqa",205,0.990385,38,208,2,206,1,2,1,3,2,110,109,97,97,34
"2929",28,"[38]yIisHoIweBquzkdwwlFDFJbKpeHHtnJHqwbGqa",200,0.990148,38,203,2,201,1,2,1,3,2,103,102,99,99,34
"2930",29,"[38]yIisHoIweBquzkdwwlFDFJbKpeHHtnJHqwbGqa",201,0.990196,38,204,2,202,1,2,1,3,2,102,101,101,101,34
"2931",30,"[38]yIisHoIweBquzkdwwlFDFJbKpeHHtnJHqwbGqa",207,0.990476,38,210,2,208,1,2,1,3,2,114,113,95,95,34
"2932",31,"[38]yIisHoIweBquzkdwwlFDFJbKpeHHtnJHqwbGqa",198,0.99005,38,201,2,199,1,2,1,3,2,96,95,104,104,34
"2933",32,"[38]yIisHoIweBquzkdwwlFDFJbKpeHHtnJHqwbGqa",212,0.990698,38,215,2,213,1,2,1,3,2,116,115,98,98,34
"2934",33,"[38]yIisHoIweBquzkdwwlFDFJbKpeHHtnJHqwbGqa",206,0.990431,38,209,2,207,1,2,1,3,2,109,108,99,99,34
"2935",34,"[38]yIisHoIweBquzkdwwlFDFJbKpeHHtnJHqwbGqa",218,0.99095,38,221,2,219,1,2,1,3,2,125,124,95,95,34
"2936",35,"[38]yIisHoIweBquzkdwwlFDFJbKpeHHtnJHqwbGqa",216,0.990868,38,219,2,217,1,2,1,3,2,124,123,94,94,34
"2937",36,"[38]yIisHoIweBquzkdwwlFDFJbKpeHHtnJHqwbGqa",195,0.989899,38,198,2,196,1,2,1,3,2,92,91,105,105,34
"2938",37,"[38]yIisHoIweBquzkdwwlFDFJbKpeHHtnJHqwbGqa",196,0.98995,38,199,2,197,1,2,1,3,2,94,93,104,104,34
"2939",38,"[38]yIisHoIweBquzkdwwlFDFJbKpeHHtnJHqwbGqa",207,0.990476,38,210,2,208,1,2,1,3,2,110,109,99,99,34
"2940",39,"[38]yIisHoIweBquzkdwwlFDFJbKpeHHtnJHqwbGqa",209,0.990566,38,212,2,210,1,2,1,3,2,114,113,97,97,34
"2941",40,"[38]yIisHoIweBquzkdwwlFDFJbKpeHHtnJHqwbGqa",205,0.990385,38,208,2,206,1,2,1,3,2,110,109,97,97,34
"2942",41,"[38]yIisHoIweBquzkdwwlFDFJbKpeHHtnJHqwbGqa",201,0.990196,38,204,2,202,1,2,1,3,2,102,101,101,101,34
"2943",42,"[38]yIisHoIweBquzkdwwlFDFJbKpeHHtnJHqwbGqa",214,0.990783,38,217,2,215,1,2,1,3,2,122,121,94,94,34
"2944",43,"[38]yIisHoIweBquzkdwwlFDFJbKpeHHtnJHqwbGqa",207,0.990476,38,210,2,208,1,2,1,3,2,113,112,96,96,34
"2945",44,"[38]yIisHoIweBquzkdwwlFDFJbKpeHHtnJHqwbGqa",211,0.990654,38,214,2,212,1,2,1,3,2,117,116,96,96,34
"2946",45,"[38]yIisHoIweBquzkdwwlFDFJbKpeHHtnJHqwbGqa",199,0.990099,38,202,2,200,1,2,1,3,2,98,97,103,103,34
"2947",46,"[38]yIisHoIweBquzkdwwlFDFJbKpeHHtnJHqwbGqa",191,0.989691,38,194,2,192,1,2,1,3,2,88,87,105,105,34
"2948",47,"[38]yIisHoIweBquzkdwwlFDFJbKpeHHtnJHqwbGqa",219,0.990991,38,222,2,220,1,2,1,3,2,127,126,94,94,34
"2949",48,"[38]yIisHoIweBquzkdwwlFDFJbKpeHHtnJHqwbGqa",219,0.990991,38,222,2,220,1,2,1,3,2,125,124,96,96,34
"2950",49,"[38]yIisHoIweBquzkdwwlFDFJbKpeHHtnJHqwbGqa",202,0.990244,38,205,2,203,1,2,1,3,2,104,103,100,100,34
"2951",50,"[38]yIisHoIweBquzkdwwlFDFJbKpeHHtnJHqwbGqa",188,0.989529,38,191,2,189,1,2,1,3,2,85,84,105,105,34
"2952",51,"[38]yIisHoIweBquzkdwwlFDFJbKpeHHtnJHqwbGqa",197,0.99,38,200,2,198,1,2,1,3,2,96,95,103,103,34
"2953",52,"[38]yIisHoIweBquzkdwwlFDFJbKpeHHtnJHqwbGqa",203,0.990291,38,206,2,204,1,2,1,3,2,108,107,97,97,34
"2954",53,"[38]yIisHoIweBquzkdwwlFDFJbKpeHHtnJHqwbGqa",200,0.990148,38,203,2,201,1,2,1,3,2,101,100,101,101,34
"2955",54,"[38]yIisHoIweBquzkdwwlFDFJbKpeHHtnJHqwbGqa",210,0.99061,38,213,2,211,1,2,1,3,2,113,112,99,99,34
"2956",55,"[38]yIisHoIweBquzkdwwlFDFJbKpeHHtnJHqwbGqa",192,0.989744,38,195,2,193,1,2,1,3,2,91,90,103,103,34
"2957",56,"[38]yIisHoIweBquzkdwwlFDFJbKpeHHtnJHqwbGqa",202,0.990244,38,205,2,203,1,2,1,3,2,103,102,101,101,34
"2958",57,"[38]yIisHoIweBquzkdwwlFDFJbKpeHHtnJHqwbGqa",191,0.989691,38,194,2,192,1,2,1,3,2,89,88,104,104,34
"2959",58,"[38]yIisHoIweBquzkdwwlFDFJbKpeHHtnJHqwbGqa",200,0.990148,38,203,2,201,1,2,1,3,2,101,100,101,101,34
"2960",59,"[38]yIisHoIweBquzkdwwlFDFJbKpeHHtnJHqwbGqa",214,0.990783,38,217,2,215,1,2,1,3,2,120,119,96,96,34
"2961",60,"[38]yIisHoIweBquzkdwwlFDFJbKpeHHtnJHqwbGqa",201,0.990196,38,204,2,202,1,2,1,3,2,100,99,103,103,34
"2962",61,"[38]yIisHoIweBquzkdwwlFDFJbKpeHHtnJHqwbGqa",200,0.990148,38,203,2,201,1,2,1,3,2,102,101,100,100,34
"2963",62,"[38]yIisHoIweBquzkdwwlFDFJbKpeHHtnJHqwbGqa",200,0.990148,38,203,2,201,1,2,1,3,2,99,98,103,103,34
"2964",63,"[38]yIisHoIweBquzkdwwlFDFJbKpeHHtnJHqwbGqa",209,0.990566,38,212,2,210,1,2,1,3,2,114,113,97,97,34
"2965",64,"[38]yIisHoIweBquzkdwwlFDFJbKpeHHtnJHqwbGqa",199,0.990099,38,202,2,200,1,2,1,3,2,101,100,100,100,34
"2966",65,"[38]yIisHoIweBquzkdwwlFDFJbKpeHHtnJHqwbGqa",192,0.989744,38,195,2,193,1,2,1,3,2,89,88,105,105,34
"2967",66,"[38]yIisHoIweBquzkdwwlFDFJbKpeHHtnJHqwbGqa",192,0.989744,38,195,2,193,1,2,1,3,2,90,89,104,104,34
"2968",67,"[38]yIisHoIweBquzkdwwlFDFJbKpeHHtnJHqwbGqa",200,0.990148,38,203,2,201,1,2,1,3,2,100,99,102,102,34
"2969",68,"[38]yIisHoIweBquzkdwwlFDFJbKpeHHtnJHqwbGqa",198,0.99005,38,201,2,199,1,2,1,3,2,97,96,103,103,34
"2970",69,"[38]yIisHoIweBquzkdwwlFDFJbKpeHHtnJHqwbGqa",197,0.99,38,200,2,198,1,2,1,3,2,97,96,102,102,34
"2971",70,"[38]yIisHoIweBquzkdwwlFDFJbKpeHHtnJHqwbGqa",204,0.990338,38,207,2,205,1,2,1,3,2,107,106,99,99,34
"2972",71,"[38]yIisHoIweBquzkdwwlFDFJbKpeHHtnJHqwbGqa",185,0.989362,38,188,2,186,1,2,1,3,2,79,78,108,108,34
"2973",72,"[38]yIisHoIweBquzkdwwlFDFJbKpeHHtnJHqwbGqa",200,0.990148,38,203,2,201,1,2,1,3,2,100,99,102,102,34
"2974",73,"[38]yIisHoIweBquzkdwwlFDFJbKpeHHtnJHqwbGqa",191,0.989691,38,194,2,192,1,2,1,3,2,92,91,101,101,34
"2975",74,"[38]yIisHoIweBquzkdwwlFDFJbKpeHHtnJHqwbGqa",205,0.990385,38,208,2,206,1,2,1,3,2,106,105,101,101,34
"2976",75,"[38]yIisHoIweBquzkdwwlFDFJbKpeHHtnJHqwbGqa",200,0.990148,38,203,2,201,1,2,1,3,2,98,97,104,104,34
"2977",76,"[38]yIisHoIweBquzkdwwlFDFJbKpeHHtnJHqwbGqa",213,0.990741,38,216,2,214,1,2,1,3,2,115,114,100,100,34
"2978",77,"[38]yIisHoIweBquzkdwwlFDFJbKpeHHtnJHqwbGqa",198,0.99005,38,201,2,199,1,2,1,3,2,98,97,102,102,34
"2979",78,"[38]yIisHoIweBquzkdwwlFDFJbKpeHHtnJHqwbGqa",198,0.99005,38,201,2,199,1,2,1,3,2,97,96,103,103,34
"2980",79,"[38]yIisHoIweBquzkdwwlFDFJbKpeHHtnJHqwbGqa",205,0.990385,38,208,2,206,1,2,1,3,2,106,105,101,101,34
"2981",80,"[38]yIisHoIweBquzkdwwlFDFJbKpeHHtnJHqwbGqa",209,0.990566,38,212,2,210,1,2,1,3,2,112,111,99,99,34
"2982",81,"[38]yIisHoIweBquzkdwwlFDFJbKpeHHtnJHqwbGqa",192,0.989744,38,195,2,193,1,2,1,3,2,92,91,102,102,34
"2983",82,"[38]yIisHoIweBquzkdwwlFDFJbKpeHHtnJHqwbGqa",201,0.990196,38,204,2,202,1,2,1,3,2,101,100,102,102,34
"2984",83,"[38]yIisHoIweBquzkdwwlFDFJbKpeHHtnJHqwbGqa",195,0.989899,38,198,2,196,1,2,1,3,2,94,93,103,103,34
"2985",84,"[38]yIisHoIweBquzkdwwlFDFJbKpeHHtnJHqwbGqa",198,0.99005,38,201,2,199,1,2,1,3,2,99,98,101,101,34
"2986",85,"[38]yIisHoIweBquzkdwwlFDFJbKpeHHtnJHqwbGqa",203,0.990291,38,206,2,204,1,2,1,3,2,104,103,101,101,34
"2987",86,"[38]yIisHoIweBquzkdwwlFDFJbKpeHHtnJHqwbGqa",199,0.990099,38,202,2,200,1,2,1,3,2,100,99,101,101,34
"2988",87,"[38]yIisHoIweBquzkdwwlFDFJbKpeHHtnJHqwbGqa",202,0.990244,38,205,2,203,1,2,1,3,2,105,104,99,99,34
"2989",88,"[38]yIisHoIweBquzkdwwlFDFJbKpeHHtnJHqwbGqa",203,0.990291,38,206,2,204,1,2,1,3,2,108,107,97,97,34
"2990",89,"[38]yIisHoIweBquzkdwwlFDFJbKpeHHtnJHqwbGqa",203,0.990291,38,206,2,204,1,2,1,3,2,104,103,101,101,34
"2991",90,"[38]yIisHoIweBquzkdwwlFDFJbKpeHHtnJHqwbGqa",208,0.990521,38,211,2,209,1,2,1,3,2,112,111,98,98,34
"2992",91,"[38]yIisHoIweBquzkdwwlFDFJbKpeHHtnJHqwbGqa",211,0.990654,38,214,2,212,1,2,1,3,2,115,114,98,98,34
"2993",92,"[38]yIisHoIweBquzkdwwlFDFJbKpeHHtnJHqwbGqa",209,0.990566,38,212,2,210,1,2,1,3,2,112,111,99,99,34
"2994",93,"[38]yIisHoIweBquzkdwwlFDFJbKpeHHtnJHqwbGqa",203,0.990291,38,206,2,204,1,2,1,3,2,105,104,100,100,34
"2995",94,"[38]yIisHoIweBquzkdwwlFDFJbKpeHHtnJHqwbGqa",217,0.990909,38,220,2,218,1,2,1,3,2,122,121,97,97,34
"2996",95,"[38]yIisHoIweBquzkdwwlFDFJbKpeHHtnJHqwbGqa",200,0.990148,38,203,2,201,1,2,1,3,2,101,100,101,101,34
"2997",96,"[38]yIisHoIweBquzkdwwlFDFJbKpeHHtnJHqwbGqa",204,0.990338,38,207,2,205,1,2,1,3,2,104,103,102,102,34
"2998",97,"[38]yIisHoIweBquzkdwwlFDFJbKpeHHtnJHqwbGqa",206,0.990431,38,209,2,207,1,2,1,3,2,111,110,97,97,34
"2999",98,"[38]yIisHoIweBquzkdwwlFDFJbKpeHHtnJHqwbGqa",193,0.989796,38,196,2,194,1,2,1,3,2,91,90,104,104,34
"3000",99,"[38]yIisHoIweBquzkdwwlFDFJbKpeHHtnJHqwbGqa",216,0.990868,38,219,2,217,1,2,1,3,2,123,122,95,95,34
"3001",0,"[40]zIlHoIpAuBkDyBvdzuKKeqbKDeelwHxnJHqvbGqa",196,0.98995,40,199,2,197,1,2,1,3,2,95,94,103,103,35
"3002",1,"[40]zIlHoIpAuBkDyBvdzuKKeqbKDeelwHxnJHqvbGqa",204,0.990338,40,207,2,205,1,2,1,3,2,108,107,98,98,35
"3003",2,"[40]zIlHoIpAuBkDyBvdzuKKeqbKDeelwHxnJHqvbGqa",192,0.989744,40,195,2,193,1,2,1,3,2,91,90,103,103,35
"3004",3,"[40]zIlHoIpAuBkDyBvdzuKKeqbKDeelwHxnJHqvbGqa",208,0.990521,40,211,2,209,1,2,1,3,2,112,111,98,98,35
"3005",4,"[40]zIlHoIpAuBkDyBvdzuKKeqbKDeelwHxnJHqvbGqa",188,0.989529,40,191,2,189,1,2,1,3,2,84,83,106,106,35
"3006",5,"[40]zIlHoIpAuBkDyBvdzuKKeqbKDeelwHxnJHqvbGqa",197,0.99,40,200,2,198,1,2,1,3,2,98,97,101,101,35
"3007",6,"[40]zIlHoIpAuBkDyBvdzuKKeqbKDeelwHxnJHqvbGqa",194,0.989848,40,197,2,195,1,2,1,3,2,93,92,103,103,35
"3008",7,"[40]zIlHoIpAuBkDyBvdzuKKeqbKDeelwHxnJHqvbGqa",199,0.990099,40,202,2,200,1,2,1,3,2,99,98,102,102,35
"3009",8,"[40]zIlHoIpAuBkDyBvdzuKKeqbKDeelwHxnJHqvbGqa",193,0.989796,40,196,2,194,1,2,1,3,2,90,89,105,105,35
"3010",9,"[40]zIlHoIpAuBkDyBvdzuKKeqbKDeelwHxnJHqvbGqa",192,0.989744,40,195,2,193,1,2,1,3,2,91,90,103,103,35
"3011",10,"[40]zIlHoIpAuBkDyBvdzuKKeqbKDeelwHxnJHqvbGqa",198,0.99005,40,201,2,199,1,2,1,3,2,99,98,101,101,35
"3012",11,"[40]zIlHoIpAuBkDyBvdzuKKeqbKDeelwHxnJHqvbGqa",197,0.99,40,200,2,198,1,2,1,3,2,98,97,101,101,35
"3013",12,"[40]zIlHoIpAuBkDyBvdzuKKeqbKDeelwHxnJHqvbGqa",194,0.989848,40,197,2,195,1,2,1,3,2,94,93,102,102,35
"3014",13,"[40]zIlHoIpAuBkDyBvdzuKKeqbKDeelwHxnJHqvbGqa",213,0.990741,40,216,2,214,1,2,1,3,2,116,115,99,99,35
"3015",14,"[40]zIlHoIpAuBkDyBvdzuKKeqbKDeelwHxnJHqvbGqa",201,0.990196,40,204,2,202,1,2,1,3,2,103,102,100,100,35
"3016",15,"[40]zIlHoIpAuBkDyBvdzuKKeqbKDeelwHxnJHqvbGqa",202,0.990244,40,205,2,203,1,2,1,3,2,104,103,100,100,35
"3017",16,"[40]zIlHoIpAuBkDyBvdzuKKeqbKDeelwHxnJHqvbGqa",203,0.990291,40,206,2,204,1,2,1,3,2,105,104,100,100,35
"3018",17,"[40]zIlHoIpAuBkDyBvdzuKKeqbKDeelwHxnJHqvbGqa",202,0.990244,40,205,2,203,1,2,1,3,2,103,102,101,101,35
"3019",18,"[40]zIlHoIpAuBkDyBvdzuKKeqbKDeelwHxnJHqvbGqa",218,0.99095,40,221,2,219,1,2,1,3,2,125,124,95,95,35
"3020",19,"[40]zIlHoIpAuBkDyBvdzuKKeqbKDeelwHxnJHqvbGqa",199,0.990099,40,202,2,200,1,2,1,3,2,100,99,101,101,35
"3021",20,"[40]zIlHoIpAuBkDyBvdzuKKeqbKDeelwHxnJHqvbGqa",196,0.98995,40,199,2,197,1,2,1,3,2,95,94,103,103,35
"3022",21,"[40]zIlHoIpAuBkDyBvdzuKKeqbKDeelwHxnJHqvbGqa",198,0.99005,40,201,2,199,1,2,1,3,2,97,96,103,103,35
"3023",22,"[40]zIlHoIpAuBkDyBvdzuKKeqbKDeelwHxnJHqvbGqa",202,0.990244,40,205,2,203,1,2,1,3,2,104,103,100,100,35
"3024",23,"[40]zIlHoIpAuBkDyBvdzuKKeqbKDeelwHxnJHqvbGqa",189,0.989583,40,192,2,190,1,2,1,3,2,85,84,106,106,35
"3025",24,"[40]zIlHoIpAuBkDyBvdzuKKeqbKDeelwHxnJHqvbGqa",195,0.989899,40,198,2,196,1,2,1,3,2,93,92,104,104,35
"3026",25,"[40]zIlHoIpAuBkDyBvdzuKKeqbKDeelwHxnJHqvbGqa",200,0.990148,40,203,2,201,1,2,1,3,2,102,101,100,100,35
"3027",26,"[40]zIlHoIpAuBkDyBvdzuKKeqbKDeelwHxnJHqvbGqa",208,0.990521,40,211,2,209,1,2,1,3,2,113,112,97,97,35
"3028",27,"[40]zIlHoIpAuBkDyBvdzuKKeqbKDeelwHxnJHqvbGqa",196,0.98995,40,199,2,197,1,2,1,3,2,95,94,103,103,35
"3029",28,"[40]zIlHoIpAuBkDyBvdzuKKeqbKDeelwHxnJHqvbGqa",203,0.990291,40,206,2,204,1,2,1,3,2,103,102,102,102,35
"3030",29,"[40]zIlHoIpAuBkDyBvdzuKKeqbKDeelwHxnJHqvbGqa",205,0.990385,40,208,2,206,1,2,1,3,2,107,106,100,100,35
"3031",30,"[40]zIlHoIpAuBkDyBvdzuKKeqbKDeelwHxnJHqvbGqa",209,0.990566,40,212,2,210,1,2,1,3,2,114,113,97,97,35
"3032",31,"[40]zIlHoIpAuBkDyBvdzuKKeqbKDeelwHxnJHqvbGqa",200,0.990148,40,203,2,201,1,2,1,3,2,102,101,100,100,35
"3033",32,"[40]zIlHoIpAuBkDyBvdzuKKeqbKDeelwHxnJHqvbGqa",205,0.990385,40,208,2,206,1,2,1,3,2,109,108,98,98,35
"3034",33,"[40]zIlHoIpAuBkDyBvdzuKKeqbKDeelwHxnJHqvbGqa",206,0.990431,40,209,2,207,1,2,1,3,2,109,108,99,99,35
"3035",34,"[40]zIlHoIpAuBkDyBvdzuKKeqbKDeelwHxnJHqvbGqa",204,0.990338,40,207,2,205,1,2,1,3,2,105,104,101,101,35
"3036",35,"[40]zIlHoIpAuBkDyBvdzuKKeqbKDeelwHxnJHqvbGqa",199,0.990099,40,202,2,200,1,2,1,3,2,99,98,102,102,35
"3037",36,"[40]zIlHoIpAuBkDyBvdzuKKeqbKDeelwHxnJHqvbGqa",192,0.989744,40,195,2,193,1,2,1,3,2,88,87,106,106,35
"3038",37,"[40]zIlHoIpAuBkDyBvdzuKKeqbKDeelwHxnJHqvbGqa",211,0.990654,40,214,2,212,1,2,1,3,2,114,113,99,99,35
"3039",38,"[40]zIlHoIpAuBkDyBvdzuKKeqbKDeelwHxnJHqvbGqa",201,0.990196,40,204,2,202,1,2,1,3,2,102,101,101,101,35
"3040",39,"[40]zIlHoIpAuBkDyBvdzuKKeqbKDeelwHxnJHqvbGqa",198,0.99005,40,201,2,199,1,2,1,3,2,100,99,100,100,35
"3041",40,"[40]zIlHoIpAuBkDyBvdzuKKeqbKDeelwHxnJHqvbGqa",198,0.99005,40,201,2,199,1,2,1,3,2,97,96,103,103,35
"3042",41,"[40]zIlHoIpAuBkDyBvdzuKKeqbKDeelwHxnJHqvbGqa",213,0.990741,40,216,2,214,1,2,1,3,2,121,120,94,94,35
"3043",42,"[40]zIlHoIpAuBkDyBvdzuKKeqbKDeelwHxnJHqvbGqa",215,0.990826,40,218,2,216,1,2,1,3,2,118,117,99,99,35
"3044",43,"[40]zIlHoIpAuBkDyBvdzuKKeqbKDeelwHxnJHqvbGqa",213,0.990741,40,216,2,214,1,2,1,3,2,117,116,98,98,35
"3045",44,"[40]zIlHoIpAuBkDyBvdzuKKeqbKDeelwHxnJHqvbGqa",198,0.99005,40,201,2,199,1,2,1,3,2,99,98,101,101,35
"3046",45,"[40]zIlHoIpAuBkDyBvdzuKKeqbKDeelwHxnJHqvbGqa",202,0.990244,40,205,2,203,1,2,1,3,2,104,103,100,100,35
"3047",46,"[40]zIlHoIpAuBkDyBvdzuKKeqbKDeelwHxnJHqvbGqa",208,0.990521,40,211,2,209,1,2,1,3,2,113,112,97,97,35
"3048",47,"[40]zIlHoIpAuBkDyBvdzuKKeqbKDeelwHxnJHqvbGqa",206,0.990431,40,209,2,207,1,2,1,3,2,109,108,99,99,35
"3049",48,"[40]zIlHoIpAuBkDyBvdzuKKeqbKDeelwHxnJHqvbGqa",202,0.990244,40,205,2,203,1,2,1,3,2,103,102,101,101,35
"3050",49,"[40]zIlHoIpAuBkDyBvdzuKKeqbKDeelwHxnJHqvbGqa",213,0.990741,40,216,2,214,1,2,1,3,2,119,118,96,96,35
"3051",50,"[40]zIlHoIpAuBkDyBvdzuKKeqbKDeelwHxnJHqvbGqa",206,0.990431,40,209,2,207,1,2,1,3,2,109,108,99,99,35
"3052",51,"[40]zIlHoIpAuBkDyBvdzuKKeqbKDeelwHxnJHqvbGqa",203,0.990291,40,206,2,204,1,2,1,3,2,104,103,101,101,35
"3053",52,"[40]zIlHoIpAuBkDyBvdzuKKeqbKDeelwHxnJHqvbGqa",210,0.99061,40,213,2,211,1,2,1,3,2,116,115,96,96,35
"3054",53,"[40]zIlHoIpAuBkDyBvdzuKKeqbKDeelwHxnJHqvbGqa",200,0.990148,40,203,2,201,1,2,1,3,2,101,100,101,101,35
"3055",54,"[40]zIlHoIpAuBkDyBvdzuKKeqbKDeelwHxnJHqvbGqa",199,0.990099,40,202,2,200,1,2,1,3,2,98,97,103,103,35
"3056",55,"[40]zIlHoIpAuBkDyBvdzuKKeqbKDeelwHxnJHqvbGqa",199,0.990099,40,202,2,200,1,2,1,3,2,99,98,102,102,35
"3057",56,"[40]zIlHoIpAuBkDyBvdzuKKeqbKDeelwHxnJHqvbGqa",195,0.989899,40,198,2,196,1,2,1,3,2,95,94,102,102,35
"3058",57,"[40]zIlHoIpAuBkDyBvdzuKKeqbKDeelwHxnJHqvbGqa",193,0.989796,40,196,2,194,1,2,1,3,2,93,92,102,102,35
"3059",58,"[40]zIlHoIpAuBkDyBvdzuKKeqbKDeelwHxnJHqvbGqa",195,0.989899,40,198,2,196,1,2,1,3,2,94,93,103,103,35
"3060",59,"[40]zIlHoIpAuBkDyBvdzuKKeqbKDeelwHxnJHqvbGqa",187,0.989474,40,190,2,188,1,2,1,3,2,84,83,105,105,35
"3061",60,"[40]zIlHoIpAuBkDyBvdzuKKeqbKDeelwHxnJHqvbGqa",199,0.990099,40,202,2,200,1,2,1,3,2,101,100,100,100,35
"3062",61,"[40]zIlHoIpAuBkDyBvdzuKKeqbKDeelwHxnJHqvbGqa",196,0.98995,40,199,2,197,1,2,1,3,2,95,94,103,103,35
"3063",62,"[40]zIlHoIpAuBkDyBvdzuKKeqbKDeelwHxnJHqvbGqa",208,0.990521,40,211,2,209,1,2,1,3,2,113,112,97,97,35
"3064",63,"[40]zIlHoIpAuBkDyBvdzuKKeqbKDeelwHxnJHqvbGqa",193,0.989796,40,196,2,194,1,2,1,3,2,92,91,103,103,35
"3065",64,"[40]zIlHoIpAuBkDyBvdzuKKeqbKDeelwHxnJHqvbGqa",204,0.990338,40,207,2,205,1,2,1,3,2,106,105,100,100,35
"3066",65,"[40]zIlHoIpAuBkDyBvdzuKKeqbKDeelwHxnJHqvbGqa",204,0.990338,40,207,2,205,1,2,1,3,2,108,107,98,98,35
"3067",66,"[40]zIlHoIpAuBkDyBvdzuKKeqbKDeelwHxnJHqvbGqa",207,0.990476,40,210,2,208,1,2,1,3,2,109,108,100,100,35
"3068",67,"[40]zIlHoIpAuBkDyBvdzuKKeqbKDeelwHxnJHqvbGqa",209,0.990566,40,212,2,210,1,2,1,3,2,113,112,98,98,35
"3069",68,"[40]zIlHoIpAuBkDyBvdzuKKeqbKDeelwHxnJHqvbGqa",204,0.990338,40,207,2,205,1,2,1,3,2,106,105,100,100,35
"3070",69,"[40]zIlHoIpAuBkDyBvdzuKKeqbKDeelwHxnJHqvbGqa",200,0.990148,40,203,2,201,1,2,1,3,2,101,100,101,101,35
"3071",70,"[40]zIlHoIpAuBkDyBvdzuKKeqbKDeelwHxnJHqvbGqa",211,0.990654,40,214,2,212,1,2,1,3,2,115,114,98,98,35
"3072",71,"[40]zIlHoIpAuBkDyBvdzuKKeqbKDeelwHxnJHqvbGqa",214,0.990783,40,217,2,215,1,2,1,3,2,120,119,96,96,35
"3073",72,"[40]zIlHoIpAuBkDyBvdzuKKeqbKDeelwHxnJHqvbGqa",205,0.990385,40,208,2,206,1,2,1,3,2,109,108,98,98,35
"3074",73,"[40]zIlHoIpAuBkDyBvdzuKKeqbKDeelwHxnJHqvbGqa",192,0.989744,40,195,2,193,1,2,1,3,2,90,89,104,104,35
"3075",74,"[40]zIlHoIpAuBkDyBvdzuKKeqbKDeelwHxnJHqvbGqa",212,0.990698,40,215,2,213,1,2,1,3,2,115,114,99,99,35
"3076",75,"[40]zIlHoIpAuBkDyBvdzuKKeqbKDeelwHxnJHqvbGqa",192,0.989744,40,195,2,193,1,2,1,3,2,91,90,103,103,35
"3077",76,"[40]zIlHoIpAuBkDyBvdzuKKeqbKDeelwHxnJHqvbGqa",192,0.989744,40,195,2,193,1,2,1,3,2,91,90,103,103,35
"3078",77,"[40]zIlHoIpAuBkDyBvdzuKKeqbKDeelwHxnJHqvbGqa",208,0.990521,40,211,2,209,1,2,1,3,2,111,110,99,99,35
"3079",78,"[40]zIlHoIpAuBkDyBvdzuKKeqbKDeelwHxnJHqvbGqa",188,0.989529,40,191,2,189,1,2,1,3,2,85,84,105,105,35
"3080",79,"[40]zIlHoIpAuBkDyBvdzuKKeqbKDeelwHxnJHqvbGqa",205,0.990385,40,208,2,206,1,2,1,3,2,108,107,99,99,35
"3081",80,"[40]zIlHoIpAuBkDyBvdzuKKeqbKDeelwHxnJHqvbGqa",200,0.990148,40,203,2,201,1,2,1,3,2,102,101,100,100,35
"3082",81,"[40]zIlHoIpAuBkDyBvdzuKKeqbKDeelwHxnJHqvbGqa",195,0.989899,40,198,2,196,1,2,1,3,2,92,91,105,105,35
"3083",82,"[40]zIlHoIpAuBkDyBvdzuKKeqbKDeelwHxnJHqvbGqa",211,0.990654,40,214,2,212,1,2,1,3,2,113,112,100,100,35
"3084",83,"[40]zIlHoIpAuBkDyBvdzuKKeqbKDeelwHxnJHqvbGqa",198,0.99005,40,201,2,199,1,2,1,3,2,99,98,101,101,35
"3085",84,"[40]zIlHoIpAuBkDyBvdzuKKeqbKDeelwHxnJHqvbGqa",214,0.990783,40,217,2,215,1,2,1,3,2,121,120,95,95,35
"3086",85,"[40]zIlHoIpAuBkDyBvdzuKKeqbKDeelwHxnJHqvbGqa",197,0.99,40,200,2,198,1,2,1,3,2,94,93,105,105,35
"3087",86,"[40]zIlHoIpAuBkDyBvdzuKKeqbKDeelwHxnJHqvbGqa",213,0.990741,40,216,2,214,1,2,1,3,2,120,119,95,95,35
"3088",87,"[40]zIlHoIpAuBkDyBvdzuKKeqbKDeelwHxnJHqvbGqa",207,0.990476,40,210,2,208,1,2,1,3,2,109,108,100,100,35
"3089",88,"[40]zIlHoIpAuBkDyBvdzuKKeqbKDeelwHxnJHqvbGqa",196,0.98995,40,199,2,197,1,2,1,3,2,96,95,102,102,35
"3090",89,"[40]zIlHoIpAuBkDyBvdzuKKeqbKDeelwHxnJHqvbGqa",202,0.990244,40,205,2,203,1,2,1,3,2,103,102,101,101,35
"3091",90,"[40]zIlHoIpAuBkDyBvdzuKKeqbKDeelwHxnJHqvbGqa",199,0.990099,40,202,2,200,1,2,1,3,2,99,98,102,102,35
"3092",91,"[40]zIlHoIpAuBkDyBvdzuKKeqbKDeelwHxnJHqvbGqa",206,0.990431,40,209,2,207,1,2,1,3,2,110,109,98,98,35
"3093",92,"[40]zIlHoIpAuBkDyBvdzuKKeqbKDeelwHxnJHqvbGqa",194,0.989848,40,197,2,195,1,2,1,3,2,93,92,103,103,35
"3094",93,"[40]zIlHoIpAuBkDyBvdzuKKeqbKDeelwHxnJHqvbGqa",197,0.99,40,200,2,198,1,2,1,3,2,99,98,100,100,35
"3095",94,"[40]zIlHoIpAuBkDyBvdzuKKeqbKDeelwHxnJHqvbGqa",206,0.990431,40,209,2,207,1,2,1,3,2,107,106,101,101,35
"3096",95,"[40]zIlHoIpAuBkDyBvdzuKKeqbKDeelwHxnJHqvbGqa",197,0.99,40,200,2,198,1,2,1,3,2,96,95,103,103,35
"3097",96,"[40]zIlHoIpAuBkDyBvdzuKKeqbKDeelwHxnJHqvbGqa",190,0.989637,40,193,2,191,1,2,1,3,2,86,85,106,106,35
"3098",97,"[40]zIlHoIpAuBkDyBvdzuKKeqbKDeelwHxnJHqvbGqa",198,0.99005,40,201,2,199,1,2,1,3,2,98,97,102,102,35
"3099",98,"[40]zIlHoIpAuBkDyBvdzuKKeqbKDeelwHxnJHqvbGqa",200,0.990148,40,203,2,201,1,2,1,3,2,100,99,102,102,35
"3100",99,"[40]zIlHoIpAuBkDyBvdzuKKeqbKDeelwHxnJHqvbGqa",204,0.990338,40,207,2,205,1,2,1,3,2,107,106,99,99,35
"3101",0,"[40]HItHoIrouBkDsEGozDKotnbKDaeoyHvnJHqvbGqa",199,0.990099,40,202,2,200,1,2,1,3,2,97,96,104,104,36
"3102",1,"[40]HItHoIrouBkDsEGozDKotnbKDaeoyHvnJHqvbGqa",204,0.990338,40,207,2,205,1,2,1,3,2,108,107,98,98,36
"3103",2,"[40]HItHoIrouBkDsEGozDKotnbKDaeoyHvnJHqvbGqa",174,0.988701,40,177,2,175,1,2,1,3,2,66,65,110,110,36
"3104",3,"[40]HItHoIrouBkDsEGozDKotnbKDaeoyHvnJHqvbGqa",207,0.990476,40,210,2,208,1,2,1,3,2,108,107,101,101,36
"3105",4,"[40]HItHoIrouBkDsEGozDKotnbKDaeoyHvnJHqvbGqa",213,0.990741,40,216,2,214,1,2,1,3,2,117,116,98,98,36
"3106",5,"[40]HItHoIrouBkDsEGozDKotnbKDaeoyHvnJHqvbGqa",215,0.990826,40,218,2,216,1,2,1,3,2,121,120,96,96,36
"3107",6,"[40]HItHoIrouBkDsEGozDKotnbKDaeoyHvnJHqvbGqa",206,0.990431,40,209,2,207,1,2,1,3,2,109,108,99,99,36
"3108",7,"[40]HItHoIrouBkDsEGozDKotnbKDaeoyHvnJHqvbGqa",216,0.990868,40,219,2,217,1,2,1,3,2,125,124,93,93,36
"3109",8,"[40]HItHoIrouBkDsEGozDKotnbKDaeoyHvnJHqvbGqa",202,0.990244,40,205,2,203,1,2,1,3,2,104,103,100,100,36
"3110",9,"[40]HItHoIrouBkDsEGozDKotnbKDaeoyHvnJHqvbGqa",188,0.989529,40,191,2,189,1,2,1,3,2,83,82,107,107,36
"3111",10,"[40]HItHoIrouBkDsEGozDKotnbKDaeoyHvnJHqvbGqa",187,0.989474,40,190,2,188,1,2,1,3,2,83,82,106,106,36
"3112",11,"[40]HItHoIrouBkDsEGozDKotnbKDaeoyHvnJHqvbGqa",195,0.989899,40,198,2,196,1,2,1,3,2,93,92,104,104,36
"3113",12,"[40]HItHoIrouBkDsEGozDKotnbKDaeoyHvnJHqvbGqa",200,0.990148,40,203,2,201,1,2,1,3,2,100,99,102,102,36
"3114",13,"[40]HItHoIrouBkDsEGozDKotnbKDaeoyHvnJHqvbGqa",209,0.990566,40,212,2,210,1,2,1,3,2,115,114,96,96,36
"3115",14,"[40]HItHoIrouBkDsEGozDKotnbKDaeoyHvnJHqvbGqa",188,0.989529,40,191,2,189,1,2,1,3,2,84,83,106,106,36
"3116",15,"[40]HItHoIrouBkDsEGozDKotnbKDaeoyHvnJHqvbGqa",190,0.989637,40,193,2,191,1,2,1,3,2,88,87,104,104,36
"3117",16,"[40]HItHoIrouBkDsEGozDKotnbKDaeoyHvnJHqvbGqa",198,0.99005,40,201,2,199,1,2,1,3,2,96,95,104,104,36
"3118",17,"[40]HItHoIrouBkDsEGozDKotnbKDaeoyHvnJHqvbGqa",199,0.990099,40,202,2,200,1,2,1,3,2,100,99,101,101,36
"3119",18,"[40]HItHoIrouBkDsEGozDKotnbKDaeoyHvnJHqvbGqa",205,0.990385,40,208,2,206,1,2,1,3,2,106,105,101,101,36
"3120",19,"[40]HItHoIrouBkDsEGozDKotnbKDaeoyHvnJHqvbGqa",212,0.990698,40,215,2,213,1,2,1,3,2,118,117,96,96,36
"3121",20,"[40]HItHoIrouBkDsEGozDKotnbKDaeoyHvnJHqvbGqa",204,0.990338,40,207,2,205,1,2,1,3,2,106,105,100,100,36
"3122",21,"[40]HItHoIrouBkDsEGozDKotnbKDaeoyHvnJHqvbGqa",217,0.990909,40,220,2,218,1,2,1,3,2,126,125,93,93,36
"3123",22,"[40]HItHoIrouBkDsEGozDKotnbKDaeoyHvnJHqvbGqa",190,0.989637,40,193,2,191,1,2,1,3,2,88,87,104,104,36
"3124",23,"[40]HItHoIrouBkDsEGozDKotnbKDaeoyHvnJHqvbGqa",195,0.989899,40,198,2,196,1,2,1,3,2,95,94,102,102,36
"3125",24,"[40]HItHoIrouBkDsEGozDKotnbKDaeoyHvnJHqvbGqa",194,0.989848,40,197,2,195,1,2,1,3,2,94,93,102,102,36
"3126",25,"[40]HItHoIrouBkDsEGozDKotnbKDaeoyHvnJHqvbGqa",193,0.989796,40,196,2,194,1,2,1,3,2,92,91,103,103,36
"3127",26,"[40]HItHoIrouBkDsEGozDKotnbKDaeoyHvnJHqvbGqa",190,0.989637,40,193,2,191,1,2,1,3,2,88,87,104,104,36
"3128",27,"[40]HItHoIrouBkDsEGozDKotnbKDaeoyHvnJHqvbGqa",189,0.989583,40,192,2,190,1,2,1,3,2,86,85,105,105,36
"3129",28,"[40]HItHoIrouBkDsEGozDKotnbKDaeoyHvnJHqvbGqa",202,0.990244,40,205,2,203,1,2,1,3,2,103,102,101,101,36
"3130",29,"[40]HItHoIrouBkDsEGozDKotnbKDaeoyHvnJHqvbGqa",190,0.989637,40,193,2,191,1,2,1,3,2,89,88,103,103,36
"3131",30,"[40]HItHoIrouBkDsEGozDKotnbKDaeoyHvnJHqvbGqa",200,0.990148,40,203,2,201,1,2,1,3,2,100,99,102,102,36
"3132",31,"[40]HItHoIrouBkDsEGozDKotnbKDaeoyHvnJHqvbGqa",198,0.99005,40,201,2,199,1,2,1,3,2,99,98,101,101,36
"3133",32,"[40]HItHoIrouBkDsEGozDKotnbKDaeoyHvnJHqvbGqa",202,0.990244,40,205,2,203,1,2,1,3,2,106,105,98,98,36
"3134",33,"[40]HItHoIrouBkDsEGozDKotnbKDaeoyHvnJHqvbGqa",201,0.990196,40,204,2,202,1,2,1,3,2,98,97,105,105,36
"3135",34,"[40]HItHoIrouBkDsEGozDKotnbKDaeoyHvnJHqvbGqa",192,0.989744,40,195,2,193,1,2,1,3,2,89,88,105,105,36
"3136",35,"[40]HItHoIrouBkDsEGozDKotnbKDaeoyHvnJHqvbGqa",196,0.98995,40,199,2,197,1,2,1,3,2,94,93,104,104,36
"3137",36,"[40]HItHoIrouBkDsEGozDKotnbKDaeoyHvnJHqvbGqa",198,0.99005,40,201,2,199,1,2,1,3,2,96,95,104,104,36
"3138",37,"[40]HItHoIrouBkDsEGozDKotnbKDaeoyHvnJHqvbGqa",200,0.990148,40,203,2,201,1,2,1,3,2,102,101,100,100,36
"3139",38,"[40]HItHoIrouBkDsEGozDKotnbKDaeoyHvnJHqvbGqa",197,0.99,40,200,2,198,1,2,1,3,2,95,94,104,104,36
"3140",39,"[40]HItHoIrouBkDsEGozDKotnbKDaeoyHvnJHqvbGqa",200,0.990148,40,203,2,201,1,2,1,3,2,101,100,101,101,36
"3141",40,"[40]HItHoIrouBkDsEGozDKotnbKDaeoyHvnJHqvbGqa",198,0.99005,40,201,2,199,1,2,1,3,2,99,98,101,101,36
"3142",41,"[40]HItHoIrouBkDsEGozDKotnbKDaeoyHvnJHqvbGqa",205,0.990385,40,208,2,206,1,2,1,3,2,106,105,101,101,36
"3143",42,"[40]HItHoIrouBkDsEGozDKotnbKDaeoyHvnJHqvbGqa",203,0.990291,40,206,2,204,1,2,1,3,2,105,104,100,100,36
"3144",43,"[40]HItHoIrouBkDsEGozDKotnbKDaeoyHvnJHqvbGqa",216,0.990868,40,219,2,217,1,2,1,3,2,120,119,98,98,36
"3145",44,"[40]HItHoIrouBkDsEGozDKotnbKDaeoyHvnJHqvbGqa",212,0.990698,40,215,2,213,1,2,1,3,2,117,116,97,97,36
"3146",45,"[40]HItHoIrouBkDsEGozDKotnbKDaeoyHvnJHqvbGqa",200,0.990148,40,203,2,201,1,2,1,3,2,100,99,102,102,36
"3147",46,"[40]HItHoIrouBkDsEGozDKotnbKDaeoyHvnJHqvbGqa",219,0.990991,40,222,2,220,1,2,1,3,2,128,127,93,93,36
"3148",47,"[40]HItHoIrouBkDsEGozDKotnbKDaeoyHvnJHqvbGqa",195,0.989899,40,198,2,196,1,2,1,3,2,94,93,103,103,36
"3149",48,"[40]HItHoIrouBkDsEGozDKotnbKDaeoyHvnJHqvbGqa",206,0.990431,40,209,2,207,1,2,1,3,2,106,105,102,102,36
"3150",49,"[40]HItHoIrouBkDsEGozDKotnbKDaeoyHvnJHqvbGqa",200,0.990148,40,203,2,201,1,2,1,3,2,100,99,102,102,36
"3151",50,"[40]HItHoIrouBkDsEGozDKotnbKDaeoyHvnJHqvbGqa",183,0.989247,40,186,2,184,1,2,1,3,2,78,77,107,107,36
"3152",51,"[40]HItHoIrouBkDsEGozDKotnbKDaeoyHvnJHqvbGqa",197,0.99,40,200,2,198,1,2,1,3,2,94,93,105,105,36
"3153",52,"[40]HItHoIrouBkDsEGozDKotnbKDaeoyHvnJHqvbGqa",202,0.990244,40,205,2,203,1,2,1,3,2,103,102,101,101,36
"3154",53,"[40]HItHoIrouBkDsEGozDKotnbKDaeoyHvnJHqvbGqa",197,0.99,40,200,2,198,1,2,1,3,2,95,94,104,104,36
"3155",54,"[40]HItHoIrouBkDsEGozDKotnbKDaeoyHvnJHqvbGqa",205,0.990385,40,208,2,206,1,2,1,3,2,104,103,103,103,36
"3156",55,"[40]HItHoIrouBkDsEGozDKotnbKDaeoyHvnJHqvbGqa",196,0.98995,40,199,2,197,1,2,1,3,2,97,96,101,101,36
"3157",56,"[40]HItHoIrouBkDsEGozDKotnbKDaeoyHvnJHqvbGqa",190,0.989637,40,193,2,191,1,2,1,3,2,88,87,104,104,36
"3158",57,"[40]HItHoIrouBkDsEGozDKotnbKDaeoyHvnJHqvbGqa",200,0.990148,40,203,2,201,1,2,1,3,2,102,101,100,100,36
"3159",58,"[40]HItHoIrouBkDsEGozDKotnbKDaeoyHvnJHqvbGqa",202,0.990244,40,205,2,203,1,2,1,3,2,101,100,103,103,36
"3160",59,"[40]HItHoIrouBkDsEGozDKotnbKDaeoyHvnJHqvbGqa",206,0.990431,40,209,2,207,1,2,1,3,2,106,105,102,102,36
"3161",60,"[40]HItHoIrouBkDsEGozDKotnbKDaeoyHvnJHqvbGqa",204,0.990338,40,207,2,205,1,2,1,3,2,105,104,101,101,36
"3162",61,"[40]HItHoIrouBkDsEGozDKotnbKDaeoyHvnJHqvbGqa",207,0.990476,40,210,2,208,1,2,1,3,2,114,113,95,95,36
"3163",62,"[40]HItHoIrouBkDsEGozDKotnbKDaeoyHvnJHqvbGqa",207,0.990476,40,210,2,208,1,2,1,3,2,108,107,101,101,36
"3164",63,"[40]HItHoIrouBkDsEGozDKotnbKDaeoyHvnJHqvbGqa",195,0.989899,40,198,2,196,1,2,1,3,2,93,92,104,104,36
"3165",64,"[40]HItHoIrouBkDsEGozDKotnbKDaeoyHvnJHqvbGqa",210,0.99061,40,213,2,211,1,2,1,3,2,114,113,98,98,36
"3166",65,"[40]HItHoIrouBkDsEGozDKotnbKDaeoyHvnJHqvbGqa",204,0.990338,40,207,2,205,1,2,1,3,2,106,105,100,100,36
"3167",66,"[40]HItHoIrouBkDsEGozDKotnbKDaeoyHvnJHqvbGqa",187,0.989474,40,190,2,188,1,2,1,3,2,82,81,107,107,36
"3168",67,"[40]HItHoIrouBkDsEGozDKotnbKDaeoyHvnJHqvbGqa",192,0.989744,40,195,2,193,1,2,1,3,2,90,89,104,104,36
"3169",68,"[40]HItHoIrouBkDsEGozDKotnbKDaeoyHvnJHqvbGqa",206,0.990431,40,209,2,207,1,2,1,3,2,108,107,100,100,36
"3170",69,"[40]HItHoIrouBkDsEGozDKotnbKDaeoyHvnJHqvbGqa",205,0.990385,40,208,2,206,1,2,1,3,2,110,109,97,97,36
"3171",70,"[40]HItHoIrouBkDsEGozDKotnbKDaeoyHvnJHqvbGqa",195,0.989899,40,198,2,196,1,2,1,3,2,97,96,100,100,36
"3172",71,"[40]HItHoIrouBkDsEGozDKotnbKDaeoyHvnJHqvbGqa",197,0.99,40,200,2,198,1,2,1,3,2,96,95,103,103,36
"3173",72,"[40]HItHoIrouBkDsEGozDKotnbKDaeoyHvnJHqvbGqa",199,0.990099,40,202,2,200,1,2,1,3,2,98,97,103,103,36
"3174",73,"[40]HItHoIrouBkDsEGozDKotnbKDaeoyHvnJHqvbGqa",205,0.990385,40,208,2,206,1,2,1,3,2,107,106,100,100,36
"3175",74,"[40]HItHoIrouBkDsEGozDKotnbKDaeoyHvnJHqvbGqa",209,0.990566,40,212,2,210,1,2,1,3,2,112,111,99,99,36
"3176",75,"[40]HItHoIrouBkDsEGozDKotnbKDaeoyHvnJHqvbGqa",188,0.989529,40,191,2,189,1,2,1,3,2,84,83,106,106,36
"3177",76,"[40]HItHoIrouBkDsEGozDKotnbKDaeoyHvnJHqvbGqa",222,0.991111,40,225,2,223,1,2,1,3,2,129,128,95,95,36
"3178",77,"[40]HItHoIrouBkDsEGozDKotnbKDaeoyHvnJHqvbGqa",203,0.990291,40,206,2,204,1,2,1,3,2,103,102,102,102,36
"3179",78,"[40]HItHoIrouBkDsEGozDKotnbKDaeoyHvnJHqvbGqa",212,0.990698,40,215,2,213,1,2,1,3,2,120,119,94,94,36
"3180",79,"[40]HItHoIrouBkDsEGozDKotnbKDaeoyHvnJHqvbGqa",201,0.990196,40,204,2,202,1,2,1,3,2,103,102,100,100,36
"3181",80,"[40]HItHoIrouBkDsEGozDKotnbKDaeoyHvnJHqvbGqa",200,0.990148,40,203,2,201,1,2,1,3,2,101,100,101,101,36
"3182",81,"[40]HItHoIrouBkDsEGozDKotnbKDaeoyHvnJHqvbGqa",205,0.990385,40,208,2,206,1,2,1,3,2,109,108,98,98,36
"3183",82,"[40]HItHoIrouBkDsEGozDKotnbKDaeoyHvnJHqvbGqa",203,0.990291,40,206,2,204,1,2,1,3,2,106,105,99,99,36
"3184",83,"[40]HItHoIrouBkDsEGozDKotnbKDaeoyHvnJHqvbGqa",206,0.990431,40,209,2,207,1,2,1,3,2,109,108,99,99,36
"3185",84,"[40]HItHoIrouBkDsEGozDKotnbKDaeoyHvnJHqvbGqa",199,0.990099,40,202,2,200,1,2,1,3,2,99,98,102,102,36
"3186",85,"[40]HItHoIrouBkDsEGozDKotnbKDaeoyHvnJHqvbGqa",201,0.990196,40,204,2,202,1,2,1,3,2,102,101,101,101,36
"3187",86,"[40]HItHoIrouBkDsEGozDKotnbKDaeoyHvnJHqvbGqa",209,0.990566,40,212,2,210,1,2,1,3,2,111,110,100,100,36
"3188",87,"[40]HItHoIrouBkDsEGozDKotnbKDaeoyHvnJHqvbGqa",197,0.99,40,200,2,198,1,2,1,3,2,96,95,103,103,36
"3189",88,"[40]HItHoIrouBkDsEGozDKotnbKDaeoyHvnJHqvbGqa",200,0.990148,40,203,2,201,1,2,1,3,2,102,101,100,100,36
"3190",89,"[40]HItHoIrouBkDsEGozDKotnbKDaeoyHvnJHqvbGqa",211,0.990654,40,214,2,212,1,2,1,3,2,115,114,98,98,36
"3191",90,"[40]HItHoIrouBkDsEGozDKotnbKDaeoyHvnJHqvbGqa",216,0.990868,40,219,2,217,1,2,1,3,2,121,120,97,97,36
"3192",91,"[40]HItHoIrouBkDsEGozDKotnbKDaeoyHvnJHqvbGqa",193,0.989796,40,196,2,194,1,2,1,3,2,92,91,103,103,36
"3193",92,"[40]HItHoIrouBkDsEGozDKotnbKDaeoyHvnJHqvbGqa",199,0.990099,40,202,2,200,1,2,1,3,2,101,100,100,100,36
"3194",93,"[40]HItHoIrouBkDsEGozDKotnbKDaeoyHvnJHqvbGqa",208,0.990521,40,211,2,209,1,2,1,3,2,112,111,98,98,36
"3195",94,"[40]HItHoIrouBkDsEGozDKotnbKDaeoyHvnJHqvbGqa",189,0.989583,40,192,2,190,1,2,1,3,2,85,84,106,106,36
"3196",95,"[40]HItHoIrouBkDsEGozDKotnbKDaeoyHvnJHqvbGqa",205,0.990385,40,208,2,206,1,2,1,3,2,109,108,98,98,36
"3197",96,"[40]HItHoIrouBkDsEGozDKotnbKDaeoyHvnJHqvbGqa",196,0.98995,40,199,2,197,1,2,1,3,2,94,93,104,104,36
"3198",97,"[40]HItHoIrouBkDsEGozDKotnbKDaeoyHvnJHqvbGqa",183,0.989247,40,186,2,184,1,2,1,3,2,77,76,108,108,36
"3199",98,"[40]HItHoIrouBkDsEGozDKotnbKDaeoyHvnJHqvbGqa",191,0.989691,40,194,2,192,1,2,1,3,2,87,86,106,106,36
"3200",99,"[40]HItHoIrouBkDsEGozDKotnbKDaeoyHvnJHqvbGqa",192,0.989744,40,195,2,193,1,2,1,3,2,90,89,104,104,36
"3201",0,"[40]iIwHoIpxuBkDFKkHxCaDvrbKDaeAsHsnJHqvbGqa",209,0.990566,40,212,2,210,1,2,1,3,2,113,112,98,98,37
"3202",1,"[40]iIwHoIpxuBkDFKkHxCaDvrbKDaeAsHsnJHqvbGqa",180,0.989071,40,183,2,181,1,2,1,3,2,73,72,109,109,37
"3203",2,"[40]iIwHoIpxuBkDFKkHxCaDvrbKDaeAsHsnJHqvbGqa",198,0.99005,40,201,2,199,1,2,1,3,2,99,98,101,101,37
"3204",3,"[40]iIwHoIpxuBkDFKkHxCaDvrbKDaeAsHsnJHqvbGqa",209,0.990566,40,212,2,210,1,2,1,3,2,113,112,98,98,37
"3205",4,"[40]iIwHoIpxuBkDFKkHxCaDvrbKDaeAsHsnJHqvbGqa",203,0.990291,40,206,2,204,1,2,1,3,2,106,105,99,99,37
"3206",5,"[40]iIwHoIpxuBkDFKkHxCaDvrbKDaeAsHsnJHqvbGqa",193,0.989796,40,196,2,194,1,2,1,3,2,91,90,104,104,37
"3207",6,"[40]iIwHoIpxuBkDFKkHxCaDvrbKDaeAsHsnJHqvbGqa",219,0.990991,40,222,2,220,1,2,1,3,2,128,127,93,93,37
"3208",7,"[40]iIwHoIpxuBkDFKkHxCaDvrbKDaeAsHsnJHqvbGqa",207,0.990476,40,210,2,208,1,2,1,3,2,112,111,97,97,37
"3209",8,"[40]iIwHoIpxuBkDFKkHxCaDvrbKDaeAsHsnJHqvbGqa",200,0.990148,40,203,2,201,1,2,1,3,2,102,101,100,100,37
"3210",9,"[40]iIwHoIpxuBkDFKkHxCaDvrbKDaeAsHsnJHqvbGqa",195,0.989899,40,198,2,196,1,2,1,3,2,94,93,103,103,37
"3211",10,"[40]iIwHoIpxuBkDFKkHxCaDvrbKDaeAsHsnJHqvbGqa",191,0.989691,40,194,2,192,1,2,1,3,2,87,86,106,106,37
"3212",11,"[40]iIwHoIpxuBkDFKkHxCaDvrbKDaeAsHsnJHqvbGqa",209,0.990566,40,212,2,210,1,2,1,3,2,111,110,100,100,37
"3213",12,"[40]iIwHoIpxuBkDFKkHxCaDvrbKDaeAsHsnJHqvbGqa",210,0.99061,40,213,2,211,1,2,1,3,2,117,116,95,95,37
"3214",13,"[40]iIwHoIpxuBkDFKkHxCaDvrbKDaeAsHsnJHqvbGqa",187,0.989474,40,190,2,188,1,2,1,3,2,80,79,109,109,37
"3215",14,"[40]iIwHoIpxuBkDFKkHxCaDvrbKDaeAsHsnJHqvbGqa",201,0.990196,40,204,2,202,1,2,1,3,2,101,100,102,102,37
"3216",15,"[40]iIwHoIpxuBkDFKkHxCaDvrbKDaeAsHsnJHqvbGqa",203,0.990291,40,206,2,204,1,2,1,3,2,105,104,100,100,37
"3217",16,"[40]iIwHoIpxuBkDFKkHxCaDvrbKDaeAsHsnJHqvbGqa",195,0.989899,40,198,2,196,1,2,1,3,2,95,94,102,102,37
"3218",17,"[40]iIwHoIpxuBkDFKkHxCaDvrbKDaeAsHsnJHqvbGqa",196,0.98995,40,199,2,197,1,2,1,3,2,93,92,105,105,37
"3219",18,"[40]iIwHoIpxuBkDFKkHxCaDvrbKDaeAsHsnJHqvbGqa",190,0.989637,40,193,2,191,1,2,1,3,2,89,88,103,103,37
"3220",19,"[40]iIwHoIpxuBkDFKkHxCaDvrbKDaeAsHsnJHqvbGqa",220,0.991031,40,223,2,221,1,2,1,3,2,128,127,94,94,37
"3221",20,"[40]iIwHoIpxuBkDFKkHxCaDvrbKDaeAsHsnJHqvbGqa",214,0.990783,40,217,2,215,1,2,1,3,2,121,120,95,95,37
"3222",21,"[40]iIwHoIpxuBkDFKkHxCaDvrbKDaeAsHsnJHqvbGqa",210,0.99061,40,213,2,211,1,2,1,3,2,111,110,101,101,37
"3223",22,"[40]iIwHoIpxuBkDFKkHxCaDvrbKDaeAsHsnJHqvbGqa",206,0.990431,40,209,2,207,1,2,1,3,2,110,109,98,98,37
"3224",23,"[40]iIwHoIpxuBkDFKkHxCaDvrbKDaeAsHsnJHqvbGqa",196,0.98995,40,199,2,197,1,2,1,3,2,95,94,103,103,37
"3225",24,"[40]iIwHoIpxuBkDFKkHxCaDvrbKDaeAsHsnJHqvbGqa",199,0.990099,40,202,2,200,1,2,1,3,2,100,99,101,101,37
"3226",25,"[40]iIwHoIpxuBkDFKkHxCaDvrbKDaeAsHsnJHqvbGqa",194,0.989848,40,197,2,195,1,2,1,3,2,93,92,103,103,37
"3227",26,"[40]iIwHoIpxuBkDFKkHxCaDvrbKDaeAsHsnJHqvbGqa",208,0.990521,40,211,2,209,1,2,1,3,2,112,111,98,98,37
"3228",27,"[40]iIwHoIpxuBkDFKkHxCaDvrbKDaeAsHsnJHqvbGqa",191,0.989691,40,194,2,192,1,2,1,3,2,90,89,103,103,37
"3229",28,"[40]iIwHoIpxuBkDFKkHxCaDvrbKDaeAsHsnJHqvbGqa",205,0.990385,40,208,2,206,1,2,1,3,2,105,104,102,102,37
"3230",29,"[40]iIwHoIpxuBkDFKkHxCaDvrbKDaeAsHsnJHqvbGqa",205,0.990385,40,208,2,206,1,2,1,3,2,108,107,99,99,37
"3231",30,"[40]iIwHoIpxuBkDFKkHxCaDvrbKDaeAsHsnJHqvbGqa",199,0.990099,40,202,2,200,1,2,1,3,2,99,98,102,102,37
"3232",31,"[40]iIwHoIpxuBkDFKkHxCaDvrbKDaeAsHsnJHqvbGqa",210,0.99061,40,213,2,211,1,2,1,3,2,116,115,96,96,37
"3233",32,"[40]iIwHoIpxuBkDFKkHxCaDvrbKDaeAsHsnJHqvbGqa",200,0.990148,40,203,2,201,1,2,1,3,2,99,98,103,103,37
"3234",33,"[40]iIwHoIpxuBkDFKkHxCaDvrbKDaeAsHsnJHqvbGqa",209,0.990566,40,212,2,210,1,2,1,3,2,113,112,98,98,37
"3235",34,"[40]iIwHoIpxuBkDFKkHxCaDvrbKDaeAsHsnJHqvbGqa",185,0.989362,40,188,2,186,1,2,1,3,2,82,81,105,105,37
"3236",35,"[40]iIwHoIpxuBkDFKkHxCaDvrbKDaeAsHsnJHqvbGqa",193,0.989796,40,196,2,194,1,2,1,3,2,92,91,103,103,37
"3237",36,"[40]iIwHoIpxuBkDFKkHxCaDvrbKDaeAsHsnJHqvbGqa",197,0.99,40,200,2,198,1,2,1,3,2,98,97,101,101,37
"3238",37,"[40]iIwHoIpxuBkDFKkHxCaDvrbKDaeAsHsnJHqvbGqa",210,0.99061,40,213,2,211,1,2,1,3,2,114,113,98,98,37
"3239",38,"[40]iIwHoIpxuBkDFKkHxCaDvrbKDaeAsHsnJHqvbGqa",211,0.990654,40,214,2,212,1,2,1,3,2,113,112,100,100,37
"3240",39,"[40]iIwHoIpxuBkDFKkHxCaDvrbKDaeAsHsnJHqvbGqa",202,0.990244,40,205,2,203,1,2,1,3,2,102,101,102,102,37
"3241",40,"[40]iIwHoIpxuBkDFKkHxCaDvrbKDaeAsHsnJHqvbGqa",208,0.990521,40,211,2,209,1,2,1,3,2,111,110,99,99,37
"3242",41,"[40]iIwHoIpxuBkDFKkHxCaDvrbKDaeAsHsnJHqvbGqa",198,0.99005,40,201,2,199,1,2,1,3,2,98,97,102,102,37
"3243",42,"[40]iIwHoIpxuBkDFKkHxCaDvrbKDaeAsHsnJHqvbGqa",198,0.99005,40,201,2,199,1,2,1,3,2,97,96,103,103,37
"3244",43,"[40]iIwHoIpxuBkDFKkHxCaDvrbKDaeAsHsnJHqvbGqa",203,0.990291,40,206,2,204,1,2,1,3,2,104,103,101,101,37
"3245",44,"[40]iIwHoIpxuBkDFKkHxCaDvrbKDaeAsHsnJHqvbGqa",211,0.990654,40,214,2,212,1,2,1,3,2,116,115,97,97,37
"3246",45,"[40]iIwHoIpxuBkDFKkHxCaDvrbKDaeAsHsnJHqvbGqa",192,0.989744,40,195,2,193,1,2,1,3,2,87,86,107,107,37
"3247",46,"[40]iIwHoIpxuBkDFKkHxCaDvrbKDaeAsHsnJHqvbGqa",208,0.990521,40,211,2,209,1,2,1,3,2,111,110,99,99,37
"3248",47,"[40]iIwHoIpxuBkDFKkHxCaDvrbKDaeAsHsnJHqvbGqa",202,0.990244,40,205,2,203,1,2,1,3,2,106,105,98,98,37
"3249",48,"[40]iIwHoIpxuBkDFKkHxCaDvrbKDaeAsHsnJHqvbGqa",203,0.990291,40,206,2,204,1,2,1,3,2,103,102,102,102,37
"3250",49,"[40]iIwHoIpxuBkDFKkHxCaDvrbKDaeAsHsnJHqvbGqa",209,0.990566,40,212,2,210,1,2,1,3,2,113,112,98,98,37
"3251",50,"[40]iIwHoIpxuBkDFKkHxCaDvrbKDaeAsHsnJHqvbGqa",200,0.990148,40,203,2,201,1,2,1,3,2,100,99,102,102,37
"3252",51,"[40]iIwHoIpxuBkDFKkHxCaDvrbKDaeAsHsnJHqvbGqa",205,0.990385,40,208,2,206,1,2,1,3,2,108,107,99,99,37
"3253",52,"[40]iIwHoIpxuBkDFKkHxCaDvrbKDaeAsHsnJHqvbGqa",204,0.990338,40,207,2,205,1,2,1,3,2,106,105,100,100,37
"3254",53,"[40]iIwHoIpxuBkDFKkHxCaDvrbKDaeAsHsnJHqvbGqa",194,0.989848,40,197,2,195,1,2,1,3,2,96,95,100,100,37
"3255",54,"[40]iIwHoIpxuBkDFKkHxCaDvrbKDaeAsHsnJHqvbGqa",200,0.990148,40,203,2,201,1,2,1,3,2,102,101,100,100,37
"3256",55,"[40]iIwHoIpxuBkDFKkHxCaDvrbKDaeAsHsnJHqvbGqa",211,0.990654,40,214,2,212,1,2,1,3,2,116,115,97,97,37
"3257",56,"[40]iIwHoIpxuBkDFKkHxCaDvrbKDaeAsHsnJHqvbGqa",198,0.99005,40,201,2,199,1,2,1,3,2,100,99,100,100,37
"3258",57,"[40]iIwHoIpxuBkDFKkHxCaDvrbKDaeAsHsnJHqvbGqa",205,0.990385,40,208,2,206,1,2,1,3,2,107,106,100,100,37
"3259",58,"[40]iIwHoIpxuBkDFKkHxCaDvrbKDaeAsHsnJHqvbGqa",213,0.990741,40,216,2,214,1,2,1,3,2,119,118,96,96,37
"3260",59,"[40]iIwHoIpxuBkDFKkHxCaDvrbKDaeAsHsnJHqvbGqa",200,0.990148,40,203,2,201,1,2,1,3,2,101,100,101,101,37
"3261",60,"[40]iIwHoIpxuBkDFKkHxCaDvrbKDaeAsHsnJHqvbGqa",198,0.99005,40,201,2,199,1,2,1,3,2,99,98,101,101,37
"3262",61,"[40]iIwHoIpxuBkDFKkHxCaDvrbKDaeAsHsnJHqvbGqa",201,0.990196,40,204,2,202,1,2,1,3,2,103,102,100,100,37
"3263",62,"[40]iIwHoIpxuBkDFKkHxCaDvrbKDaeAsHsnJHqvbGqa",207,0.990476,40,210,2,208,1,2,1,3,2,112,111,97,97,37
"3264",63,"[40]iIwHoIpxuBkDFKkHxCaDvrbKDaeAsHsnJHqvbGqa",207,0.990476,40,210,2,208,1,2,1,3,2,108,107,101,101,37
"3265",64,"[40]iIwHoIpxuBkDFKkHxCaDvrbKDaeAsHsnJHqvbGqa",200,0.990148,40,203,2,201,1,2,1,3,2,99,98,103,103,37
"3266",65,"[40]iIwHoIpxuBkDFKkHxCaDvrbKDaeAsHsnJHqvbGqa",200,0.990148,40,203,2,201,1,2,1,3,2,102,101,100,100,37
"3267",66,"[40]iIwHoIpxuBkDFKkHxCaDvrbKDaeAsHsnJHqvbGqa",204,0.990338,40,207,2,205,1,2,1,3,2,108,107,98,98,37
"3268",67,"[40]iIwHoIpxuBkDFKkHxCaDvrbKDaeAsHsnJHqvbGqa",197,0.99,40,200,2,198,1,2,1,3,2,99,98,100,100,37
"3269",68,"[40]iIwHoIpxuBkDFKkHxCaDvrbKDaeAsHsnJHqvbGqa",207,0.990476,40,210,2,208,1,2,1,3,2,108,107,101,101,37
"3270",69,"[40]iIwHoIpxuBkDFKkHxCaDvrbKDaeAsHsnJHqvbGqa",204,0.990338,40,207,2,205,1,2,1,3,2,105,104,101,101,37
"3271",70,"[40]iIwHoIpxuBkDFKkHxCaDvrbKDaeAsHsnJHqvbGqa",195,0.989899,40,198,2,196,1,2,1,3,2,92,91,105,105,37
"3272",71,"[40]iIwHoIpxuBkDFKkHxCaDvrbKDaeAsHsnJHqvbGqa",195,0.989899,40,198,2,196,1,2,1,3,2,93,92,104,104,37
"3273",72,"[40]iIwHoIpxuBkDFKkHxCaDvrbKDaeAsHsnJHqvbGqa",198,0.99005,40,201,2,199,1,2,1,3,2,98,97,102,102,37
"3274",73,"[40]iIwHoIpxuBkDFKkHxCaDvrbKDaeAsHsnJHqvbGqa",197,0.99,40,200,2,198,1,2,1,3,2,97,96,102,102,37
"3275",74,"[40]iIwHoIpxuBkDFKkHxCaDvrbKDaeAsHsnJHqvbGqa",206,0.990431,40,209,2,207,1,2,1,3,2,109,108,99,99,37
"3276",75,"[40]iIwHoIpxuBkDFKkHxCaDvrbKDaeAsHsnJHqvbGqa",205,0.990385,40,208,2,206,1,2,1,3,2,107,106,100,100,37
"3277",76,"[40]iIwHoIpxuBkDFKkHxCaDvrbKDaeAsHsnJHqvbGqa",207,0.990476,40,210,2,208,1,2,1,3,2,109,108,100,100,37
"3278",77,"[40]iIwHoIpxuBkDFKkHxCaDvrbKDaeAsHsnJHqvbGqa",199,0.990099,40,202,2,200,1,2,1,3,2,99,98,102,102,37
"3279",78,"[40]iIwHoIpxuBkDFKkHxCaDvrbKDaeAsHsnJHqvbGqa",202,0.990244,40,205,2,203,1,2,1,3,2,103,102,101,101,37
"3280",79,"[40]iIwHoIpxuBkDFKkHxCaDvrbKDaeAsHsnJHqvbGqa",203,0.990291,40,206,2,204,1,2,1,3,2,104,103,101,101,37
"3281",80,"[40]iIwHoIpxuBkDFKkHxCaDvrbKDaeAsHsnJHqvbGqa",195,0.989899,40,198,2,196,1,2,1,3,2,93,92,104,104,37
"3282",81,"[40]iIwHoIpxuBkDFKkHxCaDvrbKDaeAsHsnJHqvbGqa",201,0.990196,40,204,2,202,1,2,1,3,2,103,102,100,100,37
"3283",82,"[40]iIwHoIpxuBkDFKkHxCaDvrbKDaeAsHsnJHqvbGqa",219,0.990991,40,222,2,220,1,2,1,3,2,127,126,94,94,37
"3284",83,"[40]iIwHoIpxuBkDFKkHxCaDvrbKDaeAsHsnJHqvbGqa",210,0.99061,40,213,2,211,1,2,1,3,2,116,115,96,96,37
"3285",84,"[40]iIwHoIpxuBkDFKkHxCaDvrbKDaeAsHsnJHqvbGqa",201,0.990196,40,204,2,202,1,2,1,3,2,102,101,101,101,37
"3286",85,"[40]iIwHoIpxuBkDFKkHxCaDvrbKDaeAsHsnJHqvbGqa",202,0.990244,40,205,2,203,1,2,1,3,2,103,102,101,101,37
"3287",86,"[40]iIwHoIpxuBkDFKkHxCaDvrbKDaeAsHsnJHqvbGqa",197,0.99,40,200,2,198,1,2,1,3,2,98,97,101,101,37
"3288",87,"[40]iIwHoIpxuBkDFKkHxCaDvrbKDaeAsHsnJHqvbGqa",218,0.99095,40,221,2,219,1,2,1,3,2,128,127,92,92,37
"3289",88,"[40]iIwHoIpxuBkDFKkHxCaDvrbKDaeAsHsnJHqvbGqa",215,0.990826,40,218,2,216,1,2,1,3,2,122,121,95,95,37
"3290",89,"[40]iIwHoIpxuBkDFKkHxCaDvrbKDaeAsHsnJHqvbGqa",200,0.990148,40,203,2,201,1,2,1,3,2,101,100,101,101,37
"3291",90,"[40]iIwHoIpxuBkDFKkHxCaDvrbKDaeAsHsnJHqvbGqa",202,0.990244,40,205,2,203,1,2,1,3,2,104,103,100,100,37
"3292",91,"[40]iIwHoIpxuBkDFKkHxCaDvrbKDaeAsHsnJHqvbGqa",196,0.98995,40,199,2,197,1,2,1,3,2,95,94,103,103,37
"3293",92,"[40]iIwHoIpxuBkDFKkHxCaDvrbKDaeAsHsnJHqvbGqa",198,0.99005,40,201,2,199,1,2,1,3,2,99,98,101,101,37
"3294",93,"[40]iIwHoIpxuBkDFKkHxCaDvrbKDaeAsHsnJHqvbGqa",203,0.990291,40,206,2,204,1,2,1,3,2,105,104,100,100,37
"3295",94,"[40]iIwHoIpxuBkDFKkHxCaDvrbKDaeAsHsnJHqvbGqa",198,0.99005,40,201,2,199,1,2,1,3,2,98,97,102,102,37
"3296",95,"[40]iIwHoIpxuBkDFKkHxCaDvrbKDaeAsHsnJHqvbGqa",218,0.99095,40,221,2,219,1,2,1,3,2,127,126,93,93,37
"3297",96,"[40]iIwHoIpxuBkDFKkHxCaDvrbKDaeAsHsnJHqvbGqa",199,0.990099,40,202,2,200,1,2,1,3,2,99,98,102,102,37
"3298",97,"[40]iIwHoIpxuBkDFKkHxCaDvrbKDaeAsHsnJHqvbGqa",220,0.991031,40,223,2,221,1,2,1,3,2,128,127,94,94,37
"3299",98,"[40]iIwHoIpxuBkDFKkHxCaDvrbKDaeAsHsnJHqvbGqa",201,0.990196,40,204,2,202,1,2,1,3,2,102,101,101,101,37
"3300",99,"[40]iIwHoIpxuBkDFKkHxCaDvrbKDaeAsHsnJHqvbGqa",213,0.990741,40,216,2,214,1,2,1,3,2,117,116,98,98,37
"3301",0,"[38]GIHuoIEEBvDtAxuczmFobKDeerBHtnJHqxbGqa",190,0.989637,38,193,2,191,1,2,1,3,2,85,84,107,107,38
"3302",1,"[38]GIHuoIEEBvDtAxuczmFobKDeerBHtnJHqxbGqa",191,0.989691,38,194,2,192,1,2,1,3,2,90,89,103,103,38
"3303",2,"[38]GIHuoIEEBvDtAxuczmFobKDeerBHtnJHqxbGqa",201,0.990196,38,204,2,202,1,2,1,3,2,100,99,103,103,38
"3304",3,"[38]GIHuoIEEBvDtAxuczmFobKDeerBHtnJHqxbGqa",209,0.990566,38,212,2,210,1,2,1,3,2,112,111,99,99,38
"3305",4,"[38]GIHuoIEEBvDtAxuczmFobKDeerBHtnJHqxbGqa",201,0.990196,38,204,2,202,1,2,1,3,2,101,100,102,102,38
"3306",5,"[38]GIHuoIEEBvDtAxuczmFobKDeerBHtnJHqxbGqa",192,0.989744,38,195,2,193,1,2,1,3,2,87,86,107,107,38
"3307",6,"[38]GIHuoIEEBvDtAxuczmFobKDeerBHtnJHqxbGqa",207,0.990476,38,210,2,208,1,2,1,3,2,110,109,99,99,38
"3308",7,"[38]GIHuoIEEBvDtAxuczmFobKDeerBHtnJHqxbGqa",206,0.990431,38,209,2,207,1,2,1,3,2,107,106,101,101,38
"3309",8,"[38]GIHuoIEEBvDtAxuczmFobKDeerBHtnJHqxbGqa",205,0.990385,38,208,2,206,1,2,1,3,2,105,104,102,102,38
"3310",9,"[38]GIHuoIEEBvDtAxuczmFobKDeerBHtnJHqxbGqa",213,0.990741,38,216,2,214,1,2,1,3,2,115,114,100,100,38
"3311",10,"[38]GIHuoIEEBvDtAxuczmFobKDeerBHtnJHqxbGqa",192,0.989744,38,195,2,193,1,2,1,3,2,87,86,107,107,38
"3312",11,"[38]GIHuoIEEBvDtAxuczmFobKDeerBHtnJHqxbGqa",204,0.990338,38,207,2,205,1,2,1,3,2,102,101,104,104,38
"3313",12,"[38]GIHuoIEEBvDtAxuczmFobKDeerBHtnJHqxbGqa",198,0.99005,38,201,2,199,1,2,1,3,2,97,96,103,103,38
"3314",13,"[38]GIHuoIEEBvDtAxuczmFobKDeerBHtnJHqxbGqa",213,0.990741,38,216,2,214,1,2,1,3,2,117,116,98,98,38
"3315",14,"[38]GIHuoIEEBvDtAxuczmFobKDeerBHtnJHqxbGqa",200,0.990148,38,203,2,201,1,2,1,3,2,101,100,101,101,38
"3316",15,"[38]GIHuoIEEBvDtAxuczmFobKDeerBHtnJHqxbGqa",193,0.989796,38,196,2,194,1,2,1,3,2,90,89,105,105,38
"3317",16,"[38]GIHuoIEEBvDtAxuczmFobKDeerBHtnJHqxbGqa",210,0.99061,38,213,2,211,1,2,1,3,2,115,114,97,97,38
"3318",17,"[38]GIHuoIEEBvDtAxuczmFobKDeerBHtnJHqxbGqa",207,0.990476,38,210,2,208,1,2,1,3,2,108,107,101,101,38
"3319",18,"[38]GIHuoIEEBvDtAxuczmFobKDeerBHtnJHqxbGqa",213,0.990741,38,216,2,214,1,2,1,3,2,119,118,96,96,38
"3320",19,"[38]GIHuoIEEBvDtAxuczmFobKDeerBHtnJHqxbGqa",210,0.99061,38,213,2,211,1,2,1,3,2,111,110,101,101,38
"3321",20,"[38]GIHuoIEEBvDtAxuczmFobKDeerBHtnJHqxbGqa",193,0.989796,38,196,2,194,1,2,1,3,2,89,88,106,106,38
"3322",21,"[38]GIHuoIEEBvDtAxuczmFobKDeerBHtnJHqxbGqa",197,0.99,38,200,2,198,1,2,1,3,2,95,94,104,104,38
"3323",22,"[38]GIHuoIEEBvDtAxuczmFobKDeerBHtnJHqxbGqa",207,0.990476,38,210,2,208,1,2,1,3,2,109,108,100,100,38
"3324",23,"[38]GIHuoIEEBvDtAxuczmFobKDeerBHtnJHqxbGqa",209,0.990566,38,212,2,210,1,2,1,3,2,114,113,97,97,38
"3325",24,"[38]GIHuoIEEBvDtAxuczmFobKDeerBHtnJHqxbGqa",200,0.990148,38,203,2,201,1,2,1,3,2,100,99,102,102,38
"3326",25,"[38]GIHuoIEEBvDtAxuczmFobKDeerBHtnJHqxbGqa",182,0.989189,38,185,2,183,1,2,1,3,2,76,75,108,108,38
"3327",26,"[38]GIHuoIEEBvDtAxuczmFobKDeerBHtnJHqxbGqa",189,0.989583,38,192,2,190,1,2,1,3,2,85,84,106,106,38
"3328",27,"[38]GIHuoIEEBvDtAxuczmFobKDeerBHtnJHqxbGqa",206,0.990431,38,209,2,207,1,2,1,3,2,107,106,101,101,38
"3329",28,"[38]GIHuoIEEBvDtAxuczmFobKDeerBHtnJHqxbGqa",190,0.989637,38,193,2,191,1,2,1,3,2,86,85,106,106,38
"3330",29,"[38]GIHuoIEEBvDtAxuczmFobKDeerBHtnJHqxbGqa",204,0.990338,38,207,2,205,1,2,1,3,2,105,104,101,101,38
"3331",30,"[38]GIHuoIEEBvDtAxuczmFobKDeerBHtnJHqxbGqa",198,0.99005,38,201,2,199,1,2,1,3,2,98,97,102,102,38
"3332",31,"[38]GIHuoIEEBvDtAxuczmFobKDeerBHtnJHqxbGqa",201,0.990196,38,204,2,202,1,2,1,3,2,101,100,102,102,38
"3333",32,"[38]GIHuoIEEBvDtAxuczmFobKDeerBHtnJHqxbGqa",209,0.990566,38,212,2,210,1,2,1,3,2,111,110,100,100,38
"3334",33,"[38]GIHuoIEEBvDtAxuczmFobKDeerBHtnJHqxbGqa",217,0.990909,38,220,2,218,1,2,1,3,2,124,123,95,95,38
"3335",34,"[38]GIHuoIEEBvDtAxuczmFobKDeerBHtnJHqxbGqa",206,0.990431,38,209,2,207,1,2,1,3,2,109,108,99,99,38
"3336",35,"[38]GIHuoIEEBvDtAxuczmFobKDeerBHtnJHqxbGqa",202,0.990244,38,205,2,203,1,2,1,3,2,103,102,101,101,38
"3337",36,"[38]GIHuoIEEBvDtAxuczmFobKDeerBHtnJHqxbGqa",191,0.989691,38,194,2,192,1,2,1,3,2,88,87,105,105,38
"3338",37,"[38]GIHuoIEEBvDtAxuczmFobKDeerBHtnJHqxbGqa",189,0.989583,38,192,2,190,1,2,1,3,2,85,84,106,106,38
"3339",38,"[38]GIHuoIEEBvDtAxuczmFobKDeerBHtnJHqxbGqa",209,0.990566,38,212,2,210,1,2,1,3,2,112,111,99,99,38
"3340",39,"[38]GIHuoIEEBvDtAxuczmFobKDeerBHtnJHqxbGqa",202,0.990244,38,205,2,203,1,2,1,3,2,101,100,103,103,38
"3341",40,"[38]GIHuoIEEBvDtAxuczmFobKDeerBHtnJHqxbGqa",205,0.990385,38,208,2,206,1,2,1,3,2,105,104,102,102,38
"3342",41,"[38]GIHuoIEEBvDtAxuczmFobKDeerBHtnJHqxbGqa",211,0.990654,38,214,2,212,1,2,1,3,2,115,114,98,98,38
"3343",42,"[38]GIHuoIEEBvDtAxuczmFobKDeerBHtnJHqxbGqa",210,0.99061,38,213,2,211,1,2,1,3,2,111,110,101,101,38
"3344",43,"[38]GIHuoIEEBvDtAxuczmFobKDeerBHtnJHqxbGqa",199,0.990099,38,202,2,200,1,2,1,3,2,98,97,103,103,38
"3345",44,"[38]GIHuoIEEBvDtAxuczmFobKDeerBHtnJHqxbGqa",191,0.989691,38,194,2,192,1,2,1,3,2,88,87,105,105,38
"3346",45,"[38]GIHuoIEEBvDtAxuczmFobKDeerBHtnJHqxbGqa",191,0.989691,38,194,2,192,1,2,1,3,2,86,85,107,107,38
"3347",46,"[38]GIHuoIEEBvDtAxuczmFobKDeerBHtnJHqxbGqa",203,0.990291,38,206,2,204,1,2,1,3,2,105,104,100,100,38
"3348",47,"[38]GIHuoIEEBvDtAxuczmFobKDeerBHtnJHqxbGqa",208,0.990521,38,211,2,209,1,2,1,3,2,111,110,99,99,38
"3349",48,"[38]GIHuoIEEBvDtAxuczmFobKDeerBHtnJHqxbGqa",203,0.990291,38,206,2,204,1,2,1,3,2,104,103,101,101,38
"3350",49,"[38]GIHuoIEEBvDtAxuczmFobKDeerBHtnJHqxbGqa",187,0.989474,38,190,2,188,1,2,1,3,2,81,80,108,108,38
"3351",50,"[38]GIHuoIEEBvDtAxuczmFobKDeerBHtnJHqxbGqa",209,0.990566,38,212,2,210,1,2,1,3,2,114,113,97,97,38
"3352",51,"[38]GIHuoIEEBvDtAxuczmFobKDeerBHtnJHqxbGqa",198,0.99005,38,201,2,199,1,2,1,3,2,96,95,104,104,38
"3353",52,"[38]GIHuoIEEBvDtAxuczmFobKDeerBHtnJHqxbGqa",192,0.989744,38,195,2,193,1,2,1,3,2,90,89,104,104,38
"3354",53,"[38]GIHuoIEEBvDtAxuczmFobKDeerBHtnJHqxbGqa",206,0.990431,38,209,2,207,1,2,1,3,2,105,104,103,103,38
"3355",54,"[38]GIHuoIEEBvDtAxuczmFobKDeerBHtnJHqxbGqa",222,0.991111,38,225,2,223,1,2,1,3,2,131,130,93,93,38
"3356",55,"[38]GIHuoIEEBvDtAxuczmFobKDeerBHtnJHqxbGqa",203,0.990291,38,206,2,204,1,2,1,3,2,106,105,99,99,38
"3357",56,"[38]GIHuoIEEBvDtAxuczmFobKDeerBHtnJHqxbGqa",204,0.990338,38,207,2,205,1,2,1,3,2,103,102,103,103,38
"3358",57,"[38]GIHuoIEEBvDtAxuczmFobKDeerBHtnJHqxbGqa",207,0.990476,38,210,2,208,1,2,1,3,2,111,110,98,98,38
"3359",58,"[38]GIHuoIEEBvDtAxuczmFobKDeerBHtnJHqxbGqa",213,0.990741,38,216,2,214,1,2,1,3,2,118,117,97,97,38
"3360",59,"[38]GIHuoIEEBvDtAxuczmFobKDeerBHtnJHqxbGqa",196,0.98995,38,199,2,197,1,2,1,3,2,95,94,103,103,38
"3361",60,"[38]GIHuoIEEBvDtAxuczmFobKDeerBHtnJHqxbGqa",179,0.989011,38,182,2,180,1,2,1,3,2,73,72,108,108,38
"3362",61,"[38]GIHuoIEEBvDtAxuczmFobKDeerBHtnJHqxbGqa",206,0.990431,38,209,2,207,1,2,1,3,2,108,107,100,100,38
"3363",62,"[38]GIHuoIEEBvDtAxuczmFobKDeerBHtnJHqxbGqa",207,0.990476,38,210,2,208,1,2,1,3,2,109,108,100,100,38
"3364",63,"[38]GIHuoIEEBvDtAxuczmFobKDeerBHtnJHqxbGqa",196,0.98995,38,199,2,197,1,2,1,3,2,93,92,105,105,38
"3365",64,"[38]GIHuoIEEBvDtAxuczmFobKDeerBHtnJHqxbGqa",195,0.989899,38,198,2,196,1,2,1,3,2,90,89,107,107,38
"3366",65,"[38]GIHuoIEEBvDtAxuczmFobKDeerBHtnJHqxbGqa",200,0.990148,38,203,2,201,1,2,1,3,2,100,99,102,102,38
"3367",66,"[38]GIHuoIEEBvDtAxuczmFobKDeerBHtnJHqxbGqa",199,0.990099,38,202,2,200,1,2,1,3,2,100,99,101,101,38
"3368",67,"[38]GIHuoIEEBvDtAxuczmFobKDeerBHtnJHqxbGqa",208,0.990521,38,211,2,209,1,2,1,3,2,113,112,97,97,38
"3369",68,"[38]GIHuoIEEBvDtAxuczmFobKDeerBHtnJHqxbGqa",207,0.990476,38,210,2,208,1,2,1,3,2,110,109,99,99,38
"3370",69,"[38]GIHuoIEEBvDtAxuczmFobKDeerBHtnJHqxbGqa",200,0.990148,38,203,2,201,1,2,1,3,2,99,98,103,103,38
"3371",70,"[38]GIHuoIEEBvDtAxuczmFobKDeerBHtnJHqxbGqa",219,0.990991,38,222,2,220,1,2,1,3,2,126,125,95,95,38
"3372",71,"[38]GIHuoIEEBvDtAxuczmFobKDeerBHtnJHqxbGqa",191,0.989691,38,194,2,192,1,2,1,3,2,89,88,104,104,38
"3373",72,"[38]GIHuoIEEBvDtAxuczmFobKDeerBHtnJHqxbGqa",198,0.99005,38,201,2,199,1,2,1,3,2,99,98,101,101,38
"3374",73,"[38]GIHuoIEEBvDtAxuczmFobKDeerBHtnJHqxbGqa",195,0.989899,38,198,2,196,1,2,1,3,2,95,94,102,102,38
"3375",74,"[38]GIHuoIEEBvDtAxuczmFobKDeerBHtnJHqxbGqa",198,0.99005,38,201,2,199,1,2,1,3,2,96,95,104,104,38
"3376",75,"[38]GIHuoIEEBvDtAxuczmFobKDeerBHtnJHqxbGqa",214,0.990783,38,217,2,215,1,2,1,3,2,117,116,99,99,38
"3377",76,"[38]GIHuoIEEBvDtAxuczmFobKDeerBHtnJHqxbGqa",210,0.99061,38,213,2,211,1,2,1,3,2,114,113,98,98,38
"3378",77,"[38]GIHuoIEEBvDtAxuczmFobKDeerBHtnJHqxbGqa",202,0.990244,38,205,2,203,1,2,1,3,2,103,102,101,101,38
"3379",78,"[38]GIHuoIEEBvDtAxuczmFobKDeerBHtnJHqxbGqa",209,0.990566,38,212,2,210,1,2,1,3,2,113,112,98,98,38
"3380",79,"[38]GIHuoIEEBvDtAxuczmFobKDeerBHtnJHqxbGqa",199,0.990099,38,202,2,200,1,2,1,3,2,100,99,101,101,38
"3381",80,"[38]GIHuoIEEBvDtAxuczmFobKDeerBHtnJHqxbGqa",189,0.989583,38,192,2,190,1,2,1,3,2,88,87,103,103,38
"3382",81,"[38]GIHuoIEEBvDtAxuczmFobKDeerBHtnJHqxbGqa",202,0.990244,38,205,2,203,1,2,1,3,2,103,102,101,101,38
"3383",82,"[38]GIHuoIEEBvDtAxuczmFobKDeerBHtnJHqxbGqa",187,0.989474,38,190,2,188,1,2,1,3,2,84,83,105,105,38
"3384",83,"[38]GIHuoIEEBvDtAxuczmFobKDeerBHtnJHqxbGqa",203,0.990291,38,206,2,204,1,2,1,3,2,105,104,100,100,38
"3385",84,"[38]GIHuoIEEBvDtAxuczmFobKDeerBHtnJHqxbGqa",209,0.990566,38,212,2,210,1,2,1,3,2,114,113,97,97,38
"3386",85,"[38]GIHuoIEEBvDtAxuczmFobKDeerBHtnJHqxbGqa",216,0.990868,38,219,2,217,1,2,1,3,2,123,122,95,95,38
"3387",86,"[38]GIHuoIEEBvDtAxuczmFobKDeerBHtnJHqxbGqa",209,0.990566,38,212,2,210,1,2,1,3,2,112,111,99,99,38
"3388",87,"[38]GIHuoIEEBvDtAxuczmFobKDeerBHtnJHqxbGqa",213,0.990741,38,216,2,214,1,2,1,3,2,117,116,98,98,38
"3389",88,"[38]GIHuoIEEBvDtAxuczmFobKDeerBHtnJHqxbGqa",195,0.989899,38,198,2,196,1,2,1,3,2,92,91,105,105,38
"3390",89,"[38]GIHuoIEEBvDtAxuczmFobKDeerBHtnJHqxbGqa",208,0.990521,38,211,2,209,1,2,1,3,2,110,109,100,100,38
"3391",90,"[38]GIHuoIEEBvDtAxuczmFobKDeerBHtnJHqxbGqa",206,0.990431,38,209,2,207,1,2,1,3,2,109,108,99,99,38
"3392",91,"[38]GIHuoIEEBvDtAxuczmFobKDeerBHtnJHqxbGqa",199,0.990099,38,202,2,200,1,2,1,3,2,97,96,104,104,38
"3393",92,"[38]GIHuoIEEBvDtAxuczmFobKDeerBHtnJHqxbGqa",218,0.99095,38,221,2,219,1,2,1,3,2,126,125,94,94,38
"3394",93,"[38]GIHuoIEEBvDtAxuczmFobKDeerBHtnJHqxbGqa",197,0.99,38,200,2,198,1,2,1,3,2,94,93,105,105,38
"3395",94,"[38]GIHuoIEEBvDtAxuczmFobKDeerBHtnJHqxbGqa",213,0.990741,38,216,2,214,1,2,1,3,2,121,120,94,94,38
"3396",95,"[38]GIHuoIEEBvDtAxuczmFobKDeerBHtnJHqxbGqa",200,0.990148,38,203,2,201,1,2,1,3,2,101,100,101,101,38
"3397",96,"[38]GIHuoIEEBvDtAxuczmFobKDeerBHtnJHqxbGqa",204,0.990338,38,207,2,205,1,2,1,3,2,107,106,99,99,38
"3398",97,"[38]GIHuoIEEBvDtAxuczmFobKDeerBHtnJHqxbGqa",193,0.989796,38,196,2,194,1,2,1,3,2,86,85,109,109,38
"3399",98,"[38]GIHuoIEEBvDtAxuczmFobKDeerBHtnJHqxbGqa",210,0.99061,38,213,2,211,1,2,1,3,2,114,113,98,98,38
"3400",99,"[38]GIHuoIEEBvDtAxuczmFobKDeerBHtnJHqxbGqa",197,0.99,38,200,2,198,1,2,1,3,2,97,96,102,102,38
"3401",0,"[40]jIuHoIfFnBkDCepBrnByiwbKDaeoyHwnJHqwbGqa",199,0.990099,40,202,2,200,1,2,1,3,2,98,97,103,103,39
"3402",1,"[40]jIuHoIfFnBkDCepBrnByiwbKDaeoyHwnJHqwbGqa",208,0.990521,40,211,2,209,1,2,1,3,2,112,111,98,98,39
"3403",2,"[40]jIuHoIfFnBkDCepBrnByiwbKDaeoyHwnJHqwbGqa",189,0.989583,40,192,2,190,1,2,1,3,2,87,86,104,104,39
"3404",3,"[40]jIuHoIfFnBkDCepBrnByiwbKDaeoyHwnJHqwbGqa",203,0.990291,40,206,2,204,1,2,1,3,2,107,106,98,98,39
"3405",4,"[40]jIuHoIfFnBkDCepBrnByiwbKDaeoyHwnJHqwbGqa",208,0.990521,40,211,2,209,1,2,1,3,2,112,111,98,98,39
"3406",5,"[40]jIuHoIfFnBkDCepBrnByiwbKDaeoyHwnJHqwbGqa",204,0.990338,40,207,2,205,1,2,1,3,2,105,104,101,101,39
"3407",6,"[40]jIuHoIfFnBkDCepBrnByiwbKDaeoyHwnJHqwbGqa",194,0.989848,40,197,2,195,1,2,1,3,2,93,92,103,103,39
"3408",7,"[40]jIuHoIfFnBkDCepBrnByiwbKDaeoyHwnJHqwbGqa",198,0.99005,40,201,2,199,1,2,1,3,2,98,97,102,102,39
"3409",8,"[40]jIuHoIfFnBkDCepBrnByiwbKDaeoyHwnJHqwbGqa",205,0.990385,40,208,2,206,1,2,1,3,2,111,110,96,96,39
"3410",9,"[40]jIuHoIfFnBkDCepBrnByiwbKDaeoyHwnJHqwbGqa",195,0.989899,40,198,2,196,1,2,1,3,2,95,94,102,102,39
"3411",10,"[40]jIuHoIfFnBkDCepBrnByiwbKDaeoyHwnJHqwbGqa",200,0.990148,40,203,2,201,1,2,1,3,2,98,97,104,104,39
"3412",11,"[40]jIuHoIfFnBkDCepBrnByiwbKDaeoyHwnJHqwbGqa",202,0.990244,40,205,2,203,1,2,1,3,2,104,103,100,100,39
"3413",12,"[40]jIuHoIfFnBkDCepBrnByiwbKDaeoyHwnJHqwbGqa",199,0.990099,40,202,2,200,1,2,1,3,2,98,97,103,103,39
"3414",13,"[40]jIuHoIfFnBkDCepBrnByiwbKDaeoyHwnJHqwbGqa",198,0.99005,40,201,2,199,1,2,1,3,2,99,98,101,101,39
"3415",14,"[40]jIuHoIfFnBkDCepBrnByiwbKDaeoyHwnJHqwbGqa",205,0.990385,40,208,2,206,1,2,1,3,2,107,106,100,100,39
"3416",15,"[40]jIuHoIfFnBkDCepBrnByiwbKDaeoyHwnJHqwbGqa",189,0.989583,40,192,2,190,1,2,1,3,2,87,86,104,104,39
"3417",16,"[40]jIuHoIfFnBkDCepBrnByiwbKDaeoyHwnJHqwbGqa",187,0.989474,40,190,2,188,1,2,1,3,2,84,83,105,105,39
"3418",17,"[40]jIuHoIfFnBkDCepBrnByiwbKDaeoyHwnJHqwbGqa",206,0.990431,40,209,2,207,1,2,1,3,2,107,106,101,101,39
"3419",18,"[40]jIuHoIfFnBkDCepBrnByiwbKDaeoyHwnJHqwbGqa",204,0.990338,40,207,2,205,1,2,1,3,2,106,105,100,100,39
"3420",19,"[40]jIuHoIfFnBkDCepBrnByiwbKDaeoyHwnJHqwbGqa",213,0.990741,40,216,2,214,1,2,1,3,2,118,117,97,97,39
"3421",20,"[40]jIuHoIfFnBkDCepBrnByiwbKDaeoyHwnJHqwbGqa",190,0.989637,40,193,2,191,1,2,1,3,2,89,88,103,103,39
"3422",21,"[40]jIuHoIfFnBkDCepBrnByiwbKDaeoyHwnJHqwbGqa",202,0.990244,40,205,2,203,1,2,1,3,2,102,101,102,102,39
"3423",22,"[40]jIuHoIfFnBkDCepBrnByiwbKDaeoyHwnJHqwbGqa",191,0.989691,40,194,2,192,1,2,1,3,2,90,89,103,103,39
"3424",23,"[40]jIuHoIfFnBkDCepBrnByiwbKDaeoyHwnJHqwbGqa",201,0.990196,40,204,2,202,1,2,1,3,2,103,102,100,100,39
"3425",24,"[40]jIuHoIfFnBkDCepBrnByiwbKDaeoyHwnJHqwbGqa",206,0.990431,40,209,2,207,1,2,1,3,2,109,108,99,99,39
"3426",25,"[40]jIuHoIfFnBkDCepBrnByiwbKDaeoyHwnJHqwbGqa",191,0.989691,40,194,2,192,1,2,1,3,2,89,88,104,104,39
"3427",26,"[40]jIuHoIfFnBkDCepBrnByiwbKDaeoyHwnJHqwbGqa",209,0.990566,40,212,2,210,1,2,1,3,2,113,112,98,98,39
"3428",27,"[40]jIuHoIfFnBkDCepBrnByiwbKDaeoyHwnJHqwbGqa",206,0.990431,40,209,2,207,1,2,1,3,2,111,110,97,97,39
"3429",28,"[40]jIuHoIfFnBkDCepBrnByiwbKDaeoyHwnJHqwbGqa",206,0.990431,40,209,2,207,1,2,1,3,2,109,108,99,99,39
"3430",29,"[40]jIuHoIfFnBkDCepBrnByiwbKDaeoyHwnJHqwbGqa",195,0.989899,40,198,2,196,1,2,1,3,2,94,93,103,103,39
"3431",30,"[40]jIuHoIfFnBkDCepBrnByiwbKDaeoyHwnJHqwbGqa",209,0.990566,40,212,2,210,1,2,1,3,2,113,112,98,98,39
"3432",31,"[40]jIuHoIfFnBkDCepBrnByiwbKDaeoyHwnJHqwbGqa",200,0.990148,40,203,2,201,1,2,1,3,2,99,98,103,103,39
"3433",32,"[40]jIuHoIfFnBkDCepBrnByiwbKDaeoyHwnJHqwbGqa",200,0.990148,40,203,2,201,1,2,1,3,2,102,101,100,100,39
"3434",33,"[40]jIuHoIfFnBkDCepBrnByiwbKDaeoyHwnJHqwbGqa",213,0.990741,40,216,2,214,1,2,1,3,2,117,116,98,98,39
"3435",34,"[40]jIuHoIfFnBkDCepBrnByiwbKDaeoyHwnJHqwbGqa",207,0.990476,40,210,2,208,1,2,1,3,2,109,108,100,100,39
"3436",35,"[40]jIuHoIfFnBkDCepBrnByiwbKDaeoyHwnJHqwbGqa",206,0.990431,40,209,2,207,1,2,1,3,2,110,109,98,98,39
"3437",36,"[40]jIuHoIfFnBkDCepBrnByiwbKDaeoyHwnJHqwbGqa",195,0.989899,40,198,2,196,1,2,1,3,2,95,94,102,102,39
"3438",37,"[40]jIuHoIfFnBkDCepBrnByiwbKDaeoyHwnJHqwbGqa",223,0.99115,40,226,2,224,1,2,1,3,2,131,130,94,94,39
"3439",38,"[40]jIuHoIfFnBkDCepBrnByiwbKDaeoyHwnJHqwbGqa",210,0.99061,40,213,2,211,1,2,1,3,2,115,114,97,97,39
"3440",39,"[40]jIuHoIfFnBkDCepBrnByiwbKDaeoyHwnJHqwbGqa",198,0.99005,40,201,2,199,1,2,1,3,2,97,96,103,103,39
"3441",40,"[40]jIuHoIfFnBkDCepBrnByiwbKDaeoyHwnJHqwbGqa",202,0.990244,40,205,2,203,1,2,1,3,2,103,102,101,101,39
"3442",41,"[40]jIuHoIfFnBkDCepBrnByiwbKDaeoyHwnJHqwbGqa",204,0.990338,40,207,2,205,1,2,1,3,2,106,105,100,100,39
"3443",42,"[40]jIuHoIfFnBkDCepBrnByiwbKDaeoyHwnJHqwbGqa",210,0.99061,40,213,2,211,1,2,1,3,2,117,116,95,95,39
"3444",43,"[40]jIuHoIfFnBkDCepBrnByiwbKDaeoyHwnJHqwbGqa",213,0.990741,40,216,2,214,1,2,1,3,2,118,117,97,97,39
"3445",44,"[40]jIuHoIfFnBkDCepBrnByiwbKDaeoyHwnJHqwbGqa",208,0.990521,40,211,2,209,1,2,1,3,2,112,111,98,98,39
"3446",45,"[40]jIuHoIfFnBkDCepBrnByiwbKDaeoyHwnJHqwbGqa",202,0.990244,40,205,2,203,1,2,1,3,2,107,106,97,97,39
"3447",46,"[40]jIuHoIfFnBkDCepBrnByiwbKDaeoyHwnJHqwbGqa",220,0.991031,40,223,2,221,1,2,1,3,2,128,127,94,94,39
"3448",47,"[40]jIuHoIfFnBkDCepBrnByiwbKDaeoyHwnJHqwbGqa",205,0.990385,40,208,2,206,1,2,1,3,2,110,109,97,97,39
"3449",48,"[40]jIuHoIfFnBkDCepBrnByiwbKDaeoyHwnJHqwbGqa",189,0.989583,40,192,2,190,1,2,1,3,2,87,86,104,104,39
"3450",49,"[40]jIuHoIfFnBkDCepBrnByiwbKDaeoyHwnJHqwbGqa",200,0.990148,40,203,2,201,1,2,1,3,2,101,100,101,101,39
"3451",50,"[40]jIuHoIfFnBkDCepBrnByiwbKDaeoyHwnJHqwbGqa",206,0.990431,40,209,2,207,1,2,1,3,2,109,108,99,99,39
"3452",51,"[40]jIuHoIfFnBkDCepBrnByiwbKDaeoyHwnJHqwbGqa",202,0.990244,40,205,2,203,1,2,1,3,2,103,102,101,101,39
"3453",52,"[40]jIuHoIfFnBkDCepBrnByiwbKDaeoyHwnJHqwbGqa",209,0.990566,40,212,2,210,1,2,1,3,2,114,113,97,97,39
"3454",53,"[40]jIuHoIfFnBkDCepBrnByiwbKDaeoyHwnJHqwbGqa",194,0.989848,40,197,2,195,1,2,1,3,2,92,91,104,104,39
"3455",54,"[40]jIuHoIfFnBkDCepBrnByiwbKDaeoyHwnJHqwbGqa",211,0.990654,40,214,2,212,1,2,1,3,2,115,114,98,98,39
"3456",55,"[40]jIuHoIfFnBkDCepBrnByiwbKDaeoyHwnJHqwbGqa",210,0.99061,40,213,2,211,1,2,1,3,2,114,113,98,98,39
"3457",56,"[40]jIuHoIfFnBkDCepBrnByiwbKDaeoyHwnJHqwbGqa",195,0.989899,40,198,2,196,1,2,1,3,2,95,94,102,102,39
"3458",57,"[40]jIuHoIfFnBkDCepBrnByiwbKDaeoyHwnJHqwbGqa",191,0.989691,40,194,2,192,1,2,1,3,2,90,89,103,103,39
"3459",58,"[40]jIuHoIfFnBkDCepBrnByiwbKDaeoyHwnJHqwbGqa",208,0.990521,40,211,2,209,1,2,1,3,2,110,109,100,100,39
"3460",59,"[40]jIuHoIfFnBkDCepBrnByiwbKDaeoyHwnJHqwbGqa",193,0.989796,40,196,2,194,1,2,1,3,2,92,91,103,103,39
"3461",60,"[40]jIuHoIfFnBkDCepBrnByiwbKDaeoyHwnJHqwbGqa",203,0.990291,40,206,2,204,1,2,1,3,2,106,105,99,99,39
"3462",61,"[40]jIuHoIfFnBkDCepBrnByiwbKDaeoyHwnJHqwbGqa",188,0.989529,40,191,2,189,1,2,1,3,2,85,84,105,105,39
"3463",62,"[40]jIuHoIfFnBkDCepBrnByiwbKDaeoyHwnJHqwbGqa",204,0.990338,40,207,2,205,1,2,1,3,2,105,104,101,101,39
"3464",63,"[40]jIuHoIfFnBkDCepBrnByiwbKDaeoyHwnJHqwbGqa",201,0.990196,40,204,2,202,1,2,1,3,2,103,102,100,100,39
"3465",64,"[40]jIuHoIfFnBkDCepBrnByiwbKDaeoyHwnJHqwbGqa",192,0.989744,40,195,2,193,1,2,1,3,2,90,89,104,104,39
"3466",65,"[40]jIuHoIfFnBkDCepBrnByiwbKDaeoyHwnJHqwbGqa",196,0.98995,40,199,2,197,1,2,1,3,2,93,92,105,105,39
"3467",66,"[40]jIuHoIfFnBkDCepBrnByiwbKDaeoyHwnJHqwbGqa",211,0.990654,40,214,2,212,1,2,1,3,2,114,113,99,99,39
"3468",67,"[40]jIuHoIfFnBkDCepBrnByiwbKDaeoyHwnJHqwbGqa",188,0.989529,40,191,2,189,1,2,1,3,2,83,82,107,107,39
"3469",68,"[40]jIuHoIfFnBkDCepBrnByiwbKDaeoyHwnJHqwbGqa",199,0.990099,40,202,2,200,1,2,1,3,2,99,98,102,102,39
"3470",69,"[40]jIuHoIfFnBkDCepBrnByiwbKDaeoyHwnJHqwbGqa",195,0.989899,40,198,2,196,1,2,1,3,2,96,95,101,101,39
"3471",70,"[40]jIuHoIfFnBkDCepBrnByiwbKDaeoyHwnJHqwbGqa",200,0.990148,40,203,2,201,1,2,1,3,2,102,101,100,100,39
"3472",71,"[40]jIuHoIfFnBkDCepBrnByiwbKDaeoyHwnJHqwbGqa",203,0.990291,40,206,2,204,1,2,1,3,2,104,103,101,101,39
"3473",72,"[40]jIuHoIfFnBkDCepBrnByiwbKDaeoyHwnJHqwbGqa",197,0.99,40,200,2,198,1,2,1,3,2,97,96,102,102,39
"3474",73,"[40]jIuHoIfFnBkDCepBrnByiwbKDaeoyHwnJHqwbGqa",200,0.990148,40,203,2,201,1,2,1,3,2,103,102,99,99,39
"3475",74,"[40]jIuHoIfFnBkDCepBrnByiwbKDaeoyHwnJHqwbGqa",208,0.990521,40,211,2,209,1,2,1,3,2,114,113,96,96,39
"3476",75,"[40]jIuHoIfFnBkDCepBrnByiwbKDaeoyHwnJHqwbGqa",191,0.989691,40,194,2,192,1,2,1,3,2,86,85,107,107,39
"3477",76,"[40]jIuHoIfFnBkDCepBrnByiwbKDaeoyHwnJHqwbGqa",196,0.98995,40,199,2,197,1,2,1,3,2,96,95,102,102,39
"3478",77,"[40]jIuHoIfFnBkDCepBrnByiwbKDaeoyHwnJHqwbGqa",206,0.990431,40,209,2,207,1,2,1,3,2,109,108,99,99,39
"3479",78,"[40]jIuHoIfFnBkDCepBrnByiwbKDaeoyHwnJHqwbGqa",211,0.990654,40,214,2,212,1,2,1,3,2,118,117,95,95,39
"3480",79,"[40]jIuHoIfFnBkDCepBrnByiwbKDaeoyHwnJHqwbGqa",195,0.989899,40,198,2,196,1,2,1,3,2,92,91,105,105,39
"3481",80,"[40]jIuHoIfFnBkDCepBrnByiwbKDaeoyHwnJHqwbGqa",202,0.990244,40,205,2,203,1,2,1,3,2,102,101,102,102,39
"3482",81,"[40]jIuHoIfFnBkDCepBrnByiwbKDaeoyHwnJHqwbGqa",202,0.990244,40,205,2,203,1,2,1,3,2,101,100,103,103,39
"3483",82,"[40]jIuHoIfFnBkDCepBrnByiwbKDaeoyHwnJHqwbGqa",188,0.989529,40,191,2,189,1,2,1,3,2,87,86,103,103,39
"3484",83,"[40]jIuHoIfFnBkDCepBrnByiwbKDaeoyHwnJHqwbGqa",198,0.99005,40,201,2,199,1,2,1,3,2,97,96,103,103,39
"3485",84,"[40]jIuHoIfFnBkDCepBrnByiwbKDaeoyHwnJHqwbGqa",205,0.990385,40,208,2,206,1,2,1,3,2,106,105,101,101,39
"3486",85,"[40]jIuHoIfFnBkDCepBrnByiwbKDaeoyHwnJHqwbGqa",204,0.990338,40,207,2,205,1,2,1,3,2,104,103,102,102,39
"3487",86,"[40]jIuHoIfFnBkDCepBrnByiwbKDaeoyHwnJHqwbGqa",220,0.991031,40,223,2,221,1,2,1,3,2,127,126,95,95,39
"3488",87,"[40]jIuHoIfFnBkDCepBrnByiwbKDaeoyHwnJHqwbGqa",199,0.990099,40,202,2,200,1,2,1,3,2,101,100,100,100,39
"3489",88,"[40]jIuHoIfFnBkDCepBrnByiwbKDaeoyHwnJHqwbGqa",202,0.990244,40,205,2,203,1,2,1,3,2,103,102,101,101,39
"3490",89,"[40]jIuHoIfFnBkDCepBrnByiwbKDaeoyHwnJHqwbGqa",202,0.990244,40,205,2,203,1,2,1,3,2,101,100,103,103,39
"3491",90,"[40]jIuHoIfFnBkDCepBrnByiwbKDaeoyHwnJHqwbGqa",213,0.990741,40,216,2,214,1,2,1,3,2,119,118,96,96,39
"3492",91,"[40]jIuHoIfFnBkDCepBrnByiwbKDaeoyHwnJHqwbGqa",210,0.99061,40,213,2,211,1,2,1,3,2,115,114,97,97,39
"3493",92,"[40]jIuHoIfFnBkDCepBrnByiwbKDaeoyHwnJHqwbGqa",210,0.99061,40,213,2,211,1,2,1,3,2,113,112,99,99,39
"3494",93,"[40]jIuHoIfFnBkDCepBrnByiwbKDaeoyHwnJHqwbGqa",195,0.989899,40,198,2,196,1,2,1,3,2,94,93,103,103,39
"3495",94,"[40]jIuHoIfFnBkDCepBrnByiwbKDaeoyHwnJHqwbGqa",222,0.991111,40,225,2,223,1,2,1,3,2,130,129,94,94,39
"3496",95,"[40]jIuHoIfFnBkDCepBrnByiwbKDaeoyHwnJHqwbGqa",185,0.989362,40,188,2,186,1,2,1,3,2,81,80,106,106,39
"3497",96,"[40]jIuHoIfFnBkDCepBrnByiwbKDaeoyHwnJHqwbGqa",210,0.99061,40,213,2,211,1,2,1,3,2,117,116,95,95,39
"3498",97,"[40]jIuHoIfFnBkDCepBrnByiwbKDaeoyHwnJHqwbGqa",207,0.990476,40,210,2,208,1,2,1,3,2,111,110,98,98,39
"3499",98,"[40]jIuHoIfFnBkDCepBrnByiwbKDaeoyHwnJHqwbGqa",206,0.990431,40,209,2,207,1,2,1,3,2,108,107,100,100,39
"3500",99,"[40]jIuHoIfFnBkDCepBrnByiwbKDaeoyHwnJHqwbGqa",212,0.990698,40,215,2,213,1,2,1,3,2,117,116,97,97,39
"3501",0,"[40]AIrHoIpFotBktDBJutIblvjrcpabKHtnJHqvbGqa",218,0.99095,40,221,2,219,1,2,1,3,2,115,114,105,105,40
"3502",1,"[40]AIrHoIpFotBktDBJutIblvjrcpabKHtnJHqvbGqa",219,0.990991,40,222,2,220,1,2,1,3,2,114,113,107,107,40
"3503",2,"[40]AIrHoIpFotBktDBJutIblvjrcpabKHtnJHqvbGqa",222,0.991111,40,225,2,223,1,2,1,3,2,120,119,104,104,40
"3504",3,"[40]AIrHoIpFotBktDBJutIblvjrcpabKHtnJHqvbGqa",216,0.990868,40,219,2,217,1,2,1,3,2,110,109,108,108,40
"3505",4,"[40]AIrHoIpFotBktDBJutIblvjrcpabKHtnJHqvbGqa",236,0.991632,40,239,2,237,1,2,1,3,2,137,136,101,101,40
"3506",5,"[40]AIrHoIpFotBktDBJutIblvjrcpabKHtnJHqvbGqa",206,0.990431,40,209,2,207,1,2,1,3,2,95,94,113,113,40
"3507",6,"[40]AIrHoIpFotBktDBJutIblvjrcpabKHtnJHqvbGqa",222,0.991111,40,225,2,223,1,2,1,3,2,119,118,105,105,40
"3508",7,"[40]AIrHoIpFotBktDBJutIblvjrcpabKHtnJHqvbGqa",226,0.991266,40,229,2,227,1,2,1,3,2,123,122,105,105,40
"3509",8,"[40]AIrHoIpFotBktDBJutIblvjrcpabKHtnJHqvbGqa",225,0.991228,40,228,2,226,1,2,1,3,2,122,121,105,105,40
"3510",9,"[40]AIrHoIpFotBktDBJutIblvjrcpabKHtnJHqvbGqa",213,0.990741,40,216,2,214,1,2,1,3,2,105,104,110,110,40
"3511",10,"[40]AIrHoIpFotBktDBJutIblvjrcpabKHtnJHqvbGqa",223,0.99115,40,226,2,224,1,2,1,3,2,121,120,104,104,40
"3512",11,"[40]AIrHoIpFotBktDBJutIblvjrcpabKHtnJHqvbGqa",228,0.991342,40,231,2,229,1,2,1,3,2,122,121,108,108,40
"3513",12,"[40]AIrHoIpFotBktDBJutIblvjrcpabKHtnJHqvbGqa",224,0.991189,40,227,2,225,1,2,1,3,2,122,121,104,104,40
"3514",13,"[40]AIrHoIpFotBktDBJutIblvjrcpabKHtnJHqvbGqa",211,0.990654,40,214,2,212,1,2,1,3,2,103,102,110,110,40
"3515",14,"[40]AIrHoIpFotBktDBJutIblvjrcpabKHtnJHqvbGqa",221,0.991071,40,224,2,222,1,2,1,3,2,116,115,107,107,40
"3516",15,"[40]AIrHoIpFotBktDBJutIblvjrcpabKHtnJHqvbGqa",203,0.990291,40,206,2,204,1,2,1,3,2,90,89,115,115,40
"3517",16,"[40]AIrHoIpFotBktDBJutIblvjrcpabKHtnJHqvbGqa",208,0.990521,40,211,2,209,1,2,1,3,2,100,99,110,110,40
"3518",17,"[40]AIrHoIpFotBktDBJutIblvjrcpabKHtnJHqvbGqa",212,0.990698,40,215,2,213,1,2,1,3,2,102,101,112,112,40
"3519",18,"[40]AIrHoIpFotBktDBJutIblvjrcpabKHtnJHqvbGqa",213,0.990741,40,216,2,214,1,2,1,3,2,107,106,108,108,40
"3520",19,"[40]AIrHoIpFotBktDBJutIblvjrcpabKHtnJHqvbGqa",218,0.99095,40,221,2,219,1,2,1,3,2,110,109,110,110,40
"3521",20,"[40]AIrHoIpFotBktDBJutIblvjrcpabKHtnJHqvbGqa",215,0.990826,40,218,2,216,1,2,1,3,2,108,107,109,109,40
"3522",21,"[40]AIrHoIpFotBktDBJutIblvjrcpabKHtnJHqvbGqa",226,0.991266,40,229,2,227,1,2,1,3,2,124,123,104,104,40
"3523",22,"[40]AIrHoIpFotBktDBJutIblvjrcpabKHtnJHqvbGqa",222,0.991111,40,225,2,223,1,2,1,3,2,121,120,103,103,40
"3524",23,"[40]AIrHoIpFotBktDBJutIblvjrcpabKHtnJHqvbGqa",204,0.990338,40,207,2,205,1,2,1,3,2,96,95,110,110,40
"3525",24,"[40]AIrHoIpFotBktDBJutIblvjrcpabKHtnJHqvbGqa",211,0.990654,40,214,2,212,1,2,1,3,2,102,101,111,111,40
"3526",25,"[40]AIrHoIpFotBktDBJutIblvjrcpabKHtnJHqvbGqa",209,0.990566,40,212,2,210,1,2,1,3,2,101,100,110,110,40
"3527",26,"[40]AIrHoIpFotBktDBJutIblvjrcpabKHtnJHqvbGqa",212,0.990698,40,215,2,213,1,2,1,3,2,105,104,109,109,40
"3528",27,"[40]AIrHoIpFotBktDBJutIblvjrcpabKHtnJHqvbGqa",219,0.990991,40,222,2,220,1,2,1,3,2,117,116,104,104,40
"3529",28,"[40]AIrHoIpFotBktDBJutIblvjrcpabKHtnJHqvbGqa",207,0.990476,40,210,2,208,1,2,1,3,2,98,97,111,111,40
"3530",29,"[40]AIrHoIpFotBktDBJutIblvjrcpabKHtnJHqvbGqa",208,0.990521,40,211,2,209,1,2,1,3,2,100,99,110,110,40
"3531",30,"[40]AIrHoIpFotBktDBJutIblvjrcpabKHtnJHqvbGqa",228,0.991342,40,231,2,229,1,2,1,3,2,126,125,104,104,40
"3532",31,"[40]AIrHoIpFotBktDBJutIblvjrcpabKHtnJHqvbGqa",226,0.991266,40,229,2,227,1,2,1,3,2,123,122,105,105,40
"3533",32,"[40]AIrHoIpFotBktDBJutIblvjrcpabKHtnJHqvbGqa",229,0.991379,40,232,2,230,1,2,1,3,2,125,124,106,106,40
"3534",33,"[40]AIrHoIpFotBktDBJutIblvjrcpabKHtnJHqvbGqa",229,0.991379,40,232,2,230,1,2,1,3,2,127,126,104,104,40
"3535",34,"[40]AIrHoIpFotBktDBJutIblvjrcpabKHtnJHqvbGqa",211,0.990654,40,214,2,212,1,2,1,3,2,104,103,109,109,40
"3536",35,"[40]AIrHoIpFotBktDBJutIblvjrcpabKHtnJHqvbGqa",228,0.991342,40,231,2,229,1,2,1,3,2,128,127,102,102,40
"3537",36,"[40]AIrHoIpFotBktDBJutIblvjrcpabKHtnJHqvbGqa",230,0.991416,40,233,2,231,1,2,1,3,2,129,128,103,103,40
"3538",37,"[40]AIrHoIpFotBktDBJutIblvjrcpabKHtnJHqvbGqa",222,0.991111,40,225,2,223,1,2,1,3,2,116,115,108,108,40
"3539",38,"[40]AIrHoIpFotBktDBJutIblvjrcpabKHtnJHqvbGqa",223,0.99115,40,226,2,224,1,2,1,3,2,123,122,102,102,40
"3540",39,"[40]AIrHoIpFotBktDBJutIblvjrcpabKHtnJHqvbGqa",212,0.990698,40,215,2,213,1,2,1,3,2,104,103,110,110,40
"3541",40,"[40]AIrHoIpFotBktDBJutIblvjrcpabKHtnJHqvbGqa",214,0.990783,40,217,2,215,1,2,1,3,2,107,106,109,109,40
"3542",41,"[40]AIrHoIpFotBktDBJutIblvjrcpabKHtnJHqvbGqa",215,0.990826,40,218,2,216,1,2,1,3,2,107,106,110,110,40
"3543",42,"[40]AIrHoIpFotBktDBJutIblvjrcpabKHtnJHqvbGqa",211,0.990654,40,214,2,212,1,2,1,3,2,103,102,110,110,40
"3544",43,"[40]AIrHoIpFotBktDBJutIblvjrcpabKHtnJHqvbGqa",221,0.991071,40,224,2,222,1,2,1,3,2,117,116,106,106,40
"3545",44,"[40]AIrHoIpFotBktDBJutIblvjrcpabKHtnJHqvbGqa",233,0.991525,40,236,2,234,1,2,1,3,2,128,127,107,107,40
"3546",45,"[40]AIrHoIpFotBktDBJutIblvjrcpabKHtnJHqvbGqa",209,0.990566,40,212,2,210,1,2,1,3,2,97,96,114,114,40
"3547",46,"[40]AIrHoIpFotBktDBJutIblvjrcpabKHtnJHqvbGqa",214,0.990783,40,217,2,215,1,2,1,3,2,108,107,108,108,40
"3548",47,"[40]AIrHoIpFotBktDBJutIblvjrcpabKHtnJHqvbGqa",221,0.991071,40,224,2,222,1,2,1,3,2,117,116,106,106,40
"3549",48,"[40]AIrHoIpFotBktDBJutIblvjrcpabKHtnJHqvbGqa",225,0.991228,40,228,2,226,1,2,1,3,2,120,119,107,107,40
"3550",49,"[40]AIrHoIpFotBktDBJutIblvjrcpabKHtnJHqvbGqa",220,0.991031,40,223,2,221,1,2,1,3,2,116,115,106,106,40
"3551",50,"[40]AIrHoIpFotBktDBJutIblvjrcpabKHtnJHqvbGqa",212,0.990698,40,215,2,213,1,2,1,3,2,102,101,112,112,40
"3552",51,"[40]AIrHoIpFotBktDBJutIblvjrcpabKHtnJHqvbGqa",226,0.991266,40,229,2,227,1,2,1,3,2,122,121,106,106,40
"3553",52,"[40]AIrHoIpFotBktDBJutIblvjrcpabKHtnJHqvbGqa",217,0.990909,40,220,2,218,1,2,1,3,2,111,110,108,108,40
"3554",53,"[40]AIrHoIpFotBktDBJutIblvjrcpabKHtnJHqvbGqa",215,0.990826,40,218,2,216,1,2,1,3,2,110,109,107,107,40
"3555",54,"[40]AIrHoIpFotBktDBJutIblvjrcpabKHtnJHqvbGqa",212,0.990698,40,215,2,213,1,2,1,3,2,106,105,108,108,40
"3556",55,"[40]AIrHoIpFotBktDBJutIblvjrcpabKHtnJHqvbGqa",217,0.990909,40,220,2,218,1,2,1,3,2,110,109,109,109,40
"3557",56,"[40]AIrHoIpFotBktDBJutIblvjrcpabKHtnJHqvbGqa",221,0.991071,40,224,2,222,1,2,1,3,2,118,117,105,105,40
"3558",57,"[40]AIrHoIpFotBktDBJutIblvjrcpabKHtnJHqvbGqa",223,0.99115,40,226,2,224,1,2,1,3,2,121,120,104,104,40
"3559",58,"[40]AIrHoIpFotBktDBJutIblvjrcpabKHtnJHqvbGqa",220,0.991031,40,223,2,221,1,2,1,3,2,115,114,107,107,40
"3560",59,"[40]AIrHoIpFotBktDBJutIblvjrcpabKHtnJHqvbGqa",216,0.990868,40,219,2,217,1,2,1,3,2,110,109,108,108,40
"3561",60,"[40]AIrHoIpFotBktDBJutIblvjrcpabKHtnJHqvbGqa",208,0.990521,40,211,2,209,1,2,1,3,2,100,99,110,110,40
"3562",61,"[40]AIrHoIpFotBktDBJutIblvjrcpabKHtnJHqvbGqa",219,0.990991,40,222,2,220,1,2,1,3,2,116,115,105,105,40
"3563",62,"[40]AIrHoIpFotBktDBJutIblvjrcpabKHtnJHqvbGqa",211,0.990654,40,214,2,212,1,2,1,3,2,103,102,110,110,40
"3564",63,"[40]AIrHoIpFotBktDBJutIblvjrcpabKHtnJHqvbGqa",215,0.990826,40,218,2,216,1,2,1,3,2,106,105,111,111,40
"3565",64,"[40]AIrHoIpFotBktDBJutIblvjrcpabKHtnJHqvbGqa",220,0.991031,40,223,2,221,1,2,1,3,2,114,113,108,108,40
"3566",65,"[40]AIrHoIpFotBktDBJutIblvjrcpabKHtnJHqvbGqa",225,0.991228,40,228,2,226,1,2,1,3,2,122,121,105,105,40
"3567",66,"[40]AIrHoIpFotBktDBJutIblvjrcpabKHtnJHqvbGqa",210,0.99061,40,213,2,211,1,2,1,3,2,100,99,112,112,40
"3568",67,"[40]AIrHoIpFotBktDBJutIblvjrcpabKHtnJHqvbGqa",211,0.990654,40,214,2,212,1,2,1,3,2,103,102,110,110,40
"3569",68,"[40]AIrHoIpFotBktDBJutIblvjrcpabKHtnJHqvbGqa",216,0.990868,40,219,2,217,1,2,1,3,2,110,109,108,108,40
"3570",69,"[40]AIrHoIpFotBktDBJutIblvjrcpabKHtnJHqvbGqa",227,0.991304,40,230,2,228,1,2,1,3,2,123,122,106,106,40
"3571",70,"[40]AIrHoIpFotBktDBJutIblvjrcpabKHtnJHqvbGqa",222,0.991111,40,225,2,223,1,2,1,3,2,115,114,109,109,40
"3572",71,"[40]AIrHoIpFotBktDBJutIblvjrcpabKHtnJHqvbGqa",225,0.991228,40,228,2,226,1,2,1,3,2,125,124,102,102,40
"3573",72,"[40]AIrHoIpFotBktDBJutIblvjrcpabKHtnJHqvbGqa",226,0.991266,40,229,2,227,1,2,1,3,2,124,123,104,104,40
"3574",73,"[40]AIrHoIpFotBktDBJutIblvjrcpabKHtnJHqvbGqa",214,0.990783,40,217,2,215,1,2,1,3,2,106,105,110,110,40
"3575",74,"[40]AIrHoIpFotBktDBJutIblvjrcpabKHtnJHqvbGqa",215,0.990826,40,218,2,216,1,2,1,3,2,112,111,105,105,40
"3576",75,"[40]AIrHoIpFotBktDBJutIblvjrcpabKHtnJHqvbGqa",218,0.99095,40,221,2,219,1,2,1,3,2,113,112,107,107,40
"3577",76,"[40]AIrHoIpFotBktDBJutIblvjrcpabKHtnJHqvbGqa",208,0.990521,40,211,2,209,1,2,1,3,2,98,97,112,112,40
"3578",77,"[40]AIrHoIpFotBktDBJutIblvjrcpabKHtnJHqvbGqa",226,0.991266,40,229,2,227,1,2,1,3,2,125,124,103,103,40
"3579",78,"[40]AIrHoIpFotBktDBJutIblvjrcpabKHtnJHqvbGqa",217,0.990909,40,220,2,218,1,2,1,3,2,113,112,106,106,40
"3580",79,"[40]AIrHoIpFotBktDBJutIblvjrcpabKHtnJHqvbGqa",209,0.990566,40,212,2,210,1,2,1,3,2,99,98,112,112,40
"3581",80,"[40]AIrHoIpFotBktDBJutIblvjrcpabKHtnJHqvbGqa",214,0.990783,40,217,2,215,1,2,1,3,2,107,106,109,109,40
"3582",81,"[40]AIrHoIpFotBktDBJutIblvjrcpabKHtnJHqvbGqa",225,0.991228,40,228,2,226,1,2,1,3,2,125,124,102,102,40
"3583",82,"[40]AIrHoIpFotBktDBJutIblvjrcpabKHtnJHqvbGqa",230,0.991416,40,233,2,231,1,2,1,3,2,127,126,105,105,40
"3584",83,"[40]AIrHoIpFotBktDBJutIblvjrcpabKHtnJHqvbGqa",211,0.990654,40,214,2,212,1,2,1,3,2,102,101,111,111,40
"3585",84,"[40]AIrHoIpFotBktDBJutIblvjrcpabKHtnJHqvbGqa",230,0.991416,40,233,2,231,1,2,1,3,2,127,126,105,105,40
"3586",85,"[40]AIrHoIpFotBktDBJutIblvjrcpabKHtnJHqvbGqa",216,0.990868,40,219,2,217,1,2,1,3,2,111,110,107,107,40
"3587",86,"[40]AIrHoIpFotBktDBJutIblvjrcpabKHtnJHqvbGqa",213,0.990741,40,216,2,214,1,2,1,3,2,108,107,107,107,40
"3588",87,"[40]AIrHoIpFotBktDBJutIblvjrcpabKHtnJHqvbGqa",202,0.990244,40,205,2,203,1,2,1,3,2,89,88,115,115,40
"3589",88,"[40]AIrHoIpFotBktDBJutIblvjrcpabKHtnJHqvbGqa",225,0.991228,40,228,2,226,1,2,1,3,2,121,120,106,106,40
"3590",89,"[40]AIrHoIpFotBktDBJutIblvjrcpabKHtnJHqvbGqa",212,0.990698,40,215,2,213,1,2,1,3,2,105,104,109,109,40
"3591",90,"[40]AIrHoIpFotBktDBJutIblvjrcpabKHtnJHqvbGqa",228,0.991342,40,231,2,229,1,2,1,3,2,131,130,99,99,40
"3592",91,"[40]AIrHoIpFotBktDBJutIblvjrcpabKHtnJHqvbGqa",226,0.991266,40,229,2,227,1,2,1,3,2,125,124,103,103,40
"3593",92,"[40]AIrHoIpFotBktDBJutIblvjrcpabKHtnJHqvbGqa",218,0.99095,40,221,2,219,1,2,1,3,2,114,113,106,106,40
"3594",93,"[40]AIrHoIpFotBktDBJutIblvjrcpabKHtnJHqvbGqa",206,0.990431,40,209,2,207,1,2,1,3,2,94,93,114,114,40
"3595",94,"[40]AIrHoIpFotBktDBJutIblvjrcpabKHtnJHqvbGqa",207,0.990476,40,210,2,208,1,2,1,3,2,95,94,114,114,40
"3596",95,"[40]AIrHoIpFotBktDBJutIblvjrcpabKHtnJHqvbGqa",217,0.990909,40,220,2,218,1,2,1,3,2,109,108,110,110,40
"3597",96,"[40]AIrHoIpFotBktDBJutIblvjrcpabKHtnJHqvbGqa",217,0.990909,40,220,2,218,1,2,1,3,2,110,109,109,109,40
"3598",97,"[40]AIrHoIpFotBktDBJutIblvjrcpabKHtnJHqvbGqa",216,0.990868,40,219,2,217,1,2,1,3,2,110,109,108,108,40
"3599",98,"[40]AIrHoIpFotBktDBJutIblvjrcpabKHtnJHqvbGqa",219,0.990991,40,222,2,220,1,2,1,3,2,113,112,108,108,40
"3600",99,"[40]AIrHoIpFotBktDBJutIblvjrcpabKHtnJHqvbGqa",217,0.990909,40,220,2,218,1,2,1,3,2,114,113,105,105,40
"3601",0,"[40]mIvHoIaoEBkuFDpkrmqIlFwJsjwbKHvnJHqvbGqa",206,0.990431,40,209,2,207,1,2,1,3,2,96,95,112,112,41
"3602",1,"[40]mIvHoIaoEBkuFDpkrmqIlFwJsjwbKHvnJHqvbGqa",213,0.990741,40,216,2,214,1,2,1,3,2,105,104,110,110,41
"3603",2,"[40]mIvHoIaoEBkuFDpkrmqIlFwJsjwbKHvnJHqvbGqa",222,0.991111,40,225,2,223,1,2,1,3,2,118,117,106,106,41
"3604",3,"[40]mIvHoIaoEBkuFDpkrmqIlFwJsjwbKHvnJHqvbGqa",213,0.990741,40,216,2,214,1,2,1,3,2,105,104,110,110,41
"3605",4,"[40]mIvHoIaoEBkuFDpkrmqIlFwJsjwbKHvnJHqvbGqa",224,0.991189,40,227,2,225,1,2,1,3,2,121,120,105,105,41
"3606",5,"[40]mIvHoIaoEBkuFDpkrmqIlFwJsjwbKHvnJHqvbGqa",215,0.990826,40,218,2,216,1,2,1,3,2,107,106,110,110,41
"3607",6,"[40]mIvHoIaoEBkuFDpkrmqIlFwJsjwbKHvnJHqvbGqa",217,0.990909,40,220,2,218,1,2,1,3,2,113,112,106,106,41
"3608",7,"[40]mIvHoIaoEBkuFDpkrmqIlFwJsjwbKHvnJHqvbGqa",219,0.990991,40,222,2,220,1,2,1,3,2,112,111,109,109,41
"3609",8,"[40]mIvHoIaoEBkuFDpkrmqIlFwJsjwbKHvnJHqvbGqa",216,0.990868,40,219,2,217,1,2,1,3,2,108,107,110,110,41
"3610",9,"[40]mIvHoIaoEBkuFDpkrmqIlFwJsjwbKHvnJHqvbGqa",227,0.991304,40,230,2,228,1,2,1,3,2,125,124,104,104,41
"3611",10,"[40]mIvHoIaoEBkuFDpkrmqIlFwJsjwbKHvnJHqvbGqa",211,0.990654,40,214,2,212,1,2,1,3,2,103,102,110,110,41
"3612",11,"[40]mIvHoIaoEBkuFDpkrmqIlFwJsjwbKHvnJHqvbGqa",215,0.990826,40,218,2,216,1,2,1,3,2,109,108,108,108,41
"3613",12,"[40]mIvHoIaoEBkuFDpkrmqIlFwJsjwbKHvnJHqvbGqa",227,0.991304,40,230,2,228,1,2,1,3,2,125,124,104,104,41
"3614",13,"[40]mIvHoIaoEBkuFDpkrmqIlFwJsjwbKHvnJHqvbGqa",214,0.990783,40,217,2,215,1,2,1,3,2,107,106,109,109,41
"3615",14,"[40]mIvHoIaoEBkuFDpkrmqIlFwJsjwbKHvnJHqvbGqa",215,0.990826,40,218,2,216,1,2,1,3,2,109,108,108,108,41
"3616",15,"[40]mIvHoIaoEBkuFDpkrmqIlFwJsjwbKHvnJHqvbGqa",203,0.990291,40,206,2,204,1,2,1,3,2,93,92,112,112,41
"3617",16,"[40]mIvHoIaoEBkuFDpkrmqIlFwJsjwbKHvnJHqvbGqa",236,0.991632,40,239,2,237,1,2,1,3,2,137,136,101,101,41
"3618",17,"[40]mIvHoIaoEBkuFDpkrmqIlFwJsjwbKHvnJHqvbGqa",224,0.991189,40,227,2,225,1,2,1,3,2,121,120,105,105,41
"3619",18,"[40]mIvHoIaoEBkuFDpkrmqIlFwJsjwbKHvnJHqvbGqa",215,0.990826,40,218,2,216,1,2,1,3,2,108,107,109,109,41
"3620",19,"[40]mIvHoIaoEBkuFDpkrmqIlFwJsjwbKHvnJHqvbGqa",210,0.99061,40,213,2,211,1,2,1,3,2,99,98,113,113,41
"3621",20,"[40]mIvHoIaoEBkuFDpkrmqIlFwJsjwbKHvnJHqvbGqa",223,0.99115,40,226,2,224,1,2,1,3,2,121,120,104,104,41
"3622",21,"[40]mIvHoIaoEBkuFDpkrmqIlFwJsjwbKHvnJHqvbGqa",221,0.991071,40,224,2,222,1,2,1,3,2,116,115,107,107,41
"3623",22,"[40]mIvHoIaoEBkuFDpkrmqIlFwJsjwbKHvnJHqvbGqa",222,0.991111,40,225,2,223,1,2,1,3,2,118,117,106,106,41
"3624",23,"[40]mIvHoIaoEBkuFDpkrmqIlFwJsjwbKHvnJHqvbGqa",209,0.990566,40,212,2,210,1,2,1,3,2,100,99,111,111,41
"3625",24,"[40]mIvHoIaoEBkuFDpkrmqIlFwJsjwbKHvnJHqvbGqa",203,0.990291,40,206,2,204,1,2,1,3,2,91,90,114,114,41
"3626",25,"[40]mIvHoIaoEBkuFDpkrmqIlFwJsjwbKHvnJHqvbGqa",226,0.991266,40,229,2,227,1,2,1,3,2,122,121,106,106,41
"3627",26,"[40]mIvHoIaoEBkuFDpkrmqIlFwJsjwbKHvnJHqvbGqa",219,0.990991,40,222,2,220,1,2,1,3,2,115,114,106,106,41
"3628",27,"[40]mIvHoIaoEBkuFDpkrmqIlFwJsjwbKHvnJHqvbGqa",232,0.991489,40,235,2,233,1,2,1,3,2,134,133,100,100,41
"3629",28,"[40]mIvHoIaoEBkuFDpkrmqIlFwJsjwbKHvnJHqvbGqa",233,0.991525,40,236,2,234,1,2,1,3,2,134,133,101,101,41
"3630",29,"[40]mIvHoIaoEBkuFDpkrmqIlFwJsjwbKHvnJHqvbGqa",230,0.991416,40,233,2,231,1,2,1,3,2,129,128,103,103,41
"3631",30,"[40]mIvHoIaoEBkuFDpkrmqIlFwJsjwbKHvnJHqvbGqa",220,0.991031,40,223,2,221,1,2,1,3,2,115,114,107,107,41
"3632",31,"[40]mIvHoIaoEBkuFDpkrmqIlFwJsjwbKHvnJHqvbGqa",215,0.990826,40,218,2,216,1,2,1,3,2,108,107,109,109,41
"3633",32,"[40]mIvHoIaoEBkuFDpkrmqIlFwJsjwbKHvnJHqvbGqa",211,0.990654,40,214,2,212,1,2,1,3,2,100,99,113,113,41
"3634",33,"[40]mIvHoIaoEBkuFDpkrmqIlFwJsjwbKHvnJHqvbGqa",218,0.99095,40,221,2,219,1,2,1,3,2,113,112,107,107,41
"3635",34,"[40]mIvHoIaoEBkuFDpkrmqIlFwJsjwbKHvnJHqvbGqa",221,0.991071,40,224,2,222,1,2,1,3,2,114,113,109,109,41
"3636",35,"[40]mIvHoIaoEBkuFDpkrmqIlFwJsjwbKHvnJHqvbGqa",215,0.990826,40,218,2,216,1,2,1,3,2,102,101,115,115,41
"3637",36,"[40]mIvHoIaoEBkuFDpkrmqIlFwJsjwbKHvnJHqvbGqa",211,0.990654,40,214,2,212,1,2,1,3,2,107,106,106,106,41
"3638",37,"[40]mIvHoIaoEBkuFDpkrmqIlFwJsjwbKHvnJHqvbGqa",210,0.99061,40,213,2,211,1,2,1,3,2,102,101,110,110,41
"3639",38,"[40]mIvHoIaoEBkuFDpkrmqIlFwJsjwbKHvnJHqvbGqa",219,0.990991,40,222,2,220,1,2,1,3,2,114,113,107,107,41
"3640",39,"[40]mIvHoIaoEBkuFDpkrmqIlFwJsjwbKHvnJHqvbGqa",231,0.991453,40,234,2,232,1,2,1,3,2,131,130,102,102,41
"3641",40,"[40]mIvHoIaoEBkuFDpkrmqIlFwJsjwbKHvnJHqvbGqa",215,0.990826,40,218,2,216,1,2,1,3,2,106,105,111,111,41
"3642",41,"[40]mIvHoIaoEBkuFDpkrmqIlFwJsjwbKHvnJHqvbGqa",205,0.990385,40,208,2,206,1,2,1,3,2,94,93,113,113,41
"3643",42,"[40]mIvHoIaoEBkuFDpkrmqIlFwJsjwbKHvnJHqvbGqa",219,0.990991,40,222,2,220,1,2,1,3,2,112,111,109,109,41
"3644",43,"[40]mIvHoIaoEBkuFDpkrmqIlFwJsjwbKHvnJHqvbGqa",210,0.99061,40,213,2,211,1,2,1,3,2,102,101,110,110,41
"3645",44,"[40]mIvHoIaoEBkuFDpkrmqIlFwJsjwbKHvnJHqvbGqa",215,0.990826,40,218,2,216,1,2,1,3,2,109,108,108,108,41
"3646",45,"[40]mIvHoIaoEBkuFDpkrmqIlFwJsjwbKHvnJHqvbGqa",225,0.991228,40,228,2,226,1,2,1,3,2,123,122,104,104,41
"3647",46,"[40]mIvHoIaoEBkuFDpkrmqIlFwJsjwbKHvnJHqvbGqa",213,0.990741,40,216,2,214,1,2,1,3,2,106,105,109,109,41
"3648",47,"[40]mIvHoIaoEBkuFDpkrmqIlFwJsjwbKHvnJHqvbGqa",213,0.990741,40,216,2,214,1,2,1,3,2,103,102,112,112,41
"3649",48,"[40]mIvHoIaoEBkuFDpkrmqIlFwJsjwbKHvnJHqvbGqa",221,0.991071,40,224,2,222,1,2,1,3,2,117,116,106,106,41
"3650",49,"[40]mIvHoIaoEBkuFDpkrmqIlFwJsjwbKHvnJHqvbGqa",226,0.991266,40,229,2,227,1,2,1,3,2,124,123,104,104,41
"3651",50,"[40]mIvHoIaoEBkuFDpkrmqIlFwJsjwbKHvnJHqvbGqa",224,0.991189,40,227,2,225,1,2,1,3,2,121,120,105,105,41
"3652",51,"[40]mIvHoIaoEBkuFDpkrmqIlFwJsjwbKHvnJHqvbGqa",221,0.991071,40,224,2,222,1,2,1,3,2,115,114,108,108,41
"3653",52,"[40]mIvHoIaoEBkuFDpkrmqIlFwJsjwbKHvnJHqvbGqa",214,0.990783,40,217,2,215,1,2,1,3,2,105,104,111,111,41
"3654",53,"[40]mIvHoIaoEBkuFDpkrmqIlFwJsjwbKHvnJHqvbGqa",219,0.990991,40,222,2,220,1,2,1,3,2,115,114,106,106,41
"3655",54,"[40]mIvHoIaoEBkuFDpkrmqIlFwJsjwbKHvnJHqvbGqa",219,0.990991,40,222,2,220,1,2,1,3,2,114,113,107,107,41
"3656",55,"[40]mIvHoIaoEBkuFDpkrmqIlFwJsjwbKHvnJHqvbGqa",219,0.990991,40,222,2,220,1,2,1,3,2,116,115,105,105,41
"3657",56,"[40]mIvHoIaoEBkuFDpkrmqIlFwJsjwbKHvnJHqvbGqa",221,0.991071,40,224,2,222,1,2,1,3,2,117,116,106,106,41
"3658",57,"[40]mIvHoIaoEBkuFDpkrmqIlFwJsjwbKHvnJHqvbGqa",226,0.991266,40,229,2,227,1,2,1,3,2,123,122,105,105,41
"3659",58,"[40]mIvHoIaoEBkuFDpkrmqIlFwJsjwbKHvnJHqvbGqa",224,0.991189,40,227,2,225,1,2,1,3,2,122,121,104,104,41
"3660",59,"[40]mIvHoIaoEBkuFDpkrmqIlFwJsjwbKHvnJHqvbGqa",216,0.990868,40,219,2,217,1,2,1,3,2,105,104,113,113,41
"3661",60,"[40]mIvHoIaoEBkuFDpkrmqIlFwJsjwbKHvnJHqvbGqa",221,0.991071,40,224,2,222,1,2,1,3,2,117,116,106,106,41
"3662",61,"[40]mIvHoIaoEBkuFDpkrmqIlFwJsjwbKHvnJHqvbGqa",219,0.990991,40,222,2,220,1,2,1,3,2,112,111,109,109,41
"3663",62,"[40]mIvHoIaoEBkuFDpkrmqIlFwJsjwbKHvnJHqvbGqa",211,0.990654,40,214,2,212,1,2,1,3,2,102,101,111,111,41
"3664",63,"[40]mIvHoIaoEBkuFDpkrmqIlFwJsjwbKHvnJHqvbGqa",209,0.990566,40,212,2,210,1,2,1,3,2,98,97,113,113,41
"3665",64,"[40]mIvHoIaoEBkuFDpkrmqIlFwJsjwbKHvnJHqvbGqa",210,0.99061,40,213,2,211,1,2,1,3,2,100,99,112,112,41
"3666",65,"[40]mIvHoIaoEBkuFDpkrmqIlFwJsjwbKHvnJHqvbGqa",216,0.990868,40,219,2,217,1,2,1,3,2,110,109,108,108,41
"3667",66,"[40]mIvHoIaoEBkuFDpkrmqIlFwJsjwbKHvnJHqvbGqa",202,0.990244,40,205,2,203,1,2,1,3,2,89,88,115,115,41
"3668",67,"[40]mIvHoIaoEBkuFDpkrmqIlFwJsjwbKHvnJHqvbGqa",211,0.990654,40,214,2,212,1,2,1,3,2,99,98,114,114,41
"3669",68,"[40]mIvHoIaoEBkuFDpkrmqIlFwJsjwbKHvnJHqvbGqa",224,0.991189,40,227,2,225,1,2,1,3,2,122,121,104,104,41
"3670",69,"[40]mIvHoIaoEBkuFDpkrmqIlFwJsjwbKHvnJHqvbGqa",216,0.990868,40,219,2,217,1,2,1,3,2,107,106,111,111,41
"3671",70,"[40]mIvHoIaoEBkuFDpkrmqIlFwJsjwbKHvnJHqvbGqa",228,0.991342,40,231,2,229,1,2,1,3,2,127,126,103,103,41
"3672",71,"[40]mIvHoIaoEBkuFDpkrmqIlFwJsjwbKHvnJHqvbGqa",227,0.991304,40,230,2,228,1,2,1,3,2,125,124,104,104,41
"3673",72,"[40]mIvHoIaoEBkuFDpkrmqIlFwJsjwbKHvnJHqvbGqa",229,0.991379,40,232,2,230,1,2,1,3,2,129,128,102,102,41
"3674",73,"[40]mIvHoIaoEBkuFDpkrmqIlFwJsjwbKHvnJHqvbGqa",212,0.990698,40,215,2,213,1,2,1,3,2,105,104,109,109,41
"3675",74,"[40]mIvHoIaoEBkuFDpkrmqIlFwJsjwbKHvnJHqvbGqa",210,0.99061,40,213,2,211,1,2,1,3,2,103,102,109,109,41
"3676",75,"[40]mIvHoIaoEBkuFDpkrmqIlFwJsjwbKHvnJHqvbGqa",216,0.990868,40,219,2,217,1,2,1,3,2,110,109,108,108,41
"3677",76,"[40]mIvHoIaoEBkuFDpkrmqIlFwJsjwbKHvnJHqvbGqa",219,0.990991,40,222,2,220,1,2,1,3,2,112,111,109,109,41
"3678",77,"[40]mIvHoIaoEBkuFDpkrmqIlFwJsjwbKHvnJHqvbGqa",215,0.990826,40,218,2,216,1,2,1,3,2,107,106,110,110,41
"3679",78,"[40]mIvHoIaoEBkuFDpkrmqIlFwJsjwbKHvnJHqvbGqa",213,0.990741,40,216,2,214,1,2,1,3,2,105,104,110,110,41
"3680",79,"[40]mIvHoIaoEBkuFDpkrmqIlFwJsjwbKHvnJHqvbGqa",226,0.991266,40,229,2,227,1,2,1,3,2,125,124,103,103,41
"3681",80,"[40]mIvHoIaoEBkuFDpkrmqIlFwJsjwbKHvnJHqvbGqa",215,0.990826,40,218,2,216,1,2,1,3,2,110,109,107,107,41
"3682",81,"[40]mIvHoIaoEBkuFDpkrmqIlFwJsjwbKHvnJHqvbGqa",214,0.990783,40,217,2,215,1,2,1,3,2,108,107,108,108,41
"3683",82,"[40]mIvHoIaoEBkuFDpkrmqIlFwJsjwbKHvnJHqvbGqa",238,0.991701,40,241,2,239,1,2,1,3,2,141,140,99,99,41
"3684",83,"[40]mIvHoIaoEBkuFDpkrmqIlFwJsjwbKHvnJHqvbGqa",201,0.990196,40,204,2,202,1,2,1,3,2,90,89,113,113,41
"3685",84,"[40]mIvHoIaoEBkuFDpkrmqIlFwJsjwbKHvnJHqvbGqa",225,0.991228,40,228,2,226,1,2,1,3,2,122,121,105,105,41
"3686",85,"[40]mIvHoIaoEBkuFDpkrmqIlFwJsjwbKHvnJHqvbGqa",230,0.991416,40,233,2,231,1,2,1,3,2,131,130,101,101,41
"3687",86,"[40]mIvHoIaoEBkuFDpkrmqIlFwJsjwbKHvnJHqvbGqa",218,0.99095,40,221,2,219,1,2,1,3,2,115,114,105,105,41
"3688",87,"[40]mIvHoIaoEBkuFDpkrmqIlFwJsjwbKHvnJHqvbGqa",222,0.991111,40,225,2,223,1,2,1,3,2,121,120,103,103,41
"3689",88,"[40]mIvHoIaoEBkuFDpkrmqIlFwJsjwbKHvnJHqvbGqa",203,0.990291,40,206,2,204,1,2,1,3,2,91,90,114,114,41
"3690",89,"[40]mIvHoIaoEBkuFDpkrmqIlFwJsjwbKHvnJHqvbGqa",222,0.991111,40,225,2,223,1,2,1,3,2,119,118,105,105,41
"3691",90,"[40]mIvHoIaoEBkuFDpkrmqIlFwJsjwbKHvnJHqvbGqa",217,0.990909,40,220,2,218,1,2,1,3,2,112,111,107,107,41
"3692",91,"[40]mIvHoIaoEBkuFDpkrmqIlFwJsjwbKHvnJHqvbGqa",218,0.99095,40,221,2,219,1,2,1,3,2,112,111,108,108,41
"3693",92,"[40]mIvHoIaoEBkuFDpkrmqIlFwJsjwbKHvnJHqvbGqa",224,0.991189,40,227,2,225,1,2,1,3,2,119,118,107,107,41
"3694",93,"[40]mIvHoIaoEBkuFDpkrmqIlFwJsjwbKHvnJHqvbGqa",223,0.99115,40,226,2,224,1,2,1,3,2,122,121,103,103,41
"3695",94,"[40]mIvHoIaoEBkuFDpkrmqIlFwJsjwbKHvnJHqvbGqa",219,0.990991,40,222,2,220,1,2,1,3,2,113,112,108,108,41
"3696",95,"[40]mIvHoIaoEBkuFDpkrmqIlFwJsjwbKHvnJHqvbGqa",212,0.990698,40,215,2,213,1,2,1,3,2,103,102,111,111,41
"3697",96,"[40]mIvHoIaoEBkuFDpkrmqIlFwJsjwbKHvnJHqvbGqa",211,0.990654,40,214,2,212,1,2,1,3,2,102,101,111,111,41
"3698",97,"[40]mIvHoIaoEBkuFDpkrmqIlFwJsjwbKHvnJHqvbGqa",214,0.990783,40,217,2,215,1,2,1,3,2,107,106,109,109,41
"3699",98,"[40]mIvHoIaoEBkuFDpkrmqIlFwJsjwbKHvnJHqvbGqa",218,0.99095,40,221,2,219,1,2,1,3,2,115,114,105,105,41
"3700",99,"[40]mIvHoIaoEBkuFDpkrmqIlFwJsjwbKHvnJHqvbGqa",223,0.99115,40,226,2,224,1,2,1,3,2,119,118,106,106,41
"3701",0,"[40]xIGHoIoeEBkvFDabnrCkkhbKDeesiHxnJHqvbGqa",211,0.990654,40,214,2,212,1,2,1,3,2,117,116,96,96,42
"3702",1,"[40]xIGHoIoeEBkvFDabnrCkkhbKDeesiHxnJHqvbGqa",202,0.990244,40,205,2,203,1,2,1,3,2,100,99,104,104,42
"3703",2,"[40]xIGHoIoeEBkvFDabnrCkkhbKDeesiHxnJHqvbGqa",206,0.990431,40,209,2,207,1,2,1,3,2,109,108,99,99,42
"3704",3,"[40]xIGHoIoeEBkvFDabnrCkkhbKDeesiHxnJHqvbGqa",195,0.989899,40,198,2,196,1,2,1,3,2,92,91,105,105,42
"3705",4,"[40]xIGHoIoeEBkvFDabnrCkkhbKDeesiHxnJHqvbGqa",204,0.990338,40,207,2,205,1,2,1,3,2,107,106,99,99,42
"3706",5,"[40]xIGHoIoeEBkvFDabnrCkkhbKDeesiHxnJHqvbGqa",202,0.990244,40,205,2,203,1,2,1,3,2,100,99,104,104,42
"3707",6,"[40]xIGHoIoeEBkvFDabnrCkkhbKDeesiHxnJHqvbGqa",218,0.99095,40,221,2,219,1,2,1,3,2,120,119,100,100,42
"3708",7,"[40]xIGHoIoeEBkvFDabnrCkkhbKDeesiHxnJHqvbGqa",198,0.99005,40,201,2,199,1,2,1,3,2,97,96,103,103,42
"3709",8,"[40]xIGHoIoeEBkvFDabnrCkkhbKDeesiHxnJHqvbGqa",200,0.990148,40,203,2,201,1,2,1,3,2,101,100,101,101,42
"3710",9,"[40]xIGHoIoeEBkvFDabnrCkkhbKDeesiHxnJHqvbGqa",187,0.989474,40,190,2,188,1,2,1,3,2,85,84,104,104,42
"3711",10,"[40]xIGHoIoeEBkvFDabnrCkkhbKDeesiHxnJHqvbGqa",209,0.990566,40,212,2,210,1,2,1,3,2,111,110,100,100,42
"3712",11,"[40]xIGHoIoeEBkvFDabnrCkkhbKDeesiHxnJHqvbGqa",213,0.990741,40,216,2,214,1,2,1,3,2,119,118,96,96,42
"3713",12,"[40]xIGHoIoeEBkvFDabnrCkkhbKDeesiHxnJHqvbGqa",208,0.990521,40,211,2,209,1,2,1,3,2,110,109,100,100,42
"3714",13,"[40]xIGHoIoeEBkvFDabnrCkkhbKDeesiHxnJHqvbGqa",205,0.990385,40,208,2,206,1,2,1,3,2,109,108,98,98,42
"3715",14,"[40]xIGHoIoeEBkvFDabnrCkkhbKDeesiHxnJHqvbGqa",208,0.990521,40,211,2,209,1,2,1,3,2,111,110,99,99,42
"3716",15,"[40]xIGHoIoeEBkvFDabnrCkkhbKDeesiHxnJHqvbGqa",206,0.990431,40,209,2,207,1,2,1,3,2,109,108,99,99,42
"3717",16,"[40]xIGHoIoeEBkvFDabnrCkkhbKDeesiHxnJHqvbGqa",194,0.989848,40,197,2,195,1,2,1,3,2,92,91,104,104,42
"3718",17,"[40]xIGHoIoeEBkvFDabnrCkkhbKDeesiHxnJHqvbGqa",201,0.990196,40,204,2,202,1,2,1,3,2,99,98,104,104,42
"3719",18,"[40]xIGHoIoeEBkvFDabnrCkkhbKDeesiHxnJHqvbGqa",198,0.99005,40,201,2,199,1,2,1,3,2,100,99,100,100,42
"3720",19,"[40]xIGHoIoeEBkvFDabnrCkkhbKDeesiHxnJHqvbGqa",206,0.990431,40,209,2,207,1,2,1,3,2,109,108,99,99,42
"3721",20,"[40]xIGHoIoeEBkvFDabnrCkkhbKDeesiHxnJHqvbGqa",220,0.991031,40,223,2,221,1,2,1,3,2,131,130,91,91,42
"3722",21,"[40]xIGHoIoeEBkvFDabnrCkkhbKDeesiHxnJHqvbGqa",215,0.990826,40,218,2,216,1,2,1,3,2,119,118,98,98,42
"3723",22,"[40]xIGHoIoeEBkvFDabnrCkkhbKDeesiHxnJHqvbGqa",203,0.990291,40,206,2,204,1,2,1,3,2,102,101,103,103,42
"3724",23,"[40]xIGHoIoeEBkvFDabnrCkkhbKDeesiHxnJHqvbGqa",213,0.990741,40,216,2,214,1,2,1,3,2,120,119,95,95,42
"3725",24,"[40]xIGHoIoeEBkvFDabnrCkkhbKDeesiHxnJHqvbGqa",211,0.990654,40,214,2,212,1,2,1,3,2,115,114,98,98,42
"3726",25,"[40]xIGHoIoeEBkvFDabnrCkkhbKDeesiHxnJHqvbGqa",195,0.989899,40,198,2,196,1,2,1,3,2,93,92,104,104,42
"3727",26,"[40]xIGHoIoeEBkvFDabnrCkkhbKDeesiHxnJHqvbGqa",203,0.990291,40,206,2,204,1,2,1,3,2,105,104,100,100,42
"3728",27,"[40]xIGHoIoeEBkvFDabnrCkkhbKDeesiHxnJHqvbGqa",223,0.99115,40,226,2,224,1,2,1,3,2,130,129,95,95,42
"3729",28,"[40]xIGHoIoeEBkvFDabnrCkkhbKDeesiHxnJHqvbGqa",199,0.990099,40,202,2,200,1,2,1,3,2,98,97,103,103,42
"3730",29,"[40]xIGHoIoeEBkvFDabnrCkkhbKDeesiHxnJHqvbGqa",195,0.989899,40,198,2,196,1,2,1,3,2,92,91,105,105,42
"3731",30,"[40]xIGHoIoeEBkvFDabnrCkkhbKDeesiHxnJHqvbGqa",206,0.990431,40,209,2,207,1,2,1,3,2,108,107,100,100,42
"3732",31,"[40]xIGHoIoeEBkvFDabnrCkkhbKDeesiHxnJHqvbGqa",205,0.990385,40,208,2,206,1,2,1,3,2,107,106,100,100,42
"3733",32,"[40]xIGHoIoeEBkvFDabnrCkkhbKDeesiHxnJHqvbGqa",195,0.989899,40,198,2,196,1,2,1,3,2,91,90,106,106,42
"3734",33,"[40]xIGHoIoeEBkvFDabnrCkkhbKDeesiHxnJHqvbGqa",200,0.990148,40,203,2,201,1,2,1,3,2,100,99,102,102,42
"3735",34,"[40]xIGHoIoeEBkvFDabnrCkkhbKDeesiHxnJHqvbGqa",201,0.990196,40,204,2,202,1,2,1,3,2,100,99,103,103,42
"3736",35,"[40]xIGHoIoeEBkvFDabnrCkkhbKDeesiHxnJHqvbGqa",204,0.990338,40,207,2,205,1,2,1,3,2,104,103,102,102,42
"3737",36,"[40]xIGHoIoeEBkvFDabnrCkkhbKDeesiHxnJHqvbGqa",208,0.990521,40,211,2,209,1,2,1,3,2,111,110,99,99,42
"3738",37,"[40]xIGHoIoeEBkvFDabnrCkkhbKDeesiHxnJHqvbGqa",203,0.990291,40,206,2,204,1,2,1,3,2,106,105,99,99,42
"3739",38,"[40]xIGHoIoeEBkvFDabnrCkkhbKDeesiHxnJHqvbGqa",197,0.99,40,200,2,198,1,2,1,3,2,95,94,104,104,42
"3740",39,"[40]xIGHoIoeEBkvFDabnrCkkhbKDeesiHxnJHqvbGqa",193,0.989796,40,196,2,194,1,2,1,3,2,91,90,104,104,42
"3741",40,"[40]xIGHoIoeEBkvFDabnrCkkhbKDeesiHxnJHqvbGqa",186,0.989418,40,189,2,187,1,2,1,3,2,81,80,107,107,42
"3742",41,"[40]xIGHoIoeEBkvFDabnrCkkhbKDeesiHxnJHqvbGqa",214,0.990783,40,217,2,215,1,2,1,3,2,122,121,94,94,42
"3743",42,"[40]xIGHoIoeEBkvFDabnrCkkhbKDeesiHxnJHqvbGqa",211,0.990654,40,214,2,212,1,2,1,3,2,112,111,101,101,42
"3744",43,"[40]xIGHoIoeEBkvFDabnrCkkhbKDeesiHxnJHqvbGqa",196,0.98995,40,199,2,197,1,2,1,3,2,95,94,103,103,42
"3745",44,"[40]xIGHoIoeEBkvFDabnrCkkhbKDeesiHxnJHqvbGqa",204,0.990338,40,207,2,205,1,2,1,3,2,105,104,101,101,42
"3746",45,"[40]xIGHoIoeEBkvFDabnrCkkhbKDeesiHxnJHqvbGqa",204,0.990338,40,207,2,205,1,2,1,3,2,106,105,100,100,42
"3747",46,"[40]xIGHoIoeEBkvFDabnrCkkhbKDeesiHxnJHqvbGqa",192,0.989744,40,195,2,193,1,2,1,3,2,91,90,103,103,42
"3748",47,"[40]xIGHoIoeEBkvFDabnrCkkhbKDeesiHxnJHqvbGqa",200,0.990148,40,203,2,201,1,2,1,3,2,99,98,103,103,42
"3749",48,"[40]xIGHoIoeEBkvFDabnrCkkhbKDeesiHxnJHqvbGqa",204,0.990338,40,207,2,205,1,2,1,3,2,108,107,98,98,42
"3750",49,"[40]xIGHoIoeEBkvFDabnrCkkhbKDeesiHxnJHqvbGqa",204,0.990338,40,207,2,205,1,2,1,3,2,105,104,101,101,42
"3751",50,"[40]xIGHoIoeEBkvFDabnrCkkhbKDeesiHxnJHqvbGqa",198,0.99005,40,201,2,199,1,2,1,3,2,99,98,101,101,42
"3752",51,"[40]xIGHoIoeEBkvFDabnrCkkhbKDeesiHxnJHqvbGqa",197,0.99,40,200,2,198,1,2,1,3,2,94,93,105,105,42
"3753",52,"[40]xIGHoIoeEBkvFDabnrCkkhbKDeesiHxnJHqvbGqa",202,0.990244,40,205,2,203,1,2,1,3,2,101,100,103,103,42
"3754",53,"[40]xIGHoIoeEBkvFDabnrCkkhbKDeesiHxnJHqvbGqa",195,0.989899,40,198,2,196,1,2,1,3,2,95,94,102,102,42
"3755",54,"[40]xIGHoIoeEBkvFDabnrCkkhbKDeesiHxnJHqvbGqa",204,0.990338,40,207,2,205,1,2,1,3,2,108,107,98,98,42
"3756",55,"[40]xIGHoIoeEBkvFDabnrCkkhbKDeesiHxnJHqvbGqa",210,0.99061,40,213,2,211,1,2,1,3,2,114,113,98,98,42
"3757",56,"[40]xIGHoIoeEBkvFDabnrCkkhbKDeesiHxnJHqvbGqa",194,0.989848,40,197,2,195,1,2,1,3,2,92,91,104,104,42
"3758",57,"[40]xIGHoIoeEBkvFDabnrCkkhbKDeesiHxnJHqvbGqa",202,0.990244,40,205,2,203,1,2,1,3,2,105,104,99,99,42
"3759",58,"[40]xIGHoIoeEBkvFDabnrCkkhbKDeesiHxnJHqvbGqa",208,0.990521,40,211,2,209,1,2,1,3,2,110,109,100,100,42
"3760",59,"[40]xIGHoIoeEBkvFDabnrCkkhbKDeesiHxnJHqvbGqa",201,0.990196,40,204,2,202,1,2,1,3,2,100,99,103,103,42
"3761",60,"[40]xIGHoIoeEBkvFDabnrCkkhbKDeesiHxnJHqvbGqa",215,0.990826,40,218,2,216,1,2,1,3,2,121,120,96,96,42
"3762",61,"[40]xIGHoIoeEBkvFDabnrCkkhbKDeesiHxnJHqvbGqa",208,0.990521,40,211,2,209,1,2,1,3,2,112,111,98,98,42
"3763",62,"[40]xIGHoIoeEBkvFDabnrCkkhbKDeesiHxnJHqvbGqa",192,0.989744,40,195,2,193,1,2,1,3,2,90,89,104,104,42
"3764",63,"[40]xIGHoIoeEBkvFDabnrCkkhbKDeesiHxnJHqvbGqa",188,0.989529,40,191,2,189,1,2,1,3,2,85,84,105,105,42
"3765",64,"[40]xIGHoIoeEBkvFDabnrCkkhbKDeesiHxnJHqvbGqa",197,0.99,40,200,2,198,1,2,1,3,2,99,98,100,100,42
"3766",65,"[40]xIGHoIoeEBkvFDabnrCkkhbKDeesiHxnJHqvbGqa",207,0.990476,40,210,2,208,1,2,1,3,2,107,106,102,102,42
"3767",66,"[40]xIGHoIoeEBkvFDabnrCkkhbKDeesiHxnJHqvbGqa",197,0.99,40,200,2,198,1,2,1,3,2,95,94,104,104,42
"3768",67,"[40]xIGHoIoeEBkvFDabnrCkkhbKDeesiHxnJHqvbGqa",192,0.989744,40,195,2,193,1,2,1,3,2,90,89,104,104,42
"3769",68,"[40]xIGHoIoeEBkvFDabnrCkkhbKDeesiHxnJHqvbGqa",212,0.990698,40,215,2,213,1,2,1,3,2,120,119,94,94,42
"3770",69,"[40]xIGHoIoeEBkvFDabnrCkkhbKDeesiHxnJHqvbGqa",213,0.990741,40,216,2,214,1,2,1,3,2,117,116,98,98,42
"3771",70,"[40]xIGHoIoeEBkvFDabnrCkkhbKDeesiHxnJHqvbGqa",207,0.990476,40,210,2,208,1,2,1,3,2,109,108,100,100,42
"3772",71,"[40]xIGHoIoeEBkvFDabnrCkkhbKDeesiHxnJHqvbGqa",198,0.99005,40,201,2,199,1,2,1,3,2,97,96,103,103,42
"3773",72,"[40]xIGHoIoeEBkvFDabnrCkkhbKDeesiHxnJHqvbGqa",209,0.990566,40,212,2,210,1,2,1,3,2,115,114,96,96,42
"3774",73,"[40]xIGHoIoeEBkvFDabnrCkkhbKDeesiHxnJHqvbGqa",197,0.99,40,200,2,198,1,2,1,3,2,97,96,102,102,42
"3775",74,"[40]xIGHoIoeEBkvFDabnrCkkhbKDeesiHxnJHqvbGqa",218,0.99095,40,221,2,219,1,2,1,3,2,130,129,90,90,42
"3776",75,"[40]xIGHoIoeEBkvFDabnrCkkhbKDeesiHxnJHqvbGqa",222,0.991111,40,225,2,223,1,2,1,3,2,131,130,93,93,42
"3777",76,"[40]xIGHoIoeEBkvFDabnrCkkhbKDeesiHxnJHqvbGqa",197,0.99,40,200,2,198,1,2,1,3,2,98,97,101,101,42
"3778",77,"[40]xIGHoIoeEBkvFDabnrCkkhbKDeesiHxnJHqvbGqa",191,0.989691,40,194,2,192,1,2,1,3,2,88,87,105,105,42
"3779",78,"[40]xIGHoIoeEBkvFDabnrCkkhbKDeesiHxnJHqvbGqa",203,0.990291,40,206,2,204,1,2,1,3,2,104,103,101,101,42
"3780",79,"[40]xIGHoIoeEBkvFDabnrCkkhbKDeesiHxnJHqvbGqa",194,0.989848,40,197,2,195,1,2,1,3,2,89,88,107,107,42
"3781",80,"[40]xIGHoIoeEBkvFDabnrCkkhbKDeesiHxnJHqvbGqa",185,0.989362,40,188,2,186,1,2,1,3,2,82,81,105,105,42
"3782",81,"[40]xIGHoIoeEBkvFDabnrCkkhbKDeesiHxnJHqvbGqa",212,0.990698,40,215,2,213,1,2,1,3,2,117,116,97,97,42
"3783",82,"[40]xIGHoIoeEBkvFDabnrCkkhbKDeesiHxnJHqvbGqa",220,0.991031,40,223,2,221,1,2,1,3,2,130,129,92,92,42
"3784",83,"[40]xIGHoIoeEBkvFDabnrCkkhbKDeesiHxnJHqvbGqa",181,0.98913,40,184,2,182,1,2,1,3,2,74,73,109,109,42
"3785",84,"[40]xIGHoIoeEBkvFDabnrCkkhbKDeesiHxnJHqvbGqa",198,0.99005,40,201,2,199,1,2,1,3,2,96,95,104,104,42
"3786",85,"[40]xIGHoIoeEBkvFDabnrCkkhbKDeesiHxnJHqvbGqa",211,0.990654,40,214,2,212,1,2,1,3,2,112,111,101,101,42
"3787",86,"[40]xIGHoIoeEBkvFDabnrCkkhbKDeesiHxnJHqvbGqa",198,0.99005,40,201,2,199,1,2,1,3,2,98,97,102,102,42
"3788",87,"[40]xIGHoIoeEBkvFDabnrCkkhbKDeesiHxnJHqvbGqa",197,0.99,40,200,2,198,1,2,1,3,2,97,96,102,102,42
"3789",88,"[40]xIGHoIoeEBkvFDabnrCkkhbKDeesiHxnJHqvbGqa",210,0.99061,40,213,2,211,1,2,1,3,2,114,113,98,98,42
"3790",89,"[40]xIGHoIoeEBkvFDabnrCkkhbKDeesiHxnJHqvbGqa",196,0.98995,40,199,2,197,1,2,1,3,2,95,94,103,103,42
"3791",90,"[40]xIGHoIoeEBkvFDabnrCkkhbKDeesiHxnJHqvbGqa",212,0.990698,40,215,2,213,1,2,1,3,2,115,114,99,99,42
"3792",91,"[40]xIGHoIoeEBkvFDabnrCkkhbKDeesiHxnJHqvbGqa",199,0.990099,40,202,2,200,1,2,1,3,2,98,97,103,103,42
"3793",92,"[40]xIGHoIoeEBkvFDabnrCkkhbKDeesiHxnJHqvbGqa",204,0.990338,40,207,2,205,1,2,1,3,2,104,103,102,102,42
"3794",93,"[40]xIGHoIoeEBkvFDabnrCkkhbKDeesiHxnJHqvbGqa",198,0.99005,40,201,2,199,1,2,1,3,2,98,97,102,102,42
"3795",94,"[40]xIGHoIoeEBkvFDabnrCkkhbKDeesiHxnJHqvbGqa",200,0.990148,40,203,2,201,1,2,1,3,2,100,99,102,102,42
"3796",95,"[40]xIGHoIoeEBkvFDabnrCkkhbKDeesiHxnJHqvbGqa",194,0.989848,40,197,2,195,1,2,1,3,2,91,90,105,105,42
"3797",96,"[40]xIGHoIoeEBkvFDabnrCkkhbKDeesiHxnJHqvbGqa",205,0.990385,40,208,2,206,1,2,1,3,2,107,106,100,100,42
"3798",97,"[40]xIGHoIoeEBkvFDabnrCkkhbKDeesiHxnJHqvbGqa",211,0.990654,40,214,2,212,1,2,1,3,2,117,116,96,96,42
"3799",98,"[40]xIGHoIoeEBkvFDabnrCkkhbKDeesiHxnJHqvbGqa",197,0.99,40,200,2,198,1,2,1,3,2,99,98,100,100,42
"3800",99,"[40]xIGHoIoeEBkvFDabnrCkkhbKDeesiHxnJHqvbGqa",194,0.989848,40,197,2,195,1,2,1,3,2,94,93,102,102,42
"3801",0,"[40]vIsHoIzEnBkDCeAnsynjtebKDeewxHwnJHqwbGqa",193,0.989796,40,196,2,194,1,2,1,3,2,91,90,104,104,44
"3802",1,"[40]vIsHoIzEnBkDCeAnsynjtebKDeewxHwnJHqwbGqa",205,0.990385,40,208,2,206,1,2,1,3,2,104,103,103,103,44
"3803",2,"[40]vIsHoIzEnBkDCeAnsynjtebKDeewxHwnJHqwbGqa",196,0.98995,40,199,2,197,1,2,1,3,2,96,95,102,102,44
"3804",3,"[40]vIsHoIzEnBkDCeAnsynjtebKDeewxHwnJHqwbGqa",197,0.99,40,200,2,198,1,2,1,3,2,97,96,102,102,44
"3805",4,"[40]vIsHoIzEnBkDCeAnsynjtebKDeewxHwnJHqwbGqa",204,0.990338,40,207,2,205,1,2,1,3,2,104,103,102,102,44
"3806",5,"[40]vIsHoIzEnBkDCeAnsynjtebKDeewxHwnJHqwbGqa",202,0.990244,40,205,2,203,1,2,1,3,2,102,101,102,102,44
"3807",6,"[40]vIsHoIzEnBkDCeAnsynjtebKDeewxHwnJHqwbGqa",196,0.98995,40,199,2,197,1,2,1,3,2,94,93,104,104,44
"3808",7,"[40]vIsHoIzEnBkDCeAnsynjtebKDeewxHwnJHqwbGqa",203,0.990291,40,206,2,204,1,2,1,3,2,107,106,98,98,44
"3809",8,"[40]vIsHoIzEnBkDCeAnsynjtebKDeewxHwnJHqwbGqa",207,0.990476,40,210,2,208,1,2,1,3,2,110,109,99,99,44
"3810",9,"[40]vIsHoIzEnBkDCeAnsynjtebKDeewxHwnJHqwbGqa",202,0.990244,40,205,2,203,1,2,1,3,2,104,103,100,100,44
"3811",10,"[40]vIsHoIzEnBkDCeAnsynjtebKDeewxHwnJHqwbGqa",202,0.990244,40,205,2,203,1,2,1,3,2,104,103,100,100,44
"3812",11,"[40]vIsHoIzEnBkDCeAnsynjtebKDeewxHwnJHqwbGqa",206,0.990431,40,209,2,207,1,2,1,3,2,107,106,101,101,44
"3813",12,"[40]vIsHoIzEnBkDCeAnsynjtebKDeewxHwnJHqwbGqa",186,0.989418,40,189,2,187,1,2,1,3,2,82,81,106,106,44
"3814",13,"[40]vIsHoIzEnBkDCeAnsynjtebKDeewxHwnJHqwbGqa",198,0.99005,40,201,2,199,1,2,1,3,2,97,96,103,103,44
"3815",14,"[40]vIsHoIzEnBkDCeAnsynjtebKDeewxHwnJHqwbGqa",204,0.990338,40,207,2,205,1,2,1,3,2,106,105,100,100,44
"3816",15,"[40]vIsHoIzEnBkDCeAnsynjtebKDeewxHwnJHqwbGqa",204,0.990338,40,207,2,205,1,2,1,3,2,107,106,99,99,44
"3817",16,"[40]vIsHoIzEnBkDCeAnsynjtebKDeewxHwnJHqwbGqa",196,0.98995,40,199,2,197,1,2,1,3,2,94,93,104,104,44
"3818",17,"[40]vIsHoIzEnBkDCeAnsynjtebKDeewxHwnJHqwbGqa",210,0.99061,40,213,2,211,1,2,1,3,2,117,116,95,95,44
"3819",18,"[40]vIsHoIzEnBkDCeAnsynjtebKDeewxHwnJHqwbGqa",215,0.990826,40,218,2,216,1,2,1,3,2,121,120,96,96,44
"3820",19,"[40]vIsHoIzEnBkDCeAnsynjtebKDeewxHwnJHqwbGqa",206,0.990431,40,209,2,207,1,2,1,3,2,105,104,103,103,44
"3821",20,"[40]vIsHoIzEnBkDCeAnsynjtebKDeewxHwnJHqwbGqa",202,0.990244,40,205,2,203,1,2,1,3,2,105,104,99,99,44
"3822",21,"[40]vIsHoIzEnBkDCeAnsynjtebKDeewxHwnJHqwbGqa",202,0.990244,40,205,2,203,1,2,1,3,2,104,103,100,100,44
"3823",22,"[40]vIsHoIzEnBkDCeAnsynjtebKDeewxHwnJHqwbGqa",197,0.99,40,200,2,198,1,2,1,3,2,96,95,103,103,44
"3824",23,"[40]vIsHoIzEnBkDCeAnsynjtebKDeewxHwnJHqwbGqa",183,0.989247,40,186,2,184,1,2,1,3,2,78,77,107,107,44
"3825",24,"[40]vIsHoIzEnBkDCeAnsynjtebKDeewxHwnJHqwbGqa",205,0.990385,40,208,2,206,1,2,1,3,2,108,107,99,99,44
"3826",25,"[40]vIsHoIzEnBkDCeAnsynjtebKDeewxHwnJHqwbGqa",213,0.990741,40,216,2,214,1,2,1,3,2,122,121,93,93,44
"3827",26,"[40]vIsHoIzEnBkDCeAnsynjtebKDeewxHwnJHqwbGqa",200,0.990148,40,203,2,201,1,2,1,3,2,101,100,101,101,44
"3828",27,"[40]vIsHoIzEnBkDCeAnsynjtebKDeewxHwnJHqwbGqa",205,0.990385,40,208,2,206,1,2,1,3,2,105,104,102,102,44
"3829",28,"[40]vIsHoIzEnBkDCeAnsynjtebKDeewxHwnJHqwbGqa",198,0.99005,40,201,2,199,1,2,1,3,2,98,97,102,102,44
"3830",29,"[40]vIsHoIzEnBkDCeAnsynjtebKDeewxHwnJHqwbGqa",201,0.990196,40,204,2,202,1,2,1,3,2,102,101,101,101,44
"3831",30,"[40]vIsHoIzEnBkDCeAnsynjtebKDeewxHwnJHqwbGqa",197,0.99,40,200,2,198,1,2,1,3,2,96,95,103,103,44
"3832",31,"[40]vIsHoIzEnBkDCeAnsynjtebKDeewxHwnJHqwbGqa",197,0.99,40,200,2,198,1,2,1,3,2,96,95,103,103,44
"3833",32,"[40]vIsHoIzEnBkDCeAnsynjtebKDeewxHwnJHqwbGqa",193,0.989796,40,196,2,194,1,2,1,3,2,90,89,105,105,44
"3834",33,"[40]vIsHoIzEnBkDCeAnsynjtebKDeewxHwnJHqwbGqa",191,0.989691,40,194,2,192,1,2,1,3,2,89,88,104,104,44
"3835",34,"[40]vIsHoIzEnBkDCeAnsynjtebKDeewxHwnJHqwbGqa",208,0.990521,40,211,2,209,1,2,1,3,2,111,110,99,99,44
"3836",35,"[40]vIsHoIzEnBkDCeAnsynjtebKDeewxHwnJHqwbGqa",201,0.990196,40,204,2,202,1,2,1,3,2,102,101,101,101,44
"3837",36,"[40]vIsHoIzEnBkDCeAnsynjtebKDeewxHwnJHqwbGqa",199,0.990099,40,202,2,200,1,2,1,3,2,100,99,101,101,44
"3838",37,"[40]vIsHoIzEnBkDCeAnsynjtebKDeewxHwnJHqwbGqa",198,0.99005,40,201,2,199,1,2,1,3,2,96,95,104,104,44
"3839",38,"[40]vIsHoIzEnBkDCeAnsynjtebKDeewxHwnJHqwbGqa",208,0.990521,40,211,2,209,1,2,1,3,2,113,112,97,97,44
"3840",39,"[40]vIsHoIzEnBkDCeAnsynjtebKDeewxHwnJHqwbGqa",210,0.99061,40,213,2,211,1,2,1,3,2,118,117,94,94,44
"3841",40,"[40]vIsHoIzEnBkDCeAnsynjtebKDeewxHwnJHqwbGqa",215,0.990826,40,218,2,216,1,2,1,3,2,122,121,95,95,44
"3842",41,"[40]vIsHoIzEnBkDCeAnsynjtebKDeewxHwnJHqwbGqa",208,0.990521,40,211,2,209,1,2,1,3,2,112,111,98,98,44
"3843",42,"[40]vIsHoIzEnBkDCeAnsynjtebKDeewxHwnJHqwbGqa",209,0.990566,40,212,2,210,1,2,1,3,2,109,108,102,102,44
"3844",43,"[40]vIsHoIzEnBkDCeAnsynjtebKDeewxHwnJHqwbGqa",213,0.990741,40,216,2,214,1,2,1,3,2,119,118,96,96,44
"3845",44,"[40]vIsHoIzEnBkDCeAnsynjtebKDeewxHwnJHqwbGqa",202,0.990244,40,205,2,203,1,2,1,3,2,100,99,104,104,44
"3846",45,"[40]vIsHoIzEnBkDCeAnsynjtebKDeewxHwnJHqwbGqa",187,0.989474,40,190,2,188,1,2,1,3,2,83,82,106,106,44
"3847",46,"[40]vIsHoIzEnBkDCeAnsynjtebKDeewxHwnJHqwbGqa",202,0.990244,40,205,2,203,1,2,1,3,2,107,106,97,97,44
"3848",47,"[40]vIsHoIzEnBkDCeAnsynjtebKDeewxHwnJHqwbGqa",196,0.98995,40,199,2,197,1,2,1,3,2,96,95,102,102,44
"3849",48,"[40]vIsHoIzEnBkDCeAnsynjtebKDeewxHwnJHqwbGqa",187,0.989474,40,190,2,188,1,2,1,3,2,84,83,105,105,44
"3850",49,"[40]vIsHoIzEnBkDCeAnsynjtebKDeewxHwnJHqwbGqa",199,0.990099,40,202,2,200,1,2,1,3,2,98,97,103,103,44
"3851",50,"[40]vIsHoIzEnBkDCeAnsynjtebKDeewxHwnJHqwbGqa",201,0.990196,40,204,2,202,1,2,1,3,2,101,100,102,102,44
"3852",51,"[40]vIsHoIzEnBkDCeAnsynjtebKDeewxHwnJHqwbGqa",198,0.99005,40,201,2,199,1,2,1,3,2,98,97,102,102,44
"3853",52,"[40]vIsHoIzEnBkDCeAnsynjtebKDeewxHwnJHqwbGqa",198,0.99005,40,201,2,199,1,2,1,3,2,96,95,104,104,44
"3854",53,"[40]vIsHoIzEnBkDCeAnsynjtebKDeewxHwnJHqwbGqa",211,0.990654,40,214,2,212,1,2,1,3,2,112,111,101,101,44
"3855",54,"[40]vIsHoIzEnBkDCeAnsynjtebKDeewxHwnJHqwbGqa",203,0.990291,40,206,2,204,1,2,1,3,2,105,104,100,100,44
"3856",55,"[40]vIsHoIzEnBkDCeAnsynjtebKDeewxHwnJHqwbGqa",200,0.990148,40,203,2,201,1,2,1,3,2,102,101,100,100,44
"3857",56,"[40]vIsHoIzEnBkDCeAnsynjtebKDeewxHwnJHqwbGqa",190,0.989637,40,193,2,191,1,2,1,3,2,88,87,104,104,44
"3858",57,"[40]vIsHoIzEnBkDCeAnsynjtebKDeewxHwnJHqwbGqa",204,0.990338,40,207,2,205,1,2,1,3,2,106,105,100,100,44
"3859",58,"[40]vIsHoIzEnBkDCeAnsynjtebKDeewxHwnJHqwbGqa",200,0.990148,40,203,2,201,1,2,1,3,2,102,101,100,100,44
"3860",59,"[40]vIsHoIzEnBkDCeAnsynjtebKDeewxHwnJHqwbGqa",200,0.990148,40,203,2,201,1,2,1,3,2,101,100,101,101,44
"3861",60,"[40]vIsHoIzEnBkDCeAnsynjtebKDeewxHwnJHqwbGqa",202,0.990244,40,205,2,203,1,2,1,3,2,104,103,100,100,44
"3862",61,"[40]vIsHoIzEnBkDCeAnsynjtebKDeewxHwnJHqwbGqa",216,0.990868,40,219,2,217,1,2,1,3,2,123,122,95,95,44
"3863",62,"[40]vIsHoIzEnBkDCeAnsynjtebKDeewxHwnJHqwbGqa",206,0.990431,40,209,2,207,1,2,1,3,2,111,110,97,97,44
"3864",63,"[40]vIsHoIzEnBkDCeAnsynjtebKDeewxHwnJHqwbGqa",191,0.989691,40,194,2,192,1,2,1,3,2,88,87,105,105,44
"3865",64,"[40]vIsHoIzEnBkDCeAnsynjtebKDeewxHwnJHqwbGqa",187,0.989474,40,190,2,188,1,2,1,3,2,85,84,104,104,44
"3866",65,"[40]vIsHoIzEnBkDCeAnsynjtebKDeewxHwnJHqwbGqa",200,0.990148,40,203,2,201,1,2,1,3,2,101,100,101,101,44
"3867",66,"[40]vIsHoIzEnBkDCeAnsynjtebKDeewxHwnJHqwbGqa",223,0.99115,40,226,2,224,1,2,1,3,2,132,131,93,93,44
"3868",67,"[40]vIsHoIzEnBkDCeAnsynjtebKDeewxHwnJHqwbGqa",195,0.989899,40,198,2,196,1,2,1,3,2,91,90,106,106,44
"3869",68,"[40]vIsHoIzEnBkDCeAnsynjtebKDeewxHwnJHqwbGqa",208,0.990521,40,211,2,209,1,2,1,3,2,114,113,96,96,44
"3870",69,"[40]vIsHoIzEnBkDCeAnsynjtebKDeewxHwnJHqwbGqa",191,0.989691,40,194,2,192,1,2,1,3,2,89,88,104,104,44
"3871",70,"[40]vIsHoIzEnBkDCeAnsynjtebKDeewxHwnJHqwbGqa",201,0.990196,40,204,2,202,1,2,1,3,2,101,100,102,102,44
"3872",71,"[40]vIsHoIzEnBkDCeAnsynjtebKDeewxHwnJHqwbGqa",202,0.990244,40,205,2,203,1,2,1,3,2,104,103,100,100,44
"3873",72,"[40]vIsHoIzEnBkDCeAnsynjtebKDeewxHwnJHqwbGqa",203,0.990291,40,206,2,204,1,2,1,3,2,105,104,100,100,44
"3874",73,"[40]vIsHoIzEnBkDCeAnsynjtebKDeewxHwnJHqwbGqa",213,0.990741,40,216,2,214,1,2,1,3,2,118,117,97,97,44
"3875",74,"[40]vIsHoIzEnBkDCeAnsynjtebKDeewxHwnJHqwbGqa",199,0.990099,40,202,2,200,1,2,1,3,2,99,98,102,102,44
"3876",75,"[40]vIsHoIzEnBkDCeAnsynjtebKDeewxHwnJHqwbGqa",197,0.99,40,200,2,198,1,2,1,3,2,95,94,104,104,44
"3877",76,"[40]vIsHoIzEnBkDCeAnsynjtebKDeewxHwnJHqwbGqa",192,0.989744,40,195,2,193,1,2,1,3,2,88,87,106,106,44
"3878",77,"[40]vIsHoIzEnBkDCeAnsynjtebKDeewxHwnJHqwbGqa",201,0.990196,40,204,2,202,1,2,1,3,2,102,101,101,101,44
"3879",78,"[40]vIsHoIzEnBkDCeAnsynjtebKDeewxHwnJHqwbGqa",199,0.990099,40,202,2,200,1,2,1,3,2,100,99,101,101,44
"3880",79,"[40]vIsHoIzEnBkDCeAnsynjtebKDeewxHwnJHqwbGqa",201,0.990196,40,204,2,202,1,2,1,3,2,104,103,99,99,44
"3881",80,"[40]vIsHoIzEnBkDCeAnsynjtebKDeewxHwnJHqwbGqa",222,0.991111,40,225,2,223,1,2,1,3,2,130,129,94,94,44
"3882",81,"[40]vIsHoIzEnBkDCeAnsynjtebKDeewxHwnJHqwbGqa",193,0.989796,40,196,2,194,1,2,1,3,2,90,89,105,105,44
"3883",82,"[40]vIsHoIzEnBkDCeAnsynjtebKDeewxHwnJHqwbGqa",210,0.99061,40,213,2,211,1,2,1,3,2,115,114,97,97,44
"3884",83,"[40]vIsHoIzEnBkDCeAnsynjtebKDeewxHwnJHqwbGqa",198,0.99005,40,201,2,199,1,2,1,3,2,97,96,103,103,44
"3885",84,"[40]vIsHoIzEnBkDCeAnsynjtebKDeewxHwnJHqwbGqa",196,0.98995,40,199,2,197,1,2,1,3,2,93,92,105,105,44
"3886",85,"[40]vIsHoIzEnBkDCeAnsynjtebKDeewxHwnJHqwbGqa",198,0.99005,40,201,2,199,1,2,1,3,2,97,96,103,103,44
"3887",86,"[40]vIsHoIzEnBkDCeAnsynjtebKDeewxHwnJHqwbGqa",208,0.990521,40,211,2,209,1,2,1,3,2,110,109,100,100,44
"3888",87,"[40]vIsHoIzEnBkDCeAnsynjtebKDeewxHwnJHqwbGqa",215,0.990826,40,218,2,216,1,2,1,3,2,122,121,95,95,44
"3889",88,"[40]vIsHoIzEnBkDCeAnsynjtebKDeewxHwnJHqwbGqa",194,0.989848,40,197,2,195,1,2,1,3,2,89,88,107,107,44
"3890",89,"[40]vIsHoIzEnBkDCeAnsynjtebKDeewxHwnJHqwbGqa",217,0.990909,40,220,2,218,1,2,1,3,2,122,121,97,97,44
"3891",90,"[40]vIsHoIzEnBkDCeAnsynjtebKDeewxHwnJHqwbGqa",215,0.990826,40,218,2,216,1,2,1,3,2,121,120,96,96,44
"3892",91,"[40]vIsHoIzEnBkDCeAnsynjtebKDeewxHwnJHqwbGqa",209,0.990566,40,212,2,210,1,2,1,3,2,114,113,97,97,44
"3893",92,"[40]vIsHoIzEnBkDCeAnsynjtebKDeewxHwnJHqwbGqa",202,0.990244,40,205,2,203,1,2,1,3,2,103,102,101,101,44
"3894",93,"[40]vIsHoIzEnBkDCeAnsynjtebKDeewxHwnJHqwbGqa",190,0.989637,40,193,2,191,1,2,1,3,2,87,86,105,105,44
"3895",94,"[40]vIsHoIzEnBkDCeAnsynjtebKDeewxHwnJHqwbGqa",208,0.990521,40,211,2,209,1,2,1,3,2,111,110,99,99,44
"3896",95,"[40]vIsHoIzEnBkDCeAnsynjtebKDeewxHwnJHqwbGqa",218,0.99095,40,221,2,219,1,2,1,3,2,125,124,95,95,44
"3897",96,"[40]vIsHoIzEnBkDCeAnsynjtebKDeewxHwnJHqwbGqa",188,0.989529,40,191,2,189,1,2,1,3,2,85,84,105,105,44
"3898",97,"[40]vIsHoIzEnBkDCeAnsynjtebKDeewxHwnJHqwbGqa",196,0.98995,40,199,2,197,1,2,1,3,2,95,94,103,103,44
"3899",98,"[40]vIsHoIzEnBkDCeAnsynjtebKDeewxHwnJHqwbGqa",203,0.990291,40,206,2,204,1,2,1,3,2,106,105,99,99,44
"3900",99,"[40]vIsHoIzEnBkDCeAnsynjtebKDeewxHwnJHqwbGqa",183,0.989247,40,186,2,184,1,2,1,3,2,77,76,108,108,44
"3901",0,"[40]FIbHoIvvxBkDIDpxvIsvkwbKDaeavHwnJHqvbGqa",200,0.990148,40,203,2,201,1,2,1,3,2,99,98,103,103,45
"3902",1,"[40]FIbHoIvvxBkDIDpxvIsvkwbKDaeavHwnJHqvbGqa",207,0.990476,40,210,2,208,1,2,1,3,2,111,110,98,98,45
"3903",2,"[40]FIbHoIvvxBkDIDpxvIsvkwbKDaeavHwnJHqvbGqa",225,0.991228,40,228,2,226,1,2,1,3,2,137,136,90,90,45
"3904",3,"[40]FIbHoIvvxBkDIDpxvIsvkwbKDaeavHwnJHqvbGqa",205,0.990385,40,208,2,206,1,2,1,3,2,106,105,101,101,45
"3905",4,"[40]FIbHoIvvxBkDIDpxvIsvkwbKDaeavHwnJHqvbGqa",199,0.990099,40,202,2,200,1,2,1,3,2,101,100,100,100,45
"3906",5,"[40]FIbHoIvvxBkDIDpxvIsvkwbKDaeavHwnJHqvbGqa",201,0.990196,40,204,2,202,1,2,1,3,2,105,104,98,98,45
"3907",6,"[40]FIbHoIvvxBkDIDpxvIsvkwbKDaeavHwnJHqvbGqa",190,0.989637,40,193,2,191,1,2,1,3,2,88,87,104,104,45
"3908",7,"[40]FIbHoIvvxBkDIDpxvIsvkwbKDaeavHwnJHqvbGqa",204,0.990338,40,207,2,205,1,2,1,3,2,109,108,97,97,45
"3909",8,"[40]FIbHoIvvxBkDIDpxvIsvkwbKDaeavHwnJHqvbGqa",195,0.989899,40,198,2,196,1,2,1,3,2,94,93,103,103,45
"3910",9,"[40]FIbHoIvvxBkDIDpxvIsvkwbKDaeavHwnJHqvbGqa",199,0.990099,40,202,2,200,1,2,1,3,2,98,97,103,103,45
"3911",10,"[40]FIbHoIvvxBkDIDpxvIsvkwbKDaeavHwnJHqvbGqa",196,0.98995,40,199,2,197,1,2,1,3,2,97,96,101,101,45
"3912",11,"[40]FIbHoIvvxBkDIDpxvIsvkwbKDaeavHwnJHqvbGqa",198,0.99005,40,201,2,199,1,2,1,3,2,98,97,102,102,45
"3913",12,"[40]FIbHoIvvxBkDIDpxvIsvkwbKDaeavHwnJHqvbGqa",217,0.990909,40,220,2,218,1,2,1,3,2,126,125,93,93,45
"3914",13,"[40]FIbHoIvvxBkDIDpxvIsvkwbKDaeavHwnJHqvbGqa",208,0.990521,40,211,2,209,1,2,1,3,2,114,113,96,96,45
"3915",14,"[40]FIbHoIvvxBkDIDpxvIsvkwbKDaeavHwnJHqvbGqa",216,0.990868,40,219,2,217,1,2,1,3,2,122,121,96,96,45
"3916",15,"[40]FIbHoIvvxBkDIDpxvIsvkwbKDaeavHwnJHqvbGqa",205,0.990385,40,208,2,206,1,2,1,3,2,106,105,101,101,45
"3917",16,"[40]FIbHoIvvxBkDIDpxvIsvkwbKDaeavHwnJHqvbGqa",194,0.989848,40,197,2,195,1,2,1,3,2,94,93,102,102,45
"3918",17,"[40]FIbHoIvvxBkDIDpxvIsvkwbKDaeavHwnJHqvbGqa",194,0.989848,40,197,2,195,1,2,1,3,2,93,92,103,103,45
"3919",18,"[40]FIbHoIvvxBkDIDpxvIsvkwbKDaeavHwnJHqvbGqa",200,0.990148,40,203,2,201,1,2,1,3,2,101,100,101,101,45
"3920",19,"[40]FIbHoIvvxBkDIDpxvIsvkwbKDaeavHwnJHqvbGqa",213,0.990741,40,216,2,214,1,2,1,3,2,119,118,96,96,45
"3921",20,"[40]FIbHoIvvxBkDIDpxvIsvkwbKDaeavHwnJHqvbGqa",207,0.990476,40,210,2,208,1,2,1,3,2,113,112,96,96,45
"3922",21,"[40]FIbHoIvvxBkDIDpxvIsvkwbKDaeavHwnJHqvbGqa",190,0.989637,40,193,2,191,1,2,1,3,2,88,87,104,104,45
"3923",22,"[40]FIbHoIvvxBkDIDpxvIsvkwbKDaeavHwnJHqvbGqa",209,0.990566,40,212,2,210,1,2,1,3,2,113,112,98,98,45
"3924",23,"[40]FIbHoIvvxBkDIDpxvIsvkwbKDaeavHwnJHqvbGqa",200,0.990148,40,203,2,201,1,2,1,3,2,102,101,100,100,45
"3925",24,"[40]FIbHoIvvxBkDIDpxvIsvkwbKDaeavHwnJHqvbGqa",202,0.990244,40,205,2,203,1,2,1,3,2,102,101,102,102,45
"3926",25,"[40]FIbHoIvvxBkDIDpxvIsvkwbKDaeavHwnJHqvbGqa",204,0.990338,40,207,2,205,1,2,1,3,2,106,105,100,100,45
"3927",26,"[40]FIbHoIvvxBkDIDpxvIsvkwbKDaeavHwnJHqvbGqa",193,0.989796,40,196,2,194,1,2,1,3,2,89,88,106,106,45
"3928",27,"[40]FIbHoIvvxBkDIDpxvIsvkwbKDaeavHwnJHqvbGqa",192,0.989744,40,195,2,193,1,2,1,3,2,91,90,103,103,45
"3929",28,"[40]FIbHoIvvxBkDIDpxvIsvkwbKDaeavHwnJHqvbGqa",208,0.990521,40,211,2,209,1,2,1,3,2,112,111,98,98,45
"3930",29,"[40]FIbHoIvvxBkDIDpxvIsvkwbKDaeavHwnJHqvbGqa",193,0.989796,40,196,2,194,1,2,1,3,2,91,90,104,104,45
"3931",30,"[40]FIbHoIvvxBkDIDpxvIsvkwbKDaeavHwnJHqvbGqa",198,0.99005,40,201,2,199,1,2,1,3,2,99,98,101,101,45
"3932",31,"[40]FIbHoIvvxBkDIDpxvIsvkwbKDaeavHwnJHqvbGqa",200,0.990148,40,203,2,201,1,2,1,3,2,100,99,102,102,45
"3933",32,"[40]FIbHoIvvxBkDIDpxvIsvkwbKDaeavHwnJHqvbGqa",185,0.989362,40,188,2,186,1,2,1,3,2,82,81,105,105,45
"3934",33,"[40]FIbHoIvvxBkDIDpxvIsvkwbKDaeavHwnJHqvbGqa",207,0.990476,40,210,2,208,1,2,1,3,2,111,110,98,98,45
"3935",34,"[40]FIbHoIvvxBkDIDpxvIsvkwbKDaeavHwnJHqvbGqa",190,0.989637,40,193,2,191,1,2,1,3,2,87,86,105,105,45
"3936",35,"[40]FIbHoIvvxBkDIDpxvIsvkwbKDaeavHwnJHqvbGqa",216,0.990868,40,219,2,217,1,2,1,3,2,125,124,93,93,45
"3937",36,"[40]FIbHoIvvxBkDIDpxvIsvkwbKDaeavHwnJHqvbGqa",212,0.990698,40,215,2,213,1,2,1,3,2,121,120,93,93,45
"3938",37,"[40]FIbHoIvvxBkDIDpxvIsvkwbKDaeavHwnJHqvbGqa",201,0.990196,40,204,2,202,1,2,1,3,2,103,102,100,100,45
"3939",38,"[40]FIbHoIvvxBkDIDpxvIsvkwbKDaeavHwnJHqvbGqa",188,0.989529,40,191,2,189,1,2,1,3,2,85,84,105,105,45
"3940",39,"[40]FIbHoIvvxBkDIDpxvIsvkwbKDaeavHwnJHqvbGqa",213,0.990741,40,216,2,214,1,2,1,3,2,116,115,99,99,45
"3941",40,"[40]FIbHoIvvxBkDIDpxvIsvkwbKDaeavHwnJHqvbGqa",205,0.990385,40,208,2,206,1,2,1,3,2,109,108,98,98,45
"3942",41,"[40]FIbHoIvvxBkDIDpxvIsvkwbKDaeavHwnJHqvbGqa",212,0.990698,40,215,2,213,1,2,1,3,2,119,118,95,95,45
"3943",42,"[40]FIbHoIvvxBkDIDpxvIsvkwbKDaeavHwnJHqvbGqa",199,0.990099,40,202,2,200,1,2,1,3,2,99,98,102,102,45
"3944",43,"[40]FIbHoIvvxBkDIDpxvIsvkwbKDaeavHwnJHqvbGqa",188,0.989529,40,191,2,189,1,2,1,3,2,86,85,104,104,45
"3945",44,"[40]FIbHoIvvxBkDIDpxvIsvkwbKDaeavHwnJHqvbGqa",192,0.989744,40,195,2,193,1,2,1,3,2,91,90,103,103,45
"3946",45,"[40]FIbHoIvvxBkDIDpxvIsvkwbKDaeavHwnJHqvbGqa",192,0.989744,40,195,2,193,1,2,1,3,2,90,89,104,104,45
"3947",46,"[40]FIbHoIvvxBkDIDpxvIsvkwbKDaeavHwnJHqvbGqa",201,0.990196,40,204,2,202,1,2,1,3,2,101,100,102,102,45
"3948",47,"[40]FIbHoIvvxBkDIDpxvIsvkwbKDaeavHwnJHqvbGqa",193,0.989796,40,196,2,194,1,2,1,3,2,90,89,105,105,45
"3949",48,"[40]FIbHoIvvxBkDIDpxvIsvkwbKDaeavHwnJHqvbGqa",208,0.990521,40,211,2,209,1,2,1,3,2,111,110,99,99,45
"3950",49,"[40]FIbHoIvvxBkDIDpxvIsvkwbKDaeavHwnJHqvbGqa",219,0.990991,40,222,2,220,1,2,1,3,2,128,127,93,93,45
"3951",50,"[40]FIbHoIvvxBkDIDpxvIsvkwbKDaeavHwnJHqvbGqa",210,0.99061,40,213,2,211,1,2,1,3,2,113,112,99,99,45
"3952",51,"[40]FIbHoIvvxBkDIDpxvIsvkwbKDaeavHwnJHqvbGqa",207,0.990476,40,210,2,208,1,2,1,3,2,111,110,98,98,45
"3953",52,"[40]FIbHoIvvxBkDIDpxvIsvkwbKDaeavHwnJHqvbGqa",200,0.990148,40,203,2,201,1,2,1,3,2,103,102,99,99,45
"3954",53,"[40]FIbHoIvvxBkDIDpxvIsvkwbKDaeavHwnJHqvbGqa",201,0.990196,40,204,2,202,1,2,1,3,2,101,100,102,102,45
"3955",54,"[40]FIbHoIvvxBkDIDpxvIsvkwbKDaeavHwnJHqvbGqa",197,0.99,40,200,2,198,1,2,1,3,2,98,97,101,101,45
"3956",55,"[40]FIbHoIvvxBkDIDpxvIsvkwbKDaeavHwnJHqvbGqa",206,0.990431,40,209,2,207,1,2,1,3,2,109,108,99,99,45
"3957",56,"[40]FIbHoIvvxBkDIDpxvIsvkwbKDaeavHwnJHqvbGqa",198,0.99005,40,201,2,199,1,2,1,3,2,98,97,102,102,45
"3958",57,"[40]FIbHoIvvxBkDIDpxvIsvkwbKDaeavHwnJHqvbGqa",208,0.990521,40,211,2,209,1,2,1,3,2,110,109,100,100,45
"3959",58,"[40]FIbHoIvvxBkDIDpxvIsvkwbKDaeavHwnJHqvbGqa",201,0.990196,40,204,2,202,1,2,1,3,2,102,101,101,101,45
"3960",59,"[40]FIbHoIvvxBkDIDpxvIsvkwbKDaeavHwnJHqvbGqa",199,0.990099,40,202,2,200,1,2,1,3,2,98,97,103,103,45
"3961",60,"[40]FIbHoIvvxBkDIDpxvIsvkwbKDaeavHwnJHqvbGqa",205,0.990385,40,208,2,206,1,2,1,3,2,109,108,98,98,45
"3962",61,"[40]FIbHoIvvxBkDIDpxvIsvkwbKDaeavHwnJHqvbGqa",201,0.990196,40,204,2,202,1,2,1,3,2,101,100,102,102,45
"3963",62,"[40]FIbHoIvvxBkDIDpxvIsvkwbKDaeavHwnJHqvbGqa",209,0.990566,40,212,2,210,1,2,1,3,2,114,113,97,97,45
"3964",63,"[40]FIbHoIvvxBkDIDpxvIsvkwbKDaeavHwnJHqvbGqa",214,0.990783,40,217,2,215,1,2,1,3,2,121,120,95,95,45
"3965",64,"[40]FIbHoIvvxBkDIDpxvIsvkwbKDaeavHwnJHqvbGqa",195,0.989899,40,198,2,196,1,2,1,3,2,95,94,102,102,45
"3966",65,"[40]FIbHoIvvxBkDIDpxvIsvkwbKDaeavHwnJHqvbGqa",196,0.98995,40,199,2,197,1,2,1,3,2,96,95,102,102,45
"3967",66,"[40]FIbHoIvvxBkDIDpxvIsvkwbKDaeavHwnJHqvbGqa",198,0.99005,40,201,2,199,1,2,1,3,2,96,95,104,104,45
"3968",67,"[40]FIbHoIvvxBkDIDpxvIsvkwbKDaeavHwnJHqvbGqa",199,0.990099,40,202,2,200,1,2,1,3,2,100,99,101,101,45
"3969",68,"[40]FIbHoIvvxBkDIDpxvIsvkwbKDaeavHwnJHqvbGqa",190,0.989637,40,193,2,191,1,2,1,3,2,85,84,107,107,45
"3970",69,"[40]FIbHoIvvxBkDIDpxvIsvkwbKDaeavHwnJHqvbGqa",202,0.990244,40,205,2,203,1,2,1,3,2,102,101,102,102,45
"3971",70,"[40]FIbHoIvvxBkDIDpxvIsvkwbKDaeavHwnJHqvbGqa",206,0.990431,40,209,2,207,1,2,1,3,2,107,106,101,101,45
"3972",71,"[40]FIbHoIvvxBkDIDpxvIsvkwbKDaeavHwnJHqvbGqa",215,0.990826,40,218,2,216,1,2,1,3,2,123,122,94,94,45
"3973",72,"[40]FIbHoIvvxBkDIDpxvIsvkwbKDaeavHwnJHqvbGqa",194,0.989848,40,197,2,195,1,2,1,3,2,95,94,101,101,45
"3974",73,"[40]FIbHoIvvxBkDIDpxvIsvkwbKDaeavHwnJHqvbGqa",209,0.990566,40,212,2,210,1,2,1,3,2,114,113,97,97,45
"3975",74,"[40]FIbHoIvvxBkDIDpxvIsvkwbKDaeavHwnJHqvbGqa",189,0.989583,40,192,2,190,1,2,1,3,2,85,84,106,106,45
"3976",75,"[40]FIbHoIvvxBkDIDpxvIsvkwbKDaeavHwnJHqvbGqa",215,0.990826,40,218,2,216,1,2,1,3,2,121,120,96,96,45
"3977",76,"[40]FIbHoIvvxBkDIDpxvIsvkwbKDaeavHwnJHqvbGqa",198,0.99005,40,201,2,199,1,2,1,3,2,99,98,101,101,45
"3978",77,"[40]FIbHoIvvxBkDIDpxvIsvkwbKDaeavHwnJHqvbGqa",186,0.989418,40,189,2,187,1,2,1,3,2,84,83,104,104,45
"3979",78,"[40]FIbHoIvvxBkDIDpxvIsvkwbKDaeavHwnJHqvbGqa",202,0.990244,40,205,2,203,1,2,1,3,2,106,105,98,98,45
"3980",79,"[40]FIbHoIvvxBkDIDpxvIsvkwbKDaeavHwnJHqvbGqa",200,0.990148,40,203,2,201,1,2,1,3,2,99,98,103,103,45
"3981",80,"[40]FIbHoIvvxBkDIDpxvIsvkwbKDaeavHwnJHqvbGqa",209,0.990566,40,212,2,210,1,2,1,3,2,114,113,97,97,45
"3982",81,"[40]FIbHoIvvxBkDIDpxvIsvkwbKDaeavHwnJHqvbGqa",197,0.99,40,200,2,198,1,2,1,3,2,97,96,102,102,45
"3983",82,"[40]FIbHoIvvxBkDIDpxvIsvkwbKDaeavHwnJHqvbGqa",194,0.989848,40,197,2,195,1,2,1,3,2,91,90,105,105,45
"3984",83,"[40]FIbHoIvvxBkDIDpxvIsvkwbKDaeavHwnJHqvbGqa",208,0.990521,40,211,2,209,1,2,1,3,2,113,112,97,97,45
"3985",84,"[40]FIbHoIvvxBkDIDpxvIsvkwbKDaeavHwnJHqvbGqa",211,0.990654,40,214,2,212,1,2,1,3,2,116,115,97,97,45
"3986",85,"[40]FIbHoIvvxBkDIDpxvIsvkwbKDaeavHwnJHqvbGqa",195,0.989899,40,198,2,196,1,2,1,3,2,96,95,101,101,45
"3987",86,"[40]FIbHoIvvxBkDIDpxvIsvkwbKDaeavHwnJHqvbGqa",214,0.990783,40,217,2,215,1,2,1,3,2,115,114,101,101,45
"3988",87,"[40]FIbHoIvvxBkDIDpxvIsvkwbKDaeavHwnJHqvbGqa",210,0.99061,40,213,2,211,1,2,1,3,2,115,114,97,97,45
"3989",88,"[40]FIbHoIvvxBkDIDpxvIsvkwbKDaeavHwnJHqvbGqa",199,0.990099,40,202,2,200,1,2,1,3,2,99,98,102,102,45
"3990",89,"[40]FIbHoIvvxBkDIDpxvIsvkwbKDaeavHwnJHqvbGqa",186,0.989418,40,189,2,187,1,2,1,3,2,82,81,106,106,45
"3991",90,"[40]FIbHoIvvxBkDIDpxvIsvkwbKDaeavHwnJHqvbGqa",203,0.990291,40,206,2,204,1,2,1,3,2,104,103,101,101,45
"3992",91,"[40]FIbHoIvvxBkDIDpxvIsvkwbKDaeavHwnJHqvbGqa",195,0.989899,40,198,2,196,1,2,1,3,2,95,94,102,102,45
"3993",92,"[40]FIbHoIvvxBkDIDpxvIsvkwbKDaeavHwnJHqvbGqa",206,0.990431,40,209,2,207,1,2,1,3,2,108,107,100,100,45
"3994",93,"[40]FIbHoIvvxBkDIDpxvIsvkwbKDaeavHwnJHqvbGqa",185,0.989362,40,188,2,186,1,2,1,3,2,83,82,104,104,45
"3995",94,"[40]FIbHoIvvxBkDIDpxvIsvkwbKDaeavHwnJHqvbGqa",212,0.990698,40,215,2,213,1,2,1,3,2,115,114,99,99,45
"3996",95,"[40]FIbHoIvvxBkDIDpxvIsvkwbKDaeavHwnJHqvbGqa",203,0.990291,40,206,2,204,1,2,1,3,2,107,106,98,98,45
"3997",96,"[40]FIbHoIvvxBkDIDpxvIsvkwbKDaeavHwnJHqvbGqa",199,0.990099,40,202,2,200,1,2,1,3,2,100,99,101,101,45
"3998",97,"[40]FIbHoIvvxBkDIDpxvIsvkwbKDaeavHwnJHqvbGqa",199,0.990099,40,202,2,200,1,2,1,3,2,101,100,100,100,45
"3999",98,"[40]FIbHoIvvxBkDIDpxvIsvkwbKDaeavHwnJHqvbGqa",198,0.99005,40,201,2,199,1,2,1,3,2,100,99,100,100,45
"4000",99,"[40]FIbHoIvvxBkDIDpxvIsvkwbKDaeavHwnJHqvbGqa",194,0.989848,40,197,2,195,1,2,1,3,2,93,92,103,103,45
"4001",0,"[40]vIFHoIasABkDAExnfzdJdwbKDeehmHtnJHqvbGqa",204,0.990338,40,207,2,205,1,2,1,3,2,107,106,99,99,48
"4002",1,"[40]vIFHoIasABkDAExnfzdJdwbKDeehmHtnJHqvbGqa",204,0.990338,40,207,2,205,1,2,1,3,2,106,105,100,100,48
"4003",2,"[40]vIFHoIasABkDAExnfzdJdwbKDeehmHtnJHqvbGqa",182,0.989189,40,185,2,183,1,2,1,3,2,77,76,107,107,48
"4004",3,"[40]vIFHoIasABkDAExnfzdJdwbKDeehmHtnJHqvbGqa",219,0.990991,40,222,2,220,1,2,1,3,2,130,129,91,91,48
"4005",4,"[40]vIFHoIasABkDAExnfzdJdwbKDeehmHtnJHqvbGqa",199,0.990099,40,202,2,200,1,2,1,3,2,99,98,102,102,48
"4006",5,"[40]vIFHoIasABkDAExnfzdJdwbKDeehmHtnJHqvbGqa",204,0.990338,40,207,2,205,1,2,1,3,2,104,103,102,102,48
"4007",6,"[40]vIFHoIasABkDAExnfzdJdwbKDeehmHtnJHqvbGqa",190,0.989637,40,193,2,191,1,2,1,3,2,90,89,102,102,48
"4008",7,"[40]vIFHoIasABkDAExnfzdJdwbKDeehmHtnJHqvbGqa",201,0.990196,40,204,2,202,1,2,1,3,2,103,102,100,100,48
"4009",8,"[40]vIFHoIasABkDAExnfzdJdwbKDeehmHtnJHqvbGqa",196,0.98995,40,199,2,197,1,2,1,3,2,95,94,103,103,48
"4010",9,"[40]vIFHoIasABkDAExnfzdJdwbKDeehmHtnJHqvbGqa",200,0.990148,40,203,2,201,1,2,1,3,2,99,98,103,103,48
"4011",10,"[40]vIFHoIasABkDAExnfzdJdwbKDeehmHtnJHqvbGqa",213,0.990741,40,216,2,214,1,2,1,3,2,119,118,96,96,48
"4012",11,"[40]vIFHoIasABkDAExnfzdJdwbKDeehmHtnJHqvbGqa",201,0.990196,40,204,2,202,1,2,1,3,2,102,101,101,101,48
"4013",12,"[40]vIFHoIasABkDAExnfzdJdwbKDeehmHtnJHqvbGqa",207,0.990476,40,210,2,208,1,2,1,3,2,111,110,98,98,48
"4014",13,"[40]vIFHoIasABkDAExnfzdJdwbKDeehmHtnJHqvbGqa",215,0.990826,40,218,2,216,1,2,1,3,2,121,120,96,96,48
"4015",14,"[40]vIFHoIasABkDAExnfzdJdwbKDeehmHtnJHqvbGqa",205,0.990385,40,208,2,206,1,2,1,3,2,108,107,99,99,48
"4016",15,"[40]vIFHoIasABkDAExnfzdJdwbKDeehmHtnJHqvbGqa",204,0.990338,40,207,2,205,1,2,1,3,2,108,107,98,98,48
"4017",16,"[40]vIFHoIasABkDAExnfzdJdwbKDeehmHtnJHqvbGqa",199,0.990099,40,202,2,200,1,2,1,3,2,99,98,102,102,48
"4018",17,"[40]vIFHoIasABkDAExnfzdJdwbKDeehmHtnJHqvbGqa",214,0.990783,40,217,2,215,1,2,1,3,2,121,120,95,95,48
"4019",18,"[40]vIFHoIasABkDAExnfzdJdwbKDeehmHtnJHqvbGqa",202,0.990244,40,205,2,203,1,2,1,3,2,104,103,100,100,48
"4020",19,"[40]vIFHoIasABkDAExnfzdJdwbKDeehmHtnJHqvbGqa",202,0.990244,40,205,2,203,1,2,1,3,2,106,105,98,98,48
"4021",20,"[40]vIFHoIasABkDAExnfzdJdwbKDeehmHtnJHqvbGqa",198,0.99005,40,201,2,199,1,2,1,3,2,99,98,101,101,48
"4022",21,"[40]vIFHoIasABkDAExnfzdJdwbKDeehmHtnJHqvbGqa",214,0.990783,40,217,2,215,1,2,1,3,2,119,118,97,97,48
"4023",22,"[40]vIFHoIasABkDAExnfzdJdwbKDeehmHtnJHqvbGqa",192,0.989744,40,195,2,193,1,2,1,3,2,87,86,107,107,48
"4024",23,"[40]vIFHoIasABkDAExnfzdJdwbKDeehmHtnJHqvbGqa",198,0.99005,40,201,2,199,1,2,1,3,2,97,96,103,103,48
"4025",24,"[40]vIFHoIasABkDAExnfzdJdwbKDeehmHtnJHqvbGqa",204,0.990338,40,207,2,205,1,2,1,3,2,107,106,99,99,48
"4026",25,"[40]vIFHoIasABkDAExnfzdJdwbKDeehmHtnJHqvbGqa",206,0.990431,40,209,2,207,1,2,1,3,2,109,108,99,99,48
"4027",26,"[40]vIFHoIasABkDAExnfzdJdwbKDeehmHtnJHqvbGqa",203,0.990291,40,206,2,204,1,2,1,3,2,104,103,101,101,48
"4028",27,"[40]vIFHoIasABkDAExnfzdJdwbKDeehmHtnJHqvbGqa",207,0.990476,40,210,2,208,1,2,1,3,2,112,111,97,97,48
"4029",28,"[40]vIFHoIasABkDAExnfzdJdwbKDeehmHtnJHqvbGqa",210,0.99061,40,213,2,211,1,2,1,3,2,114,113,98,98,48
"4030",29,"[40]vIFHoIasABkDAExnfzdJdwbKDeehmHtnJHqvbGqa",198,0.99005,40,201,2,199,1,2,1,3,2,96,95,104,104,48
"4031",30,"[40]vIFHoIasABkDAExnfzdJdwbKDeehmHtnJHqvbGqa",196,0.98995,40,199,2,197,1,2,1,3,2,94,93,104,104,48
"4032",31,"[40]vIFHoIasABkDAExnfzdJdwbKDeehmHtnJHqvbGqa",204,0.990338,40,207,2,205,1,2,1,3,2,110,109,96,96,48
"4033",32,"[40]vIFHoIasABkDAExnfzdJdwbKDeehmHtnJHqvbGqa",216,0.990868,40,219,2,217,1,2,1,3,2,124,123,94,94,48
"4034",33,"[40]vIFHoIasABkDAExnfzdJdwbKDeehmHtnJHqvbGqa",204,0.990338,40,207,2,205,1,2,1,3,2,107,106,99,99,48
"4035",34,"[40]vIFHoIasABkDAExnfzdJdwbKDeehmHtnJHqvbGqa",193,0.989796,40,196,2,194,1,2,1,3,2,91,90,104,104,48
"4036",35,"[40]vIFHoIasABkDAExnfzdJdwbKDeehmHtnJHqvbGqa",186,0.989418,40,189,2,187,1,2,1,3,2,82,81,106,106,48
"4037",36,"[40]vIFHoIasABkDAExnfzdJdwbKDeehmHtnJHqvbGqa",201,0.990196,40,204,2,202,1,2,1,3,2,104,103,99,99,48
"4038",37,"[40]vIFHoIasABkDAExnfzdJdwbKDeehmHtnJHqvbGqa",194,0.989848,40,197,2,195,1,2,1,3,2,93,92,103,103,48
"4039",38,"[40]vIFHoIasABkDAExnfzdJdwbKDeehmHtnJHqvbGqa",221,0.991071,40,224,2,222,1,2,1,3,2,131,130,92,92,48
"4040",39,"[40]vIFHoIasABkDAExnfzdJdwbKDeehmHtnJHqvbGqa",209,0.990566,40,212,2,210,1,2,1,3,2,112,111,99,99,48
"4041",40,"[40]vIFHoIasABkDAExnfzdJdwbKDeehmHtnJHqvbGqa",211,0.990654,40,214,2,212,1,2,1,3,2,114,113,99,99,48
"4042",41,"[40]vIFHoIasABkDAExnfzdJdwbKDeehmHtnJHqvbGqa",201,0.990196,40,204,2,202,1,2,1,3,2,100,99,103,103,48
"4043",42,"[40]vIFHoIasABkDAExnfzdJdwbKDeehmHtnJHqvbGqa",205,0.990385,40,208,2,206,1,2,1,3,2,107,106,100,100,48
"4044",43,"[40]vIFHoIasABkDAExnfzdJdwbKDeehmHtnJHqvbGqa",200,0.990148,40,203,2,201,1,2,1,3,2,103,102,99,99,48
"4045",44,"[40]vIFHoIasABkDAExnfzdJdwbKDeehmHtnJHqvbGqa",202,0.990244,40,205,2,203,1,2,1,3,2,101,100,103,103,48
"4046",45,"[40]vIFHoIasABkDAExnfzdJdwbKDeehmHtnJHqvbGqa",201,0.990196,40,204,2,202,1,2,1,3,2,103,102,100,100,48
"4047",46,"[40]vIFHoIasABkDAExnfzdJdwbKDeehmHtnJHqvbGqa",205,0.990385,40,208,2,206,1,2,1,3,2,107,106,100,100,48
"4048",47,"[40]vIFHoIasABkDAExnfzdJdwbKDeehmHtnJHqvbGqa",215,0.990826,40,218,2,216,1,2,1,3,2,121,120,96,96,48
"4049",48,"[40]vIFHoIasABkDAExnfzdJdwbKDeehmHtnJHqvbGqa",218,0.99095,40,221,2,219,1,2,1,3,2,125,124,95,95,48
"4050",49,"[40]vIFHoIasABkDAExnfzdJdwbKDeehmHtnJHqvbGqa",198,0.99005,40,201,2,199,1,2,1,3,2,98,97,102,102,48
"4051",50,"[40]vIFHoIasABkDAExnfzdJdwbKDeehmHtnJHqvbGqa",196,0.98995,40,199,2,197,1,2,1,3,2,97,96,101,101,48
"4052",51,"[40]vIFHoIasABkDAExnfzdJdwbKDeehmHtnJHqvbGqa",197,0.99,40,200,2,198,1,2,1,3,2,97,96,102,102,48
"4053",52,"[40]vIFHoIasABkDAExnfzdJdwbKDeehmHtnJHqvbGqa",200,0.990148,40,203,2,201,1,2,1,3,2,101,100,101,101,48
"4054",53,"[40]vIFHoIasABkDAExnfzdJdwbKDeehmHtnJHqvbGqa",206,0.990431,40,209,2,207,1,2,1,3,2,108,107,100,100,48
"4055",54,"[40]vIFHoIasABkDAExnfzdJdwbKDeehmHtnJHqvbGqa",189,0.989583,40,192,2,190,1,2,1,3,2,84,83,107,107,48
"4056",55,"[40]vIFHoIasABkDAExnfzdJdwbKDeehmHtnJHqvbGqa",207,0.990476,40,210,2,208,1,2,1,3,2,112,111,97,97,48
"4057",56,"[40]vIFHoIasABkDAExnfzdJdwbKDeehmHtnJHqvbGqa",202,0.990244,40,205,2,203,1,2,1,3,2,106,105,98,98,48
"4058",57,"[40]vIFHoIasABkDAExnfzdJdwbKDeehmHtnJHqvbGqa",214,0.990783,40,217,2,215,1,2,1,3,2,121,120,95,95,48
"4059",58,"[40]vIFHoIasABkDAExnfzdJdwbKDeehmHtnJHqvbGqa",199,0.990099,40,202,2,200,1,2,1,3,2,98,97,103,103,48
"4060",59,"[40]vIFHoIasABkDAExnfzdJdwbKDeehmHtnJHqvbGqa",202,0.990244,40,205,2,203,1,2,1,3,2,103,102,101,101,48
"4061",60,"[40]vIFHoIasABkDAExnfzdJdwbKDeehmHtnJHqvbGqa",191,0.989691,40,194,2,192,1,2,1,3,2,89,88,104,104,48
"4062",61,"[40]vIFHoIasABkDAExnfzdJdwbKDeehmHtnJHqvbGqa",212,0.990698,40,215,2,213,1,2,1,3,2,118,117,96,96,48
"4063",62,"[40]vIFHoIasABkDAExnfzdJdwbKDeehmHtnJHqvbGqa",201,0.990196,40,204,2,202,1,2,1,3,2,100,99,103,103,48
"4064",63,"[40]vIFHoIasABkDAExnfzdJdwbKDeehmHtnJHqvbGqa",207,0.990476,40,210,2,208,1,2,1,3,2,110,109,99,99,48
"4065",64,"[40]vIFHoIasABkDAExnfzdJdwbKDeehmHtnJHqvbGqa",211,0.990654,40,214,2,212,1,2,1,3,2,115,114,98,98,48
"4066",65,"[40]vIFHoIasABkDAExnfzdJdwbKDeehmHtnJHqvbGqa",195,0.989899,40,198,2,196,1,2,1,3,2,96,95,101,101,48
"4067",66,"[40]vIFHoIasABkDAExnfzdJdwbKDeehmHtnJHqvbGqa",204,0.990338,40,207,2,205,1,2,1,3,2,105,104,101,101,48
"4068",67,"[40]vIFHoIasABkDAExnfzdJdwbKDeehmHtnJHqvbGqa",199,0.990099,40,202,2,200,1,2,1,3,2,100,99,101,101,48
"4069",68,"[40]vIFHoIasABkDAExnfzdJdwbKDeehmHtnJHqvbGqa",204,0.990338,40,207,2,205,1,2,1,3,2,104,103,102,102,48
"4070",69,"[40]vIFHoIasABkDAExnfzdJdwbKDeehmHtnJHqvbGqa",192,0.989744,40,195,2,193,1,2,1,3,2,90,89,104,104,48
"4071",70,"[40]vIFHoIasABkDAExnfzdJdwbKDeehmHtnJHqvbGqa",188,0.989529,40,191,2,189,1,2,1,3,2,84,83,106,106,48
"4072",71,"[40]vIFHoIasABkDAExnfzdJdwbKDeehmHtnJHqvbGqa",193,0.989796,40,196,2,194,1,2,1,3,2,90,89,105,105,48
"4073",72,"[40]vIFHoIasABkDAExnfzdJdwbKDeehmHtnJHqvbGqa",185,0.989362,40,188,2,186,1,2,1,3,2,80,79,107,107,48
"4074",73,"[40]vIFHoIasABkDAExnfzdJdwbKDeehmHtnJHqvbGqa",221,0.991071,40,224,2,222,1,2,1,3,2,132,131,91,91,48
"4075",74,"[40]vIFHoIasABkDAExnfzdJdwbKDeehmHtnJHqvbGqa",197,0.99,40,200,2,198,1,2,1,3,2,96,95,103,103,48
"4076",75,"[40]vIFHoIasABkDAExnfzdJdwbKDeehmHtnJHqvbGqa",210,0.99061,40,213,2,211,1,2,1,3,2,111,110,101,101,48
"4077",76,"[40]vIFHoIasABkDAExnfzdJdwbKDeehmHtnJHqvbGqa",203,0.990291,40,206,2,204,1,2,1,3,2,104,103,101,101,48
"4078",77,"[40]vIFHoIasABkDAExnfzdJdwbKDeehmHtnJHqvbGqa",197,0.99,40,200,2,198,1,2,1,3,2,98,97,101,101,48
"4079",78,"[40]vIFHoIasABkDAExnfzdJdwbKDeehmHtnJHqvbGqa",206,0.990431,40,209,2,207,1,2,1,3,2,109,108,99,99,48
"4080",79,"[40]vIFHoIasABkDAExnfzdJdwbKDeehmHtnJHqvbGqa",198,0.99005,40,201,2,199,1,2,1,3,2,99,98,101,101,48
"4081",80,"[40]vIFHoIasABkDAExnfzdJdwbKDeehmHtnJHqvbGqa",189,0.989583,40,192,2,190,1,2,1,3,2,86,85,105,105,48
"4082",81,"[40]vIFHoIasABkDAExnfzdJdwbKDeehmHtnJHqvbGqa",209,0.990566,40,212,2,210,1,2,1,3,2,113,112,98,98,48
"4083",82,"[40]vIFHoIasABkDAExnfzdJdwbKDeehmHtnJHqvbGqa",199,0.990099,40,202,2,200,1,2,1,3,2,98,97,103,103,48
"4084",83,"[40]vIFHoIasABkDAExnfzdJdwbKDeehmHtnJHqvbGqa",197,0.99,40,200,2,198,1,2,1,3,2,96,95,103,103,48
"4085",84,"[40]vIFHoIasABkDAExnfzdJdwbKDeehmHtnJHqvbGqa",205,0.990385,40,208,2,206,1,2,1,3,2,106,105,101,101,48
"4086",85,"[40]vIFHoIasABkDAExnfzdJdwbKDeehmHtnJHqvbGqa",194,0.989848,40,197,2,195,1,2,1,3,2,95,94,101,101,48
"4087",86,"[40]vIFHoIasABkDAExnfzdJdwbKDeehmHtnJHqvbGqa",201,0.990196,40,204,2,202,1,2,1,3,2,102,101,101,101,48
"4088",87,"[40]vIFHoIasABkDAExnfzdJdwbKDeehmHtnJHqvbGqa",202,0.990244,40,205,2,203,1,2,1,3,2,106,105,98,98,48
"4089",88,"[40]vIFHoIasABkDAExnfzdJdwbKDeehmHtnJHqvbGqa",196,0.98995,40,199,2,197,1,2,1,3,2,97,96,101,101,48
"4090",89,"[40]vIFHoIasABkDAExnfzdJdwbKDeehmHtnJHqvbGqa",206,0.990431,40,209,2,207,1,2,1,3,2,110,109,98,98,48
"4091",90,"[40]vIFHoIasABkDAExnfzdJdwbKDeehmHtnJHqvbGqa",187,0.989474,40,190,2,188,1,2,1,3,2,81,80,108,108,48
"4092",91,"[40]vIFHoIasABkDAExnfzdJdwbKDeehmHtnJHqvbGqa",196,0.98995,40,199,2,197,1,2,1,3,2,97,96,101,101,48
"4093",92,"[40]vIFHoIasABkDAExnfzdJdwbKDeehmHtnJHqvbGqa",197,0.99,40,200,2,198,1,2,1,3,2,99,98,100,100,48
"4094",93,"[40]vIFHoIasABkDAExnfzdJdwbKDeehmHtnJHqvbGqa",200,0.990148,40,203,2,201,1,2,1,3,2,99,98,103,103,48
"4095",94,"[40]vIFHoIasABkDAExnfzdJdwbKDeehmHtnJHqvbGqa",203,0.990291,40,206,2,204,1,2,1,3,2,107,106,98,98,48
"4096",95,"[40]vIFHoIasABkDAExnfzdJdwbKDeehmHtnJHqvbGqa",207,0.990476,40,210,2,208,1,2,1,3,2,112,111,97,97,48
"4097",96,"[40]vIFHoIasABkDAExnfzdJdwbKDeehmHtnJHqvbGqa",213,0.990741,40,216,2,214,1,2,1,3,2,118,117,97,97,48
"4098",97,"[40]vIFHoIasABkDAExnfzdJdwbKDeehmHtnJHqvbGqa",215,0.990826,40,218,2,216,1,2,1,3,2,120,119,97,97,48
"4099",98,"[40]vIFHoIasABkDAExnfzdJdwbKDeehmHtnJHqvbGqa",202,0.990244,40,205,2,203,1,2,1,3,2,103,102,101,101,48
"4100",99,"[40]vIFHoIasABkDAExnfzdJdwbKDeehmHtnJHqvbGqa",206,0.990431,40,209,2,207,1,2,1,3,2,109,108,99,99,48
"4101",0,"[38]jIyHoIEBlDhbDpDbesmCbKDaepFHunJHqvbGqa",209,0.990566,38,212,2,210,1,2,1,3,2,113,112,98,98,49
"4102",1,"[38]jIyHoIEBlDhbDpDbesmCbKDaepFHunJHqvbGqa",200,0.990148,38,203,2,201,1,2,1,3,2,100,99,102,102,49
"4103",2,"[38]jIyHoIEBlDhbDpDbesmCbKDaepFHunJHqvbGqa",200,0.990148,38,203,2,201,1,2,1,3,2,101,100,101,101,49
"4104",3,"[38]jIyHoIEBlDhbDpDbesmCbKDaepFHunJHqvbGqa",216,0.990868,38,219,2,217,1,2,1,3,2,120,119,98,98,49
"4105",4,"[38]jIyHoIEBlDhbDpDbesmCbKDaepFHunJHqvbGqa",198,0.99005,38,201,2,199,1,2,1,3,2,97,96,103,103,49
"4106",5,"[38]jIyHoIEBlDhbDpDbesmCbKDaepFHunJHqvbGqa",199,0.990099,38,202,2,200,1,2,1,3,2,95,94,106,106,49
"4107",6,"[38]jIyHoIEBlDhbDpDbesmCbKDaepFHunJHqvbGqa",208,0.990521,38,211,2,209,1,2,1,3,2,108,107,102,102,49
"4108",7,"[38]jIyHoIEBlDhbDpDbesmCbKDaepFHunJHqvbGqa",201,0.990196,38,204,2,202,1,2,1,3,2,102,101,101,101,49
"4109",8,"[38]jIyHoIEBlDhbDpDbesmCbKDaepFHunJHqvbGqa",193,0.989796,38,196,2,194,1,2,1,3,2,90,89,105,105,49
"4110",9,"[38]jIyHoIEBlDhbDpDbesmCbKDaepFHunJHqvbGqa",195,0.989899,38,198,2,196,1,2,1,3,2,92,91,105,105,49
"4111",10,"[38]jIyHoIEBlDhbDpDbesmCbKDaepFHunJHqvbGqa",204,0.990338,38,207,2,205,1,2,1,3,2,104,103,102,102,49
"4112",11,"[38]jIyHoIEBlDhbDpDbesmCbKDaepFHunJHqvbGqa",198,0.99005,38,201,2,199,1,2,1,3,2,96,95,104,104,49
"4113",12,"[38]jIyHoIEBlDhbDpDbesmCbKDaepFHunJHqvbGqa",197,0.99,38,200,2,198,1,2,1,3,2,96,95,103,103,49
"4114",13,"[38]jIyHoIEBlDhbDpDbesmCbKDaepFHunJHqvbGqa",188,0.989529,38,191,2,189,1,2,1,3,2,82,81,108,108,49
"4115",14,"[38]jIyHoIEBlDhbDpDbesmCbKDaepFHunJHqvbGqa",214,0.990783,38,217,2,215,1,2,1,3,2,120,119,96,96,49
"4116",15,"[38]jIyHoIEBlDhbDpDbesmCbKDaepFHunJHqvbGqa",205,0.990385,38,208,2,206,1,2,1,3,2,108,107,99,99,49
"4117",16,"[38]jIyHoIEBlDhbDpDbesmCbKDaepFHunJHqvbGqa",192,0.989744,38,195,2,193,1,2,1,3,2,89,88,105,105,49
"4118",17,"[38]jIyHoIEBlDhbDpDbesmCbKDaepFHunJHqvbGqa",199,0.990099,38,202,2,200,1,2,1,3,2,101,100,100,100,49
"4119",18,"[38]jIyHoIEBlDhbDpDbesmCbKDaepFHunJHqvbGqa",189,0.989583,38,192,2,190,1,2,1,3,2,86,85,105,105,49
"4120",19,"[38]jIyHoIEBlDhbDpDbesmCbKDaepFHunJHqvbGqa",207,0.990476,38,210,2,208,1,2,1,3,2,111,110,98,98,49
"4121",20,"[38]jIyHoIEBlDhbDpDbesmCbKDaepFHunJHqvbGqa",205,0.990385,38,208,2,206,1,2,1,3,2,107,106,100,100,49
"4122",21,"[38]jIyHoIEBlDhbDpDbesmCbKDaepFHunJHqvbGqa",203,0.990291,38,206,2,204,1,2,1,3,2,105,104,100,100,49
"4123",22,"[38]jIyHoIEBlDhbDpDbesmCbKDaepFHunJHqvbGqa",205,0.990385,38,208,2,206,1,2,1,3,2,108,107,99,99,49
"4124",23,"[38]jIyHoIEBlDhbDpDbesmCbKDaepFHunJHqvbGqa",191,0.989691,38,194,2,192,1,2,1,3,2,88,87,105,105,49
"4125",24,"[38]jIyHoIEBlDhbDpDbesmCbKDaepFHunJHqvbGqa",198,0.99005,38,201,2,199,1,2,1,3,2,97,96,103,103,49
"4126",25,"[38]jIyHoIEBlDhbDpDbesmCbKDaepFHunJHqvbGqa",203,0.990291,38,206,2,204,1,2,1,3,2,106,105,99,99,49
"4127",26,"[38]jIyHoIEBlDhbDpDbesmCbKDaepFHunJHqvbGqa",201,0.990196,38,204,2,202,1,2,1,3,2,103,102,100,100,49
"4128",27,"[38]jIyHoIEBlDhbDpDbesmCbKDaepFHunJHqvbGqa",200,0.990148,38,203,2,201,1,2,1,3,2,101,100,101,101,49
"4129",28,"[38]jIyHoIEBlDhbDpDbesmCbKDaepFHunJHqvbGqa",205,0.990385,38,208,2,206,1,2,1,3,2,105,104,102,102,49
"4130",29,"[38]jIyHoIEBlDhbDpDbesmCbKDaepFHunJHqvbGqa",199,0.990099,38,202,2,200,1,2,1,3,2,100,99,101,101,49
"4131",30,"[38]jIyHoIEBlDhbDpDbesmCbKDaepFHunJHqvbGqa",202,0.990244,38,205,2,203,1,2,1,3,2,104,103,100,100,49
"4132",31,"[38]jIyHoIEBlDhbDpDbesmCbKDaepFHunJHqvbGqa",212,0.990698,38,215,2,213,1,2,1,3,2,117,116,97,97,49
"4133",32,"[38]jIyHoIEBlDhbDpDbesmCbKDaepFHunJHqvbGqa",193,0.989796,38,196,2,194,1,2,1,3,2,93,92,102,102,49
"4134",33,"[38]jIyHoIEBlDhbDpDbesmCbKDaepFHunJHqvbGqa",206,0.990431,38,209,2,207,1,2,1,3,2,108,107,100,100,49
"4135",34,"[38]jIyHoIEBlDhbDpDbesmCbKDaepFHunJHqvbGqa",200,0.990148,38,203,2,201,1,2,1,3,2,99,98,103,103,49
"4136",35,"[38]jIyHoIEBlDhbDpDbesmCbKDaepFHunJHqvbGqa",210,0.99061,38,213,2,211,1,2,1,3,2,111,110,101,101,49
"4137",36,"[38]jIyHoIEBlDhbDpDbesmCbKDaepFHunJHqvbGqa",209,0.990566,38,212,2,210,1,2,1,3,2,112,111,99,99,49
"4138",37,"[38]jIyHoIEBlDhbDpDbesmCbKDaepFHunJHqvbGqa",215,0.990826,38,218,2,216,1,2,1,3,2,120,119,97,97,49
"4139",38,"[38]jIyHoIEBlDhbDpDbesmCbKDaepFHunJHqvbGqa",212,0.990698,38,215,2,213,1,2,1,3,2,117,116,97,97,49
"4140",39,"[38]jIyHoIEBlDhbDpDbesmCbKDaepFHunJHqvbGqa",194,0.989848,38,197,2,195,1,2,1,3,2,92,91,104,104,49
"4141",40,"[38]jIyHoIEBlDhbDpDbesmCbKDaepFHunJHqvbGqa",210,0.99061,38,213,2,211,1,2,1,3,2,116,115,96,96,49
"4142",41,"[38]jIyHoIEBlDhbDpDbesmCbKDaepFHunJHqvbGqa",200,0.990148,38,203,2,201,1,2,1,3,2,102,101,100,100,49
"4143",42,"[38]jIyHoIEBlDhbDpDbesmCbKDaepFHunJHqvbGqa",200,0.990148,38,203,2,201,1,2,1,3,2,100,99,102,102,49
"4144",43,"[38]jIyHoIEBlDhbDpDbesmCbKDaepFHunJHqvbGqa",195,0.989899,38,198,2,196,1,2,1,3,2,92,91,105,105,49
"4145",44,"[38]jIyHoIEBlDhbDpDbesmCbKDaepFHunJHqvbGqa",202,0.990244,38,205,2,203,1,2,1,3,2,100,99,104,104,49
"4146",45,"[38]jIyHoIEBlDhbDpDbesmCbKDaepFHunJHqvbGqa",215,0.990826,38,218,2,216,1,2,1,3,2,122,121,95,95,49
"4147",46,"[38]jIyHoIEBlDhbDpDbesmCbKDaepFHunJHqvbGqa",200,0.990148,38,203,2,201,1,2,1,3,2,101,100,101,101,49
"4148",47,"[38]jIyHoIEBlDhbDpDbesmCbKDaepFHunJHqvbGqa",188,0.989529,38,191,2,189,1,2,1,3,2,85,84,105,105,49
"4149",48,"[38]jIyHoIEBlDhbDpDbesmCbKDaepFHunJHqvbGqa",201,0.990196,38,204,2,202,1,2,1,3,2,99,98,104,104,49
"4150",49,"[38]jIyHoIEBlDhbDpDbesmCbKDaepFHunJHqvbGqa",183,0.989247,38,186,2,184,1,2,1,3,2,79,78,106,106,49
"4151",50,"[38]jIyHoIEBlDhbDpDbesmCbKDaepFHunJHqvbGqa",188,0.989529,38,191,2,189,1,2,1,3,2,83,82,107,107,49
"4152",51,"[38]jIyHoIEBlDhbDpDbesmCbKDaepFHunJHqvbGqa",210,0.99061,38,213,2,211,1,2,1,3,2,114,113,98,98,49
"4153",52,"[38]jIyHoIEBlDhbDpDbesmCbKDaepFHunJHqvbGqa",194,0.989848,38,197,2,195,1,2,1,3,2,91,90,105,105,49
"4154",53,"[38]jIyHoIEBlDhbDpDbesmCbKDaepFHunJHqvbGqa",219,0.990991,38,222,2,220,1,2,1,3,2,125,124,96,96,49
"4155",54,"[38]jIyHoIEBlDhbDpDbesmCbKDaepFHunJHqvbGqa",188,0.989529,38,191,2,189,1,2,1,3,2,80,79,110,110,49
"4156",55,"[38]jIyHoIEBlDhbDpDbesmCbKDaepFHunJHqvbGqa",212,0.990698,38,215,2,213,1,2,1,3,2,116,115,98,98,49
"4157",56,"[38]jIyHoIEBlDhbDpDbesmCbKDaepFHunJHqvbGqa",202,0.990244,38,205,2,203,1,2,1,3,2,100,99,104,104,49
"4158",57,"[38]jIyHoIEBlDhbDpDbesmCbKDaepFHunJHqvbGqa",209,0.990566,38,212,2,210,1,2,1,3,2,113,112,98,98,49
"4159",58,"[38]jIyHoIEBlDhbDpDbesmCbKDaepFHunJHqvbGqa",212,0.990698,38,215,2,213,1,2,1,3,2,116,115,98,98,49
"4160",59,"[38]jIyHoIEBlDhbDpDbesmCbKDaepFHunJHqvbGqa",208,0.990521,38,211,2,209,1,2,1,3,2,111,110,99,99,49
"4161",60,"[38]jIyHoIEBlDhbDpDbesmCbKDaepFHunJHqvbGqa",204,0.990338,38,207,2,205,1,2,1,3,2,104,103,102,102,49
"4162",61,"[38]jIyHoIEBlDhbDpDbesmCbKDaepFHunJHqvbGqa",208,0.990521,38,211,2,209,1,2,1,3,2,113,112,97,97,49
"4163",62,"[38]jIyHoIEBlDhbDpDbesmCbKDaepFHunJHqvbGqa",206,0.990431,38,209,2,207,1,2,1,3,2,112,111,96,96,49
"4164",63,"[38]jIyHoIEBlDhbDpDbesmCbKDaepFHunJHqvbGqa",207,0.990476,38,210,2,208,1,2,1,3,2,110,109,99,99,49
"4165",64,"[38]jIyHoIEBlDhbDpDbesmCbKDaepFHunJHqvbGqa",204,0.990338,38,207,2,205,1,2,1,3,2,107,106,99,99,49
"4166",65,"[38]jIyHoIEBlDhbDpDbesmCbKDaepFHunJHqvbGqa",198,0.99005,38,201,2,199,1,2,1,3,2,96,95,104,104,49
"4167",66,"[38]jIyHoIEBlDhbDpDbesmCbKDaepFHunJHqvbGqa",197,0.99,38,200,2,198,1,2,1,3,2,96,95,103,103,49
"4168",67,"[38]jIyHoIEBlDhbDpDbesmCbKDaepFHunJHqvbGqa",207,0.990476,38,210,2,208,1,2,1,3,2,111,110,98,98,49
"4169",68,"[38]jIyHoIEBlDhbDpDbesmCbKDaepFHunJHqvbGqa",201,0.990196,38,204,2,202,1,2,1,3,2,102,101,101,101,49
"4170",69,"[38]jIyHoIEBlDhbDpDbesmCbKDaepFHunJHqvbGqa",218,0.99095,38,221,2,219,1,2,1,3,2,125,124,95,95,49
"4171",70,"[38]jIyHoIEBlDhbDpDbesmCbKDaepFHunJHqvbGqa",189,0.989583,38,192,2,190,1,2,1,3,2,86,85,105,105,49
"4172",71,"[38]jIyHoIEBlDhbDpDbesmCbKDaepFHunJHqvbGqa",185,0.989362,38,188,2,186,1,2,1,3,2,82,81,105,105,49
"4173",72,"[38]jIyHoIEBlDhbDpDbesmCbKDaepFHunJHqvbGqa",186,0.989418,38,189,2,187,1,2,1,3,2,83,82,105,105,49
"4174",73,"[38]jIyHoIEBlDhbDpDbesmCbKDaepFHunJHqvbGqa",200,0.990148,38,203,2,201,1,2,1,3,2,100,99,102,102,49
"4175",74,"[38]jIyHoIEBlDhbDpDbesmCbKDaepFHunJHqvbGqa",194,0.989848,38,197,2,195,1,2,1,3,2,93,92,103,103,49
"4176",75,"[38]jIyHoIEBlDhbDpDbesmCbKDaepFHunJHqvbGqa",211,0.990654,38,214,2,212,1,2,1,3,2,115,114,98,98,49
"4177",76,"[38]jIyHoIEBlDhbDpDbesmCbKDaepFHunJHqvbGqa",193,0.989796,38,196,2,194,1,2,1,3,2,91,90,104,104,49
"4178",77,"[38]jIyHoIEBlDhbDpDbesmCbKDaepFHunJHqvbGqa",202,0.990244,38,205,2,203,1,2,1,3,2,103,102,101,101,49
"4179",78,"[38]jIyHoIEBlDhbDpDbesmCbKDaepFHunJHqvbGqa",206,0.990431,38,209,2,207,1,2,1,3,2,109,108,99,99,49
"4180",79,"[38]jIyHoIEBlDhbDpDbesmCbKDaepFHunJHqvbGqa",214,0.990783,38,217,2,215,1,2,1,3,2,119,118,97,97,49
"4181",80,"[38]jIyHoIEBlDhbDpDbesmCbKDaepFHunJHqvbGqa",204,0.990338,38,207,2,205,1,2,1,3,2,105,104,101,101,49
"4182",81,"[38]jIyHoIEBlDhbDpDbesmCbKDaepFHunJHqvbGqa",207,0.990476,38,210,2,208,1,2,1,3,2,106,105,103,103,49
"4183",82,"[38]jIyHoIEBlDhbDpDbesmCbKDaepFHunJHqvbGqa",189,0.989583,38,192,2,190,1,2,1,3,2,87,86,104,104,49
"4184",83,"[38]jIyHoIEBlDhbDpDbesmCbKDaepFHunJHqvbGqa",206,0.990431,38,209,2,207,1,2,1,3,2,108,107,100,100,49
"4185",84,"[38]jIyHoIEBlDhbDpDbesmCbKDaepFHunJHqvbGqa",206,0.990431,38,209,2,207,1,2,1,3,2,107,106,101,101,49
"4186",85,"[38]jIyHoIEBlDhbDpDbesmCbKDaepFHunJHqvbGqa",200,0.990148,38,203,2,201,1,2,1,3,2,100,99,102,102,49
"4187",86,"[38]jIyHoIEBlDhbDpDbesmCbKDaepFHunJHqvbGqa",203,0.990291,38,206,2,204,1,2,1,3,2,102,101,103,103,49
"4188",87,"[38]jIyHoIEBlDhbDpDbesmCbKDaepFHunJHqvbGqa",195,0.989899,38,198,2,196,1,2,1,3,2,94,93,103,103,49
"4189",88,"[38]jIyHoIEBlDhbDpDbesmCbKDaepFHunJHqvbGqa",205,0.990385,38,208,2,206,1,2,1,3,2,108,107,99,99,49
"4190",89,"[38]jIyHoIEBlDhbDpDbesmCbKDaepFHunJHqvbGqa",203,0.990291,38,206,2,204,1,2,1,3,2,105,104,100,100,49
"4191",90,"[38]jIyHoIEBlDhbDpDbesmCbKDaepFHunJHqvbGqa",223,0.99115,38,226,2,224,1,2,1,3,2,133,132,92,92,49
"4192",91,"[38]jIyHoIEBlDhbDpDbesmCbKDaepFHunJHqvbGqa",206,0.990431,38,209,2,207,1,2,1,3,2,107,106,101,101,49
"4193",92,"[38]jIyHoIEBlDhbDpDbesmCbKDaepFHunJHqvbGqa",206,0.990431,38,209,2,207,1,2,1,3,2,108,107,100,100,49
"4194",93,"[38]jIyHoIEBlDhbDpDbesmCbKDaepFHunJHqvbGqa",192,0.989744,38,195,2,193,1,2,1,3,2,87,86,107,107,49
"4195",94,"[38]jIyHoIEBlDhbDpDbesmCbKDaepFHunJHqvbGqa",201,0.990196,38,204,2,202,1,2,1,3,2,101,100,102,102,49
"4196",95,"[38]jIyHoIEBlDhbDpDbesmCbKDaepFHunJHqvbGqa",206,0.990431,38,209,2,207,1,2,1,3,2,110,109,98,98,49
"4197",96,"[38]jIyHoIEBlDhbDpDbesmCbKDaepFHunJHqvbGqa",213,0.990741,38,216,2,214,1,2,1,3,2,118,117,97,97,49
"4198",97,"[38]jIyHoIEBlDhbDpDbesmCbKDaepFHunJHqvbGqa",209,0.990566,38,212,2,210,1,2,1,3,2,114,113,97,97,49
"4199",98,"[38]jIyHoIEBlDhbDpDbesmCbKDaepFHunJHqvbGqa",203,0.990291,38,206,2,204,1,2,1,3,2,102,101,103,103,49
"4200",99,"[38]jIyHoIEBlDhbDpDbesmCbKDaepFHunJHqvbGqa",206,0.990431,38,209,2,207,1,2,1,3,2,111,110,97,97,49
"4201",0,"[35]IjHoIEBDFHtIiDxHnbKDaenfHwnJHqvbGqa",199,0.990099,35,202,2,200,1,2,1,3,2,101,100,100,100,50
"4202",1,"[35]IjHoIEBDFHtIiDxHnbKDaenfHwnJHqvbGqa",210,0.99061,35,213,2,211,1,2,1,3,2,115,114,97,97,50
"4203",2,"[35]IjHoIEBDFHtIiDxHnbKDaenfHwnJHqvbGqa",187,0.989474,35,190,2,188,1,2,1,3,2,80,79,109,109,50
"4204",3,"[35]IjHoIEBDFHtIiDxHnbKDaenfHwnJHqvbGqa",194,0.989848,35,197,2,195,1,2,1,3,2,91,90,105,105,50
"4205",4,"[35]IjHoIEBDFHtIiDxHnbKDaenfHwnJHqvbGqa",215,0.990826,35,218,2,216,1,2,1,3,2,121,120,96,96,50
"4206",5,"[35]IjHoIEBDFHtIiDxHnbKDaenfHwnJHqvbGqa",199,0.990099,35,202,2,200,1,2,1,3,2,100,99,101,101,50
"4207",6,"[35]IjHoIEBDFHtIiDxHnbKDaenfHwnJHqvbGqa",200,0.990148,35,203,2,201,1,2,1,3,2,101,100,101,101,50
"4208",7,"[35]IjHoIEBDFHtIiDxHnbKDaenfHwnJHqvbGqa",204,0.990338,35,207,2,205,1,2,1,3,2,104,103,102,102,50
"4209",8,"[35]IjHoIEBDFHtIiDxHnbKDaenfHwnJHqvbGqa",204,0.990338,35,207,2,205,1,2,1,3,2,105,104,101,101,50
"4210",9,"[35]IjHoIEBDFHtIiDxHnbKDaenfHwnJHqvbGqa",216,0.990868,35,219,2,217,1,2,1,3,2,122,121,96,96,50
"4211",10,"[35]IjHoIEBDFHtIiDxHnbKDaenfHwnJHqvbGqa",209,0.990566,35,212,2,210,1,2,1,3,2,113,112,98,98,50
"4212",11,"[35]IjHoIEBDFHtIiDxHnbKDaenfHwnJHqvbGqa",211,0.990654,35,214,2,212,1,2,1,3,2,116,115,97,97,50
"4213",12,"[35]IjHoIEBDFHtIiDxHnbKDaenfHwnJHqvbGqa",211,0.990654,35,214,2,212,1,2,1,3,2,116,115,97,97,50
"4214",13,"[35]IjHoIEBDFHtIiDxHnbKDaenfHwnJHqvbGqa",204,0.990338,35,207,2,205,1,2,1,3,2,107,106,99,99,50
"4215",14,"[35]IjHoIEBDFHtIiDxHnbKDaenfHwnJHqvbGqa",202,0.990244,35,205,2,203,1,2,1,3,2,105,104,99,99,50
"4216",15,"[35]IjHoIEBDFHtIiDxHnbKDaenfHwnJHqvbGqa",196,0.98995,35,199,2,197,1,2,1,3,2,94,93,104,104,50
"4217",16,"[35]IjHoIEBDFHtIiDxHnbKDaenfHwnJHqvbGqa",205,0.990385,35,208,2,206,1,2,1,3,2,104,103,103,103,50
"4218",17,"[35]IjHoIEBDFHtIiDxHnbKDaenfHwnJHqvbGqa",220,0.991031,35,223,2,221,1,2,1,3,2,128,127,94,94,50
"4219",18,"[35]IjHoIEBDFHtIiDxHnbKDaenfHwnJHqvbGqa",201,0.990196,35,204,2,202,1,2,1,3,2,103,102,100,100,50
"4220",19,"[35]IjHoIEBDFHtIiDxHnbKDaenfHwnJHqvbGqa",211,0.990654,35,214,2,212,1,2,1,3,2,115,114,98,98,50
"4221",20,"[35]IjHoIEBDFHtIiDxHnbKDaenfHwnJHqvbGqa",192,0.989744,35,195,2,193,1,2,1,3,2,87,86,107,107,50
"4222",21,"[35]IjHoIEBDFHtIiDxHnbKDaenfHwnJHqvbGqa",209,0.990566,35,212,2,210,1,2,1,3,2,111,110,100,100,50
"4223",22,"[35]IjHoIEBDFHtIiDxHnbKDaenfHwnJHqvbGqa",201,0.990196,35,204,2,202,1,2,1,3,2,102,101,101,101,50
"4224",23,"[35]IjHoIEBDFHtIiDxHnbKDaenfHwnJHqvbGqa",215,0.990826,35,218,2,216,1,2,1,3,2,118,117,99,99,50
"4225",24,"[35]IjHoIEBDFHtIiDxHnbKDaenfHwnJHqvbGqa",214,0.990783,35,217,2,215,1,2,1,3,2,116,115,100,100,50
"4226",25,"[35]IjHoIEBDFHtIiDxHnbKDaenfHwnJHqvbGqa",201,0.990196,35,204,2,202,1,2,1,3,2,101,100,102,102,50
"4227",26,"[35]IjHoIEBDFHtIiDxHnbKDaenfHwnJHqvbGqa",199,0.990099,35,202,2,200,1,2,1,3,2,99,98,102,102,50
"4228",27,"[35]IjHoIEBDFHtIiDxHnbKDaenfHwnJHqvbGqa",202,0.990244,35,205,2,203,1,2,1,3,2,103,102,101,101,50
"4229",28,"[35]IjHoIEBDFHtIiDxHnbKDaenfHwnJHqvbGqa",203,0.990291,35,206,2,204,1,2,1,3,2,104,103,101,101,50
"4230",29,"[35]IjHoIEBDFHtIiDxHnbKDaenfHwnJHqvbGqa",187,0.989474,35,190,2,188,1,2,1,3,2,83,82,106,106,50
"4231",30,"[35]IjHoIEBDFHtIiDxHnbKDaenfHwnJHqvbGqa",211,0.990654,35,214,2,212,1,2,1,3,2,114,113,99,99,50
"4232",31,"[35]IjHoIEBDFHtIiDxHnbKDaenfHwnJHqvbGqa",218,0.99095,35,221,2,219,1,2,1,3,2,124,123,96,96,50
"4233",32,"[35]IjHoIEBDFHtIiDxHnbKDaenfHwnJHqvbGqa",202,0.990244,35,205,2,203,1,2,1,3,2,99,98,105,105,50
"4234",33,"[35]IjHoIEBDFHtIiDxHnbKDaenfHwnJHqvbGqa",200,0.990148,35,203,2,201,1,2,1,3,2,100,99,102,102,50
"4235",34,"[35]IjHoIEBDFHtIiDxHnbKDaenfHwnJHqvbGqa",204,0.990338,35,207,2,205,1,2,1,3,2,105,104,101,101,50
"4236",35,"[35]IjHoIEBDFHtIiDxHnbKDaenfHwnJHqvbGqa",197,0.99,35,200,2,198,1,2,1,3,2,97,96,102,102,50
"4237",36,"[35]IjHoIEBDFHtIiDxHnbKDaenfHwnJHqvbGqa",193,0.989796,35,196,2,194,1,2,1,3,2,87,86,108,108,50
"4238",37,"[35]IjHoIEBDFHtIiDxHnbKDaenfHwnJHqvbGqa",189,0.989583,35,192,2,190,1,2,1,3,2,84,83,107,107,50
"4239",38,"[35]IjHoIEBDFHtIiDxHnbKDaenfHwnJHqvbGqa",201,0.990196,35,204,2,202,1,2,1,3,2,101,100,102,102,50
"4240",39,"[35]IjHoIEBDFHtIiDxHnbKDaenfHwnJHqvbGqa",191,0.989691,35,194,2,192,1,2,1,3,2,89,88,104,104,50
"4241",40,"[35]IjHoIEBDFHtIiDxHnbKDaenfHwnJHqvbGqa",208,0.990521,35,211,2,209,1,2,1,3,2,110,109,100,100,50
"4242",41,"[35]IjHoIEBDFHtIiDxHnbKDaenfHwnJHqvbGqa",182,0.989189,35,185,2,183,1,2,1,3,2,76,75,108,108,50
"4243",42,"[35]IjHoIEBDFHtIiDxHnbKDaenfHwnJHqvbGqa",207,0.990476,35,210,2,208,1,2,1,3,2,110,109,99,99,50
"4244",43,"[35]IjHoIEBDFHtIiDxHnbKDaenfHwnJHqvbGqa",212,0.990698,35,215,2,213,1,2,1,3,2,113,112,101,101,50
"4245",44,"[35]IjHoIEBDFHtIiDxHnbKDaenfHwnJHqvbGqa",208,0.990521,35,211,2,209,1,2,1,3,2,111,110,99,99,50
"4246",45,"[35]IjHoIEBDFHtIiDxHnbKDaenfHwnJHqvbGqa",207,0.990476,35,210,2,208,1,2,1,3,2,112,111,97,97,50
"4247",46,"[35]IjHoIEBDFHtIiDxHnbKDaenfHwnJHqvbGqa",187,0.989474,35,190,2,188,1,2,1,3,2,82,81,107,107,50
"4248",47,"[35]IjHoIEBDFHtIiDxHnbKDaenfHwnJHqvbGqa",217,0.990909,35,220,2,218,1,2,1,3,2,123,122,96,96,50
"4249",48,"[35]IjHoIEBDFHtIiDxHnbKDaenfHwnJHqvbGqa",207,0.990476,35,210,2,208,1,2,1,3,2,111,110,98,98,50
"4250",49,"[35]IjHoIEBDFHtIiDxHnbKDaenfHwnJHqvbGqa",201,0.990196,35,204,2,202,1,2,1,3,2,101,100,102,102,50
"4251",50,"[35]IjHoIEBDFHtIiDxHnbKDaenfHwnJHqvbGqa",202,0.990244,35,205,2,203,1,2,1,3,2,102,101,102,102,50
"4252",51,"[35]IjHoIEBDFHtIiDxHnbKDaenfHwnJHqvbGqa",214,0.990783,35,217,2,215,1,2,1,3,2,119,118,97,97,50
"4253",52,"[35]IjHoIEBDFHtIiDxHnbKDaenfHwnJHqvbGqa",193,0.989796,35,196,2,194,1,2,1,3,2,90,89,105,105,50
"4254",53,"[35]IjHoIEBDFHtIiDxHnbKDaenfHwnJHqvbGqa",207,0.990476,35,210,2,208,1,2,1,3,2,112,111,97,97,50
"4255",54,"[35]IjHoIEBDFHtIiDxHnbKDaenfHwnJHqvbGqa",214,0.990783,35,217,2,215,1,2,1,3,2,120,119,96,96,50
"4256",55,"[35]IjHoIEBDFHtIiDxHnbKDaenfHwnJHqvbGqa",200,0.990148,35,203,2,201,1,2,1,3,2,97,96,105,105,50
"4257",56,"[35]IjHoIEBDFHtIiDxHnbKDaenfHwnJHqvbGqa",209,0.990566,35,212,2,210,1,2,1,3,2,114,113,97,97,50
"4258",57,"[35]IjHoIEBDFHtIiDxHnbKDaenfHwnJHqvbGqa",215,0.990826,35,218,2,216,1,2,1,3,2,122,121,95,95,50
"4259",58,"[35]IjHoIEBDFHtIiDxHnbKDaenfHwnJHqvbGqa",217,0.990909,35,220,2,218,1,2,1,3,2,122,121,97,97,50
"4260",59,"[35]IjHoIEBDFHtIiDxHnbKDaenfHwnJHqvbGqa",207,0.990476,35,210,2,208,1,2,1,3,2,107,106,102,102,50
"4261",60,"[35]IjHoIEBDFHtIiDxHnbKDaenfHwnJHqvbGqa",208,0.990521,35,211,2,209,1,2,1,3,2,110,109,100,100,50
"4262",61,"[35]IjHoIEBDFHtIiDxHnbKDaenfHwnJHqvbGqa",189,0.989583,35,192,2,190,1,2,1,3,2,86,85,105,105,50
"4263",62,"[35]IjHoIEBDFHtIiDxHnbKDaenfHwnJHqvbGqa",218,0.99095,35,221,2,219,1,2,1,3,2,120,119,100,100,50
"4264",63,"[35]IjHoIEBDFHtIiDxHnbKDaenfHwnJHqvbGqa",193,0.989796,35,196,2,194,1,2,1,3,2,90,89,105,105,50
"4265",64,"[35]IjHoIEBDFHtIiDxHnbKDaenfHwnJHqvbGqa",211,0.990654,35,214,2,212,1,2,1,3,2,115,114,98,98,50
"4266",65,"[35]IjHoIEBDFHtIiDxHnbKDaenfHwnJHqvbGqa",195,0.989899,35,198,2,196,1,2,1,3,2,94,93,103,103,50
"4267",66,"[35]IjHoIEBDFHtIiDxHnbKDaenfHwnJHqvbGqa",195,0.989899,35,198,2,196,1,2,1,3,2,94,93,103,103,50
"4268",67,"[35]IjHoIEBDFHtIiDxHnbKDaenfHwnJHqvbGqa",196,0.98995,35,199,2,197,1,2,1,3,2,93,92,105,105,50
"4269",68,"[35]IjHoIEBDFHtIiDxHnbKDaenfHwnJHqvbGqa",198,0.99005,35,201,2,199,1,2,1,3,2,97,96,103,103,50
"4270",69,"[35]IjHoIEBDFHtIiDxHnbKDaenfHwnJHqvbGqa",199,0.990099,35,202,2,200,1,2,1,3,2,98,97,103,103,50
"4271",70,"[35]IjHoIEBDFHtIiDxHnbKDaenfHwnJHqvbGqa",214,0.990783,35,217,2,215,1,2,1,3,2,119,118,97,97,50
"4272",71,"[35]IjHoIEBDFHtIiDxHnbKDaenfHwnJHqvbGqa",200,0.990148,35,203,2,201,1,2,1,3,2,100,99,102,102,50
"4273",72,"[35]IjHoIEBDFHtIiDxHnbKDaenfHwnJHqvbGqa",195,0.989899,35,198,2,196,1,2,1,3,2,95,94,102,102,50
"4274",73,"[35]IjHoIEBDFHtIiDxHnbKDaenfHwnJHqvbGqa",205,0.990385,35,208,2,206,1,2,1,3,2,105,104,102,102,50
"4275",74,"[35]IjHoIEBDFHtIiDxHnbKDaenfHwnJHqvbGqa",191,0.989691,35,194,2,192,1,2,1,3,2,90,89,103,103,50
"4276",75,"[35]IjHoIEBDFHtIiDxHnbKDaenfHwnJHqvbGqa",196,0.98995,35,199,2,197,1,2,1,3,2,95,94,103,103,50
"4277",76,"[35]IjHoIEBDFHtIiDxHnbKDaenfHwnJHqvbGqa",205,0.990385,35,208,2,206,1,2,1,3,2,108,107,99,99,50
"4278",77,"[35]IjHoIEBDFHtIiDxHnbKDaenfHwnJHqvbGqa",203,0.990291,35,206,2,204,1,2,1,3,2,103,102,102,102,50
"4279",78,"[35]IjHoIEBDFHtIiDxHnbKDaenfHwnJHqvbGqa",204,0.990338,35,207,2,205,1,2,1,3,2,106,105,100,100,50
"4280",79,"[35]IjHoIEBDFHtIiDxHnbKDaenfHwnJHqvbGqa",217,0.990909,35,220,2,218,1,2,1,3,2,124,123,95,95,50
"4281",80,"[35]IjHoIEBDFHtIiDxHnbKDaenfHwnJHqvbGqa",206,0.990431,35,209,2,207,1,2,1,3,2,107,106,101,101,50
"4282",81,"[35]IjHoIEBDFHtIiDxHnbKDaenfHwnJHqvbGqa",212,0.990698,35,215,2,213,1,2,1,3,2,115,114,99,99,50
"4283",82,"[35]IjHoIEBDFHtIiDxHnbKDaenfHwnJHqvbGqa",193,0.989796,35,196,2,194,1,2,1,3,2,93,92,102,102,50
"4284",83,"[35]IjHoIEBDFHtIiDxHnbKDaenfHwnJHqvbGqa",209,0.990566,35,212,2,210,1,2,1,3,2,112,111,99,99,50
"4285",84,"[35]IjHoIEBDFHtIiDxHnbKDaenfHwnJHqvbGqa",209,0.990566,35,212,2,210,1,2,1,3,2,111,110,100,100,50
"4286",85,"[35]IjHoIEBDFHtIiDxHnbKDaenfHwnJHqvbGqa",200,0.990148,35,203,2,201,1,2,1,3,2,102,101,100,100,50
"4287",86,"[35]IjHoIEBDFHtIiDxHnbKDaenfHwnJHqvbGqa",200,0.990148,35,203,2,201,1,2,1,3,2,101,100,101,101,50
"4288",87,"[35]IjHoIEBDFHtIiDxHnbKDaenfHwnJHqvbGqa",211,0.990654,35,214,2,212,1,2,1,3,2,116,115,97,97,50
"4289",88,"[35]IjHoIEBDFHtIiDxHnbKDaenfHwnJHqvbGqa",206,0.990431,35,209,2,207,1,2,1,3,2,109,108,99,99,50
"4290",89,"[35]IjHoIEBDFHtIiDxHnbKDaenfHwnJHqvbGqa",199,0.990099,35,202,2,200,1,2,1,3,2,99,98,102,102,50
"4291",90,"[35]IjHoIEBDFHtIiDxHnbKDaenfHwnJHqvbGqa",213,0.990741,35,216,2,214,1,2,1,3,2,119,118,96,96,50
"4292",91,"[35]IjHoIEBDFHtIiDxHnbKDaenfHwnJHqvbGqa",202,0.990244,35,205,2,203,1,2,1,3,2,105,104,99,99,50
"4293",92,"[35]IjHoIEBDFHtIiDxHnbKDaenfHwnJHqvbGqa",191,0.989691,35,194,2,192,1,2,1,3,2,90,89,103,103,50
"4294",93,"[35]IjHoIEBDFHtIiDxHnbKDaenfHwnJHqvbGqa",207,0.990476,35,210,2,208,1,2,1,3,2,109,108,100,100,50
"4295",94,"[35]IjHoIEBDFHtIiDxHnbKDaenfHwnJHqvbGqa",198,0.99005,35,201,2,199,1,2,1,3,2,97,96,103,103,50
"4296",95,"[35]IjHoIEBDFHtIiDxHnbKDaenfHwnJHqvbGqa",207,0.990476,35,210,2,208,1,2,1,3,2,111,110,98,98,50
"4297",96,"[35]IjHoIEBDFHtIiDxHnbKDaenfHwnJHqvbGqa",201,0.990196,35,204,2,202,1,2,1,3,2,100,99,103,103,50
"4298",97,"[35]IjHoIEBDFHtIiDxHnbKDaenfHwnJHqvbGqa",201,0.990196,35,204,2,202,1,2,1,3,2,100,99,103,103,50
"4299",98,"[35]IjHoIEBDFHtIiDxHnbKDaenfHwnJHqvbGqa",190,0.989637,35,193,2,191,1,2,1,3,2,85,84,107,107,50
"4300",99,"[35]IjHoIEBDFHtIiDxHnbKDaenfHwnJHqvbGqa",201,0.990196,35,204,2,202,1,2,1,3,2,102,101,101,101,50
"4301",0,"[40]yIdHoIdwFBkDmrJAunBkhxbKDaersHunJHqwbGqa",209,0.990566,40,212,2,210,1,2,1,3,2,113,112,98,98,51
"4302",1,"[40]yIdHoIdwFBkDmrJAunBkhxbKDaersHunJHqwbGqa",220,0.991031,40,223,2,221,1,2,1,3,2,131,130,91,91,51
"4303",2,"[40]yIdHoIdwFBkDmrJAunBkhxbKDaersHunJHqwbGqa",203,0.990291,40,206,2,204,1,2,1,3,2,103,102,102,102,51
"4304",3,"[40]yIdHoIdwFBkDmrJAunBkhxbKDaersHunJHqwbGqa",192,0.989744,40,195,2,193,1,2,1,3,2,90,89,104,104,51
"4305",4,"[40]yIdHoIdwFBkDmrJAunBkhxbKDaersHunJHqwbGqa",184,0.989305,40,187,2,185,1,2,1,3,2,80,79,106,106,51
"4306",5,"[40]yIdHoIdwFBkDmrJAunBkhxbKDaersHunJHqwbGqa",208,0.990521,40,211,2,209,1,2,1,3,2,111,110,99,99,51
"4307",6,"[40]yIdHoIdwFBkDmrJAunBkhxbKDaersHunJHqwbGqa",209,0.990566,40,212,2,210,1,2,1,3,2,113,112,98,98,51
"4308",7,"[40]yIdHoIdwFBkDmrJAunBkhxbKDaersHunJHqwbGqa",211,0.990654,40,214,2,212,1,2,1,3,2,116,115,97,97,51
"4309",8,"[40]yIdHoIdwFBkDmrJAunBkhxbKDaersHunJHqwbGqa",195,0.989899,40,198,2,196,1,2,1,3,2,95,94,102,102,51
"4310",9,"[40]yIdHoIdwFBkDmrJAunBkhxbKDaersHunJHqwbGqa",202,0.990244,40,205,2,203,1,2,1,3,2,104,103,100,100,51
"4311",10,"[40]yIdHoIdwFBkDmrJAunBkhxbKDaersHunJHqwbGqa",214,0.990783,40,217,2,215,1,2,1,3,2,122,121,94,94,51
"4312",11,"[40]yIdHoIdwFBkDmrJAunBkhxbKDaersHunJHqwbGqa",187,0.989474,40,190,2,188,1,2,1,3,2,86,85,103,103,51
"4313",12,"[40]yIdHoIdwFBkDmrJAunBkhxbKDaersHunJHqwbGqa",207,0.990476,40,210,2,208,1,2,1,3,2,111,110,98,98,51
"4314",13,"[40]yIdHoIdwFBkDmrJAunBkhxbKDaersHunJHqwbGqa",191,0.989691,40,194,2,192,1,2,1,3,2,90,89,103,103,51
"4315",14,"[40]yIdHoIdwFBkDmrJAunBkhxbKDaersHunJHqwbGqa",197,0.99,40,200,2,198,1,2,1,3,2,97,96,102,102,51
"4316",15,"[40]yIdHoIdwFBkDmrJAunBkhxbKDaersHunJHqwbGqa",195,0.989899,40,198,2,196,1,2,1,3,2,93,92,104,104,51
"4317",16,"[40]yIdHoIdwFBkDmrJAunBkhxbKDaersHunJHqwbGqa",196,0.98995,40,199,2,197,1,2,1,3,2,91,90,107,107,51
"4318",17,"[40]yIdHoIdwFBkDmrJAunBkhxbKDaersHunJHqwbGqa",196,0.98995,40,199,2,197,1,2,1,3,2,94,93,104,104,51
"4319",18,"[40]yIdHoIdwFBkDmrJAunBkhxbKDaersHunJHqwbGqa",195,0.989899,40,198,2,196,1,2,1,3,2,95,94,102,102,51
"4320",19,"[40]yIdHoIdwFBkDmrJAunBkhxbKDaersHunJHqwbGqa",200,0.990148,40,203,2,201,1,2,1,3,2,100,99,102,102,51
"4321",20,"[40]yIdHoIdwFBkDmrJAunBkhxbKDaersHunJHqwbGqa",221,0.991071,40,224,2,222,1,2,1,3,2,132,131,91,91,51
"4322",21,"[40]yIdHoIdwFBkDmrJAunBkhxbKDaersHunJHqwbGqa",222,0.991111,40,225,2,223,1,2,1,3,2,128,127,96,96,51
"4323",22,"[40]yIdHoIdwFBkDmrJAunBkhxbKDaersHunJHqwbGqa",207,0.990476,40,210,2,208,1,2,1,3,2,110,109,99,99,51
"4324",23,"[40]yIdHoIdwFBkDmrJAunBkhxbKDaersHunJHqwbGqa",190,0.989637,40,193,2,191,1,2,1,3,2,87,86,105,105,51
"4325",24,"[40]yIdHoIdwFBkDmrJAunBkhxbKDaersHunJHqwbGqa",205,0.990385,40,208,2,206,1,2,1,3,2,107,106,100,100,51
"4326",25,"[40]yIdHoIdwFBkDmrJAunBkhxbKDaersHunJHqwbGqa",203,0.990291,40,206,2,204,1,2,1,3,2,103,102,102,102,51
"4327",26,"[40]yIdHoIdwFBkDmrJAunBkhxbKDaersHunJHqwbGqa",203,0.990291,40,206,2,204,1,2,1,3,2,104,103,101,101,51
"4328",27,"[40]yIdHoIdwFBkDmrJAunBkhxbKDaersHunJHqwbGqa",200,0.990148,40,203,2,201,1,2,1,3,2,100,99,102,102,51
"4329",28,"[40]yIdHoIdwFBkDmrJAunBkhxbKDaersHunJHqwbGqa",203,0.990291,40,206,2,204,1,2,1,3,2,107,106,98,98,51
"4330",29,"[40]yIdHoIdwFBkDmrJAunBkhxbKDaersHunJHqwbGqa",203,0.990291,40,206,2,204,1,2,1,3,2,106,105,99,99,51
"4331",30,"[40]yIdHoIdwFBkDmrJAunBkhxbKDaersHunJHqwbGqa",205,0.990385,40,208,2,206,1,2,1,3,2,107,106,100,100,51
"4332",31,"[40]yIdHoIdwFBkDmrJAunBkhxbKDaersHunJHqwbGqa",197,0.99,40,200,2,198,1,2,1,3,2,95,94,104,104,51
"4333",32,"[40]yIdHoIdwFBkDmrJAunBkhxbKDaersHunJHqwbGqa",197,0.99,40,200,2,198,1,2,1,3,2,97,96,102,102,51
"4334",33,"[40]yIdHoIdwFBkDmrJAunBkhxbKDaersHunJHqwbGqa",201,0.990196,40,204,2,202,1,2,1,3,2,103,102,100,100,51
"4335",34,"[40]yIdHoIdwFBkDmrJAunBkhxbKDaersHunJHqwbGqa",201,0.990196,40,204,2,202,1,2,1,3,2,101,100,102,102,51
"4336",35,"[40]yIdHoIdwFBkDmrJAunBkhxbKDaersHunJHqwbGqa",197,0.99,40,200,2,198,1,2,1,3,2,98,97,101,101,51
"4337",36,"[40]yIdHoIdwFBkDmrJAunBkhxbKDaersHunJHqwbGqa",192,0.989744,40,195,2,193,1,2,1,3,2,91,90,103,103,51
"4338",37,"[40]yIdHoIdwFBkDmrJAunBkhxbKDaersHunJHqwbGqa",190,0.989637,40,193,2,191,1,2,1,3,2,86,85,106,106,51
"4339",38,"[40]yIdHoIdwFBkDmrJAunBkhxbKDaersHunJHqwbGqa",198,0.99005,40,201,2,199,1,2,1,3,2,99,98,101,101,51
"4340",39,"[40]yIdHoIdwFBkDmrJAunBkhxbKDaersHunJHqwbGqa",202,0.990244,40,205,2,203,1,2,1,3,2,103,102,101,101,51
"4341",40,"[40]yIdHoIdwFBkDmrJAunBkhxbKDaersHunJHqwbGqa",191,0.989691,40,194,2,192,1,2,1,3,2,88,87,105,105,51
"4342",41,"[40]yIdHoIdwFBkDmrJAunBkhxbKDaersHunJHqwbGqa",203,0.990291,40,206,2,204,1,2,1,3,2,105,104,100,100,51
"4343",42,"[40]yIdHoIdwFBkDmrJAunBkhxbKDaersHunJHqwbGqa",188,0.989529,40,191,2,189,1,2,1,3,2,84,83,106,106,51
"4344",43,"[40]yIdHoIdwFBkDmrJAunBkhxbKDaersHunJHqwbGqa",204,0.990338,40,207,2,205,1,2,1,3,2,107,106,99,99,51
"4345",44,"[40]yIdHoIdwFBkDmrJAunBkhxbKDaersHunJHqwbGqa",204,0.990338,40,207,2,205,1,2,1,3,2,106,105,100,100,51
"4346",45,"[40]yIdHoIdwFBkDmrJAunBkhxbKDaersHunJHqwbGqa",205,0.990385,40,208,2,206,1,2,1,3,2,106,105,101,101,51
"4347",46,"[40]yIdHoIdwFBkDmrJAunBkhxbKDaersHunJHqwbGqa",203,0.990291,40,206,2,204,1,2,1,3,2,105,104,100,100,51
"4348",47,"[40]yIdHoIdwFBkDmrJAunBkhxbKDaersHunJHqwbGqa",198,0.99005,40,201,2,199,1,2,1,3,2,100,99,100,100,51
"4349",48,"[40]yIdHoIdwFBkDmrJAunBkhxbKDaersHunJHqwbGqa",220,0.991031,40,223,2,221,1,2,1,3,2,126,125,96,96,51
"4350",49,"[40]yIdHoIdwFBkDmrJAunBkhxbKDaersHunJHqwbGqa",206,0.990431,40,209,2,207,1,2,1,3,2,109,108,99,99,51
"4351",50,"[40]yIdHoIdwFBkDmrJAunBkhxbKDaersHunJHqwbGqa",199,0.990099,40,202,2,200,1,2,1,3,2,99,98,102,102,51
"4352",51,"[40]yIdHoIdwFBkDmrJAunBkhxbKDaersHunJHqwbGqa",204,0.990338,40,207,2,205,1,2,1,3,2,104,103,102,102,51
"4353",52,"[40]yIdHoIdwFBkDmrJAunBkhxbKDaersHunJHqwbGqa",190,0.989637,40,193,2,191,1,2,1,3,2,88,87,104,104,51
"4354",53,"[40]yIdHoIdwFBkDmrJAunBkhxbKDaersHunJHqwbGqa",204,0.990338,40,207,2,205,1,2,1,3,2,109,108,97,97,51
"4355",54,"[40]yIdHoIdwFBkDmrJAunBkhxbKDaersHunJHqwbGqa",215,0.990826,40,218,2,216,1,2,1,3,2,122,121,95,95,51
"4356",55,"[40]yIdHoIdwFBkDmrJAunBkhxbKDaersHunJHqwbGqa",196,0.98995,40,199,2,197,1,2,1,3,2,95,94,103,103,51
"4357",56,"[40]yIdHoIdwFBkDmrJAunBkhxbKDaersHunJHqwbGqa",206,0.990431,40,209,2,207,1,2,1,3,2,108,107,100,100,51
"4358",57,"[40]yIdHoIdwFBkDmrJAunBkhxbKDaersHunJHqwbGqa",196,0.98995,40,199,2,197,1,2,1,3,2,96,95,102,102,51
"4359",58,"[40]yIdHoIdwFBkDmrJAunBkhxbKDaersHunJHqwbGqa",196,0.98995,40,199,2,197,1,2,1,3,2,96,95,102,102,51
"4360",59,"[40]yIdHoIdwFBkDmrJAunBkhxbKDaersHunJHqwbGqa",204,0.990338,40,207,2,205,1,2,1,3,2,107,106,99,99,51
"4361",60,"[40]yIdHoIdwFBkDmrJAunBkhxbKDaersHunJHqwbGqa",205,0.990385,40,208,2,206,1,2,1,3,2,107,106,100,100,51
"4362",61,"[40]yIdHoIdwFBkDmrJAunBkhxbKDaersHunJHqwbGqa",198,0.99005,40,201,2,199,1,2,1,3,2,97,96,103,103,51
"4363",62,"[40]yIdHoIdwFBkDmrJAunBkhxbKDaersHunJHqwbGqa",202,0.990244,40,205,2,203,1,2,1,3,2,106,105,98,98,51
"4364",63,"[40]yIdHoIdwFBkDmrJAunBkhxbKDaersHunJHqwbGqa",195,0.989899,40,198,2,196,1,2,1,3,2,94,93,103,103,51
"4365",64,"[40]yIdHoIdwFBkDmrJAunBkhxbKDaersHunJHqwbGqa",194,0.989848,40,197,2,195,1,2,1,3,2,94,93,102,102,51
"4366",65,"[40]yIdHoIdwFBkDmrJAunBkhxbKDaersHunJHqwbGqa",205,0.990385,40,208,2,206,1,2,1,3,2,108,107,99,99,51
"4367",66,"[40]yIdHoIdwFBkDmrJAunBkhxbKDaersHunJHqwbGqa",204,0.990338,40,207,2,205,1,2,1,3,2,108,107,98,98,51
"4368",67,"[40]yIdHoIdwFBkDmrJAunBkhxbKDaersHunJHqwbGqa",190,0.989637,40,193,2,191,1,2,1,3,2,85,84,107,107,51
"4369",68,"[40]yIdHoIdwFBkDmrJAunBkhxbKDaersHunJHqwbGqa",194,0.989848,40,197,2,195,1,2,1,3,2,94,93,102,102,51
"4370",69,"[40]yIdHoIdwFBkDmrJAunBkhxbKDaersHunJHqwbGqa",208,0.990521,40,211,2,209,1,2,1,3,2,112,111,98,98,51
"4371",70,"[40]yIdHoIdwFBkDmrJAunBkhxbKDaersHunJHqwbGqa",199,0.990099,40,202,2,200,1,2,1,3,2,98,97,103,103,51
"4372",71,"[40]yIdHoIdwFBkDmrJAunBkhxbKDaersHunJHqwbGqa",207,0.990476,40,210,2,208,1,2,1,3,2,111,110,98,98,51
"4373",72,"[40]yIdHoIdwFBkDmrJAunBkhxbKDaersHunJHqwbGqa",201,0.990196,40,204,2,202,1,2,1,3,2,103,102,100,100,51
"4374",73,"[40]yIdHoIdwFBkDmrJAunBkhxbKDaersHunJHqwbGqa",224,0.991189,40,227,2,225,1,2,1,3,2,135,134,91,91,51
"4375",74,"[40]yIdHoIdwFBkDmrJAunBkhxbKDaersHunJHqwbGqa",202,0.990244,40,205,2,203,1,2,1,3,2,102,101,102,102,51
"4376",75,"[40]yIdHoIdwFBkDmrJAunBkhxbKDaersHunJHqwbGqa",207,0.990476,40,210,2,208,1,2,1,3,2,113,112,96,96,51
"4377",76,"[40]yIdHoIdwFBkDmrJAunBkhxbKDaersHunJHqwbGqa",200,0.990148,40,203,2,201,1,2,1,3,2,100,99,102,102,51
"4378",77,"[40]yIdHoIdwFBkDmrJAunBkhxbKDaersHunJHqwbGqa",197,0.99,40,200,2,198,1,2,1,3,2,95,94,104,104,51
"4379",78,"[40]yIdHoIdwFBkDmrJAunBkhxbKDaersHunJHqwbGqa",206,0.990431,40,209,2,207,1,2,1,3,2,107,106,101,101,51
"4380",79,"[40]yIdHoIdwFBkDmrJAunBkhxbKDaersHunJHqwbGqa",206,0.990431,40,209,2,207,1,2,1,3,2,110,109,98,98,51
"4381",80,"[40]yIdHoIdwFBkDmrJAunBkhxbKDaersHunJHqwbGqa",194,0.989848,40,197,2,195,1,2,1,3,2,92,91,104,104,51
"4382",81,"[40]yIdHoIdwFBkDmrJAunBkhxbKDaersHunJHqwbGqa",185,0.989362,40,188,2,186,1,2,1,3,2,81,80,106,106,51
"4383",82,"[40]yIdHoIdwFBkDmrJAunBkhxbKDaersHunJHqwbGqa",204,0.990338,40,207,2,205,1,2,1,3,2,106,105,100,100,51
"4384",83,"[40]yIdHoIdwFBkDmrJAunBkhxbKDaersHunJHqwbGqa",199,0.990099,40,202,2,200,1,2,1,3,2,99,98,102,102,51
"4385",84,"[40]yIdHoIdwFBkDmrJAunBkhxbKDaersHunJHqwbGqa",198,0.99005,40,201,2,199,1,2,1,3,2,98,97,102,102,51
"4386",85,"[40]yIdHoIdwFBkDmrJAunBkhxbKDaersHunJHqwbGqa",198,0.99005,40,201,2,199,1,2,1,3,2,98,97,102,102,51
"4387",86,"[40]yIdHoIdwFBkDmrJAunBkhxbKDaersHunJHqwbGqa",200,0.990148,40,203,2,201,1,2,1,3,2,101,100,101,101,51
"4388",87,"[40]yIdHoIdwFBkDmrJAunBkhxbKDaersHunJHqwbGqa",183,0.989247,40,186,2,184,1,2,1,3,2,78,77,107,107,51
"4389",88,"[40]yIdHoIdwFBkDmrJAunBkhxbKDaersHunJHqwbGqa",202,0.990244,40,205,2,203,1,2,1,3,2,102,101,102,102,51
"4390",89,"[40]yIdHoIdwFBkDmrJAunBkhxbKDaersHunJHqwbGqa",210,0.99061,40,213,2,211,1,2,1,3,2,113,112,99,99,51
"4391",90,"[40]yIdHoIdwFBkDmrJAunBkhxbKDaersHunJHqwbGqa",199,0.990099,40,202,2,200,1,2,1,3,2,99,98,102,102,51
"4392",91,"[40]yIdHoIdwFBkDmrJAunBkhxbKDaersHunJHqwbGqa",209,0.990566,40,212,2,210,1,2,1,3,2,114,113,97,97,51
"4393",92,"[40]yIdHoIdwFBkDmrJAunBkhxbKDaersHunJHqwbGqa",201,0.990196,40,204,2,202,1,2,1,3,2,102,101,101,101,51
"4394",93,"[40]yIdHoIdwFBkDmrJAunBkhxbKDaersHunJHqwbGqa",192,0.989744,40,195,2,193,1,2,1,3,2,91,90,103,103,51
"4395",94,"[40]yIdHoIdwFBkDmrJAunBkhxbKDaersHunJHqwbGqa",218,0.99095,40,221,2,219,1,2,1,3,2,127,126,93,93,51
"4396",95,"[40]yIdHoIdwFBkDmrJAunBkhxbKDaersHunJHqwbGqa",207,0.990476,40,210,2,208,1,2,1,3,2,110,109,99,99,51
"4397",96,"[40]yIdHoIdwFBkDmrJAunBkhxbKDaersHunJHqwbGqa",211,0.990654,40,214,2,212,1,2,1,3,2,114,113,99,99,51
"4398",97,"[40]yIdHoIdwFBkDmrJAunBkhxbKDaersHunJHqwbGqa",200,0.990148,40,203,2,201,1,2,1,3,2,100,99,102,102,51
"4399",98,"[40]yIdHoIdwFBkDmrJAunBkhxbKDaersHunJHqwbGqa",197,0.99,40,200,2,198,1,2,1,3,2,93,92,106,106,51
"4400",99,"[40]yIdHoIdwFBkDmrJAunBkhxbKDaersHunJHqwbGqa",199,0.990099,40,202,2,200,1,2,1,3,2,99,98,102,102,51
"4401",0,"[40]cIuHoIoEABkDkeDGpHyiHDbKDaetuHsnJHqvbGqa",200,0.990148,40,203,2,201,1,2,1,3,2,100,99,102,102,53
"4402",1,"[40]cIuHoIoEABkDkeDGpHyiHDbKDaetuHsnJHqvbGqa",210,0.99061,40,213,2,211,1,2,1,3,2,116,115,96,96,53
"4403",2,"[40]cIuHoIoEABkDkeDGpHyiHDbKDaetuHsnJHqvbGqa",201,0.990196,40,204,2,202,1,2,1,3,2,103,102,100,100,53
"4404",3,"[40]cIuHoIoEABkDkeDGpHyiHDbKDaetuHsnJHqvbGqa",196,0.98995,40,199,2,197,1,2,1,3,2,96,95,102,102,53
"4405",4,"[40]cIuHoIoEABkDkeDGpHyiHDbKDaetuHsnJHqvbGqa",196,0.98995,40,199,2,197,1,2,1,3,2,98,97,100,100,53
"4406",5,"[40]cIuHoIoEABkDkeDGpHyiHDbKDaetuHsnJHqvbGqa",209,0.990566,40,212,2,210,1,2,1,3,2,110,109,101,101,53
"4407",6,"[40]cIuHoIoEABkDkeDGpHyiHDbKDaetuHsnJHqvbGqa",202,0.990244,40,205,2,203,1,2,1,3,2,103,102,101,101,53
"4408",7,"[40]cIuHoIoEABkDkeDGpHyiHDbKDaetuHsnJHqvbGqa",209,0.990566,40,212,2,210,1,2,1,3,2,110,109,101,101,53
"4409",8,"[40]cIuHoIoEABkDkeDGpHyiHDbKDaetuHsnJHqvbGqa",211,0.990654,40,214,2,212,1,2,1,3,2,116,115,97,97,53
"4410",9,"[40]cIuHoIoEABkDkeDGpHyiHDbKDaetuHsnJHqvbGqa",206,0.990431,40,209,2,207,1,2,1,3,2,111,110,97,97,53
"4411",10,"[40]cIuHoIoEABkDkeDGpHyiHDbKDaetuHsnJHqvbGqa",206,0.990431,40,209,2,207,1,2,1,3,2,108,107,100,100,53
"4412",11,"[40]cIuHoIoEABkDkeDGpHyiHDbKDaetuHsnJHqvbGqa",194,0.989848,40,197,2,195,1,2,1,3,2,94,93,102,102,53
"4413",12,"[40]cIuHoIoEABkDkeDGpHyiHDbKDaetuHsnJHqvbGqa",194,0.989848,40,197,2,195,1,2,1,3,2,91,90,105,105,53
"4414",13,"[40]cIuHoIoEABkDkeDGpHyiHDbKDaetuHsnJHqvbGqa",198,0.99005,40,201,2,199,1,2,1,3,2,97,96,103,103,53
"4415",14,"[40]cIuHoIoEABkDkeDGpHyiHDbKDaetuHsnJHqvbGqa",199,0.990099,40,202,2,200,1,2,1,3,2,100,99,101,101,53
"4416",15,"[40]cIuHoIoEABkDkeDGpHyiHDbKDaetuHsnJHqvbGqa",196,0.98995,40,199,2,197,1,2,1,3,2,93,92,105,105,53
"4417",16,"[40]cIuHoIoEABkDkeDGpHyiHDbKDaetuHsnJHqvbGqa",206,0.990431,40,209,2,207,1,2,1,3,2,111,110,97,97,53
"4418",17,"[40]cIuHoIoEABkDkeDGpHyiHDbKDaetuHsnJHqvbGqa",208,0.990521,40,211,2,209,1,2,1,3,2,111,110,99,99,53
"4419",18,"[40]cIuHoIoEABkDkeDGpHyiHDbKDaetuHsnJHqvbGqa",202,0.990244,40,205,2,203,1,2,1,3,2,108,107,96,96,53
"4420",19,"[40]cIuHoIoEABkDkeDGpHyiHDbKDaetuHsnJHqvbGqa",201,0.990196,40,204,2,202,1,2,1,3,2,101,100,102,102,53
"4421",20,"[40]cIuHoIoEABkDkeDGpHyiHDbKDaetuHsnJHqvbGqa",206,0.990431,40,209,2,207,1,2,1,3,2,107,106,101,101,53
"4422",21,"[40]cIuHoIoEABkDkeDGpHyiHDbKDaetuHsnJHqvbGqa",212,0.990698,40,215,2,213,1,2,1,3,2,118,117,96,96,53
"4423",22,"[40]cIuHoIoEABkDkeDGpHyiHDbKDaetuHsnJHqvbGqa",206,0.990431,40,209,2,207,1,2,1,3,2,110,109,98,98,53
"4424",23,"[40]cIuHoIoEABkDkeDGpHyiHDbKDaetuHsnJHqvbGqa",176,0.988827,40,179,2,177,1,2,1,3,2,70,69,108,108,53
"4425",24,"[40]cIuHoIoEABkDkeDGpHyiHDbKDaetuHsnJHqvbGqa",195,0.989899,40,198,2,196,1,2,1,3,2,94,93,103,103,53
"4426",25,"[40]cIuHoIoEABkDkeDGpHyiHDbKDaetuHsnJHqvbGqa",203,0.990291,40,206,2,204,1,2,1,3,2,105,104,100,100,53
"4427",26,"[40]cIuHoIoEABkDkeDGpHyiHDbKDaetuHsnJHqvbGqa",204,0.990338,40,207,2,205,1,2,1,3,2,103,102,103,103,53
"4428",27,"[40]cIuHoIoEABkDkeDGpHyiHDbKDaetuHsnJHqvbGqa",190,0.989637,40,193,2,191,1,2,1,3,2,88,87,104,104,53
"4429",28,"[40]cIuHoIoEABkDkeDGpHyiHDbKDaetuHsnJHqvbGqa",217,0.990909,40,220,2,218,1,2,1,3,2,123,122,96,96,53
"4430",29,"[40]cIuHoIoEABkDkeDGpHyiHDbKDaetuHsnJHqvbGqa",217,0.990909,40,220,2,218,1,2,1,3,2,125,124,94,94,53
"4431",30,"[40]cIuHoIoEABkDkeDGpHyiHDbKDaetuHsnJHqvbGqa",201,0.990196,40,204,2,202,1,2,1,3,2,102,101,101,101,53
"4432",31,"[40]cIuHoIoEABkDkeDGpHyiHDbKDaetuHsnJHqvbGqa",215,0.990826,40,218,2,216,1,2,1,3,2,122,121,95,95,53
"4433",32,"[40]cIuHoIoEABkDkeDGpHyiHDbKDaetuHsnJHqvbGqa",193,0.989796,40,196,2,194,1,2,1,3,2,90,89,105,105,53
"4434",33,"[40]cIuHoIoEABkDkeDGpHyiHDbKDaetuHsnJHqvbGqa",199,0.990099,40,202,2,200,1,2,1,3,2,98,97,103,103,53
"4435",34,"[40]cIuHoIoEABkDkeDGpHyiHDbKDaetuHsnJHqvbGqa",186,0.989418,40,189,2,187,1,2,1,3,2,81,80,107,107,53
"4436",35,"[40]cIuHoIoEABkDkeDGpHyiHDbKDaetuHsnJHqvbGqa",213,0.990741,40,216,2,214,1,2,1,3,2,118,117,97,97,53
"4437",36,"[40]cIuHoIoEABkDkeDGpHyiHDbKDaetuHsnJHqvbGqa",202,0.990244,40,205,2,203,1,2,1,3,2,105,104,99,99,53
"4438",37,"[40]cIuHoIoEABkDkeDGpHyiHDbKDaetuHsnJHqvbGqa",203,0.990291,40,206,2,204,1,2,1,3,2,106,105,99,99,53
"4439",38,"[40]cIuHoIoEABkDkeDGpHyiHDbKDaetuHsnJHqvbGqa",198,0.99005,40,201,2,199,1,2,1,3,2,97,96,103,103,53
"4440",39,"[40]cIuHoIoEABkDkeDGpHyiHDbKDaetuHsnJHqvbGqa",205,0.990385,40,208,2,206,1,2,1,3,2,109,108,98,98,53
"4441",40,"[40]cIuHoIoEABkDkeDGpHyiHDbKDaetuHsnJHqvbGqa",200,0.990148,40,203,2,201,1,2,1,3,2,102,101,100,100,53
"4442",41,"[40]cIuHoIoEABkDkeDGpHyiHDbKDaetuHsnJHqvbGqa",214,0.990783,40,217,2,215,1,2,1,3,2,119,118,97,97,53
"4443",42,"[40]cIuHoIoEABkDkeDGpHyiHDbKDaetuHsnJHqvbGqa",196,0.98995,40,199,2,197,1,2,1,3,2,95,94,103,103,53
"4444",43,"[40]cIuHoIoEABkDkeDGpHyiHDbKDaetuHsnJHqvbGqa",191,0.989691,40,194,2,192,1,2,1,3,2,89,88,104,104,53
"4445",44,"[40]cIuHoIoEABkDkeDGpHyiHDbKDaetuHsnJHqvbGqa",203,0.990291,40,206,2,204,1,2,1,3,2,104,103,101,101,53
"4446",45,"[40]cIuHoIoEABkDkeDGpHyiHDbKDaetuHsnJHqvbGqa",193,0.989796,40,196,2,194,1,2,1,3,2,91,90,104,104,53
"4447",46,"[40]cIuHoIoEABkDkeDGpHyiHDbKDaetuHsnJHqvbGqa",196,0.98995,40,199,2,197,1,2,1,3,2,96,95,102,102,53
"4448",47,"[40]cIuHoIoEABkDkeDGpHyiHDbKDaetuHsnJHqvbGqa",206,0.990431,40,209,2,207,1,2,1,3,2,106,105,102,102,53
"4449",48,"[40]cIuHoIoEABkDkeDGpHyiHDbKDaetuHsnJHqvbGqa",203,0.990291,40,206,2,204,1,2,1,3,2,106,105,99,99,53
"4450",49,"[40]cIuHoIoEABkDkeDGpHyiHDbKDaetuHsnJHqvbGqa",200,0.990148,40,203,2,201,1,2,1,3,2,103,102,99,99,53
"4451",50,"[40]cIuHoIoEABkDkeDGpHyiHDbKDaetuHsnJHqvbGqa",206,0.990431,40,209,2,207,1,2,1,3,2,108,107,100,100,53
"4452",51,"[40]cIuHoIoEABkDkeDGpHyiHDbKDaetuHsnJHqvbGqa",188,0.989529,40,191,2,189,1,2,1,3,2,81,80,109,109,53
"4453",52,"[40]cIuHoIoEABkDkeDGpHyiHDbKDaetuHsnJHqvbGqa",198,0.99005,40,201,2,199,1,2,1,3,2,97,96,103,103,53
"4454",53,"[40]cIuHoIoEABkDkeDGpHyiHDbKDaetuHsnJHqvbGqa",210,0.99061,40,213,2,211,1,2,1,3,2,116,115,96,96,53
"4455",54,"[40]cIuHoIoEABkDkeDGpHyiHDbKDaetuHsnJHqvbGqa",194,0.989848,40,197,2,195,1,2,1,3,2,93,92,103,103,53
"4456",55,"[40]cIuHoIoEABkDkeDGpHyiHDbKDaetuHsnJHqvbGqa",198,0.99005,40,201,2,199,1,2,1,3,2,99,98,101,101,53
"4457",56,"[40]cIuHoIoEABkDkeDGpHyiHDbKDaetuHsnJHqvbGqa",204,0.990338,40,207,2,205,1,2,1,3,2,106,105,100,100,53
"4458",57,"[40]cIuHoIoEABkDkeDGpHyiHDbKDaetuHsnJHqvbGqa",208,0.990521,40,211,2,209,1,2,1,3,2,111,110,99,99,53
"4459",58,"[40]cIuHoIoEABkDkeDGpHyiHDbKDaetuHsnJHqvbGqa",219,0.990991,40,222,2,220,1,2,1,3,2,126,125,95,95,53
"4460",59,"[40]cIuHoIoEABkDkeDGpHyiHDbKDaetuHsnJHqvbGqa",202,0.990244,40,205,2,203,1,2,1,3,2,106,105,98,98,53
"4461",60,"[40]cIuHoIoEABkDkeDGpHyiHDbKDaetuHsnJHqvbGqa",216,0.990868,40,219,2,217,1,2,1,3,2,123,122,95,95,53
"4462",61,"[40]cIuHoIoEABkDkeDGpHyiHDbKDaetuHsnJHqvbGqa",207,0.990476,40,210,2,208,1,2,1,3,2,110,109,99,99,53
"4463",62,"[40]cIuHoIoEABkDkeDGpHyiHDbKDaetuHsnJHqvbGqa",206,0.990431,40,209,2,207,1,2,1,3,2,111,110,97,97,53
"4464",63,"[40]cIuHoIoEABkDkeDGpHyiHDbKDaetuHsnJHqvbGqa",197,0.99,40,200,2,198,1,2,1,3,2,97,96,102,102,53
"4465",64,"[40]cIuHoIoEABkDkeDGpHyiHDbKDaetuHsnJHqvbGqa",192,0.989744,40,195,2,193,1,2,1,3,2,89,88,105,105,53
"4466",65,"[40]cIuHoIoEABkDkeDGpHyiHDbKDaetuHsnJHqvbGqa",222,0.991111,40,225,2,223,1,2,1,3,2,133,132,91,91,53
"4467",66,"[40]cIuHoIoEABkDkeDGpHyiHDbKDaetuHsnJHqvbGqa",192,0.989744,40,195,2,193,1,2,1,3,2,90,89,104,104,53
"4468",67,"[40]cIuHoIoEABkDkeDGpHyiHDbKDaetuHsnJHqvbGqa",209,0.990566,40,212,2,210,1,2,1,3,2,114,113,97,97,53
"4469",68,"[40]cIuHoIoEABkDkeDGpHyiHDbKDaetuHsnJHqvbGqa",201,0.990196,40,204,2,202,1,2,1,3,2,103,102,100,100,53
"4470",69,"[40]cIuHoIoEABkDkeDGpHyiHDbKDaetuHsnJHqvbGqa",210,0.99061,40,213,2,211,1,2,1,3,2,113,112,99,99,53
"4471",70,"[40]cIuHoIoEABkDkeDGpHyiHDbKDaetuHsnJHqvbGqa",209,0.990566,40,212,2,210,1,2,1,3,2,114,113,97,97,53
"4472",71,"[40]cIuHoIoEABkDkeDGpHyiHDbKDaetuHsnJHqvbGqa",198,0.99005,40,201,2,199,1,2,1,3,2,97,96,103,103,53
"4473",72,"[40]cIuHoIoEABkDkeDGpHyiHDbKDaetuHsnJHqvbGqa",204,0.990338,40,207,2,205,1,2,1,3,2,105,104,101,101,53
"4474",73,"[40]cIuHoIoEABkDkeDGpHyiHDbKDaetuHsnJHqvbGqa",206,0.990431,40,209,2,207,1,2,1,3,2,110,109,98,98,53
"4475",74,"[40]cIuHoIoEABkDkeDGpHyiHDbKDaetuHsnJHqvbGqa",202,0.990244,40,205,2,203,1,2,1,3,2,101,100,103,103,53
"4476",75,"[40]cIuHoIoEABkDkeDGpHyiHDbKDaetuHsnJHqvbGqa",205,0.990385,40,208,2,206,1,2,1,3,2,108,107,99,99,53
"4477",76,"[40]cIuHoIoEABkDkeDGpHyiHDbKDaetuHsnJHqvbGqa",218,0.99095,40,221,2,219,1,2,1,3,2,127,126,93,93,53
"4478",77,"[40]cIuHoIoEABkDkeDGpHyiHDbKDaetuHsnJHqvbGqa",201,0.990196,40,204,2,202,1,2,1,3,2,104,103,99,99,53
"4479",78,"[40]cIuHoIoEABkDkeDGpHyiHDbKDaetuHsnJHqvbGqa",214,0.990783,40,217,2,215,1,2,1,3,2,120,119,96,96,53
"4480",79,"[40]cIuHoIoEABkDkeDGpHyiHDbKDaetuHsnJHqvbGqa",209,0.990566,40,212,2,210,1,2,1,3,2,114,113,97,97,53
"4481",80,"[40]cIuHoIoEABkDkeDGpHyiHDbKDaetuHsnJHqvbGqa",207,0.990476,40,210,2,208,1,2,1,3,2,109,108,100,100,53
"4482",81,"[40]cIuHoIoEABkDkeDGpHyiHDbKDaetuHsnJHqvbGqa",212,0.990698,40,215,2,213,1,2,1,3,2,118,117,96,96,53
"4483",82,"[40]cIuHoIoEABkDkeDGpHyiHDbKDaetuHsnJHqvbGqa",202,0.990244,40,205,2,203,1,2,1,3,2,105,104,99,99,53
"4484",83,"[40]cIuHoIoEABkDkeDGpHyiHDbKDaetuHsnJHqvbGqa",185,0.989362,40,188,2,186,1,2,1,3,2,81,80,106,106,53
"4485",84,"[40]cIuHoIoEABkDkeDGpHyiHDbKDaetuHsnJHqvbGqa",211,0.990654,40,214,2,212,1,2,1,3,2,117,116,96,96,53
"4486",85,"[40]cIuHoIoEABkDkeDGpHyiHDbKDaetuHsnJHqvbGqa",206,0.990431,40,209,2,207,1,2,1,3,2,108,107,100,100,53
"4487",86,"[40]cIuHoIoEABkDkeDGpHyiHDbKDaetuHsnJHqvbGqa",196,0.98995,40,199,2,197,1,2,1,3,2,96,95,102,102,53
"4488",87,"[40]cIuHoIoEABkDkeDGpHyiHDbKDaetuHsnJHqvbGqa",208,0.990521,40,211,2,209,1,2,1,3,2,111,110,99,99,53
"4489",88,"[40]cIuHoIoEABkDkeDGpHyiHDbKDaetuHsnJHqvbGqa",212,0.990698,40,215,2,213,1,2,1,3,2,119,118,95,95,53
"4490",89,"[40]cIuHoIoEABkDkeDGpHyiHDbKDaetuHsnJHqvbGqa",203,0.990291,40,206,2,204,1,2,1,3,2,105,104,100,100,53
"4491",90,"[40]cIuHoIoEABkDkeDGpHyiHDbKDaetuHsnJHqvbGqa",202,0.990244,40,205,2,203,1,2,1,3,2,104,103,100,100,53
"4492",91,"[40]cIuHoIoEABkDkeDGpHyiHDbKDaetuHsnJHqvbGqa",204,0.990338,40,207,2,205,1,2,1,3,2,104,103,102,102,53
"4493",92,"[40]cIuHoIoEABkDkeDGpHyiHDbKDaetuHsnJHqvbGqa",189,0.989583,40,192,2,190,1,2,1,3,2,84,83,107,107,53
"4494",93,"[40]cIuHoIoEABkDkeDGpHyiHDbKDaetuHsnJHqvbGqa",198,0.99005,40,201,2,199,1,2,1,3,2,101,100,99,99,53
"4495",94,"[40]cIuHoIoEABkDkeDGpHyiHDbKDaetuHsnJHqvbGqa",194,0.989848,40,197,2,195,1,2,1,3,2,88,87,108,108,53
"4496",95,"[40]cIuHoIoEABkDkeDGpHyiHDbKDaetuHsnJHqvbGqa",206,0.990431,40,209,2,207,1,2,1,3,2,111,110,97,97,53
"4497",96,"[40]cIuHoIoEABkDkeDGpHyiHDbKDaetuHsnJHqvbGqa",195,0.989899,40,198,2,196,1,2,1,3,2,94,93,103,103,53
"4498",97,"[40]cIuHoIoEABkDkeDGpHyiHDbKDaetuHsnJHqvbGqa",199,0.990099,40,202,2,200,1,2,1,3,2,98,97,103,103,53
"4499",98,"[40]cIuHoIoEABkDkeDGpHyiHDbKDaetuHsnJHqvbGqa",201,0.990196,40,204,2,202,1,2,1,3,2,102,101,101,101,53
"4500",99,"[40]cIuHoIoEABkDkeDGpHyiHDbKDaetuHsnJHqvbGqa",204,0.990338,40,207,2,205,1,2,1,3,2,107,106,99,99,53
"4501",0,"[40]cIHHoIoFfBkDhAtvBforEvbKDaeduHtnJHqvbGqa",202,0.990244,40,205,2,203,1,2,1,3,2,103,102,101,101,54
"4502",1,"[40]cIHHoIoFfBkDhAtvBforEvbKDaeduHtnJHqvbGqa",198,0.99005,40,201,2,199,1,2,1,3,2,99,98,101,101,54
"4503",2,"[40]cIHHoIoFfBkDhAtvBforEvbKDaeduHtnJHqvbGqa",201,0.990196,40,204,2,202,1,2,1,3,2,102,101,101,101,54
"4504",3,"[40]cIHHoIoFfBkDhAtvBforEvbKDaeduHtnJHqvbGqa",206,0.990431,40,209,2,207,1,2,1,3,2,109,108,99,99,54
"4505",4,"[40]cIHHoIoFfBkDhAtvBforEvbKDaeduHtnJHqvbGqa",190,0.989637,40,193,2,191,1,2,1,3,2,87,86,105,105,54
"4506",5,"[40]cIHHoIoFfBkDhAtvBforEvbKDaeduHtnJHqvbGqa",200,0.990148,40,203,2,201,1,2,1,3,2,102,101,100,100,54
"4507",6,"[40]cIHHoIoFfBkDhAtvBforEvbKDaeduHtnJHqvbGqa",194,0.989848,40,197,2,195,1,2,1,3,2,92,91,104,104,54
"4508",7,"[40]cIHHoIoFfBkDhAtvBforEvbKDaeduHtnJHqvbGqa",207,0.990476,40,210,2,208,1,2,1,3,2,111,110,98,98,54
"4509",8,"[40]cIHHoIoFfBkDhAtvBforEvbKDaeduHtnJHqvbGqa",217,0.990909,40,220,2,218,1,2,1,3,2,122,121,97,97,54
"4510",9,"[40]cIHHoIoFfBkDhAtvBforEvbKDaeduHtnJHqvbGqa",211,0.990654,40,214,2,212,1,2,1,3,2,114,113,99,99,54
"4511",10,"[40]cIHHoIoFfBkDhAtvBforEvbKDaeduHtnJHqvbGqa",202,0.990244,40,205,2,203,1,2,1,3,2,104,103,100,100,54
"4512",11,"[40]cIHHoIoFfBkDhAtvBforEvbKDaeduHtnJHqvbGqa",194,0.989848,40,197,2,195,1,2,1,3,2,93,92,103,103,54
"4513",12,"[40]cIHHoIoFfBkDhAtvBforEvbKDaeduHtnJHqvbGqa",204,0.990338,40,207,2,205,1,2,1,3,2,105,104,101,101,54
"4514",13,"[40]cIHHoIoFfBkDhAtvBforEvbKDaeduHtnJHqvbGqa",194,0.989848,40,197,2,195,1,2,1,3,2,95,94,101,101,54
"4515",14,"[40]cIHHoIoFfBkDhAtvBforEvbKDaeduHtnJHqvbGqa",199,0.990099,40,202,2,200,1,2,1,3,2,99,98,102,102,54
"4516",15,"[40]cIHHoIoFfBkDhAtvBforEvbKDaeduHtnJHqvbGqa",215,0.990826,40,218,2,216,1,2,1,3,2,121,120,96,96,54
"4517",16,"[40]cIHHoIoFfBkDhAtvBforEvbKDaeduHtnJHqvbGqa",215,0.990826,40,218,2,216,1,2,1,3,2,121,120,96,96,54
"4518",17,"[40]cIHHoIoFfBkDhAtvBforEvbKDaeduHtnJHqvbGqa",203,0.990291,40,206,2,204,1,2,1,3,2,103,102,102,102,54
"4519",18,"[40]cIHHoIoFfBkDhAtvBforEvbKDaeduHtnJHqvbGqa",206,0.990431,40,209,2,207,1,2,1,3,2,110,109,98,98,54
"4520",19,"[40]cIHHoIoFfBkDhAtvBforEvbKDaeduHtnJHqvbGqa",197,0.99,40,200,2,198,1,2,1,3,2,98,97,101,101,54
"4521",20,"[40]cIHHoIoFfBkDhAtvBforEvbKDaeduHtnJHqvbGqa",199,0.990099,40,202,2,200,1,2,1,3,2,99,98,102,102,54
"4522",21,"[40]cIHHoIoFfBkDhAtvBforEvbKDaeduHtnJHqvbGqa",209,0.990566,40,212,2,210,1,2,1,3,2,113,112,98,98,54
"4523",22,"[40]cIHHoIoFfBkDhAtvBforEvbKDaeduHtnJHqvbGqa",196,0.98995,40,199,2,197,1,2,1,3,2,95,94,103,103,54
"4524",23,"[40]cIHHoIoFfBkDhAtvBforEvbKDaeduHtnJHqvbGqa",213,0.990741,40,216,2,214,1,2,1,3,2,118,117,97,97,54
"4525",24,"[40]cIHHoIoFfBkDhAtvBforEvbKDaeduHtnJHqvbGqa",201,0.990196,40,204,2,202,1,2,1,3,2,102,101,101,101,54
"4526",25,"[40]cIHHoIoFfBkDhAtvBforEvbKDaeduHtnJHqvbGqa",213,0.990741,40,216,2,214,1,2,1,3,2,122,121,93,93,54
"4527",26,"[40]cIHHoIoFfBkDhAtvBforEvbKDaeduHtnJHqvbGqa",207,0.990476,40,210,2,208,1,2,1,3,2,110,109,99,99,54
"4528",27,"[40]cIHHoIoFfBkDhAtvBforEvbKDaeduHtnJHqvbGqa",204,0.990338,40,207,2,205,1,2,1,3,2,106,105,100,100,54
"4529",28,"[40]cIHHoIoFfBkDhAtvBforEvbKDaeduHtnJHqvbGqa",205,0.990385,40,208,2,206,1,2,1,3,2,106,105,101,101,54
"4530",29,"[40]cIHHoIoFfBkDhAtvBforEvbKDaeduHtnJHqvbGqa",195,0.989899,40,198,2,196,1,2,1,3,2,94,93,103,103,54
"4531",30,"[40]cIHHoIoFfBkDhAtvBforEvbKDaeduHtnJHqvbGqa",198,0.99005,40,201,2,199,1,2,1,3,2,99,98,101,101,54
"4532",31,"[40]cIHHoIoFfBkDhAtvBforEvbKDaeduHtnJHqvbGqa",213,0.990741,40,216,2,214,1,2,1,3,2,117,116,98,98,54
"4533",32,"[40]cIHHoIoFfBkDhAtvBforEvbKDaeduHtnJHqvbGqa",188,0.989529,40,191,2,189,1,2,1,3,2,85,84,105,105,54
"4534",33,"[40]cIHHoIoFfBkDhAtvBforEvbKDaeduHtnJHqvbGqa",193,0.989796,40,196,2,194,1,2,1,3,2,93,92,102,102,54
"4535",34,"[40]cIHHoIoFfBkDhAtvBforEvbKDaeduHtnJHqvbGqa",198,0.99005,40,201,2,199,1,2,1,3,2,95,94,105,105,54
"4536",35,"[40]cIHHoIoFfBkDhAtvBforEvbKDaeduHtnJHqvbGqa",201,0.990196,40,204,2,202,1,2,1,3,2,101,100,102,102,54
"4537",36,"[40]cIHHoIoFfBkDhAtvBforEvbKDaeduHtnJHqvbGqa",212,0.990698,40,215,2,213,1,2,1,3,2,116,115,98,98,54
"4538",37,"[40]cIHHoIoFfBkDhAtvBforEvbKDaeduHtnJHqvbGqa",193,0.989796,40,196,2,194,1,2,1,3,2,90,89,105,105,54
"4539",38,"[40]cIHHoIoFfBkDhAtvBforEvbKDaeduHtnJHqvbGqa",204,0.990338,40,207,2,205,1,2,1,3,2,107,106,99,99,54
"4540",39,"[40]cIHHoIoFfBkDhAtvBforEvbKDaeduHtnJHqvbGqa",197,0.99,40,200,2,198,1,2,1,3,2,96,95,103,103,54
"4541",40,"[40]cIHHoIoFfBkDhAtvBforEvbKDaeduHtnJHqvbGqa",203,0.990291,40,206,2,204,1,2,1,3,2,107,106,98,98,54
"4542",41,"[40]cIHHoIoFfBkDhAtvBforEvbKDaeduHtnJHqvbGqa",207,0.990476,40,210,2,208,1,2,1,3,2,110,109,99,99,54
"4543",42,"[40]cIHHoIoFfBkDhAtvBforEvbKDaeduHtnJHqvbGqa",201,0.990196,40,204,2,202,1,2,1,3,2,102,101,101,101,54
"4544",43,"[40]cIHHoIoFfBkDhAtvBforEvbKDaeduHtnJHqvbGqa",201,0.990196,40,204,2,202,1,2,1,3,2,102,101,101,101,54
"4545",44,"[40]cIHHoIoFfBkDhAtvBforEvbKDaeduHtnJHqvbGqa",201,0.990196,40,204,2,202,1,2,1,3,2,101,100,102,102,54
"4546",45,"[40]cIHHoIoFfBkDhAtvBforEvbKDaeduHtnJHqvbGqa",191,0.989691,40,194,2,192,1,2,1,3,2,88,87,105,105,54
"4547",46,"[40]cIHHoIoFfBkDhAtvBforEvbKDaeduHtnJHqvbGqa",214,0.990783,40,217,2,215,1,2,1,3,2,117,116,99,99,54
"4548",47,"[40]cIHHoIoFfBkDhAtvBforEvbKDaeduHtnJHqvbGqa",194,0.989848,40,197,2,195,1,2,1,3,2,93,92,103,103,54
"4549",48,"[40]cIHHoIoFfBkDhAtvBforEvbKDaeduHtnJHqvbGqa",201,0.990196,40,204,2,202,1,2,1,3,2,103,102,100,100,54
"4550",49,"[40]cIHHoIoFfBkDhAtvBforEvbKDaeduHtnJHqvbGqa",221,0.991071,40,224,2,222,1,2,1,3,2,128,127,95,95,54
"4551",50,"[40]cIHHoIoFfBkDhAtvBforEvbKDaeduHtnJHqvbGqa",194,0.989848,40,197,2,195,1,2,1,3,2,90,89,106,106,54
"4552",51,"[40]cIHHoIoFfBkDhAtvBforEvbKDaeduHtnJHqvbGqa",211,0.990654,40,214,2,212,1,2,1,3,2,115,114,98,98,54
"4553",52,"[40]cIHHoIoFfBkDhAtvBforEvbKDaeduHtnJHqvbGqa",210,0.99061,40,213,2,211,1,2,1,3,2,114,113,98,98,54
"4554",53,"[40]cIHHoIoFfBkDhAtvBforEvbKDaeduHtnJHqvbGqa",199,0.990099,40,202,2,200,1,2,1,3,2,99,98,102,102,54
"4555",54,"[40]cIHHoIoFfBkDhAtvBforEvbKDaeduHtnJHqvbGqa",212,0.990698,40,215,2,213,1,2,1,3,2,116,115,98,98,54
"4556",55,"[40]cIHHoIoFfBkDhAtvBforEvbKDaeduHtnJHqvbGqa",191,0.989691,40,194,2,192,1,2,1,3,2,89,88,104,104,54
"4557",56,"[40]cIHHoIoFfBkDhAtvBforEvbKDaeduHtnJHqvbGqa",209,0.990566,40,212,2,210,1,2,1,3,2,115,114,96,96,54
"4558",57,"[40]cIHHoIoFfBkDhAtvBforEvbKDaeduHtnJHqvbGqa",204,0.990338,40,207,2,205,1,2,1,3,2,107,106,99,99,54
"4559",58,"[40]cIHHoIoFfBkDhAtvBforEvbKDaeduHtnJHqvbGqa",195,0.989899,40,198,2,196,1,2,1,3,2,94,93,103,103,54
"4560",59,"[40]cIHHoIoFfBkDhAtvBforEvbKDaeduHtnJHqvbGqa",217,0.990909,40,220,2,218,1,2,1,3,2,124,123,95,95,54
"4561",60,"[40]cIHHoIoFfBkDhAtvBforEvbKDaeduHtnJHqvbGqa",187,0.989474,40,190,2,188,1,2,1,3,2,82,81,107,107,54
"4562",61,"[40]cIHHoIoFfBkDhAtvBforEvbKDaeduHtnJHqvbGqa",197,0.99,40,200,2,198,1,2,1,3,2,95,94,104,104,54
"4563",62,"[40]cIHHoIoFfBkDhAtvBforEvbKDaeduHtnJHqvbGqa",209,0.990566,40,212,2,210,1,2,1,3,2,112,111,99,99,54
"4564",63,"[40]cIHHoIoFfBkDhAtvBforEvbKDaeduHtnJHqvbGqa",184,0.989305,40,187,2,185,1,2,1,3,2,79,78,107,107,54
"4565",64,"[40]cIHHoIoFfBkDhAtvBforEvbKDaeduHtnJHqvbGqa",187,0.989474,40,190,2,188,1,2,1,3,2,83,82,106,106,54
"4566",65,"[40]cIHHoIoFfBkDhAtvBforEvbKDaeduHtnJHqvbGqa",207,0.990476,40,210,2,208,1,2,1,3,2,110,109,99,99,54
"4567",66,"[40]cIHHoIoFfBkDhAtvBforEvbKDaeduHtnJHqvbGqa",205,0.990385,40,208,2,206,1,2,1,3,2,108,107,99,99,54
"4568",67,"[40]cIHHoIoFfBkDhAtvBforEvbKDaeduHtnJHqvbGqa",202,0.990244,40,205,2,203,1,2,1,3,2,103,102,101,101,54
"4569",68,"[40]cIHHoIoFfBkDhAtvBforEvbKDaeduHtnJHqvbGqa",206,0.990431,40,209,2,207,1,2,1,3,2,105,104,103,103,54
"4570",69,"[40]cIHHoIoFfBkDhAtvBforEvbKDaeduHtnJHqvbGqa",194,0.989848,40,197,2,195,1,2,1,3,2,94,93,102,102,54
"4571",70,"[40]cIHHoIoFfBkDhAtvBforEvbKDaeduHtnJHqvbGqa",206,0.990431,40,209,2,207,1,2,1,3,2,109,108,99,99,54
"4572",71,"[40]cIHHoIoFfBkDhAtvBforEvbKDaeduHtnJHqvbGqa",202,0.990244,40,205,2,203,1,2,1,3,2,102,101,102,102,54
"4573",72,"[40]cIHHoIoFfBkDhAtvBforEvbKDaeduHtnJHqvbGqa",193,0.989796,40,196,2,194,1,2,1,3,2,92,91,103,103,54
"4574",73,"[40]cIHHoIoFfBkDhAtvBforEvbKDaeduHtnJHqvbGqa",190,0.989637,40,193,2,191,1,2,1,3,2,87,86,105,105,54
"4575",74,"[40]cIHHoIoFfBkDhAtvBforEvbKDaeduHtnJHqvbGqa",193,0.989796,40,196,2,194,1,2,1,3,2,92,91,103,103,54
"4576",75,"[40]cIHHoIoFfBkDhAtvBforEvbKDaeduHtnJHqvbGqa",203,0.990291,40,206,2,204,1,2,1,3,2,107,106,98,98,54
"4577",76,"[40]cIHHoIoFfBkDhAtvBforEvbKDaeduHtnJHqvbGqa",206,0.990431,40,209,2,207,1,2,1,3,2,108,107,100,100,54
"4578",77,"[40]cIHHoIoFfBkDhAtvBforEvbKDaeduHtnJHqvbGqa",202,0.990244,40,205,2,203,1,2,1,3,2,104,103,100,100,54
"4579",78,"[40]cIHHoIoFfBkDhAtvBforEvbKDaeduHtnJHqvbGqa",195,0.989899,40,198,2,196,1,2,1,3,2,94,93,103,103,54
"4580",79,"[40]cIHHoIoFfBkDhAtvBforEvbKDaeduHtnJHqvbGqa",213,0.990741,40,216,2,214,1,2,1,3,2,118,117,97,97,54
"4581",80,"[40]cIHHoIoFfBkDhAtvBforEvbKDaeduHtnJHqvbGqa",197,0.99,40,200,2,198,1,2,1,3,2,99,98,100,100,54
"4582",81,"[40]cIHHoIoFfBkDhAtvBforEvbKDaeduHtnJHqvbGqa",214,0.990783,40,217,2,215,1,2,1,3,2,122,121,94,94,54
"4583",82,"[40]cIHHoIoFfBkDhAtvBforEvbKDaeduHtnJHqvbGqa",218,0.99095,40,221,2,219,1,2,1,3,2,124,123,96,96,54
"4584",83,"[40]cIHHoIoFfBkDhAtvBforEvbKDaeduHtnJHqvbGqa",219,0.990991,40,222,2,220,1,2,1,3,2,126,125,95,95,54
"4585",84,"[40]cIHHoIoFfBkDhAtvBforEvbKDaeduHtnJHqvbGqa",195,0.989899,40,198,2,196,1,2,1,3,2,90,89,107,107,54
"4586",85,"[40]cIHHoIoFfBkDhAtvBforEvbKDaeduHtnJHqvbGqa",204,0.990338,40,207,2,205,1,2,1,3,2,105,104,101,101,54
"4587",86,"[40]cIHHoIoFfBkDhAtvBforEvbKDaeduHtnJHqvbGqa",200,0.990148,40,203,2,201,1,2,1,3,2,102,101,100,100,54
"4588",87,"[40]cIHHoIoFfBkDhAtvBforEvbKDaeduHtnJHqvbGqa",204,0.990338,40,207,2,205,1,2,1,3,2,105,104,101,101,54
"4589",88,"[40]cIHHoIoFfBkDhAtvBforEvbKDaeduHtnJHqvbGqa",214,0.990783,40,217,2,215,1,2,1,3,2,121,120,95,95,54
"4590",89,"[40]cIHHoIoFfBkDhAtvBforEvbKDaeduHtnJHqvbGqa",194,0.989848,40,197,2,195,1,2,1,3,2,92,91,104,104,54
"4591",90,"[40]cIHHoIoFfBkDhAtvBforEvbKDaeduHtnJHqvbGqa",196,0.98995,40,199,2,197,1,2,1,3,2,98,97,100,100,54
"4592",91,"[40]cIHHoIoFfBkDhAtvBforEvbKDaeduHtnJHqvbGqa",208,0.990521,40,211,2,209,1,2,1,3,2,110,109,100,100,54
"4593",92,"[40]cIHHoIoFfBkDhAtvBforEvbKDaeduHtnJHqvbGqa",195,0.989899,40,198,2,196,1,2,1,3,2,94,93,103,103,54
"4594",93,"[40]cIHHoIoFfBkDhAtvBforEvbKDaeduHtnJHqvbGqa",197,0.99,40,200,2,198,1,2,1,3,2,98,97,101,101,54
"4595",94,"[40]cIHHoIoFfBkDhAtvBforEvbKDaeduHtnJHqvbGqa",177,0.988889,40,180,2,178,1,2,1,3,2,70,69,109,109,54
"4596",95,"[40]cIHHoIoFfBkDhAtvBforEvbKDaeduHtnJHqvbGqa",209,0.990566,40,212,2,210,1,2,1,3,2,114,113,97,97,54
"4597",96,"[40]cIHHoIoFfBkDhAtvBforEvbKDaeduHtnJHqvbGqa",199,0.990099,40,202,2,200,1,2,1,3,2,100,99,101,101,54
"4598",97,"[40]cIHHoIoFfBkDhAtvBforEvbKDaeduHtnJHqvbGqa",207,0.990476,40,210,2,208,1,2,1,3,2,113,112,96,96,54
"4599",98,"[40]cIHHoIoFfBkDhAtvBforEvbKDaeduHtnJHqvbGqa",201,0.990196,40,204,2,202,1,2,1,3,2,102,101,101,101,54
"4600",99,"[40]cIHHoIoFfBkDhAtvBforEvbKDaeduHtnJHqvbGqa",201,0.990196,40,204,2,202,1,2,1,3,2,97,96,106,106,54
"4601",0,"[40]cIlHoIonnBkDakllnocHEKbKDaegtHvnJHqvbGqa",203,0.990291,40,206,2,204,1,2,1,3,2,104,103,101,101,55
"4602",1,"[40]cIlHoIonnBkDakllnocHEKbKDaegtHvnJHqvbGqa",213,0.990741,40,216,2,214,1,2,1,3,2,119,118,96,96,55
"4603",2,"[40]cIlHoIonnBkDakllnocHEKbKDaegtHvnJHqvbGqa",214,0.990783,40,217,2,215,1,2,1,3,2,120,119,96,96,55
"4604",3,"[40]cIlHoIonnBkDakllnocHEKbKDaegtHvnJHqvbGqa",185,0.989362,40,188,2,186,1,2,1,3,2,80,79,107,107,55
"4605",4,"[40]cIlHoIonnBkDakllnocHEKbKDaegtHvnJHqvbGqa",204,0.990338,40,207,2,205,1,2,1,3,2,105,104,101,101,55
"4606",5,"[40]cIlHoIonnBkDakllnocHEKbKDaegtHvnJHqvbGqa",203,0.990291,40,206,2,204,1,2,1,3,2,104,103,101,101,55
"4607",6,"[40]cIlHoIonnBkDakllnocHEKbKDaegtHvnJHqvbGqa",200,0.990148,40,203,2,201,1,2,1,3,2,102,101,100,100,55
"4608",7,"[40]cIlHoIonnBkDakllnocHEKbKDaegtHvnJHqvbGqa",208,0.990521,40,211,2,209,1,2,1,3,2,113,112,97,97,55
"4609",8,"[40]cIlHoIonnBkDakllnocHEKbKDaegtHvnJHqvbGqa",203,0.990291,40,206,2,204,1,2,1,3,2,105,104,100,100,55
"4610",9,"[40]cIlHoIonnBkDakllnocHEKbKDaegtHvnJHqvbGqa",191,0.989691,40,194,2,192,1,2,1,3,2,88,87,105,105,55
"4611",10,"[40]cIlHoIonnBkDakllnocHEKbKDaegtHvnJHqvbGqa",215,0.990826,40,218,2,216,1,2,1,3,2,123,122,94,94,55
"4612",11,"[40]cIlHoIonnBkDakllnocHEKbKDaegtHvnJHqvbGqa",188,0.989529,40,191,2,189,1,2,1,3,2,83,82,107,107,55
"4613",12,"[40]cIlHoIonnBkDakllnocHEKbKDaegtHvnJHqvbGqa",200,0.990148,40,203,2,201,1,2,1,3,2,100,99,102,102,55
"4614",13,"[40]cIlHoIonnBkDakllnocHEKbKDaegtHvnJHqvbGqa",200,0.990148,40,203,2,201,1,2,1,3,2,102,101,100,100,55
"4615",14,"[40]cIlHoIonnBkDakllnocHEKbKDaegtHvnJHqvbGqa",221,0.991071,40,224,2,222,1,2,1,3,2,131,130,92,92,55
"4616",15,"[40]cIlHoIonnBkDakllnocHEKbKDaegtHvnJHqvbGqa",194,0.989848,40,197,2,195,1,2,1,3,2,92,91,104,104,55
"4617",16,"[40]cIlHoIonnBkDakllnocHEKbKDaegtHvnJHqvbGqa",200,0.990148,40,203,2,201,1,2,1,3,2,102,101,100,100,55
"4618",17,"[40]cIlHoIonnBkDakllnocHEKbKDaegtHvnJHqvbGqa",194,0.989848,40,197,2,195,1,2,1,3,2,93,92,103,103,55
"4619",18,"[40]cIlHoIonnBkDakllnocHEKbKDaegtHvnJHqvbGqa",202,0.990244,40,205,2,203,1,2,1,3,2,104,103,100,100,55
"4620",19,"[40]cIlHoIonnBkDakllnocHEKbKDaegtHvnJHqvbGqa",203,0.990291,40,206,2,204,1,2,1,3,2,104,103,101,101,55
"4621",20,"[40]cIlHoIonnBkDakllnocHEKbKDaegtHvnJHqvbGqa",198,0.99005,40,201,2,199,1,2,1,3,2,98,97,102,102,55
"4622",21,"[40]cIlHoIonnBkDakllnocHEKbKDaegtHvnJHqvbGqa",197,0.99,40,200,2,198,1,2,1,3,2,96,95,103,103,55
"4623",22,"[40]cIlHoIonnBkDakllnocHEKbKDaegtHvnJHqvbGqa",204,0.990338,40,207,2,205,1,2,1,3,2,107,106,99,99,55
"4624",23,"[40]cIlHoIonnBkDakllnocHEKbKDaegtHvnJHqvbGqa",192,0.989744,40,195,2,193,1,2,1,3,2,90,89,104,104,55
"4625",24,"[40]cIlHoIonnBkDakllnocHEKbKDaegtHvnJHqvbGqa",193,0.989796,40,196,2,194,1,2,1,3,2,91,90,104,104,55
"4626",25,"[40]cIlHoIonnBkDakllnocHEKbKDaegtHvnJHqvbGqa",204,0.990338,40,207,2,205,1,2,1,3,2,106,105,100,100,55
"4627",26,"[40]cIlHoIonnBkDakllnocHEKbKDaegtHvnJHqvbGqa",191,0.989691,40,194,2,192,1,2,1,3,2,87,86,106,106,55
"4628",27,"[40]cIlHoIonnBkDakllnocHEKbKDaegtHvnJHqvbGqa",216,0.990868,40,219,2,217,1,2,1,3,2,120,119,98,98,55
"4629",28,"[40]cIlHoIonnBkDakllnocHEKbKDaegtHvnJHqvbGqa",200,0.990148,40,203,2,201,1,2,1,3,2,102,101,100,100,55
"4630",29,"[40]cIlHoIonnBkDakllnocHEKbKDaegtHvnJHqvbGqa",186,0.989418,40,189,2,187,1,2,1,3,2,82,81,106,106,55
"4631",30,"[40]cIlHoIonnBkDakllnocHEKbKDaegtHvnJHqvbGqa",210,0.99061,40,213,2,211,1,2,1,3,2,114,113,98,98,55
"4632",31,"[40]cIlHoIonnBkDakllnocHEKbKDaegtHvnJHqvbGqa",210,0.99061,40,213,2,211,1,2,1,3,2,111,110,101,101,55
"4633",32,"[40]cIlHoIonnBkDakllnocHEKbKDaegtHvnJHqvbGqa",207,0.990476,40,210,2,208,1,2,1,3,2,110,109,99,99,55
"4634",33,"[40]cIlHoIonnBkDakllnocHEKbKDaegtHvnJHqvbGqa",202,0.990244,40,205,2,203,1,2,1,3,2,103,102,101,101,55
"4635",34,"[40]cIlHoIonnBkDakllnocHEKbKDaegtHvnJHqvbGqa",206,0.990431,40,209,2,207,1,2,1,3,2,110,109,98,98,55
"4636",35,"[40]cIlHoIonnBkDakllnocHEKbKDaegtHvnJHqvbGqa",204,0.990338,40,207,2,205,1,2,1,3,2,108,107,98,98,55
"4637",36,"[40]cIlHoIonnBkDakllnocHEKbKDaegtHvnJHqvbGqa",214,0.990783,40,217,2,215,1,2,1,3,2,119,118,97,97,55
"4638",37,"[40]cIlHoIonnBkDakllnocHEKbKDaegtHvnJHqvbGqa",206,0.990431,40,209,2,207,1,2,1,3,2,109,108,99,99,55
"4639",38,"[40]cIlHoIonnBkDakllnocHEKbKDaegtHvnJHqvbGqa",188,0.989529,40,191,2,189,1,2,1,3,2,87,86,103,103,55
"4640",39,"[40]cIlHoIonnBkDakllnocHEKbKDaegtHvnJHqvbGqa",202,0.990244,40,205,2,203,1,2,1,3,2,102,101,102,102,55
"4641",40,"[40]cIlHoIonnBkDakllnocHEKbKDaegtHvnJHqvbGqa",203,0.990291,40,206,2,204,1,2,1,3,2,104,103,101,101,55
"4642",41,"[40]cIlHoIonnBkDakllnocHEKbKDaegtHvnJHqvbGqa",203,0.990291,40,206,2,204,1,2,1,3,2,106,105,99,99,55
"4643",42,"[40]cIlHoIonnBkDakllnocHEKbKDaegtHvnJHqvbGqa",203,0.990291,40,206,2,204,1,2,1,3,2,105,104,100,100,55
"4644",43,"[40]cIlHoIonnBkDakllnocHEKbKDaegtHvnJHqvbGqa",214,0.990783,40,217,2,215,1,2,1,3,2,120,119,96,96,55
"4645",44,"[40]cIlHoIonnBkDakllnocHEKbKDaegtHvnJHqvbGqa",189,0.989583,40,192,2,190,1,2,1,3,2,86,85,105,105,55
"4646",45,"[40]cIlHoIonnBkDakllnocHEKbKDaegtHvnJHqvbGqa",198,0.99005,40,201,2,199,1,2,1,3,2,98,97,102,102,55
"4647",46,"[40]cIlHoIonnBkDakllnocHEKbKDaegtHvnJHqvbGqa",201,0.990196,40,204,2,202,1,2,1,3,2,101,100,102,102,55
"4648",47,"[40]cIlHoIonnBkDakllnocHEKbKDaegtHvnJHqvbGqa",212,0.990698,40,215,2,213,1,2,1,3,2,117,116,97,97,55
"4649",48,"[40]cIlHoIonnBkDakllnocHEKbKDaegtHvnJHqvbGqa",205,0.990385,40,208,2,206,1,2,1,3,2,107,106,100,100,55
"4650",49,"[40]cIlHoIonnBkDakllnocHEKbKDaegtHvnJHqvbGqa",189,0.989583,40,192,2,190,1,2,1,3,2,86,85,105,105,55
"4651",50,"[40]cIlHoIonnBkDakllnocHEKbKDaegtHvnJHqvbGqa",191,0.989691,40,194,2,192,1,2,1,3,2,87,86,106,106,55
"4652",51,"[40]cIlHoIonnBkDakllnocHEKbKDaegtHvnJHqvbGqa",197,0.99,40,200,2,198,1,2,1,3,2,97,96,102,102,55
"4653",52,"[40]cIlHoIonnBkDakllnocHEKbKDaegtHvnJHqvbGqa",199,0.990099,40,202,2,200,1,2,1,3,2,99,98,102,102,55
"4654",53,"[40]cIlHoIonnBkDakllnocHEKbKDaegtHvnJHqvbGqa",202,0.990244,40,205,2,203,1,2,1,3,2,103,102,101,101,55
"4655",54,"[40]cIlHoIonnBkDakllnocHEKbKDaegtHvnJHqvbGqa",198,0.99005,40,201,2,199,1,2,1,3,2,98,97,102,102,55
"4656",55,"[40]cIlHoIonnBkDakllnocHEKbKDaegtHvnJHqvbGqa",214,0.990783,40,217,2,215,1,2,1,3,2,121,120,95,95,55
"4657",56,"[40]cIlHoIonnBkDakllnocHEKbKDaegtHvnJHqvbGqa",208,0.990521,40,211,2,209,1,2,1,3,2,111,110,99,99,55
"4658",57,"[40]cIlHoIonnBkDakllnocHEKbKDaegtHvnJHqvbGqa",201,0.990196,40,204,2,202,1,2,1,3,2,104,103,99,99,55
"4659",58,"[40]cIlHoIonnBkDakllnocHEKbKDaegtHvnJHqvbGqa",201,0.990196,40,204,2,202,1,2,1,3,2,100,99,103,103,55
"4660",59,"[40]cIlHoIonnBkDakllnocHEKbKDaegtHvnJHqvbGqa",217,0.990909,40,220,2,218,1,2,1,3,2,127,126,92,92,55
"4661",60,"[40]cIlHoIonnBkDakllnocHEKbKDaegtHvnJHqvbGqa",197,0.99,40,200,2,198,1,2,1,3,2,98,97,101,101,55
"4662",61,"[40]cIlHoIonnBkDakllnocHEKbKDaegtHvnJHqvbGqa",196,0.98995,40,199,2,197,1,2,1,3,2,98,97,100,100,55
"4663",62,"[40]cIlHoIonnBkDakllnocHEKbKDaegtHvnJHqvbGqa",206,0.990431,40,209,2,207,1,2,1,3,2,109,108,99,99,55
"4664",63,"[40]cIlHoIonnBkDakllnocHEKbKDaegtHvnJHqvbGqa",202,0.990244,40,205,2,203,1,2,1,3,2,102,101,102,102,55
"4665",64,"[40]cIlHoIonnBkDakllnocHEKbKDaegtHvnJHqvbGqa",189,0.989583,40,192,2,190,1,2,1,3,2,89,88,102,102,55
"4666",65,"[40]cIlHoIonnBkDakllnocHEKbKDaegtHvnJHqvbGqa",206,0.990431,40,209,2,207,1,2,1,3,2,107,106,101,101,55
"4667",66,"[40]cIlHoIonnBkDakllnocHEKbKDaegtHvnJHqvbGqa",191,0.989691,40,194,2,192,1,2,1,3,2,87,86,106,106,55
"4668",67,"[40]cIlHoIonnBkDakllnocHEKbKDaegtHvnJHqvbGqa",193,0.989796,40,196,2,194,1,2,1,3,2,92,91,103,103,55
"4669",68,"[40]cIlHoIonnBkDakllnocHEKbKDaegtHvnJHqvbGqa",198,0.99005,40,201,2,199,1,2,1,3,2,99,98,101,101,55
"4670",69,"[40]cIlHoIonnBkDakllnocHEKbKDaegtHvnJHqvbGqa",201,0.990196,40,204,2,202,1,2,1,3,2,102,101,101,101,55
"4671",70,"[40]cIlHoIonnBkDakllnocHEKbKDaegtHvnJHqvbGqa",196,0.98995,40,199,2,197,1,2,1,3,2,97,96,101,101,55
"4672",71,"[40]cIlHoIonnBkDakllnocHEKbKDaegtHvnJHqvbGqa",198,0.99005,40,201,2,199,1,2,1,3,2,96,95,104,104,55
"4673",72,"[40]cIlHoIonnBkDakllnocHEKbKDaegtHvnJHqvbGqa",209,0.990566,40,212,2,210,1,2,1,3,2,112,111,99,99,55
"4674",73,"[40]cIlHoIonnBkDakllnocHEKbKDaegtHvnJHqvbGqa",211,0.990654,40,214,2,212,1,2,1,3,2,114,113,99,99,55
"4675",74,"[40]cIlHoIonnBkDakllnocHEKbKDaegtHvnJHqvbGqa",204,0.990338,40,207,2,205,1,2,1,3,2,103,102,103,103,55
"4676",75,"[40]cIlHoIonnBkDakllnocHEKbKDaegtHvnJHqvbGqa",201,0.990196,40,204,2,202,1,2,1,3,2,101,100,102,102,55
"4677",76,"[40]cIlHoIonnBkDakllnocHEKbKDaegtHvnJHqvbGqa",198,0.99005,40,201,2,199,1,2,1,3,2,98,97,102,102,55
"4678",77,"[40]cIlHoIonnBkDakllnocHEKbKDaegtHvnJHqvbGqa",201,0.990196,40,204,2,202,1,2,1,3,2,101,100,102,102,55
"4679",78,"[40]cIlHoIonnBkDakllnocHEKbKDaegtHvnJHqvbGqa",215,0.990826,40,218,2,216,1,2,1,3,2,121,120,96,96,55
"4680",79,"[40]cIlHoIonnBkDakllnocHEKbKDaegtHvnJHqvbGqa",205,0.990385,40,208,2,206,1,2,1,3,2,110,109,97,97,55
"4681",80,"[40]cIlHoIonnBkDakllnocHEKbKDaegtHvnJHqvbGqa",193,0.989796,40,196,2,194,1,2,1,3,2,91,90,104,104,55
"4682",81,"[40]cIlHoIonnBkDakllnocHEKbKDaegtHvnJHqvbGqa",202,0.990244,40,205,2,203,1,2,1,3,2,104,103,100,100,55
"4683",82,"[40]cIlHoIonnBkDakllnocHEKbKDaegtHvnJHqvbGqa",206,0.990431,40,209,2,207,1,2,1,3,2,110,109,98,98,55
"4684",83,"[40]cIlHoIonnBkDakllnocHEKbKDaegtHvnJHqvbGqa",204,0.990338,40,207,2,205,1,2,1,3,2,110,109,96,96,55
"4685",84,"[40]cIlHoIonnBkDakllnocHEKbKDaegtHvnJHqvbGqa",218,0.99095,40,221,2,219,1,2,1,3,2,127,126,93,93,55
"4686",85,"[40]cIlHoIonnBkDakllnocHEKbKDaegtHvnJHqvbGqa",196,0.98995,40,199,2,197,1,2,1,3,2,97,96,101,101,55
"4687",86,"[40]cIlHoIonnBkDakllnocHEKbKDaegtHvnJHqvbGqa",196,0.98995,40,199,2,197,1,2,1,3,2,97,96,101,101,55
"4688",87,"[40]cIlHoIonnBkDakllnocHEKbKDaegtHvnJHqvbGqa",196,0.98995,40,199,2,197,1,2,1,3,2,96,95,102,102,55
"4689",88,"[40]cIlHoIonnBkDakllnocHEKbKDaegtHvnJHqvbGqa",191,0.989691,40,194,2,192,1,2,1,3,2,91,90,102,102,55
"4690",89,"[40]cIlHoIonnBkDakllnocHEKbKDaegtHvnJHqvbGqa",222,0.991111,40,225,2,223,1,2,1,3,2,130,129,94,94,55
"4691",90,"[40]cIlHoIonnBkDakllnocHEKbKDaegtHvnJHqvbGqa",202,0.990244,40,205,2,203,1,2,1,3,2,104,103,100,100,55
"4692",91,"[40]cIlHoIonnBkDakllnocHEKbKDaegtHvnJHqvbGqa",190,0.989637,40,193,2,191,1,2,1,3,2,84,83,108,108,55
"4693",92,"[40]cIlHoIonnBkDakllnocHEKbKDaegtHvnJHqvbGqa",201,0.990196,40,204,2,202,1,2,1,3,2,104,103,99,99,55
"4694",93,"[40]cIlHoIonnBkDakllnocHEKbKDaegtHvnJHqvbGqa",217,0.990909,40,220,2,218,1,2,1,3,2,124,123,95,95,55
"4695",94,"[40]cIlHoIonnBkDakllnocHEKbKDaegtHvnJHqvbGqa",194,0.989848,40,197,2,195,1,2,1,3,2,90,89,106,106,55
"4696",95,"[40]cIlHoIonnBkDakllnocHEKbKDaegtHvnJHqvbGqa",207,0.990476,40,210,2,208,1,2,1,3,2,111,110,98,98,55
"4697",96,"[40]cIlHoIonnBkDakllnocHEKbKDaegtHvnJHqvbGqa",204,0.990338,40,207,2,205,1,2,1,3,2,104,103,102,102,55
"4698",97,"[40]cIlHoIonnBkDakllnocHEKbKDaegtHvnJHqvbGqa",202,0.990244,40,205,2,203,1,2,1,3,2,102,101,102,102,55
"4699",98,"[40]cIlHoIonnBkDakllnocHEKbKDaegtHvnJHqvbGqa",198,0.99005,40,201,2,199,1,2,1,3,2,97,96,103,103,55
"4700",99,"[40]cIlHoIonnBkDakllnocHEKbKDaegtHvnJHqvbGqa",209,0.990566,40,212,2,210,1,2,1,3,2,112,111,99,99,55
"4701",0,"[40]olIHoIxGBkDwvKKItGFdAebKDaetdHunJHqvbGqa",204,0.990338,40,207,2,205,1,2,1,3,2,108,107,98,98,56
"4702",1,"[40]olIHoIxGBkDwvKKItGFdAebKDaetdHunJHqvbGqa",198,0.99005,40,201,2,199,1,2,1,3,2,98,97,102,102,56
"4703",2,"[40]olIHoIxGBkDwvKKItGFdAebKDaetdHunJHqvbGqa",206,0.990431,40,209,2,207,1,2,1,3,2,107,106,101,101,56
"4704",3,"[40]olIHoIxGBkDwvKKItGFdAebKDaetdHunJHqvbGqa",198,0.99005,40,201,2,199,1,2,1,3,2,99,98,101,101,56
"4705",4,"[40]olIHoIxGBkDwvKKItGFdAebKDaetdHunJHqvbGqa",201,0.990196,40,204,2,202,1,2,1,3,2,104,103,99,99,56
"4706",5,"[40]olIHoIxGBkDwvKKItGFdAebKDaetdHunJHqvbGqa",197,0.99,40,200,2,198,1,2,1,3,2,96,95,103,103,56
"4707",6,"[40]olIHoIxGBkDwvKKItGFdAebKDaetdHunJHqvbGqa",191,0.989691,40,194,2,192,1,2,1,3,2,88,87,105,105,56
"4708",7,"[40]olIHoIxGBkDwvKKItGFdAebKDaetdHunJHqvbGqa",196,0.98995,40,199,2,197,1,2,1,3,2,96,95,102,102,56
"4709",8,"[40]olIHoIxGBkDwvKKItGFdAebKDaetdHunJHqvbGqa",193,0.989796,40,196,2,194,1,2,1,3,2,92,91,103,103,56
"4710",9,"[40]olIHoIxGBkDwvKKItGFdAebKDaetdHunJHqvbGqa",206,0.990431,40,209,2,207,1,2,1,3,2,106,105,102,102,56
"4711",10,"[40]olIHoIxGBkDwvKKItGFdAebKDaetdHunJHqvbGqa",209,0.990566,40,212,2,210,1,2,1,3,2,112,111,99,99,56
"4712",11,"[40]olIHoIxGBkDwvKKItGFdAebKDaetdHunJHqvbGqa",202,0.990244,40,205,2,203,1,2,1,3,2,104,103,100,100,56
"4713",12,"[40]olIHoIxGBkDwvKKItGFdAebKDaetdHunJHqvbGqa",202,0.990244,40,205,2,203,1,2,1,3,2,103,102,101,101,56
"4714",13,"[40]olIHoIxGBkDwvKKItGFdAebKDaetdHunJHqvbGqa",200,0.990148,40,203,2,201,1,2,1,3,2,100,99,102,102,56
"4715",14,"[40]olIHoIxGBkDwvKKItGFdAebKDaetdHunJHqvbGqa",193,0.989796,40,196,2,194,1,2,1,3,2,92,91,103,103,56
"4716",15,"[40]olIHoIxGBkDwvKKItGFdAebKDaetdHunJHqvbGqa",205,0.990385,40,208,2,206,1,2,1,3,2,112,111,95,95,56
"4717",16,"[40]olIHoIxGBkDwvKKItGFdAebKDaetdHunJHqvbGqa",215,0.990826,40,218,2,216,1,2,1,3,2,121,120,96,96,56
"4718",17,"[40]olIHoIxGBkDwvKKItGFdAebKDaetdHunJHqvbGqa",209,0.990566,40,212,2,210,1,2,1,3,2,113,112,98,98,56
"4719",18,"[40]olIHoIxGBkDwvKKItGFdAebKDaetdHunJHqvbGqa",193,0.989796,40,196,2,194,1,2,1,3,2,91,90,104,104,56
"4720",19,"[40]olIHoIxGBkDwvKKItGFdAebKDaetdHunJHqvbGqa",203,0.990291,40,206,2,204,1,2,1,3,2,103,102,102,102,56
"4721",20,"[40]olIHoIxGBkDwvKKItGFdAebKDaetdHunJHqvbGqa",195,0.989899,40,198,2,196,1,2,1,3,2,95,94,102,102,56
"4722",21,"[40]olIHoIxGBkDwvKKItGFdAebKDaetdHunJHqvbGqa",198,0.99005,40,201,2,199,1,2,1,3,2,98,97,102,102,56
"4723",22,"[40]olIHoIxGBkDwvKKItGFdAebKDaetdHunJHqvbGqa",197,0.99,40,200,2,198,1,2,1,3,2,94,93,105,105,56
"4724",23,"[40]olIHoIxGBkDwvKKItGFdAebKDaetdHunJHqvbGqa",213,0.990741,40,216,2,214,1,2,1,3,2,121,120,94,94,56
"4725",24,"[40]olIHoIxGBkDwvKKItGFdAebKDaetdHunJHqvbGqa",209,0.990566,40,212,2,210,1,2,1,3,2,112,111,99,99,56
"4726",25,"[40]olIHoIxGBkDwvKKItGFdAebKDaetdHunJHqvbGqa",195,0.989899,40,198,2,196,1,2,1,3,2,93,92,104,104,56
"4727",26,"[40]olIHoIxGBkDwvKKItGFdAebKDaetdHunJHqvbGqa",192,0.989744,40,195,2,193,1,2,1,3,2,91,90,103,103,56
"4728",27,"[40]olIHoIxGBkDwvKKItGFdAebKDaetdHunJHqvbGqa",207,0.990476,40,210,2,208,1,2,1,3,2,109,108,100,100,56
"4729",28,"[40]olIHoIxGBkDwvKKItGFdAebKDaetdHunJHqvbGqa",206,0.990431,40,209,2,207,1,2,1,3,2,109,108,99,99,56
"4730",29,"[40]olIHoIxGBkDwvKKItGFdAebKDaetdHunJHqvbGqa",188,0.989529,40,191,2,189,1,2,1,3,2,86,85,104,104,56
"4731",30,"[40]olIHoIxGBkDwvKKItGFdAebKDaetdHunJHqvbGqa",194,0.989848,40,197,2,195,1,2,1,3,2,93,92,103,103,56
"4732",31,"[40]olIHoIxGBkDwvKKItGFdAebKDaetdHunJHqvbGqa",202,0.990244,40,205,2,203,1,2,1,3,2,102,101,102,102,56
"4733",32,"[40]olIHoIxGBkDwvKKItGFdAebKDaetdHunJHqvbGqa",203,0.990291,40,206,2,204,1,2,1,3,2,105,104,100,100,56
"4734",33,"[40]olIHoIxGBkDwvKKItGFdAebKDaetdHunJHqvbGqa",199,0.990099,40,202,2,200,1,2,1,3,2,100,99,101,101,56
"4735",34,"[40]olIHoIxGBkDwvKKItGFdAebKDaetdHunJHqvbGqa",204,0.990338,40,207,2,205,1,2,1,3,2,108,107,98,98,56
"4736",35,"[40]olIHoIxGBkDwvKKItGFdAebKDaetdHunJHqvbGqa",205,0.990385,40,208,2,206,1,2,1,3,2,110,109,97,97,56
"4737",36,"[40]olIHoIxGBkDwvKKItGFdAebKDaetdHunJHqvbGqa",197,0.99,40,200,2,198,1,2,1,3,2,97,96,102,102,56
"4738",37,"[40]olIHoIxGBkDwvKKItGFdAebKDaetdHunJHqvbGqa",206,0.990431,40,209,2,207,1,2,1,3,2,112,111,96,96,56
"4739",38,"[40]olIHoIxGBkDwvKKItGFdAebKDaetdHunJHqvbGqa",217,0.990909,40,220,2,218,1,2,1,3,2,122,121,97,97,56
"4740",39,"[40]olIHoIxGBkDwvKKItGFdAebKDaetdHunJHqvbGqa",207,0.990476,40,210,2,208,1,2,1,3,2,111,110,98,98,56
"4741",40,"[40]olIHoIxGBkDwvKKItGFdAebKDaetdHunJHqvbGqa",202,0.990244,40,205,2,203,1,2,1,3,2,106,105,98,98,56
"4742",41,"[40]olIHoIxGBkDwvKKItGFdAebKDaetdHunJHqvbGqa",198,0.99005,40,201,2,199,1,2,1,3,2,101,100,99,99,56
"4743",42,"[40]olIHoIxGBkDwvKKItGFdAebKDaetdHunJHqvbGqa",189,0.989583,40,192,2,190,1,2,1,3,2,85,84,106,106,56
"4744",43,"[40]olIHoIxGBkDwvKKItGFdAebKDaetdHunJHqvbGqa",197,0.99,40,200,2,198,1,2,1,3,2,98,97,101,101,56
"4745",44,"[40]olIHoIxGBkDwvKKItGFdAebKDaetdHunJHqvbGqa",201,0.990196,40,204,2,202,1,2,1,3,2,101,100,102,102,56
"4746",45,"[40]olIHoIxGBkDwvKKItGFdAebKDaetdHunJHqvbGqa",204,0.990338,40,207,2,205,1,2,1,3,2,106,105,100,100,56
"4747",46,"[40]olIHoIxGBkDwvKKItGFdAebKDaetdHunJHqvbGqa",196,0.98995,40,199,2,197,1,2,1,3,2,93,92,105,105,56
"4748",47,"[40]olIHoIxGBkDwvKKItGFdAebKDaetdHunJHqvbGqa",201,0.990196,40,204,2,202,1,2,1,3,2,105,104,98,98,56
"4749",48,"[40]olIHoIxGBkDwvKKItGFdAebKDaetdHunJHqvbGqa",198,0.99005,40,201,2,199,1,2,1,3,2,99,98,101,101,56
"4750",49,"[40]olIHoIxGBkDwvKKItGFdAebKDaetdHunJHqvbGqa",213,0.990741,40,216,2,214,1,2,1,3,2,120,119,95,95,56
"4751",50,"[40]olIHoIxGBkDwvKKItGFdAebKDaetdHunJHqvbGqa",210,0.99061,40,213,2,211,1,2,1,3,2,115,114,97,97,56
"4752",51,"[40]olIHoIxGBkDwvKKItGFdAebKDaetdHunJHqvbGqa",205,0.990385,40,208,2,206,1,2,1,3,2,111,110,96,96,56
"4753",52,"[40]olIHoIxGBkDwvKKItGFdAebKDaetdHunJHqvbGqa",209,0.990566,40,212,2,210,1,2,1,3,2,111,110,100,100,56
"4754",53,"[40]olIHoIxGBkDwvKKItGFdAebKDaetdHunJHqvbGqa",217,0.990909,40,220,2,218,1,2,1,3,2,124,123,95,95,56
"4755",54,"[40]olIHoIxGBkDwvKKItGFdAebKDaetdHunJHqvbGqa",197,0.99,40,200,2,198,1,2,1,3,2,96,95,103,103,56
"4756",55,"[40]olIHoIxGBkDwvKKItGFdAebKDaetdHunJHqvbGqa",198,0.99005,40,201,2,199,1,2,1,3,2,98,97,102,102,56
"4757",56,"[40]olIHoIxGBkDwvKKItGFdAebKDaetdHunJHqvbGqa",217,0.990909,40,220,2,218,1,2,1,3,2,125,124,94,94,56
"4758",57,"[40]olIHoIxGBkDwvKKItGFdAebKDaetdHunJHqvbGqa",200,0.990148,40,203,2,201,1,2,1,3,2,101,100,101,101,56
"4759",58,"[40]olIHoIxGBkDwvKKItGFdAebKDaetdHunJHqvbGqa",206,0.990431,40,209,2,207,1,2,1,3,2,106,105,102,102,56
"4760",59,"[40]olIHoIxGBkDwvKKItGFdAebKDaetdHunJHqvbGqa",207,0.990476,40,210,2,208,1,2,1,3,2,109,108,100,100,56
"4761",60,"[40]olIHoIxGBkDwvKKItGFdAebKDaetdHunJHqvbGqa",212,0.990698,40,215,2,213,1,2,1,3,2,116,115,98,98,56
"4762",61,"[40]olIHoIxGBkDwvKKItGFdAebKDaetdHunJHqvbGqa",200,0.990148,40,203,2,201,1,2,1,3,2,100,99,102,102,56
"4763",62,"[40]olIHoIxGBkDwvKKItGFdAebKDaetdHunJHqvbGqa",200,0.990148,40,203,2,201,1,2,1,3,2,101,100,101,101,56
"4764",63,"[40]olIHoIxGBkDwvKKItGFdAebKDaetdHunJHqvbGqa",204,0.990338,40,207,2,205,1,2,1,3,2,107,106,99,99,56
"4765",64,"[40]olIHoIxGBkDwvKKItGFdAebKDaetdHunJHqvbGqa",195,0.989899,40,198,2,196,1,2,1,3,2,92,91,105,105,56
"4766",65,"[40]olIHoIxGBkDwvKKItGFdAebKDaetdHunJHqvbGqa",205,0.990385,40,208,2,206,1,2,1,3,2,111,110,96,96,56
"4767",66,"[40]olIHoIxGBkDwvKKItGFdAebKDaetdHunJHqvbGqa",191,0.989691,40,194,2,192,1,2,1,3,2,90,89,103,103,56
"4768",67,"[40]olIHoIxGBkDwvKKItGFdAebKDaetdHunJHqvbGqa",208,0.990521,40,211,2,209,1,2,1,3,2,110,109,100,100,56
"4769",68,"[40]olIHoIxGBkDwvKKItGFdAebKDaetdHunJHqvbGqa",200,0.990148,40,203,2,201,1,2,1,3,2,101,100,101,101,56
"4770",69,"[40]olIHoIxGBkDwvKKItGFdAebKDaetdHunJHqvbGqa",189,0.989583,40,192,2,190,1,2,1,3,2,85,84,106,106,56
"4771",70,"[40]olIHoIxGBkDwvKKItGFdAebKDaetdHunJHqvbGqa",201,0.990196,40,204,2,202,1,2,1,3,2,103,102,100,100,56
"4772",71,"[40]olIHoIxGBkDwvKKItGFdAebKDaetdHunJHqvbGqa",206,0.990431,40,209,2,207,1,2,1,3,2,109,108,99,99,56
"4773",72,"[40]olIHoIxGBkDwvKKItGFdAebKDaetdHunJHqvbGqa",188,0.989529,40,191,2,189,1,2,1,3,2,84,83,106,106,56
"4774",73,"[40]olIHoIxGBkDwvKKItGFdAebKDaetdHunJHqvbGqa",212,0.990698,40,215,2,213,1,2,1,3,2,116,115,98,98,56
"4775",74,"[40]olIHoIxGBkDwvKKItGFdAebKDaetdHunJHqvbGqa",198,0.99005,40,201,2,199,1,2,1,3,2,96,95,104,104,56
"4776",75,"[40]olIHoIxGBkDwvKKItGFdAebKDaetdHunJHqvbGqa",197,0.99,40,200,2,198,1,2,1,3,2,98,97,101,101,56
"4777",76,"[40]olIHoIxGBkDwvKKItGFdAebKDaetdHunJHqvbGqa",194,0.989848,40,197,2,195,1,2,1,3,2,93,92,103,103,56
"4778",77,"[40]olIHoIxGBkDwvKKItGFdAebKDaetdHunJHqvbGqa",195,0.989899,40,198,2,196,1,2,1,3,2,96,95,101,101,56
"4779",78,"[40]olIHoIxGBkDwvKKItGFdAebKDaetdHunJHqvbGqa",206,0.990431,40,209,2,207,1,2,1,3,2,110,109,98,98,56
"4780",79,"[40]olIHoIxGBkDwvKKItGFdAebKDaetdHunJHqvbGqa",194,0.989848,40,197,2,195,1,2,1,3,2,92,91,104,104,56
"4781",80,"[40]olIHoIxGBkDwvKKItGFdAebKDaetdHunJHqvbGqa",199,0.990099,40,202,2,200,1,2,1,3,2,97,96,104,104,56
"4782",81,"[40]olIHoIxGBkDwvKKItGFdAebKDaetdHunJHqvbGqa",185,0.989362,40,188,2,186,1,2,1,3,2,79,78,108,108,56
"4783",82,"[40]olIHoIxGBkDwvKKItGFdAebKDaetdHunJHqvbGqa",204,0.990338,40,207,2,205,1,2,1,3,2,106,105,100,100,56
"4784",83,"[40]olIHoIxGBkDwvKKItGFdAebKDaetdHunJHqvbGqa",186,0.989418,40,189,2,187,1,2,1,3,2,84,83,104,104,56
"4785",84,"[40]olIHoIxGBkDwvKKItGFdAebKDaetdHunJHqvbGqa",207,0.990476,40,210,2,208,1,2,1,3,2,111,110,98,98,56
"4786",85,"[40]olIHoIxGBkDwvKKItGFdAebKDaetdHunJHqvbGqa",202,0.990244,40,205,2,203,1,2,1,3,2,103,102,101,101,56
"4787",86,"[40]olIHoIxGBkDwvKKItGFdAebKDaetdHunJHqvbGqa",206,0.990431,40,209,2,207,1,2,1,3,2,111,110,97,97,56
"4788",87,"[40]olIHoIxGBkDwvKKItGFdAebKDaetdHunJHqvbGqa",201,0.990196,40,204,2,202,1,2,1,3,2,101,100,102,102,56
"4789",88,"[40]olIHoIxGBkDwvKKItGFdAebKDaetdHunJHqvbGqa",199,0.990099,40,202,2,200,1,2,1,3,2,96,95,105,105,56
"4790",89,"[40]olIHoIxGBkDwvKKItGFdAebKDaetdHunJHqvbGqa",193,0.989796,40,196,2,194,1,2,1,3,2,91,90,104,104,56
"4791",90,"[40]olIHoIxGBkDwvKKItGFdAebKDaetdHunJHqvbGqa",200,0.990148,40,203,2,201,1,2,1,3,2,102,101,100,100,56
"4792",91,"[40]olIHoIxGBkDwvKKItGFdAebKDaetdHunJHqvbGqa",194,0.989848,40,197,2,195,1,2,1,3,2,95,94,101,101,56
"4793",92,"[40]olIHoIxGBkDwvKKItGFdAebKDaetdHunJHqvbGqa",203,0.990291,40,206,2,204,1,2,1,3,2,104,103,101,101,56
"4794",93,"[40]olIHoIxGBkDwvKKItGFdAebKDaetdHunJHqvbGqa",221,0.991071,40,224,2,222,1,2,1,3,2,128,127,95,95,56
"4795",94,"[40]olIHoIxGBkDwvKKItGFdAebKDaetdHunJHqvbGqa",212,0.990698,40,215,2,213,1,2,1,3,2,117,116,97,97,56
"4796",95,"[40]olIHoIxGBkDwvKKItGFdAebKDaetdHunJHqvbGqa",202,0.990244,40,205,2,203,1,2,1,3,2,105,104,99,99,56
"4797",96,"[40]olIHoIxGBkDwvKKItGFdAebKDaetdHunJHqvbGqa",197,0.99,40,200,2,198,1,2,1,3,2,99,98,100,100,56
"4798",97,"[40]olIHoIxGBkDwvKKItGFdAebKDaetdHunJHqvbGqa",212,0.990698,40,215,2,213,1,2,1,3,2,117,116,97,97,56
"4799",98,"[40]olIHoIxGBkDwvKKItGFdAebKDaetdHunJHqvbGqa",188,0.989529,40,191,2,189,1,2,1,3,2,84,83,106,106,56
"4800",99,"[40]olIHoIxGBkDwvKKItGFdAebKDaetdHunJHqvbGqa",193,0.989796,40,196,2,194,1,2,1,3,2,92,91,103,103,56
"4801",0,"[40]tIwHoIvcfBkDwqgjfbJcfFbKDaejmHxnJHqvbGqa",207,0.990476,40,210,2,208,1,2,1,3,2,111,110,98,98,57
"4802",1,"[40]tIwHoIvcfBkDwqgjfbJcfFbKDaejmHxnJHqvbGqa",209,0.990566,40,212,2,210,1,2,1,3,2,112,111,99,99,57
"4803",2,"[40]tIwHoIvcfBkDwqgjfbJcfFbKDaejmHxnJHqvbGqa",199,0.990099,40,202,2,200,1,2,1,3,2,100,99,101,101,57
"4804",3,"[40]tIwHoIvcfBkDwqgjfbJcfFbKDaejmHxnJHqvbGqa",195,0.989899,40,198,2,196,1,2,1,3,2,95,94,102,102,57
"4805",4,"[40]tIwHoIvcfBkDwqgjfbJcfFbKDaejmHxnJHqvbGqa",212,0.990698,40,215,2,213,1,2,1,3,2,118,117,96,96,57
"4806",5,"[40]tIwHoIvcfBkDwqgjfbJcfFbKDaejmHxnJHqvbGqa",214,0.990783,40,217,2,215,1,2,1,3,2,120,119,96,96,57
"4807",6,"[40]tIwHoIvcfBkDwqgjfbJcfFbKDaejmHxnJHqvbGqa",202,0.990244,40,205,2,203,1,2,1,3,2,103,102,101,101,57
"4808",7,"[40]tIwHoIvcfBkDwqgjfbJcfFbKDaejmHxnJHqvbGqa",200,0.990148,40,203,2,201,1,2,1,3,2,100,99,102,102,57
"4809",8,"[40]tIwHoIvcfBkDwqgjfbJcfFbKDaejmHxnJHqvbGqa",190,0.989637,40,193,2,191,1,2,1,3,2,87,86,105,105,57
"4810",9,"[40]tIwHoIvcfBkDwqgjfbJcfFbKDaejmHxnJHqvbGqa",218,0.99095,40,221,2,219,1,2,1,3,2,125,124,95,95,57
"4811",10,"[40]tIwHoIvcfBkDwqgjfbJcfFbKDaejmHxnJHqvbGqa",210,0.99061,40,213,2,211,1,2,1,3,2,114,113,98,98,57
"4812",11,"[40]tIwHoIvcfBkDwqgjfbJcfFbKDaejmHxnJHqvbGqa",196,0.98995,40,199,2,197,1,2,1,3,2,96,95,102,102,57
"4813",12,"[40]tIwHoIvcfBkDwqgjfbJcfFbKDaejmHxnJHqvbGqa",208,0.990521,40,211,2,209,1,2,1,3,2,110,109,100,100,57
"4814",13,"[40]tIwHoIvcfBkDwqgjfbJcfFbKDaejmHxnJHqvbGqa",195,0.989899,40,198,2,196,1,2,1,3,2,94,93,103,103,57
"4815",14,"[40]tIwHoIvcfBkDwqgjfbJcfFbKDaejmHxnJHqvbGqa",194,0.989848,40,197,2,195,1,2,1,3,2,92,91,104,104,57
"4816",15,"[40]tIwHoIvcfBkDwqgjfbJcfFbKDaejmHxnJHqvbGqa",197,0.99,40,200,2,198,1,2,1,3,2,96,95,103,103,57
"4817",16,"[40]tIwHoIvcfBkDwqgjfbJcfFbKDaejmHxnJHqvbGqa",200,0.990148,40,203,2,201,1,2,1,3,2,101,100,101,101,57
"4818",17,"[40]tIwHoIvcfBkDwqgjfbJcfFbKDaejmHxnJHqvbGqa",195,0.989899,40,198,2,196,1,2,1,3,2,92,91,105,105,57
"4819",18,"[40]tIwHoIvcfBkDwqgjfbJcfFbKDaejmHxnJHqvbGqa",208,0.990521,40,211,2,209,1,2,1,3,2,114,113,96,96,57
"4820",19,"[40]tIwHoIvcfBkDwqgjfbJcfFbKDaejmHxnJHqvbGqa",200,0.990148,40,203,2,201,1,2,1,3,2,99,98,103,103,57
"4821",20,"[40]tIwHoIvcfBkDwqgjfbJcfFbKDaejmHxnJHqvbGqa",204,0.990338,40,207,2,205,1,2,1,3,2,106,105,100,100,57
"4822",21,"[40]tIwHoIvcfBkDwqgjfbJcfFbKDaejmHxnJHqvbGqa",200,0.990148,40,203,2,201,1,2,1,3,2,102,101,100,100,57
"4823",22,"[40]tIwHoIvcfBkDwqgjfbJcfFbKDaejmHxnJHqvbGqa",194,0.989848,40,197,2,195,1,2,1,3,2,94,93,102,102,57
"4824",23,"[40]tIwHoIvcfBkDwqgjfbJcfFbKDaejmHxnJHqvbGqa",203,0.990291,40,206,2,204,1,2,1,3,2,104,103,101,101,57
"4825",24,"[40]tIwHoIvcfBkDwqgjfbJcfFbKDaejmHxnJHqvbGqa",202,0.990244,40,205,2,203,1,2,1,3,2,103,102,101,101,57
"4826",25,"[40]tIwHoIvcfBkDwqgjfbJcfFbKDaejmHxnJHqvbGqa",205,0.990385,40,208,2,206,1,2,1,3,2,107,106,100,100,57
"4827",26,"[40]tIwHoIvcfBkDwqgjfbJcfFbKDaejmHxnJHqvbGqa",215,0.990826,40,218,2,216,1,2,1,3,2,122,121,95,95,57
"4828",27,"[40]tIwHoIvcfBkDwqgjfbJcfFbKDaejmHxnJHqvbGqa",184,0.989305,40,187,2,185,1,2,1,3,2,78,77,108,108,57
"4829",28,"[40]tIwHoIvcfBkDwqgjfbJcfFbKDaejmHxnJHqvbGqa",213,0.990741,40,216,2,214,1,2,1,3,2,118,117,97,97,57
"4830",29,"[40]tIwHoIvcfBkDwqgjfbJcfFbKDaejmHxnJHqvbGqa",210,0.99061,40,213,2,211,1,2,1,3,2,116,115,96,96,57
"4831",30,"[40]tIwHoIvcfBkDwqgjfbJcfFbKDaejmHxnJHqvbGqa",200,0.990148,40,203,2,201,1,2,1,3,2,101,100,101,101,57
"4832",31,"[40]tIwHoIvcfBkDwqgjfbJcfFbKDaejmHxnJHqvbGqa",189,0.989583,40,192,2,190,1,2,1,3,2,86,85,105,105,57
"4833",32,"[40]tIwHoIvcfBkDwqgjfbJcfFbKDaejmHxnJHqvbGqa",208,0.990521,40,211,2,209,1,2,1,3,2,109,108,101,101,57
"4834",33,"[40]tIwHoIvcfBkDwqgjfbJcfFbKDaejmHxnJHqvbGqa",192,0.989744,40,195,2,193,1,2,1,3,2,89,88,105,105,57
"4835",34,"[40]tIwHoIvcfBkDwqgjfbJcfFbKDaejmHxnJHqvbGqa",200,0.990148,40,203,2,201,1,2,1,3,2,101,100,101,101,57
"4836",35,"[40]tIwHoIvcfBkDwqgjfbJcfFbKDaejmHxnJHqvbGqa",201,0.990196,40,204,2,202,1,2,1,3,2,102,101,101,101,57
"4837",36,"[40]tIwHoIvcfBkDwqgjfbJcfFbKDaejmHxnJHqvbGqa",196,0.98995,40,199,2,197,1,2,1,3,2,94,93,104,104,57
"4838",37,"[40]tIwHoIvcfBkDwqgjfbJcfFbKDaejmHxnJHqvbGqa",208,0.990521,40,211,2,209,1,2,1,3,2,112,111,98,98,57
"4839",38,"[40]tIwHoIvcfBkDwqgjfbJcfFbKDaejmHxnJHqvbGqa",214,0.990783,40,217,2,215,1,2,1,3,2,122,121,94,94,57
"4840",39,"[40]tIwHoIvcfBkDwqgjfbJcfFbKDaejmHxnJHqvbGqa",207,0.990476,40,210,2,208,1,2,1,3,2,113,112,96,96,57
"4841",40,"[40]tIwHoIvcfBkDwqgjfbJcfFbKDaejmHxnJHqvbGqa",194,0.989848,40,197,2,195,1,2,1,3,2,94,93,102,102,57
"4842",41,"[40]tIwHoIvcfBkDwqgjfbJcfFbKDaejmHxnJHqvbGqa",202,0.990244,40,205,2,203,1,2,1,3,2,103,102,101,101,57
"4843",42,"[40]tIwHoIvcfBkDwqgjfbJcfFbKDaejmHxnJHqvbGqa",191,0.989691,40,194,2,192,1,2,1,3,2,91,90,102,102,57
"4844",43,"[40]tIwHoIvcfBkDwqgjfbJcfFbKDaejmHxnJHqvbGqa",203,0.990291,40,206,2,204,1,2,1,3,2,106,105,99,99,57
"4845",44,"[40]tIwHoIvcfBkDwqgjfbJcfFbKDaejmHxnJHqvbGqa",200,0.990148,40,203,2,201,1,2,1,3,2,101,100,101,101,57
"4846",45,"[40]tIwHoIvcfBkDwqgjfbJcfFbKDaejmHxnJHqvbGqa",192,0.989744,40,195,2,193,1,2,1,3,2,89,88,105,105,57
"4847",46,"[40]tIwHoIvcfBkDwqgjfbJcfFbKDaejmHxnJHqvbGqa",198,0.99005,40,201,2,199,1,2,1,3,2,99,98,101,101,57
"4848",47,"[40]tIwHoIvcfBkDwqgjfbJcfFbKDaejmHxnJHqvbGqa",202,0.990244,40,205,2,203,1,2,1,3,2,103,102,101,101,57
"4849",48,"[40]tIwHoIvcfBkDwqgjfbJcfFbKDaejmHxnJHqvbGqa",204,0.990338,40,207,2,205,1,2,1,3,2,105,104,101,101,57
"4850",49,"[40]tIwHoIvcfBkDwqgjfbJcfFbKDaejmHxnJHqvbGqa",204,0.990338,40,207,2,205,1,2,1,3,2,105,104,101,101,57
"4851",50,"[40]tIwHoIvcfBkDwqgjfbJcfFbKDaejmHxnJHqvbGqa",202,0.990244,40,205,2,203,1,2,1,3,2,102,101,102,102,57
"4852",51,"[40]tIwHoIvcfBkDwqgjfbJcfFbKDaejmHxnJHqvbGqa",195,0.989899,40,198,2,196,1,2,1,3,2,96,95,101,101,57
"4853",52,"[40]tIwHoIvcfBkDwqgjfbJcfFbKDaejmHxnJHqvbGqa",193,0.989796,40,196,2,194,1,2,1,3,2,90,89,105,105,57
"4854",53,"[40]tIwHoIvcfBkDwqgjfbJcfFbKDaejmHxnJHqvbGqa",192,0.989744,40,195,2,193,1,2,1,3,2,90,89,104,104,57
"4855",54,"[40]tIwHoIvcfBkDwqgjfbJcfFbKDaejmHxnJHqvbGqa",195,0.989899,40,198,2,196,1,2,1,3,2,94,93,103,103,57
"4856",55,"[40]tIwHoIvcfBkDwqgjfbJcfFbKDaejmHxnJHqvbGqa",209,0.990566,40,212,2,210,1,2,1,3,2,113,112,98,98,57
"4857",56,"[40]tIwHoIvcfBkDwqgjfbJcfFbKDaejmHxnJHqvbGqa",201,0.990196,40,204,2,202,1,2,1,3,2,102,101,101,101,57
"4858",57,"[40]tIwHoIvcfBkDwqgjfbJcfFbKDaejmHxnJHqvbGqa",187,0.989474,40,190,2,188,1,2,1,3,2,85,84,104,104,57
"4859",58,"[40]tIwHoIvcfBkDwqgjfbJcfFbKDaejmHxnJHqvbGqa",192,0.989744,40,195,2,193,1,2,1,3,2,89,88,105,105,57
"4860",59,"[40]tIwHoIvcfBkDwqgjfbJcfFbKDaejmHxnJHqvbGqa",195,0.989899,40,198,2,196,1,2,1,3,2,95,94,102,102,57
"4861",60,"[40]tIwHoIvcfBkDwqgjfbJcfFbKDaejmHxnJHqvbGqa",184,0.989305,40,187,2,185,1,2,1,3,2,77,76,109,109,57
"4862",61,"[40]tIwHoIvcfBkDwqgjfbJcfFbKDaejmHxnJHqvbGqa",214,0.990783,40,217,2,215,1,2,1,3,2,122,121,94,94,57
"4863",62,"[40]tIwHoIvcfBkDwqgjfbJcfFbKDaejmHxnJHqvbGqa",193,0.989796,40,196,2,194,1,2,1,3,2,90,89,105,105,57
"4864",63,"[40]tIwHoIvcfBkDwqgjfbJcfFbKDaejmHxnJHqvbGqa",208,0.990521,40,211,2,209,1,2,1,3,2,113,112,97,97,57
"4865",64,"[40]tIwHoIvcfBkDwqgjfbJcfFbKDaejmHxnJHqvbGqa",197,0.99,40,200,2,198,1,2,1,3,2,97,96,102,102,57
"4866",65,"[40]tIwHoIvcfBkDwqgjfbJcfFbKDaejmHxnJHqvbGqa",197,0.99,40,200,2,198,1,2,1,3,2,97,96,102,102,57
"4867",66,"[40]tIwHoIvcfBkDwqgjfbJcfFbKDaejmHxnJHqvbGqa",203,0.990291,40,206,2,204,1,2,1,3,2,104,103,101,101,57
"4868",67,"[40]tIwHoIvcfBkDwqgjfbJcfFbKDaejmHxnJHqvbGqa",202,0.990244,40,205,2,203,1,2,1,3,2,104,103,100,100,57
"4869",68,"[40]tIwHoIvcfBkDwqgjfbJcfFbKDaejmHxnJHqvbGqa",197,0.99,40,200,2,198,1,2,1,3,2,98,97,101,101,57
"4870",69,"[40]tIwHoIvcfBkDwqgjfbJcfFbKDaejmHxnJHqvbGqa",199,0.990099,40,202,2,200,1,2,1,3,2,100,99,101,101,57
"4871",70,"[40]tIwHoIvcfBkDwqgjfbJcfFbKDaejmHxnJHqvbGqa",192,0.989744,40,195,2,193,1,2,1,3,2,91,90,103,103,57
"4872",71,"[40]tIwHoIvcfBkDwqgjfbJcfFbKDaejmHxnJHqvbGqa",201,0.990196,40,204,2,202,1,2,1,3,2,102,101,101,101,57
"4873",72,"[40]tIwHoIvcfBkDwqgjfbJcfFbKDaejmHxnJHqvbGqa",210,0.99061,40,213,2,211,1,2,1,3,2,114,113,98,98,57
"4874",73,"[40]tIwHoIvcfBkDwqgjfbJcfFbKDaejmHxnJHqvbGqa",208,0.990521,40,211,2,209,1,2,1,3,2,113,112,97,97,57
"4875",74,"[40]tIwHoIvcfBkDwqgjfbJcfFbKDaejmHxnJHqvbGqa",197,0.99,40,200,2,198,1,2,1,3,2,95,94,104,104,57
"4876",75,"[40]tIwHoIvcfBkDwqgjfbJcfFbKDaejmHxnJHqvbGqa",202,0.990244,40,205,2,203,1,2,1,3,2,104,103,100,100,57
"4877",76,"[40]tIwHoIvcfBkDwqgjfbJcfFbKDaejmHxnJHqvbGqa",202,0.990244,40,205,2,203,1,2,1,3,2,103,102,101,101,57
"4878",77,"[40]tIwHoIvcfBkDwqgjfbJcfFbKDaejmHxnJHqvbGqa",203,0.990291,40,206,2,204,1,2,1,3,2,105,104,100,100,57
"4879",78,"[40]tIwHoIvcfBkDwqgjfbJcfFbKDaejmHxnJHqvbGqa",206,0.990431,40,209,2,207,1,2,1,3,2,110,109,98,98,57
"4880",79,"[40]tIwHoIvcfBkDwqgjfbJcfFbKDaejmHxnJHqvbGqa",189,0.989583,40,192,2,190,1,2,1,3,2,86,85,105,105,57
"4881",80,"[40]tIwHoIvcfBkDwqgjfbJcfFbKDaejmHxnJHqvbGqa",204,0.990338,40,207,2,205,1,2,1,3,2,109,108,97,97,57
"4882",81,"[40]tIwHoIvcfBkDwqgjfbJcfFbKDaejmHxnJHqvbGqa",196,0.98995,40,199,2,197,1,2,1,3,2,96,95,102,102,57
"4883",82,"[40]tIwHoIvcfBkDwqgjfbJcfFbKDaejmHxnJHqvbGqa",187,0.989474,40,190,2,188,1,2,1,3,2,85,84,104,104,57
"4884",83,"[40]tIwHoIvcfBkDwqgjfbJcfFbKDaejmHxnJHqvbGqa",205,0.990385,40,208,2,206,1,2,1,3,2,107,106,100,100,57
"4885",84,"[40]tIwHoIvcfBkDwqgjfbJcfFbKDaejmHxnJHqvbGqa",199,0.990099,40,202,2,200,1,2,1,3,2,102,101,99,99,57
"4886",85,"[40]tIwHoIvcfBkDwqgjfbJcfFbKDaejmHxnJHqvbGqa",206,0.990431,40,209,2,207,1,2,1,3,2,111,110,97,97,57
"4887",86,"[40]tIwHoIvcfBkDwqgjfbJcfFbKDaejmHxnJHqvbGqa",223,0.99115,40,226,2,224,1,2,1,3,2,133,132,92,92,57
"4888",87,"[40]tIwHoIvcfBkDwqgjfbJcfFbKDaejmHxnJHqvbGqa",185,0.989362,40,188,2,186,1,2,1,3,2,81,80,106,106,57
"4889",88,"[40]tIwHoIvcfBkDwqgjfbJcfFbKDaejmHxnJHqvbGqa",198,0.99005,40,201,2,199,1,2,1,3,2,101,100,99,99,57
"4890",89,"[40]tIwHoIvcfBkDwqgjfbJcfFbKDaejmHxnJHqvbGqa",207,0.990476,40,210,2,208,1,2,1,3,2,110,109,99,99,57
"4891",90,"[40]tIwHoIvcfBkDwqgjfbJcfFbKDaejmHxnJHqvbGqa",199,0.990099,40,202,2,200,1,2,1,3,2,97,96,104,104,57
"4892",91,"[40]tIwHoIvcfBkDwqgjfbJcfFbKDaejmHxnJHqvbGqa",210,0.99061,40,213,2,211,1,2,1,3,2,112,111,100,100,57
"4893",92,"[40]tIwHoIvcfBkDwqgjfbJcfFbKDaejmHxnJHqvbGqa",207,0.990476,40,210,2,208,1,2,1,3,2,109,108,100,100,57
"4894",93,"[40]tIwHoIvcfBkDwqgjfbJcfFbKDaejmHxnJHqvbGqa",195,0.989899,40,198,2,196,1,2,1,3,2,93,92,104,104,57
"4895",94,"[40]tIwHoIvcfBkDwqgjfbJcfFbKDaejmHxnJHqvbGqa",200,0.990148,40,203,2,201,1,2,1,3,2,101,100,101,101,57
"4896",95,"[40]tIwHoIvcfBkDwqgjfbJcfFbKDaejmHxnJHqvbGqa",201,0.990196,40,204,2,202,1,2,1,3,2,99,98,104,104,57
"4897",96,"[40]tIwHoIvcfBkDwqgjfbJcfFbKDaejmHxnJHqvbGqa",196,0.98995,40,199,2,197,1,2,1,3,2,97,96,101,101,57
"4898",97,"[40]tIwHoIvcfBkDwqgjfbJcfFbKDaejmHxnJHqvbGqa",193,0.989796,40,196,2,194,1,2,1,3,2,90,89,105,105,57
"4899",98,"[40]tIwHoIvcfBkDwqgjfbJcfFbKDaejmHxnJHqvbGqa",187,0.989474,40,190,2,188,1,2,1,3,2,85,84,104,104,57
"4900",99,"[40]tIwHoIvcfBkDwqgjfbJcfFbKDaejmHxnJHqvbGqa",205,0.990385,40,208,2,206,1,2,1,3,2,105,104,102,102,57
"4901",0,"[40]hIzHoIuaGBkDnhJcmwCashbKDeezlHunJHqvbGqa",184,0.989305,40,187,2,185,1,2,1,3,2,79,78,107,107,58
"4902",1,"[40]hIzHoIuaGBkDnhJcmwCashbKDeezlHunJHqvbGqa",202,0.990244,40,205,2,203,1,2,1,3,2,102,101,102,102,58
"4903",2,"[40]hIzHoIuaGBkDnhJcmwCashbKDeezlHunJHqvbGqa",204,0.990338,40,207,2,205,1,2,1,3,2,106,105,100,100,58
"4904",3,"[40]hIzHoIuaGBkDnhJcmwCashbKDeezlHunJHqvbGqa",200,0.990148,40,203,2,201,1,2,1,3,2,101,100,101,101,58
"4905",4,"[40]hIzHoIuaGBkDnhJcmwCashbKDeezlHunJHqvbGqa",198,0.99005,40,201,2,199,1,2,1,3,2,96,95,104,104,58
"4906",5,"[40]hIzHoIuaGBkDnhJcmwCashbKDeezlHunJHqvbGqa",209,0.990566,40,212,2,210,1,2,1,3,2,114,113,97,97,58
"4907",6,"[40]hIzHoIuaGBkDnhJcmwCashbKDeezlHunJHqvbGqa",202,0.990244,40,205,2,203,1,2,1,3,2,105,104,99,99,58
"4908",7,"[40]hIzHoIuaGBkDnhJcmwCashbKDeezlHunJHqvbGqa",192,0.989744,40,195,2,193,1,2,1,3,2,90,89,104,104,58
"4909",8,"[40]hIzHoIuaGBkDnhJcmwCashbKDeezlHunJHqvbGqa",194,0.989848,40,197,2,195,1,2,1,3,2,91,90,105,105,58
"4910",9,"[40]hIzHoIuaGBkDnhJcmwCashbKDeezlHunJHqvbGqa",206,0.990431,40,209,2,207,1,2,1,3,2,109,108,99,99,58
"4911",10,"[40]hIzHoIuaGBkDnhJcmwCashbKDeezlHunJHqvbGqa",193,0.989796,40,196,2,194,1,2,1,3,2,90,89,105,105,58
"4912",11,"[40]hIzHoIuaGBkDnhJcmwCashbKDeezlHunJHqvbGqa",197,0.99,40,200,2,198,1,2,1,3,2,97,96,102,102,58
"4913",12,"[40]hIzHoIuaGBkDnhJcmwCashbKDeezlHunJHqvbGqa",211,0.990654,40,214,2,212,1,2,1,3,2,117,116,96,96,58
"4914",13,"[40]hIzHoIuaGBkDnhJcmwCashbKDeezlHunJHqvbGqa",196,0.98995,40,199,2,197,1,2,1,3,2,96,95,102,102,58
"4915",14,"[40]hIzHoIuaGBkDnhJcmwCashbKDeezlHunJHqvbGqa",195,0.989899,40,198,2,196,1,2,1,3,2,94,93,103,103,58
"4916",15,"[40]hIzHoIuaGBkDnhJcmwCashbKDeezlHunJHqvbGqa",196,0.98995,40,199,2,197,1,2,1,3,2,96,95,102,102,58
"4917",16,"[40]hIzHoIuaGBkDnhJcmwCashbKDeezlHunJHqvbGqa",214,0.990783,40,217,2,215,1,2,1,3,2,121,120,95,95,58
"4918",17,"[40]hIzHoIuaGBkDnhJcmwCashbKDeezlHunJHqvbGqa",215,0.990826,40,218,2,216,1,2,1,3,2,119,118,98,98,58
"4919",18,"[40]hIzHoIuaGBkDnhJcmwCashbKDeezlHunJHqvbGqa",216,0.990868,40,219,2,217,1,2,1,3,2,123,122,95,95,58
"4920",19,"[40]hIzHoIuaGBkDnhJcmwCashbKDeezlHunJHqvbGqa",197,0.99,40,200,2,198,1,2,1,3,2,97,96,102,102,58
"4921",20,"[40]hIzHoIuaGBkDnhJcmwCashbKDeezlHunJHqvbGqa",201,0.990196,40,204,2,202,1,2,1,3,2,101,100,102,102,58
"4922",21,"[40]hIzHoIuaGBkDnhJcmwCashbKDeezlHunJHqvbGqa",211,0.990654,40,214,2,212,1,2,1,3,2,114,113,99,99,58
"4923",22,"[40]hIzHoIuaGBkDnhJcmwCashbKDeezlHunJHqvbGqa",205,0.990385,40,208,2,206,1,2,1,3,2,108,107,99,99,58
"4924",23,"[40]hIzHoIuaGBkDnhJcmwCashbKDeezlHunJHqvbGqa",212,0.990698,40,215,2,213,1,2,1,3,2,114,113,100,100,58
"4925",24,"[40]hIzHoIuaGBkDnhJcmwCashbKDeezlHunJHqvbGqa",187,0.989474,40,190,2,188,1,2,1,3,2,86,85,103,103,58
"4926",25,"[40]hIzHoIuaGBkDnhJcmwCashbKDeezlHunJHqvbGqa",189,0.989583,40,192,2,190,1,2,1,3,2,83,82,108,108,58
"4927",26,"[40]hIzHoIuaGBkDnhJcmwCashbKDeezlHunJHqvbGqa",199,0.990099,40,202,2,200,1,2,1,3,2,101,100,100,100,58
"4928",27,"[40]hIzHoIuaGBkDnhJcmwCashbKDeezlHunJHqvbGqa",197,0.99,40,200,2,198,1,2,1,3,2,97,96,102,102,58
"4929",28,"[40]hIzHoIuaGBkDnhJcmwCashbKDeezlHunJHqvbGqa",202,0.990244,40,205,2,203,1,2,1,3,2,103,102,101,101,58
"4930",29,"[40]hIzHoIuaGBkDnhJcmwCashbKDeezlHunJHqvbGqa",202,0.990244,40,205,2,203,1,2,1,3,2,104,103,100,100,58
"4931",30,"[40]hIzHoIuaGBkDnhJcmwCashbKDeezlHunJHqvbGqa",185,0.989362,40,188,2,186,1,2,1,3,2,79,78,108,108,58
"4932",31,"[40]hIzHoIuaGBkDnhJcmwCashbKDeezlHunJHqvbGqa",207,0.990476,40,210,2,208,1,2,1,3,2,109,108,100,100,58
"4933",32,"[40]hIzHoIuaGBkDnhJcmwCashbKDeezlHunJHqvbGqa",202,0.990244,40,205,2,203,1,2,1,3,2,106,105,98,98,58
"4934",33,"[40]hIzHoIuaGBkDnhJcmwCashbKDeezlHunJHqvbGqa",209,0.990566,40,212,2,210,1,2,1,3,2,114,113,97,97,58
"4935",34,"[40]hIzHoIuaGBkDnhJcmwCashbKDeezlHunJHqvbGqa",193,0.989796,40,196,2,194,1,2,1,3,2,89,88,106,106,58
"4936",35,"[40]hIzHoIuaGBkDnhJcmwCashbKDeezlHunJHqvbGqa",205,0.990385,40,208,2,206,1,2,1,3,2,107,106,100,100,58
"4937",36,"[40]hIzHoIuaGBkDnhJcmwCashbKDeezlHunJHqvbGqa",198,0.99005,40,201,2,199,1,2,1,3,2,99,98,101,101,58
"4938",37,"[40]hIzHoIuaGBkDnhJcmwCashbKDeezlHunJHqvbGqa",201,0.990196,40,204,2,202,1,2,1,3,2,101,100,102,102,58
"4939",38,"[40]hIzHoIuaGBkDnhJcmwCashbKDeezlHunJHqvbGqa",199,0.990099,40,202,2,200,1,2,1,3,2,103,102,98,98,58
"4940",39,"[40]hIzHoIuaGBkDnhJcmwCashbKDeezlHunJHqvbGqa",197,0.99,40,200,2,198,1,2,1,3,2,97,96,102,102,58
"4941",40,"[40]hIzHoIuaGBkDnhJcmwCashbKDeezlHunJHqvbGqa",193,0.989796,40,196,2,194,1,2,1,3,2,90,89,105,105,58
"4942",41,"[40]hIzHoIuaGBkDnhJcmwCashbKDeezlHunJHqvbGqa",202,0.990244,40,205,2,203,1,2,1,3,2,102,101,102,102,58
"4943",42,"[40]hIzHoIuaGBkDnhJcmwCashbKDeezlHunJHqvbGqa",190,0.989637,40,193,2,191,1,2,1,3,2,85,84,107,107,58
"4944",43,"[40]hIzHoIuaGBkDnhJcmwCashbKDeezlHunJHqvbGqa",202,0.990244,40,205,2,203,1,2,1,3,2,104,103,100,100,58
"4945",44,"[40]hIzHoIuaGBkDnhJcmwCashbKDeezlHunJHqvbGqa",194,0.989848,40,197,2,195,1,2,1,3,2,92,91,104,104,58
"4946",45,"[40]hIzHoIuaGBkDnhJcmwCashbKDeezlHunJHqvbGqa",198,0.99005,40,201,2,199,1,2,1,3,2,100,99,100,100,58
"4947",46,"[40]hIzHoIuaGBkDnhJcmwCashbKDeezlHunJHqvbGqa",206,0.990431,40,209,2,207,1,2,1,3,2,108,107,100,100,58
"4948",47,"[40]hIzHoIuaGBkDnhJcmwCashbKDeezlHunJHqvbGqa",212,0.990698,40,215,2,213,1,2,1,3,2,118,117,96,96,58
"4949",48,"[40]hIzHoIuaGBkDnhJcmwCashbKDeezlHunJHqvbGqa",198,0.99005,40,201,2,199,1,2,1,3,2,97,96,103,103,58
"4950",49,"[40]hIzHoIuaGBkDnhJcmwCashbKDeezlHunJHqvbGqa",208,0.990521,40,211,2,209,1,2,1,3,2,112,111,98,98,58
"4951",50,"[40]hIzHoIuaGBkDnhJcmwCashbKDeezlHunJHqvbGqa",204,0.990338,40,207,2,205,1,2,1,3,2,108,107,98,98,58
"4952",51,"[40]hIzHoIuaGBkDnhJcmwCashbKDeezlHunJHqvbGqa",199,0.990099,40,202,2,200,1,2,1,3,2,101,100,100,100,58
"4953",52,"[40]hIzHoIuaGBkDnhJcmwCashbKDeezlHunJHqvbGqa",199,0.990099,40,202,2,200,1,2,1,3,2,100,99,101,101,58
"4954",53,"[40]hIzHoIuaGBkDnhJcmwCashbKDeezlHunJHqvbGqa",206,0.990431,40,209,2,207,1,2,1,3,2,110,109,98,98,58
"4955",54,"[40]hIzHoIuaGBkDnhJcmwCashbKDeezlHunJHqvbGqa",206,0.990431,40,209,2,207,1,2,1,3,2,112,111,96,96,58
"4956",55,"[40]hIzHoIuaGBkDnhJcmwCashbKDeezlHunJHqvbGqa",193,0.989796,40,196,2,194,1,2,1,3,2,91,90,104,104,58
"4957",56,"[40]hIzHoIuaGBkDnhJcmwCashbKDeezlHunJHqvbGqa",208,0.990521,40,211,2,209,1,2,1,3,2,112,111,98,98,58
"4958",57,"[40]hIzHoIuaGBkDnhJcmwCashbKDeezlHunJHqvbGqa",207,0.990476,40,210,2,208,1,2,1,3,2,108,107,101,101,58
"4959",58,"[40]hIzHoIuaGBkDnhJcmwCashbKDeezlHunJHqvbGqa",190,0.989637,40,193,2,191,1,2,1,3,2,86,85,106,106,58
"4960",59,"[40]hIzHoIuaGBkDnhJcmwCashbKDeezlHunJHqvbGqa",201,0.990196,40,204,2,202,1,2,1,3,2,102,101,101,101,58
"4961",60,"[40]hIzHoIuaGBkDnhJcmwCashbKDeezlHunJHqvbGqa",198,0.99005,40,201,2,199,1,2,1,3,2,98,97,102,102,58
"4962",61,"[40]hIzHoIuaGBkDnhJcmwCashbKDeezlHunJHqvbGqa",209,0.990566,40,212,2,210,1,2,1,3,2,111,110,100,100,58
"4963",62,"[40]hIzHoIuaGBkDnhJcmwCashbKDeezlHunJHqvbGqa",202,0.990244,40,205,2,203,1,2,1,3,2,106,105,98,98,58
"4964",63,"[40]hIzHoIuaGBkDnhJcmwCashbKDeezlHunJHqvbGqa",200,0.990148,40,203,2,201,1,2,1,3,2,103,102,99,99,58
"4965",64,"[40]hIzHoIuaGBkDnhJcmwCashbKDeezlHunJHqvbGqa",201,0.990196,40,204,2,202,1,2,1,3,2,100,99,103,103,58
"4966",65,"[40]hIzHoIuaGBkDnhJcmwCashbKDeezlHunJHqvbGqa",204,0.990338,40,207,2,205,1,2,1,3,2,107,106,99,99,58
"4967",66,"[40]hIzHoIuaGBkDnhJcmwCashbKDeezlHunJHqvbGqa",200,0.990148,40,203,2,201,1,2,1,3,2,103,102,99,99,58
"4968",67,"[40]hIzHoIuaGBkDnhJcmwCashbKDeezlHunJHqvbGqa",188,0.989529,40,191,2,189,1,2,1,3,2,85,84,105,105,58
"4969",68,"[40]hIzHoIuaGBkDnhJcmwCashbKDeezlHunJHqvbGqa",217,0.990909,40,220,2,218,1,2,1,3,2,123,122,96,96,58
"4970",69,"[40]hIzHoIuaGBkDnhJcmwCashbKDeezlHunJHqvbGqa",215,0.990826,40,218,2,216,1,2,1,3,2,121,120,96,96,58
"4971",70,"[40]hIzHoIuaGBkDnhJcmwCashbKDeezlHunJHqvbGqa",200,0.990148,40,203,2,201,1,2,1,3,2,102,101,100,100,58
"4972",71,"[40]hIzHoIuaGBkDnhJcmwCashbKDeezlHunJHqvbGqa",197,0.99,40,200,2,198,1,2,1,3,2,99,98,100,100,58
"4973",72,"[40]hIzHoIuaGBkDnhJcmwCashbKDeezlHunJHqvbGqa",196,0.98995,40,199,2,197,1,2,1,3,2,94,93,104,104,58
"4974",73,"[40]hIzHoIuaGBkDnhJcmwCashbKDeezlHunJHqvbGqa",204,0.990338,40,207,2,205,1,2,1,3,2,105,104,101,101,58
"4975",74,"[40]hIzHoIuaGBkDnhJcmwCashbKDeezlHunJHqvbGqa",189,0.989583,40,192,2,190,1,2,1,3,2,88,87,103,103,58
"4976",75,"[40]hIzHoIuaGBkDnhJcmwCashbKDeezlHunJHqvbGqa",215,0.990826,40,218,2,216,1,2,1,3,2,123,122,94,94,58
"4977",76,"[40]hIzHoIuaGBkDnhJcmwCashbKDeezlHunJHqvbGqa",189,0.989583,40,192,2,190,1,2,1,3,2,86,85,105,105,58
"4978",77,"[40]hIzHoIuaGBkDnhJcmwCashbKDeezlHunJHqvbGqa",191,0.989691,40,194,2,192,1,2,1,3,2,90,89,103,103,58
"4979",78,"[40]hIzHoIuaGBkDnhJcmwCashbKDeezlHunJHqvbGqa",204,0.990338,40,207,2,205,1,2,1,3,2,108,107,98,98,58
"4980",79,"[40]hIzHoIuaGBkDnhJcmwCashbKDeezlHunJHqvbGqa",193,0.989796,40,196,2,194,1,2,1,3,2,95,94,100,100,58
"4981",80,"[40]hIzHoIuaGBkDnhJcmwCashbKDeezlHunJHqvbGqa",198,0.99005,40,201,2,199,1,2,1,3,2,98,97,102,102,58
"4982",81,"[40]hIzHoIuaGBkDnhJcmwCashbKDeezlHunJHqvbGqa",203,0.990291,40,206,2,204,1,2,1,3,2,107,106,98,98,58
"4983",82,"[40]hIzHoIuaGBkDnhJcmwCashbKDeezlHunJHqvbGqa",207,0.990476,40,210,2,208,1,2,1,3,2,109,108,100,100,58
"4984",83,"[40]hIzHoIuaGBkDnhJcmwCashbKDeezlHunJHqvbGqa",193,0.989796,40,196,2,194,1,2,1,3,2,91,90,104,104,58
"4985",84,"[40]hIzHoIuaGBkDnhJcmwCashbKDeezlHunJHqvbGqa",195,0.989899,40,198,2,196,1,2,1,3,2,92,91,105,105,58
"4986",85,"[40]hIzHoIuaGBkDnhJcmwCashbKDeezlHunJHqvbGqa",204,0.990338,40,207,2,205,1,2,1,3,2,107,106,99,99,58
"4987",86,"[40]hIzHoIuaGBkDnhJcmwCashbKDeezlHunJHqvbGqa",212,0.990698,40,215,2,213,1,2,1,3,2,118,117,96,96,58
"4988",87,"[40]hIzHoIuaGBkDnhJcmwCashbKDeezlHunJHqvbGqa",206,0.990431,40,209,2,207,1,2,1,3,2,105,104,103,103,58
"4989",88,"[40]hIzHoIuaGBkDnhJcmwCashbKDeezlHunJHqvbGqa",205,0.990385,40,208,2,206,1,2,1,3,2,107,106,100,100,58
"4990",89,"[40]hIzHoIuaGBkDnhJcmwCashbKDeezlHunJHqvbGqa",199,0.990099,40,202,2,200,1,2,1,3,2,99,98,102,102,58
"4991",90,"[40]hIzHoIuaGBkDnhJcmwCashbKDeezlHunJHqvbGqa",198,0.99005,40,201,2,199,1,2,1,3,2,97,96,103,103,58
"4992",91,"[40]hIzHoIuaGBkDnhJcmwCashbKDeezlHunJHqvbGqa",198,0.99005,40,201,2,199,1,2,1,3,2,100,99,100,100,58
"4993",92,"[40]hIzHoIuaGBkDnhJcmwCashbKDeezlHunJHqvbGqa",195,0.989899,40,198,2,196,1,2,1,3,2,92,91,105,105,58
"4994",93,"[40]hIzHoIuaGBkDnhJcmwCashbKDeezlHunJHqvbGqa",203,0.990291,40,206,2,204,1,2,1,3,2,104,103,101,101,58
"4995",94,"[40]hIzHoIuaGBkDnhJcmwCashbKDeezlHunJHqvbGqa",202,0.990244,40,205,2,203,1,2,1,3,2,106,105,98,98,58
"4996",95,"[40]hIzHoIuaGBkDnhJcmwCashbKDeezlHunJHqvbGqa",207,0.990476,40,210,2,208,1,2,1,3,2,111,110,98,98,58
"4997",96,"[40]hIzHoIuaGBkDnhJcmwCashbKDeezlHunJHqvbGqa",197,0.99,40,200,2,198,1,2,1,3,2,94,93,105,105,58
"4998",97,"[40]hIzHoIuaGBkDnhJcmwCashbKDeezlHunJHqvbGqa",216,0.990868,40,219,2,217,1,2,1,3,2,122,121,96,96,58
"4999",98,"[40]hIzHoIuaGBkDnhJcmwCashbKDeezlHunJHqvbGqa",212,0.990698,40,215,2,213,1,2,1,3,2,120,119,94,94,58
"5000",99,"[40]hIzHoIuaGBkDnhJcmwCashbKDeezlHunJHqvbGqa",200,0.990148,40,203,2,201,1,2,1,3,2,100,99,102,102,58
"5001",0,"[40]zIuHoIrexBkbDahCDsFpxjahqAeKHnunJHqveGqa",204,0.990338,40,207,2,205,1,2,1,3,2,100,99,106,106,59
"5002",1,"[40]zIuHoIrexBkbDahCDsFpxjahqAeKHnunJHqveGqa",216,0.990868,40,219,2,217,1,2,1,3,2,116,115,102,102,59
"5003",2,"[40]zIuHoIrexBkbDahCDsFpxjahqAeKHnunJHqveGqa",210,0.99061,40,213,2,211,1,2,1,3,2,107,106,105,105,59
"5004",3,"[40]zIuHoIrexBkbDahCDsFpxjahqAeKHnunJHqveGqa",204,0.990338,40,207,2,205,1,2,1,3,2,96,95,110,110,59
"5005",4,"[40]zIuHoIrexBkbDahCDsFpxjahqAeKHnunJHqveGqa",210,0.99061,40,213,2,211,1,2,1,3,2,106,105,106,106,59
"5006",5,"[40]zIuHoIrexBkbDahCDsFpxjahqAeKHnunJHqveGqa",207,0.990476,40,210,2,208,1,2,1,3,2,104,103,105,105,59
"5007",6,"[40]zIuHoIrexBkbDahCDsFpxjahqAeKHnunJHqveGqa",216,0.990868,40,219,2,217,1,2,1,3,2,118,117,100,100,59
"5008",7,"[40]zIuHoIrexBkbDahCDsFpxjahqAeKHnunJHqveGqa",202,0.990244,40,205,2,203,1,2,1,3,2,96,95,108,108,59
"5009",8,"[40]zIuHoIrexBkbDahCDsFpxjahqAeKHnunJHqveGqa",206,0.990431,40,209,2,207,1,2,1,3,2,103,102,105,105,59
"5010",9,"[40]zIuHoIrexBkbDahCDsFpxjahqAeKHnunJHqveGqa",209,0.990566,40,212,2,210,1,2,1,3,2,109,108,102,102,59
"5011",10,"[40]zIuHoIrexBkbDahCDsFpxjahqAeKHnunJHqveGqa",218,0.99095,40,221,2,219,1,2,1,3,2,123,122,97,97,59
"5012",11,"[40]zIuHoIrexBkbDahCDsFpxjahqAeKHnunJHqveGqa",217,0.990909,40,220,2,218,1,2,1,3,2,117,116,102,102,59
"5013",12,"[40]zIuHoIrexBkbDahCDsFpxjahqAeKHnunJHqveGqa",210,0.99061,40,213,2,211,1,2,1,3,2,110,109,102,102,59
"5014",13,"[40]zIuHoIrexBkbDahCDsFpxjahqAeKHnunJHqveGqa",208,0.990521,40,211,2,209,1,2,1,3,2,106,105,104,104,59
"5015",14,"[40]zIuHoIrexBkbDahCDsFpxjahqAeKHnunJHqveGqa",204,0.990338,40,207,2,205,1,2,1,3,2,100,99,106,106,59
"5016",15,"[40]zIuHoIrexBkbDahCDsFpxjahqAeKHnunJHqveGqa",202,0.990244,40,205,2,203,1,2,1,3,2,95,94,109,109,59
"5017",16,"[40]zIuHoIrexBkbDahCDsFpxjahqAeKHnunJHqveGqa",192,0.989744,40,195,2,193,1,2,1,3,2,81,80,113,113,59
"5018",17,"[40]zIuHoIrexBkbDahCDsFpxjahqAeKHnunJHqveGqa",204,0.990338,40,207,2,205,1,2,1,3,2,98,97,108,108,59
"5019",18,"[40]zIuHoIrexBkbDahCDsFpxjahqAeKHnunJHqveGqa",212,0.990698,40,215,2,213,1,2,1,3,2,110,109,104,104,59
"5020",19,"[40]zIuHoIrexBkbDahCDsFpxjahqAeKHnunJHqveGqa",206,0.990431,40,209,2,207,1,2,1,3,2,102,101,106,106,59
"5021",20,"[40]zIuHoIrexBkbDahCDsFpxjahqAeKHnunJHqveGqa",217,0.990909,40,220,2,218,1,2,1,3,2,120,119,99,99,59
"5022",21,"[40]zIuHoIrexBkbDahCDsFpxjahqAeKHnunJHqveGqa",194,0.989848,40,197,2,195,1,2,1,3,2,85,84,111,111,59
"5023",22,"[40]zIuHoIrexBkbDahCDsFpxjahqAeKHnunJHqveGqa",202,0.990244,40,205,2,203,1,2,1,3,2,98,97,106,106,59
"5024",23,"[40]zIuHoIrexBkbDahCDsFpxjahqAeKHnunJHqveGqa",202,0.990244,40,205,2,203,1,2,1,3,2,96,95,108,108,59
"5025",24,"[40]zIuHoIrexBkbDahCDsFpxjahqAeKHnunJHqveGqa",200,0.990148,40,203,2,201,1,2,1,3,2,94,93,108,108,59
"5026",25,"[40]zIuHoIrexBkbDahCDsFpxjahqAeKHnunJHqveGqa",215,0.990826,40,218,2,216,1,2,1,3,2,116,115,101,101,59
"5027",26,"[40]zIuHoIrexBkbDahCDsFpxjahqAeKHnunJHqveGqa",203,0.990291,40,206,2,204,1,2,1,3,2,97,96,108,108,59
"5028",27,"[40]zIuHoIrexBkbDahCDsFpxjahqAeKHnunJHqveGqa",220,0.991031,40,223,2,221,1,2,1,3,2,124,123,98,98,59
"5029",28,"[40]zIuHoIrexBkbDahCDsFpxjahqAeKHnunJHqveGqa",204,0.990338,40,207,2,205,1,2,1,3,2,100,99,106,106,59
"5030",29,"[40]zIuHoIrexBkbDahCDsFpxjahqAeKHnunJHqveGqa",205,0.990385,40,208,2,206,1,2,1,3,2,100,99,107,107,59
"5031",30,"[40]zIuHoIrexBkbDahCDsFpxjahqAeKHnunJHqveGqa",222,0.991111,40,225,2,223,1,2,1,3,2,127,126,97,97,59
"5032",31,"[40]zIuHoIrexBkbDahCDsFpxjahqAeKHnunJHqveGqa",226,0.991266,40,229,2,227,1,2,1,3,2,131,130,97,97,59
"5033",32,"[40]zIuHoIrexBkbDahCDsFpxjahqAeKHnunJHqveGqa",207,0.990476,40,210,2,208,1,2,1,3,2,104,103,105,105,59
"5034",33,"[40]zIuHoIrexBkbDahCDsFpxjahqAeKHnunJHqveGqa",205,0.990385,40,208,2,206,1,2,1,3,2,103,102,104,104,59
"5035",34,"[40]zIuHoIrexBkbDahCDsFpxjahqAeKHnunJHqveGqa",212,0.990698,40,215,2,213,1,2,1,3,2,111,110,103,103,59
"5036",35,"[40]zIuHoIrexBkbDahCDsFpxjahqAeKHnunJHqveGqa",207,0.990476,40,210,2,208,1,2,1,3,2,104,103,105,105,59
"5037",36,"[40]zIuHoIrexBkbDahCDsFpxjahqAeKHnunJHqveGqa",204,0.990338,40,207,2,205,1,2,1,3,2,99,98,107,107,59
"5038",37,"[40]zIuHoIrexBkbDahCDsFpxjahqAeKHnunJHqveGqa",198,0.99005,40,201,2,199,1,2,1,3,2,90,89,110,110,59
"5039",38,"[40]zIuHoIrexBkbDahCDsFpxjahqAeKHnunJHqveGqa",214,0.990783,40,217,2,215,1,2,1,3,2,115,114,101,101,59
"5040",39,"[40]zIuHoIrexBkbDahCDsFpxjahqAeKHnunJHqveGqa",210,0.99061,40,213,2,211,1,2,1,3,2,108,107,104,104,59
"5041",40,"[40]zIuHoIrexBkbDahCDsFpxjahqAeKHnunJHqveGqa",204,0.990338,40,207,2,205,1,2,1,3,2,101,100,105,105,59
"5042",41,"[40]zIuHoIrexBkbDahCDsFpxjahqAeKHnunJHqveGqa",210,0.99061,40,213,2,211,1,2,1,3,2,110,109,102,102,59
"5043",42,"[40]zIuHoIrexBkbDahCDsFpxjahqAeKHnunJHqveGqa",194,0.989848,40,197,2,195,1,2,1,3,2,85,84,111,111,59
"5044",43,"[40]zIuHoIrexBkbDahCDsFpxjahqAeKHnunJHqveGqa",219,0.990991,40,222,2,220,1,2,1,3,2,124,123,97,97,59
"5045",44,"[40]zIuHoIrexBkbDahCDsFpxjahqAeKHnunJHqveGqa",212,0.990698,40,215,2,213,1,2,1,3,2,110,109,104,104,59
"5046",45,"[40]zIuHoIrexBkbDahCDsFpxjahqAeKHnunJHqveGqa",216,0.990868,40,219,2,217,1,2,1,3,2,119,118,99,99,59
"5047",46,"[40]zIuHoIrexBkbDahCDsFpxjahqAeKHnunJHqveGqa",205,0.990385,40,208,2,206,1,2,1,3,2,100,99,107,107,59
"5048",47,"[40]zIuHoIrexBkbDahCDsFpxjahqAeKHnunJHqveGqa",205,0.990385,40,208,2,206,1,2,1,3,2,102,101,105,105,59
"5049",48,"[40]zIuHoIrexBkbDahCDsFpxjahqAeKHnunJHqveGqa",203,0.990291,40,206,2,204,1,2,1,3,2,100,99,105,105,59
"5050",49,"[40]zIuHoIrexBkbDahCDsFpxjahqAeKHnunJHqveGqa",214,0.990783,40,217,2,215,1,2,1,3,2,115,114,101,101,59
"5051",50,"[40]zIuHoIrexBkbDahCDsFpxjahqAeKHnunJHqveGqa",203,0.990291,40,206,2,204,1,2,1,3,2,96,95,109,109,59
"5052",51,"[40]zIuHoIrexBkbDahCDsFpxjahqAeKHnunJHqveGqa",197,0.99,40,200,2,198,1,2,1,3,2,87,86,112,112,59
"5053",52,"[40]zIuHoIrexBkbDahCDsFpxjahqAeKHnunJHqveGqa",201,0.990196,40,204,2,202,1,2,1,3,2,95,94,108,108,59
"5054",53,"[40]zIuHoIrexBkbDahCDsFpxjahqAeKHnunJHqveGqa",221,0.991071,40,224,2,222,1,2,1,3,2,127,126,96,96,59
"5055",54,"[40]zIuHoIrexBkbDahCDsFpxjahqAeKHnunJHqveGqa",204,0.990338,40,207,2,205,1,2,1,3,2,98,97,108,108,59
"5056",55,"[40]zIuHoIrexBkbDahCDsFpxjahqAeKHnunJHqveGqa",208,0.990521,40,211,2,209,1,2,1,3,2,105,104,105,105,59
"5057",56,"[40]zIuHoIrexBkbDahCDsFpxjahqAeKHnunJHqveGqa",202,0.990244,40,205,2,203,1,2,1,3,2,98,97,106,106,59
"5058",57,"[40]zIuHoIrexBkbDahCDsFpxjahqAeKHnunJHqveGqa",213,0.990741,40,216,2,214,1,2,1,3,2,115,114,100,100,59
"5059",58,"[40]zIuHoIrexBkbDahCDsFpxjahqAeKHnunJHqveGqa",219,0.990991,40,222,2,220,1,2,1,3,2,120,119,101,101,59
"5060",59,"[40]zIuHoIrexBkbDahCDsFpxjahqAeKHnunJHqveGqa",219,0.990991,40,222,2,220,1,2,1,3,2,124,123,97,97,59
"5061",60,"[40]zIuHoIrexBkbDahCDsFpxjahqAeKHnunJHqveGqa",207,0.990476,40,210,2,208,1,2,1,3,2,104,103,105,105,59
"5062",61,"[40]zIuHoIrexBkbDahCDsFpxjahqAeKHnunJHqveGqa",206,0.990431,40,209,2,207,1,2,1,3,2,102,101,106,106,59
"5063",62,"[40]zIuHoIrexBkbDahCDsFpxjahqAeKHnunJHqveGqa",197,0.99,40,200,2,198,1,2,1,3,2,89,88,110,110,59
"5064",63,"[40]zIuHoIrexBkbDahCDsFpxjahqAeKHnunJHqveGqa",213,0.990741,40,216,2,214,1,2,1,3,2,114,113,101,101,59
"5065",64,"[40]zIuHoIrexBkbDahCDsFpxjahqAeKHnunJHqveGqa",206,0.990431,40,209,2,207,1,2,1,3,2,103,102,105,105,59
"5066",65,"[40]zIuHoIrexBkbDahCDsFpxjahqAeKHnunJHqveGqa",216,0.990868,40,219,2,217,1,2,1,3,2,117,116,101,101,59
"5067",66,"[40]zIuHoIrexBkbDahCDsFpxjahqAeKHnunJHqveGqa",202,0.990244,40,205,2,203,1,2,1,3,2,97,96,107,107,59
"5068",67,"[40]zIuHoIrexBkbDahCDsFpxjahqAeKHnunJHqveGqa",210,0.99061,40,213,2,211,1,2,1,3,2,109,108,103,103,59
"5069",68,"[40]zIuHoIrexBkbDahCDsFpxjahqAeKHnunJHqveGqa",207,0.990476,40,210,2,208,1,2,1,3,2,104,103,105,105,59
"5070",69,"[40]zIuHoIrexBkbDahCDsFpxjahqAeKHnunJHqveGqa",199,0.990099,40,202,2,200,1,2,1,3,2,93,92,108,108,59
"5071",70,"[40]zIuHoIrexBkbDahCDsFpxjahqAeKHnunJHqveGqa",207,0.990476,40,210,2,208,1,2,1,3,2,102,101,107,107,59
"5072",71,"[40]zIuHoIrexBkbDahCDsFpxjahqAeKHnunJHqveGqa",202,0.990244,40,205,2,203,1,2,1,3,2,97,96,107,107,59
"5073",72,"[40]zIuHoIrexBkbDahCDsFpxjahqAeKHnunJHqveGqa",197,0.99,40,200,2,198,1,2,1,3,2,89,88,110,110,59
"5074",73,"[40]zIuHoIrexBkbDahCDsFpxjahqAeKHnunJHqveGqa",219,0.990991,40,222,2,220,1,2,1,3,2,123,122,98,98,59
"5075",74,"[40]zIuHoIrexBkbDahCDsFpxjahqAeKHnunJHqveGqa",207,0.990476,40,210,2,208,1,2,1,3,2,105,104,104,104,59
"5076",75,"[40]zIuHoIrexBkbDahCDsFpxjahqAeKHnunJHqveGqa",205,0.990385,40,208,2,206,1,2,1,3,2,101,100,106,106,59
"5077",76,"[40]zIuHoIrexBkbDahCDsFpxjahqAeKHnunJHqveGqa",213,0.990741,40,216,2,214,1,2,1,3,2,114,113,101,101,59
"5078",77,"[40]zIuHoIrexBkbDahCDsFpxjahqAeKHnunJHqveGqa",207,0.990476,40,210,2,208,1,2,1,3,2,102,101,107,107,59
"5079",78,"[40]zIuHoIrexBkbDahCDsFpxjahqAeKHnunJHqveGqa",206,0.990431,40,209,2,207,1,2,1,3,2,102,101,106,106,59
"5080",79,"[40]zIuHoIrexBkbDahCDsFpxjahqAeKHnunJHqveGqa",215,0.990826,40,218,2,216,1,2,1,3,2,115,114,102,102,59
"5081",80,"[40]zIuHoIrexBkbDahCDsFpxjahqAeKHnunJHqveGqa",213,0.990741,40,216,2,214,1,2,1,3,2,112,111,103,103,59
"5082",81,"[40]zIuHoIrexBkbDahCDsFpxjahqAeKHnunJHqveGqa",218,0.99095,40,221,2,219,1,2,1,3,2,120,119,100,100,59
"5083",82,"[40]zIuHoIrexBkbDahCDsFpxjahqAeKHnunJHqveGqa",220,0.991031,40,223,2,221,1,2,1,3,2,122,121,100,100,59
"5084",83,"[40]zIuHoIrexBkbDahCDsFpxjahqAeKHnunJHqveGqa",195,0.989899,40,198,2,196,1,2,1,3,2,87,86,110,110,59
"5085",84,"[40]zIuHoIrexBkbDahCDsFpxjahqAeKHnunJHqveGqa",208,0.990521,40,211,2,209,1,2,1,3,2,107,106,103,103,59
"5086",85,"[40]zIuHoIrexBkbDahCDsFpxjahqAeKHnunJHqveGqa",215,0.990826,40,218,2,216,1,2,1,3,2,114,113,103,103,59
"5087",86,"[40]zIuHoIrexBkbDahCDsFpxjahqAeKHnunJHqveGqa",209,0.990566,40,212,2,210,1,2,1,3,2,105,104,106,106,59
"5088",87,"[40]zIuHoIrexBkbDahCDsFpxjahqAeKHnunJHqveGqa",210,0.99061,40,213,2,211,1,2,1,3,2,110,109,102,102,59
"5089",88,"[40]zIuHoIrexBkbDahCDsFpxjahqAeKHnunJHqveGqa",202,0.990244,40,205,2,203,1,2,1,3,2,98,97,106,106,59
"5090",89,"[40]zIuHoIrexBkbDahCDsFpxjahqAeKHnunJHqveGqa",210,0.99061,40,213,2,211,1,2,1,3,2,111,110,101,101,59
"5091",90,"[40]zIuHoIrexBkbDahCDsFpxjahqAeKHnunJHqveGqa",217,0.990909,40,220,2,218,1,2,1,3,2,119,118,100,100,59
"5092",91,"[40]zIuHoIrexBkbDahCDsFpxjahqAeKHnunJHqveGqa",202,0.990244,40,205,2,203,1,2,1,3,2,98,97,106,106,59
"5093",92,"[40]zIuHoIrexBkbDahCDsFpxjahqAeKHnunJHqveGqa",221,0.991071,40,224,2,222,1,2,1,3,2,123,122,100,100,59
"5094",93,"[40]zIuHoIrexBkbDahCDsFpxjahqAeKHnunJHqveGqa",215,0.990826,40,218,2,216,1,2,1,3,2,116,115,101,101,59
"5095",94,"[40]zIuHoIrexBkbDahCDsFpxjahqAeKHnunJHqveGqa",206,0.990431,40,209,2,207,1,2,1,3,2,103,102,105,105,59
"5096",95,"[40]zIuHoIrexBkbDahCDsFpxjahqAeKHnunJHqveGqa",192,0.989744,40,195,2,193,1,2,1,3,2,82,81,112,112,59
"5097",96,"[40]zIuHoIrexBkbDahCDsFpxjahqAeKHnunJHqveGqa",193,0.989796,40,196,2,194,1,2,1,3,2,85,84,110,110,59
"5098",97,"[40]zIuHoIrexBkbDahCDsFpxjahqAeKHnunJHqveGqa",210,0.99061,40,213,2,211,1,2,1,3,2,109,108,103,103,59
"5099",98,"[40]zIuHoIrexBkbDahCDsFpxjahqAeKHnunJHqveGqa",198,0.99005,40,201,2,199,1,2,1,3,2,92,91,108,108,59
"5100",99,"[40]zIuHoIrexBkbDahCDsFpxjahqAeKHnunJHqveGqa",214,0.990783,40,217,2,215,1,2,1,3,2,115,114,101,101,59
"5101",0,"[40]wIyHoIpAeBkDDonoExjdlhbKDaeGdHvnJHqwbGqa",193,0.989796,40,196,2,194,1,2,1,3,2,92,91,103,103,60
"5102",1,"[40]wIyHoIpAeBkDDonoExjdlhbKDaeGdHvnJHqwbGqa",204,0.990338,40,207,2,205,1,2,1,3,2,106,105,100,100,60
"5103",2,"[40]wIyHoIpAeBkDDonoExjdlhbKDaeGdHvnJHqwbGqa",195,0.989899,40,198,2,196,1,2,1,3,2,95,94,102,102,60
"5104",3,"[40]wIyHoIpAeBkDDonoExjdlhbKDaeGdHvnJHqwbGqa",203,0.990291,40,206,2,204,1,2,1,3,2,103,102,102,102,60
"5105",4,"[40]wIyHoIpAeBkDDonoExjdlhbKDaeGdHvnJHqwbGqa",205,0.990385,40,208,2,206,1,2,1,3,2,109,108,98,98,60
"5106",5,"[40]wIyHoIpAeBkDDonoExjdlhbKDaeGdHvnJHqwbGqa",189,0.989583,40,192,2,190,1,2,1,3,2,86,85,105,105,60
"5107",6,"[40]wIyHoIpAeBkDDonoExjdlhbKDaeGdHvnJHqwbGqa",194,0.989848,40,197,2,195,1,2,1,3,2,93,92,103,103,60
"5108",7,"[40]wIyHoIpAeBkDDonoExjdlhbKDaeGdHvnJHqwbGqa",196,0.98995,40,199,2,197,1,2,1,3,2,96,95,102,102,60
"5109",8,"[40]wIyHoIpAeBkDDonoExjdlhbKDaeGdHvnJHqwbGqa",204,0.990338,40,207,2,205,1,2,1,3,2,104,103,102,102,60
"5110",9,"[40]wIyHoIpAeBkDDonoExjdlhbKDaeGdHvnJHqwbGqa",216,0.990868,40,219,2,217,1,2,1,3,2,120,119,98,98,60
"5111",10,"[40]wIyHoIpAeBkDDonoExjdlhbKDaeGdHvnJHqwbGqa",199,0.990099,40,202,2,200,1,2,1,3,2,97,96,104,104,60
"5112",11,"[40]wIyHoIpAeBkDDonoExjdlhbKDaeGdHvnJHqwbGqa",201,0.990196,40,204,2,202,1,2,1,3,2,103,102,100,100,60
"5113",12,"[40]wIyHoIpAeBkDDonoExjdlhbKDaeGdHvnJHqwbGqa",199,0.990099,40,202,2,200,1,2,1,3,2,102,101,99,99,60
"5114",13,"[40]wIyHoIpAeBkDDonoExjdlhbKDaeGdHvnJHqwbGqa",197,0.99,40,200,2,198,1,2,1,3,2,98,97,101,101,60
"5115",14,"[40]wIyHoIpAeBkDDonoExjdlhbKDaeGdHvnJHqwbGqa",209,0.990566,40,212,2,210,1,2,1,3,2,111,110,100,100,60
"5116",15,"[40]wIyHoIpAeBkDDonoExjdlhbKDaeGdHvnJHqwbGqa",184,0.989305,40,187,2,185,1,2,1,3,2,80,79,106,106,60
"5117",16,"[40]wIyHoIpAeBkDDonoExjdlhbKDaeGdHvnJHqwbGqa",209,0.990566,40,212,2,210,1,2,1,3,2,110,109,101,101,60
"5118",17,"[40]wIyHoIpAeBkDDonoExjdlhbKDaeGdHvnJHqwbGqa",197,0.99,40,200,2,198,1,2,1,3,2,94,93,105,105,60
"5119",18,"[40]wIyHoIpAeBkDDonoExjdlhbKDaeGdHvnJHqwbGqa",218,0.99095,40,221,2,219,1,2,1,3,2,126,125,94,94,60
"5120",19,"[40]wIyHoIpAeBkDDonoExjdlhbKDaeGdHvnJHqwbGqa",206,0.990431,40,209,2,207,1,2,1,3,2,110,109,98,98,60
"5121",20,"[40]wIyHoIpAeBkDDonoExjdlhbKDaeGdHvnJHqwbGqa",191,0.989691,40,194,2,192,1,2,1,3,2,86,85,107,107,60
"5122",21,"[40]wIyHoIpAeBkDDonoExjdlhbKDaeGdHvnJHqwbGqa",202,0.990244,40,205,2,203,1,2,1,3,2,100,99,104,104,60
"5123",22,"[40]wIyHoIpAeBkDDonoExjdlhbKDaeGdHvnJHqwbGqa",202,0.990244,40,205,2,203,1,2,1,3,2,105,104,99,99,60
"5124",23,"[40]wIyHoIpAeBkDDonoExjdlhbKDaeGdHvnJHqwbGqa",210,0.99061,40,213,2,211,1,2,1,3,2,116,115,96,96,60
"5125",24,"[40]wIyHoIpAeBkDDonoExjdlhbKDaeGdHvnJHqwbGqa",208,0.990521,40,211,2,209,1,2,1,3,2,115,114,95,95,60
"5126",25,"[40]wIyHoIpAeBkDDonoExjdlhbKDaeGdHvnJHqwbGqa",207,0.990476,40,210,2,208,1,2,1,3,2,108,107,101,101,60
"5127",26,"[40]wIyHoIpAeBkDDonoExjdlhbKDaeGdHvnJHqwbGqa",209,0.990566,40,212,2,210,1,2,1,3,2,113,112,98,98,60
"5128",27,"[40]wIyHoIpAeBkDDonoExjdlhbKDaeGdHvnJHqwbGqa",213,0.990741,40,216,2,214,1,2,1,3,2,119,118,96,96,60
"5129",28,"[40]wIyHoIpAeBkDDonoExjdlhbKDaeGdHvnJHqwbGqa",200,0.990148,40,203,2,201,1,2,1,3,2,100,99,102,102,60
"5130",29,"[40]wIyHoIpAeBkDDonoExjdlhbKDaeGdHvnJHqwbGqa",213,0.990741,40,216,2,214,1,2,1,3,2,118,117,97,97,60
"5131",30,"[40]wIyHoIpAeBkDDonoExjdlhbKDaeGdHvnJHqwbGqa",206,0.990431,40,209,2,207,1,2,1,3,2,111,110,97,97,60
"5132",31,"[40]wIyHoIpAeBkDDonoExjdlhbKDaeGdHvnJHqwbGqa",199,0.990099,40,202,2,200,1,2,1,3,2,99,98,102,102,60
"5133",32,"[40]wIyHoIpAeBkDDonoExjdlhbKDaeGdHvnJHqwbGqa",203,0.990291,40,206,2,204,1,2,1,3,2,104,103,101,101,60
"5134",33,"[40]wIyHoIpAeBkDDonoExjdlhbKDaeGdHvnJHqwbGqa",190,0.989637,40,193,2,191,1,2,1,3,2,89,88,103,103,60
"5135",34,"[40]wIyHoIpAeBkDDonoExjdlhbKDaeGdHvnJHqwbGqa",200,0.990148,40,203,2,201,1,2,1,3,2,102,101,100,100,60
"5136",35,"[40]wIyHoIpAeBkDDonoExjdlhbKDaeGdHvnJHqwbGqa",211,0.990654,40,214,2,212,1,2,1,3,2,115,114,98,98,60
"5137",36,"[40]wIyHoIpAeBkDDonoExjdlhbKDaeGdHvnJHqwbGqa",238,0.991701,40,241,2,239,1,2,1,3,2,152,151,88,88,60
"5138",37,"[40]wIyHoIpAeBkDDonoExjdlhbKDaeGdHvnJHqwbGqa",206,0.990431,40,209,2,207,1,2,1,3,2,107,106,101,101,60
"5139",38,"[40]wIyHoIpAeBkDDonoExjdlhbKDaeGdHvnJHqwbGqa",200,0.990148,40,203,2,201,1,2,1,3,2,100,99,102,102,60
"5140",39,"[40]wIyHoIpAeBkDDonoExjdlhbKDaeGdHvnJHqwbGqa",192,0.989744,40,195,2,193,1,2,1,3,2,88,87,106,106,60
"5141",40,"[40]wIyHoIpAeBkDDonoExjdlhbKDaeGdHvnJHqwbGqa",207,0.990476,40,210,2,208,1,2,1,3,2,110,109,99,99,60
"5142",41,"[40]wIyHoIpAeBkDDonoExjdlhbKDaeGdHvnJHqwbGqa",204,0.990338,40,207,2,205,1,2,1,3,2,107,106,99,99,60
"5143",42,"[40]wIyHoIpAeBkDDonoExjdlhbKDaeGdHvnJHqwbGqa",207,0.990476,40,210,2,208,1,2,1,3,2,108,107,101,101,60
"5144",43,"[40]wIyHoIpAeBkDDonoExjdlhbKDaeGdHvnJHqwbGqa",194,0.989848,40,197,2,195,1,2,1,3,2,93,92,103,103,60
"5145",44,"[40]wIyHoIpAeBkDDonoExjdlhbKDaeGdHvnJHqwbGqa",205,0.990385,40,208,2,206,1,2,1,3,2,109,108,98,98,60
"5146",45,"[40]wIyHoIpAeBkDDonoExjdlhbKDaeGdHvnJHqwbGqa",209,0.990566,40,212,2,210,1,2,1,3,2,113,112,98,98,60
"5147",46,"[40]wIyHoIpAeBkDDonoExjdlhbKDaeGdHvnJHqwbGqa",206,0.990431,40,209,2,207,1,2,1,3,2,108,107,100,100,60
"5148",47,"[40]wIyHoIpAeBkDDonoExjdlhbKDaeGdHvnJHqwbGqa",217,0.990909,40,220,2,218,1,2,1,3,2,126,125,93,93,60
"5149",48,"[40]wIyHoIpAeBkDDonoExjdlhbKDaeGdHvnJHqwbGqa",200,0.990148,40,203,2,201,1,2,1,3,2,100,99,102,102,60
"5150",49,"[40]wIyHoIpAeBkDDonoExjdlhbKDaeGdHvnJHqwbGqa",218,0.99095,40,221,2,219,1,2,1,3,2,126,125,94,94,60
"5151",50,"[40]wIyHoIpAeBkDDonoExjdlhbKDaeGdHvnJHqwbGqa",202,0.990244,40,205,2,203,1,2,1,3,2,105,104,99,99,60
"5152",51,"[40]wIyHoIpAeBkDDonoExjdlhbKDaeGdHvnJHqwbGqa",202,0.990244,40,205,2,203,1,2,1,3,2,103,102,101,101,60
"5153",52,"[40]wIyHoIpAeBkDDonoExjdlhbKDaeGdHvnJHqwbGqa",198,0.99005,40,201,2,199,1,2,1,3,2,100,99,100,100,60
"5154",53,"[40]wIyHoIpAeBkDDonoExjdlhbKDaeGdHvnJHqwbGqa",210,0.99061,40,213,2,211,1,2,1,3,2,114,113,98,98,60
"5155",54,"[40]wIyHoIpAeBkDDonoExjdlhbKDaeGdHvnJHqwbGqa",207,0.990476,40,210,2,208,1,2,1,3,2,111,110,98,98,60
"5156",55,"[40]wIyHoIpAeBkDDonoExjdlhbKDaeGdHvnJHqwbGqa",187,0.989474,40,190,2,188,1,2,1,3,2,84,83,105,105,60
"5157",56,"[40]wIyHoIpAeBkDDonoExjdlhbKDaeGdHvnJHqwbGqa",205,0.990385,40,208,2,206,1,2,1,3,2,108,107,99,99,60
"5158",57,"[40]wIyHoIpAeBkDDonoExjdlhbKDaeGdHvnJHqwbGqa",210,0.99061,40,213,2,211,1,2,1,3,2,114,113,98,98,60
"5159",58,"[40]wIyHoIpAeBkDDonoExjdlhbKDaeGdHvnJHqwbGqa",192,0.989744,40,195,2,193,1,2,1,3,2,91,90,103,103,60
"5160",59,"[40]wIyHoIpAeBkDDonoExjdlhbKDaeGdHvnJHqwbGqa",178,0.98895,40,181,2,179,1,2,1,3,2,71,70,109,109,60
"5161",60,"[40]wIyHoIpAeBkDDonoExjdlhbKDaeGdHvnJHqwbGqa",202,0.990244,40,205,2,203,1,2,1,3,2,104,103,100,100,60
"5162",61,"[40]wIyHoIpAeBkDDonoExjdlhbKDaeGdHvnJHqwbGqa",207,0.990476,40,210,2,208,1,2,1,3,2,108,107,101,101,60
"5163",62,"[40]wIyHoIpAeBkDDonoExjdlhbKDaeGdHvnJHqwbGqa",198,0.99005,40,201,2,199,1,2,1,3,2,96,95,104,104,60
"5164",63,"[40]wIyHoIpAeBkDDonoExjdlhbKDaeGdHvnJHqwbGqa",201,0.990196,40,204,2,202,1,2,1,3,2,103,102,100,100,60
"5165",64,"[40]wIyHoIpAeBkDDonoExjdlhbKDaeGdHvnJHqwbGqa",213,0.990741,40,216,2,214,1,2,1,3,2,118,117,97,97,60
"5166",65,"[40]wIyHoIpAeBkDDonoExjdlhbKDaeGdHvnJHqwbGqa",216,0.990868,40,219,2,217,1,2,1,3,2,119,118,99,99,60
"5167",66,"[40]wIyHoIpAeBkDDonoExjdlhbKDaeGdHvnJHqwbGqa",202,0.990244,40,205,2,203,1,2,1,3,2,102,101,102,102,60
"5168",67,"[40]wIyHoIpAeBkDDonoExjdlhbKDaeGdHvnJHqwbGqa",212,0.990698,40,215,2,213,1,2,1,3,2,119,118,95,95,60
"5169",68,"[40]wIyHoIpAeBkDDonoExjdlhbKDaeGdHvnJHqwbGqa",195,0.989899,40,198,2,196,1,2,1,3,2,95,94,102,102,60
"5170",69,"[40]wIyHoIpAeBkDDonoExjdlhbKDaeGdHvnJHqwbGqa",210,0.99061,40,213,2,211,1,2,1,3,2,113,112,99,99,60
"5171",70,"[40]wIyHoIpAeBkDDonoExjdlhbKDaeGdHvnJHqwbGqa",196,0.98995,40,199,2,197,1,2,1,3,2,93,92,105,105,60
"5172",71,"[40]wIyHoIpAeBkDDonoExjdlhbKDaeGdHvnJHqwbGqa",211,0.990654,40,214,2,212,1,2,1,3,2,117,116,96,96,60
"5173",72,"[40]wIyHoIpAeBkDDonoExjdlhbKDaeGdHvnJHqwbGqa",206,0.990431,40,209,2,207,1,2,1,3,2,108,107,100,100,60
"5174",73,"[40]wIyHoIpAeBkDDonoExjdlhbKDaeGdHvnJHqwbGqa",200,0.990148,40,203,2,201,1,2,1,3,2,100,99,102,102,60
"5175",74,"[40]wIyHoIpAeBkDDonoExjdlhbKDaeGdHvnJHqwbGqa",202,0.990244,40,205,2,203,1,2,1,3,2,103,102,101,101,60
"5176",75,"[40]wIyHoIpAeBkDDonoExjdlhbKDaeGdHvnJHqwbGqa",207,0.990476,40,210,2,208,1,2,1,3,2,110,109,99,99,60
"5177",76,"[40]wIyHoIpAeBkDDonoExjdlhbKDaeGdHvnJHqwbGqa",203,0.990291,40,206,2,204,1,2,1,3,2,105,104,100,100,60
"5178",77,"[40]wIyHoIpAeBkDDonoExjdlhbKDaeGdHvnJHqwbGqa",209,0.990566,40,212,2,210,1,2,1,3,2,113,112,98,98,60
"5179",78,"[40]wIyHoIpAeBkDDonoExjdlhbKDaeGdHvnJHqwbGqa",212,0.990698,40,215,2,213,1,2,1,3,2,116,115,98,98,60
"5180",79,"[40]wIyHoIpAeBkDDonoExjdlhbKDaeGdHvnJHqwbGqa",201,0.990196,40,204,2,202,1,2,1,3,2,102,101,101,101,60
"5181",80,"[40]wIyHoIpAeBkDDonoExjdlhbKDaeGdHvnJHqwbGqa",192,0.989744,40,195,2,193,1,2,1,3,2,89,88,105,105,60
"5182",81,"[40]wIyHoIpAeBkDDonoExjdlhbKDaeGdHvnJHqwbGqa",194,0.989848,40,197,2,195,1,2,1,3,2,93,92,103,103,60
"5183",82,"[40]wIyHoIpAeBkDDonoExjdlhbKDaeGdHvnJHqwbGqa",192,0.989744,40,195,2,193,1,2,1,3,2,89,88,105,105,60
"5184",83,"[40]wIyHoIpAeBkDDonoExjdlhbKDaeGdHvnJHqwbGqa",200,0.990148,40,203,2,201,1,2,1,3,2,99,98,103,103,60
"5185",84,"[40]wIyHoIpAeBkDDonoExjdlhbKDaeGdHvnJHqwbGqa",200,0.990148,40,203,2,201,1,2,1,3,2,101,100,101,101,60
"5186",85,"[40]wIyHoIpAeBkDDonoExjdlhbKDaeGdHvnJHqwbGqa",209,0.990566,40,212,2,210,1,2,1,3,2,113,112,98,98,60
"5187",86,"[40]wIyHoIpAeBkDDonoExjdlhbKDaeGdHvnJHqwbGqa",196,0.98995,40,199,2,197,1,2,1,3,2,95,94,103,103,60
"5188",87,"[40]wIyHoIpAeBkDDonoExjdlhbKDaeGdHvnJHqwbGqa",212,0.990698,40,215,2,213,1,2,1,3,2,116,115,98,98,60
"5189",88,"[40]wIyHoIpAeBkDDonoExjdlhbKDaeGdHvnJHqwbGqa",193,0.989796,40,196,2,194,1,2,1,3,2,92,91,103,103,60
"5190",89,"[40]wIyHoIpAeBkDDonoExjdlhbKDaeGdHvnJHqwbGqa",201,0.990196,40,204,2,202,1,2,1,3,2,103,102,100,100,60
"5191",90,"[40]wIyHoIpAeBkDDonoExjdlhbKDaeGdHvnJHqwbGqa",201,0.990196,40,204,2,202,1,2,1,3,2,101,100,102,102,60
"5192",91,"[40]wIyHoIpAeBkDDonoExjdlhbKDaeGdHvnJHqwbGqa",204,0.990338,40,207,2,205,1,2,1,3,2,105,104,101,101,60
"5193",92,"[40]wIyHoIpAeBkDDonoExjdlhbKDaeGdHvnJHqwbGqa",214,0.990783,40,217,2,215,1,2,1,3,2,121,120,95,95,60
"5194",93,"[40]wIyHoIpAeBkDDonoExjdlhbKDaeGdHvnJHqwbGqa",207,0.990476,40,210,2,208,1,2,1,3,2,113,112,96,96,60
"5195",94,"[40]wIyHoIpAeBkDDonoExjdlhbKDaeGdHvnJHqwbGqa",202,0.990244,40,205,2,203,1,2,1,3,2,101,100,103,103,60
"5196",95,"[40]wIyHoIpAeBkDDonoExjdlhbKDaeGdHvnJHqwbGqa",200,0.990148,40,203,2,201,1,2,1,3,2,103,102,99,99,60
"5197",96,"[40]wIyHoIpAeBkDDonoExjdlhbKDaeGdHvnJHqwbGqa",198,0.99005,40,201,2,199,1,2,1,3,2,99,98,101,101,60
"5198",97,"[40]wIyHoIpAeBkDDonoExjdlhbKDaeGdHvnJHqwbGqa",191,0.989691,40,194,2,192,1,2,1,3,2,88,87,105,105,60
"5199",98,"[40]wIyHoIpAeBkDDonoExjdlhbKDaeGdHvnJHqwbGqa",200,0.990148,40,203,2,201,1,2,1,3,2,101,100,101,101,60
"5200",99,"[40]wIyHoIpAeBkDDonoExjdlhbKDaeGdHvnJHqwbGqa",195,0.989899,40,198,2,196,1,2,1,3,2,95,94,102,102,60
"5201",0,"[40]qIdHoIEDcBkDxcBJfgrvgAbKDaetmHwnJHqxbGqa",205,0.990385,40,208,2,206,1,2,1,3,2,110,109,97,97,61
"5202",1,"[40]qIdHoIEDcBkDxcBJfgrvgAbKDaetmHwnJHqxbGqa",206,0.990431,40,209,2,207,1,2,1,3,2,110,109,98,98,61
"5203",2,"[40]qIdHoIEDcBkDxcBJfgrvgAbKDaetmHwnJHqxbGqa",204,0.990338,40,207,2,205,1,2,1,3,2,105,104,101,101,61
"5204",3,"[40]qIdHoIEDcBkDxcBJfgrvgAbKDaetmHwnJHqxbGqa",193,0.989796,40,196,2,194,1,2,1,3,2,88,87,107,107,61
"5205",4,"[40]qIdHoIEDcBkDxcBJfgrvgAbKDaetmHwnJHqxbGqa",200,0.990148,40,203,2,201,1,2,1,3,2,104,103,98,98,61
"5206",5,"[40]qIdHoIEDcBkDxcBJfgrvgAbKDaetmHwnJHqxbGqa",214,0.990783,40,217,2,215,1,2,1,3,2,118,117,98,98,61
"5207",6,"[40]qIdHoIEDcBkDxcBJfgrvgAbKDaetmHwnJHqxbGqa",214,0.990783,40,217,2,215,1,2,1,3,2,121,120,95,95,61
"5208",7,"[40]qIdHoIEDcBkDxcBJfgrvgAbKDaetmHwnJHqxbGqa",181,0.98913,40,184,2,182,1,2,1,3,2,76,75,107,107,61
"5209",8,"[40]qIdHoIEDcBkDxcBJfgrvgAbKDaetmHwnJHqxbGqa",198,0.99005,40,201,2,199,1,2,1,3,2,99,98,101,101,61
"5210",9,"[40]qIdHoIEDcBkDxcBJfgrvgAbKDaetmHwnJHqxbGqa",211,0.990654,40,214,2,212,1,2,1,3,2,117,116,96,96,61
"5211",10,"[40]qIdHoIEDcBkDxcBJfgrvgAbKDaetmHwnJHqxbGqa",190,0.989637,40,193,2,191,1,2,1,3,2,91,90,101,101,61
"5212",11,"[40]qIdHoIEDcBkDxcBJfgrvgAbKDaetmHwnJHqxbGqa",213,0.990741,40,216,2,214,1,2,1,3,2,122,121,93,93,61
"5213",12,"[40]qIdHoIEDcBkDxcBJfgrvgAbKDaetmHwnJHqxbGqa",190,0.989637,40,193,2,191,1,2,1,3,2,89,88,103,103,61
"5214",13,"[40]qIdHoIEDcBkDxcBJfgrvgAbKDaetmHwnJHqxbGqa",182,0.989189,40,185,2,183,1,2,1,3,2,76,75,108,108,61
"5215",14,"[40]qIdHoIEDcBkDxcBJfgrvgAbKDaetmHwnJHqxbGqa",201,0.990196,40,204,2,202,1,2,1,3,2,102,101,101,101,61
"5216",15,"[40]qIdHoIEDcBkDxcBJfgrvgAbKDaetmHwnJHqxbGqa",189,0.989583,40,192,2,190,1,2,1,3,2,83,82,108,108,61
"5217",16,"[40]qIdHoIEDcBkDxcBJfgrvgAbKDaetmHwnJHqxbGqa",190,0.989637,40,193,2,191,1,2,1,3,2,86,85,106,106,61
"5218",17,"[40]qIdHoIEDcBkDxcBJfgrvgAbKDaetmHwnJHqxbGqa",205,0.990385,40,208,2,206,1,2,1,3,2,108,107,99,99,61
"5219",18,"[40]qIdHoIEDcBkDxcBJfgrvgAbKDaetmHwnJHqxbGqa",201,0.990196,40,204,2,202,1,2,1,3,2,104,103,99,99,61
"5220",19,"[40]qIdHoIEDcBkDxcBJfgrvgAbKDaetmHwnJHqxbGqa",215,0.990826,40,218,2,216,1,2,1,3,2,120,119,97,97,61
"5221",20,"[40]qIdHoIEDcBkDxcBJfgrvgAbKDaetmHwnJHqxbGqa",201,0.990196,40,204,2,202,1,2,1,3,2,103,102,100,100,61
"5222",21,"[40]qIdHoIEDcBkDxcBJfgrvgAbKDaetmHwnJHqxbGqa",202,0.990244,40,205,2,203,1,2,1,3,2,104,103,100,100,61
"5223",22,"[40]qIdHoIEDcBkDxcBJfgrvgAbKDaetmHwnJHqxbGqa",206,0.990431,40,209,2,207,1,2,1,3,2,108,107,100,100,61
"5224",23,"[40]qIdHoIEDcBkDxcBJfgrvgAbKDaetmHwnJHqxbGqa",189,0.989583,40,192,2,190,1,2,1,3,2,87,86,104,104,61
"5225",24,"[40]qIdHoIEDcBkDxcBJfgrvgAbKDaetmHwnJHqxbGqa",202,0.990244,40,205,2,203,1,2,1,3,2,104,103,100,100,61
"5226",25,"[40]qIdHoIEDcBkDxcBJfgrvgAbKDaetmHwnJHqxbGqa",188,0.989529,40,191,2,189,1,2,1,3,2,86,85,104,104,61
"5227",26,"[40]qIdHoIEDcBkDxcBJfgrvgAbKDaetmHwnJHqxbGqa",198,0.99005,40,201,2,199,1,2,1,3,2,99,98,101,101,61
"5228",27,"[40]qIdHoIEDcBkDxcBJfgrvgAbKDaetmHwnJHqxbGqa",190,0.989637,40,193,2,191,1,2,1,3,2,89,88,103,103,61
"5229",28,"[40]qIdHoIEDcBkDxcBJfgrvgAbKDaetmHwnJHqxbGqa",187,0.989474,40,190,2,188,1,2,1,3,2,82,81,107,107,61
"5230",29,"[40]qIdHoIEDcBkDxcBJfgrvgAbKDaetmHwnJHqxbGqa",203,0.990291,40,206,2,204,1,2,1,3,2,104,103,101,101,61
"5231",30,"[40]qIdHoIEDcBkDxcBJfgrvgAbKDaetmHwnJHqxbGqa",206,0.990431,40,209,2,207,1,2,1,3,2,108,107,100,100,61
"5232",31,"[40]qIdHoIEDcBkDxcBJfgrvgAbKDaetmHwnJHqxbGqa",189,0.989583,40,192,2,190,1,2,1,3,2,86,85,105,105,61
"5233",32,"[40]qIdHoIEDcBkDxcBJfgrvgAbKDaetmHwnJHqxbGqa",201,0.990196,40,204,2,202,1,2,1,3,2,103,102,100,100,61
"5234",33,"[40]qIdHoIEDcBkDxcBJfgrvgAbKDaetmHwnJHqxbGqa",206,0.990431,40,209,2,207,1,2,1,3,2,107,106,101,101,61
"5235",34,"[40]qIdHoIEDcBkDxcBJfgrvgAbKDaetmHwnJHqxbGqa",202,0.990244,40,205,2,203,1,2,1,3,2,103,102,101,101,61
"5236",35,"[40]qIdHoIEDcBkDxcBJfgrvgAbKDaetmHwnJHqxbGqa",199,0.990099,40,202,2,200,1,2,1,3,2,98,97,103,103,61
"5237",36,"[40]qIdHoIEDcBkDxcBJfgrvgAbKDaetmHwnJHqxbGqa",199,0.990099,40,202,2,200,1,2,1,3,2,101,100,100,100,61
"5238",37,"[40]qIdHoIEDcBkDxcBJfgrvgAbKDaetmHwnJHqxbGqa",205,0.990385,40,208,2,206,1,2,1,3,2,108,107,99,99,61
"5239",38,"[40]qIdHoIEDcBkDxcBJfgrvgAbKDaetmHwnJHqxbGqa",198,0.99005,40,201,2,199,1,2,1,3,2,97,96,103,103,61
"5240",39,"[40]qIdHoIEDcBkDxcBJfgrvgAbKDaetmHwnJHqxbGqa",204,0.990338,40,207,2,205,1,2,1,3,2,106,105,100,100,61
"5241",40,"[40]qIdHoIEDcBkDxcBJfgrvgAbKDaetmHwnJHqxbGqa",191,0.989691,40,194,2,192,1,2,1,3,2,91,90,102,102,61
"5242",41,"[40]qIdHoIEDcBkDxcBJfgrvgAbKDaetmHwnJHqxbGqa",203,0.990291,40,206,2,204,1,2,1,3,2,104,103,101,101,61
"5243",42,"[40]qIdHoIEDcBkDxcBJfgrvgAbKDaetmHwnJHqxbGqa",194,0.989848,40,197,2,195,1,2,1,3,2,93,92,103,103,61
"5244",43,"[40]qIdHoIEDcBkDxcBJfgrvgAbKDaetmHwnJHqxbGqa",212,0.990698,40,215,2,213,1,2,1,3,2,117,116,97,97,61
"5245",44,"[40]qIdHoIEDcBkDxcBJfgrvgAbKDaetmHwnJHqxbGqa",193,0.989796,40,196,2,194,1,2,1,3,2,91,90,104,104,61
"5246",45,"[40]qIdHoIEDcBkDxcBJfgrvgAbKDaetmHwnJHqxbGqa",202,0.990244,40,205,2,203,1,2,1,3,2,103,102,101,101,61
"5247",46,"[40]qIdHoIEDcBkDxcBJfgrvgAbKDaetmHwnJHqxbGqa",195,0.989899,40,198,2,196,1,2,1,3,2,94,93,103,103,61
"5248",47,"[40]qIdHoIEDcBkDxcBJfgrvgAbKDaetmHwnJHqxbGqa",207,0.990476,40,210,2,208,1,2,1,3,2,108,107,101,101,61
"5249",48,"[40]qIdHoIEDcBkDxcBJfgrvgAbKDaetmHwnJHqxbGqa",213,0.990741,40,216,2,214,1,2,1,3,2,118,117,97,97,61
"5250",49,"[40]qIdHoIEDcBkDxcBJfgrvgAbKDaetmHwnJHqxbGqa",199,0.990099,40,202,2,200,1,2,1,3,2,97,96,104,104,61
"5251",50,"[40]qIdHoIEDcBkDxcBJfgrvgAbKDaetmHwnJHqxbGqa",205,0.990385,40,208,2,206,1,2,1,3,2,107,106,100,100,61
"5252",51,"[40]qIdHoIEDcBkDxcBJfgrvgAbKDaetmHwnJHqxbGqa",210,0.99061,40,213,2,211,1,2,1,3,2,114,113,98,98,61
"5253",52,"[40]qIdHoIEDcBkDxcBJfgrvgAbKDaetmHwnJHqxbGqa",197,0.99,40,200,2,198,1,2,1,3,2,97,96,102,102,61
"5254",53,"[40]qIdHoIEDcBkDxcBJfgrvgAbKDaetmHwnJHqxbGqa",192,0.989744,40,195,2,193,1,2,1,3,2,89,88,105,105,61
"5255",54,"[40]qIdHoIEDcBkDxcBJfgrvgAbKDaetmHwnJHqxbGqa",217,0.990909,40,220,2,218,1,2,1,3,2,123,122,96,96,61
"5256",55,"[40]qIdHoIEDcBkDxcBJfgrvgAbKDaetmHwnJHqxbGqa",212,0.990698,40,215,2,213,1,2,1,3,2,118,117,96,96,61
"5257",56,"[40]qIdHoIEDcBkDxcBJfgrvgAbKDaetmHwnJHqxbGqa",190,0.989637,40,193,2,191,1,2,1,3,2,87,86,105,105,61
"5258",57,"[40]qIdHoIEDcBkDxcBJfgrvgAbKDaetmHwnJHqxbGqa",200,0.990148,40,203,2,201,1,2,1,3,2,102,101,100,100,61
"5259",58,"[40]qIdHoIEDcBkDxcBJfgrvgAbKDaetmHwnJHqxbGqa",205,0.990385,40,208,2,206,1,2,1,3,2,106,105,101,101,61
"5260",59,"[40]qIdHoIEDcBkDxcBJfgrvgAbKDaetmHwnJHqxbGqa",208,0.990521,40,211,2,209,1,2,1,3,2,110,109,100,100,61
"5261",60,"[40]qIdHoIEDcBkDxcBJfgrvgAbKDaetmHwnJHqxbGqa",184,0.989305,40,187,2,185,1,2,1,3,2,78,77,108,108,61
"5262",61,"[40]qIdHoIEDcBkDxcBJfgrvgAbKDaetmHwnJHqxbGqa",223,0.99115,40,226,2,224,1,2,1,3,2,135,134,90,90,61
"5263",62,"[40]qIdHoIEDcBkDxcBJfgrvgAbKDaetmHwnJHqxbGqa",194,0.989848,40,197,2,195,1,2,1,3,2,93,92,103,103,61
"5264",63,"[40]qIdHoIEDcBkDxcBJfgrvgAbKDaetmHwnJHqxbGqa",192,0.989744,40,195,2,193,1,2,1,3,2,90,89,104,104,61
"5265",64,"[40]qIdHoIEDcBkDxcBJfgrvgAbKDaetmHwnJHqxbGqa",209,0.990566,40,212,2,210,1,2,1,3,2,114,113,97,97,61
"5266",65,"[40]qIdHoIEDcBkDxcBJfgrvgAbKDaetmHwnJHqxbGqa",209,0.990566,40,212,2,210,1,2,1,3,2,114,113,97,97,61
"5267",66,"[40]qIdHoIEDcBkDxcBJfgrvgAbKDaetmHwnJHqxbGqa",204,0.990338,40,207,2,205,1,2,1,3,2,106,105,100,100,61
"5268",67,"[40]qIdHoIEDcBkDxcBJfgrvgAbKDaetmHwnJHqxbGqa",210,0.99061,40,213,2,211,1,2,1,3,2,115,114,97,97,61
"5269",68,"[40]qIdHoIEDcBkDxcBJfgrvgAbKDaetmHwnJHqxbGqa",198,0.99005,40,201,2,199,1,2,1,3,2,96,95,104,104,61
"5270",69,"[40]qIdHoIEDcBkDxcBJfgrvgAbKDaetmHwnJHqxbGqa",195,0.989899,40,198,2,196,1,2,1,3,2,91,90,106,106,61
"5271",70,"[40]qIdHoIEDcBkDxcBJfgrvgAbKDaetmHwnJHqxbGqa",207,0.990476,40,210,2,208,1,2,1,3,2,109,108,100,100,61
"5272",71,"[40]qIdHoIEDcBkDxcBJfgrvgAbKDaetmHwnJHqxbGqa",202,0.990244,40,205,2,203,1,2,1,3,2,104,103,100,100,61
"5273",72,"[40]qIdHoIEDcBkDxcBJfgrvgAbKDaetmHwnJHqxbGqa",222,0.991111,40,225,2,223,1,2,1,3,2,132,131,92,92,61
"5274",73,"[40]qIdHoIEDcBkDxcBJfgrvgAbKDaetmHwnJHqxbGqa",202,0.990244,40,205,2,203,1,2,1,3,2,104,103,100,100,61
"5275",74,"[40]qIdHoIEDcBkDxcBJfgrvgAbKDaetmHwnJHqxbGqa",199,0.990099,40,202,2,200,1,2,1,3,2,97,96,104,104,61
"5276",75,"[40]qIdHoIEDcBkDxcBJfgrvgAbKDaetmHwnJHqxbGqa",198,0.99005,40,201,2,199,1,2,1,3,2,98,97,102,102,61
"5277",76,"[40]qIdHoIEDcBkDxcBJfgrvgAbKDaetmHwnJHqxbGqa",195,0.989899,40,198,2,196,1,2,1,3,2,94,93,103,103,61
"5278",77,"[40]qIdHoIEDcBkDxcBJfgrvgAbKDaetmHwnJHqxbGqa",201,0.990196,40,204,2,202,1,2,1,3,2,103,102,100,100,61
"5279",78,"[40]qIdHoIEDcBkDxcBJfgrvgAbKDaetmHwnJHqxbGqa",193,0.989796,40,196,2,194,1,2,1,3,2,92,91,103,103,61
"5280",79,"[40]qIdHoIEDcBkDxcBJfgrvgAbKDaetmHwnJHqxbGqa",209,0.990566,40,212,2,210,1,2,1,3,2,110,109,101,101,61
"5281",80,"[40]qIdHoIEDcBkDxcBJfgrvgAbKDaetmHwnJHqxbGqa",199,0.990099,40,202,2,200,1,2,1,3,2,101,100,100,100,61
"5282",81,"[40]qIdHoIEDcBkDxcBJfgrvgAbKDaetmHwnJHqxbGqa",200,0.990148,40,203,2,201,1,2,1,3,2,101,100,101,101,61
"5283",82,"[40]qIdHoIEDcBkDxcBJfgrvgAbKDaetmHwnJHqxbGqa",209,0.990566,40,212,2,210,1,2,1,3,2,112,111,99,99,61
"5284",83,"[40]qIdHoIEDcBkDxcBJfgrvgAbKDaetmHwnJHqxbGqa",204,0.990338,40,207,2,205,1,2,1,3,2,105,104,101,101,61
"5285",84,"[40]qIdHoIEDcBkDxcBJfgrvgAbKDaetmHwnJHqxbGqa",199,0.990099,40,202,2,200,1,2,1,3,2,96,95,105,105,61
"5286",85,"[40]qIdHoIEDcBkDxcBJfgrvgAbKDaetmHwnJHqxbGqa",203,0.990291,40,206,2,204,1,2,1,3,2,103,102,102,102,61
"5287",86,"[40]qIdHoIEDcBkDxcBJfgrvgAbKDaetmHwnJHqxbGqa",198,0.99005,40,201,2,199,1,2,1,3,2,101,100,99,99,61
"5288",87,"[40]qIdHoIEDcBkDxcBJfgrvgAbKDaetmHwnJHqxbGqa",190,0.989637,40,193,2,191,1,2,1,3,2,86,85,106,106,61
"5289",88,"[40]qIdHoIEDcBkDxcBJfgrvgAbKDaetmHwnJHqxbGqa",210,0.99061,40,213,2,211,1,2,1,3,2,116,115,96,96,61
"5290",89,"[40]qIdHoIEDcBkDxcBJfgrvgAbKDaetmHwnJHqxbGqa",189,0.989583,40,192,2,190,1,2,1,3,2,86,85,105,105,61
"5291",90,"[40]qIdHoIEDcBkDxcBJfgrvgAbKDaetmHwnJHqxbGqa",205,0.990385,40,208,2,206,1,2,1,3,2,109,108,98,98,61
"5292",91,"[40]qIdHoIEDcBkDxcBJfgrvgAbKDaetmHwnJHqxbGqa",207,0.990476,40,210,2,208,1,2,1,3,2,111,110,98,98,61
"5293",92,"[40]qIdHoIEDcBkDxcBJfgrvgAbKDaetmHwnJHqxbGqa",207,0.990476,40,210,2,208,1,2,1,3,2,110,109,99,99,61
"5294",93,"[40]qIdHoIEDcBkDxcBJfgrvgAbKDaetmHwnJHqxbGqa",200,0.990148,40,203,2,201,1,2,1,3,2,98,97,104,104,61
"5295",94,"[40]qIdHoIEDcBkDxcBJfgrvgAbKDaetmHwnJHqxbGqa",204,0.990338,40,207,2,205,1,2,1,3,2,107,106,99,99,61
"5296",95,"[40]qIdHoIEDcBkDxcBJfgrvgAbKDaetmHwnJHqxbGqa",213,0.990741,40,216,2,214,1,2,1,3,2,119,118,96,96,61
"5297",96,"[40]qIdHoIEDcBkDxcBJfgrvgAbKDaetmHwnJHqxbGqa",205,0.990385,40,208,2,206,1,2,1,3,2,108,107,99,99,61
"5298",97,"[40]qIdHoIEDcBkDxcBJfgrvgAbKDaetmHwnJHqxbGqa",190,0.989637,40,193,2,191,1,2,1,3,2,85,84,107,107,61
"5299",98,"[40]qIdHoIEDcBkDxcBJfgrvgAbKDaetmHwnJHqxbGqa",209,0.990566,40,212,2,210,1,2,1,3,2,114,113,97,97,61
"5300",99,"[40]qIdHoIEDcBkDxcBJfgrvgAbKDaetmHwnJHqxbGqa",196,0.98995,40,199,2,197,1,2,1,3,2,96,95,102,102,61
"5301",0,"[39]GIfHoItdEBlDEDtiGkJJIAfBzIbKHunJHqvbGqa",227,0.991304,39,230,2,228,1,2,1,3,2,129,128,100,100,62
"5302",1,"[39]GIfHoItdEBlDEDtiGkJJIAfBzIbKHunJHqvbGqa",222,0.991111,39,225,2,223,1,2,1,3,2,118,117,106,106,62
"5303",2,"[39]GIfHoItdEBlDEDtiGkJJIAfBzIbKHunJHqvbGqa",219,0.990991,39,222,2,220,1,2,1,3,2,112,111,109,109,62
"5304",3,"[39]GIfHoItdEBlDEDtiGkJJIAfBzIbKHunJHqvbGqa",245,0.991935,39,248,2,246,1,2,1,3,2,150,149,97,97,62
"5305",4,"[39]GIfHoItdEBlDEDtiGkJJIAfBzIbKHunJHqvbGqa",215,0.990826,39,218,2,216,1,2,1,3,2,107,106,110,110,62
"5306",5,"[39]GIfHoItdEBlDEDtiGkJJIAfBzIbKHunJHqvbGqa",214,0.990783,39,217,2,215,1,2,1,3,2,103,102,113,113,62
"5307",6,"[39]GIfHoItdEBlDEDtiGkJJIAfBzIbKHunJHqvbGqa",211,0.990654,39,214,2,212,1,2,1,3,2,101,100,112,112,62
"5308",7,"[39]GIfHoItdEBlDEDtiGkJJIAfBzIbKHunJHqvbGqa",204,0.990338,39,207,2,205,1,2,1,3,2,93,92,113,113,62
"5309",8,"[39]GIfHoItdEBlDEDtiGkJJIAfBzIbKHunJHqvbGqa",217,0.990909,39,220,2,218,1,2,1,3,2,110,109,109,109,62
"5310",9,"[39]GIfHoItdEBlDEDtiGkJJIAfBzIbKHunJHqvbGqa",212,0.990698,39,215,2,213,1,2,1,3,2,106,105,108,108,62
"5311",10,"[39]GIfHoItdEBlDEDtiGkJJIAfBzIbKHunJHqvbGqa",205,0.990385,39,208,2,206,1,2,1,3,2,92,91,115,115,62
"5312",11,"[39]GIfHoItdEBlDEDtiGkJJIAfBzIbKHunJHqvbGqa",211,0.990654,39,214,2,212,1,2,1,3,2,106,105,107,107,62
"5313",12,"[39]GIfHoItdEBlDEDtiGkJJIAfBzIbKHunJHqvbGqa",214,0.990783,39,217,2,215,1,2,1,3,2,103,102,113,113,62
"5314",13,"[39]GIfHoItdEBlDEDtiGkJJIAfBzIbKHunJHqvbGqa",220,0.991031,39,223,2,221,1,2,1,3,2,113,112,109,109,62
"5315",14,"[39]GIfHoItdEBlDEDtiGkJJIAfBzIbKHunJHqvbGqa",219,0.990991,39,222,2,220,1,2,1,3,2,112,111,109,109,62
"5316",15,"[39]GIfHoItdEBlDEDtiGkJJIAfBzIbKHunJHqvbGqa",218,0.99095,39,221,2,219,1,2,1,3,2,112,111,108,108,62
"5317",16,"[39]GIfHoItdEBlDEDtiGkJJIAfBzIbKHunJHqvbGqa",220,0.991031,39,223,2,221,1,2,1,3,2,115,114,107,107,62
"5318",17,"[39]GIfHoItdEBlDEDtiGkJJIAfBzIbKHunJHqvbGqa",209,0.990566,39,212,2,210,1,2,1,3,2,101,100,110,110,62
"5319",18,"[39]GIfHoItdEBlDEDtiGkJJIAfBzIbKHunJHqvbGqa",210,0.99061,39,213,2,211,1,2,1,3,2,101,100,111,111,62
"5320",19,"[39]GIfHoItdEBlDEDtiGkJJIAfBzIbKHunJHqvbGqa",225,0.991228,39,228,2,226,1,2,1,3,2,121,120,106,106,62
"5321",20,"[39]GIfHoItdEBlDEDtiGkJJIAfBzIbKHunJHqvbGqa",236,0.991632,39,239,2,237,1,2,1,3,2,138,137,100,100,62
"5322",21,"[39]GIfHoItdEBlDEDtiGkJJIAfBzIbKHunJHqvbGqa",201,0.990196,39,204,2,202,1,2,1,3,2,89,88,114,114,62
"5323",22,"[39]GIfHoItdEBlDEDtiGkJJIAfBzIbKHunJHqvbGqa",209,0.990566,39,212,2,210,1,2,1,3,2,99,98,112,112,62
"5324",23,"[39]GIfHoItdEBlDEDtiGkJJIAfBzIbKHunJHqvbGqa",219,0.990991,39,222,2,220,1,2,1,3,2,115,114,106,106,62
"5325",24,"[39]GIfHoItdEBlDEDtiGkJJIAfBzIbKHunJHqvbGqa",234,0.991561,39,237,2,235,1,2,1,3,2,136,135,100,100,62
"5326",25,"[39]GIfHoItdEBlDEDtiGkJJIAfBzIbKHunJHqvbGqa",211,0.990654,39,214,2,212,1,2,1,3,2,102,101,111,111,62
"5327",26,"[39]GIfHoItdEBlDEDtiGkJJIAfBzIbKHunJHqvbGqa",212,0.990698,39,215,2,213,1,2,1,3,2,102,101,112,112,62
"5328",27,"[39]GIfHoItdEBlDEDtiGkJJIAfBzIbKHunJHqvbGqa",219,0.990991,39,222,2,220,1,2,1,3,2,113,112,108,108,62
"5329",28,"[39]GIfHoItdEBlDEDtiGkJJIAfBzIbKHunJHqvbGqa",207,0.990476,39,210,2,208,1,2,1,3,2,97,96,112,112,62
"5330",29,"[39]GIfHoItdEBlDEDtiGkJJIAfBzIbKHunJHqvbGqa",223,0.99115,39,226,2,224,1,2,1,3,2,118,117,107,107,62
"5331",30,"[39]GIfHoItdEBlDEDtiGkJJIAfBzIbKHunJHqvbGqa",207,0.990476,39,210,2,208,1,2,1,3,2,98,97,111,111,62
"5332",31,"[39]GIfHoItdEBlDEDtiGkJJIAfBzIbKHunJHqvbGqa",224,0.991189,39,227,2,225,1,2,1,3,2,120,119,106,106,62
"5333",32,"[39]GIfHoItdEBlDEDtiGkJJIAfBzIbKHunJHqvbGqa",217,0.990909,39,220,2,218,1,2,1,3,2,111,110,108,108,62
"5334",33,"[39]GIfHoItdEBlDEDtiGkJJIAfBzIbKHunJHqvbGqa",223,0.99115,39,226,2,224,1,2,1,3,2,119,118,106,106,62
"5335",34,"[39]GIfHoItdEBlDEDtiGkJJIAfBzIbKHunJHqvbGqa",215,0.990826,39,218,2,216,1,2,1,3,2,108,107,109,109,62
"5336",35,"[39]GIfHoItdEBlDEDtiGkJJIAfBzIbKHunJHqvbGqa",215,0.990826,39,218,2,216,1,2,1,3,2,109,108,108,108,62
"5337",36,"[39]GIfHoItdEBlDEDtiGkJJIAfBzIbKHunJHqvbGqa",223,0.99115,39,226,2,224,1,2,1,3,2,121,120,104,104,62
"5338",37,"[39]GIfHoItdEBlDEDtiGkJJIAfBzIbKHunJHqvbGqa",224,0.991189,39,227,2,225,1,2,1,3,2,119,118,107,107,62
"5339",38,"[39]GIfHoItdEBlDEDtiGkJJIAfBzIbKHunJHqvbGqa",216,0.990868,39,219,2,217,1,2,1,3,2,112,111,106,106,62
"5340",39,"[39]GIfHoItdEBlDEDtiGkJJIAfBzIbKHunJHqvbGqa",211,0.990654,39,214,2,212,1,2,1,3,2,103,102,110,110,62
"5341",40,"[39]GIfHoItdEBlDEDtiGkJJIAfBzIbKHunJHqvbGqa",214,0.990783,39,217,2,215,1,2,1,3,2,110,109,106,106,62
"5342",41,"[39]GIfHoItdEBlDEDtiGkJJIAfBzIbKHunJHqvbGqa",221,0.991071,39,224,2,222,1,2,1,3,2,116,115,107,107,62
"5343",42,"[39]GIfHoItdEBlDEDtiGkJJIAfBzIbKHunJHqvbGqa",219,0.990991,39,222,2,220,1,2,1,3,2,115,114,106,106,62
"5344",43,"[39]GIfHoItdEBlDEDtiGkJJIAfBzIbKHunJHqvbGqa",228,0.991342,39,231,2,229,1,2,1,3,2,129,128,101,101,62
"5345",44,"[39]GIfHoItdEBlDEDtiGkJJIAfBzIbKHunJHqvbGqa",212,0.990698,39,215,2,213,1,2,1,3,2,104,103,110,110,62
"5346",45,"[39]GIfHoItdEBlDEDtiGkJJIAfBzIbKHunJHqvbGqa",205,0.990385,39,208,2,206,1,2,1,3,2,92,91,115,115,62
"5347",46,"[39]GIfHoItdEBlDEDtiGkJJIAfBzIbKHunJHqvbGqa",208,0.990521,39,211,2,209,1,2,1,3,2,99,98,111,111,62
"5348",47,"[39]GIfHoItdEBlDEDtiGkJJIAfBzIbKHunJHqvbGqa",214,0.990783,39,217,2,215,1,2,1,3,2,107,106,109,109,62
"5349",48,"[39]GIfHoItdEBlDEDtiGkJJIAfBzIbKHunJHqvbGqa",222,0.991111,39,225,2,223,1,2,1,3,2,118,117,106,106,62
"5350",49,"[39]GIfHoItdEBlDEDtiGkJJIAfBzIbKHunJHqvbGqa",224,0.991189,39,227,2,225,1,2,1,3,2,119,118,107,107,62
"5351",50,"[39]GIfHoItdEBlDEDtiGkJJIAfBzIbKHunJHqvbGqa",226,0.991266,39,229,2,227,1,2,1,3,2,123,122,105,105,62
"5352",51,"[39]GIfHoItdEBlDEDtiGkJJIAfBzIbKHunJHqvbGqa",218,0.99095,39,221,2,219,1,2,1,3,2,113,112,107,107,62
"5353",52,"[39]GIfHoItdEBlDEDtiGkJJIAfBzIbKHunJHqvbGqa",211,0.990654,39,214,2,212,1,2,1,3,2,102,101,111,111,62
"5354",53,"[39]GIfHoItdEBlDEDtiGkJJIAfBzIbKHunJHqvbGqa",206,0.990431,39,209,2,207,1,2,1,3,2,93,92,115,115,62
"5355",54,"[39]GIfHoItdEBlDEDtiGkJJIAfBzIbKHunJHqvbGqa",219,0.990991,39,222,2,220,1,2,1,3,2,111,110,110,110,62
"5356",55,"[39]GIfHoItdEBlDEDtiGkJJIAfBzIbKHunJHqvbGqa",223,0.99115,39,226,2,224,1,2,1,3,2,117,116,108,108,62
"5357",56,"[39]GIfHoItdEBlDEDtiGkJJIAfBzIbKHunJHqvbGqa",207,0.990476,39,210,2,208,1,2,1,3,2,95,94,114,114,62
"5358",57,"[39]GIfHoItdEBlDEDtiGkJJIAfBzIbKHunJHqvbGqa",211,0.990654,39,214,2,212,1,2,1,3,2,104,103,109,109,62
"5359",58,"[39]GIfHoItdEBlDEDtiGkJJIAfBzIbKHunJHqvbGqa",227,0.991304,39,230,2,228,1,2,1,3,2,127,126,102,102,62
"5360",59,"[39]GIfHoItdEBlDEDtiGkJJIAfBzIbKHunJHqvbGqa",215,0.990826,39,218,2,216,1,2,1,3,2,109,108,108,108,62
"5361",60,"[39]GIfHoItdEBlDEDtiGkJJIAfBzIbKHunJHqvbGqa",224,0.991189,39,227,2,225,1,2,1,3,2,120,119,106,106,62
"5362",61,"[39]GIfHoItdEBlDEDtiGkJJIAfBzIbKHunJHqvbGqa",210,0.99061,39,213,2,211,1,2,1,3,2,103,102,109,109,62
"5363",62,"[39]GIfHoItdEBlDEDtiGkJJIAfBzIbKHunJHqvbGqa",207,0.990476,39,210,2,208,1,2,1,3,2,96,95,113,113,62
"5364",63,"[39]GIfHoItdEBlDEDtiGkJJIAfBzIbKHunJHqvbGqa",212,0.990698,39,215,2,213,1,2,1,3,2,104,103,110,110,62
"5365",64,"[39]GIfHoItdEBlDEDtiGkJJIAfBzIbKHunJHqvbGqa",228,0.991342,39,231,2,229,1,2,1,3,2,126,125,104,104,62
"5366",65,"[39]GIfHoItdEBlDEDtiGkJJIAfBzIbKHunJHqvbGqa",222,0.991111,39,225,2,223,1,2,1,3,2,115,114,109,109,62
"5367",66,"[39]GIfHoItdEBlDEDtiGkJJIAfBzIbKHunJHqvbGqa",216,0.990868,39,219,2,217,1,2,1,3,2,111,110,107,107,62
"5368",67,"[39]GIfHoItdEBlDEDtiGkJJIAfBzIbKHunJHqvbGqa",229,0.991379,39,232,2,230,1,2,1,3,2,127,126,104,104,62
"5369",68,"[39]GIfHoItdEBlDEDtiGkJJIAfBzIbKHunJHqvbGqa",223,0.99115,39,226,2,224,1,2,1,3,2,119,118,106,106,62
"5370",69,"[39]GIfHoItdEBlDEDtiGkJJIAfBzIbKHunJHqvbGqa",226,0.991266,39,229,2,227,1,2,1,3,2,125,124,103,103,62
"5371",70,"[39]GIfHoItdEBlDEDtiGkJJIAfBzIbKHunJHqvbGqa",217,0.990909,39,220,2,218,1,2,1,3,2,108,107,111,111,62
"5372",71,"[39]GIfHoItdEBlDEDtiGkJJIAfBzIbKHunJHqvbGqa",220,0.991031,39,223,2,221,1,2,1,3,2,113,112,109,109,62
"5373",72,"[39]GIfHoItdEBlDEDtiGkJJIAfBzIbKHunJHqvbGqa",223,0.99115,39,226,2,224,1,2,1,3,2,118,117,107,107,62
"5374",73,"[39]GIfHoItdEBlDEDtiGkJJIAfBzIbKHunJHqvbGqa",218,0.99095,39,221,2,219,1,2,1,3,2,110,109,110,110,62
"5375",74,"[39]GIfHoItdEBlDEDtiGkJJIAfBzIbKHunJHqvbGqa",201,0.990196,39,204,2,202,1,2,1,3,2,87,86,116,116,62
"5376",75,"[39]GIfHoItdEBlDEDtiGkJJIAfBzIbKHunJHqvbGqa",226,0.991266,39,229,2,227,1,2,1,3,2,121,120,107,107,62
"5377",76,"[39]GIfHoItdEBlDEDtiGkJJIAfBzIbKHunJHqvbGqa",222,0.991111,39,225,2,223,1,2,1,3,2,114,113,110,110,62
"5378",77,"[39]GIfHoItdEBlDEDtiGkJJIAfBzIbKHunJHqvbGqa",216,0.990868,39,219,2,217,1,2,1,3,2,108,107,110,110,62
"5379",78,"[39]GIfHoItdEBlDEDtiGkJJIAfBzIbKHunJHqvbGqa",227,0.991304,39,230,2,228,1,2,1,3,2,122,121,107,107,62
"5380",79,"[39]GIfHoItdEBlDEDtiGkJJIAfBzIbKHunJHqvbGqa",225,0.991228,39,228,2,226,1,2,1,3,2,124,123,103,103,62
"5381",80,"[39]GIfHoItdEBlDEDtiGkJJIAfBzIbKHunJHqvbGqa",201,0.990196,39,204,2,202,1,2,1,3,2,89,88,114,114,62
"5382",81,"[39]GIfHoItdEBlDEDtiGkJJIAfBzIbKHunJHqvbGqa",214,0.990783,39,217,2,215,1,2,1,3,2,106,105,110,110,62
"5383",82,"[39]GIfHoItdEBlDEDtiGkJJIAfBzIbKHunJHqvbGqa",215,0.990826,39,218,2,216,1,2,1,3,2,111,110,106,106,62
"5384",83,"[39]GIfHoItdEBlDEDtiGkJJIAfBzIbKHunJHqvbGqa",220,0.991031,39,223,2,221,1,2,1,3,2,114,113,108,108,62
"5385",84,"[39]GIfHoItdEBlDEDtiGkJJIAfBzIbKHunJHqvbGqa",214,0.990783,39,217,2,215,1,2,1,3,2,108,107,108,108,62
"5386",85,"[39]GIfHoItdEBlDEDtiGkJJIAfBzIbKHunJHqvbGqa",210,0.99061,39,213,2,211,1,2,1,3,2,102,101,110,110,62
"5387",86,"[39]GIfHoItdEBlDEDtiGkJJIAfBzIbKHunJHqvbGqa",209,0.990566,39,212,2,210,1,2,1,3,2,101,100,110,110,62
"5388",87,"[39]GIfHoItdEBlDEDtiGkJJIAfBzIbKHunJHqvbGqa",219,0.990991,39,222,2,220,1,2,1,3,2,116,115,105,105,62
"5389",88,"[39]GIfHoItdEBlDEDtiGkJJIAfBzIbKHunJHqvbGqa",208,0.990521,39,211,2,209,1,2,1,3,2,95,94,115,115,62
"5390",89,"[39]GIfHoItdEBlDEDtiGkJJIAfBzIbKHunJHqvbGqa",215,0.990826,39,218,2,216,1,2,1,3,2,109,108,108,108,62
"5391",90,"[39]GIfHoItdEBlDEDtiGkJJIAfBzIbKHunJHqvbGqa",218,0.99095,39,221,2,219,1,2,1,3,2,116,115,104,104,62
"5392",91,"[39]GIfHoItdEBlDEDtiGkJJIAfBzIbKHunJHqvbGqa",212,0.990698,39,215,2,213,1,2,1,3,2,106,105,108,108,62
"5393",92,"[39]GIfHoItdEBlDEDtiGkJJIAfBzIbKHunJHqvbGqa",211,0.990654,39,214,2,212,1,2,1,3,2,103,102,110,110,62
"5394",93,"[39]GIfHoItdEBlDEDtiGkJJIAfBzIbKHunJHqvbGqa",223,0.99115,39,226,2,224,1,2,1,3,2,119,118,106,106,62
"5395",94,"[39]GIfHoItdEBlDEDtiGkJJIAfBzIbKHunJHqvbGqa",213,0.990741,39,216,2,214,1,2,1,3,2,106,105,109,109,62
"5396",95,"[39]GIfHoItdEBlDEDtiGkJJIAfBzIbKHunJHqvbGqa",206,0.990431,39,209,2,207,1,2,1,3,2,95,94,113,113,62
"5397",96,"[39]GIfHoItdEBlDEDtiGkJJIAfBzIbKHunJHqvbGqa",220,0.991031,39,223,2,221,1,2,1,3,2,110,109,112,112,62
"5398",97,"[39]GIfHoItdEBlDEDtiGkJJIAfBzIbKHunJHqvbGqa",229,0.991379,39,232,2,230,1,2,1,3,2,125,124,106,106,62
"5399",98,"[39]GIfHoItdEBlDEDtiGkJJIAfBzIbKHunJHqvbGqa",221,0.991071,39,224,2,222,1,2,1,3,2,115,114,108,108,62
"5400",99,"[39]GIfHoItdEBlDEDtiGkJJIAfBzIbKHunJHqvbGqa",229,0.991379,39,232,2,230,1,2,1,3,2,127,126,104,104,62
"5401",0,"[40]uIhHoIptuBkDptFhoCrEuebKDeetGHsnJHqwbGqa",203,0.990291,40,206,2,204,1,2,1,3,2,104,103,101,101,63
"5402",1,"[40]uIhHoIptuBkDptFhoCrEuebKDeetGHsnJHqwbGqa",205,0.990385,40,208,2,206,1,2,1,3,2,106,105,101,101,63
"5403",2,"[40]uIhHoIptuBkDptFhoCrEuebKDeetGHsnJHqwbGqa",208,0.990521,40,211,2,209,1,2,1,3,2,112,111,98,98,63
"5404",3,"[40]uIhHoIptuBkDptFhoCrEuebKDeetGHsnJHqwbGqa",200,0.990148,40,203,2,201,1,2,1,3,2,102,101,100,100,63
"5405",4,"[40]uIhHoIptuBkDptFhoCrEuebKDeetGHsnJHqwbGqa",214,0.990783,40,217,2,215,1,2,1,3,2,122,121,94,94,63
"5406",5,"[40]uIhHoIptuBkDptFhoCrEuebKDeetGHsnJHqwbGqa",211,0.990654,40,214,2,212,1,2,1,3,2,116,115,97,97,63
"5407",6,"[40]uIhHoIptuBkDptFhoCrEuebKDeetGHsnJHqwbGqa",207,0.990476,40,210,2,208,1,2,1,3,2,112,111,97,97,63
"5408",7,"[40]uIhHoIptuBkDptFhoCrEuebKDeetGHsnJHqwbGqa",214,0.990783,40,217,2,215,1,2,1,3,2,120,119,96,96,63
"5409",8,"[40]uIhHoIptuBkDptFhoCrEuebKDeetGHsnJHqwbGqa",198,0.99005,40,201,2,199,1,2,1,3,2,97,96,103,103,63
"5410",9,"[40]uIhHoIptuBkDptFhoCrEuebKDeetGHsnJHqwbGqa",187,0.989474,40,190,2,188,1,2,1,3,2,83,82,106,106,63
"5411",10,"[40]uIhHoIptuBkDptFhoCrEuebKDeetGHsnJHqwbGqa",210,0.99061,40,213,2,211,1,2,1,3,2,116,115,96,96,63
"5412",11,"[40]uIhHoIptuBkDptFhoCrEuebKDeetGHsnJHqwbGqa",197,0.99,40,200,2,198,1,2,1,3,2,98,97,101,101,63
"5413",12,"[40]uIhHoIptuBkDptFhoCrEuebKDeetGHsnJHqwbGqa",225,0.991228,40,228,2,226,1,2,1,3,2,137,136,90,90,63
"5414",13,"[40]uIhHoIptuBkDptFhoCrEuebKDeetGHsnJHqwbGqa",213,0.990741,40,216,2,214,1,2,1,3,2,120,119,95,95,63
"5415",14,"[40]uIhHoIptuBkDptFhoCrEuebKDeetGHsnJHqwbGqa",200,0.990148,40,203,2,201,1,2,1,3,2,100,99,102,102,63
"5416",15,"[40]uIhHoIptuBkDptFhoCrEuebKDeetGHsnJHqwbGqa",199,0.990099,40,202,2,200,1,2,1,3,2,100,99,101,101,63
"5417",16,"[40]uIhHoIptuBkDptFhoCrEuebKDeetGHsnJHqwbGqa",200,0.990148,40,203,2,201,1,2,1,3,2,101,100,101,101,63
"5418",17,"[40]uIhHoIptuBkDptFhoCrEuebKDeetGHsnJHqwbGqa",208,0.990521,40,211,2,209,1,2,1,3,2,112,111,98,98,63
"5419",18,"[40]uIhHoIptuBkDptFhoCrEuebKDeetGHsnJHqwbGqa",202,0.990244,40,205,2,203,1,2,1,3,2,103,102,101,101,63
"5420",19,"[40]uIhHoIptuBkDptFhoCrEuebKDeetGHsnJHqwbGqa",215,0.990826,40,218,2,216,1,2,1,3,2,121,120,96,96,63
"5421",20,"[40]uIhHoIptuBkDptFhoCrEuebKDeetGHsnJHqwbGqa",204,0.990338,40,207,2,205,1,2,1,3,2,108,107,98,98,63
"5422",21,"[40]uIhHoIptuBkDptFhoCrEuebKDeetGHsnJHqwbGqa",202,0.990244,40,205,2,203,1,2,1,3,2,103,102,101,101,63
"5423",22,"[40]uIhHoIptuBkDptFhoCrEuebKDeetGHsnJHqwbGqa",214,0.990783,40,217,2,215,1,2,1,3,2,119,118,97,97,63
"5424",23,"[40]uIhHoIptuBkDptFhoCrEuebKDeetGHsnJHqwbGqa",192,0.989744,40,195,2,193,1,2,1,3,2,90,89,104,104,63
"5425",24,"[40]uIhHoIptuBkDptFhoCrEuebKDeetGHsnJHqwbGqa",194,0.989848,40,197,2,195,1,2,1,3,2,97,96,99,99,63
"5426",25,"[40]uIhHoIptuBkDptFhoCrEuebKDeetGHsnJHqwbGqa",192,0.989744,40,195,2,193,1,2,1,3,2,89,88,105,105,63
"5427",26,"[40]uIhHoIptuBkDptFhoCrEuebKDeetGHsnJHqwbGqa",204,0.990338,40,207,2,205,1,2,1,3,2,105,104,101,101,63
"5428",27,"[40]uIhHoIptuBkDptFhoCrEuebKDeetGHsnJHqwbGqa",196,0.98995,40,199,2,197,1,2,1,3,2,95,94,103,103,63
"5429",28,"[40]uIhHoIptuBkDptFhoCrEuebKDeetGHsnJHqwbGqa",188,0.989529,40,191,2,189,1,2,1,3,2,84,83,106,106,63
"5430",29,"[40]uIhHoIptuBkDptFhoCrEuebKDeetGHsnJHqwbGqa",206,0.990431,40,209,2,207,1,2,1,3,2,108,107,100,100,63
"5431",30,"[40]uIhHoIptuBkDptFhoCrEuebKDeetGHsnJHqwbGqa",198,0.99005,40,201,2,199,1,2,1,3,2,95,94,105,105,63
"5432",31,"[40]uIhHoIptuBkDptFhoCrEuebKDeetGHsnJHqwbGqa",203,0.990291,40,206,2,204,1,2,1,3,2,105,104,100,100,63
"5433",32,"[40]uIhHoIptuBkDptFhoCrEuebKDeetGHsnJHqwbGqa",202,0.990244,40,205,2,203,1,2,1,3,2,102,101,102,102,63
"5434",33,"[40]uIhHoIptuBkDptFhoCrEuebKDeetGHsnJHqwbGqa",206,0.990431,40,209,2,207,1,2,1,3,2,111,110,97,97,63
"5435",34,"[40]uIhHoIptuBkDptFhoCrEuebKDeetGHsnJHqwbGqa",199,0.990099,40,202,2,200,1,2,1,3,2,99,98,102,102,63
"5436",35,"[40]uIhHoIptuBkDptFhoCrEuebKDeetGHsnJHqwbGqa",202,0.990244,40,205,2,203,1,2,1,3,2,105,104,99,99,63
"5437",36,"[40]uIhHoIptuBkDptFhoCrEuebKDeetGHsnJHqwbGqa",186,0.989418,40,189,2,187,1,2,1,3,2,82,81,106,106,63
"5438",37,"[40]uIhHoIptuBkDptFhoCrEuebKDeetGHsnJHqwbGqa",199,0.990099,40,202,2,200,1,2,1,3,2,98,97,103,103,63
"5439",38,"[40]uIhHoIptuBkDptFhoCrEuebKDeetGHsnJHqwbGqa",186,0.989418,40,189,2,187,1,2,1,3,2,80,79,108,108,63
"5440",39,"[40]uIhHoIptuBkDptFhoCrEuebKDeetGHsnJHqwbGqa",192,0.989744,40,195,2,193,1,2,1,3,2,90,89,104,104,63
"5441",40,"[40]uIhHoIptuBkDptFhoCrEuebKDeetGHsnJHqwbGqa",197,0.99,40,200,2,198,1,2,1,3,2,97,96,102,102,63
"5442",41,"[40]uIhHoIptuBkDptFhoCrEuebKDeetGHsnJHqwbGqa",209,0.990566,40,212,2,210,1,2,1,3,2,113,112,98,98,63
"5443",42,"[40]uIhHoIptuBkDptFhoCrEuebKDeetGHsnJHqwbGqa",191,0.989691,40,194,2,192,1,2,1,3,2,90,89,103,103,63
"5444",43,"[40]uIhHoIptuBkDptFhoCrEuebKDeetGHsnJHqwbGqa",212,0.990698,40,215,2,213,1,2,1,3,2,120,119,94,94,63
"5445",44,"[40]uIhHoIptuBkDptFhoCrEuebKDeetGHsnJHqwbGqa",202,0.990244,40,205,2,203,1,2,1,3,2,104,103,100,100,63
"5446",45,"[40]uIhHoIptuBkDptFhoCrEuebKDeetGHsnJHqwbGqa",211,0.990654,40,214,2,212,1,2,1,3,2,116,115,97,97,63
"5447",46,"[40]uIhHoIptuBkDptFhoCrEuebKDeetGHsnJHqwbGqa",193,0.989796,40,196,2,194,1,2,1,3,2,93,92,102,102,63
"5448",47,"[40]uIhHoIptuBkDptFhoCrEuebKDeetGHsnJHqwbGqa",216,0.990868,40,219,2,217,1,2,1,3,2,123,122,95,95,63
"5449",48,"[40]uIhHoIptuBkDptFhoCrEuebKDeetGHsnJHqwbGqa",218,0.99095,40,221,2,219,1,2,1,3,2,126,125,94,94,63
"5450",49,"[40]uIhHoIptuBkDptFhoCrEuebKDeetGHsnJHqwbGqa",194,0.989848,40,197,2,195,1,2,1,3,2,91,90,105,105,63
"5451",50,"[40]uIhHoIptuBkDptFhoCrEuebKDeetGHsnJHqwbGqa",195,0.989899,40,198,2,196,1,2,1,3,2,93,92,104,104,63
"5452",51,"[40]uIhHoIptuBkDptFhoCrEuebKDeetGHsnJHqwbGqa",213,0.990741,40,216,2,214,1,2,1,3,2,118,117,97,97,63
"5453",52,"[40]uIhHoIptuBkDptFhoCrEuebKDeetGHsnJHqwbGqa",218,0.99095,40,221,2,219,1,2,1,3,2,127,126,93,93,63
"5454",53,"[40]uIhHoIptuBkDptFhoCrEuebKDeetGHsnJHqwbGqa",197,0.99,40,200,2,198,1,2,1,3,2,95,94,104,104,63
"5455",54,"[40]uIhHoIptuBkDptFhoCrEuebKDeetGHsnJHqwbGqa",200,0.990148,40,203,2,201,1,2,1,3,2,101,100,101,101,63
"5456",55,"[40]uIhHoIptuBkDptFhoCrEuebKDeetGHsnJHqwbGqa",207,0.990476,40,210,2,208,1,2,1,3,2,110,109,99,99,63
"5457",56,"[40]uIhHoIptuBkDptFhoCrEuebKDeetGHsnJHqwbGqa",214,0.990783,40,217,2,215,1,2,1,3,2,123,122,93,93,63
"5458",57,"[40]uIhHoIptuBkDptFhoCrEuebKDeetGHsnJHqwbGqa",207,0.990476,40,210,2,208,1,2,1,3,2,109,108,100,100,63
"5459",58,"[40]uIhHoIptuBkDptFhoCrEuebKDeetGHsnJHqwbGqa",207,0.990476,40,210,2,208,1,2,1,3,2,106,105,103,103,63
"5460",59,"[40]uIhHoIptuBkDptFhoCrEuebKDeetGHsnJHqwbGqa",206,0.990431,40,209,2,207,1,2,1,3,2,107,106,101,101,63
"5461",60,"[40]uIhHoIptuBkDptFhoCrEuebKDeetGHsnJHqwbGqa",208,0.990521,40,211,2,209,1,2,1,3,2,111,110,99,99,63
"5462",61,"[40]uIhHoIptuBkDptFhoCrEuebKDeetGHsnJHqwbGqa",192,0.989744,40,195,2,193,1,2,1,3,2,91,90,103,103,63
"5463",62,"[40]uIhHoIptuBkDptFhoCrEuebKDeetGHsnJHqwbGqa",207,0.990476,40,210,2,208,1,2,1,3,2,109,108,100,100,63
"5464",63,"[40]uIhHoIptuBkDptFhoCrEuebKDeetGHsnJHqwbGqa",193,0.989796,40,196,2,194,1,2,1,3,2,91,90,104,104,63
"5465",64,"[40]uIhHoIptuBkDptFhoCrEuebKDeetGHsnJHqwbGqa",206,0.990431,40,209,2,207,1,2,1,3,2,107,106,101,101,63
"5466",65,"[40]uIhHoIptuBkDptFhoCrEuebKDeetGHsnJHqwbGqa",195,0.989899,40,198,2,196,1,2,1,3,2,96,95,101,101,63
"5467",66,"[40]uIhHoIptuBkDptFhoCrEuebKDeetGHsnJHqwbGqa",221,0.991071,40,224,2,222,1,2,1,3,2,130,129,93,93,63
"5468",67,"[40]uIhHoIptuBkDptFhoCrEuebKDeetGHsnJHqwbGqa",207,0.990476,40,210,2,208,1,2,1,3,2,111,110,98,98,63
"5469",68,"[40]uIhHoIptuBkDptFhoCrEuebKDeetGHsnJHqwbGqa",198,0.99005,40,201,2,199,1,2,1,3,2,99,98,101,101,63
"5470",69,"[40]uIhHoIptuBkDptFhoCrEuebKDeetGHsnJHqwbGqa",204,0.990338,40,207,2,205,1,2,1,3,2,107,106,99,99,63
"5471",70,"[40]uIhHoIptuBkDptFhoCrEuebKDeetGHsnJHqwbGqa",195,0.989899,40,198,2,196,1,2,1,3,2,96,95,101,101,63
"5472",71,"[40]uIhHoIptuBkDptFhoCrEuebKDeetGHsnJHqwbGqa",201,0.990196,40,204,2,202,1,2,1,3,2,102,101,101,101,63
"5473",72,"[40]uIhHoIptuBkDptFhoCrEuebKDeetGHsnJHqwbGqa",209,0.990566,40,212,2,210,1,2,1,3,2,111,110,100,100,63
"5474",73,"[40]uIhHoIptuBkDptFhoCrEuebKDeetGHsnJHqwbGqa",207,0.990476,40,210,2,208,1,2,1,3,2,112,111,97,97,63
"5475",74,"[40]uIhHoIptuBkDptFhoCrEuebKDeetGHsnJHqwbGqa",210,0.99061,40,213,2,211,1,2,1,3,2,113,112,99,99,63
"5476",75,"[40]uIhHoIptuBkDptFhoCrEuebKDeetGHsnJHqwbGqa",217,0.990909,40,220,2,218,1,2,1,3,2,124,123,95,95,63
"5477",76,"[40]uIhHoIptuBkDptFhoCrEuebKDeetGHsnJHqwbGqa",205,0.990385,40,208,2,206,1,2,1,3,2,106,105,101,101,63
"5478",77,"[40]uIhHoIptuBkDptFhoCrEuebKDeetGHsnJHqwbGqa",188,0.989529,40,191,2,189,1,2,1,3,2,84,83,106,106,63
"5479",78,"[40]uIhHoIptuBkDptFhoCrEuebKDeetGHsnJHqwbGqa",209,0.990566,40,212,2,210,1,2,1,3,2,114,113,97,97,63
"5480",79,"[40]uIhHoIptuBkDptFhoCrEuebKDeetGHsnJHqwbGqa",202,0.990244,40,205,2,203,1,2,1,3,2,104,103,100,100,63
"5481",80,"[40]uIhHoIptuBkDptFhoCrEuebKDeetGHsnJHqwbGqa",184,0.989305,40,187,2,185,1,2,1,3,2,81,80,105,105,63
"5482",81,"[40]uIhHoIptuBkDptFhoCrEuebKDeetGHsnJHqwbGqa",198,0.99005,40,201,2,199,1,2,1,3,2,96,95,104,104,63
"5483",82,"[40]uIhHoIptuBkDptFhoCrEuebKDeetGHsnJHqwbGqa",208,0.990521,40,211,2,209,1,2,1,3,2,114,113,96,96,63
"5484",83,"[40]uIhHoIptuBkDptFhoCrEuebKDeetGHsnJHqwbGqa",193,0.989796,40,196,2,194,1,2,1,3,2,91,90,104,104,63
"5485",84,"[40]uIhHoIptuBkDptFhoCrEuebKDeetGHsnJHqwbGqa",205,0.990385,40,208,2,206,1,2,1,3,2,107,106,100,100,63
"5486",85,"[40]uIhHoIptuBkDptFhoCrEuebKDeetGHsnJHqwbGqa",207,0.990476,40,210,2,208,1,2,1,3,2,110,109,99,99,63
"5487",86,"[40]uIhHoIptuBkDptFhoCrEuebKDeetGHsnJHqwbGqa",201,0.990196,40,204,2,202,1,2,1,3,2,99,98,104,104,63
"5488",87,"[40]uIhHoIptuBkDptFhoCrEuebKDeetGHsnJHqwbGqa",204,0.990338,40,207,2,205,1,2,1,3,2,105,104,101,101,63
"5489",88,"[40]uIhHoIptuBkDptFhoCrEuebKDeetGHsnJHqwbGqa",195,0.989899,40,198,2,196,1,2,1,3,2,95,94,102,102,63
"5490",89,"[40]uIhHoIptuBkDptFhoCrEuebKDeetGHsnJHqwbGqa",222,0.991111,40,225,2,223,1,2,1,3,2,132,131,92,92,63
"5491",90,"[40]uIhHoIptuBkDptFhoCrEuebKDeetGHsnJHqwbGqa",191,0.989691,40,194,2,192,1,2,1,3,2,86,85,107,107,63
"5492",91,"[40]uIhHoIptuBkDptFhoCrEuebKDeetGHsnJHqwbGqa",209,0.990566,40,212,2,210,1,2,1,3,2,112,111,99,99,63
"5493",92,"[40]uIhHoIptuBkDptFhoCrEuebKDeetGHsnJHqwbGqa",217,0.990909,40,220,2,218,1,2,1,3,2,124,123,95,95,63
"5494",93,"[40]uIhHoIptuBkDptFhoCrEuebKDeetGHsnJHqwbGqa",189,0.989583,40,192,2,190,1,2,1,3,2,85,84,106,106,63
"5495",94,"[40]uIhHoIptuBkDptFhoCrEuebKDeetGHsnJHqwbGqa",212,0.990698,40,215,2,213,1,2,1,3,2,117,116,97,97,63
"5496",95,"[40]uIhHoIptuBkDptFhoCrEuebKDeetGHsnJHqwbGqa",197,0.99,40,200,2,198,1,2,1,3,2,96,95,103,103,63
"5497",96,"[40]uIhHoIptuBkDptFhoCrEuebKDeetGHsnJHqwbGqa",200,0.990148,40,203,2,201,1,2,1,3,2,101,100,101,101,63
"5498",97,"[40]uIhHoIptuBkDptFhoCrEuebKDeetGHsnJHqwbGqa",200,0.990148,40,203,2,201,1,2,1,3,2,101,100,101,101,63
"5499",98,"[40]uIhHoIptuBkDptFhoCrEuebKDeetGHsnJHqwbGqa",200,0.990148,40,203,2,201,1,2,1,3,2,102,101,100,100,63
"5500",99,"[40]uIhHoIptuBkDptFhoCrEuebKDeetGHsnJHqwbGqa",210,0.99061,40,213,2,211,1,2,1,3,2,114,113,98,98,63
"5501",0,"[44]gIHoIvdBqCqrdzwEpGlFKurjqbtbKDedtHxnJHqvbGqa",205,0.990385,44,208,2,206,1,2,1,3,2,107,106,100,100,64
"5502",1,"[44]gIHoIvdBqCqrdzwEpGlFKurjqbtbKDedtHxnJHqvbGqa",199,0.990099,44,202,2,200,1,2,1,3,2,99,98,102,102,64
"5503",2,"[44]gIHoIvdBqCqrdzwEpGlFKurjqbtbKDedtHxnJHqvbGqa",184,0.989305,44,187,2,185,1,2,1,3,2,79,78,107,107,64
"5504",3,"[44]gIHoIvdBqCqrdzwEpGlFKurjqbtbKDedtHxnJHqvbGqa",206,0.990431,44,209,2,207,1,2,1,3,2,108,107,100,100,64
"5505",4,"[44]gIHoIvdBqCqrdzwEpGlFKurjqbtbKDedtHxnJHqvbGqa",212,0.990698,44,215,2,213,1,2,1,3,2,117,116,97,97,64
"5506",5,"[44]gIHoIvdBqCqrdzwEpGlFKurjqbtbKDedtHxnJHqvbGqa",191,0.989691,44,194,2,192,1,2,1,3,2,88,87,105,105,64
"5507",6,"[44]gIHoIvdBqCqrdzwEpGlFKurjqbtbKDedtHxnJHqvbGqa",223,0.99115,44,226,2,224,1,2,1,3,2,131,130,94,94,64
"5508",7,"[44]gIHoIvdBqCqrdzwEpGlFKurjqbtbKDedtHxnJHqvbGqa",207,0.990476,44,210,2,208,1,2,1,3,2,109,108,100,100,64
"5509",8,"[44]gIHoIvdBqCqrdzwEpGlFKurjqbtbKDedtHxnJHqvbGqa",181,0.98913,44,184,2,182,1,2,1,3,2,76,75,107,107,64
"5510",9,"[44]gIHoIvdBqCqrdzwEpGlFKurjqbtbKDedtHxnJHqvbGqa",194,0.989848,44,197,2,195,1,2,1,3,2,93,92,103,103,64
"5511",10,"[44]gIHoIvdBqCqrdzwEpGlFKurjqbtbKDedtHxnJHqvbGqa",191,0.989691,44,194,2,192,1,2,1,3,2,90,89,103,103,64
"5512",11,"[44]gIHoIvdBqCqrdzwEpGlFKurjqbtbKDedtHxnJHqvbGqa",194,0.989848,44,197,2,195,1,2,1,3,2,93,92,103,103,64
"5513",12,"[44]gIHoIvdBqCqrdzwEpGlFKurjqbtbKDedtHxnJHqvbGqa",200,0.990148,44,203,2,201,1,2,1,3,2,101,100,101,101,64
"5514",13,"[44]gIHoIvdBqCqrdzwEpGlFKurjqbtbKDedtHxnJHqvbGqa",203,0.990291,44,206,2,204,1,2,1,3,2,106,105,99,99,64
"5515",14,"[44]gIHoIvdBqCqrdzwEpGlFKurjqbtbKDedtHxnJHqvbGqa",198,0.99005,44,201,2,199,1,2,1,3,2,98,97,102,102,64
"5516",15,"[44]gIHoIvdBqCqrdzwEpGlFKurjqbtbKDedtHxnJHqvbGqa",200,0.990148,44,203,2,201,1,2,1,3,2,98,97,104,104,64
"5517",16,"[44]gIHoIvdBqCqrdzwEpGlFKurjqbtbKDedtHxnJHqvbGqa",203,0.990291,44,206,2,204,1,2,1,3,2,103,102,102,102,64
"5518",17,"[44]gIHoIvdBqCqrdzwEpGlFKurjqbtbKDedtHxnJHqvbGqa",206,0.990431,44,209,2,207,1,2,1,3,2,108,107,100,100,64
"5519",18,"[44]gIHoIvdBqCqrdzwEpGlFKurjqbtbKDedtHxnJHqvbGqa",210,0.99061,44,213,2,211,1,2,1,3,2,112,111,100,100,64
"5520",19,"[44]gIHoIvdBqCqrdzwEpGlFKurjqbtbKDedtHxnJHqvbGqa",191,0.989691,44,194,2,192,1,2,1,3,2,88,87,105,105,64
"5521",20,"[44]gIHoIvdBqCqrdzwEpGlFKurjqbtbKDedtHxnJHqvbGqa",202,0.990244,44,205,2,203,1,2,1,3,2,100,99,104,104,64
"5522",21,"[44]gIHoIvdBqCqrdzwEpGlFKurjqbtbKDedtHxnJHqvbGqa",212,0.990698,44,215,2,213,1,2,1,3,2,117,116,97,97,64
"5523",22,"[44]gIHoIvdBqCqrdzwEpGlFKurjqbtbKDedtHxnJHqvbGqa",201,0.990196,44,204,2,202,1,2,1,3,2,102,101,101,101,64
"5524",23,"[44]gIHoIvdBqCqrdzwEpGlFKurjqbtbKDedtHxnJHqvbGqa",221,0.991071,44,224,2,222,1,2,1,3,2,132,131,91,91,64
"5525",24,"[44]gIHoIvdBqCqrdzwEpGlFKurjqbtbKDedtHxnJHqvbGqa",192,0.989744,44,195,2,193,1,2,1,3,2,89,88,105,105,64
"5526",25,"[44]gIHoIvdBqCqrdzwEpGlFKurjqbtbKDedtHxnJHqvbGqa",186,0.989418,44,189,2,187,1,2,1,3,2,83,82,105,105,64
"5527",26,"[44]gIHoIvdBqCqrdzwEpGlFKurjqbtbKDedtHxnJHqvbGqa",189,0.989583,44,192,2,190,1,2,1,3,2,84,83,107,107,64
"5528",27,"[44]gIHoIvdBqCqrdzwEpGlFKurjqbtbKDedtHxnJHqvbGqa",194,0.989848,44,197,2,195,1,2,1,3,2,92,91,104,104,64
"5529",28,"[44]gIHoIvdBqCqrdzwEpGlFKurjqbtbKDedtHxnJHqvbGqa",213,0.990741,44,216,2,214,1,2,1,3,2,119,118,96,96,64
"5530",29,"[44]gIHoIvdBqCqrdzwEpGlFKurjqbtbKDedtHxnJHqvbGqa",217,0.990909,44,220,2,218,1,2,1,3,2,124,123,95,95,64
"5531",30,"[44]gIHoIvdBqCqrdzwEpGlFKurjqbtbKDedtHxnJHqvbGqa",200,0.990148,44,203,2,201,1,2,1,3,2,102,101,100,100,64
"5532",31,"[44]gIHoIvdBqCqrdzwEpGlFKurjqbtbKDedtHxnJHqvbGqa",207,0.990476,44,210,2,208,1,2,1,3,2,112,111,97,97,64
"5533",32,"[44]gIHoIvdBqCqrdzwEpGlFKurjqbtbKDedtHxnJHqvbGqa",208,0.990521,44,211,2,209,1,2,1,3,2,112,111,98,98,64
"5534",33,"[44]gIHoIvdBqCqrdzwEpGlFKurjqbtbKDedtHxnJHqvbGqa",197,0.99,44,200,2,198,1,2,1,3,2,97,96,102,102,64
"5535",34,"[44]gIHoIvdBqCqrdzwEpGlFKurjqbtbKDedtHxnJHqvbGqa",200,0.990148,44,203,2,201,1,2,1,3,2,98,97,104,104,64
"5536",35,"[44]gIHoIvdBqCqrdzwEpGlFKurjqbtbKDedtHxnJHqvbGqa",205,0.990385,44,208,2,206,1,2,1,3,2,107,106,100,100,64
"5537",36,"[44]gIHoIvdBqCqrdzwEpGlFKurjqbtbKDedtHxnJHqvbGqa",213,0.990741,44,216,2,214,1,2,1,3,2,118,117,97,97,64
"5538",37,"[44]gIHoIvdBqCqrdzwEpGlFKurjqbtbKDedtHxnJHqvbGqa",206,0.990431,44,209,2,207,1,2,1,3,2,109,108,99,99,64
"5539",38,"[44]gIHoIvdBqCqrdzwEpGlFKurjqbtbKDedtHxnJHqvbGqa",193,0.989796,44,196,2,194,1,2,1,3,2,90,89,105,105,64
"5540",39,"[44]gIHoIvdBqCqrdzwEpGlFKurjqbtbKDedtHxnJHqvbGqa",209,0.990566,44,212,2,210,1,2,1,3,2,112,111,99,99,64
"5541",40,"[44]gIHoIvdBqCqrdzwEpGlFKurjqbtbKDedtHxnJHqvbGqa",213,0.990741,44,216,2,214,1,2,1,3,2,117,116,98,98,64
"5542",41,"[44]gIHoIvdBqCqrdzwEpGlFKurjqbtbKDedtHxnJHqvbGqa",192,0.989744,44,195,2,193,1,2,1,3,2,91,90,103,103,64
"5543",42,"[44]gIHoIvdBqCqrdzwEpGlFKurjqbtbKDedtHxnJHqvbGqa",204,0.990338,44,207,2,205,1,2,1,3,2,106,105,100,100,64
"5544",43,"[44]gIHoIvdBqCqrdzwEpGlFKurjqbtbKDedtHxnJHqvbGqa",201,0.990196,44,204,2,202,1,2,1,3,2,104,103,99,99,64
"5545",44,"[44]gIHoIvdBqCqrdzwEpGlFKurjqbtbKDedtHxnJHqvbGqa",193,0.989796,44,196,2,194,1,2,1,3,2,91,90,104,104,64
"5546",45,"[44]gIHoIvdBqCqrdzwEpGlFKurjqbtbKDedtHxnJHqvbGqa",206,0.990431,44,209,2,207,1,2,1,3,2,107,106,101,101,64
"5547",46,"[44]gIHoIvdBqCqrdzwEpGlFKurjqbtbKDedtHxnJHqvbGqa",202,0.990244,44,205,2,203,1,2,1,3,2,106,105,98,98,64
"5548",47,"[44]gIHoIvdBqCqrdzwEpGlFKurjqbtbKDedtHxnJHqvbGqa",200,0.990148,44,203,2,201,1,2,1,3,2,99,98,103,103,64
"5549",48,"[44]gIHoIvdBqCqrdzwEpGlFKurjqbtbKDedtHxnJHqvbGqa",202,0.990244,44,205,2,203,1,2,1,3,2,102,101,102,102,64
"5550",49,"[44]gIHoIvdBqCqrdzwEpGlFKurjqbtbKDedtHxnJHqvbGqa",188,0.989529,44,191,2,189,1,2,1,3,2,85,84,105,105,64
"5551",50,"[44]gIHoIvdBqCqrdzwEpGlFKurjqbtbKDedtHxnJHqvbGqa",207,0.990476,44,210,2,208,1,2,1,3,2,109,108,100,100,64
"5552",51,"[44]gIHoIvdBqCqrdzwEpGlFKurjqbtbKDedtHxnJHqvbGqa",210,0.99061,44,213,2,211,1,2,1,3,2,115,114,97,97,64
"5553",52,"[44]gIHoIvdBqCqrdzwEpGlFKurjqbtbKDedtHxnJHqvbGqa",187,0.989474,44,190,2,188,1,2,1,3,2,83,82,106,106,64
"5554",53,"[44]gIHoIvdBqCqrdzwEpGlFKurjqbtbKDedtHxnJHqvbGqa",206,0.990431,44,209,2,207,1,2,1,3,2,107,106,101,101,64
"5555",54,"[44]gIHoIvdBqCqrdzwEpGlFKurjqbtbKDedtHxnJHqvbGqa",196,0.98995,44,199,2,197,1,2,1,3,2,92,91,106,106,64
"5556",55,"[44]gIHoIvdBqCqrdzwEpGlFKurjqbtbKDedtHxnJHqvbGqa",193,0.989796,44,196,2,194,1,2,1,3,2,91,90,104,104,64
"5557",56,"[44]gIHoIvdBqCqrdzwEpGlFKurjqbtbKDedtHxnJHqvbGqa",207,0.990476,44,210,2,208,1,2,1,3,2,113,112,96,96,64
"5558",57,"[44]gIHoIvdBqCqrdzwEpGlFKurjqbtbKDedtHxnJHqvbGqa",198,0.99005,44,201,2,199,1,2,1,3,2,98,97,102,102,64
"5559",58,"[44]gIHoIvdBqCqrdzwEpGlFKurjqbtbKDedtHxnJHqvbGqa",212,0.990698,44,215,2,213,1,2,1,3,2,117,116,97,97,64
"5560",59,"[44]gIHoIvdBqCqrdzwEpGlFKurjqbtbKDedtHxnJHqvbGqa",190,0.989637,44,193,2,191,1,2,1,3,2,85,84,107,107,64
"5561",60,"[44]gIHoIvdBqCqrdzwEpGlFKurjqbtbKDedtHxnJHqvbGqa",192,0.989744,44,195,2,193,1,2,1,3,2,87,86,107,107,64
"5562",61,"[44]gIHoIvdBqCqrdzwEpGlFKurjqbtbKDedtHxnJHqvbGqa",208,0.990521,44,211,2,209,1,2,1,3,2,110,109,100,100,64
"5563",62,"[44]gIHoIvdBqCqrdzwEpGlFKurjqbtbKDedtHxnJHqvbGqa",193,0.989796,44,196,2,194,1,2,1,3,2,91,90,104,104,64
"5564",63,"[44]gIHoIvdBqCqrdzwEpGlFKurjqbtbKDedtHxnJHqvbGqa",210,0.99061,44,213,2,211,1,2,1,3,2,115,114,97,97,64
"5565",64,"[44]gIHoIvdBqCqrdzwEpGlFKurjqbtbKDedtHxnJHqvbGqa",201,0.990196,44,204,2,202,1,2,1,3,2,102,101,101,101,64
"5566",65,"[44]gIHoIvdBqCqrdzwEpGlFKurjqbtbKDedtHxnJHqvbGqa",200,0.990148,44,203,2,201,1,2,1,3,2,100,99,102,102,64
"5567",66,"[44]gIHoIvdBqCqrdzwEpGlFKurjqbtbKDedtHxnJHqvbGqa",202,0.990244,44,205,2,203,1,2,1,3,2,102,101,102,102,64
"5568",67,"[44]gIHoIvdBqCqrdzwEpGlFKurjqbtbKDedtHxnJHqvbGqa",196,0.98995,44,199,2,197,1,2,1,3,2,94,93,104,104,64
"5569",68,"[44]gIHoIvdBqCqrdzwEpGlFKurjqbtbKDedtHxnJHqvbGqa",193,0.989796,44,196,2,194,1,2,1,3,2,88,87,107,107,64
"5570",69,"[44]gIHoIvdBqCqrdzwEpGlFKurjqbtbKDedtHxnJHqvbGqa",190,0.989637,44,193,2,191,1,2,1,3,2,89,88,103,103,64
"5571",70,"[44]gIHoIvdBqCqrdzwEpGlFKurjqbtbKDedtHxnJHqvbGqa",209,0.990566,44,212,2,210,1,2,1,3,2,111,110,100,100,64
"5572",71,"[44]gIHoIvdBqCqrdzwEpGlFKurjqbtbKDedtHxnJHqvbGqa",203,0.990291,44,206,2,204,1,2,1,3,2,103,102,102,102,64
"5573",72,"[44]gIHoIvdBqCqrdzwEpGlFKurjqbtbKDedtHxnJHqvbGqa",187,0.989474,44,190,2,188,1,2,1,3,2,83,82,106,106,64
"5574",73,"[44]gIHoIvdBqCqrdzwEpGlFKurjqbtbKDedtHxnJHqvbGqa",211,0.990654,44,214,2,212,1,2,1,3,2,116,115,97,97,64
"5575",74,"[44]gIHoIvdBqCqrdzwEpGlFKurjqbtbKDedtHxnJHqvbGqa",191,0.989691,44,194,2,192,1,2,1,3,2,88,87,105,105,64
"5576",75,"[44]gIHoIvdBqCqrdzwEpGlFKurjqbtbKDedtHxnJHqvbGqa",200,0.990148,44,203,2,201,1,2,1,3,2,98,97,104,104,64
"5577",76,"[44]gIHoIvdBqCqrdzwEpGlFKurjqbtbKDedtHxnJHqvbGqa",223,0.99115,44,226,2,224,1,2,1,3,2,131,130,94,94,64
"5578",77,"[44]gIHoIvdBqCqrdzwEpGlFKurjqbtbKDedtHxnJHqvbGqa",197,0.99,44,200,2,198,1,2,1,3,2,93,92,106,106,64
"5579",78,"[44]gIHoIvdBqCqrdzwEpGlFKurjqbtbKDedtHxnJHqvbGqa",197,0.99,44,200,2,198,1,2,1,3,2,96,95,103,103,64
"5580",79,"[44]gIHoIvdBqCqrdzwEpGlFKurjqbtbKDedtHxnJHqvbGqa",201,0.990196,44,204,2,202,1,2,1,3,2,100,99,103,103,64
"5581",80,"[44]gIHoIvdBqCqrdzwEpGlFKurjqbtbKDedtHxnJHqvbGqa",215,0.990826,44,218,2,216,1,2,1,3,2,120,119,97,97,64
"5582",81,"[44]gIHoIvdBqCqrdzwEpGlFKurjqbtbKDedtHxnJHqvbGqa",206,0.990431,44,209,2,207,1,2,1,3,2,106,105,102,102,64
"5583",82,"[44]gIHoIvdBqCqrdzwEpGlFKurjqbtbKDedtHxnJHqvbGqa",194,0.989848,44,197,2,195,1,2,1,3,2,91,90,105,105,64
"5584",83,"[44]gIHoIvdBqCqrdzwEpGlFKurjqbtbKDedtHxnJHqvbGqa",217,0.990909,44,220,2,218,1,2,1,3,2,123,122,96,96,64
"5585",84,"[44]gIHoIvdBqCqrdzwEpGlFKurjqbtbKDedtHxnJHqvbGqa",205,0.990385,44,208,2,206,1,2,1,3,2,107,106,100,100,64
"5586",85,"[44]gIHoIvdBqCqrdzwEpGlFKurjqbtbKDedtHxnJHqvbGqa",207,0.990476,44,210,2,208,1,2,1,3,2,110,109,99,99,64
"5587",86,"[44]gIHoIvdBqCqrdzwEpGlFKurjqbtbKDedtHxnJHqvbGqa",189,0.989583,44,192,2,190,1,2,1,3,2,86,85,105,105,64
"5588",87,"[44]gIHoIvdBqCqrdzwEpGlFKurjqbtbKDedtHxnJHqvbGqa",194,0.989848,44,197,2,195,1,2,1,3,2,93,92,103,103,64
"5589",88,"[44]gIHoIvdBqCqrdzwEpGlFKurjqbtbKDedtHxnJHqvbGqa",207,0.990476,44,210,2,208,1,2,1,3,2,108,107,101,101,64
"5590",89,"[44]gIHoIvdBqCqrdzwEpGlFKurjqbtbKDedtHxnJHqvbGqa",210,0.99061,44,213,2,211,1,2,1,3,2,112,111,100,100,64
"5591",90,"[44]gIHoIvdBqCqrdzwEpGlFKurjqbtbKDedtHxnJHqvbGqa",196,0.98995,44,199,2,197,1,2,1,3,2,95,94,103,103,64
"5592",91,"[44]gIHoIvdBqCqrdzwEpGlFKurjqbtbKDedtHxnJHqvbGqa",201,0.990196,44,204,2,202,1,2,1,3,2,100,99,103,103,64
"5593",92,"[44]gIHoIvdBqCqrdzwEpGlFKurjqbtbKDedtHxnJHqvbGqa",196,0.98995,44,199,2,197,1,2,1,3,2,95,94,103,103,64
"5594",93,"[44]gIHoIvdBqCqrdzwEpGlFKurjqbtbKDedtHxnJHqvbGqa",198,0.99005,44,201,2,199,1,2,1,3,2,98,97,102,102,64
"5595",94,"[44]gIHoIvdBqCqrdzwEpGlFKurjqbtbKDedtHxnJHqvbGqa",202,0.990244,44,205,2,203,1,2,1,3,2,102,101,102,102,64
"5596",95,"[44]gIHoIvdBqCqrdzwEpGlFKurjqbtbKDedtHxnJHqvbGqa",195,0.989899,44,198,2,196,1,2,1,3,2,93,92,104,104,64
"5597",96,"[44]gIHoIvdBqCqrdzwEpGlFKurjqbtbKDedtHxnJHqvbGqa",202,0.990244,44,205,2,203,1,2,1,3,2,104,103,100,100,64
"5598",97,"[44]gIHoIvdBqCqrdzwEpGlFKurjqbtbKDedtHxnJHqvbGqa",208,0.990521,44,211,2,209,1,2,1,3,2,112,111,98,98,64
"5599",98,"[44]gIHoIvdBqCqrdzwEpGlFKurjqbtbKDedtHxnJHqvbGqa",198,0.99005,44,201,2,199,1,2,1,3,2,97,96,103,103,64
"5600",99,"[44]gIHoIvdBqCqrdzwEpGlFKurjqbtbKDedtHxnJHqvbGqa",194,0.989848,44,197,2,195,1,2,1,3,2,93,92,103,103,64
"5601",0,"[40]xIHHoIpGvBkDsnFkvxovyBbKDaeppHvnJHqvbGqa",201,0.990196,40,204,2,202,1,2,1,3,2,102,101,101,101,67
"5602",1,"[40]xIHHoIpGvBkDsnFkvxovyBbKDaeppHvnJHqvbGqa",192,0.989744,40,195,2,193,1,2,1,3,2,92,91,102,102,67
"5603",2,"[40]xIHHoIpGvBkDsnFkvxovyBbKDaeppHvnJHqvbGqa",191,0.989691,40,194,2,192,1,2,1,3,2,88,87,105,105,67
"5604",3,"[40]xIHHoIpGvBkDsnFkvxovyBbKDaeppHvnJHqvbGqa",205,0.990385,40,208,2,206,1,2,1,3,2,108,107,99,99,67
"5605",4,"[40]xIHHoIpGvBkDsnFkvxovyBbKDaeppHvnJHqvbGqa",195,0.989899,40,198,2,196,1,2,1,3,2,92,91,105,105,67
"5606",5,"[40]xIHHoIpGvBkDsnFkvxovyBbKDaeppHvnJHqvbGqa",191,0.989691,40,194,2,192,1,2,1,3,2,88,87,105,105,67
"5607",6,"[40]xIHHoIpGvBkDsnFkvxovyBbKDaeppHvnJHqvbGqa",195,0.989899,40,198,2,196,1,2,1,3,2,93,92,104,104,67
"5608",7,"[40]xIHHoIpGvBkDsnFkvxovyBbKDaeppHvnJHqvbGqa",194,0.989848,40,197,2,195,1,2,1,3,2,93,92,103,103,67
"5609",8,"[40]xIHHoIpGvBkDsnFkvxovyBbKDaeppHvnJHqvbGqa",201,0.990196,40,204,2,202,1,2,1,3,2,101,100,102,102,67
"5610",9,"[40]xIHHoIpGvBkDsnFkvxovyBbKDaeppHvnJHqvbGqa",197,0.99,40,200,2,198,1,2,1,3,2,95,94,104,104,67
"5611",10,"[40]xIHHoIpGvBkDsnFkvxovyBbKDaeppHvnJHqvbGqa",196,0.98995,40,199,2,197,1,2,1,3,2,96,95,102,102,67
"5612",11,"[40]xIHHoIpGvBkDsnFkvxovyBbKDaeppHvnJHqvbGqa",214,0.990783,40,217,2,215,1,2,1,3,2,121,120,95,95,67
"5613",12,"[40]xIHHoIpGvBkDsnFkvxovyBbKDaeppHvnJHqvbGqa",194,0.989848,40,197,2,195,1,2,1,3,2,91,90,105,105,67
"5614",13,"[40]xIHHoIpGvBkDsnFkvxovyBbKDaeppHvnJHqvbGqa",205,0.990385,40,208,2,206,1,2,1,3,2,106,105,101,101,67
"5615",14,"[40]xIHHoIpGvBkDsnFkvxovyBbKDaeppHvnJHqvbGqa",204,0.990338,40,207,2,205,1,2,1,3,2,104,103,102,102,67
"5616",15,"[40]xIHHoIpGvBkDsnFkvxovyBbKDaeppHvnJHqvbGqa",202,0.990244,40,205,2,203,1,2,1,3,2,103,102,101,101,67
"5617",16,"[40]xIHHoIpGvBkDsnFkvxovyBbKDaeppHvnJHqvbGqa",199,0.990099,40,202,2,200,1,2,1,3,2,100,99,101,101,67
"5618",17,"[40]xIHHoIpGvBkDsnFkvxovyBbKDaeppHvnJHqvbGqa",203,0.990291,40,206,2,204,1,2,1,3,2,104,103,101,101,67
"5619",18,"[40]xIHHoIpGvBkDsnFkvxovyBbKDaeppHvnJHqvbGqa",198,0.99005,40,201,2,199,1,2,1,3,2,99,98,101,101,67
"5620",19,"[40]xIHHoIpGvBkDsnFkvxovyBbKDaeppHvnJHqvbGqa",207,0.990476,40,210,2,208,1,2,1,3,2,112,111,97,97,67
"5621",20,"[40]xIHHoIpGvBkDsnFkvxovyBbKDaeppHvnJHqvbGqa",207,0.990476,40,210,2,208,1,2,1,3,2,110,109,99,99,67
"5622",21,"[40]xIHHoIpGvBkDsnFkvxovyBbKDaeppHvnJHqvbGqa",195,0.989899,40,198,2,196,1,2,1,3,2,96,95,101,101,67
"5623",22,"[40]xIHHoIpGvBkDsnFkvxovyBbKDaeppHvnJHqvbGqa",215,0.990826,40,218,2,216,1,2,1,3,2,120,119,97,97,67
"5624",23,"[40]xIHHoIpGvBkDsnFkvxovyBbKDaeppHvnJHqvbGqa",205,0.990385,40,208,2,206,1,2,1,3,2,107,106,100,100,67
"5625",24,"[40]xIHHoIpGvBkDsnFkvxovyBbKDaeppHvnJHqvbGqa",204,0.990338,40,207,2,205,1,2,1,3,2,106,105,100,100,67
"5626",25,"[40]xIHHoIpGvBkDsnFkvxovyBbKDaeppHvnJHqvbGqa",203,0.990291,40,206,2,204,1,2,1,3,2,104,103,101,101,67
"5627",26,"[40]xIHHoIpGvBkDsnFkvxovyBbKDaeppHvnJHqvbGqa",191,0.989691,40,194,2,192,1,2,1,3,2,89,88,104,104,67
"5628",27,"[40]xIHHoIpGvBkDsnFkvxovyBbKDaeppHvnJHqvbGqa",203,0.990291,40,206,2,204,1,2,1,3,2,104,103,101,101,67
"5629",28,"[40]xIHHoIpGvBkDsnFkvxovyBbKDaeppHvnJHqvbGqa",208,0.990521,40,211,2,209,1,2,1,3,2,113,112,97,97,67
"5630",29,"[40]xIHHoIpGvBkDsnFkvxovyBbKDaeppHvnJHqvbGqa",197,0.99,40,200,2,198,1,2,1,3,2,97,96,102,102,67
"5631",30,"[40]xIHHoIpGvBkDsnFkvxovyBbKDaeppHvnJHqvbGqa",193,0.989796,40,196,2,194,1,2,1,3,2,93,92,102,102,67
"5632",31,"[40]xIHHoIpGvBkDsnFkvxovyBbKDaeppHvnJHqvbGqa",188,0.989529,40,191,2,189,1,2,1,3,2,85,84,105,105,67
"5633",32,"[40]xIHHoIpGvBkDsnFkvxovyBbKDaeppHvnJHqvbGqa",182,0.989189,40,185,2,183,1,2,1,3,2,74,73,110,110,67
"5634",33,"[40]xIHHoIpGvBkDsnFkvxovyBbKDaeppHvnJHqvbGqa",205,0.990385,40,208,2,206,1,2,1,3,2,106,105,101,101,67
"5635",34,"[40]xIHHoIpGvBkDsnFkvxovyBbKDaeppHvnJHqvbGqa",210,0.99061,40,213,2,211,1,2,1,3,2,115,114,97,97,67
"5636",35,"[40]xIHHoIpGvBkDsnFkvxovyBbKDaeppHvnJHqvbGqa",201,0.990196,40,204,2,202,1,2,1,3,2,102,101,101,101,67
"5637",36,"[40]xIHHoIpGvBkDsnFkvxovyBbKDaeppHvnJHqvbGqa",198,0.99005,40,201,2,199,1,2,1,3,2,100,99,100,100,67
"5638",37,"[40]xIHHoIpGvBkDsnFkvxovyBbKDaeppHvnJHqvbGqa",196,0.98995,40,199,2,197,1,2,1,3,2,97,96,101,101,67
"5639",38,"[40]xIHHoIpGvBkDsnFkvxovyBbKDaeppHvnJHqvbGqa",189,0.989583,40,192,2,190,1,2,1,3,2,86,85,105,105,67
"5640",39,"[40]xIHHoIpGvBkDsnFkvxovyBbKDaeppHvnJHqvbGqa",212,0.990698,40,215,2,213,1,2,1,3,2,113,112,101,101,67
"5641",40,"[40]xIHHoIpGvBkDsnFkvxovyBbKDaeppHvnJHqvbGqa",217,0.990909,40,220,2,218,1,2,1,3,2,124,123,95,95,67
"5642",41,"[40]xIHHoIpGvBkDsnFkvxovyBbKDaeppHvnJHqvbGqa",206,0.990431,40,209,2,207,1,2,1,3,2,110,109,98,98,67
"5643",42,"[40]xIHHoIpGvBkDsnFkvxovyBbKDaeppHvnJHqvbGqa",197,0.99,40,200,2,198,1,2,1,3,2,94,93,105,105,67
"5644",43,"[40]xIHHoIpGvBkDsnFkvxovyBbKDaeppHvnJHqvbGqa",212,0.990698,40,215,2,213,1,2,1,3,2,115,114,99,99,67
"5645",44,"[40]xIHHoIpGvBkDsnFkvxovyBbKDaeppHvnJHqvbGqa",200,0.990148,40,203,2,201,1,2,1,3,2,100,99,102,102,67
"5646",45,"[40]xIHHoIpGvBkDsnFkvxovyBbKDaeppHvnJHqvbGqa",206,0.990431,40,209,2,207,1,2,1,3,2,106,105,102,102,67
"5647",46,"[40]xIHHoIpGvBkDsnFkvxovyBbKDaeppHvnJHqvbGqa",200,0.990148,40,203,2,201,1,2,1,3,2,102,101,100,100,67
"5648",47,"[40]xIHHoIpGvBkDsnFkvxovyBbKDaeppHvnJHqvbGqa",208,0.990521,40,211,2,209,1,2,1,3,2,110,109,100,100,67
"5649",48,"[40]xIHHoIpGvBkDsnFkvxovyBbKDaeppHvnJHqvbGqa",200,0.990148,40,203,2,201,1,2,1,3,2,99,98,103,103,67
"5650",49,"[40]xIHHoIpGvBkDsnFkvxovyBbKDaeppHvnJHqvbGqa",204,0.990338,40,207,2,205,1,2,1,3,2,105,104,101,101,67
"5651",50,"[40]xIHHoIpGvBkDsnFkvxovyBbKDaeppHvnJHqvbGqa",218,0.99095,40,221,2,219,1,2,1,3,2,124,123,96,96,67
"5652",51,"[40]xIHHoIpGvBkDsnFkvxovyBbKDaeppHvnJHqvbGqa",196,0.98995,40,199,2,197,1,2,1,3,2,95,94,103,103,67
"5653",52,"[40]xIHHoIpGvBkDsnFkvxovyBbKDaeppHvnJHqvbGqa",196,0.98995,40,199,2,197,1,2,1,3,2,96,95,102,102,67
"5654",53,"[40]xIHHoIpGvBkDsnFkvxovyBbKDaeppHvnJHqvbGqa",191,0.989691,40,194,2,192,1,2,1,3,2,88,87,105,105,67
"5655",54,"[40]xIHHoIpGvBkDsnFkvxovyBbKDaeppHvnJHqvbGqa",199,0.990099,40,202,2,200,1,2,1,3,2,99,98,102,102,67
"5656",55,"[40]xIHHoIpGvBkDsnFkvxovyBbKDaeppHvnJHqvbGqa",197,0.99,40,200,2,198,1,2,1,3,2,95,94,104,104,67
"5657",56,"[40]xIHHoIpGvBkDsnFkvxovyBbKDaeppHvnJHqvbGqa",194,0.989848,40,197,2,195,1,2,1,3,2,92,91,104,104,67
"5658",57,"[40]xIHHoIpGvBkDsnFkvxovyBbKDaeppHvnJHqvbGqa",197,0.99,40,200,2,198,1,2,1,3,2,97,96,102,102,67
"5659",58,"[40]xIHHoIpGvBkDsnFkvxovyBbKDaeppHvnJHqvbGqa",203,0.990291,40,206,2,204,1,2,1,3,2,104,103,101,101,67
"5660",59,"[40]xIHHoIpGvBkDsnFkvxovyBbKDaeppHvnJHqvbGqa",196,0.98995,40,199,2,197,1,2,1,3,2,95,94,103,103,67
"5661",60,"[40]xIHHoIpGvBkDsnFkvxovyBbKDaeppHvnJHqvbGqa",205,0.990385,40,208,2,206,1,2,1,3,2,107,106,100,100,67
"5662",61,"[40]xIHHoIpGvBkDsnFkvxovyBbKDaeppHvnJHqvbGqa",191,0.989691,40,194,2,192,1,2,1,3,2,90,89,103,103,67
"5663",62,"[40]xIHHoIpGvBkDsnFkvxovyBbKDaeppHvnJHqvbGqa",198,0.99005,40,201,2,199,1,2,1,3,2,98,97,102,102,67
"5664",63,"[40]xIHHoIpGvBkDsnFkvxovyBbKDaeppHvnJHqvbGqa",198,0.99005,40,201,2,199,1,2,1,3,2,96,95,104,104,67
"5665",64,"[40]xIHHoIpGvBkDsnFkvxovyBbKDaeppHvnJHqvbGqa",201,0.990196,40,204,2,202,1,2,1,3,2,100,99,103,103,67
"5666",65,"[40]xIHHoIpGvBkDsnFkvxovyBbKDaeppHvnJHqvbGqa",209,0.990566,40,212,2,210,1,2,1,3,2,114,113,97,97,67
"5667",66,"[40]xIHHoIpGvBkDsnFkvxovyBbKDaeppHvnJHqvbGqa",207,0.990476,40,210,2,208,1,2,1,3,2,108,107,101,101,67
"5668",67,"[40]xIHHoIpGvBkDsnFkvxovyBbKDaeppHvnJHqvbGqa",208,0.990521,40,211,2,209,1,2,1,3,2,110,109,100,100,67
"5669",68,"[40]xIHHoIpGvBkDsnFkvxovyBbKDaeppHvnJHqvbGqa",197,0.99,40,200,2,198,1,2,1,3,2,95,94,104,104,67
"5670",69,"[40]xIHHoIpGvBkDsnFkvxovyBbKDaeppHvnJHqvbGqa",198,0.99005,40,201,2,199,1,2,1,3,2,98,97,102,102,67
"5671",70,"[40]xIHHoIpGvBkDsnFkvxovyBbKDaeppHvnJHqvbGqa",206,0.990431,40,209,2,207,1,2,1,3,2,106,105,102,102,67
"5672",71,"[40]xIHHoIpGvBkDsnFkvxovyBbKDaeppHvnJHqvbGqa",191,0.989691,40,194,2,192,1,2,1,3,2,87,86,106,106,67
"5673",72,"[40]xIHHoIpGvBkDsnFkvxovyBbKDaeppHvnJHqvbGqa",200,0.990148,40,203,2,201,1,2,1,3,2,101,100,101,101,67
"5674",73,"[40]xIHHoIpGvBkDsnFkvxovyBbKDaeppHvnJHqvbGqa",211,0.990654,40,214,2,212,1,2,1,3,2,120,119,93,93,67
"5675",74,"[40]xIHHoIpGvBkDsnFkvxovyBbKDaeppHvnJHqvbGqa",183,0.989247,40,186,2,184,1,2,1,3,2,78,77,107,107,67
"5676",75,"[40]xIHHoIpGvBkDsnFkvxovyBbKDaeppHvnJHqvbGqa",211,0.990654,40,214,2,212,1,2,1,3,2,115,114,98,98,67
"5677",76,"[40]xIHHoIpGvBkDsnFkvxovyBbKDaeppHvnJHqvbGqa",208,0.990521,40,211,2,209,1,2,1,3,2,114,113,96,96,67
"5678",77,"[40]xIHHoIpGvBkDsnFkvxovyBbKDaeppHvnJHqvbGqa",211,0.990654,40,214,2,212,1,2,1,3,2,115,114,98,98,67
"5679",78,"[40]xIHHoIpGvBkDsnFkvxovyBbKDaeppHvnJHqvbGqa",214,0.990783,40,217,2,215,1,2,1,3,2,119,118,97,97,67
"5680",79,"[40]xIHHoIpGvBkDsnFkvxovyBbKDaeppHvnJHqvbGqa",197,0.99,40,200,2,198,1,2,1,3,2,94,93,105,105,67
"5681",80,"[40]xIHHoIpGvBkDsnFkvxovyBbKDaeppHvnJHqvbGqa",198,0.99005,40,201,2,199,1,2,1,3,2,98,97,102,102,67
"5682",81,"[40]xIHHoIpGvBkDsnFkvxovyBbKDaeppHvnJHqvbGqa",196,0.98995,40,199,2,197,1,2,1,3,2,96,95,102,102,67
"5683",82,"[40]xIHHoIpGvBkDsnFkvxovyBbKDaeppHvnJHqvbGqa",209,0.990566,40,212,2,210,1,2,1,3,2,112,111,99,99,67
"5684",83,"[40]xIHHoIpGvBkDsnFkvxovyBbKDaeppHvnJHqvbGqa",190,0.989637,40,193,2,191,1,2,1,3,2,89,88,103,103,67
"5685",84,"[40]xIHHoIpGvBkDsnFkvxovyBbKDaeppHvnJHqvbGqa",200,0.990148,40,203,2,201,1,2,1,3,2,100,99,102,102,67
"5686",85,"[40]xIHHoIpGvBkDsnFkvxovyBbKDaeppHvnJHqvbGqa",224,0.991189,40,227,2,225,1,2,1,3,2,132,131,94,94,67
"5687",86,"[40]xIHHoIpGvBkDsnFkvxovyBbKDaeppHvnJHqvbGqa",217,0.990909,40,220,2,218,1,2,1,3,2,125,124,94,94,67
"5688",87,"[40]xIHHoIpGvBkDsnFkvxovyBbKDaeppHvnJHqvbGqa",218,0.99095,40,221,2,219,1,2,1,3,2,124,123,96,96,67
"5689",88,"[40]xIHHoIpGvBkDsnFkvxovyBbKDaeppHvnJHqvbGqa",210,0.99061,40,213,2,211,1,2,1,3,2,114,113,98,98,67
"5690",89,"[40]xIHHoIpGvBkDsnFkvxovyBbKDaeppHvnJHqvbGqa",198,0.99005,40,201,2,199,1,2,1,3,2,98,97,102,102,67
"5691",90,"[40]xIHHoIpGvBkDsnFkvxovyBbKDaeppHvnJHqvbGqa",216,0.990868,40,219,2,217,1,2,1,3,2,125,124,93,93,67
"5692",91,"[40]xIHHoIpGvBkDsnFkvxovyBbKDaeppHvnJHqvbGqa",206,0.990431,40,209,2,207,1,2,1,3,2,110,109,98,98,67
"5693",92,"[40]xIHHoIpGvBkDsnFkvxovyBbKDaeppHvnJHqvbGqa",202,0.990244,40,205,2,203,1,2,1,3,2,101,100,103,103,67
"5694",93,"[40]xIHHoIpGvBkDsnFkvxovyBbKDaeppHvnJHqvbGqa",201,0.990196,40,204,2,202,1,2,1,3,2,101,100,102,102,67
"5695",94,"[40]xIHHoIpGvBkDsnFkvxovyBbKDaeppHvnJHqvbGqa",220,0.991031,40,223,2,221,1,2,1,3,2,127,126,95,95,67
"5696",95,"[40]xIHHoIpGvBkDsnFkvxovyBbKDaeppHvnJHqvbGqa",216,0.990868,40,219,2,217,1,2,1,3,2,123,122,95,95,67
"5697",96,"[40]xIHHoIpGvBkDsnFkvxovyBbKDaeppHvnJHqvbGqa",204,0.990338,40,207,2,205,1,2,1,3,2,106,105,100,100,67
"5698",97,"[40]xIHHoIpGvBkDsnFkvxovyBbKDaeppHvnJHqvbGqa",191,0.989691,40,194,2,192,1,2,1,3,2,87,86,106,106,67
"5699",98,"[40]xIHHoIpGvBkDsnFkvxovyBbKDaeppHvnJHqvbGqa",193,0.989796,40,196,2,194,1,2,1,3,2,93,92,102,102,67
"5700",99,"[40]xIHHoIpGvBkDsnFkvxovyBbKDaeppHvnJHqvbGqa",206,0.990431,40,209,2,207,1,2,1,3,2,108,107,100,100,67
"5701",0,"[40]lIlHoInyBkDACockjmHEsFbKDaeyhHwnJHqvbGqa",191,0.989691,40,194,2,192,1,2,1,3,2,88,87,105,105,68
"5702",1,"[40]lIlHoInyBkDACockjmHEsFbKDaeyhHwnJHqvbGqa",190,0.989637,40,193,2,191,1,2,1,3,2,86,85,106,106,68
"5703",2,"[40]lIlHoInyBkDACockjmHEsFbKDaeyhHwnJHqvbGqa",192,0.989744,40,195,2,193,1,2,1,3,2,91,90,103,103,68
"5704",3,"[40]lIlHoInyBkDACockjmHEsFbKDaeyhHwnJHqvbGqa",207,0.990476,40,210,2,208,1,2,1,3,2,111,110,98,98,68
"5705",4,"[40]lIlHoInyBkDACockjmHEsFbKDaeyhHwnJHqvbGqa",208,0.990521,40,211,2,209,1,2,1,3,2,112,111,98,98,68
"5706",5,"[40]lIlHoInyBkDACockjmHEsFbKDaeyhHwnJHqvbGqa",206,0.990431,40,209,2,207,1,2,1,3,2,108,107,100,100,68
"5707",6,"[40]lIlHoInyBkDACockjmHEsFbKDaeyhHwnJHqvbGqa",204,0.990338,40,207,2,205,1,2,1,3,2,108,107,98,98,68
"5708",7,"[40]lIlHoInyBkDACockjmHEsFbKDaeyhHwnJHqvbGqa",200,0.990148,40,203,2,201,1,2,1,3,2,101,100,101,101,68
"5709",8,"[40]lIlHoInyBkDACockjmHEsFbKDaeyhHwnJHqvbGqa",214,0.990783,40,217,2,215,1,2,1,3,2,119,118,97,97,68
"5710",9,"[40]lIlHoInyBkDACockjmHEsFbKDaeyhHwnJHqvbGqa",196,0.98995,40,199,2,197,1,2,1,3,2,95,94,103,103,68
"5711",10,"[40]lIlHoInyBkDACockjmHEsFbKDaeyhHwnJHqvbGqa",207,0.990476,40,210,2,208,1,2,1,3,2,111,110,98,98,68
"5712",11,"[40]lIlHoInyBkDACockjmHEsFbKDaeyhHwnJHqvbGqa",188,0.989529,40,191,2,189,1,2,1,3,2,84,83,106,106,68
"5713",12,"[40]lIlHoInyBkDACockjmHEsFbKDaeyhHwnJHqvbGqa",200,0.990148,40,203,2,201,1,2,1,3,2,101,100,101,101,68
"5714",13,"[40]lIlHoInyBkDACockjmHEsFbKDaeyhHwnJHqvbGqa",209,0.990566,40,212,2,210,1,2,1,3,2,114,113,97,97,68
"5715",14,"[40]lIlHoInyBkDACockjmHEsFbKDaeyhHwnJHqvbGqa",191,0.989691,40,194,2,192,1,2,1,3,2,88,87,105,105,68
"5716",15,"[40]lIlHoInyBkDACockjmHEsFbKDaeyhHwnJHqvbGqa",208,0.990521,40,211,2,209,1,2,1,3,2,113,112,97,97,68
"5717",16,"[40]lIlHoInyBkDACockjmHEsFbKDaeyhHwnJHqvbGqa",203,0.990291,40,206,2,204,1,2,1,3,2,104,103,101,101,68
"5718",17,"[40]lIlHoInyBkDACockjmHEsFbKDaeyhHwnJHqvbGqa",197,0.99,40,200,2,198,1,2,1,3,2,95,94,104,104,68
"5719",18,"[40]lIlHoInyBkDACockjmHEsFbKDaeyhHwnJHqvbGqa",197,0.99,40,200,2,198,1,2,1,3,2,97,96,102,102,68
"5720",19,"[40]lIlHoInyBkDACockjmHEsFbKDaeyhHwnJHqvbGqa",196,0.98995,40,199,2,197,1,2,1,3,2,96,95,102,102,68
"5721",20,"[40]lIlHoInyBkDACockjmHEsFbKDaeyhHwnJHqvbGqa",204,0.990338,40,207,2,205,1,2,1,3,2,105,104,101,101,68
"5722",21,"[40]lIlHoInyBkDACockjmHEsFbKDaeyhHwnJHqvbGqa",199,0.990099,40,202,2,200,1,2,1,3,2,99,98,102,102,68
"5723",22,"[40]lIlHoInyBkDACockjmHEsFbKDaeyhHwnJHqvbGqa",200,0.990148,40,203,2,201,1,2,1,3,2,101,100,101,101,68
"5724",23,"[40]lIlHoInyBkDACockjmHEsFbKDaeyhHwnJHqvbGqa",213,0.990741,40,216,2,214,1,2,1,3,2,118,117,97,97,68
"5725",24,"[40]lIlHoInyBkDACockjmHEsFbKDaeyhHwnJHqvbGqa",199,0.990099,40,202,2,200,1,2,1,3,2,101,100,100,100,68
"5726",25,"[40]lIlHoInyBkDACockjmHEsFbKDaeyhHwnJHqvbGqa",200,0.990148,40,203,2,201,1,2,1,3,2,102,101,100,100,68
"5727",26,"[40]lIlHoInyBkDACockjmHEsFbKDaeyhHwnJHqvbGqa",205,0.990385,40,208,2,206,1,2,1,3,2,107,106,100,100,68
"5728",27,"[40]lIlHoInyBkDACockjmHEsFbKDaeyhHwnJHqvbGqa",208,0.990521,40,211,2,209,1,2,1,3,2,111,110,99,99,68
"5729",28,"[40]lIlHoInyBkDACockjmHEsFbKDaeyhHwnJHqvbGqa",208,0.990521,40,211,2,209,1,2,1,3,2,113,112,97,97,68
"5730",29,"[40]lIlHoInyBkDACockjmHEsFbKDaeyhHwnJHqvbGqa",200,0.990148,40,203,2,201,1,2,1,3,2,100,99,102,102,68
"5731",30,"[40]lIlHoInyBkDACockjmHEsFbKDaeyhHwnJHqvbGqa",201,0.990196,40,204,2,202,1,2,1,3,2,104,103,99,99,68
"5732",31,"[40]lIlHoInyBkDACockjmHEsFbKDaeyhHwnJHqvbGqa",203,0.990291,40,206,2,204,1,2,1,3,2,105,104,100,100,68
"5733",32,"[40]lIlHoInyBkDACockjmHEsFbKDaeyhHwnJHqvbGqa",198,0.99005,40,201,2,199,1,2,1,3,2,100,99,100,100,68
"5734",33,"[40]lIlHoInyBkDACockjmHEsFbKDaeyhHwnJHqvbGqa",207,0.990476,40,210,2,208,1,2,1,3,2,112,111,97,97,68
"5735",34,"[40]lIlHoInyBkDACockjmHEsFbKDaeyhHwnJHqvbGqa",197,0.99,40,200,2,198,1,2,1,3,2,98,97,101,101,68
"5736",35,"[40]lIlHoInyBkDACockjmHEsFbKDaeyhHwnJHqvbGqa",216,0.990868,40,219,2,217,1,2,1,3,2,122,121,96,96,68
"5737",36,"[40]lIlHoInyBkDACockjmHEsFbKDaeyhHwnJHqvbGqa",202,0.990244,40,205,2,203,1,2,1,3,2,104,103,100,100,68
"5738",37,"[40]lIlHoInyBkDACockjmHEsFbKDaeyhHwnJHqvbGqa",208,0.990521,40,211,2,209,1,2,1,3,2,112,111,98,98,68
"5739",38,"[40]lIlHoInyBkDACockjmHEsFbKDaeyhHwnJHqvbGqa",192,0.989744,40,195,2,193,1,2,1,3,2,92,91,102,102,68
"5740",39,"[40]lIlHoInyBkDACockjmHEsFbKDaeyhHwnJHqvbGqa",213,0.990741,40,216,2,214,1,2,1,3,2,115,114,100,100,68
"5741",40,"[40]lIlHoInyBkDACockjmHEsFbKDaeyhHwnJHqvbGqa",197,0.99,40,200,2,198,1,2,1,3,2,96,95,103,103,68
"5742",41,"[40]lIlHoInyBkDACockjmHEsFbKDaeyhHwnJHqvbGqa",190,0.989637,40,193,2,191,1,2,1,3,2,88,87,104,104,68
"5743",42,"[40]lIlHoInyBkDACockjmHEsFbKDaeyhHwnJHqvbGqa",202,0.990244,40,205,2,203,1,2,1,3,2,102,101,102,102,68
"5744",43,"[40]lIlHoInyBkDACockjmHEsFbKDaeyhHwnJHqvbGqa",211,0.990654,40,214,2,212,1,2,1,3,2,117,116,96,96,68
"5745",44,"[40]lIlHoInyBkDACockjmHEsFbKDaeyhHwnJHqvbGqa",204,0.990338,40,207,2,205,1,2,1,3,2,107,106,99,99,68
"5746",45,"[40]lIlHoInyBkDACockjmHEsFbKDaeyhHwnJHqvbGqa",216,0.990868,40,219,2,217,1,2,1,3,2,125,124,93,93,68
"5747",46,"[40]lIlHoInyBkDACockjmHEsFbKDaeyhHwnJHqvbGqa",193,0.989796,40,196,2,194,1,2,1,3,2,93,92,102,102,68
"5748",47,"[40]lIlHoInyBkDACockjmHEsFbKDaeyhHwnJHqvbGqa",203,0.990291,40,206,2,204,1,2,1,3,2,106,105,99,99,68
"5749",48,"[40]lIlHoInyBkDACockjmHEsFbKDaeyhHwnJHqvbGqa",185,0.989362,40,188,2,186,1,2,1,3,2,80,79,107,107,68
"5750",49,"[40]lIlHoInyBkDACockjmHEsFbKDaeyhHwnJHqvbGqa",210,0.99061,40,213,2,211,1,2,1,3,2,115,114,97,97,68
"5751",50,"[40]lIlHoInyBkDACockjmHEsFbKDaeyhHwnJHqvbGqa",200,0.990148,40,203,2,201,1,2,1,3,2,100,99,102,102,68
"5752",51,"[40]lIlHoInyBkDACockjmHEsFbKDaeyhHwnJHqvbGqa",193,0.989796,40,196,2,194,1,2,1,3,2,93,92,102,102,68
"5753",52,"[40]lIlHoInyBkDACockjmHEsFbKDaeyhHwnJHqvbGqa",204,0.990338,40,207,2,205,1,2,1,3,2,108,107,98,98,68
"5754",53,"[40]lIlHoInyBkDACockjmHEsFbKDaeyhHwnJHqvbGqa",194,0.989848,40,197,2,195,1,2,1,3,2,92,91,104,104,68
"5755",54,"[40]lIlHoInyBkDACockjmHEsFbKDaeyhHwnJHqvbGqa",195,0.989899,40,198,2,196,1,2,1,3,2,94,93,103,103,68
"5756",55,"[40]lIlHoInyBkDACockjmHEsFbKDaeyhHwnJHqvbGqa",201,0.990196,40,204,2,202,1,2,1,3,2,103,102,100,100,68
"5757",56,"[40]lIlHoInyBkDACockjmHEsFbKDaeyhHwnJHqvbGqa",213,0.990741,40,216,2,214,1,2,1,3,2,115,114,100,100,68
"5758",57,"[40]lIlHoInyBkDACockjmHEsFbKDaeyhHwnJHqvbGqa",198,0.99005,40,201,2,199,1,2,1,3,2,99,98,101,101,68
"5759",58,"[40]lIlHoInyBkDACockjmHEsFbKDaeyhHwnJHqvbGqa",196,0.98995,40,199,2,197,1,2,1,3,2,94,93,104,104,68
"5760",59,"[40]lIlHoInyBkDACockjmHEsFbKDaeyhHwnJHqvbGqa",204,0.990338,40,207,2,205,1,2,1,3,2,107,106,99,99,68
"5761",60,"[40]lIlHoInyBkDACockjmHEsFbKDaeyhHwnJHqvbGqa",200,0.990148,40,203,2,201,1,2,1,3,2,101,100,101,101,68
"5762",61,"[40]lIlHoInyBkDACockjmHEsFbKDaeyhHwnJHqvbGqa",212,0.990698,40,215,2,213,1,2,1,3,2,117,116,97,97,68
"5763",62,"[40]lIlHoInyBkDACockjmHEsFbKDaeyhHwnJHqvbGqa",205,0.990385,40,208,2,206,1,2,1,3,2,109,108,98,98,68
"5764",63,"[40]lIlHoInyBkDACockjmHEsFbKDaeyhHwnJHqvbGqa",205,0.990385,40,208,2,206,1,2,1,3,2,109,108,98,98,68
"5765",64,"[40]lIlHoInyBkDACockjmHEsFbKDaeyhHwnJHqvbGqa",208,0.990521,40,211,2,209,1,2,1,3,2,111,110,99,99,68
"5766",65,"[40]lIlHoInyBkDACockjmHEsFbKDaeyhHwnJHqvbGqa",213,0.990741,40,216,2,214,1,2,1,3,2,115,114,100,100,68
"5767",66,"[40]lIlHoInyBkDACockjmHEsFbKDaeyhHwnJHqvbGqa",192,0.989744,40,195,2,193,1,2,1,3,2,92,91,102,102,68
"5768",67,"[40]lIlHoInyBkDACockjmHEsFbKDaeyhHwnJHqvbGqa",194,0.989848,40,197,2,195,1,2,1,3,2,95,94,101,101,68
"5769",68,"[40]lIlHoInyBkDACockjmHEsFbKDaeyhHwnJHqvbGqa",200,0.990148,40,203,2,201,1,2,1,3,2,100,99,102,102,68
"5770",69,"[40]lIlHoInyBkDACockjmHEsFbKDaeyhHwnJHqvbGqa",212,0.990698,40,215,2,213,1,2,1,3,2,119,118,95,95,68
"5771",70,"[40]lIlHoInyBkDACockjmHEsFbKDaeyhHwnJHqvbGqa",197,0.99,40,200,2,198,1,2,1,3,2,97,96,102,102,68
"5772",71,"[40]lIlHoInyBkDACockjmHEsFbKDaeyhHwnJHqvbGqa",194,0.989848,40,197,2,195,1,2,1,3,2,92,91,104,104,68
"5773",72,"[40]lIlHoInyBkDACockjmHEsFbKDaeyhHwnJHqvbGqa",220,0.991031,40,223,2,221,1,2,1,3,2,131,130,91,91,68
"5774",73,"[40]lIlHoInyBkDACockjmHEsFbKDaeyhHwnJHqvbGqa",189,0.989583,40,192,2,190,1,2,1,3,2,86,85,105,105,68
"5775",74,"[40]lIlHoInyBkDACockjmHEsFbKDaeyhHwnJHqvbGqa",198,0.99005,40,201,2,199,1,2,1,3,2,95,94,105,105,68
"5776",75,"[40]lIlHoInyBkDACockjmHEsFbKDaeyhHwnJHqvbGqa",206,0.990431,40,209,2,207,1,2,1,3,2,110,109,98,98,68
"5777",76,"[40]lIlHoInyBkDACockjmHEsFbKDaeyhHwnJHqvbGqa",198,0.99005,40,201,2,199,1,2,1,3,2,98,97,102,102,68
"5778",77,"[40]lIlHoInyBkDACockjmHEsFbKDaeyhHwnJHqvbGqa",198,0.99005,40,201,2,199,1,2,1,3,2,98,97,102,102,68
"5779",78,"[40]lIlHoInyBkDACockjmHEsFbKDaeyhHwnJHqvbGqa",209,0.990566,40,212,2,210,1,2,1,3,2,114,113,97,97,68
"5780",79,"[40]lIlHoInyBkDACockjmHEsFbKDaeyhHwnJHqvbGqa",200,0.990148,40,203,2,201,1,2,1,3,2,102,101,100,100,68
"5781",80,"[40]lIlHoInyBkDACockjmHEsFbKDaeyhHwnJHqvbGqa",202,0.990244,40,205,2,203,1,2,1,3,2,105,104,99,99,68
"5782",81,"[40]lIlHoInyBkDACockjmHEsFbKDaeyhHwnJHqvbGqa",218,0.99095,40,221,2,219,1,2,1,3,2,125,124,95,95,68
"5783",82,"[40]lIlHoInyBkDACockjmHEsFbKDaeyhHwnJHqvbGqa",211,0.990654,40,214,2,212,1,2,1,3,2,119,118,94,94,68
"5784",83,"[40]lIlHoInyBkDACockjmHEsFbKDaeyhHwnJHqvbGqa",194,0.989848,40,197,2,195,1,2,1,3,2,93,92,103,103,68
"5785",84,"[40]lIlHoInyBkDACockjmHEsFbKDaeyhHwnJHqvbGqa",195,0.989899,40,198,2,196,1,2,1,3,2,95,94,102,102,68
"5786",85,"[40]lIlHoInyBkDACockjmHEsFbKDaeyhHwnJHqvbGqa",208,0.990521,40,211,2,209,1,2,1,3,2,111,110,99,99,68
"5787",86,"[40]lIlHoInyBkDACockjmHEsFbKDaeyhHwnJHqvbGqa",193,0.989796,40,196,2,194,1,2,1,3,2,92,91,103,103,68
"5788",87,"[40]lIlHoInyBkDACockjmHEsFbKDaeyhHwnJHqvbGqa",208,0.990521,40,211,2,209,1,2,1,3,2,112,111,98,98,68
"5789",88,"[40]lIlHoInyBkDACockjmHEsFbKDaeyhHwnJHqvbGqa",214,0.990783,40,217,2,215,1,2,1,3,2,121,120,95,95,68
"5790",89,"[40]lIlHoInyBkDACockjmHEsFbKDaeyhHwnJHqvbGqa",205,0.990385,40,208,2,206,1,2,1,3,2,106,105,101,101,68
"5791",90,"[40]lIlHoInyBkDACockjmHEsFbKDaeyhHwnJHqvbGqa",207,0.990476,40,210,2,208,1,2,1,3,2,112,111,97,97,68
"5792",91,"[40]lIlHoInyBkDACockjmHEsFbKDaeyhHwnJHqvbGqa",205,0.990385,40,208,2,206,1,2,1,3,2,107,106,100,100,68
"5793",92,"[40]lIlHoInyBkDACockjmHEsFbKDaeyhHwnJHqvbGqa",199,0.990099,40,202,2,200,1,2,1,3,2,101,100,100,100,68
"5794",93,"[40]lIlHoInyBkDACockjmHEsFbKDaeyhHwnJHqvbGqa",205,0.990385,40,208,2,206,1,2,1,3,2,106,105,101,101,68
"5795",94,"[40]lIlHoInyBkDACockjmHEsFbKDaeyhHwnJHqvbGqa",199,0.990099,40,202,2,200,1,2,1,3,2,101,100,100,100,68
"5796",95,"[40]lIlHoInyBkDACockjmHEsFbKDaeyhHwnJHqvbGqa",192,0.989744,40,195,2,193,1,2,1,3,2,90,89,104,104,68
"5797",96,"[40]lIlHoInyBkDACockjmHEsFbKDaeyhHwnJHqvbGqa",205,0.990385,40,208,2,206,1,2,1,3,2,106,105,101,101,68
"5798",97,"[40]lIlHoInyBkDACockjmHEsFbKDaeyhHwnJHqvbGqa",199,0.990099,40,202,2,200,1,2,1,3,2,98,97,103,103,68
"5799",98,"[40]lIlHoInyBkDACockjmHEsFbKDaeyhHwnJHqvbGqa",191,0.989691,40,194,2,192,1,2,1,3,2,91,90,102,102,68
"5800",99,"[40]lIlHoInyBkDACockjmHEsFbKDaeyhHwnJHqvbGqa",197,0.99,40,200,2,198,1,2,1,3,2,96,95,103,103,68
"5801",0,"[40]sIiHoIdxsBkDxyoFBIIrmobKDaeorHsnJHqvbGqa",211,0.990654,40,214,2,212,1,2,1,3,2,117,116,96,96,69
"5802",1,"[40]sIiHoIdxsBkDxyoFBIIrmobKDaeorHsnJHqvbGqa",198,0.99005,40,201,2,199,1,2,1,3,2,102,101,98,98,69
"5803",2,"[40]sIiHoIdxsBkDxyoFBIIrmobKDaeorHsnJHqvbGqa",198,0.99005,40,201,2,199,1,2,1,3,2,97,96,103,103,69
"5804",3,"[40]sIiHoIdxsBkDxyoFBIIrmobKDaeorHsnJHqvbGqa",214,0.990783,40,217,2,215,1,2,1,3,2,121,120,95,95,69
"5805",4,"[40]sIiHoIdxsBkDxyoFBIIrmobKDaeorHsnJHqvbGqa",183,0.989247,40,186,2,184,1,2,1,3,2,76,75,109,109,69
"5806",5,"[40]sIiHoIdxsBkDxyoFBIIrmobKDaeorHsnJHqvbGqa",201,0.990196,40,204,2,202,1,2,1,3,2,101,100,102,102,69
"5807",6,"[40]sIiHoIdxsBkDxyoFBIIrmobKDaeorHsnJHqvbGqa",202,0.990244,40,205,2,203,1,2,1,3,2,103,102,101,101,69
"5808",7,"[40]sIiHoIdxsBkDxyoFBIIrmobKDaeorHsnJHqvbGqa",207,0.990476,40,210,2,208,1,2,1,3,2,110,109,99,99,69
"5809",8,"[40]sIiHoIdxsBkDxyoFBIIrmobKDaeorHsnJHqvbGqa",214,0.990783,40,217,2,215,1,2,1,3,2,120,119,96,96,69
"5810",9,"[40]sIiHoIdxsBkDxyoFBIIrmobKDaeorHsnJHqvbGqa",195,0.989899,40,198,2,196,1,2,1,3,2,95,94,102,102,69
"5811",10,"[40]sIiHoIdxsBkDxyoFBIIrmobKDaeorHsnJHqvbGqa",210,0.99061,40,213,2,211,1,2,1,3,2,116,115,96,96,69
"5812",11,"[40]sIiHoIdxsBkDxyoFBIIrmobKDaeorHsnJHqvbGqa",209,0.990566,40,212,2,210,1,2,1,3,2,111,110,100,100,69
"5813",12,"[40]sIiHoIdxsBkDxyoFBIIrmobKDaeorHsnJHqvbGqa",196,0.98995,40,199,2,197,1,2,1,3,2,97,96,101,101,69
"5814",13,"[40]sIiHoIdxsBkDxyoFBIIrmobKDaeorHsnJHqvbGqa",219,0.990991,40,222,2,220,1,2,1,3,2,123,122,98,98,69
"5815",14,"[40]sIiHoIdxsBkDxyoFBIIrmobKDaeorHsnJHqvbGqa",191,0.989691,40,194,2,192,1,2,1,3,2,88,87,105,105,69
"5816",15,"[40]sIiHoIdxsBkDxyoFBIIrmobKDaeorHsnJHqvbGqa",201,0.990196,40,204,2,202,1,2,1,3,2,100,99,103,103,69
"5817",16,"[40]sIiHoIdxsBkDxyoFBIIrmobKDaeorHsnJHqvbGqa",211,0.990654,40,214,2,212,1,2,1,3,2,116,115,97,97,69
"5818",17,"[40]sIiHoIdxsBkDxyoFBIIrmobKDaeorHsnJHqvbGqa",199,0.990099,40,202,2,200,1,2,1,3,2,99,98,102,102,69
"5819",18,"[40]sIiHoIdxsBkDxyoFBIIrmobKDaeorHsnJHqvbGqa",206,0.990431,40,209,2,207,1,2,1,3,2,109,108,99,99,69
"5820",19,"[40]sIiHoIdxsBkDxyoFBIIrmobKDaeorHsnJHqvbGqa",207,0.990476,40,210,2,208,1,2,1,3,2,111,110,98,98,69
"5821",20,"[40]sIiHoIdxsBkDxyoFBIIrmobKDaeorHsnJHqvbGqa",209,0.990566,40,212,2,210,1,2,1,3,2,109,108,102,102,69
"5822",21,"[40]sIiHoIdxsBkDxyoFBIIrmobKDaeorHsnJHqvbGqa",197,0.99,40,200,2,198,1,2,1,3,2,97,96,102,102,69
"5823",22,"[40]sIiHoIdxsBkDxyoFBIIrmobKDaeorHsnJHqvbGqa",196,0.98995,40,199,2,197,1,2,1,3,2,96,95,102,102,69
"5824",23,"[40]sIiHoIdxsBkDxyoFBIIrmobKDaeorHsnJHqvbGqa",219,0.990991,40,222,2,220,1,2,1,3,2,126,125,95,95,69
"5825",24,"[40]sIiHoIdxsBkDxyoFBIIrmobKDaeorHsnJHqvbGqa",207,0.990476,40,210,2,208,1,2,1,3,2,112,111,97,97,69
"5826",25,"[40]sIiHoIdxsBkDxyoFBIIrmobKDaeorHsnJHqvbGqa",192,0.989744,40,195,2,193,1,2,1,3,2,90,89,104,104,69
"5827",26,"[40]sIiHoIdxsBkDxyoFBIIrmobKDaeorHsnJHqvbGqa",203,0.990291,40,206,2,204,1,2,1,3,2,102,101,103,103,69
"5828",27,"[40]sIiHoIdxsBkDxyoFBIIrmobKDaeorHsnJHqvbGqa",206,0.990431,40,209,2,207,1,2,1,3,2,107,106,101,101,69
"5829",28,"[40]sIiHoIdxsBkDxyoFBIIrmobKDaeorHsnJHqvbGqa",203,0.990291,40,206,2,204,1,2,1,3,2,105,104,100,100,69
"5830",29,"[40]sIiHoIdxsBkDxyoFBIIrmobKDaeorHsnJHqvbGqa",185,0.989362,40,188,2,186,1,2,1,3,2,81,80,106,106,69
"5831",30,"[40]sIiHoIdxsBkDxyoFBIIrmobKDaeorHsnJHqvbGqa",200,0.990148,40,203,2,201,1,2,1,3,2,102,101,100,100,69
"5832",31,"[40]sIiHoIdxsBkDxyoFBIIrmobKDaeorHsnJHqvbGqa",206,0.990431,40,209,2,207,1,2,1,3,2,109,108,99,99,69
"5833",32,"[40]sIiHoIdxsBkDxyoFBIIrmobKDaeorHsnJHqvbGqa",203,0.990291,40,206,2,204,1,2,1,3,2,103,102,102,102,69
"5834",33,"[40]sIiHoIdxsBkDxyoFBIIrmobKDaeorHsnJHqvbGqa",206,0.990431,40,209,2,207,1,2,1,3,2,111,110,97,97,69
"5835",34,"[40]sIiHoIdxsBkDxyoFBIIrmobKDaeorHsnJHqvbGqa",201,0.990196,40,204,2,202,1,2,1,3,2,105,104,98,98,69
"5836",35,"[40]sIiHoIdxsBkDxyoFBIIrmobKDaeorHsnJHqvbGqa",194,0.989848,40,197,2,195,1,2,1,3,2,92,91,104,104,69
"5837",36,"[40]sIiHoIdxsBkDxyoFBIIrmobKDaeorHsnJHqvbGqa",197,0.99,40,200,2,198,1,2,1,3,2,97,96,102,102,69
"5838",37,"[40]sIiHoIdxsBkDxyoFBIIrmobKDaeorHsnJHqvbGqa",185,0.989362,40,188,2,186,1,2,1,3,2,79,78,108,108,69
"5839",38,"[40]sIiHoIdxsBkDxyoFBIIrmobKDaeorHsnJHqvbGqa",206,0.990431,40,209,2,207,1,2,1,3,2,111,110,97,97,69
"5840",39,"[40]sIiHoIdxsBkDxyoFBIIrmobKDaeorHsnJHqvbGqa",199,0.990099,40,202,2,200,1,2,1,3,2,100,99,101,101,69
"5841",40,"[40]sIiHoIdxsBkDxyoFBIIrmobKDaeorHsnJHqvbGqa",197,0.99,40,200,2,198,1,2,1,3,2,96,95,103,103,69
"5842",41,"[40]sIiHoIdxsBkDxyoFBIIrmobKDaeorHsnJHqvbGqa",191,0.989691,40,194,2,192,1,2,1,3,2,90,89,103,103,69
"5843",42,"[40]sIiHoIdxsBkDxyoFBIIrmobKDaeorHsnJHqvbGqa",189,0.989583,40,192,2,190,1,2,1,3,2,87,86,104,104,69
"5844",43,"[40]sIiHoIdxsBkDxyoFBIIrmobKDaeorHsnJHqvbGqa",195,0.989899,40,198,2,196,1,2,1,3,2,92,91,105,105,69
"5845",44,"[40]sIiHoIdxsBkDxyoFBIIrmobKDaeorHsnJHqvbGqa",182,0.989189,40,185,2,183,1,2,1,3,2,76,75,108,108,69
"5846",45,"[40]sIiHoIdxsBkDxyoFBIIrmobKDaeorHsnJHqvbGqa",210,0.99061,40,213,2,211,1,2,1,3,2,116,115,96,96,69
"5847",46,"[40]sIiHoIdxsBkDxyoFBIIrmobKDaeorHsnJHqvbGqa",195,0.989899,40,198,2,196,1,2,1,3,2,97,96,100,100,69
"5848",47,"[40]sIiHoIdxsBkDxyoFBIIrmobKDaeorHsnJHqvbGqa",213,0.990741,40,216,2,214,1,2,1,3,2,119,118,96,96,69
"5849",48,"[40]sIiHoIdxsBkDxyoFBIIrmobKDaeorHsnJHqvbGqa",210,0.99061,40,213,2,211,1,2,1,3,2,116,115,96,96,69
"5850",49,"[40]sIiHoIdxsBkDxyoFBIIrmobKDaeorHsnJHqvbGqa",202,0.990244,40,205,2,203,1,2,1,3,2,104,103,100,100,69
"5851",50,"[40]sIiHoIdxsBkDxyoFBIIrmobKDaeorHsnJHqvbGqa",194,0.989848,40,197,2,195,1,2,1,3,2,92,91,104,104,69
"5852",51,"[40]sIiHoIdxsBkDxyoFBIIrmobKDaeorHsnJHqvbGqa",203,0.990291,40,206,2,204,1,2,1,3,2,104,103,101,101,69
"5853",52,"[40]sIiHoIdxsBkDxyoFBIIrmobKDaeorHsnJHqvbGqa",204,0.990338,40,207,2,205,1,2,1,3,2,106,105,100,100,69
"5854",53,"[40]sIiHoIdxsBkDxyoFBIIrmobKDaeorHsnJHqvbGqa",211,0.990654,40,214,2,212,1,2,1,3,2,116,115,97,97,69
"5855",54,"[40]sIiHoIdxsBkDxyoFBIIrmobKDaeorHsnJHqvbGqa",195,0.989899,40,198,2,196,1,2,1,3,2,95,94,102,102,69
"5856",55,"[40]sIiHoIdxsBkDxyoFBIIrmobKDaeorHsnJHqvbGqa",199,0.990099,40,202,2,200,1,2,1,3,2,100,99,101,101,69
"5857",56,"[40]sIiHoIdxsBkDxyoFBIIrmobKDaeorHsnJHqvbGqa",193,0.989796,40,196,2,194,1,2,1,3,2,90,89,105,105,69
"5858",57,"[40]sIiHoIdxsBkDxyoFBIIrmobKDaeorHsnJHqvbGqa",205,0.990385,40,208,2,206,1,2,1,3,2,107,106,100,100,69
"5859",58,"[40]sIiHoIdxsBkDxyoFBIIrmobKDaeorHsnJHqvbGqa",218,0.99095,40,221,2,219,1,2,1,3,2,123,122,97,97,69
"5860",59,"[40]sIiHoIdxsBkDxyoFBIIrmobKDaeorHsnJHqvbGqa",201,0.990196,40,204,2,202,1,2,1,3,2,102,101,101,101,69
"5861",60,"[40]sIiHoIdxsBkDxyoFBIIrmobKDaeorHsnJHqvbGqa",198,0.99005,40,201,2,199,1,2,1,3,2,100,99,100,100,69
"5862",61,"[40]sIiHoIdxsBkDxyoFBIIrmobKDaeorHsnJHqvbGqa",193,0.989796,40,196,2,194,1,2,1,3,2,90,89,105,105,69
"5863",62,"[40]sIiHoIdxsBkDxyoFBIIrmobKDaeorHsnJHqvbGqa",198,0.99005,40,201,2,199,1,2,1,3,2,99,98,101,101,69
"5864",63,"[40]sIiHoIdxsBkDxyoFBIIrmobKDaeorHsnJHqvbGqa",199,0.990099,40,202,2,200,1,2,1,3,2,98,97,103,103,69
"5865",64,"[40]sIiHoIdxsBkDxyoFBIIrmobKDaeorHsnJHqvbGqa",219,0.990991,40,222,2,220,1,2,1,3,2,130,129,91,91,69
"5866",65,"[40]sIiHoIdxsBkDxyoFBIIrmobKDaeorHsnJHqvbGqa",212,0.990698,40,215,2,213,1,2,1,3,2,118,117,96,96,69
"5867",66,"[40]sIiHoIdxsBkDxyoFBIIrmobKDaeorHsnJHqvbGqa",216,0.990868,40,219,2,217,1,2,1,3,2,121,120,97,97,69
"5868",67,"[40]sIiHoIdxsBkDxyoFBIIrmobKDaeorHsnJHqvbGqa",196,0.98995,40,199,2,197,1,2,1,3,2,95,94,103,103,69
"5869",68,"[40]sIiHoIdxsBkDxyoFBIIrmobKDaeorHsnJHqvbGqa",200,0.990148,40,203,2,201,1,2,1,3,2,102,101,100,100,69
"5870",69,"[40]sIiHoIdxsBkDxyoFBIIrmobKDaeorHsnJHqvbGqa",207,0.990476,40,210,2,208,1,2,1,3,2,111,110,98,98,69
"5871",70,"[40]sIiHoIdxsBkDxyoFBIIrmobKDaeorHsnJHqvbGqa",194,0.989848,40,197,2,195,1,2,1,3,2,93,92,103,103,69
"5872",71,"[40]sIiHoIdxsBkDxyoFBIIrmobKDaeorHsnJHqvbGqa",207,0.990476,40,210,2,208,1,2,1,3,2,110,109,99,99,69
"5873",72,"[40]sIiHoIdxsBkDxyoFBIIrmobKDaeorHsnJHqvbGqa",197,0.99,40,200,2,198,1,2,1,3,2,95,94,104,104,69
"5874",73,"[40]sIiHoIdxsBkDxyoFBIIrmobKDaeorHsnJHqvbGqa",208,0.990521,40,211,2,209,1,2,1,3,2,112,111,98,98,69
"5875",74,"[40]sIiHoIdxsBkDxyoFBIIrmobKDaeorHsnJHqvbGqa",200,0.990148,40,203,2,201,1,2,1,3,2,101,100,101,101,69
"5876",75,"[40]sIiHoIdxsBkDxyoFBIIrmobKDaeorHsnJHqvbGqa",185,0.989362,40,188,2,186,1,2,1,3,2,80,79,107,107,69
"5877",76,"[40]sIiHoIdxsBkDxyoFBIIrmobKDaeorHsnJHqvbGqa",195,0.989899,40,198,2,196,1,2,1,3,2,94,93,103,103,69
"5878",77,"[40]sIiHoIdxsBkDxyoFBIIrmobKDaeorHsnJHqvbGqa",199,0.990099,40,202,2,200,1,2,1,3,2,101,100,100,100,69
"5879",78,"[40]sIiHoIdxsBkDxyoFBIIrmobKDaeorHsnJHqvbGqa",212,0.990698,40,215,2,213,1,2,1,3,2,115,114,99,99,69
"5880",79,"[40]sIiHoIdxsBkDxyoFBIIrmobKDaeorHsnJHqvbGqa",196,0.98995,40,199,2,197,1,2,1,3,2,95,94,103,103,69
"5881",80,"[40]sIiHoIdxsBkDxyoFBIIrmobKDaeorHsnJHqvbGqa",202,0.990244,40,205,2,203,1,2,1,3,2,103,102,101,101,69
"5882",81,"[40]sIiHoIdxsBkDxyoFBIIrmobKDaeorHsnJHqvbGqa",200,0.990148,40,203,2,201,1,2,1,3,2,101,100,101,101,69
"5883",82,"[40]sIiHoIdxsBkDxyoFBIIrmobKDaeorHsnJHqvbGqa",193,0.989796,40,196,2,194,1,2,1,3,2,90,89,105,105,69
"5884",83,"[40]sIiHoIdxsBkDxyoFBIIrmobKDaeorHsnJHqvbGqa",211,0.990654,40,214,2,212,1,2,1,3,2,116,115,97,97,69
"5885",84,"[40]sIiHoIdxsBkDxyoFBIIrmobKDaeorHsnJHqvbGqa",195,0.989899,40,198,2,196,1,2,1,3,2,95,94,102,102,69
"5886",85,"[40]sIiHoIdxsBkDxyoFBIIrmobKDaeorHsnJHqvbGqa",204,0.990338,40,207,2,205,1,2,1,3,2,104,103,102,102,69
"5887",86,"[40]sIiHoIdxsBkDxyoFBIIrmobKDaeorHsnJHqvbGqa",203,0.990291,40,206,2,204,1,2,1,3,2,106,105,99,99,69
"5888",87,"[40]sIiHoIdxsBkDxyoFBIIrmobKDaeorHsnJHqvbGqa",203,0.990291,40,206,2,204,1,2,1,3,2,102,101,103,103,69
"5889",88,"[40]sIiHoIdxsBkDxyoFBIIrmobKDaeorHsnJHqvbGqa",193,0.989796,40,196,2,194,1,2,1,3,2,93,92,102,102,69
"5890",89,"[40]sIiHoIdxsBkDxyoFBIIrmobKDaeorHsnJHqvbGqa",193,0.989796,40,196,2,194,1,2,1,3,2,90,89,105,105,69
"5891",90,"[40]sIiHoIdxsBkDxyoFBIIrmobKDaeorHsnJHqvbGqa",210,0.99061,40,213,2,211,1,2,1,3,2,114,113,98,98,69
"5892",91,"[40]sIiHoIdxsBkDxyoFBIIrmobKDaeorHsnJHqvbGqa",212,0.990698,40,215,2,213,1,2,1,3,2,117,116,97,97,69
"5893",92,"[40]sIiHoIdxsBkDxyoFBIIrmobKDaeorHsnJHqvbGqa",194,0.989848,40,197,2,195,1,2,1,3,2,90,89,106,106,69
"5894",93,"[40]sIiHoIdxsBkDxyoFBIIrmobKDaeorHsnJHqvbGqa",208,0.990521,40,211,2,209,1,2,1,3,2,109,108,101,101,69
"5895",94,"[40]sIiHoIdxsBkDxyoFBIIrmobKDaeorHsnJHqvbGqa",199,0.990099,40,202,2,200,1,2,1,3,2,99,98,102,102,69
"5896",95,"[40]sIiHoIdxsBkDxyoFBIIrmobKDaeorHsnJHqvbGqa",196,0.98995,40,199,2,197,1,2,1,3,2,93,92,105,105,69
"5897",96,"[40]sIiHoIdxsBkDxyoFBIIrmobKDaeorHsnJHqvbGqa",203,0.990291,40,206,2,204,1,2,1,3,2,107,106,98,98,69
"5898",97,"[40]sIiHoIdxsBkDxyoFBIIrmobKDaeorHsnJHqvbGqa",194,0.989848,40,197,2,195,1,2,1,3,2,92,91,104,104,69
"5899",98,"[40]sIiHoIdxsBkDxyoFBIIrmobKDaeorHsnJHqvbGqa",213,0.990741,40,216,2,214,1,2,1,3,2,119,118,96,96,69
"5900",99,"[40]sIiHoIdxsBkDxyoFBIIrmobKDaeorHsnJHqvbGqa",194,0.989848,40,197,2,195,1,2,1,3,2,93,92,103,103,69
"5901",0,"[39]HImHoIjdEBlDEdbCwvJkBIewEdeKHwnJHqveGqa",214,0.990783,39,217,2,215,1,2,1,3,2,108,107,108,108,70
"5902",1,"[39]HImHoIjdEBlDEdbCwvJkBIewEdeKHwnJHqveGqa",212,0.990698,39,215,2,213,1,2,1,3,2,105,104,109,109,70
"5903",2,"[39]HImHoIjdEBlDEdbCwvJkBIewEdeKHwnJHqveGqa",231,0.991453,39,234,2,232,1,2,1,3,2,132,131,101,101,70
"5904",3,"[39]HImHoIjdEBlDEdbCwvJkBIewEdeKHwnJHqveGqa",217,0.990909,39,220,2,218,1,2,1,3,2,110,109,109,109,70
"5905",4,"[39]HImHoIjdEBlDEdbCwvJkBIewEdeKHwnJHqveGqa",220,0.991031,39,223,2,221,1,2,1,3,2,114,113,108,108,70
"5906",5,"[39]HImHoIjdEBlDEdbCwvJkBIewEdeKHwnJHqveGqa",224,0.991189,39,227,2,225,1,2,1,3,2,121,120,105,105,70
"5907",6,"[39]HImHoIjdEBlDEdbCwvJkBIewEdeKHwnJHqveGqa",227,0.991304,39,230,2,228,1,2,1,3,2,126,125,103,103,70
"5908",7,"[39]HImHoIjdEBlDEdbCwvJkBIewEdeKHwnJHqveGqa",214,0.990783,39,217,2,215,1,2,1,3,2,106,105,110,110,70
"5909",8,"[39]HImHoIjdEBlDEdbCwvJkBIewEdeKHwnJHqveGqa",218,0.99095,39,221,2,219,1,2,1,3,2,112,111,108,108,70
"5910",9,"[39]HImHoIjdEBlDEdbCwvJkBIewEdeKHwnJHqveGqa",225,0.991228,39,228,2,226,1,2,1,3,2,123,122,104,104,70
"5911",10,"[39]HImHoIjdEBlDEdbCwvJkBIewEdeKHwnJHqveGqa",213,0.990741,39,216,2,214,1,2,1,3,2,104,103,111,111,70
"5912",11,"[39]HImHoIjdEBlDEdbCwvJkBIewEdeKHwnJHqveGqa",210,0.99061,39,213,2,211,1,2,1,3,2,99,98,113,113,70
"5913",12,"[39]HImHoIjdEBlDEdbCwvJkBIewEdeKHwnJHqveGqa",221,0.991071,39,224,2,222,1,2,1,3,2,115,114,108,108,70
"5914",13,"[39]HImHoIjdEBlDEdbCwvJkBIewEdeKHwnJHqveGqa",223,0.99115,39,226,2,224,1,2,1,3,2,121,120,104,104,70
"5915",14,"[39]HImHoIjdEBlDEdbCwvJkBIewEdeKHwnJHqveGqa",228,0.991342,39,231,2,229,1,2,1,3,2,124,123,106,106,70
"5916",15,"[39]HImHoIjdEBlDEdbCwvJkBIewEdeKHwnJHqveGqa",226,0.991266,39,229,2,227,1,2,1,3,2,124,123,104,104,70
"5917",16,"[39]HImHoIjdEBlDEdbCwvJkBIewEdeKHwnJHqveGqa",231,0.991453,39,234,2,232,1,2,1,3,2,132,131,101,101,70
"5918",17,"[39]HImHoIjdEBlDEdbCwvJkBIewEdeKHwnJHqveGqa",209,0.990566,39,212,2,210,1,2,1,3,2,99,98,112,112,70
"5919",18,"[39]HImHoIjdEBlDEdbCwvJkBIewEdeKHwnJHqveGqa",215,0.990826,39,218,2,216,1,2,1,3,2,110,109,107,107,70
"5920",19,"[39]HImHoIjdEBlDEdbCwvJkBIewEdeKHwnJHqveGqa",213,0.990741,39,216,2,214,1,2,1,3,2,102,101,113,113,70
"5921",20,"[39]HImHoIjdEBlDEdbCwvJkBIewEdeKHwnJHqveGqa",218,0.99095,39,221,2,219,1,2,1,3,2,112,111,108,108,70
"5922",21,"[39]HImHoIjdEBlDEdbCwvJkBIewEdeKHwnJHqveGqa",212,0.990698,39,215,2,213,1,2,1,3,2,104,103,110,110,70
"5923",22,"[39]HImHoIjdEBlDEdbCwvJkBIewEdeKHwnJHqveGqa",196,0.98995,39,199,2,197,1,2,1,3,2,84,83,114,114,70
"5924",23,"[39]HImHoIjdEBlDEdbCwvJkBIewEdeKHwnJHqveGqa",194,0.989848,39,197,2,195,1,2,1,3,2,81,80,115,115,70
"5925",24,"[39]HImHoIjdEBlDEdbCwvJkBIewEdeKHwnJHqveGqa",211,0.990654,39,214,2,212,1,2,1,3,2,104,103,109,109,70
"5926",25,"[39]HImHoIjdEBlDEdbCwvJkBIewEdeKHwnJHqveGqa",211,0.990654,39,214,2,212,1,2,1,3,2,103,102,110,110,70
"5927",26,"[39]HImHoIjdEBlDEdbCwvJkBIewEdeKHwnJHqveGqa",224,0.991189,39,227,2,225,1,2,1,3,2,119,118,107,107,70
"5928",27,"[39]HImHoIjdEBlDEdbCwvJkBIewEdeKHwnJHqveGqa",215,0.990826,39,218,2,216,1,2,1,3,2,109,108,108,108,70
"5929",28,"[39]HImHoIjdEBlDEdbCwvJkBIewEdeKHwnJHqveGqa",223,0.99115,39,226,2,224,1,2,1,3,2,120,119,105,105,70
"5930",29,"[39]HImHoIjdEBlDEdbCwvJkBIewEdeKHwnJHqveGqa",222,0.991111,39,225,2,223,1,2,1,3,2,118,117,106,106,70
"5931",30,"[39]HImHoIjdEBlDEdbCwvJkBIewEdeKHwnJHqveGqa",229,0.991379,39,232,2,230,1,2,1,3,2,125,124,106,106,70
"5932",31,"[39]HImHoIjdEBlDEdbCwvJkBIewEdeKHwnJHqveGqa",206,0.990431,39,209,2,207,1,2,1,3,2,96,95,112,112,70
"5933",32,"[39]HImHoIjdEBlDEdbCwvJkBIewEdeKHwnJHqveGqa",217,0.990909,39,220,2,218,1,2,1,3,2,108,107,111,111,70
"5934",33,"[39]HImHoIjdEBlDEdbCwvJkBIewEdeKHwnJHqveGqa",213,0.990741,39,216,2,214,1,2,1,3,2,109,108,106,106,70
"5935",34,"[39]HImHoIjdEBlDEdbCwvJkBIewEdeKHwnJHqveGqa",203,0.990291,39,206,2,204,1,2,1,3,2,91,90,114,114,70
"5936",35,"[39]HImHoIjdEBlDEdbCwvJkBIewEdeKHwnJHqveGqa",218,0.99095,39,221,2,219,1,2,1,3,2,110,109,110,110,70
"5937",36,"[39]HImHoIjdEBlDEdbCwvJkBIewEdeKHwnJHqveGqa",216,0.990868,39,219,2,217,1,2,1,3,2,110,109,108,108,70
"5938",37,"[39]HImHoIjdEBlDEdbCwvJkBIewEdeKHwnJHqveGqa",222,0.991111,39,225,2,223,1,2,1,3,2,119,118,105,105,70
"5939",38,"[39]HImHoIjdEBlDEdbCwvJkBIewEdeKHwnJHqveGqa",220,0.991031,39,223,2,221,1,2,1,3,2,117,116,105,105,70
"5940",39,"[39]HImHoIjdEBlDEdbCwvJkBIewEdeKHwnJHqveGqa",215,0.990826,39,218,2,216,1,2,1,3,2,107,106,110,110,70
"5941",40,"[39]HImHoIjdEBlDEdbCwvJkBIewEdeKHwnJHqveGqa",203,0.990291,39,206,2,204,1,2,1,3,2,91,90,114,114,70
"5942",41,"[39]HImHoIjdEBlDEdbCwvJkBIewEdeKHwnJHqveGqa",212,0.990698,39,215,2,213,1,2,1,3,2,105,104,109,109,70
"5943",42,"[39]HImHoIjdEBlDEdbCwvJkBIewEdeKHwnJHqveGqa",217,0.990909,39,220,2,218,1,2,1,3,2,108,107,111,111,70
"5944",43,"[39]HImHoIjdEBlDEdbCwvJkBIewEdeKHwnJHqveGqa",221,0.991071,39,224,2,222,1,2,1,3,2,117,116,106,106,70
"5945",44,"[39]HImHoIjdEBlDEdbCwvJkBIewEdeKHwnJHqveGqa",221,0.991071,39,224,2,222,1,2,1,3,2,119,118,104,104,70
"5946",45,"[39]HImHoIjdEBlDEdbCwvJkBIewEdeKHwnJHqveGqa",223,0.99115,39,226,2,224,1,2,1,3,2,120,119,105,105,70
"5947",46,"[39]HImHoIjdEBlDEdbCwvJkBIewEdeKHwnJHqveGqa",225,0.991228,39,228,2,226,1,2,1,3,2,121,120,106,106,70
"5948",47,"[39]HImHoIjdEBlDEdbCwvJkBIewEdeKHwnJHqveGqa",200,0.990148,39,203,2,201,1,2,1,3,2,87,86,115,115,70
"5949",48,"[39]HImHoIjdEBlDEdbCwvJkBIewEdeKHwnJHqveGqa",212,0.990698,39,215,2,213,1,2,1,3,2,105,104,109,109,70
"5950",49,"[39]HImHoIjdEBlDEdbCwvJkBIewEdeKHwnJHqveGqa",214,0.990783,39,217,2,215,1,2,1,3,2,108,107,108,108,70
"5951",50,"[39]HImHoIjdEBlDEdbCwvJkBIewEdeKHwnJHqveGqa",213,0.990741,39,216,2,214,1,2,1,3,2,104,103,111,111,70
"5952",51,"[39]HImHoIjdEBlDEdbCwvJkBIewEdeKHwnJHqveGqa",207,0.990476,39,210,2,208,1,2,1,3,2,94,93,115,115,70
"5953",52,"[39]HImHoIjdEBlDEdbCwvJkBIewEdeKHwnJHqveGqa",204,0.990338,39,207,2,205,1,2,1,3,2,93,92,113,113,70
"5954",53,"[39]HImHoIjdEBlDEdbCwvJkBIewEdeKHwnJHqveGqa",224,0.991189,39,227,2,225,1,2,1,3,2,118,117,108,108,70
"5955",54,"[39]HImHoIjdEBlDEdbCwvJkBIewEdeKHwnJHqveGqa",204,0.990338,39,207,2,205,1,2,1,3,2,92,91,114,114,70
"5956",55,"[39]HImHoIjdEBlDEdbCwvJkBIewEdeKHwnJHqveGqa",204,0.990338,39,207,2,205,1,2,1,3,2,92,91,114,114,70
"5957",56,"[39]HImHoIjdEBlDEdbCwvJkBIewEdeKHwnJHqveGqa",213,0.990741,39,216,2,214,1,2,1,3,2,106,105,109,109,70
"5958",57,"[39]HImHoIjdEBlDEdbCwvJkBIewEdeKHwnJHqveGqa",220,0.991031,39,223,2,221,1,2,1,3,2,113,112,109,109,70
"5959",58,"[39]HImHoIjdEBlDEdbCwvJkBIewEdeKHwnJHqveGqa",219,0.990991,39,222,2,220,1,2,1,3,2,116,115,105,105,70
"5960",59,"[39]HImHoIjdEBlDEdbCwvJkBIewEdeKHwnJHqveGqa",229,0.991379,39,232,2,230,1,2,1,3,2,126,125,105,105,70
"5961",60,"[39]HImHoIjdEBlDEdbCwvJkBIewEdeKHwnJHqveGqa",225,0.991228,39,228,2,226,1,2,1,3,2,123,122,104,104,70
"5962",61,"[39]HImHoIjdEBlDEdbCwvJkBIewEdeKHwnJHqveGqa",220,0.991031,39,223,2,221,1,2,1,3,2,115,114,107,107,70
"5963",62,"[39]HImHoIjdEBlDEdbCwvJkBIewEdeKHwnJHqveGqa",219,0.990991,39,222,2,220,1,2,1,3,2,113,112,108,108,70
"5964",63,"[39]HImHoIjdEBlDEdbCwvJkBIewEdeKHwnJHqveGqa",211,0.990654,39,214,2,212,1,2,1,3,2,103,102,110,110,70
"5965",64,"[39]HImHoIjdEBlDEdbCwvJkBIewEdeKHwnJHqveGqa",214,0.990783,39,217,2,215,1,2,1,3,2,105,104,111,111,70
"5966",65,"[39]HImHoIjdEBlDEdbCwvJkBIewEdeKHwnJHqveGqa",214,0.990783,39,217,2,215,1,2,1,3,2,105,104,111,111,70
"5967",66,"[39]HImHoIjdEBlDEdbCwvJkBIewEdeKHwnJHqveGqa",209,0.990566,39,212,2,210,1,2,1,3,2,98,97,113,113,70
"5968",67,"[39]HImHoIjdEBlDEdbCwvJkBIewEdeKHwnJHqveGqa",216,0.990868,39,219,2,217,1,2,1,3,2,108,107,110,110,70
"5969",68,"[39]HImHoIjdEBlDEdbCwvJkBIewEdeKHwnJHqveGqa",182,0.989189,39,185,2,183,1,2,1,3,2,62,61,122,122,70
"5970",69,"[39]HImHoIjdEBlDEdbCwvJkBIewEdeKHwnJHqveGqa",200,0.990148,39,203,2,201,1,2,1,3,2,85,84,117,117,70
"5971",70,"[39]HImHoIjdEBlDEdbCwvJkBIewEdeKHwnJHqveGqa",209,0.990566,39,212,2,210,1,2,1,3,2,101,100,110,110,70
"5972",71,"[39]HImHoIjdEBlDEdbCwvJkBIewEdeKHwnJHqveGqa",220,0.991031,39,223,2,221,1,2,1,3,2,116,115,106,106,70
"5973",72,"[39]HImHoIjdEBlDEdbCwvJkBIewEdeKHwnJHqveGqa",223,0.99115,39,226,2,224,1,2,1,3,2,120,119,105,105,70
"5974",73,"[39]HImHoIjdEBlDEdbCwvJkBIewEdeKHwnJHqveGqa",219,0.990991,39,222,2,220,1,2,1,3,2,113,112,108,108,70
"5975",74,"[39]HImHoIjdEBlDEdbCwvJkBIewEdeKHwnJHqveGqa",214,0.990783,39,217,2,215,1,2,1,3,2,105,104,111,111,70
"5976",75,"[39]HImHoIjdEBlDEdbCwvJkBIewEdeKHwnJHqveGqa",225,0.991228,39,228,2,226,1,2,1,3,2,123,122,104,104,70
"5977",76,"[39]HImHoIjdEBlDEdbCwvJkBIewEdeKHwnJHqveGqa",233,0.991525,39,236,2,234,1,2,1,3,2,133,132,102,102,70
"5978",77,"[39]HImHoIjdEBlDEdbCwvJkBIewEdeKHwnJHqveGqa",226,0.991266,39,229,2,227,1,2,1,3,2,123,122,105,105,70
"5979",78,"[39]HImHoIjdEBlDEdbCwvJkBIewEdeKHwnJHqveGqa",218,0.99095,39,221,2,219,1,2,1,3,2,113,112,107,107,70
"5980",79,"[39]HImHoIjdEBlDEdbCwvJkBIewEdeKHwnJHqveGqa",217,0.990909,39,220,2,218,1,2,1,3,2,108,107,111,111,70
"5981",80,"[39]HImHoIjdEBlDEdbCwvJkBIewEdeKHwnJHqveGqa",224,0.991189,39,227,2,225,1,2,1,3,2,120,119,106,106,70
"5982",81,"[39]HImHoIjdEBlDEdbCwvJkBIewEdeKHwnJHqveGqa",219,0.990991,39,222,2,220,1,2,1,3,2,113,112,108,108,70
"5983",82,"[39]HImHoIjdEBlDEdbCwvJkBIewEdeKHwnJHqveGqa",216,0.990868,39,219,2,217,1,2,1,3,2,107,106,111,111,70
"5984",83,"[39]HImHoIjdEBlDEdbCwvJkBIewEdeKHwnJHqveGqa",217,0.990909,39,220,2,218,1,2,1,3,2,112,111,107,107,70
"5985",84,"[39]HImHoIjdEBlDEdbCwvJkBIewEdeKHwnJHqveGqa",211,0.990654,39,214,2,212,1,2,1,3,2,104,103,109,109,70
"5986",85,"[39]HImHoIjdEBlDEdbCwvJkBIewEdeKHwnJHqveGqa",208,0.990521,39,211,2,209,1,2,1,3,2,97,96,113,113,70
"5987",86,"[39]HImHoIjdEBlDEdbCwvJkBIewEdeKHwnJHqveGqa",207,0.990476,39,210,2,208,1,2,1,3,2,99,98,110,110,70
"5988",87,"[39]HImHoIjdEBlDEdbCwvJkBIewEdeKHwnJHqveGqa",209,0.990566,39,212,2,210,1,2,1,3,2,101,100,110,110,70
"5989",88,"[39]HImHoIjdEBlDEdbCwvJkBIewEdeKHwnJHqveGqa",212,0.990698,39,215,2,213,1,2,1,3,2,101,100,113,113,70
"5990",89,"[39]HImHoIjdEBlDEdbCwvJkBIewEdeKHwnJHqveGqa",223,0.99115,39,226,2,224,1,2,1,3,2,119,118,106,106,70
"5991",90,"[39]HImHoIjdEBlDEdbCwvJkBIewEdeKHwnJHqveGqa",216,0.990868,39,219,2,217,1,2,1,3,2,110,109,108,108,70
"5992",91,"[39]HImHoIjdEBlDEdbCwvJkBIewEdeKHwnJHqveGqa",214,0.990783,39,217,2,215,1,2,1,3,2,107,106,109,109,70
"5993",92,"[39]HImHoIjdEBlDEdbCwvJkBIewEdeKHwnJHqveGqa",207,0.990476,39,210,2,208,1,2,1,3,2,98,97,111,111,70
"5994",93,"[39]HImHoIjdEBlDEdbCwvJkBIewEdeKHwnJHqveGqa",218,0.99095,39,221,2,219,1,2,1,3,2,112,111,108,108,70
"5995",94,"[39]HImHoIjdEBlDEdbCwvJkBIewEdeKHwnJHqveGqa",214,0.990783,39,217,2,215,1,2,1,3,2,105,104,111,111,70
"5996",95,"[39]HImHoIjdEBlDEdbCwvJkBIewEdeKHwnJHqveGqa",218,0.99095,39,221,2,219,1,2,1,3,2,113,112,107,107,70
"5997",96,"[39]HImHoIjdEBlDEdbCwvJkBIewEdeKHwnJHqveGqa",213,0.990741,39,216,2,214,1,2,1,3,2,106,105,109,109,70
"5998",97,"[39]HImHoIjdEBlDEdbCwvJkBIewEdeKHwnJHqveGqa",210,0.99061,39,213,2,211,1,2,1,3,2,101,100,111,111,70
"5999",98,"[39]HImHoIjdEBlDEdbCwvJkBIewEdeKHwnJHqveGqa",206,0.990431,39,209,2,207,1,2,1,3,2,95,94,113,113,70
"6000",99,"[39]HImHoIjdEBlDEdbCwvJkBIewEdeKHwnJHqveGqa",210,0.99061,39,213,2,211,1,2,1,3,2,101,100,111,111,70
"6001",0,"[40]tIrHoIbsaBkDwCsKxbGsylbKpaefhHunJHqvbGqa",214,0.990783,40,217,2,215,1,2,1,3,2,121,120,95,95,71
"6002",1,"[40]tIrHoIbsaBkDwCsKxbGsylbKpaefhHunJHqvbGqa",194,0.989848,40,197,2,195,1,2,1,3,2,92,91,104,104,71
"6003",2,"[40]tIrHoIbsaBkDwCsKxbGsylbKpaefhHunJHqvbGqa",201,0.990196,40,204,2,202,1,2,1,3,2,102,101,101,101,71
"6004",3,"[40]tIrHoIbsaBkDwCsKxbGsylbKpaefhHunJHqvbGqa",218,0.99095,40,221,2,219,1,2,1,3,2,125,124,95,95,71
"6005",4,"[40]tIrHoIbsaBkDwCsKxbGsylbKpaefhHunJHqvbGqa",200,0.990148,40,203,2,201,1,2,1,3,2,104,103,98,98,71
"6006",5,"[40]tIrHoIbsaBkDwCsKxbGsylbKpaefhHunJHqvbGqa",205,0.990385,40,208,2,206,1,2,1,3,2,107,106,100,100,71
"6007",6,"[40]tIrHoIbsaBkDwCsKxbGsylbKpaefhHunJHqvbGqa",212,0.990698,40,215,2,213,1,2,1,3,2,119,118,95,95,71
"6008",7,"[40]tIrHoIbsaBkDwCsKxbGsylbKpaefhHunJHqvbGqa",197,0.99,40,200,2,198,1,2,1,3,2,95,94,104,104,71
"6009",8,"[40]tIrHoIbsaBkDwCsKxbGsylbKpaefhHunJHqvbGqa",203,0.990291,40,206,2,204,1,2,1,3,2,104,103,101,101,71
"6010",9,"[40]tIrHoIbsaBkDwCsKxbGsylbKpaefhHunJHqvbGqa",202,0.990244,40,205,2,203,1,2,1,3,2,101,100,103,103,71
"6011",10,"[40]tIrHoIbsaBkDwCsKxbGsylbKpaefhHunJHqvbGqa",198,0.99005,40,201,2,199,1,2,1,3,2,98,97,102,102,71
"6012",11,"[40]tIrHoIbsaBkDwCsKxbGsylbKpaefhHunJHqvbGqa",200,0.990148,40,203,2,201,1,2,1,3,2,102,101,100,100,71
"6013",12,"[40]tIrHoIbsaBkDwCsKxbGsylbKpaefhHunJHqvbGqa",196,0.98995,40,199,2,197,1,2,1,3,2,94,93,104,104,71
"6014",13,"[40]tIrHoIbsaBkDwCsKxbGsylbKpaefhHunJHqvbGqa",207,0.990476,40,210,2,208,1,2,1,3,2,113,112,96,96,71
"6015",14,"[40]tIrHoIbsaBkDwCsKxbGsylbKpaefhHunJHqvbGqa",203,0.990291,40,206,2,204,1,2,1,3,2,106,105,99,99,71
"6016",15,"[40]tIrHoIbsaBkDwCsKxbGsylbKpaefhHunJHqvbGqa",192,0.989744,40,195,2,193,1,2,1,3,2,91,90,103,103,71
"6017",16,"[40]tIrHoIbsaBkDwCsKxbGsylbKpaefhHunJHqvbGqa",205,0.990385,40,208,2,206,1,2,1,3,2,108,107,99,99,71
"6018",17,"[40]tIrHoIbsaBkDwCsKxbGsylbKpaefhHunJHqvbGqa",202,0.990244,40,205,2,203,1,2,1,3,2,105,104,99,99,71
"6019",18,"[40]tIrHoIbsaBkDwCsKxbGsylbKpaefhHunJHqvbGqa",190,0.989637,40,193,2,191,1,2,1,3,2,86,85,106,106,71
"6020",19,"[40]tIrHoIbsaBkDwCsKxbGsylbKpaefhHunJHqvbGqa",201,0.990196,40,204,2,202,1,2,1,3,2,101,100,102,102,71
"6021",20,"[40]tIrHoIbsaBkDwCsKxbGsylbKpaefhHunJHqvbGqa",204,0.990338,40,207,2,205,1,2,1,3,2,107,106,99,99,71
"6022",21,"[40]tIrHoIbsaBkDwCsKxbGsylbKpaefhHunJHqvbGqa",210,0.99061,40,213,2,211,1,2,1,3,2,114,113,98,98,71
"6023",22,"[40]tIrHoIbsaBkDwCsKxbGsylbKpaefhHunJHqvbGqa",207,0.990476,40,210,2,208,1,2,1,3,2,110,109,99,99,71
"6024",23,"[40]tIrHoIbsaBkDwCsKxbGsylbKpaefhHunJHqvbGqa",201,0.990196,40,204,2,202,1,2,1,3,2,102,101,101,101,71
"6025",24,"[40]tIrHoIbsaBkDwCsKxbGsylbKpaefhHunJHqvbGqa",211,0.990654,40,214,2,212,1,2,1,3,2,116,115,97,97,71
"6026",25,"[40]tIrHoIbsaBkDwCsKxbGsylbKpaefhHunJHqvbGqa",195,0.989899,40,198,2,196,1,2,1,3,2,96,95,101,101,71
"6027",26,"[40]tIrHoIbsaBkDwCsKxbGsylbKpaefhHunJHqvbGqa",209,0.990566,40,212,2,210,1,2,1,3,2,114,113,97,97,71
"6028",27,"[40]tIrHoIbsaBkDwCsKxbGsylbKpaefhHunJHqvbGqa",208,0.990521,40,211,2,209,1,2,1,3,2,110,109,100,100,71
"6029",28,"[40]tIrHoIbsaBkDwCsKxbGsylbKpaefhHunJHqvbGqa",191,0.989691,40,194,2,192,1,2,1,3,2,90,89,103,103,71
"6030",29,"[40]tIrHoIbsaBkDwCsKxbGsylbKpaefhHunJHqvbGqa",205,0.990385,40,208,2,206,1,2,1,3,2,107,106,100,100,71
"6031",30,"[40]tIrHoIbsaBkDwCsKxbGsylbKpaefhHunJHqvbGqa",203,0.990291,40,206,2,204,1,2,1,3,2,105,104,100,100,71
"6032",31,"[40]tIrHoIbsaBkDwCsKxbGsylbKpaefhHunJHqvbGqa",206,0.990431,40,209,2,207,1,2,1,3,2,107,106,101,101,71
"6033",32,"[40]tIrHoIbsaBkDwCsKxbGsylbKpaefhHunJHqvbGqa",204,0.990338,40,207,2,205,1,2,1,3,2,106,105,100,100,71
"6034",33,"[40]tIrHoIbsaBkDwCsKxbGsylbKpaefhHunJHqvbGqa",200,0.990148,40,203,2,201,1,2,1,3,2,100,99,102,102,71
"6035",34,"[40]tIrHoIbsaBkDwCsKxbGsylbKpaefhHunJHqvbGqa",211,0.990654,40,214,2,212,1,2,1,3,2,118,117,95,95,71
"6036",35,"[40]tIrHoIbsaBkDwCsKxbGsylbKpaefhHunJHqvbGqa",207,0.990476,40,210,2,208,1,2,1,3,2,109,108,100,100,71
"6037",36,"[40]tIrHoIbsaBkDwCsKxbGsylbKpaefhHunJHqvbGqa",200,0.990148,40,203,2,201,1,2,1,3,2,101,100,101,101,71
"6038",37,"[40]tIrHoIbsaBkDwCsKxbGsylbKpaefhHunJHqvbGqa",206,0.990431,40,209,2,207,1,2,1,3,2,111,110,97,97,71
"6039",38,"[40]tIrHoIbsaBkDwCsKxbGsylbKpaefhHunJHqvbGqa",189,0.989583,40,192,2,190,1,2,1,3,2,86,85,105,105,71
"6040",39,"[40]tIrHoIbsaBkDwCsKxbGsylbKpaefhHunJHqvbGqa",209,0.990566,40,212,2,210,1,2,1,3,2,113,112,98,98,71
"6041",40,"[40]tIrHoIbsaBkDwCsKxbGsylbKpaefhHunJHqvbGqa",207,0.990476,40,210,2,208,1,2,1,3,2,111,110,98,98,71
"6042",41,"[40]tIrHoIbsaBkDwCsKxbGsylbKpaefhHunJHqvbGqa",187,0.989474,40,190,2,188,1,2,1,3,2,83,82,106,106,71
"6043",42,"[40]tIrHoIbsaBkDwCsKxbGsylbKpaefhHunJHqvbGqa",204,0.990338,40,207,2,205,1,2,1,3,2,108,107,98,98,71
"6044",43,"[40]tIrHoIbsaBkDwCsKxbGsylbKpaefhHunJHqvbGqa",179,0.989011,40,182,2,180,1,2,1,3,2,74,73,107,107,71
"6045",44,"[40]tIrHoIbsaBkDwCsKxbGsylbKpaefhHunJHqvbGqa",205,0.990385,40,208,2,206,1,2,1,3,2,107,106,100,100,71
"6046",45,"[40]tIrHoIbsaBkDwCsKxbGsylbKpaefhHunJHqvbGqa",205,0.990385,40,208,2,206,1,2,1,3,2,106,105,101,101,71
"6047",46,"[40]tIrHoIbsaBkDwCsKxbGsylbKpaefhHunJHqvbGqa",211,0.990654,40,214,2,212,1,2,1,3,2,118,117,95,95,71
"6048",47,"[40]tIrHoIbsaBkDwCsKxbGsylbKpaefhHunJHqvbGqa",197,0.99,40,200,2,198,1,2,1,3,2,96,95,103,103,71
"6049",48,"[40]tIrHoIbsaBkDwCsKxbGsylbKpaefhHunJHqvbGqa",207,0.990476,40,210,2,208,1,2,1,3,2,111,110,98,98,71
"6050",49,"[40]tIrHoIbsaBkDwCsKxbGsylbKpaefhHunJHqvbGqa",197,0.99,40,200,2,198,1,2,1,3,2,96,95,103,103,71
"6051",50,"[40]tIrHoIbsaBkDwCsKxbGsylbKpaefhHunJHqvbGqa",214,0.990783,40,217,2,215,1,2,1,3,2,121,120,95,95,71
"6052",51,"[40]tIrHoIbsaBkDwCsKxbGsylbKpaefhHunJHqvbGqa",202,0.990244,40,205,2,203,1,2,1,3,2,103,102,101,101,71
"6053",52,"[40]tIrHoIbsaBkDwCsKxbGsylbKpaefhHunJHqvbGqa",202,0.990244,40,205,2,203,1,2,1,3,2,100,99,104,104,71
"6054",53,"[40]tIrHoIbsaBkDwCsKxbGsylbKpaefhHunJHqvbGqa",204,0.990338,40,207,2,205,1,2,1,3,2,106,105,100,100,71
"6055",54,"[40]tIrHoIbsaBkDwCsKxbGsylbKpaefhHunJHqvbGqa",204,0.990338,40,207,2,205,1,2,1,3,2,108,107,98,98,71
"6056",55,"[40]tIrHoIbsaBkDwCsKxbGsylbKpaefhHunJHqvbGqa",203,0.990291,40,206,2,204,1,2,1,3,2,106,105,99,99,71
"6057",56,"[40]tIrHoIbsaBkDwCsKxbGsylbKpaefhHunJHqvbGqa",187,0.989474,40,190,2,188,1,2,1,3,2,84,83,105,105,71
"6058",57,"[40]tIrHoIbsaBkDwCsKxbGsylbKpaefhHunJHqvbGqa",201,0.990196,40,204,2,202,1,2,1,3,2,103,102,100,100,71
"6059",58,"[40]tIrHoIbsaBkDwCsKxbGsylbKpaefhHunJHqvbGqa",195,0.989899,40,198,2,196,1,2,1,3,2,95,94,102,102,71
"6060",59,"[40]tIrHoIbsaBkDwCsKxbGsylbKpaefhHunJHqvbGqa",209,0.990566,40,212,2,210,1,2,1,3,2,112,111,99,99,71
"6061",60,"[40]tIrHoIbsaBkDwCsKxbGsylbKpaefhHunJHqvbGqa",202,0.990244,40,205,2,203,1,2,1,3,2,104,103,100,100,71
"6062",61,"[40]tIrHoIbsaBkDwCsKxbGsylbKpaefhHunJHqvbGqa",198,0.99005,40,201,2,199,1,2,1,3,2,102,101,98,98,71
"6063",62,"[40]tIrHoIbsaBkDwCsKxbGsylbKpaefhHunJHqvbGqa",195,0.989899,40,198,2,196,1,2,1,3,2,91,90,106,106,71
"6064",63,"[40]tIrHoIbsaBkDwCsKxbGsylbKpaefhHunJHqvbGqa",194,0.989848,40,197,2,195,1,2,1,3,2,93,92,103,103,71
"6065",64,"[40]tIrHoIbsaBkDwCsKxbGsylbKpaefhHunJHqvbGqa",213,0.990741,40,216,2,214,1,2,1,3,2,118,117,97,97,71
"6066",65,"[40]tIrHoIbsaBkDwCsKxbGsylbKpaefhHunJHqvbGqa",208,0.990521,40,211,2,209,1,2,1,3,2,111,110,99,99,71
"6067",66,"[40]tIrHoIbsaBkDwCsKxbGsylbKpaefhHunJHqvbGqa",205,0.990385,40,208,2,206,1,2,1,3,2,106,105,101,101,71
"6068",67,"[40]tIrHoIbsaBkDwCsKxbGsylbKpaefhHunJHqvbGqa",208,0.990521,40,211,2,209,1,2,1,3,2,112,111,98,98,71
"6069",68,"[40]tIrHoIbsaBkDwCsKxbGsylbKpaefhHunJHqvbGqa",205,0.990385,40,208,2,206,1,2,1,3,2,107,106,100,100,71
"6070",69,"[40]tIrHoIbsaBkDwCsKxbGsylbKpaefhHunJHqvbGqa",201,0.990196,40,204,2,202,1,2,1,3,2,99,98,104,104,71
"6071",70,"[40]tIrHoIbsaBkDwCsKxbGsylbKpaefhHunJHqvbGqa",209,0.990566,40,212,2,210,1,2,1,3,2,113,112,98,98,71
"6072",71,"[40]tIrHoIbsaBkDwCsKxbGsylbKpaefhHunJHqvbGqa",191,0.989691,40,194,2,192,1,2,1,3,2,88,87,105,105,71
"6073",72,"[40]tIrHoIbsaBkDwCsKxbGsylbKpaefhHunJHqvbGqa",195,0.989899,40,198,2,196,1,2,1,3,2,94,93,103,103,71
"6074",73,"[40]tIrHoIbsaBkDwCsKxbGsylbKpaefhHunJHqvbGqa",202,0.990244,40,205,2,203,1,2,1,3,2,105,104,99,99,71
"6075",74,"[40]tIrHoIbsaBkDwCsKxbGsylbKpaefhHunJHqvbGqa",185,0.989362,40,188,2,186,1,2,1,3,2,80,79,107,107,71
"6076",75,"[40]tIrHoIbsaBkDwCsKxbGsylbKpaefhHunJHqvbGqa",211,0.990654,40,214,2,212,1,2,1,3,2,117,116,96,96,71
"6077",76,"[40]tIrHoIbsaBkDwCsKxbGsylbKpaefhHunJHqvbGqa",212,0.990698,40,215,2,213,1,2,1,3,2,118,117,96,96,71
"6078",77,"[40]tIrHoIbsaBkDwCsKxbGsylbKpaefhHunJHqvbGqa",200,0.990148,40,203,2,201,1,2,1,3,2,100,99,102,102,71
"6079",78,"[40]tIrHoIbsaBkDwCsKxbGsylbKpaefhHunJHqvbGqa",208,0.990521,40,211,2,209,1,2,1,3,2,113,112,97,97,71
"6080",79,"[40]tIrHoIbsaBkDwCsKxbGsylbKpaefhHunJHqvbGqa",195,0.989899,40,198,2,196,1,2,1,3,2,95,94,102,102,71
"6081",80,"[40]tIrHoIbsaBkDwCsKxbGsylbKpaefhHunJHqvbGqa",199,0.990099,40,202,2,200,1,2,1,3,2,100,99,101,101,71
"6082",81,"[40]tIrHoIbsaBkDwCsKxbGsylbKpaefhHunJHqvbGqa",188,0.989529,40,191,2,189,1,2,1,3,2,87,86,103,103,71
"6083",82,"[40]tIrHoIbsaBkDwCsKxbGsylbKpaefhHunJHqvbGqa",207,0.990476,40,210,2,208,1,2,1,3,2,114,113,95,95,71
"6084",83,"[40]tIrHoIbsaBkDwCsKxbGsylbKpaefhHunJHqvbGqa",203,0.990291,40,206,2,204,1,2,1,3,2,106,105,99,99,71
"6085",84,"[40]tIrHoIbsaBkDwCsKxbGsylbKpaefhHunJHqvbGqa",201,0.990196,40,204,2,202,1,2,1,3,2,100,99,103,103,71
"6086",85,"[40]tIrHoIbsaBkDwCsKxbGsylbKpaefhHunJHqvbGqa",199,0.990099,40,202,2,200,1,2,1,3,2,101,100,100,100,71
"6087",86,"[40]tIrHoIbsaBkDwCsKxbGsylbKpaefhHunJHqvbGqa",210,0.99061,40,213,2,211,1,2,1,3,2,115,114,97,97,71
"6088",87,"[40]tIrHoIbsaBkDwCsKxbGsylbKpaefhHunJHqvbGqa",210,0.99061,40,213,2,211,1,2,1,3,2,112,111,100,100,71
"6089",88,"[40]tIrHoIbsaBkDwCsKxbGsylbKpaefhHunJHqvbGqa",194,0.989848,40,197,2,195,1,2,1,3,2,93,92,103,103,71
"6090",89,"[40]tIrHoIbsaBkDwCsKxbGsylbKpaefhHunJHqvbGqa",197,0.99,40,200,2,198,1,2,1,3,2,95,94,104,104,71
"6091",90,"[40]tIrHoIbsaBkDwCsKxbGsylbKpaefhHunJHqvbGqa",211,0.990654,40,214,2,212,1,2,1,3,2,116,115,97,97,71
"6092",91,"[40]tIrHoIbsaBkDwCsKxbGsylbKpaefhHunJHqvbGqa",214,0.990783,40,217,2,215,1,2,1,3,2,120,119,96,96,71
"6093",92,"[40]tIrHoIbsaBkDwCsKxbGsylbKpaefhHunJHqvbGqa",197,0.99,40,200,2,198,1,2,1,3,2,97,96,102,102,71
"6094",93,"[40]tIrHoIbsaBkDwCsKxbGsylbKpaefhHunJHqvbGqa",184,0.989305,40,187,2,185,1,2,1,3,2,80,79,106,106,71
"6095",94,"[40]tIrHoIbsaBkDwCsKxbGsylbKpaefhHunJHqvbGqa",212,0.990698,40,215,2,213,1,2,1,3,2,117,116,97,97,71
"6096",95,"[40]tIrHoIbsaBkDwCsKxbGsylbKpaefhHunJHqvbGqa",194,0.989848,40,197,2,195,1,2,1,3,2,93,92,103,103,71
"6097",96,"[40]tIrHoIbsaBkDwCsKxbGsylbKpaefhHunJHqvbGqa",195,0.989899,40,198,2,196,1,2,1,3,2,93,92,104,104,71
"6098",97,"[40]tIrHoIbsaBkDwCsKxbGsylbKpaefhHunJHqvbGqa",199,0.990099,40,202,2,200,1,2,1,3,2,102,101,99,99,71
"6099",98,"[40]tIrHoIbsaBkDwCsKxbGsylbKpaefhHunJHqvbGqa",214,0.990783,40,217,2,215,1,2,1,3,2,122,121,94,94,71
"6100",99,"[40]tIrHoIbsaBkDwCsKxbGsylbKpaefhHunJHqvbGqa",196,0.98995,40,199,2,197,1,2,1,3,2,96,95,102,102,71
"6101",0,"[40]bIbHoIDdbBkDtGtkIdBGmrbKDaeHgHsnJHqvbGqa",187,0.989474,40,190,2,188,1,2,1,3,2,84,83,105,105,72
"6102",1,"[40]bIbHoIDdbBkDtGtkIdBGmrbKDaeHgHsnJHqvbGqa",199,0.990099,40,202,2,200,1,2,1,3,2,99,98,102,102,72
"6103",2,"[40]bIbHoIDdbBkDtGtkIdBGmrbKDaeHgHsnJHqvbGqa",210,0.99061,40,213,2,211,1,2,1,3,2,115,114,97,97,72
"6104",3,"[40]bIbHoIDdbBkDtGtkIdBGmrbKDaeHgHsnJHqvbGqa",203,0.990291,40,206,2,204,1,2,1,3,2,105,104,100,100,72
"6105",4,"[40]bIbHoIDdbBkDtGtkIdBGmrbKDaeHgHsnJHqvbGqa",201,0.990196,40,204,2,202,1,2,1,3,2,101,100,102,102,72
"6106",5,"[40]bIbHoIDdbBkDtGtkIdBGmrbKDaeHgHsnJHqvbGqa",212,0.990698,40,215,2,213,1,2,1,3,2,118,117,96,96,72
"6107",6,"[40]bIbHoIDdbBkDtGtkIdBGmrbKDaeHgHsnJHqvbGqa",195,0.989899,40,198,2,196,1,2,1,3,2,94,93,103,103,72
"6108",7,"[40]bIbHoIDdbBkDtGtkIdBGmrbKDaeHgHsnJHqvbGqa",185,0.989362,40,188,2,186,1,2,1,3,2,81,80,106,106,72
"6109",8,"[40]bIbHoIDdbBkDtGtkIdBGmrbKDaeHgHsnJHqvbGqa",196,0.98995,40,199,2,197,1,2,1,3,2,96,95,102,102,72
"6110",9,"[40]bIbHoIDdbBkDtGtkIdBGmrbKDaeHgHsnJHqvbGqa",209,0.990566,40,212,2,210,1,2,1,3,2,113,112,98,98,72
"6111",10,"[40]bIbHoIDdbBkDtGtkIdBGmrbKDaeHgHsnJHqvbGqa",215,0.990826,40,218,2,216,1,2,1,3,2,122,121,95,95,72
"6112",11,"[40]bIbHoIDdbBkDtGtkIdBGmrbKDaeHgHsnJHqvbGqa",223,0.99115,40,226,2,224,1,2,1,3,2,130,129,95,95,72
"6113",12,"[40]bIbHoIDdbBkDtGtkIdBGmrbKDaeHgHsnJHqvbGqa",192,0.989744,40,195,2,193,1,2,1,3,2,92,91,102,102,72
"6114",13,"[40]bIbHoIDdbBkDtGtkIdBGmrbKDaeHgHsnJHqvbGqa",200,0.990148,40,203,2,201,1,2,1,3,2,103,102,99,99,72
"6115",14,"[40]bIbHoIDdbBkDtGtkIdBGmrbKDaeHgHsnJHqvbGqa",197,0.99,40,200,2,198,1,2,1,3,2,96,95,103,103,72
"6116",15,"[40]bIbHoIDdbBkDtGtkIdBGmrbKDaeHgHsnJHqvbGqa",192,0.989744,40,195,2,193,1,2,1,3,2,90,89,104,104,72
"6117",16,"[40]bIbHoIDdbBkDtGtkIdBGmrbKDaeHgHsnJHqvbGqa",192,0.989744,40,195,2,193,1,2,1,3,2,91,90,103,103,72
"6118",17,"[40]bIbHoIDdbBkDtGtkIdBGmrbKDaeHgHsnJHqvbGqa",192,0.989744,40,195,2,193,1,2,1,3,2,91,90,103,103,72
"6119",18,"[40]bIbHoIDdbBkDtGtkIdBGmrbKDaeHgHsnJHqvbGqa",209,0.990566,40,212,2,210,1,2,1,3,2,116,115,95,95,72
"6120",19,"[40]bIbHoIDdbBkDtGtkIdBGmrbKDaeHgHsnJHqvbGqa",208,0.990521,40,211,2,209,1,2,1,3,2,113,112,97,97,72
"6121",20,"[40]bIbHoIDdbBkDtGtkIdBGmrbKDaeHgHsnJHqvbGqa",196,0.98995,40,199,2,197,1,2,1,3,2,95,94,103,103,72
"6122",21,"[40]bIbHoIDdbBkDtGtkIdBGmrbKDaeHgHsnJHqvbGqa",205,0.990385,40,208,2,206,1,2,1,3,2,108,107,99,99,72
"6123",22,"[40]bIbHoIDdbBkDtGtkIdBGmrbKDaeHgHsnJHqvbGqa",210,0.99061,40,213,2,211,1,2,1,3,2,117,116,95,95,72
"6124",23,"[40]bIbHoIDdbBkDtGtkIdBGmrbKDaeHgHsnJHqvbGqa",199,0.990099,40,202,2,200,1,2,1,3,2,100,99,101,101,72
"6125",24,"[40]bIbHoIDdbBkDtGtkIdBGmrbKDaeHgHsnJHqvbGqa",191,0.989691,40,194,2,192,1,2,1,3,2,87,86,106,106,72
"6126",25,"[40]bIbHoIDdbBkDtGtkIdBGmrbKDaeHgHsnJHqvbGqa",194,0.989848,40,197,2,195,1,2,1,3,2,94,93,102,102,72
"6127",26,"[40]bIbHoIDdbBkDtGtkIdBGmrbKDaeHgHsnJHqvbGqa",207,0.990476,40,210,2,208,1,2,1,3,2,110,109,99,99,72
"6128",27,"[40]bIbHoIDdbBkDtGtkIdBGmrbKDaeHgHsnJHqvbGqa",217,0.990909,40,220,2,218,1,2,1,3,2,127,126,92,92,72
"6129",28,"[40]bIbHoIDdbBkDtGtkIdBGmrbKDaeHgHsnJHqvbGqa",204,0.990338,40,207,2,205,1,2,1,3,2,105,104,101,101,72
"6130",29,"[40]bIbHoIDdbBkDtGtkIdBGmrbKDaeHgHsnJHqvbGqa",212,0.990698,40,215,2,213,1,2,1,3,2,115,114,99,99,72
"6131",30,"[40]bIbHoIDdbBkDtGtkIdBGmrbKDaeHgHsnJHqvbGqa",202,0.990244,40,205,2,203,1,2,1,3,2,102,101,102,102,72
"6132",31,"[40]bIbHoIDdbBkDtGtkIdBGmrbKDaeHgHsnJHqvbGqa",201,0.990196,40,204,2,202,1,2,1,3,2,103,102,100,100,72
"6133",32,"[40]bIbHoIDdbBkDtGtkIdBGmrbKDaeHgHsnJHqvbGqa",209,0.990566,40,212,2,210,1,2,1,3,2,111,110,100,100,72
"6134",33,"[40]bIbHoIDdbBkDtGtkIdBGmrbKDaeHgHsnJHqvbGqa",190,0.989637,40,193,2,191,1,2,1,3,2,84,83,108,108,72
"6135",34,"[40]bIbHoIDdbBkDtGtkIdBGmrbKDaeHgHsnJHqvbGqa",203,0.990291,40,206,2,204,1,2,1,3,2,104,103,101,101,72
"6136",35,"[40]bIbHoIDdbBkDtGtkIdBGmrbKDaeHgHsnJHqvbGqa",216,0.990868,40,219,2,217,1,2,1,3,2,123,122,95,95,72
"6137",36,"[40]bIbHoIDdbBkDtGtkIdBGmrbKDaeHgHsnJHqvbGqa",199,0.990099,40,202,2,200,1,2,1,3,2,97,96,104,104,72
"6138",37,"[40]bIbHoIDdbBkDtGtkIdBGmrbKDaeHgHsnJHqvbGqa",197,0.99,40,200,2,198,1,2,1,3,2,97,96,102,102,72
"6139",38,"[40]bIbHoIDdbBkDtGtkIdBGmrbKDaeHgHsnJHqvbGqa",194,0.989848,40,197,2,195,1,2,1,3,2,94,93,102,102,72
"6140",39,"[40]bIbHoIDdbBkDtGtkIdBGmrbKDaeHgHsnJHqvbGqa",201,0.990196,40,204,2,202,1,2,1,3,2,100,99,103,103,72
"6141",40,"[40]bIbHoIDdbBkDtGtkIdBGmrbKDaeHgHsnJHqvbGqa",193,0.989796,40,196,2,194,1,2,1,3,2,92,91,103,103,72
"6142",41,"[40]bIbHoIDdbBkDtGtkIdBGmrbKDaeHgHsnJHqvbGqa",195,0.989899,40,198,2,196,1,2,1,3,2,94,93,103,103,72
"6143",42,"[40]bIbHoIDdbBkDtGtkIdBGmrbKDaeHgHsnJHqvbGqa",198,0.99005,40,201,2,199,1,2,1,3,2,97,96,103,103,72
"6144",43,"[40]bIbHoIDdbBkDtGtkIdBGmrbKDaeHgHsnJHqvbGqa",207,0.990476,40,210,2,208,1,2,1,3,2,109,108,100,100,72
"6145",44,"[40]bIbHoIDdbBkDtGtkIdBGmrbKDaeHgHsnJHqvbGqa",196,0.98995,40,199,2,197,1,2,1,3,2,95,94,103,103,72
"6146",45,"[40]bIbHoIDdbBkDtGtkIdBGmrbKDaeHgHsnJHqvbGqa",207,0.990476,40,210,2,208,1,2,1,3,2,109,108,100,100,72
"6147",46,"[40]bIbHoIDdbBkDtGtkIdBGmrbKDaeHgHsnJHqvbGqa",198,0.99005,40,201,2,199,1,2,1,3,2,95,94,105,105,72
"6148",47,"[40]bIbHoIDdbBkDtGtkIdBGmrbKDaeHgHsnJHqvbGqa",195,0.989899,40,198,2,196,1,2,1,3,2,95,94,102,102,72
"6149",48,"[40]bIbHoIDdbBkDtGtkIdBGmrbKDaeHgHsnJHqvbGqa",207,0.990476,40,210,2,208,1,2,1,3,2,111,110,98,98,72
"6150",49,"[40]bIbHoIDdbBkDtGtkIdBGmrbKDaeHgHsnJHqvbGqa",204,0.990338,40,207,2,205,1,2,1,3,2,103,102,103,103,72
"6151",50,"[40]bIbHoIDdbBkDtGtkIdBGmrbKDaeHgHsnJHqvbGqa",203,0.990291,40,206,2,204,1,2,1,3,2,106,105,99,99,72
"6152",51,"[40]bIbHoIDdbBkDtGtkIdBGmrbKDaeHgHsnJHqvbGqa",205,0.990385,40,208,2,206,1,2,1,3,2,107,106,100,100,72
"6153",52,"[40]bIbHoIDdbBkDtGtkIdBGmrbKDaeHgHsnJHqvbGqa",192,0.989744,40,195,2,193,1,2,1,3,2,90,89,104,104,72
"6154",53,"[40]bIbHoIDdbBkDtGtkIdBGmrbKDaeHgHsnJHqvbGqa",196,0.98995,40,199,2,197,1,2,1,3,2,98,97,100,100,72
"6155",54,"[40]bIbHoIDdbBkDtGtkIdBGmrbKDaeHgHsnJHqvbGqa",203,0.990291,40,206,2,204,1,2,1,3,2,104,103,101,101,72
"6156",55,"[40]bIbHoIDdbBkDtGtkIdBGmrbKDaeHgHsnJHqvbGqa",202,0.990244,40,205,2,203,1,2,1,3,2,104,103,100,100,72
"6157",56,"[40]bIbHoIDdbBkDtGtkIdBGmrbKDaeHgHsnJHqvbGqa",194,0.989848,40,197,2,195,1,2,1,3,2,88,87,108,108,72
"6158",57,"[40]bIbHoIDdbBkDtGtkIdBGmrbKDaeHgHsnJHqvbGqa",202,0.990244,40,205,2,203,1,2,1,3,2,104,103,100,100,72
"6159",58,"[40]bIbHoIDdbBkDtGtkIdBGmrbKDaeHgHsnJHqvbGqa",190,0.989637,40,193,2,191,1,2,1,3,2,88,87,104,104,72
"6160",59,"[40]bIbHoIDdbBkDtGtkIdBGmrbKDaeHgHsnJHqvbGqa",204,0.990338,40,207,2,205,1,2,1,3,2,105,104,101,101,72
"6161",60,"[40]bIbHoIDdbBkDtGtkIdBGmrbKDaeHgHsnJHqvbGqa",202,0.990244,40,205,2,203,1,2,1,3,2,103,102,101,101,72
"6162",61,"[40]bIbHoIDdbBkDtGtkIdBGmrbKDaeHgHsnJHqvbGqa",209,0.990566,40,212,2,210,1,2,1,3,2,115,114,96,96,72
"6163",62,"[40]bIbHoIDdbBkDtGtkIdBGmrbKDaeHgHsnJHqvbGqa",209,0.990566,40,212,2,210,1,2,1,3,2,111,110,100,100,72
"6164",63,"[40]bIbHoIDdbBkDtGtkIdBGmrbKDaeHgHsnJHqvbGqa",198,0.99005,40,201,2,199,1,2,1,3,2,98,97,102,102,72
"6165",64,"[40]bIbHoIDdbBkDtGtkIdBGmrbKDaeHgHsnJHqvbGqa",217,0.990909,40,220,2,218,1,2,1,3,2,126,125,93,93,72
"6166",65,"[40]bIbHoIDdbBkDtGtkIdBGmrbKDaeHgHsnJHqvbGqa",202,0.990244,40,205,2,203,1,2,1,3,2,104,103,100,100,72
"6167",66,"[40]bIbHoIDdbBkDtGtkIdBGmrbKDaeHgHsnJHqvbGqa",204,0.990338,40,207,2,205,1,2,1,3,2,112,111,94,94,72
"6168",67,"[40]bIbHoIDdbBkDtGtkIdBGmrbKDaeHgHsnJHqvbGqa",193,0.989796,40,196,2,194,1,2,1,3,2,90,89,105,105,72
"6169",68,"[40]bIbHoIDdbBkDtGtkIdBGmrbKDaeHgHsnJHqvbGqa",193,0.989796,40,196,2,194,1,2,1,3,2,92,91,103,103,72
"6170",69,"[40]bIbHoIDdbBkDtGtkIdBGmrbKDaeHgHsnJHqvbGqa",214,0.990783,40,217,2,215,1,2,1,3,2,121,120,95,95,72
"6171",70,"[40]bIbHoIDdbBkDtGtkIdBGmrbKDaeHgHsnJHqvbGqa",193,0.989796,40,196,2,194,1,2,1,3,2,91,90,104,104,72
"6172",71,"[40]bIbHoIDdbBkDtGtkIdBGmrbKDaeHgHsnJHqvbGqa",213,0.990741,40,216,2,214,1,2,1,3,2,119,118,96,96,72
"6173",72,"[40]bIbHoIDdbBkDtGtkIdBGmrbKDaeHgHsnJHqvbGqa",198,0.99005,40,201,2,199,1,2,1,3,2,99,98,101,101,72
"6174",73,"[40]bIbHoIDdbBkDtGtkIdBGmrbKDaeHgHsnJHqvbGqa",202,0.990244,40,205,2,203,1,2,1,3,2,103,102,101,101,72
"6175",74,"[40]bIbHoIDdbBkDtGtkIdBGmrbKDaeHgHsnJHqvbGqa",194,0.989848,40,197,2,195,1,2,1,3,2,93,92,103,103,72
"6176",75,"[40]bIbHoIDdbBkDtGtkIdBGmrbKDaeHgHsnJHqvbGqa",193,0.989796,40,196,2,194,1,2,1,3,2,94,93,101,101,72
"6177",76,"[40]bIbHoIDdbBkDtGtkIdBGmrbKDaeHgHsnJHqvbGqa",194,0.989848,40,197,2,195,1,2,1,3,2,91,90,105,105,72
"6178",77,"[40]bIbHoIDdbBkDtGtkIdBGmrbKDaeHgHsnJHqvbGqa",198,0.99005,40,201,2,199,1,2,1,3,2,101,100,99,99,72
"6179",78,"[40]bIbHoIDdbBkDtGtkIdBGmrbKDaeHgHsnJHqvbGqa",210,0.99061,40,213,2,211,1,2,1,3,2,112,111,100,100,72
"6180",79,"[40]bIbHoIDdbBkDtGtkIdBGmrbKDaeHgHsnJHqvbGqa",202,0.990244,40,205,2,203,1,2,1,3,2,104,103,100,100,72
"6181",80,"[40]bIbHoIDdbBkDtGtkIdBGmrbKDaeHgHsnJHqvbGqa",202,0.990244,40,205,2,203,1,2,1,3,2,106,105,98,98,72
"6182",81,"[40]bIbHoIDdbBkDtGtkIdBGmrbKDaeHgHsnJHqvbGqa",199,0.990099,40,202,2,200,1,2,1,3,2,102,101,99,99,72
"6183",82,"[40]bIbHoIDdbBkDtGtkIdBGmrbKDaeHgHsnJHqvbGqa",212,0.990698,40,215,2,213,1,2,1,3,2,118,117,96,96,72
"6184",83,"[40]bIbHoIDdbBkDtGtkIdBGmrbKDaeHgHsnJHqvbGqa",202,0.990244,40,205,2,203,1,2,1,3,2,102,101,102,102,72
"6185",84,"[40]bIbHoIDdbBkDtGtkIdBGmrbKDaeHgHsnJHqvbGqa",202,0.990244,40,205,2,203,1,2,1,3,2,103,102,101,101,72
"6186",85,"[40]bIbHoIDdbBkDtGtkIdBGmrbKDaeHgHsnJHqvbGqa",208,0.990521,40,211,2,209,1,2,1,3,2,113,112,97,97,72
"6187",86,"[40]bIbHoIDdbBkDtGtkIdBGmrbKDaeHgHsnJHqvbGqa",206,0.990431,40,209,2,207,1,2,1,3,2,108,107,100,100,72
"6188",87,"[40]bIbHoIDdbBkDtGtkIdBGmrbKDaeHgHsnJHqvbGqa",198,0.99005,40,201,2,199,1,2,1,3,2,98,97,102,102,72
"6189",88,"[40]bIbHoIDdbBkDtGtkIdBGmrbKDaeHgHsnJHqvbGqa",198,0.99005,40,201,2,199,1,2,1,3,2,100,99,100,100,72
"6190",89,"[40]bIbHoIDdbBkDtGtkIdBGmrbKDaeHgHsnJHqvbGqa",196,0.98995,40,199,2,197,1,2,1,3,2,97,96,101,101,72
"6191",90,"[40]bIbHoIDdbBkDtGtkIdBGmrbKDaeHgHsnJHqvbGqa",202,0.990244,40,205,2,203,1,2,1,3,2,102,101,102,102,72
"6192",91,"[40]bIbHoIDdbBkDtGtkIdBGmrbKDaeHgHsnJHqvbGqa",220,0.991031,40,223,2,221,1,2,1,3,2,129,128,93,93,72
"6193",92,"[40]bIbHoIDdbBkDtGtkIdBGmrbKDaeHgHsnJHqvbGqa",211,0.990654,40,214,2,212,1,2,1,3,2,117,116,96,96,72
"6194",93,"[40]bIbHoIDdbBkDtGtkIdBGmrbKDaeHgHsnJHqvbGqa",205,0.990385,40,208,2,206,1,2,1,3,2,109,108,98,98,72
"6195",94,"[40]bIbHoIDdbBkDtGtkIdBGmrbKDaeHgHsnJHqvbGqa",212,0.990698,40,215,2,213,1,2,1,3,2,117,116,97,97,72
"6196",95,"[40]bIbHoIDdbBkDtGtkIdBGmrbKDaeHgHsnJHqvbGqa",194,0.989848,40,197,2,195,1,2,1,3,2,91,90,105,105,72
"6197",96,"[40]bIbHoIDdbBkDtGtkIdBGmrbKDaeHgHsnJHqvbGqa",207,0.990476,40,210,2,208,1,2,1,3,2,110,109,99,99,72
"6198",97,"[40]bIbHoIDdbBkDtGtkIdBGmrbKDaeHgHsnJHqvbGqa",196,0.98995,40,199,2,197,1,2,1,3,2,97,96,101,101,72
"6199",98,"[40]bIbHoIDdbBkDtGtkIdBGmrbKDaeHgHsnJHqvbGqa",202,0.990244,40,205,2,203,1,2,1,3,2,104,103,100,100,72
"6200",99,"[40]bIbHoIDdbBkDtGtkIdBGmrbKDaeHgHsnJHqvbGqa",207,0.990476,40,210,2,208,1,2,1,3,2,110,109,99,99,72
"6201",0,"[40]HIfHoIrpkBkDsCurwxAqcxbKDaehdHtnJHqvbGqa",202,0.990244,40,205,2,203,1,2,1,3,2,103,102,101,101,73
"6202",1,"[40]HIfHoIrpkBkDsCurwxAqcxbKDaehdHtnJHqvbGqa",198,0.99005,40,201,2,199,1,2,1,3,2,97,96,103,103,73
"6203",2,"[40]HIfHoIrpkBkDsCurwxAqcxbKDaehdHtnJHqvbGqa",192,0.989744,40,195,2,193,1,2,1,3,2,90,89,104,104,73
"6204",3,"[40]HIfHoIrpkBkDsCurwxAqcxbKDaehdHtnJHqvbGqa",191,0.989691,40,194,2,192,1,2,1,3,2,90,89,103,103,73
"6205",4,"[40]HIfHoIrpkBkDsCurwxAqcxbKDaehdHtnJHqvbGqa",193,0.989796,40,196,2,194,1,2,1,3,2,90,89,105,105,73
"6206",5,"[40]HIfHoIrpkBkDsCurwxAqcxbKDaehdHtnJHqvbGqa",199,0.990099,40,202,2,200,1,2,1,3,2,101,100,100,100,73
"6207",6,"[40]HIfHoIrpkBkDsCurwxAqcxbKDaehdHtnJHqvbGqa",204,0.990338,40,207,2,205,1,2,1,3,2,106,105,100,100,73
"6208",7,"[40]HIfHoIrpkBkDsCurwxAqcxbKDaehdHtnJHqvbGqa",212,0.990698,40,215,2,213,1,2,1,3,2,119,118,95,95,73
"6209",8,"[40]HIfHoIrpkBkDsCurwxAqcxbKDaehdHtnJHqvbGqa",212,0.990698,40,215,2,213,1,2,1,3,2,119,118,95,95,73
"6210",9,"[40]HIfHoIrpkBkDsCurwxAqcxbKDaehdHtnJHqvbGqa",207,0.990476,40,210,2,208,1,2,1,3,2,110,109,99,99,73
"6211",10,"[40]HIfHoIrpkBkDsCurwxAqcxbKDaehdHtnJHqvbGqa",203,0.990291,40,206,2,204,1,2,1,3,2,103,102,102,102,73
"6212",11,"[40]HIfHoIrpkBkDsCurwxAqcxbKDaehdHtnJHqvbGqa",203,0.990291,40,206,2,204,1,2,1,3,2,105,104,100,100,73
"6213",12,"[40]HIfHoIrpkBkDsCurwxAqcxbKDaehdHtnJHqvbGqa",202,0.990244,40,205,2,203,1,2,1,3,2,102,101,102,102,73
"6214",13,"[40]HIfHoIrpkBkDsCurwxAqcxbKDaehdHtnJHqvbGqa",197,0.99,40,200,2,198,1,2,1,3,2,96,95,103,103,73
"6215",14,"[40]HIfHoIrpkBkDsCurwxAqcxbKDaehdHtnJHqvbGqa",201,0.990196,40,204,2,202,1,2,1,3,2,101,100,102,102,73
"6216",15,"[40]HIfHoIrpkBkDsCurwxAqcxbKDaehdHtnJHqvbGqa",203,0.990291,40,206,2,204,1,2,1,3,2,106,105,99,99,73
"6217",16,"[40]HIfHoIrpkBkDsCurwxAqcxbKDaehdHtnJHqvbGqa",199,0.990099,40,202,2,200,1,2,1,3,2,99,98,102,102,73
"6218",17,"[40]HIfHoIrpkBkDsCurwxAqcxbKDaehdHtnJHqvbGqa",191,0.989691,40,194,2,192,1,2,1,3,2,86,85,107,107,73
"6219",18,"[40]HIfHoIrpkBkDsCurwxAqcxbKDaehdHtnJHqvbGqa",205,0.990385,40,208,2,206,1,2,1,3,2,107,106,100,100,73
"6220",19,"[40]HIfHoIrpkBkDsCurwxAqcxbKDaehdHtnJHqvbGqa",214,0.990783,40,217,2,215,1,2,1,3,2,118,117,98,98,73
"6221",20,"[40]HIfHoIrpkBkDsCurwxAqcxbKDaehdHtnJHqvbGqa",200,0.990148,40,203,2,201,1,2,1,3,2,101,100,101,101,73
"6222",21,"[40]HIfHoIrpkBkDsCurwxAqcxbKDaehdHtnJHqvbGqa",205,0.990385,40,208,2,206,1,2,1,3,2,107,106,100,100,73
"6223",22,"[40]HIfHoIrpkBkDsCurwxAqcxbKDaehdHtnJHqvbGqa",192,0.989744,40,195,2,193,1,2,1,3,2,91,90,103,103,73
"6224",23,"[40]HIfHoIrpkBkDsCurwxAqcxbKDaehdHtnJHqvbGqa",197,0.99,40,200,2,198,1,2,1,3,2,97,96,102,102,73
"6225",24,"[40]HIfHoIrpkBkDsCurwxAqcxbKDaehdHtnJHqvbGqa",185,0.989362,40,188,2,186,1,2,1,3,2,81,80,106,106,73
"6226",25,"[40]HIfHoIrpkBkDsCurwxAqcxbKDaehdHtnJHqvbGqa",192,0.989744,40,195,2,193,1,2,1,3,2,90,89,104,104,73
"6227",26,"[40]HIfHoIrpkBkDsCurwxAqcxbKDaehdHtnJHqvbGqa",203,0.990291,40,206,2,204,1,2,1,3,2,105,104,100,100,73
"6228",27,"[40]HIfHoIrpkBkDsCurwxAqcxbKDaehdHtnJHqvbGqa",204,0.990338,40,207,2,205,1,2,1,3,2,106,105,100,100,73
"6229",28,"[40]HIfHoIrpkBkDsCurwxAqcxbKDaehdHtnJHqvbGqa",191,0.989691,40,194,2,192,1,2,1,3,2,91,90,102,102,73
"6230",29,"[40]HIfHoIrpkBkDsCurwxAqcxbKDaehdHtnJHqvbGqa",197,0.99,40,200,2,198,1,2,1,3,2,95,94,104,104,73
"6231",30,"[40]HIfHoIrpkBkDsCurwxAqcxbKDaehdHtnJHqvbGqa",183,0.989247,40,186,2,184,1,2,1,3,2,79,78,106,106,73
"6232",31,"[40]HIfHoIrpkBkDsCurwxAqcxbKDaehdHtnJHqvbGqa",199,0.990099,40,202,2,200,1,2,1,3,2,101,100,100,100,73
"6233",32,"[40]HIfHoIrpkBkDsCurwxAqcxbKDaehdHtnJHqvbGqa",196,0.98995,40,199,2,197,1,2,1,3,2,95,94,103,103,73
"6234",33,"[40]HIfHoIrpkBkDsCurwxAqcxbKDaehdHtnJHqvbGqa",212,0.990698,40,215,2,213,1,2,1,3,2,119,118,95,95,73
"6235",34,"[40]HIfHoIrpkBkDsCurwxAqcxbKDaehdHtnJHqvbGqa",189,0.989583,40,192,2,190,1,2,1,3,2,84,83,107,107,73
"6236",35,"[40]HIfHoIrpkBkDsCurwxAqcxbKDaehdHtnJHqvbGqa",208,0.990521,40,211,2,209,1,2,1,3,2,112,111,98,98,73
"6237",36,"[40]HIfHoIrpkBkDsCurwxAqcxbKDaehdHtnJHqvbGqa",217,0.990909,40,220,2,218,1,2,1,3,2,122,121,97,97,73
"6238",37,"[40]HIfHoIrpkBkDsCurwxAqcxbKDaehdHtnJHqvbGqa",199,0.990099,40,202,2,200,1,2,1,3,2,100,99,101,101,73
"6239",38,"[40]HIfHoIrpkBkDsCurwxAqcxbKDaehdHtnJHqvbGqa",212,0.990698,40,215,2,213,1,2,1,3,2,119,118,95,95,73
"6240",39,"[40]HIfHoIrpkBkDsCurwxAqcxbKDaehdHtnJHqvbGqa",201,0.990196,40,204,2,202,1,2,1,3,2,101,100,102,102,73
"6241",40,"[40]HIfHoIrpkBkDsCurwxAqcxbKDaehdHtnJHqvbGqa",206,0.990431,40,209,2,207,1,2,1,3,2,112,111,96,96,73
"6242",41,"[40]HIfHoIrpkBkDsCurwxAqcxbKDaehdHtnJHqvbGqa",208,0.990521,40,211,2,209,1,2,1,3,2,111,110,99,99,73
"6243",42,"[40]HIfHoIrpkBkDsCurwxAqcxbKDaehdHtnJHqvbGqa",207,0.990476,40,210,2,208,1,2,1,3,2,110,109,99,99,73
"6244",43,"[40]HIfHoIrpkBkDsCurwxAqcxbKDaehdHtnJHqvbGqa",203,0.990291,40,206,2,204,1,2,1,3,2,104,103,101,101,73
"6245",44,"[40]HIfHoIrpkBkDsCurwxAqcxbKDaehdHtnJHqvbGqa",205,0.990385,40,208,2,206,1,2,1,3,2,104,103,103,103,73
"6246",45,"[40]HIfHoIrpkBkDsCurwxAqcxbKDaehdHtnJHqvbGqa",214,0.990783,40,217,2,215,1,2,1,3,2,122,121,94,94,73
"6247",46,"[40]HIfHoIrpkBkDsCurwxAqcxbKDaehdHtnJHqvbGqa",205,0.990385,40,208,2,206,1,2,1,3,2,107,106,100,100,73
"6248",47,"[40]HIfHoIrpkBkDsCurwxAqcxbKDaehdHtnJHqvbGqa",211,0.990654,40,214,2,212,1,2,1,3,2,117,116,96,96,73
"6249",48,"[40]HIfHoIrpkBkDsCurwxAqcxbKDaehdHtnJHqvbGqa",206,0.990431,40,209,2,207,1,2,1,3,2,111,110,97,97,73
"6250",49,"[40]HIfHoIrpkBkDsCurwxAqcxbKDaehdHtnJHqvbGqa",191,0.989691,40,194,2,192,1,2,1,3,2,87,86,106,106,73
"6251",50,"[40]HIfHoIrpkBkDsCurwxAqcxbKDaehdHtnJHqvbGqa",201,0.990196,40,204,2,202,1,2,1,3,2,105,104,98,98,73
"6252",51,"[40]HIfHoIrpkBkDsCurwxAqcxbKDaehdHtnJHqvbGqa",199,0.990099,40,202,2,200,1,2,1,3,2,98,97,103,103,73
"6253",52,"[40]HIfHoIrpkBkDsCurwxAqcxbKDaehdHtnJHqvbGqa",195,0.989899,40,198,2,196,1,2,1,3,2,94,93,103,103,73
"6254",53,"[40]HIfHoIrpkBkDsCurwxAqcxbKDaehdHtnJHqvbGqa",206,0.990431,40,209,2,207,1,2,1,3,2,109,108,99,99,73
"6255",54,"[40]HIfHoIrpkBkDsCurwxAqcxbKDaehdHtnJHqvbGqa",202,0.990244,40,205,2,203,1,2,1,3,2,103,102,101,101,73
"6256",55,"[40]HIfHoIrpkBkDsCurwxAqcxbKDaehdHtnJHqvbGqa",194,0.989848,40,197,2,195,1,2,1,3,2,94,93,102,102,73
"6257",56,"[40]HIfHoIrpkBkDsCurwxAqcxbKDaehdHtnJHqvbGqa",194,0.989848,40,197,2,195,1,2,1,3,2,94,93,102,102,73
"6258",57,"[40]HIfHoIrpkBkDsCurwxAqcxbKDaehdHtnJHqvbGqa",198,0.99005,40,201,2,199,1,2,1,3,2,97,96,103,103,73
"6259",58,"[40]HIfHoIrpkBkDsCurwxAqcxbKDaehdHtnJHqvbGqa",198,0.99005,40,201,2,199,1,2,1,3,2,98,97,102,102,73
"6260",59,"[40]HIfHoIrpkBkDsCurwxAqcxbKDaehdHtnJHqvbGqa",211,0.990654,40,214,2,212,1,2,1,3,2,118,117,95,95,73
"6261",60,"[40]HIfHoIrpkBkDsCurwxAqcxbKDaehdHtnJHqvbGqa",195,0.989899,40,198,2,196,1,2,1,3,2,91,90,106,106,73
"6262",61,"[40]HIfHoIrpkBkDsCurwxAqcxbKDaehdHtnJHqvbGqa",204,0.990338,40,207,2,205,1,2,1,3,2,107,106,99,99,73
"6263",62,"[40]HIfHoIrpkBkDsCurwxAqcxbKDaehdHtnJHqvbGqa",208,0.990521,40,211,2,209,1,2,1,3,2,111,110,99,99,73
"6264",63,"[40]HIfHoIrpkBkDsCurwxAqcxbKDaehdHtnJHqvbGqa",203,0.990291,40,206,2,204,1,2,1,3,2,105,104,100,100,73
"6265",64,"[40]HIfHoIrpkBkDsCurwxAqcxbKDaehdHtnJHqvbGqa",210,0.99061,40,213,2,211,1,2,1,3,2,112,111,100,100,73
"6266",65,"[40]HIfHoIrpkBkDsCurwxAqcxbKDaehdHtnJHqvbGqa",208,0.990521,40,211,2,209,1,2,1,3,2,112,111,98,98,73
"6267",66,"[40]HIfHoIrpkBkDsCurwxAqcxbKDaehdHtnJHqvbGqa",200,0.990148,40,203,2,201,1,2,1,3,2,102,101,100,100,73
"6268",67,"[40]HIfHoIrpkBkDsCurwxAqcxbKDaehdHtnJHqvbGqa",204,0.990338,40,207,2,205,1,2,1,3,2,104,103,102,102,73
"6269",68,"[40]HIfHoIrpkBkDsCurwxAqcxbKDaehdHtnJHqvbGqa",201,0.990196,40,204,2,202,1,2,1,3,2,104,103,99,99,73
"6270",69,"[40]HIfHoIrpkBkDsCurwxAqcxbKDaehdHtnJHqvbGqa",201,0.990196,40,204,2,202,1,2,1,3,2,102,101,101,101,73
"6271",70,"[40]HIfHoIrpkBkDsCurwxAqcxbKDaehdHtnJHqvbGqa",193,0.989796,40,196,2,194,1,2,1,3,2,91,90,104,104,73
"6272",71,"[40]HIfHoIrpkBkDsCurwxAqcxbKDaehdHtnJHqvbGqa",184,0.989305,40,187,2,185,1,2,1,3,2,79,78,107,107,73
"6273",72,"[40]HIfHoIrpkBkDsCurwxAqcxbKDaehdHtnJHqvbGqa",195,0.989899,40,198,2,196,1,2,1,3,2,94,93,103,103,73
"6274",73,"[40]HIfHoIrpkBkDsCurwxAqcxbKDaehdHtnJHqvbGqa",204,0.990338,40,207,2,205,1,2,1,3,2,109,108,97,97,73
"6275",74,"[40]HIfHoIrpkBkDsCurwxAqcxbKDaehdHtnJHqvbGqa",192,0.989744,40,195,2,193,1,2,1,3,2,93,92,101,101,73
"6276",75,"[40]HIfHoIrpkBkDsCurwxAqcxbKDaehdHtnJHqvbGqa",195,0.989899,40,198,2,196,1,2,1,3,2,94,93,103,103,73
"6277",76,"[40]HIfHoIrpkBkDsCurwxAqcxbKDaehdHtnJHqvbGqa",205,0.990385,40,208,2,206,1,2,1,3,2,108,107,99,99,73
"6278",77,"[40]HIfHoIrpkBkDsCurwxAqcxbKDaehdHtnJHqvbGqa",196,0.98995,40,199,2,197,1,2,1,3,2,94,93,104,104,73
"6279",78,"[40]HIfHoIrpkBkDsCurwxAqcxbKDaehdHtnJHqvbGqa",195,0.989899,40,198,2,196,1,2,1,3,2,92,91,105,105,73
"6280",79,"[40]HIfHoIrpkBkDsCurwxAqcxbKDaehdHtnJHqvbGqa",202,0.990244,40,205,2,203,1,2,1,3,2,102,101,102,102,73
"6281",80,"[40]HIfHoIrpkBkDsCurwxAqcxbKDaehdHtnJHqvbGqa",190,0.989637,40,193,2,191,1,2,1,3,2,88,87,104,104,73
"6282",81,"[40]HIfHoIrpkBkDsCurwxAqcxbKDaehdHtnJHqvbGqa",187,0.989474,40,190,2,188,1,2,1,3,2,83,82,106,106,73
"6283",82,"[40]HIfHoIrpkBkDsCurwxAqcxbKDaehdHtnJHqvbGqa",203,0.990291,40,206,2,204,1,2,1,3,2,107,106,98,98,73
"6284",83,"[40]HIfHoIrpkBkDsCurwxAqcxbKDaehdHtnJHqvbGqa",197,0.99,40,200,2,198,1,2,1,3,2,96,95,103,103,73
"6285",84,"[40]HIfHoIrpkBkDsCurwxAqcxbKDaehdHtnJHqvbGqa",213,0.990741,40,216,2,214,1,2,1,3,2,119,118,96,96,73
"6286",85,"[40]HIfHoIrpkBkDsCurwxAqcxbKDaehdHtnJHqvbGqa",201,0.990196,40,204,2,202,1,2,1,3,2,99,98,104,104,73
"6287",86,"[40]HIfHoIrpkBkDsCurwxAqcxbKDaehdHtnJHqvbGqa",201,0.990196,40,204,2,202,1,2,1,3,2,103,102,100,100,73
"6288",87,"[40]HIfHoIrpkBkDsCurwxAqcxbKDaehdHtnJHqvbGqa",201,0.990196,40,204,2,202,1,2,1,3,2,103,102,100,100,73
"6289",88,"[40]HIfHoIrpkBkDsCurwxAqcxbKDaehdHtnJHqvbGqa",201,0.990196,40,204,2,202,1,2,1,3,2,101,100,102,102,73
"6290",89,"[40]HIfHoIrpkBkDsCurwxAqcxbKDaehdHtnJHqvbGqa",210,0.99061,40,213,2,211,1,2,1,3,2,115,114,97,97,73
"6291",90,"[40]HIfHoIrpkBkDsCurwxAqcxbKDaehdHtnJHqvbGqa",203,0.990291,40,206,2,204,1,2,1,3,2,105,104,100,100,73
"6292",91,"[40]HIfHoIrpkBkDsCurwxAqcxbKDaehdHtnJHqvbGqa",192,0.989744,40,195,2,193,1,2,1,3,2,90,89,104,104,73
"6293",92,"[40]HIfHoIrpkBkDsCurwxAqcxbKDaehdHtnJHqvbGqa",203,0.990291,40,206,2,204,1,2,1,3,2,104,103,101,101,73
"6294",93,"[40]HIfHoIrpkBkDsCurwxAqcxbKDaehdHtnJHqvbGqa",184,0.989305,40,187,2,185,1,2,1,3,2,81,80,105,105,73
"6295",94,"[40]HIfHoIrpkBkDsCurwxAqcxbKDaehdHtnJHqvbGqa",184,0.989305,40,187,2,185,1,2,1,3,2,79,78,107,107,73
"6296",95,"[40]HIfHoIrpkBkDsCurwxAqcxbKDaehdHtnJHqvbGqa",208,0.990521,40,211,2,209,1,2,1,3,2,112,111,98,98,73
"6297",96,"[40]HIfHoIrpkBkDsCurwxAqcxbKDaehdHtnJHqvbGqa",214,0.990783,40,217,2,215,1,2,1,3,2,120,119,96,96,73
"6298",97,"[40]HIfHoIrpkBkDsCurwxAqcxbKDaehdHtnJHqvbGqa",202,0.990244,40,205,2,203,1,2,1,3,2,102,101,102,102,73
"6299",98,"[40]HIfHoIrpkBkDsCurwxAqcxbKDaehdHtnJHqvbGqa",196,0.98995,40,199,2,197,1,2,1,3,2,96,95,102,102,73
"6300",99,"[40]HIfHoIrpkBkDsCurwxAqcxbKDaehdHtnJHqvbGqa",192,0.989744,40,195,2,193,1,2,1,3,2,89,88,105,105,73
"6301",0,"[40]IFqHoIppnBkDzcjHKCvbzhbKDaegFHvnJHqvbGqa",194,0.989848,40,197,2,195,1,2,1,3,2,94,93,102,102,74
"6302",1,"[40]IFqHoIppnBkDzcjHKCvbzhbKDaegFHvnJHqvbGqa",194,0.989848,40,197,2,195,1,2,1,3,2,91,90,105,105,74
"6303",2,"[40]IFqHoIppnBkDzcjHKCvbzhbKDaegFHvnJHqvbGqa",198,0.99005,40,201,2,199,1,2,1,3,2,97,96,103,103,74
"6304",3,"[40]IFqHoIppnBkDzcjHKCvbzhbKDaegFHvnJHqvbGqa",199,0.990099,40,202,2,200,1,2,1,3,2,99,98,102,102,74
"6305",4,"[40]IFqHoIppnBkDzcjHKCvbzhbKDaegFHvnJHqvbGqa",194,0.989848,40,197,2,195,1,2,1,3,2,91,90,105,105,74
"6306",5,"[40]IFqHoIppnBkDzcjHKCvbzhbKDaegFHvnJHqvbGqa",199,0.990099,40,202,2,200,1,2,1,3,2,99,98,102,102,74
"6307",6,"[40]IFqHoIppnBkDzcjHKCvbzhbKDaegFHvnJHqvbGqa",195,0.989899,40,198,2,196,1,2,1,3,2,93,92,104,104,74
"6308",7,"[40]IFqHoIppnBkDzcjHKCvbzhbKDaegFHvnJHqvbGqa",202,0.990244,40,205,2,203,1,2,1,3,2,106,105,98,98,74
"6309",8,"[40]IFqHoIppnBkDzcjHKCvbzhbKDaegFHvnJHqvbGqa",205,0.990385,40,208,2,206,1,2,1,3,2,106,105,101,101,74
"6310",9,"[40]IFqHoIppnBkDzcjHKCvbzhbKDaegFHvnJHqvbGqa",212,0.990698,40,215,2,213,1,2,1,3,2,119,118,95,95,74
"6311",10,"[40]IFqHoIppnBkDzcjHKCvbzhbKDaegFHvnJHqvbGqa",201,0.990196,40,204,2,202,1,2,1,3,2,100,99,103,103,74
"6312",11,"[40]IFqHoIppnBkDzcjHKCvbzhbKDaegFHvnJHqvbGqa",204,0.990338,40,207,2,205,1,2,1,3,2,108,107,98,98,74
"6313",12,"[40]IFqHoIppnBkDzcjHKCvbzhbKDaegFHvnJHqvbGqa",204,0.990338,40,207,2,205,1,2,1,3,2,105,104,101,101,74
"6314",13,"[40]IFqHoIppnBkDzcjHKCvbzhbKDaegFHvnJHqvbGqa",196,0.98995,40,199,2,197,1,2,1,3,2,96,95,102,102,74
"6315",14,"[40]IFqHoIppnBkDzcjHKCvbzhbKDaegFHvnJHqvbGqa",202,0.990244,40,205,2,203,1,2,1,3,2,105,104,99,99,74
"6316",15,"[40]IFqHoIppnBkDzcjHKCvbzhbKDaegFHvnJHqvbGqa",206,0.990431,40,209,2,207,1,2,1,3,2,108,107,100,100,74
"6317",16,"[40]IFqHoIppnBkDzcjHKCvbzhbKDaegFHvnJHqvbGqa",206,0.990431,40,209,2,207,1,2,1,3,2,110,109,98,98,74
"6318",17,"[40]IFqHoIppnBkDzcjHKCvbzhbKDaegFHvnJHqvbGqa",211,0.990654,40,214,2,212,1,2,1,3,2,115,114,98,98,74
"6319",18,"[40]IFqHoIppnBkDzcjHKCvbzhbKDaegFHvnJHqvbGqa",185,0.989362,40,188,2,186,1,2,1,3,2,80,79,107,107,74
"6320",19,"[40]IFqHoIppnBkDzcjHKCvbzhbKDaegFHvnJHqvbGqa",204,0.990338,40,207,2,205,1,2,1,3,2,107,106,99,99,74
"6321",20,"[40]IFqHoIppnBkDzcjHKCvbzhbKDaegFHvnJHqvbGqa",203,0.990291,40,206,2,204,1,2,1,3,2,104,103,101,101,74
"6322",21,"[40]IFqHoIppnBkDzcjHKCvbzhbKDaegFHvnJHqvbGqa",201,0.990196,40,204,2,202,1,2,1,3,2,102,101,101,101,74
"6323",22,"[40]IFqHoIppnBkDzcjHKCvbzhbKDaegFHvnJHqvbGqa",200,0.990148,40,203,2,201,1,2,1,3,2,104,103,98,98,74
"6324",23,"[40]IFqHoIppnBkDzcjHKCvbzhbKDaegFHvnJHqvbGqa",199,0.990099,40,202,2,200,1,2,1,3,2,101,100,100,100,74
"6325",24,"[40]IFqHoIppnBkDzcjHKCvbzhbKDaegFHvnJHqvbGqa",213,0.990741,40,216,2,214,1,2,1,3,2,122,121,93,93,74
"6326",25,"[40]IFqHoIppnBkDzcjHKCvbzhbKDaegFHvnJHqvbGqa",186,0.989418,40,189,2,187,1,2,1,3,2,80,79,108,108,74
"6327",26,"[40]IFqHoIppnBkDzcjHKCvbzhbKDaegFHvnJHqvbGqa",193,0.989796,40,196,2,194,1,2,1,3,2,91,90,104,104,74
"6328",27,"[40]IFqHoIppnBkDzcjHKCvbzhbKDaegFHvnJHqvbGqa",205,0.990385,40,208,2,206,1,2,1,3,2,107,106,100,100,74
"6329",28,"[40]IFqHoIppnBkDzcjHKCvbzhbKDaegFHvnJHqvbGqa",208,0.990521,40,211,2,209,1,2,1,3,2,112,111,98,98,74
"6330",29,"[40]IFqHoIppnBkDzcjHKCvbzhbKDaegFHvnJHqvbGqa",193,0.989796,40,196,2,194,1,2,1,3,2,93,92,102,102,74
"6331",30,"[40]IFqHoIppnBkDzcjHKCvbzhbKDaegFHvnJHqvbGqa",207,0.990476,40,210,2,208,1,2,1,3,2,108,107,101,101,74
"6332",31,"[40]IFqHoIppnBkDzcjHKCvbzhbKDaegFHvnJHqvbGqa",201,0.990196,40,204,2,202,1,2,1,3,2,103,102,100,100,74
"6333",32,"[40]IFqHoIppnBkDzcjHKCvbzhbKDaegFHvnJHqvbGqa",197,0.99,40,200,2,198,1,2,1,3,2,99,98,100,100,74
"6334",33,"[40]IFqHoIppnBkDzcjHKCvbzhbKDaegFHvnJHqvbGqa",199,0.990099,40,202,2,200,1,2,1,3,2,100,99,101,101,74
"6335",34,"[40]IFqHoIppnBkDzcjHKCvbzhbKDaegFHvnJHqvbGqa",192,0.989744,40,195,2,193,1,2,1,3,2,89,88,105,105,74
"6336",35,"[40]IFqHoIppnBkDzcjHKCvbzhbKDaegFHvnJHqvbGqa",207,0.990476,40,210,2,208,1,2,1,3,2,111,110,98,98,74
"6337",36,"[40]IFqHoIppnBkDzcjHKCvbzhbKDaegFHvnJHqvbGqa",190,0.989637,40,193,2,191,1,2,1,3,2,87,86,105,105,74
"6338",37,"[40]IFqHoIppnBkDzcjHKCvbzhbKDaegFHvnJHqvbGqa",200,0.990148,40,203,2,201,1,2,1,3,2,101,100,101,101,74
"6339",38,"[40]IFqHoIppnBkDzcjHKCvbzhbKDaegFHvnJHqvbGqa",218,0.99095,40,221,2,219,1,2,1,3,2,125,124,95,95,74
"6340",39,"[40]IFqHoIppnBkDzcjHKCvbzhbKDaegFHvnJHqvbGqa",204,0.990338,40,207,2,205,1,2,1,3,2,108,107,98,98,74
"6341",40,"[40]IFqHoIppnBkDzcjHKCvbzhbKDaegFHvnJHqvbGqa",190,0.989637,40,193,2,191,1,2,1,3,2,87,86,105,105,74
"6342",41,"[40]IFqHoIppnBkDzcjHKCvbzhbKDaegFHvnJHqvbGqa",210,0.99061,40,213,2,211,1,2,1,3,2,116,115,96,96,74
"6343",42,"[40]IFqHoIppnBkDzcjHKCvbzhbKDaegFHvnJHqvbGqa",184,0.989305,40,187,2,185,1,2,1,3,2,78,77,108,108,74
"6344",43,"[40]IFqHoIppnBkDzcjHKCvbzhbKDaegFHvnJHqvbGqa",211,0.990654,40,214,2,212,1,2,1,3,2,115,114,98,98,74
"6345",44,"[40]IFqHoIppnBkDzcjHKCvbzhbKDaegFHvnJHqvbGqa",206,0.990431,40,209,2,207,1,2,1,3,2,107,106,101,101,74
"6346",45,"[40]IFqHoIppnBkDzcjHKCvbzhbKDaegFHvnJHqvbGqa",208,0.990521,40,211,2,209,1,2,1,3,2,114,113,96,96,74
"6347",46,"[40]IFqHoIppnBkDzcjHKCvbzhbKDaegFHvnJHqvbGqa",200,0.990148,40,203,2,201,1,2,1,3,2,98,97,104,104,74
"6348",47,"[40]IFqHoIppnBkDzcjHKCvbzhbKDaegFHvnJHqvbGqa",218,0.99095,40,221,2,219,1,2,1,3,2,125,124,95,95,74
"6349",48,"[40]IFqHoIppnBkDzcjHKCvbzhbKDaegFHvnJHqvbGqa",208,0.990521,40,211,2,209,1,2,1,3,2,112,111,98,98,74
"6350",49,"[40]IFqHoIppnBkDzcjHKCvbzhbKDaegFHvnJHqvbGqa",200,0.990148,40,203,2,201,1,2,1,3,2,103,102,99,99,74
"6351",50,"[40]IFqHoIppnBkDzcjHKCvbzhbKDaegFHvnJHqvbGqa",209,0.990566,40,212,2,210,1,2,1,3,2,113,112,98,98,74
"6352",51,"[40]IFqHoIppnBkDzcjHKCvbzhbKDaegFHvnJHqvbGqa",196,0.98995,40,199,2,197,1,2,1,3,2,95,94,103,103,74
"6353",52,"[40]IFqHoIppnBkDzcjHKCvbzhbKDaegFHvnJHqvbGqa",206,0.990431,40,209,2,207,1,2,1,3,2,109,108,99,99,74
"6354",53,"[40]IFqHoIppnBkDzcjHKCvbzhbKDaegFHvnJHqvbGqa",200,0.990148,40,203,2,201,1,2,1,3,2,102,101,100,100,74
"6355",54,"[40]IFqHoIppnBkDzcjHKCvbzhbKDaegFHvnJHqvbGqa",189,0.989583,40,192,2,190,1,2,1,3,2,86,85,105,105,74
"6356",55,"[40]IFqHoIppnBkDzcjHKCvbzhbKDaegFHvnJHqvbGqa",201,0.990196,40,204,2,202,1,2,1,3,2,101,100,102,102,74
"6357",56,"[40]IFqHoIppnBkDzcjHKCvbzhbKDaegFHvnJHqvbGqa",198,0.99005,40,201,2,199,1,2,1,3,2,99,98,101,101,74
"6358",57,"[40]IFqHoIppnBkDzcjHKCvbzhbKDaegFHvnJHqvbGqa",203,0.990291,40,206,2,204,1,2,1,3,2,105,104,100,100,74
"6359",58,"[40]IFqHoIppnBkDzcjHKCvbzhbKDaegFHvnJHqvbGqa",204,0.990338,40,207,2,205,1,2,1,3,2,106,105,100,100,74
"6360",59,"[40]IFqHoIppnBkDzcjHKCvbzhbKDaegFHvnJHqvbGqa",210,0.99061,40,213,2,211,1,2,1,3,2,116,115,96,96,74
"6361",60,"[40]IFqHoIppnBkDzcjHKCvbzhbKDaegFHvnJHqvbGqa",179,0.989011,40,182,2,180,1,2,1,3,2,72,71,109,109,74
"6362",61,"[40]IFqHoIppnBkDzcjHKCvbzhbKDaegFHvnJHqvbGqa",193,0.989796,40,196,2,194,1,2,1,3,2,90,89,105,105,74
"6363",62,"[40]IFqHoIppnBkDzcjHKCvbzhbKDaegFHvnJHqvbGqa",185,0.989362,40,188,2,186,1,2,1,3,2,81,80,106,106,74
"6364",63,"[40]IFqHoIppnBkDzcjHKCvbzhbKDaegFHvnJHqvbGqa",199,0.990099,40,202,2,200,1,2,1,3,2,99,98,102,102,74
"6365",64,"[40]IFqHoIppnBkDzcjHKCvbzhbKDaegFHvnJHqvbGqa",221,0.991071,40,224,2,222,1,2,1,3,2,132,131,91,91,74
"6366",65,"[40]IFqHoIppnBkDzcjHKCvbzhbKDaegFHvnJHqvbGqa",187,0.989474,40,190,2,188,1,2,1,3,2,85,84,104,104,74
"6367",66,"[40]IFqHoIppnBkDzcjHKCvbzhbKDaegFHvnJHqvbGqa",201,0.990196,40,204,2,202,1,2,1,3,2,101,100,102,102,74
"6368",67,"[40]IFqHoIppnBkDzcjHKCvbzhbKDaegFHvnJHqvbGqa",196,0.98995,40,199,2,197,1,2,1,3,2,96,95,102,102,74
"6369",68,"[40]IFqHoIppnBkDzcjHKCvbzhbKDaegFHvnJHqvbGqa",194,0.989848,40,197,2,195,1,2,1,3,2,92,91,104,104,74
"6370",69,"[40]IFqHoIppnBkDzcjHKCvbzhbKDaegFHvnJHqvbGqa",191,0.989691,40,194,2,192,1,2,1,3,2,88,87,105,105,74
"6371",70,"[40]IFqHoIppnBkDzcjHKCvbzhbKDaegFHvnJHqvbGqa",205,0.990385,40,208,2,206,1,2,1,3,2,109,108,98,98,74
"6372",71,"[40]IFqHoIppnBkDzcjHKCvbzhbKDaegFHvnJHqvbGqa",206,0.990431,40,209,2,207,1,2,1,3,2,106,105,102,102,74
"6373",72,"[40]IFqHoIppnBkDzcjHKCvbzhbKDaegFHvnJHqvbGqa",200,0.990148,40,203,2,201,1,2,1,3,2,99,98,103,103,74
"6374",73,"[40]IFqHoIppnBkDzcjHKCvbzhbKDaegFHvnJHqvbGqa",196,0.98995,40,199,2,197,1,2,1,3,2,94,93,104,104,74
"6375",74,"[40]IFqHoIppnBkDzcjHKCvbzhbKDaegFHvnJHqvbGqa",191,0.989691,40,194,2,192,1,2,1,3,2,90,89,103,103,74
"6376",75,"[40]IFqHoIppnBkDzcjHKCvbzhbKDaegFHvnJHqvbGqa",208,0.990521,40,211,2,209,1,2,1,3,2,114,113,96,96,74
"6377",76,"[40]IFqHoIppnBkDzcjHKCvbzhbKDaegFHvnJHqvbGqa",184,0.989305,40,187,2,185,1,2,1,3,2,82,81,104,104,74
"6378",77,"[40]IFqHoIppnBkDzcjHKCvbzhbKDaegFHvnJHqvbGqa",198,0.99005,40,201,2,199,1,2,1,3,2,98,97,102,102,74
"6379",78,"[40]IFqHoIppnBkDzcjHKCvbzhbKDaegFHvnJHqvbGqa",186,0.989418,40,189,2,187,1,2,1,3,2,81,80,107,107,74
"6380",79,"[40]IFqHoIppnBkDzcjHKCvbzhbKDaegFHvnJHqvbGqa",207,0.990476,40,210,2,208,1,2,1,3,2,109,108,100,100,74
"6381",80,"[40]IFqHoIppnBkDzcjHKCvbzhbKDaegFHvnJHqvbGqa",215,0.990826,40,218,2,216,1,2,1,3,2,121,120,96,96,74
"6382",81,"[40]IFqHoIppnBkDzcjHKCvbzhbKDaegFHvnJHqvbGqa",200,0.990148,40,203,2,201,1,2,1,3,2,101,100,101,101,74
"6383",82,"[40]IFqHoIppnBkDzcjHKCvbzhbKDaegFHvnJHqvbGqa",198,0.99005,40,201,2,199,1,2,1,3,2,101,100,99,99,74
"6384",83,"[40]IFqHoIppnBkDzcjHKCvbzhbKDaegFHvnJHqvbGqa",196,0.98995,40,199,2,197,1,2,1,3,2,95,94,103,103,74
"6385",84,"[40]IFqHoIppnBkDzcjHKCvbzhbKDaegFHvnJHqvbGqa",198,0.99005,40,201,2,199,1,2,1,3,2,96,95,104,104,74
"6386",85,"[40]IFqHoIppnBkDzcjHKCvbzhbKDaegFHvnJHqvbGqa",202,0.990244,40,205,2,203,1,2,1,3,2,102,101,102,102,74
"6387",86,"[40]IFqHoIppnBkDzcjHKCvbzhbKDaegFHvnJHqvbGqa",199,0.990099,40,202,2,200,1,2,1,3,2,98,97,103,103,74
"6388",87,"[40]IFqHoIppnBkDzcjHKCvbzhbKDaegFHvnJHqvbGqa",190,0.989637,40,193,2,191,1,2,1,3,2,89,88,103,103,74
"6389",88,"[40]IFqHoIppnBkDzcjHKCvbzhbKDaegFHvnJHqvbGqa",195,0.989899,40,198,2,196,1,2,1,3,2,94,93,103,103,74
"6390",89,"[40]IFqHoIppnBkDzcjHKCvbzhbKDaegFHvnJHqvbGqa",209,0.990566,40,212,2,210,1,2,1,3,2,111,110,100,100,74
"6391",90,"[40]IFqHoIppnBkDzcjHKCvbzhbKDaegFHvnJHqvbGqa",209,0.990566,40,212,2,210,1,2,1,3,2,114,113,97,97,74
"6392",91,"[40]IFqHoIppnBkDzcjHKCvbzhbKDaegFHvnJHqvbGqa",193,0.989796,40,196,2,194,1,2,1,3,2,92,91,103,103,74
"6393",92,"[40]IFqHoIppnBkDzcjHKCvbzhbKDaegFHvnJHqvbGqa",206,0.990431,40,209,2,207,1,2,1,3,2,111,110,97,97,74
"6394",93,"[40]IFqHoIppnBkDzcjHKCvbzhbKDaegFHvnJHqvbGqa",204,0.990338,40,207,2,205,1,2,1,3,2,109,108,97,97,74
"6395",94,"[40]IFqHoIppnBkDzcjHKCvbzhbKDaegFHvnJHqvbGqa",201,0.990196,40,204,2,202,1,2,1,3,2,103,102,100,100,74
"6396",95,"[40]IFqHoIppnBkDzcjHKCvbzhbKDaegFHvnJHqvbGqa",212,0.990698,40,215,2,213,1,2,1,3,2,117,116,97,97,74
"6397",96,"[40]IFqHoIppnBkDzcjHKCvbzhbKDaegFHvnJHqvbGqa",194,0.989848,40,197,2,195,1,2,1,3,2,92,91,104,104,74
"6398",97,"[40]IFqHoIppnBkDzcjHKCvbzhbKDaegFHvnJHqvbGqa",199,0.990099,40,202,2,200,1,2,1,3,2,99,98,102,102,74
"6399",98,"[40]IFqHoIppnBkDzcjHKCvbzhbKDaegFHvnJHqvbGqa",195,0.989899,40,198,2,196,1,2,1,3,2,92,91,105,105,74
"6400",99,"[40]IFqHoIppnBkDzcjHKCvbzhbKDaegFHvnJHqvbGqa",206,0.990431,40,209,2,207,1,2,1,3,2,111,110,97,97,74
"6401",0,"[40]AIjHoIcwdBkDqfeGglKtFibKDeeemHsnJHqvbGqa",187,0.989474,40,190,2,188,1,2,1,3,2,82,81,107,107,75
"6402",1,"[40]AIjHoIcwdBkDqfeGglKtFibKDeeemHsnJHqvbGqa",194,0.989848,40,197,2,195,1,2,1,3,2,93,92,103,103,75
"6403",2,"[40]AIjHoIcwdBkDqfeGglKtFibKDeeemHsnJHqvbGqa",221,0.991071,40,224,2,222,1,2,1,3,2,128,127,95,95,75
"6404",3,"[40]AIjHoIcwdBkDqfeGglKtFibKDeeemHsnJHqvbGqa",206,0.990431,40,209,2,207,1,2,1,3,2,112,111,96,96,75
"6405",4,"[40]AIjHoIcwdBkDqfeGglKtFibKDeeemHsnJHqvbGqa",204,0.990338,40,207,2,205,1,2,1,3,2,108,107,98,98,75
"6406",5,"[40]AIjHoIcwdBkDqfeGglKtFibKDeeemHsnJHqvbGqa",203,0.990291,40,206,2,204,1,2,1,3,2,103,102,102,102,75
"6407",6,"[40]AIjHoIcwdBkDqfeGglKtFibKDeeemHsnJHqvbGqa",199,0.990099,40,202,2,200,1,2,1,3,2,99,98,102,102,75
"6408",7,"[40]AIjHoIcwdBkDqfeGglKtFibKDeeemHsnJHqvbGqa",215,0.990826,40,218,2,216,1,2,1,3,2,122,121,95,95,75
"6409",8,"[40]AIjHoIcwdBkDqfeGglKtFibKDeeemHsnJHqvbGqa",209,0.990566,40,212,2,210,1,2,1,3,2,114,113,97,97,75
"6410",9,"[40]AIjHoIcwdBkDqfeGglKtFibKDeeemHsnJHqvbGqa",203,0.990291,40,206,2,204,1,2,1,3,2,104,103,101,101,75
"6411",10,"[40]AIjHoIcwdBkDqfeGglKtFibKDeeemHsnJHqvbGqa",189,0.989583,40,192,2,190,1,2,1,3,2,87,86,104,104,75
"6412",11,"[40]AIjHoIcwdBkDqfeGglKtFibKDeeemHsnJHqvbGqa",203,0.990291,40,206,2,204,1,2,1,3,2,106,105,99,99,75
"6413",12,"[40]AIjHoIcwdBkDqfeGglKtFibKDeeemHsnJHqvbGqa",206,0.990431,40,209,2,207,1,2,1,3,2,107,106,101,101,75
"6414",13,"[40]AIjHoIcwdBkDqfeGglKtFibKDeeemHsnJHqvbGqa",199,0.990099,40,202,2,200,1,2,1,3,2,99,98,102,102,75
"6415",14,"[40]AIjHoIcwdBkDqfeGglKtFibKDeeemHsnJHqvbGqa",205,0.990385,40,208,2,206,1,2,1,3,2,106,105,101,101,75
"6416",15,"[40]AIjHoIcwdBkDqfeGglKtFibKDeeemHsnJHqvbGqa",210,0.99061,40,213,2,211,1,2,1,3,2,113,112,99,99,75
"6417",16,"[40]AIjHoIcwdBkDqfeGglKtFibKDeeemHsnJHqvbGqa",186,0.989418,40,189,2,187,1,2,1,3,2,81,80,107,107,75
"6418",17,"[40]AIjHoIcwdBkDqfeGglKtFibKDeeemHsnJHqvbGqa",201,0.990196,40,204,2,202,1,2,1,3,2,99,98,104,104,75
"6419",18,"[40]AIjHoIcwdBkDqfeGglKtFibKDeeemHsnJHqvbGqa",209,0.990566,40,212,2,210,1,2,1,3,2,114,113,97,97,75
"6420",19,"[40]AIjHoIcwdBkDqfeGglKtFibKDeeemHsnJHqvbGqa",202,0.990244,40,205,2,203,1,2,1,3,2,105,104,99,99,75
"6421",20,"[40]AIjHoIcwdBkDqfeGglKtFibKDeeemHsnJHqvbGqa",212,0.990698,40,215,2,213,1,2,1,3,2,117,116,97,97,75
"6422",21,"[40]AIjHoIcwdBkDqfeGglKtFibKDeeemHsnJHqvbGqa",213,0.990741,40,216,2,214,1,2,1,3,2,117,116,98,98,75
"6423",22,"[40]AIjHoIcwdBkDqfeGglKtFibKDeeemHsnJHqvbGqa",199,0.990099,40,202,2,200,1,2,1,3,2,100,99,101,101,75
"6424",23,"[40]AIjHoIcwdBkDqfeGglKtFibKDeeemHsnJHqvbGqa",202,0.990244,40,205,2,203,1,2,1,3,2,105,104,99,99,75
"6425",24,"[40]AIjHoIcwdBkDqfeGglKtFibKDeeemHsnJHqvbGqa",201,0.990196,40,204,2,202,1,2,1,3,2,102,101,101,101,75
"6426",25,"[40]AIjHoIcwdBkDqfeGglKtFibKDeeemHsnJHqvbGqa",216,0.990868,40,219,2,217,1,2,1,3,2,121,120,97,97,75
"6427",26,"[40]AIjHoIcwdBkDqfeGglKtFibKDeeemHsnJHqvbGqa",203,0.990291,40,206,2,204,1,2,1,3,2,105,104,100,100,75
"6428",27,"[40]AIjHoIcwdBkDqfeGglKtFibKDeeemHsnJHqvbGqa",205,0.990385,40,208,2,206,1,2,1,3,2,108,107,99,99,75
"6429",28,"[40]AIjHoIcwdBkDqfeGglKtFibKDeeemHsnJHqvbGqa",208,0.990521,40,211,2,209,1,2,1,3,2,113,112,97,97,75
"6430",29,"[40]AIjHoIcwdBkDqfeGglKtFibKDeeemHsnJHqvbGqa",184,0.989305,40,187,2,185,1,2,1,3,2,77,76,109,109,75
"6431",30,"[40]AIjHoIcwdBkDqfeGglKtFibKDeeemHsnJHqvbGqa",197,0.99,40,200,2,198,1,2,1,3,2,97,96,102,102,75
"6432",31,"[40]AIjHoIcwdBkDqfeGglKtFibKDeeemHsnJHqvbGqa",192,0.989744,40,195,2,193,1,2,1,3,2,93,92,101,101,75
"6433",32,"[40]AIjHoIcwdBkDqfeGglKtFibKDeeemHsnJHqvbGqa",197,0.99,40,200,2,198,1,2,1,3,2,97,96,102,102,75
"6434",33,"[40]AIjHoIcwdBkDqfeGglKtFibKDeeemHsnJHqvbGqa",207,0.990476,40,210,2,208,1,2,1,3,2,111,110,98,98,75
"6435",34,"[40]AIjHoIcwdBkDqfeGglKtFibKDeeemHsnJHqvbGqa",204,0.990338,40,207,2,205,1,2,1,3,2,107,106,99,99,75
"6436",35,"[40]AIjHoIcwdBkDqfeGglKtFibKDeeemHsnJHqvbGqa",206,0.990431,40,209,2,207,1,2,1,3,2,109,108,99,99,75
"6437",36,"[40]AIjHoIcwdBkDqfeGglKtFibKDeeemHsnJHqvbGqa",203,0.990291,40,206,2,204,1,2,1,3,2,105,104,100,100,75
"6438",37,"[40]AIjHoIcwdBkDqfeGglKtFibKDeeemHsnJHqvbGqa",204,0.990338,40,207,2,205,1,2,1,3,2,106,105,100,100,75
"6439",38,"[40]AIjHoIcwdBkDqfeGglKtFibKDeeemHsnJHqvbGqa",183,0.989247,40,186,2,184,1,2,1,3,2,76,75,109,109,75
"6440",39,"[40]AIjHoIcwdBkDqfeGglKtFibKDeeemHsnJHqvbGqa",199,0.990099,40,202,2,200,1,2,1,3,2,99,98,102,102,75
"6441",40,"[40]AIjHoIcwdBkDqfeGglKtFibKDeeemHsnJHqvbGqa",192,0.989744,40,195,2,193,1,2,1,3,2,92,91,102,102,75
"6442",41,"[40]AIjHoIcwdBkDqfeGglKtFibKDeeemHsnJHqvbGqa",197,0.99,40,200,2,198,1,2,1,3,2,94,93,105,105,75
"6443",42,"[40]AIjHoIcwdBkDqfeGglKtFibKDeeemHsnJHqvbGqa",209,0.990566,40,212,2,210,1,2,1,3,2,111,110,100,100,75
"6444",43,"[40]AIjHoIcwdBkDqfeGglKtFibKDeeemHsnJHqvbGqa",201,0.990196,40,204,2,202,1,2,1,3,2,103,102,100,100,75
"6445",44,"[40]AIjHoIcwdBkDqfeGglKtFibKDeeemHsnJHqvbGqa",201,0.990196,40,204,2,202,1,2,1,3,2,102,101,101,101,75
"6446",45,"[40]AIjHoIcwdBkDqfeGglKtFibKDeeemHsnJHqvbGqa",206,0.990431,40,209,2,207,1,2,1,3,2,108,107,100,100,75
"6447",46,"[40]AIjHoIcwdBkDqfeGglKtFibKDeeemHsnJHqvbGqa",190,0.989637,40,193,2,191,1,2,1,3,2,86,85,106,106,75
"6448",47,"[40]AIjHoIcwdBkDqfeGglKtFibKDeeemHsnJHqvbGqa",201,0.990196,40,204,2,202,1,2,1,3,2,101,100,102,102,75
"6449",48,"[40]AIjHoIcwdBkDqfeGglKtFibKDeeemHsnJHqvbGqa",207,0.990476,40,210,2,208,1,2,1,3,2,108,107,101,101,75
"6450",49,"[40]AIjHoIcwdBkDqfeGglKtFibKDeeemHsnJHqvbGqa",199,0.990099,40,202,2,200,1,2,1,3,2,98,97,103,103,75
"6451",50,"[40]AIjHoIcwdBkDqfeGglKtFibKDeeemHsnJHqvbGqa",213,0.990741,40,216,2,214,1,2,1,3,2,118,117,97,97,75
"6452",51,"[40]AIjHoIcwdBkDqfeGglKtFibKDeeemHsnJHqvbGqa",209,0.990566,40,212,2,210,1,2,1,3,2,113,112,98,98,75
"6453",52,"[40]AIjHoIcwdBkDqfeGglKtFibKDeeemHsnJHqvbGqa",207,0.990476,40,210,2,208,1,2,1,3,2,110,109,99,99,75
"6454",53,"[40]AIjHoIcwdBkDqfeGglKtFibKDeeemHsnJHqvbGqa",200,0.990148,40,203,2,201,1,2,1,3,2,101,100,101,101,75
"6455",54,"[40]AIjHoIcwdBkDqfeGglKtFibKDeeemHsnJHqvbGqa",204,0.990338,40,207,2,205,1,2,1,3,2,106,105,100,100,75
"6456",55,"[40]AIjHoIcwdBkDqfeGglKtFibKDeeemHsnJHqvbGqa",201,0.990196,40,204,2,202,1,2,1,3,2,103,102,100,100,75
"6457",56,"[40]AIjHoIcwdBkDqfeGglKtFibKDeeemHsnJHqvbGqa",202,0.990244,40,205,2,203,1,2,1,3,2,104,103,100,100,75
"6458",57,"[40]AIjHoIcwdBkDqfeGglKtFibKDeeemHsnJHqvbGqa",200,0.990148,40,203,2,201,1,2,1,3,2,97,96,105,105,75
"6459",58,"[40]AIjHoIcwdBkDqfeGglKtFibKDeeemHsnJHqvbGqa",212,0.990698,40,215,2,213,1,2,1,3,2,118,117,96,96,75
"6460",59,"[40]AIjHoIcwdBkDqfeGglKtFibKDeeemHsnJHqvbGqa",198,0.99005,40,201,2,199,1,2,1,3,2,100,99,100,100,75
"6461",60,"[40]AIjHoIcwdBkDqfeGglKtFibKDeeemHsnJHqvbGqa",210,0.99061,40,213,2,211,1,2,1,3,2,117,116,95,95,75
"6462",61,"[40]AIjHoIcwdBkDqfeGglKtFibKDeeemHsnJHqvbGqa",202,0.990244,40,205,2,203,1,2,1,3,2,104,103,100,100,75
"6463",62,"[40]AIjHoIcwdBkDqfeGglKtFibKDeeemHsnJHqvbGqa",196,0.98995,40,199,2,197,1,2,1,3,2,97,96,101,101,75
"6464",63,"[40]AIjHoIcwdBkDqfeGglKtFibKDeeemHsnJHqvbGqa",190,0.989637,40,193,2,191,1,2,1,3,2,88,87,104,104,75
"6465",64,"[40]AIjHoIcwdBkDqfeGglKtFibKDeeemHsnJHqvbGqa",199,0.990099,40,202,2,200,1,2,1,3,2,99,98,102,102,75
"6466",65,"[40]AIjHoIcwdBkDqfeGglKtFibKDeeemHsnJHqvbGqa",211,0.990654,40,214,2,212,1,2,1,3,2,117,116,96,96,75
"6467",66,"[40]AIjHoIcwdBkDqfeGglKtFibKDeeemHsnJHqvbGqa",199,0.990099,40,202,2,200,1,2,1,3,2,98,97,103,103,75
"6468",67,"[40]AIjHoIcwdBkDqfeGglKtFibKDeeemHsnJHqvbGqa",213,0.990741,40,216,2,214,1,2,1,3,2,119,118,96,96,75
"6469",68,"[40]AIjHoIcwdBkDqfeGglKtFibKDeeemHsnJHqvbGqa",199,0.990099,40,202,2,200,1,2,1,3,2,101,100,100,100,75
"6470",69,"[40]AIjHoIcwdBkDqfeGglKtFibKDeeemHsnJHqvbGqa",208,0.990521,40,211,2,209,1,2,1,3,2,111,110,99,99,75
"6471",70,"[40]AIjHoIcwdBkDqfeGglKtFibKDeeemHsnJHqvbGqa",222,0.991111,40,225,2,223,1,2,1,3,2,128,127,96,96,75
"6472",71,"[40]AIjHoIcwdBkDqfeGglKtFibKDeeemHsnJHqvbGqa",203,0.990291,40,206,2,204,1,2,1,3,2,105,104,100,100,75
"6473",72,"[40]AIjHoIcwdBkDqfeGglKtFibKDeeemHsnJHqvbGqa",192,0.989744,40,195,2,193,1,2,1,3,2,89,88,105,105,75
"6474",73,"[40]AIjHoIcwdBkDqfeGglKtFibKDeeemHsnJHqvbGqa",201,0.990196,40,204,2,202,1,2,1,3,2,100,99,103,103,75
"6475",74,"[40]AIjHoIcwdBkDqfeGglKtFibKDeeemHsnJHqvbGqa",186,0.989418,40,189,2,187,1,2,1,3,2,82,81,106,106,75
"6476",75,"[40]AIjHoIcwdBkDqfeGglKtFibKDeeemHsnJHqvbGqa",203,0.990291,40,206,2,204,1,2,1,3,2,104,103,101,101,75
"6477",76,"[40]AIjHoIcwdBkDqfeGglKtFibKDeeemHsnJHqvbGqa",203,0.990291,40,206,2,204,1,2,1,3,2,106,105,99,99,75
"6478",77,"[40]AIjHoIcwdBkDqfeGglKtFibKDeeemHsnJHqvbGqa",211,0.990654,40,214,2,212,1,2,1,3,2,115,114,98,98,75
"6479",78,"[40]AIjHoIcwdBkDqfeGglKtFibKDeeemHsnJHqvbGqa",204,0.990338,40,207,2,205,1,2,1,3,2,106,105,100,100,75
"6480",79,"[40]AIjHoIcwdBkDqfeGglKtFibKDeeemHsnJHqvbGqa",210,0.99061,40,213,2,211,1,2,1,3,2,115,114,97,97,75
"6481",80,"[40]AIjHoIcwdBkDqfeGglKtFibKDeeemHsnJHqvbGqa",205,0.990385,40,208,2,206,1,2,1,3,2,107,106,100,100,75
"6482",81,"[40]AIjHoIcwdBkDqfeGglKtFibKDeeemHsnJHqvbGqa",199,0.990099,40,202,2,200,1,2,1,3,2,101,100,100,100,75
"6483",82,"[40]AIjHoIcwdBkDqfeGglKtFibKDeeemHsnJHqvbGqa",198,0.99005,40,201,2,199,1,2,1,3,2,100,99,100,100,75
"6484",83,"[40]AIjHoIcwdBkDqfeGglKtFibKDeeemHsnJHqvbGqa",187,0.989474,40,190,2,188,1,2,1,3,2,85,84,104,104,75
"6485",84,"[40]AIjHoIcwdBkDqfeGglKtFibKDeeemHsnJHqvbGqa",199,0.990099,40,202,2,200,1,2,1,3,2,101,100,100,100,75
"6486",85,"[40]AIjHoIcwdBkDqfeGglKtFibKDeeemHsnJHqvbGqa",196,0.98995,40,199,2,197,1,2,1,3,2,97,96,101,101,75
"6487",86,"[40]AIjHoIcwdBkDqfeGglKtFibKDeeemHsnJHqvbGqa",213,0.990741,40,216,2,214,1,2,1,3,2,119,118,96,96,75
"6488",87,"[40]AIjHoIcwdBkDqfeGglKtFibKDeeemHsnJHqvbGqa",204,0.990338,40,207,2,205,1,2,1,3,2,106,105,100,100,75
"6489",88,"[40]AIjHoIcwdBkDqfeGglKtFibKDeeemHsnJHqvbGqa",202,0.990244,40,205,2,203,1,2,1,3,2,104,103,100,100,75
"6490",89,"[40]AIjHoIcwdBkDqfeGglKtFibKDeeemHsnJHqvbGqa",216,0.990868,40,219,2,217,1,2,1,3,2,125,124,93,93,75
"6491",90,"[40]AIjHoIcwdBkDqfeGglKtFibKDeeemHsnJHqvbGqa",217,0.990909,40,220,2,218,1,2,1,3,2,124,123,95,95,75
"6492",91,"[40]AIjHoIcwdBkDqfeGglKtFibKDeeemHsnJHqvbGqa",193,0.989796,40,196,2,194,1,2,1,3,2,90,89,105,105,75
"6493",92,"[40]AIjHoIcwdBkDqfeGglKtFibKDeeemHsnJHqvbGqa",210,0.99061,40,213,2,211,1,2,1,3,2,118,117,94,94,75
"6494",93,"[40]AIjHoIcwdBkDqfeGglKtFibKDeeemHsnJHqvbGqa",195,0.989899,40,198,2,196,1,2,1,3,2,93,92,104,104,75
"6495",94,"[40]AIjHoIcwdBkDqfeGglKtFibKDeeemHsnJHqvbGqa",192,0.989744,40,195,2,193,1,2,1,3,2,86,85,108,108,75
"6496",95,"[40]AIjHoIcwdBkDqfeGglKtFibKDeeemHsnJHqvbGqa",205,0.990385,40,208,2,206,1,2,1,3,2,107,106,100,100,75
"6497",96,"[40]AIjHoIcwdBkDqfeGglKtFibKDeeemHsnJHqvbGqa",199,0.990099,40,202,2,200,1,2,1,3,2,97,96,104,104,75
"6498",97,"[40]AIjHoIcwdBkDqfeGglKtFibKDeeemHsnJHqvbGqa",212,0.990698,40,215,2,213,1,2,1,3,2,117,116,97,97,75
"6499",98,"[40]AIjHoIcwdBkDqfeGglKtFibKDeeemHsnJHqvbGqa",194,0.989848,40,197,2,195,1,2,1,3,2,93,92,103,103,75
"6500",99,"[40]AIjHoIcwdBkDqfeGglKtFibKDeeemHsnJHqvbGqa",186,0.989418,40,189,2,187,1,2,1,3,2,81,80,107,107,75
"6501",0,"[40]tIwHoIwFvBkDulmHcgkBcIbKDaeuaHsnJHqvbGqa",192,0.989744,40,195,2,193,1,2,1,3,2,91,90,103,103,76
"6502",1,"[40]tIwHoIwFvBkDulmHcgkBcIbKDaeuaHsnJHqvbGqa",203,0.990291,40,206,2,204,1,2,1,3,2,104,103,101,101,76
"6503",2,"[40]tIwHoIwFvBkDulmHcgkBcIbKDaeuaHsnJHqvbGqa",203,0.990291,40,206,2,204,1,2,1,3,2,107,106,98,98,76
"6504",3,"[40]tIwHoIwFvBkDulmHcgkBcIbKDaeuaHsnJHqvbGqa",196,0.98995,40,199,2,197,1,2,1,3,2,95,94,103,103,76
"6505",4,"[40]tIwHoIwFvBkDulmHcgkBcIbKDaeuaHsnJHqvbGqa",201,0.990196,40,204,2,202,1,2,1,3,2,104,103,99,99,76
"6506",5,"[40]tIwHoIwFvBkDulmHcgkBcIbKDaeuaHsnJHqvbGqa",199,0.990099,40,202,2,200,1,2,1,3,2,100,99,101,101,76
"6507",6,"[40]tIwHoIwFvBkDulmHcgkBcIbKDaeuaHsnJHqvbGqa",193,0.989796,40,196,2,194,1,2,1,3,2,92,91,103,103,76
"6508",7,"[40]tIwHoIwFvBkDulmHcgkBcIbKDaeuaHsnJHqvbGqa",203,0.990291,40,206,2,204,1,2,1,3,2,104,103,101,101,76
"6509",8,"[40]tIwHoIwFvBkDulmHcgkBcIbKDaeuaHsnJHqvbGqa",186,0.989418,40,189,2,187,1,2,1,3,2,82,81,106,106,76
"6510",9,"[40]tIwHoIwFvBkDulmHcgkBcIbKDaeuaHsnJHqvbGqa",205,0.990385,40,208,2,206,1,2,1,3,2,109,108,98,98,76
"6511",10,"[40]tIwHoIwFvBkDulmHcgkBcIbKDaeuaHsnJHqvbGqa",216,0.990868,40,219,2,217,1,2,1,3,2,126,125,92,92,76
"6512",11,"[40]tIwHoIwFvBkDulmHcgkBcIbKDaeuaHsnJHqvbGqa",205,0.990385,40,208,2,206,1,2,1,3,2,108,107,99,99,76
"6513",12,"[40]tIwHoIwFvBkDulmHcgkBcIbKDaeuaHsnJHqvbGqa",209,0.990566,40,212,2,210,1,2,1,3,2,112,111,99,99,76
"6514",13,"[40]tIwHoIwFvBkDulmHcgkBcIbKDaeuaHsnJHqvbGqa",219,0.990991,40,222,2,220,1,2,1,3,2,126,125,95,95,76
"6515",14,"[40]tIwHoIwFvBkDulmHcgkBcIbKDaeuaHsnJHqvbGqa",200,0.990148,40,203,2,201,1,2,1,3,2,101,100,101,101,76
"6516",15,"[40]tIwHoIwFvBkDulmHcgkBcIbKDaeuaHsnJHqvbGqa",213,0.990741,40,216,2,214,1,2,1,3,2,120,119,95,95,76
"6517",16,"[40]tIwHoIwFvBkDulmHcgkBcIbKDaeuaHsnJHqvbGqa",196,0.98995,40,199,2,197,1,2,1,3,2,98,97,100,100,76
"6518",17,"[40]tIwHoIwFvBkDulmHcgkBcIbKDaeuaHsnJHqvbGqa",201,0.990196,40,204,2,202,1,2,1,3,2,102,101,101,101,76
"6519",18,"[40]tIwHoIwFvBkDulmHcgkBcIbKDaeuaHsnJHqvbGqa",189,0.989583,40,192,2,190,1,2,1,3,2,86,85,105,105,76
"6520",19,"[40]tIwHoIwFvBkDulmHcgkBcIbKDaeuaHsnJHqvbGqa",192,0.989744,40,195,2,193,1,2,1,3,2,92,91,102,102,76
"6521",20,"[40]tIwHoIwFvBkDulmHcgkBcIbKDaeuaHsnJHqvbGqa",202,0.990244,40,205,2,203,1,2,1,3,2,104,103,100,100,76
"6522",21,"[40]tIwHoIwFvBkDulmHcgkBcIbKDaeuaHsnJHqvbGqa",200,0.990148,40,203,2,201,1,2,1,3,2,101,100,101,101,76
"6523",22,"[40]tIwHoIwFvBkDulmHcgkBcIbKDaeuaHsnJHqvbGqa",197,0.99,40,200,2,198,1,2,1,3,2,96,95,103,103,76
"6524",23,"[40]tIwHoIwFvBkDulmHcgkBcIbKDaeuaHsnJHqvbGqa",209,0.990566,40,212,2,210,1,2,1,3,2,112,111,99,99,76
"6525",24,"[40]tIwHoIwFvBkDulmHcgkBcIbKDaeuaHsnJHqvbGqa",214,0.990783,40,217,2,215,1,2,1,3,2,122,121,94,94,76
"6526",25,"[40]tIwHoIwFvBkDulmHcgkBcIbKDaeuaHsnJHqvbGqa",193,0.989796,40,196,2,194,1,2,1,3,2,91,90,104,104,76
"6527",26,"[40]tIwHoIwFvBkDulmHcgkBcIbKDaeuaHsnJHqvbGqa",193,0.989796,40,196,2,194,1,2,1,3,2,91,90,104,104,76
"6528",27,"[40]tIwHoIwFvBkDulmHcgkBcIbKDaeuaHsnJHqvbGqa",203,0.990291,40,206,2,204,1,2,1,3,2,104,103,101,101,76
"6529",28,"[40]tIwHoIwFvBkDulmHcgkBcIbKDaeuaHsnJHqvbGqa",212,0.990698,40,215,2,213,1,2,1,3,2,115,114,99,99,76
"6530",29,"[40]tIwHoIwFvBkDulmHcgkBcIbKDaeuaHsnJHqvbGqa",205,0.990385,40,208,2,206,1,2,1,3,2,106,105,101,101,76
"6531",30,"[40]tIwHoIwFvBkDulmHcgkBcIbKDaeuaHsnJHqvbGqa",203,0.990291,40,206,2,204,1,2,1,3,2,105,104,100,100,76
"6532",31,"[40]tIwHoIwFvBkDulmHcgkBcIbKDaeuaHsnJHqvbGqa",198,0.99005,40,201,2,199,1,2,1,3,2,100,99,100,100,76
"6533",32,"[40]tIwHoIwFvBkDulmHcgkBcIbKDaeuaHsnJHqvbGqa",191,0.989691,40,194,2,192,1,2,1,3,2,89,88,104,104,76
"6534",33,"[40]tIwHoIwFvBkDulmHcgkBcIbKDaeuaHsnJHqvbGqa",203,0.990291,40,206,2,204,1,2,1,3,2,105,104,100,100,76
"6535",34,"[40]tIwHoIwFvBkDulmHcgkBcIbKDaeuaHsnJHqvbGqa",200,0.990148,40,203,2,201,1,2,1,3,2,102,101,100,100,76
"6536",35,"[40]tIwHoIwFvBkDulmHcgkBcIbKDaeuaHsnJHqvbGqa",194,0.989848,40,197,2,195,1,2,1,3,2,94,93,102,102,76
"6537",36,"[40]tIwHoIwFvBkDulmHcgkBcIbKDaeuaHsnJHqvbGqa",204,0.990338,40,207,2,205,1,2,1,3,2,106,105,100,100,76
"6538",37,"[40]tIwHoIwFvBkDulmHcgkBcIbKDaeuaHsnJHqvbGqa",213,0.990741,40,216,2,214,1,2,1,3,2,117,116,98,98,76
"6539",38,"[40]tIwHoIwFvBkDulmHcgkBcIbKDaeuaHsnJHqvbGqa",201,0.990196,40,204,2,202,1,2,1,3,2,102,101,101,101,76
"6540",39,"[40]tIwHoIwFvBkDulmHcgkBcIbKDaeuaHsnJHqvbGqa",212,0.990698,40,215,2,213,1,2,1,3,2,117,116,97,97,76
"6541",40,"[40]tIwHoIwFvBkDulmHcgkBcIbKDaeuaHsnJHqvbGqa",199,0.990099,40,202,2,200,1,2,1,3,2,99,98,102,102,76
"6542",41,"[40]tIwHoIwFvBkDulmHcgkBcIbKDaeuaHsnJHqvbGqa",208,0.990521,40,211,2,209,1,2,1,3,2,110,109,100,100,76
"6543",42,"[40]tIwHoIwFvBkDulmHcgkBcIbKDaeuaHsnJHqvbGqa",209,0.990566,40,212,2,210,1,2,1,3,2,116,115,95,95,76
"6544",43,"[40]tIwHoIwFvBkDulmHcgkBcIbKDaeuaHsnJHqvbGqa",221,0.991071,40,224,2,222,1,2,1,3,2,130,129,93,93,76
"6545",44,"[40]tIwHoIwFvBkDulmHcgkBcIbKDaeuaHsnJHqvbGqa",210,0.99061,40,213,2,211,1,2,1,3,2,116,115,96,96,76
"6546",45,"[40]tIwHoIwFvBkDulmHcgkBcIbKDaeuaHsnJHqvbGqa",193,0.989796,40,196,2,194,1,2,1,3,2,91,90,104,104,76
"6547",46,"[40]tIwHoIwFvBkDulmHcgkBcIbKDaeuaHsnJHqvbGqa",199,0.990099,40,202,2,200,1,2,1,3,2,100,99,101,101,76
"6548",47,"[40]tIwHoIwFvBkDulmHcgkBcIbKDaeuaHsnJHqvbGqa",213,0.990741,40,216,2,214,1,2,1,3,2,118,117,97,97,76
"6549",48,"[40]tIwHoIwFvBkDulmHcgkBcIbKDaeuaHsnJHqvbGqa",195,0.989899,40,198,2,196,1,2,1,3,2,96,95,101,101,76
"6550",49,"[40]tIwHoIwFvBkDulmHcgkBcIbKDaeuaHsnJHqvbGqa",197,0.99,40,200,2,198,1,2,1,3,2,96,95,103,103,76
"6551",50,"[40]tIwHoIwFvBkDulmHcgkBcIbKDaeuaHsnJHqvbGqa",203,0.990291,40,206,2,204,1,2,1,3,2,105,104,100,100,76
"6552",51,"[40]tIwHoIwFvBkDulmHcgkBcIbKDaeuaHsnJHqvbGqa",201,0.990196,40,204,2,202,1,2,1,3,2,101,100,102,102,76
"6553",52,"[40]tIwHoIwFvBkDulmHcgkBcIbKDaeuaHsnJHqvbGqa",199,0.990099,40,202,2,200,1,2,1,3,2,101,100,100,100,76
"6554",53,"[40]tIwHoIwFvBkDulmHcgkBcIbKDaeuaHsnJHqvbGqa",209,0.990566,40,212,2,210,1,2,1,3,2,113,112,98,98,76
"6555",54,"[40]tIwHoIwFvBkDulmHcgkBcIbKDaeuaHsnJHqvbGqa",200,0.990148,40,203,2,201,1,2,1,3,2,102,101,100,100,76
"6556",55,"[40]tIwHoIwFvBkDulmHcgkBcIbKDaeuaHsnJHqvbGqa",186,0.989418,40,189,2,187,1,2,1,3,2,83,82,105,105,76
"6557",56,"[40]tIwHoIwFvBkDulmHcgkBcIbKDaeuaHsnJHqvbGqa",203,0.990291,40,206,2,204,1,2,1,3,2,102,101,103,103,76
"6558",57,"[40]tIwHoIwFvBkDulmHcgkBcIbKDaeuaHsnJHqvbGqa",192,0.989744,40,195,2,193,1,2,1,3,2,90,89,104,104,76
"6559",58,"[40]tIwHoIwFvBkDulmHcgkBcIbKDaeuaHsnJHqvbGqa",191,0.989691,40,194,2,192,1,2,1,3,2,87,86,106,106,76
"6560",59,"[40]tIwHoIwFvBkDulmHcgkBcIbKDaeuaHsnJHqvbGqa",217,0.990909,40,220,2,218,1,2,1,3,2,125,124,94,94,76
"6561",60,"[40]tIwHoIwFvBkDulmHcgkBcIbKDaeuaHsnJHqvbGqa",192,0.989744,40,195,2,193,1,2,1,3,2,90,89,104,104,76
"6562",61,"[40]tIwHoIwFvBkDulmHcgkBcIbKDaeuaHsnJHqvbGqa",205,0.990385,40,208,2,206,1,2,1,3,2,107,106,100,100,76
"6563",62,"[40]tIwHoIwFvBkDulmHcgkBcIbKDaeuaHsnJHqvbGqa",200,0.990148,40,203,2,201,1,2,1,3,2,104,103,98,98,76
"6564",63,"[40]tIwHoIwFvBkDulmHcgkBcIbKDaeuaHsnJHqvbGqa",188,0.989529,40,191,2,189,1,2,1,3,2,85,84,105,105,76
"6565",64,"[40]tIwHoIwFvBkDulmHcgkBcIbKDaeuaHsnJHqvbGqa",209,0.990566,40,212,2,210,1,2,1,3,2,116,115,95,95,76
"6566",65,"[40]tIwHoIwFvBkDulmHcgkBcIbKDaeuaHsnJHqvbGqa",181,0.98913,40,184,2,182,1,2,1,3,2,74,73,109,109,76
"6567",66,"[40]tIwHoIwFvBkDulmHcgkBcIbKDaeuaHsnJHqvbGqa",206,0.990431,40,209,2,207,1,2,1,3,2,110,109,98,98,76
"6568",67,"[40]tIwHoIwFvBkDulmHcgkBcIbKDaeuaHsnJHqvbGqa",195,0.989899,40,198,2,196,1,2,1,3,2,92,91,105,105,76
"6569",68,"[40]tIwHoIwFvBkDulmHcgkBcIbKDaeuaHsnJHqvbGqa",210,0.99061,40,213,2,211,1,2,1,3,2,115,114,97,97,76
"6570",69,"[40]tIwHoIwFvBkDulmHcgkBcIbKDaeuaHsnJHqvbGqa",202,0.990244,40,205,2,203,1,2,1,3,2,103,102,101,101,76
"6571",70,"[40]tIwHoIwFvBkDulmHcgkBcIbKDaeuaHsnJHqvbGqa",204,0.990338,40,207,2,205,1,2,1,3,2,108,107,98,98,76
"6572",71,"[40]tIwHoIwFvBkDulmHcgkBcIbKDaeuaHsnJHqvbGqa",204,0.990338,40,207,2,205,1,2,1,3,2,107,106,99,99,76
"6573",72,"[40]tIwHoIwFvBkDulmHcgkBcIbKDaeuaHsnJHqvbGqa",210,0.99061,40,213,2,211,1,2,1,3,2,116,115,96,96,76
"6574",73,"[40]tIwHoIwFvBkDulmHcgkBcIbKDaeuaHsnJHqvbGqa",207,0.990476,40,210,2,208,1,2,1,3,2,109,108,100,100,76
"6575",74,"[40]tIwHoIwFvBkDulmHcgkBcIbKDaeuaHsnJHqvbGqa",200,0.990148,40,203,2,201,1,2,1,3,2,100,99,102,102,76
"6576",75,"[40]tIwHoIwFvBkDulmHcgkBcIbKDaeuaHsnJHqvbGqa",216,0.990868,40,219,2,217,1,2,1,3,2,121,120,97,97,76
"6577",76,"[40]tIwHoIwFvBkDulmHcgkBcIbKDaeuaHsnJHqvbGqa",208,0.990521,40,211,2,209,1,2,1,3,2,113,112,97,97,76
"6578",77,"[40]tIwHoIwFvBkDulmHcgkBcIbKDaeuaHsnJHqvbGqa",213,0.990741,40,216,2,214,1,2,1,3,2,118,117,97,97,76
"6579",78,"[40]tIwHoIwFvBkDulmHcgkBcIbKDaeuaHsnJHqvbGqa",208,0.990521,40,211,2,209,1,2,1,3,2,113,112,97,97,76
"6580",79,"[40]tIwHoIwFvBkDulmHcgkBcIbKDaeuaHsnJHqvbGqa",183,0.989247,40,186,2,184,1,2,1,3,2,79,78,106,106,76
"6581",80,"[40]tIwHoIwFvBkDulmHcgkBcIbKDaeuaHsnJHqvbGqa",218,0.99095,40,221,2,219,1,2,1,3,2,127,126,93,93,76
"6582",81,"[40]tIwHoIwFvBkDulmHcgkBcIbKDaeuaHsnJHqvbGqa",205,0.990385,40,208,2,206,1,2,1,3,2,108,107,99,99,76
"6583",82,"[40]tIwHoIwFvBkDulmHcgkBcIbKDaeuaHsnJHqvbGqa",222,0.991111,40,225,2,223,1,2,1,3,2,131,130,93,93,76
"6584",83,"[40]tIwHoIwFvBkDulmHcgkBcIbKDaeuaHsnJHqvbGqa",214,0.990783,40,217,2,215,1,2,1,3,2,120,119,96,96,76
"6585",84,"[40]tIwHoIwFvBkDulmHcgkBcIbKDaeuaHsnJHqvbGqa",200,0.990148,40,203,2,201,1,2,1,3,2,101,100,101,101,76
"6586",85,"[40]tIwHoIwFvBkDulmHcgkBcIbKDaeuaHsnJHqvbGqa",210,0.99061,40,213,2,211,1,2,1,3,2,114,113,98,98,76
"6587",86,"[40]tIwHoIwFvBkDulmHcgkBcIbKDaeuaHsnJHqvbGqa",196,0.98995,40,199,2,197,1,2,1,3,2,94,93,104,104,76
"6588",87,"[40]tIwHoIwFvBkDulmHcgkBcIbKDaeuaHsnJHqvbGqa",184,0.989305,40,187,2,185,1,2,1,3,2,83,82,103,103,76
"6589",88,"[40]tIwHoIwFvBkDulmHcgkBcIbKDaeuaHsnJHqvbGqa",212,0.990698,40,215,2,213,1,2,1,3,2,117,116,97,97,76
"6590",89,"[40]tIwHoIwFvBkDulmHcgkBcIbKDaeuaHsnJHqvbGqa",194,0.989848,40,197,2,195,1,2,1,3,2,93,92,103,103,76
"6591",90,"[40]tIwHoIwFvBkDulmHcgkBcIbKDaeuaHsnJHqvbGqa",210,0.99061,40,213,2,211,1,2,1,3,2,113,112,99,99,76
"6592",91,"[40]tIwHoIwFvBkDulmHcgkBcIbKDaeuaHsnJHqvbGqa",209,0.990566,40,212,2,210,1,2,1,3,2,113,112,98,98,76
"6593",92,"[40]tIwHoIwFvBkDulmHcgkBcIbKDaeuaHsnJHqvbGqa",205,0.990385,40,208,2,206,1,2,1,3,2,107,106,100,100,76
"6594",93,"[40]tIwHoIwFvBkDulmHcgkBcIbKDaeuaHsnJHqvbGqa",200,0.990148,40,203,2,201,1,2,1,3,2,102,101,100,100,76
"6595",94,"[40]tIwHoIwFvBkDulmHcgkBcIbKDaeuaHsnJHqvbGqa",208,0.990521,40,211,2,209,1,2,1,3,2,113,112,97,97,76
"6596",95,"[40]tIwHoIwFvBkDulmHcgkBcIbKDaeuaHsnJHqvbGqa",190,0.989637,40,193,2,191,1,2,1,3,2,86,85,106,106,76
"6597",96,"[40]tIwHoIwFvBkDulmHcgkBcIbKDaeuaHsnJHqvbGqa",192,0.989744,40,195,2,193,1,2,1,3,2,89,88,105,105,76
"6598",97,"[40]tIwHoIwFvBkDulmHcgkBcIbKDaeuaHsnJHqvbGqa",197,0.99,40,200,2,198,1,2,1,3,2,97,96,102,102,76
"6599",98,"[40]tIwHoIwFvBkDulmHcgkBcIbKDaeuaHsnJHqvbGqa",212,0.990698,40,215,2,213,1,2,1,3,2,117,116,97,97,76
"6600",99,"[40]tIwHoIwFvBkDulmHcgkBcIbKDaeuaHsnJHqvbGqa",210,0.99061,40,213,2,211,1,2,1,3,2,116,115,96,96,76
"6601",0,"[40]BIhHoIpmtBkDFEEFKxnxJtbKDaezvHxnJHqvbGqa",200,0.990148,40,203,2,201,1,2,1,3,2,100,99,102,102,77
"6602",1,"[40]BIhHoIpmtBkDFEEFKxnxJtbKDaezvHxnJHqvbGqa",204,0.990338,40,207,2,205,1,2,1,3,2,105,104,101,101,77
"6603",2,"[40]BIhHoIpmtBkDFEEFKxnxJtbKDaezvHxnJHqvbGqa",206,0.990431,40,209,2,207,1,2,1,3,2,109,108,99,99,77
"6604",3,"[40]BIhHoIpmtBkDFEEFKxnxJtbKDaezvHxnJHqvbGqa",193,0.989796,40,196,2,194,1,2,1,3,2,90,89,105,105,77
"6605",4,"[40]BIhHoIpmtBkDFEEFKxnxJtbKDaezvHxnJHqvbGqa",208,0.990521,40,211,2,209,1,2,1,3,2,112,111,98,98,77
"6606",5,"[40]BIhHoIpmtBkDFEEFKxnxJtbKDaezvHxnJHqvbGqa",213,0.990741,40,216,2,214,1,2,1,3,2,118,117,97,97,77
"6607",6,"[40]BIhHoIpmtBkDFEEFKxnxJtbKDaezvHxnJHqvbGqa",195,0.989899,40,198,2,196,1,2,1,3,2,95,94,102,102,77
"6608",7,"[40]BIhHoIpmtBkDFEEFKxnxJtbKDaezvHxnJHqvbGqa",206,0.990431,40,209,2,207,1,2,1,3,2,106,105,102,102,77
"6609",8,"[40]BIhHoIpmtBkDFEEFKxnxJtbKDaezvHxnJHqvbGqa",211,0.990654,40,214,2,212,1,2,1,3,2,119,118,94,94,77
"6610",9,"[40]BIhHoIpmtBkDFEEFKxnxJtbKDaezvHxnJHqvbGqa",200,0.990148,40,203,2,201,1,2,1,3,2,101,100,101,101,77
"6611",10,"[40]BIhHoIpmtBkDFEEFKxnxJtbKDaezvHxnJHqvbGqa",206,0.990431,40,209,2,207,1,2,1,3,2,112,111,96,96,77
"6612",11,"[40]BIhHoIpmtBkDFEEFKxnxJtbKDaezvHxnJHqvbGqa",212,0.990698,40,215,2,213,1,2,1,3,2,115,114,99,99,77
"6613",12,"[40]BIhHoIpmtBkDFEEFKxnxJtbKDaezvHxnJHqvbGqa",203,0.990291,40,206,2,204,1,2,1,3,2,107,106,98,98,77
"6614",13,"[40]BIhHoIpmtBkDFEEFKxnxJtbKDaezvHxnJHqvbGqa",204,0.990338,40,207,2,205,1,2,1,3,2,102,101,104,104,77
"6615",14,"[40]BIhHoIpmtBkDFEEFKxnxJtbKDaezvHxnJHqvbGqa",212,0.990698,40,215,2,213,1,2,1,3,2,119,118,95,95,77
"6616",15,"[40]BIhHoIpmtBkDFEEFKxnxJtbKDaezvHxnJHqvbGqa",186,0.989418,40,189,2,187,1,2,1,3,2,83,82,105,105,77
"6617",16,"[40]BIhHoIpmtBkDFEEFKxnxJtbKDaezvHxnJHqvbGqa",191,0.989691,40,194,2,192,1,2,1,3,2,87,86,106,106,77
"6618",17,"[40]BIhHoIpmtBkDFEEFKxnxJtbKDaezvHxnJHqvbGqa",197,0.99,40,200,2,198,1,2,1,3,2,97,96,102,102,77
"6619",18,"[40]BIhHoIpmtBkDFEEFKxnxJtbKDaezvHxnJHqvbGqa",196,0.98995,40,199,2,197,1,2,1,3,2,94,93,104,104,77
"6620",19,"[40]BIhHoIpmtBkDFEEFKxnxJtbKDaezvHxnJHqvbGqa",204,0.990338,40,207,2,205,1,2,1,3,2,105,104,101,101,77
"6621",20,"[40]BIhHoIpmtBkDFEEFKxnxJtbKDaezvHxnJHqvbGqa",206,0.990431,40,209,2,207,1,2,1,3,2,108,107,100,100,77
"6622",21,"[40]BIhHoIpmtBkDFEEFKxnxJtbKDaezvHxnJHqvbGqa",200,0.990148,40,203,2,201,1,2,1,3,2,102,101,100,100,77
"6623",22,"[40]BIhHoIpmtBkDFEEFKxnxJtbKDaezvHxnJHqvbGqa",191,0.989691,40,194,2,192,1,2,1,3,2,90,89,103,103,77
"6624",23,"[40]BIhHoIpmtBkDFEEFKxnxJtbKDaezvHxnJHqvbGqa",195,0.989899,40,198,2,196,1,2,1,3,2,95,94,102,102,77
"6625",24,"[40]BIhHoIpmtBkDFEEFKxnxJtbKDaezvHxnJHqvbGqa",204,0.990338,40,207,2,205,1,2,1,3,2,108,107,98,98,77
"6626",25,"[40]BIhHoIpmtBkDFEEFKxnxJtbKDaezvHxnJHqvbGqa",197,0.99,40,200,2,198,1,2,1,3,2,95,94,104,104,77
"6627",26,"[40]BIhHoIpmtBkDFEEFKxnxJtbKDaezvHxnJHqvbGqa",198,0.99005,40,201,2,199,1,2,1,3,2,97,96,103,103,77
"6628",27,"[40]BIhHoIpmtBkDFEEFKxnxJtbKDaezvHxnJHqvbGqa",196,0.98995,40,199,2,197,1,2,1,3,2,95,94,103,103,77
"6629",28,"[40]BIhHoIpmtBkDFEEFKxnxJtbKDaezvHxnJHqvbGqa",207,0.990476,40,210,2,208,1,2,1,3,2,110,109,99,99,77
"6630",29,"[40]BIhHoIpmtBkDFEEFKxnxJtbKDaezvHxnJHqvbGqa",198,0.99005,40,201,2,199,1,2,1,3,2,97,96,103,103,77
"6631",30,"[40]BIhHoIpmtBkDFEEFKxnxJtbKDaezvHxnJHqvbGqa",204,0.990338,40,207,2,205,1,2,1,3,2,107,106,99,99,77
"6632",31,"[40]BIhHoIpmtBkDFEEFKxnxJtbKDaezvHxnJHqvbGqa",210,0.99061,40,213,2,211,1,2,1,3,2,113,112,99,99,77
"6633",32,"[40]BIhHoIpmtBkDFEEFKxnxJtbKDaezvHxnJHqvbGqa",198,0.99005,40,201,2,199,1,2,1,3,2,99,98,101,101,77
"6634",33,"[40]BIhHoIpmtBkDFEEFKxnxJtbKDaezvHxnJHqvbGqa",193,0.989796,40,196,2,194,1,2,1,3,2,88,87,107,107,77
"6635",34,"[40]BIhHoIpmtBkDFEEFKxnxJtbKDaezvHxnJHqvbGqa",205,0.990385,40,208,2,206,1,2,1,3,2,107,106,100,100,77
"6636",35,"[40]BIhHoIpmtBkDFEEFKxnxJtbKDaezvHxnJHqvbGqa",202,0.990244,40,205,2,203,1,2,1,3,2,105,104,99,99,77
"6637",36,"[40]BIhHoIpmtBkDFEEFKxnxJtbKDaezvHxnJHqvbGqa",193,0.989796,40,196,2,194,1,2,1,3,2,92,91,103,103,77
"6638",37,"[40]BIhHoIpmtBkDFEEFKxnxJtbKDaezvHxnJHqvbGqa",193,0.989796,40,196,2,194,1,2,1,3,2,90,89,105,105,77
"6639",38,"[40]BIhHoIpmtBkDFEEFKxnxJtbKDaezvHxnJHqvbGqa",190,0.989637,40,193,2,191,1,2,1,3,2,90,89,102,102,77
"6640",39,"[40]BIhHoIpmtBkDFEEFKxnxJtbKDaezvHxnJHqvbGqa",199,0.990099,40,202,2,200,1,2,1,3,2,99,98,102,102,77
"6641",40,"[40]BIhHoIpmtBkDFEEFKxnxJtbKDaezvHxnJHqvbGqa",200,0.990148,40,203,2,201,1,2,1,3,2,102,101,100,100,77
"6642",41,"[40]BIhHoIpmtBkDFEEFKxnxJtbKDaezvHxnJHqvbGqa",197,0.99,40,200,2,198,1,2,1,3,2,96,95,103,103,77
"6643",42,"[40]BIhHoIpmtBkDFEEFKxnxJtbKDaezvHxnJHqvbGqa",202,0.990244,40,205,2,203,1,2,1,3,2,104,103,100,100,77
"6644",43,"[40]BIhHoIpmtBkDFEEFKxnxJtbKDaezvHxnJHqvbGqa",204,0.990338,40,207,2,205,1,2,1,3,2,105,104,101,101,77
"6645",44,"[40]BIhHoIpmtBkDFEEFKxnxJtbKDaezvHxnJHqvbGqa",196,0.98995,40,199,2,197,1,2,1,3,2,92,91,106,106,77
"6646",45,"[40]BIhHoIpmtBkDFEEFKxnxJtbKDaezvHxnJHqvbGqa",191,0.989691,40,194,2,192,1,2,1,3,2,88,87,105,105,77
"6647",46,"[40]BIhHoIpmtBkDFEEFKxnxJtbKDaezvHxnJHqvbGqa",202,0.990244,40,205,2,203,1,2,1,3,2,104,103,100,100,77
"6648",47,"[40]BIhHoIpmtBkDFEEFKxnxJtbKDaezvHxnJHqvbGqa",204,0.990338,40,207,2,205,1,2,1,3,2,105,104,101,101,77
"6649",48,"[40]BIhHoIpmtBkDFEEFKxnxJtbKDaezvHxnJHqvbGqa",205,0.990385,40,208,2,206,1,2,1,3,2,108,107,99,99,77
"6650",49,"[40]BIhHoIpmtBkDFEEFKxnxJtbKDaezvHxnJHqvbGqa",194,0.989848,40,197,2,195,1,2,1,3,2,94,93,102,102,77
"6651",50,"[40]BIhHoIpmtBkDFEEFKxnxJtbKDaezvHxnJHqvbGqa",205,0.990385,40,208,2,206,1,2,1,3,2,109,108,98,98,77
"6652",51,"[40]BIhHoIpmtBkDFEEFKxnxJtbKDaezvHxnJHqvbGqa",204,0.990338,40,207,2,205,1,2,1,3,2,106,105,100,100,77
"6653",52,"[40]BIhHoIpmtBkDFEEFKxnxJtbKDaezvHxnJHqvbGqa",202,0.990244,40,205,2,203,1,2,1,3,2,102,101,102,102,77
"6654",53,"[40]BIhHoIpmtBkDFEEFKxnxJtbKDaezvHxnJHqvbGqa",202,0.990244,40,205,2,203,1,2,1,3,2,104,103,100,100,77
"6655",54,"[40]BIhHoIpmtBkDFEEFKxnxJtbKDaezvHxnJHqvbGqa",202,0.990244,40,205,2,203,1,2,1,3,2,103,102,101,101,77
"6656",55,"[40]BIhHoIpmtBkDFEEFKxnxJtbKDaezvHxnJHqvbGqa",202,0.990244,40,205,2,203,1,2,1,3,2,102,101,102,102,77
"6657",56,"[40]BIhHoIpmtBkDFEEFKxnxJtbKDaezvHxnJHqvbGqa",203,0.990291,40,206,2,204,1,2,1,3,2,104,103,101,101,77
"6658",57,"[40]BIhHoIpmtBkDFEEFKxnxJtbKDaezvHxnJHqvbGqa",207,0.990476,40,210,2,208,1,2,1,3,2,112,111,97,97,77
"6659",58,"[40]BIhHoIpmtBkDFEEFKxnxJtbKDaezvHxnJHqvbGqa",200,0.990148,40,203,2,201,1,2,1,3,2,99,98,103,103,77
"6660",59,"[40]BIhHoIpmtBkDFEEFKxnxJtbKDaezvHxnJHqvbGqa",222,0.991111,40,225,2,223,1,2,1,3,2,133,132,91,91,77
"6661",60,"[40]BIhHoIpmtBkDFEEFKxnxJtbKDaezvHxnJHqvbGqa",193,0.989796,40,196,2,194,1,2,1,3,2,92,91,103,103,77
"6662",61,"[40]BIhHoIpmtBkDFEEFKxnxJtbKDaezvHxnJHqvbGqa",209,0.990566,40,212,2,210,1,2,1,3,2,113,112,98,98,77
"6663",62,"[40]BIhHoIpmtBkDFEEFKxnxJtbKDaezvHxnJHqvbGqa",211,0.990654,40,214,2,212,1,2,1,3,2,117,116,96,96,77
"6664",63,"[40]BIhHoIpmtBkDFEEFKxnxJtbKDaezvHxnJHqvbGqa",215,0.990826,40,218,2,216,1,2,1,3,2,121,120,96,96,77
"6665",64,"[40]BIhHoIpmtBkDFEEFKxnxJtbKDaezvHxnJHqvbGqa",213,0.990741,40,216,2,214,1,2,1,3,2,119,118,96,96,77
"6666",65,"[40]BIhHoIpmtBkDFEEFKxnxJtbKDaezvHxnJHqvbGqa",210,0.99061,40,213,2,211,1,2,1,3,2,113,112,99,99,77
"6667",66,"[40]BIhHoIpmtBkDFEEFKxnxJtbKDaezvHxnJHqvbGqa",206,0.990431,40,209,2,207,1,2,1,3,2,110,109,98,98,77
"6668",67,"[40]BIhHoIpmtBkDFEEFKxnxJtbKDaezvHxnJHqvbGqa",192,0.989744,40,195,2,193,1,2,1,3,2,90,89,104,104,77
"6669",68,"[40]BIhHoIpmtBkDFEEFKxnxJtbKDaezvHxnJHqvbGqa",181,0.98913,40,184,2,182,1,2,1,3,2,74,73,109,109,77
"6670",69,"[40]BIhHoIpmtBkDFEEFKxnxJtbKDaezvHxnJHqvbGqa",208,0.990521,40,211,2,209,1,2,1,3,2,112,111,98,98,77
"6671",70,"[40]BIhHoIpmtBkDFEEFKxnxJtbKDaezvHxnJHqvbGqa",210,0.99061,40,213,2,211,1,2,1,3,2,117,116,95,95,77
"6672",71,"[40]BIhHoIpmtBkDFEEFKxnxJtbKDaezvHxnJHqvbGqa",219,0.990991,40,222,2,220,1,2,1,3,2,125,124,96,96,77
"6673",72,"[40]BIhHoIpmtBkDFEEFKxnxJtbKDaezvHxnJHqvbGqa",202,0.990244,40,205,2,203,1,2,1,3,2,102,101,102,102,77
"6674",73,"[40]BIhHoIpmtBkDFEEFKxnxJtbKDaezvHxnJHqvbGqa",214,0.990783,40,217,2,215,1,2,1,3,2,120,119,96,96,77
"6675",74,"[40]BIhHoIpmtBkDFEEFKxnxJtbKDaezvHxnJHqvbGqa",208,0.990521,40,211,2,209,1,2,1,3,2,110,109,100,100,77
"6676",75,"[40]BIhHoIpmtBkDFEEFKxnxJtbKDaezvHxnJHqvbGqa",208,0.990521,40,211,2,209,1,2,1,3,2,111,110,99,99,77
"6677",76,"[40]BIhHoIpmtBkDFEEFKxnxJtbKDaezvHxnJHqvbGqa",205,0.990385,40,208,2,206,1,2,1,3,2,108,107,99,99,77
"6678",77,"[40]BIhHoIpmtBkDFEEFKxnxJtbKDaezvHxnJHqvbGqa",199,0.990099,40,202,2,200,1,2,1,3,2,102,101,99,99,77
"6679",78,"[40]BIhHoIpmtBkDFEEFKxnxJtbKDaezvHxnJHqvbGqa",200,0.990148,40,203,2,201,1,2,1,3,2,99,98,103,103,77
"6680",79,"[40]BIhHoIpmtBkDFEEFKxnxJtbKDaezvHxnJHqvbGqa",195,0.989899,40,198,2,196,1,2,1,3,2,94,93,103,103,77
"6681",80,"[40]BIhHoIpmtBkDFEEFKxnxJtbKDaezvHxnJHqvbGqa",195,0.989899,40,198,2,196,1,2,1,3,2,95,94,102,102,77
"6682",81,"[40]BIhHoIpmtBkDFEEFKxnxJtbKDaezvHxnJHqvbGqa",186,0.989418,40,189,2,187,1,2,1,3,2,82,81,106,106,77
"6683",82,"[40]BIhHoIpmtBkDFEEFKxnxJtbKDaezvHxnJHqvbGqa",203,0.990291,40,206,2,204,1,2,1,3,2,105,104,100,100,77
"6684",83,"[40]BIhHoIpmtBkDFEEFKxnxJtbKDaezvHxnJHqvbGqa",206,0.990431,40,209,2,207,1,2,1,3,2,109,108,99,99,77
"6685",84,"[40]BIhHoIpmtBkDFEEFKxnxJtbKDaezvHxnJHqvbGqa",195,0.989899,40,198,2,196,1,2,1,3,2,94,93,103,103,77
"6686",85,"[40]BIhHoIpmtBkDFEEFKxnxJtbKDaezvHxnJHqvbGqa",191,0.989691,40,194,2,192,1,2,1,3,2,90,89,103,103,77
"6687",86,"[40]BIhHoIpmtBkDFEEFKxnxJtbKDaezvHxnJHqvbGqa",205,0.990385,40,208,2,206,1,2,1,3,2,109,108,98,98,77
"6688",87,"[40]BIhHoIpmtBkDFEEFKxnxJtbKDaezvHxnJHqvbGqa",191,0.989691,40,194,2,192,1,2,1,3,2,88,87,105,105,77
"6689",88,"[40]BIhHoIpmtBkDFEEFKxnxJtbKDaezvHxnJHqvbGqa",201,0.990196,40,204,2,202,1,2,1,3,2,102,101,101,101,77
"6690",89,"[40]BIhHoIpmtBkDFEEFKxnxJtbKDaezvHxnJHqvbGqa",201,0.990196,40,204,2,202,1,2,1,3,2,101,100,102,102,77
"6691",90,"[40]BIhHoIpmtBkDFEEFKxnxJtbKDaezvHxnJHqvbGqa",217,0.990909,40,220,2,218,1,2,1,3,2,124,123,95,95,77
"6692",91,"[40]BIhHoIpmtBkDFEEFKxnxJtbKDaezvHxnJHqvbGqa",201,0.990196,40,204,2,202,1,2,1,3,2,105,104,98,98,77
"6693",92,"[40]BIhHoIpmtBkDFEEFKxnxJtbKDaezvHxnJHqvbGqa",190,0.989637,40,193,2,191,1,2,1,3,2,87,86,105,105,77
"6694",93,"[40]BIhHoIpmtBkDFEEFKxnxJtbKDaezvHxnJHqvbGqa",199,0.990099,40,202,2,200,1,2,1,3,2,100,99,101,101,77
"6695",94,"[40]BIhHoIpmtBkDFEEFKxnxJtbKDaezvHxnJHqvbGqa",200,0.990148,40,203,2,201,1,2,1,3,2,101,100,101,101,77
"6696",95,"[40]BIhHoIpmtBkDFEEFKxnxJtbKDaezvHxnJHqvbGqa",197,0.99,40,200,2,198,1,2,1,3,2,94,93,105,105,77
"6697",96,"[40]BIhHoIpmtBkDFEEFKxnxJtbKDaezvHxnJHqvbGqa",187,0.989474,40,190,2,188,1,2,1,3,2,85,84,104,104,77
"6698",97,"[40]BIhHoIpmtBkDFEEFKxnxJtbKDaezvHxnJHqvbGqa",200,0.990148,40,203,2,201,1,2,1,3,2,104,103,98,98,77
"6699",98,"[40]BIhHoIpmtBkDFEEFKxnxJtbKDaezvHxnJHqvbGqa",203,0.990291,40,206,2,204,1,2,1,3,2,105,104,100,100,77
"6700",99,"[40]BIhHoIpmtBkDFEEFKxnxJtbKDaezvHxnJHqvbGqa",205,0.990385,40,208,2,206,1,2,1,3,2,106,105,101,101,77
"6701",0,"[40]HIfHoIosnBkDkyxvyFDpzibKDeersHwnJHqwbGqa",193,0.989796,40,196,2,194,1,2,1,3,2,90,89,105,105,78
"6702",1,"[40]HIfHoIosnBkDkyxvyFDpzibKDeersHwnJHqwbGqa",195,0.989899,40,198,2,196,1,2,1,3,2,93,92,104,104,78
"6703",2,"[40]HIfHoIosnBkDkyxvyFDpzibKDeersHwnJHqwbGqa",190,0.989637,40,193,2,191,1,2,1,3,2,86,85,106,106,78
"6704",3,"[40]HIfHoIosnBkDkyxvyFDpzibKDeersHwnJHqwbGqa",211,0.990654,40,214,2,212,1,2,1,3,2,114,113,99,99,78
"6705",4,"[40]HIfHoIosnBkDkyxvyFDpzibKDeersHwnJHqwbGqa",196,0.98995,40,199,2,197,1,2,1,3,2,96,95,102,102,78
"6706",5,"[40]HIfHoIosnBkDkyxvyFDpzibKDeersHwnJHqwbGqa",196,0.98995,40,199,2,197,1,2,1,3,2,96,95,102,102,78
"6707",6,"[40]HIfHoIosnBkDkyxvyFDpzibKDeersHwnJHqwbGqa",193,0.989796,40,196,2,194,1,2,1,3,2,91,90,104,104,78
"6708",7,"[40]HIfHoIosnBkDkyxvyFDpzibKDeersHwnJHqwbGqa",200,0.990148,40,203,2,201,1,2,1,3,2,101,100,101,101,78
"6709",8,"[40]HIfHoIosnBkDkyxvyFDpzibKDeersHwnJHqwbGqa",194,0.989848,40,197,2,195,1,2,1,3,2,92,91,104,104,78
"6710",9,"[40]HIfHoIosnBkDkyxvyFDpzibKDeersHwnJHqwbGqa",183,0.989247,40,186,2,184,1,2,1,3,2,78,77,107,107,78
"6711",10,"[40]HIfHoIosnBkDkyxvyFDpzibKDeersHwnJHqwbGqa",209,0.990566,40,212,2,210,1,2,1,3,2,112,111,99,99,78
"6712",11,"[40]HIfHoIosnBkDkyxvyFDpzibKDeersHwnJHqwbGqa",195,0.989899,40,198,2,196,1,2,1,3,2,93,92,104,104,78
"6713",12,"[40]HIfHoIosnBkDkyxvyFDpzibKDeersHwnJHqwbGqa",211,0.990654,40,214,2,212,1,2,1,3,2,116,115,97,97,78
"6714",13,"[40]HIfHoIosnBkDkyxvyFDpzibKDeersHwnJHqwbGqa",191,0.989691,40,194,2,192,1,2,1,3,2,88,87,105,105,78
"6715",14,"[40]HIfHoIosnBkDkyxvyFDpzibKDeersHwnJHqwbGqa",198,0.99005,40,201,2,199,1,2,1,3,2,100,99,100,100,78
"6716",15,"[40]HIfHoIosnBkDkyxvyFDpzibKDeersHwnJHqwbGqa",200,0.990148,40,203,2,201,1,2,1,3,2,100,99,102,102,78
"6717",16,"[40]HIfHoIosnBkDkyxvyFDpzibKDeersHwnJHqwbGqa",214,0.990783,40,217,2,215,1,2,1,3,2,118,117,98,98,78
"6718",17,"[40]HIfHoIosnBkDkyxvyFDpzibKDeersHwnJHqwbGqa",204,0.990338,40,207,2,205,1,2,1,3,2,106,105,100,100,78
"6719",18,"[40]HIfHoIosnBkDkyxvyFDpzibKDeersHwnJHqwbGqa",197,0.99,40,200,2,198,1,2,1,3,2,97,96,102,102,78
"6720",19,"[40]HIfHoIosnBkDkyxvyFDpzibKDeersHwnJHqwbGqa",191,0.989691,40,194,2,192,1,2,1,3,2,87,86,106,106,78
"6721",20,"[40]HIfHoIosnBkDkyxvyFDpzibKDeersHwnJHqwbGqa",204,0.990338,40,207,2,205,1,2,1,3,2,107,106,99,99,78
"6722",21,"[40]HIfHoIosnBkDkyxvyFDpzibKDeersHwnJHqwbGqa",185,0.989362,40,188,2,186,1,2,1,3,2,83,82,104,104,78
"6723",22,"[40]HIfHoIosnBkDkyxvyFDpzibKDeersHwnJHqwbGqa",202,0.990244,40,205,2,203,1,2,1,3,2,105,104,99,99,78
"6724",23,"[40]HIfHoIosnBkDkyxvyFDpzibKDeersHwnJHqwbGqa",215,0.990826,40,218,2,216,1,2,1,3,2,122,121,95,95,78
"6725",24,"[40]HIfHoIosnBkDkyxvyFDpzibKDeersHwnJHqwbGqa",198,0.99005,40,201,2,199,1,2,1,3,2,99,98,101,101,78
"6726",25,"[40]HIfHoIosnBkDkyxvyFDpzibKDeersHwnJHqwbGqa",195,0.989899,40,198,2,196,1,2,1,3,2,94,93,103,103,78
"6727",26,"[40]HIfHoIosnBkDkyxvyFDpzibKDeersHwnJHqwbGqa",195,0.989899,40,198,2,196,1,2,1,3,2,91,90,106,106,78
"6728",27,"[40]HIfHoIosnBkDkyxvyFDpzibKDeersHwnJHqwbGqa",202,0.990244,40,205,2,203,1,2,1,3,2,104,103,100,100,78
"6729",28,"[40]HIfHoIosnBkDkyxvyFDpzibKDeersHwnJHqwbGqa",192,0.989744,40,195,2,193,1,2,1,3,2,90,89,104,104,78
"6730",29,"[40]HIfHoIosnBkDkyxvyFDpzibKDeersHwnJHqwbGqa",194,0.989848,40,197,2,195,1,2,1,3,2,92,91,104,104,78
"6731",30,"[40]HIfHoIosnBkDkyxvyFDpzibKDeersHwnJHqwbGqa",180,0.989071,40,183,2,181,1,2,1,3,2,74,73,108,108,78
"6732",31,"[40]HIfHoIosnBkDkyxvyFDpzibKDeersHwnJHqwbGqa",202,0.990244,40,205,2,203,1,2,1,3,2,103,102,101,101,78
"6733",32,"[40]HIfHoIosnBkDkyxvyFDpzibKDeersHwnJHqwbGqa",195,0.989899,40,198,2,196,1,2,1,3,2,94,93,103,103,78
"6734",33,"[40]HIfHoIosnBkDkyxvyFDpzibKDeersHwnJHqwbGqa",202,0.990244,40,205,2,203,1,2,1,3,2,105,104,99,99,78
"6735",34,"[40]HIfHoIosnBkDkyxvyFDpzibKDeersHwnJHqwbGqa",195,0.989899,40,198,2,196,1,2,1,3,2,94,93,103,103,78
"6736",35,"[40]HIfHoIosnBkDkyxvyFDpzibKDeersHwnJHqwbGqa",204,0.990338,40,207,2,205,1,2,1,3,2,106,105,100,100,78
"6737",36,"[40]HIfHoIosnBkDkyxvyFDpzibKDeersHwnJHqwbGqa",216,0.990868,40,219,2,217,1,2,1,3,2,124,123,94,94,78
"6738",37,"[40]HIfHoIosnBkDkyxvyFDpzibKDeersHwnJHqwbGqa",192,0.989744,40,195,2,193,1,2,1,3,2,91,90,103,103,78
"6739",38,"[40]HIfHoIosnBkDkyxvyFDpzibKDeersHwnJHqwbGqa",207,0.990476,40,210,2,208,1,2,1,3,2,110,109,99,99,78
"6740",39,"[40]HIfHoIosnBkDkyxvyFDpzibKDeersHwnJHqwbGqa",212,0.990698,40,215,2,213,1,2,1,3,2,118,117,96,96,78
"6741",40,"[40]HIfHoIosnBkDkyxvyFDpzibKDeersHwnJHqwbGqa",206,0.990431,40,209,2,207,1,2,1,3,2,111,110,97,97,78
"6742",41,"[40]HIfHoIosnBkDkyxvyFDpzibKDeersHwnJHqwbGqa",205,0.990385,40,208,2,206,1,2,1,3,2,108,107,99,99,78
"6743",42,"[40]HIfHoIosnBkDkyxvyFDpzibKDeersHwnJHqwbGqa",207,0.990476,40,210,2,208,1,2,1,3,2,109,108,100,100,78
"6744",43,"[40]HIfHoIosnBkDkyxvyFDpzibKDeersHwnJHqwbGqa",199,0.990099,40,202,2,200,1,2,1,3,2,99,98,102,102,78
"6745",44,"[40]HIfHoIosnBkDkyxvyFDpzibKDeersHwnJHqwbGqa",200,0.990148,40,203,2,201,1,2,1,3,2,100,99,102,102,78
"6746",45,"[40]HIfHoIosnBkDkyxvyFDpzibKDeersHwnJHqwbGqa",213,0.990741,40,216,2,214,1,2,1,3,2,116,115,99,99,78
"6747",46,"[40]HIfHoIosnBkDkyxvyFDpzibKDeersHwnJHqwbGqa",206,0.990431,40,209,2,207,1,2,1,3,2,110,109,98,98,78
"6748",47,"[40]HIfHoIosnBkDkyxvyFDpzibKDeersHwnJHqwbGqa",208,0.990521,40,211,2,209,1,2,1,3,2,109,108,101,101,78
"6749",48,"[40]HIfHoIosnBkDkyxvyFDpzibKDeersHwnJHqwbGqa",192,0.989744,40,195,2,193,1,2,1,3,2,91,90,103,103,78
"6750",49,"[40]HIfHoIosnBkDkyxvyFDpzibKDeersHwnJHqwbGqa",197,0.99,40,200,2,198,1,2,1,3,2,96,95,103,103,78
"6751",50,"[40]HIfHoIosnBkDkyxvyFDpzibKDeersHwnJHqwbGqa",196,0.98995,40,199,2,197,1,2,1,3,2,95,94,103,103,78
"6752",51,"[40]HIfHoIosnBkDkyxvyFDpzibKDeersHwnJHqwbGqa",215,0.990826,40,218,2,216,1,2,1,3,2,121,120,96,96,78
"6753",52,"[40]HIfHoIosnBkDkyxvyFDpzibKDeersHwnJHqwbGqa",203,0.990291,40,206,2,204,1,2,1,3,2,102,101,103,103,78
"6754",53,"[40]HIfHoIosnBkDkyxvyFDpzibKDeersHwnJHqwbGqa",193,0.989796,40,196,2,194,1,2,1,3,2,89,88,106,106,78
"6755",54,"[40]HIfHoIosnBkDkyxvyFDpzibKDeersHwnJHqwbGqa",205,0.990385,40,208,2,206,1,2,1,3,2,107,106,100,100,78
"6756",55,"[40]HIfHoIosnBkDkyxvyFDpzibKDeersHwnJHqwbGqa",211,0.990654,40,214,2,212,1,2,1,3,2,117,116,96,96,78
"6757",56,"[40]HIfHoIosnBkDkyxvyFDpzibKDeersHwnJHqwbGqa",204,0.990338,40,207,2,205,1,2,1,3,2,107,106,99,99,78
"6758",57,"[40]HIfHoIosnBkDkyxvyFDpzibKDeersHwnJHqwbGqa",200,0.990148,40,203,2,201,1,2,1,3,2,100,99,102,102,78
"6759",58,"[40]HIfHoIosnBkDkyxvyFDpzibKDeersHwnJHqwbGqa",195,0.989899,40,198,2,196,1,2,1,3,2,95,94,102,102,78
"6760",59,"[40]HIfHoIosnBkDkyxvyFDpzibKDeersHwnJHqwbGqa",199,0.990099,40,202,2,200,1,2,1,3,2,99,98,102,102,78
"6761",60,"[40]HIfHoIosnBkDkyxvyFDpzibKDeersHwnJHqwbGqa",202,0.990244,40,205,2,203,1,2,1,3,2,104,103,100,100,78
"6762",61,"[40]HIfHoIosnBkDkyxvyFDpzibKDeersHwnJHqwbGqa",197,0.99,40,200,2,198,1,2,1,3,2,97,96,102,102,78
"6763",62,"[40]HIfHoIosnBkDkyxvyFDpzibKDeersHwnJHqwbGqa",205,0.990385,40,208,2,206,1,2,1,3,2,110,109,97,97,78
"6764",63,"[40]HIfHoIosnBkDkyxvyFDpzibKDeersHwnJHqwbGqa",195,0.989899,40,198,2,196,1,2,1,3,2,93,92,104,104,78
"6765",64,"[40]HIfHoIosnBkDkyxvyFDpzibKDeersHwnJHqwbGqa",202,0.990244,40,205,2,203,1,2,1,3,2,105,104,99,99,78
"6766",65,"[40]HIfHoIosnBkDkyxvyFDpzibKDeersHwnJHqwbGqa",199,0.990099,40,202,2,200,1,2,1,3,2,101,100,100,100,78
"6767",66,"[40]HIfHoIosnBkDkyxvyFDpzibKDeersHwnJHqwbGqa",194,0.989848,40,197,2,195,1,2,1,3,2,92,91,104,104,78
"6768",67,"[40]HIfHoIosnBkDkyxvyFDpzibKDeersHwnJHqwbGqa",207,0.990476,40,210,2,208,1,2,1,3,2,111,110,98,98,78
"6769",68,"[40]HIfHoIosnBkDkyxvyFDpzibKDeersHwnJHqwbGqa",210,0.99061,40,213,2,211,1,2,1,3,2,115,114,97,97,78
"6770",69,"[40]HIfHoIosnBkDkyxvyFDpzibKDeersHwnJHqwbGqa",201,0.990196,40,204,2,202,1,2,1,3,2,101,100,102,102,78
"6771",70,"[40]HIfHoIosnBkDkyxvyFDpzibKDeersHwnJHqwbGqa",196,0.98995,40,199,2,197,1,2,1,3,2,96,95,102,102,78
"6772",71,"[40]HIfHoIosnBkDkyxvyFDpzibKDeersHwnJHqwbGqa",198,0.99005,40,201,2,199,1,2,1,3,2,95,94,105,105,78
"6773",72,"[40]HIfHoIosnBkDkyxvyFDpzibKDeersHwnJHqwbGqa",207,0.990476,40,210,2,208,1,2,1,3,2,108,107,101,101,78
"6774",73,"[40]HIfHoIosnBkDkyxvyFDpzibKDeersHwnJHqwbGqa",204,0.990338,40,207,2,205,1,2,1,3,2,107,106,99,99,78
"6775",74,"[40]HIfHoIosnBkDkyxvyFDpzibKDeersHwnJHqwbGqa",189,0.989583,40,192,2,190,1,2,1,3,2,89,88,102,102,78
"6776",75,"[40]HIfHoIosnBkDkyxvyFDpzibKDeersHwnJHqwbGqa",192,0.989744,40,195,2,193,1,2,1,3,2,92,91,102,102,78
"6777",76,"[40]HIfHoIosnBkDkyxvyFDpzibKDeersHwnJHqwbGqa",190,0.989637,40,193,2,191,1,2,1,3,2,87,86,105,105,78
"6778",77,"[40]HIfHoIosnBkDkyxvyFDpzibKDeersHwnJHqwbGqa",197,0.99,40,200,2,198,1,2,1,3,2,96,95,103,103,78
"6779",78,"[40]HIfHoIosnBkDkyxvyFDpzibKDeersHwnJHqwbGqa",214,0.990783,40,217,2,215,1,2,1,3,2,118,117,98,98,78
"6780",79,"[40]HIfHoIosnBkDkyxvyFDpzibKDeersHwnJHqwbGqa",200,0.990148,40,203,2,201,1,2,1,3,2,100,99,102,102,78
"6781",80,"[40]HIfHoIosnBkDkyxvyFDpzibKDeersHwnJHqwbGqa",186,0.989418,40,189,2,187,1,2,1,3,2,82,81,106,106,78
"6782",81,"[40]HIfHoIosnBkDkyxvyFDpzibKDeersHwnJHqwbGqa",198,0.99005,40,201,2,199,1,2,1,3,2,99,98,101,101,78
"6783",82,"[40]HIfHoIosnBkDkyxvyFDpzibKDeersHwnJHqwbGqa",199,0.990099,40,202,2,200,1,2,1,3,2,101,100,100,100,78
"6784",83,"[40]HIfHoIosnBkDkyxvyFDpzibKDeersHwnJHqwbGqa",189,0.989583,40,192,2,190,1,2,1,3,2,86,85,105,105,78
"6785",84,"[40]HIfHoIosnBkDkyxvyFDpzibKDeersHwnJHqwbGqa",199,0.990099,40,202,2,200,1,2,1,3,2,101,100,100,100,78
"6786",85,"[40]HIfHoIosnBkDkyxvyFDpzibKDeersHwnJHqwbGqa",206,0.990431,40,209,2,207,1,2,1,3,2,109,108,99,99,78
"6787",86,"[40]HIfHoIosnBkDkyxvyFDpzibKDeersHwnJHqwbGqa",205,0.990385,40,208,2,206,1,2,1,3,2,108,107,99,99,78
"6788",87,"[40]HIfHoIosnBkDkyxvyFDpzibKDeersHwnJHqwbGqa",199,0.990099,40,202,2,200,1,2,1,3,2,97,96,104,104,78
"6789",88,"[40]HIfHoIosnBkDkyxvyFDpzibKDeersHwnJHqwbGqa",202,0.990244,40,205,2,203,1,2,1,3,2,102,101,102,102,78
"6790",89,"[40]HIfHoIosnBkDkyxvyFDpzibKDeersHwnJHqwbGqa",197,0.99,40,200,2,198,1,2,1,3,2,96,95,103,103,78
"6791",90,"[40]HIfHoIosnBkDkyxvyFDpzibKDeersHwnJHqwbGqa",199,0.990099,40,202,2,200,1,2,1,3,2,100,99,101,101,78
"6792",91,"[40]HIfHoIosnBkDkyxvyFDpzibKDeersHwnJHqwbGqa",205,0.990385,40,208,2,206,1,2,1,3,2,109,108,98,98,78
"6793",92,"[40]HIfHoIosnBkDkyxvyFDpzibKDeersHwnJHqwbGqa",196,0.98995,40,199,2,197,1,2,1,3,2,97,96,101,101,78
"6794",93,"[40]HIfHoIosnBkDkyxvyFDpzibKDeersHwnJHqwbGqa",199,0.990099,40,202,2,200,1,2,1,3,2,101,100,100,100,78
"6795",94,"[40]HIfHoIosnBkDkyxvyFDpzibKDeersHwnJHqwbGqa",199,0.990099,40,202,2,200,1,2,1,3,2,99,98,102,102,78
"6796",95,"[40]HIfHoIosnBkDkyxvyFDpzibKDeersHwnJHqwbGqa",199,0.990099,40,202,2,200,1,2,1,3,2,100,99,101,101,78
"6797",96,"[40]HIfHoIosnBkDkyxvyFDpzibKDeersHwnJHqwbGqa",211,0.990654,40,214,2,212,1,2,1,3,2,113,112,100,100,78
"6798",97,"[40]HIfHoIosnBkDkyxvyFDpzibKDeersHwnJHqwbGqa",192,0.989744,40,195,2,193,1,2,1,3,2,89,88,105,105,78
"6799",98,"[40]HIfHoIosnBkDkyxvyFDpzibKDeersHwnJHqwbGqa",207,0.990476,40,210,2,208,1,2,1,3,2,110,109,99,99,78
"6800",99,"[40]HIfHoIosnBkDkyxvyFDpzibKDeersHwnJHqwbGqa",198,0.99005,40,201,2,199,1,2,1,3,2,97,96,103,103,78
"6801",0,"[40]BIEHoIoJeBkoCDhcoexDiIiAJpHbKHtnJHqvbGqa",222,0.991111,40,225,2,223,1,2,1,3,2,117,116,107,107,79
"6802",1,"[40]BIEHoIoJeBkoCDhcoexDiIiAJpHbKHtnJHqvbGqa",211,0.990654,40,214,2,212,1,2,1,3,2,103,102,110,110,79
"6803",2,"[40]BIEHoIoJeBkoCDhcoexDiIiAJpHbKHtnJHqvbGqa",221,0.991071,40,224,2,222,1,2,1,3,2,115,114,108,108,79
"6804",3,"[40]BIEHoIoJeBkoCDhcoexDiIiAJpHbKHtnJHqvbGqa",211,0.990654,40,214,2,212,1,2,1,3,2,98,97,115,115,79
"6805",4,"[40]BIEHoIoJeBkoCDhcoexDiIiAJpHbKHtnJHqvbGqa",209,0.990566,40,212,2,210,1,2,1,3,2,98,97,113,113,79
"6806",5,"[40]BIEHoIoJeBkoCDhcoexDiIiAJpHbKHtnJHqvbGqa",235,0.991597,40,238,2,236,1,2,1,3,2,135,134,102,102,79
"6807",6,"[40]BIEHoIoJeBkoCDhcoexDiIiAJpHbKHtnJHqvbGqa",217,0.990909,40,220,2,218,1,2,1,3,2,108,107,111,111,79
"6808",7,"[40]BIEHoIoJeBkoCDhcoexDiIiAJpHbKHtnJHqvbGqa",213,0.990741,40,216,2,214,1,2,1,3,2,104,103,111,111,79
"6809",8,"[40]BIEHoIoJeBkoCDhcoexDiIiAJpHbKHtnJHqvbGqa",221,0.991071,40,224,2,222,1,2,1,3,2,115,114,108,108,79
"6810",9,"[40]BIEHoIoJeBkoCDhcoexDiIiAJpHbKHtnJHqvbGqa",209,0.990566,40,212,2,210,1,2,1,3,2,100,99,111,111,79
"6811",10,"[40]BIEHoIoJeBkoCDhcoexDiIiAJpHbKHtnJHqvbGqa",209,0.990566,40,212,2,210,1,2,1,3,2,96,95,115,115,79
"6812",11,"[40]BIEHoIoJeBkoCDhcoexDiIiAJpHbKHtnJHqvbGqa",220,0.991031,40,223,2,221,1,2,1,3,2,114,113,108,108,79
"6813",12,"[40]BIEHoIoJeBkoCDhcoexDiIiAJpHbKHtnJHqvbGqa",213,0.990741,40,216,2,214,1,2,1,3,2,107,106,108,108,79
"6814",13,"[40]BIEHoIoJeBkoCDhcoexDiIiAJpHbKHtnJHqvbGqa",220,0.991031,40,223,2,221,1,2,1,3,2,113,112,109,109,79
"6815",14,"[40]BIEHoIoJeBkoCDhcoexDiIiAJpHbKHtnJHqvbGqa",213,0.990741,40,216,2,214,1,2,1,3,2,104,103,111,111,79
"6816",15,"[40]BIEHoIoJeBkoCDhcoexDiIiAJpHbKHtnJHqvbGqa",225,0.991228,40,228,2,226,1,2,1,3,2,121,120,106,106,79
"6817",16,"[40]BIEHoIoJeBkoCDhcoexDiIiAJpHbKHtnJHqvbGqa",217,0.990909,40,220,2,218,1,2,1,3,2,110,109,109,109,79
"6818",17,"[40]BIEHoIoJeBkoCDhcoexDiIiAJpHbKHtnJHqvbGqa",215,0.990826,40,218,2,216,1,2,1,3,2,105,104,112,112,79
"6819",18,"[40]BIEHoIoJeBkoCDhcoexDiIiAJpHbKHtnJHqvbGqa",217,0.990909,40,220,2,218,1,2,1,3,2,109,108,110,110,79
"6820",19,"[40]BIEHoIoJeBkoCDhcoexDiIiAJpHbKHtnJHqvbGqa",205,0.990385,40,208,2,206,1,2,1,3,2,92,91,115,115,79
"6821",20,"[40]BIEHoIoJeBkoCDhcoexDiIiAJpHbKHtnJHqvbGqa",216,0.990868,40,219,2,217,1,2,1,3,2,107,106,111,111,79
"6822",21,"[40]BIEHoIoJeBkoCDhcoexDiIiAJpHbKHtnJHqvbGqa",210,0.99061,40,213,2,211,1,2,1,3,2,98,97,114,114,79
"6823",22,"[40]BIEHoIoJeBkoCDhcoexDiIiAJpHbKHtnJHqvbGqa",218,0.99095,40,221,2,219,1,2,1,3,2,110,109,110,110,79
"6824",23,"[40]BIEHoIoJeBkoCDhcoexDiIiAJpHbKHtnJHqvbGqa",234,0.991561,40,237,2,235,1,2,1,3,2,136,135,100,100,79
"6825",24,"[40]BIEHoIoJeBkoCDhcoexDiIiAJpHbKHtnJHqvbGqa",220,0.991031,40,223,2,221,1,2,1,3,2,111,110,111,111,79
"6826",25,"[40]BIEHoIoJeBkoCDhcoexDiIiAJpHbKHtnJHqvbGqa",204,0.990338,40,207,2,205,1,2,1,3,2,93,92,113,113,79
"6827",26,"[40]BIEHoIoJeBkoCDhcoexDiIiAJpHbKHtnJHqvbGqa",213,0.990741,40,216,2,214,1,2,1,3,2,105,104,110,110,79
"6828",27,"[40]BIEHoIoJeBkoCDhcoexDiIiAJpHbKHtnJHqvbGqa",223,0.99115,40,226,2,224,1,2,1,3,2,119,118,106,106,79
"6829",28,"[40]BIEHoIoJeBkoCDhcoexDiIiAJpHbKHtnJHqvbGqa",210,0.99061,40,213,2,211,1,2,1,3,2,99,98,113,113,79
"6830",29,"[40]BIEHoIoJeBkoCDhcoexDiIiAJpHbKHtnJHqvbGqa",220,0.991031,40,223,2,221,1,2,1,3,2,114,113,108,108,79
"6831",30,"[40]BIEHoIoJeBkoCDhcoexDiIiAJpHbKHtnJHqvbGqa",216,0.990868,40,219,2,217,1,2,1,3,2,107,106,111,111,79
"6832",31,"[40]BIEHoIoJeBkoCDhcoexDiIiAJpHbKHtnJHqvbGqa",223,0.99115,40,226,2,224,1,2,1,3,2,121,120,104,104,79
"6833",32,"[40]BIEHoIoJeBkoCDhcoexDiIiAJpHbKHtnJHqvbGqa",223,0.99115,40,226,2,224,1,2,1,3,2,118,117,107,107,79
"6834",33,"[40]BIEHoIoJeBkoCDhcoexDiIiAJpHbKHtnJHqvbGqa",210,0.99061,40,213,2,211,1,2,1,3,2,98,97,114,114,79
"6835",34,"[40]BIEHoIoJeBkoCDhcoexDiIiAJpHbKHtnJHqvbGqa",212,0.990698,40,215,2,213,1,2,1,3,2,100,99,114,114,79
"6836",35,"[40]BIEHoIoJeBkoCDhcoexDiIiAJpHbKHtnJHqvbGqa",211,0.990654,40,214,2,212,1,2,1,3,2,99,98,114,114,79
"6837",36,"[40]BIEHoIoJeBkoCDhcoexDiIiAJpHbKHtnJHqvbGqa",208,0.990521,40,211,2,209,1,2,1,3,2,99,98,111,111,79
"6838",37,"[40]BIEHoIoJeBkoCDhcoexDiIiAJpHbKHtnJHqvbGqa",211,0.990654,40,214,2,212,1,2,1,3,2,101,100,112,112,79
"6839",38,"[40]BIEHoIoJeBkoCDhcoexDiIiAJpHbKHtnJHqvbGqa",213,0.990741,40,216,2,214,1,2,1,3,2,105,104,110,110,79
"6840",39,"[40]BIEHoIoJeBkoCDhcoexDiIiAJpHbKHtnJHqvbGqa",207,0.990476,40,210,2,208,1,2,1,3,2,99,98,110,110,79
"6841",40,"[40]BIEHoIoJeBkoCDhcoexDiIiAJpHbKHtnJHqvbGqa",226,0.991266,40,229,2,227,1,2,1,3,2,124,123,104,104,79
"6842",41,"[40]BIEHoIoJeBkoCDhcoexDiIiAJpHbKHtnJHqvbGqa",209,0.990566,40,212,2,210,1,2,1,3,2,99,98,112,112,79
"6843",42,"[40]BIEHoIoJeBkoCDhcoexDiIiAJpHbKHtnJHqvbGqa",217,0.990909,40,220,2,218,1,2,1,3,2,110,109,109,109,79
"6844",43,"[40]BIEHoIoJeBkoCDhcoexDiIiAJpHbKHtnJHqvbGqa",212,0.990698,40,215,2,213,1,2,1,3,2,108,107,106,106,79
"6845",44,"[40]BIEHoIoJeBkoCDhcoexDiIiAJpHbKHtnJHqvbGqa",221,0.991071,40,224,2,222,1,2,1,3,2,115,114,108,108,79
"6846",45,"[40]BIEHoIoJeBkoCDhcoexDiIiAJpHbKHtnJHqvbGqa",225,0.991228,40,228,2,226,1,2,1,3,2,123,122,104,104,79
"6847",46,"[40]BIEHoIoJeBkoCDhcoexDiIiAJpHbKHtnJHqvbGqa",216,0.990868,40,219,2,217,1,2,1,3,2,108,107,110,110,79
"6848",47,"[40]BIEHoIoJeBkoCDhcoexDiIiAJpHbKHtnJHqvbGqa",216,0.990868,40,219,2,217,1,2,1,3,2,111,110,107,107,79
"6849",48,"[40]BIEHoIoJeBkoCDhcoexDiIiAJpHbKHtnJHqvbGqa",218,0.99095,40,221,2,219,1,2,1,3,2,113,112,107,107,79
"6850",49,"[40]BIEHoIoJeBkoCDhcoexDiIiAJpHbKHtnJHqvbGqa",226,0.991266,40,229,2,227,1,2,1,3,2,124,123,104,104,79
"6851",50,"[40]BIEHoIoJeBkoCDhcoexDiIiAJpHbKHtnJHqvbGqa",204,0.990338,40,207,2,205,1,2,1,3,2,92,91,114,114,79
"6852",51,"[40]BIEHoIoJeBkoCDhcoexDiIiAJpHbKHtnJHqvbGqa",209,0.990566,40,212,2,210,1,2,1,3,2,101,100,110,110,79
"6853",52,"[40]BIEHoIoJeBkoCDhcoexDiIiAJpHbKHtnJHqvbGqa",221,0.991071,40,224,2,222,1,2,1,3,2,116,115,107,107,79
"6854",53,"[40]BIEHoIoJeBkoCDhcoexDiIiAJpHbKHtnJHqvbGqa",208,0.990521,40,211,2,209,1,2,1,3,2,97,96,113,113,79
"6855",54,"[40]BIEHoIoJeBkoCDhcoexDiIiAJpHbKHtnJHqvbGqa",223,0.99115,40,226,2,224,1,2,1,3,2,121,120,104,104,79
"6856",55,"[40]BIEHoIoJeBkoCDhcoexDiIiAJpHbKHtnJHqvbGqa",217,0.990909,40,220,2,218,1,2,1,3,2,110,109,109,109,79
"6857",56,"[40]BIEHoIoJeBkoCDhcoexDiIiAJpHbKHtnJHqvbGqa",204,0.990338,40,207,2,205,1,2,1,3,2,92,91,114,114,79
"6858",57,"[40]BIEHoIoJeBkoCDhcoexDiIiAJpHbKHtnJHqvbGqa",213,0.990741,40,216,2,214,1,2,1,3,2,101,100,114,114,79
"6859",58,"[40]BIEHoIoJeBkoCDhcoexDiIiAJpHbKHtnJHqvbGqa",220,0.991031,40,223,2,221,1,2,1,3,2,113,112,109,109,79
"6860",59,"[40]BIEHoIoJeBkoCDhcoexDiIiAJpHbKHtnJHqvbGqa",226,0.991266,40,229,2,227,1,2,1,3,2,123,122,105,105,79
"6861",60,"[40]BIEHoIoJeBkoCDhcoexDiIiAJpHbKHtnJHqvbGqa",212,0.990698,40,215,2,213,1,2,1,3,2,101,100,113,113,79
"6862",61,"[40]BIEHoIoJeBkoCDhcoexDiIiAJpHbKHtnJHqvbGqa",223,0.99115,40,226,2,224,1,2,1,3,2,116,115,109,109,79
"6863",62,"[40]BIEHoIoJeBkoCDhcoexDiIiAJpHbKHtnJHqvbGqa",207,0.990476,40,210,2,208,1,2,1,3,2,97,96,112,112,79
"6864",63,"[40]BIEHoIoJeBkoCDhcoexDiIiAJpHbKHtnJHqvbGqa",214,0.990783,40,217,2,215,1,2,1,3,2,106,105,110,110,79
"6865",64,"[40]BIEHoIoJeBkoCDhcoexDiIiAJpHbKHtnJHqvbGqa",231,0.991453,40,234,2,232,1,2,1,3,2,129,128,104,104,79
"6866",65,"[40]BIEHoIoJeBkoCDhcoexDiIiAJpHbKHtnJHqvbGqa",199,0.990099,40,202,2,200,1,2,1,3,2,88,87,113,113,79
"6867",66,"[40]BIEHoIoJeBkoCDhcoexDiIiAJpHbKHtnJHqvbGqa",225,0.991228,40,228,2,226,1,2,1,3,2,117,116,110,110,79
"6868",67,"[40]BIEHoIoJeBkoCDhcoexDiIiAJpHbKHtnJHqvbGqa",220,0.991031,40,223,2,221,1,2,1,3,2,110,109,112,112,79
"6869",68,"[40]BIEHoIoJeBkoCDhcoexDiIiAJpHbKHtnJHqvbGqa",212,0.990698,40,215,2,213,1,2,1,3,2,102,101,112,112,79
"6870",69,"[40]BIEHoIoJeBkoCDhcoexDiIiAJpHbKHtnJHqvbGqa",211,0.990654,40,214,2,212,1,2,1,3,2,100,99,113,113,79
"6871",70,"[40]BIEHoIoJeBkoCDhcoexDiIiAJpHbKHtnJHqvbGqa",211,0.990654,40,214,2,212,1,2,1,3,2,103,102,110,110,79
"6872",71,"[40]BIEHoIoJeBkoCDhcoexDiIiAJpHbKHtnJHqvbGqa",226,0.991266,40,229,2,227,1,2,1,3,2,124,123,104,104,79
"6873",72,"[40]BIEHoIoJeBkoCDhcoexDiIiAJpHbKHtnJHqvbGqa",218,0.99095,40,221,2,219,1,2,1,3,2,112,111,108,108,79
"6874",73,"[40]BIEHoIoJeBkoCDhcoexDiIiAJpHbKHtnJHqvbGqa",207,0.990476,40,210,2,208,1,2,1,3,2,94,93,115,115,79
"6875",74,"[40]BIEHoIoJeBkoCDhcoexDiIiAJpHbKHtnJHqvbGqa",234,0.991561,40,237,2,235,1,2,1,3,2,133,132,103,103,79
"6876",75,"[40]BIEHoIoJeBkoCDhcoexDiIiAJpHbKHtnJHqvbGqa",212,0.990698,40,215,2,213,1,2,1,3,2,106,105,108,108,79
"6877",76,"[40]BIEHoIoJeBkoCDhcoexDiIiAJpHbKHtnJHqvbGqa",211,0.990654,40,214,2,212,1,2,1,3,2,99,98,114,114,79
"6878",77,"[40]BIEHoIoJeBkoCDhcoexDiIiAJpHbKHtnJHqvbGqa",209,0.990566,40,212,2,210,1,2,1,3,2,98,97,113,113,79
"6879",78,"[40]BIEHoIoJeBkoCDhcoexDiIiAJpHbKHtnJHqvbGqa",216,0.990868,40,219,2,217,1,2,1,3,2,110,109,108,108,79
"6880",79,"[40]BIEHoIoJeBkoCDhcoexDiIiAJpHbKHtnJHqvbGqa",232,0.991489,40,235,2,233,1,2,1,3,2,133,132,101,101,79
"6881",80,"[40]BIEHoIoJeBkoCDhcoexDiIiAJpHbKHtnJHqvbGqa",228,0.991342,40,231,2,229,1,2,1,3,2,126,125,104,104,79
"6882",81,"[40]BIEHoIoJeBkoCDhcoexDiIiAJpHbKHtnJHqvbGqa",219,0.990991,40,222,2,220,1,2,1,3,2,114,113,107,107,79
"6883",82,"[40]BIEHoIoJeBkoCDhcoexDiIiAJpHbKHtnJHqvbGqa",211,0.990654,40,214,2,212,1,2,1,3,2,103,102,110,110,79
"6884",83,"[40]BIEHoIoJeBkoCDhcoexDiIiAJpHbKHtnJHqvbGqa",222,0.991111,40,225,2,223,1,2,1,3,2,116,115,108,108,79
"6885",84,"[40]BIEHoIoJeBkoCDhcoexDiIiAJpHbKHtnJHqvbGqa",211,0.990654,40,214,2,212,1,2,1,3,2,99,98,114,114,79
"6886",85,"[40]BIEHoIoJeBkoCDhcoexDiIiAJpHbKHtnJHqvbGqa",216,0.990868,40,219,2,217,1,2,1,3,2,107,106,111,111,79
"6887",86,"[40]BIEHoIoJeBkoCDhcoexDiIiAJpHbKHtnJHqvbGqa",240,0.99177,40,243,2,241,1,2,1,3,2,142,141,100,100,79
"6888",87,"[40]BIEHoIoJeBkoCDhcoexDiIiAJpHbKHtnJHqvbGqa",226,0.991266,40,229,2,227,1,2,1,3,2,120,119,108,108,79
"6889",88,"[40]BIEHoIoJeBkoCDhcoexDiIiAJpHbKHtnJHqvbGqa",225,0.991228,40,228,2,226,1,2,1,3,2,123,122,104,104,79
"6890",89,"[40]BIEHoIoJeBkoCDhcoexDiIiAJpHbKHtnJHqvbGqa",219,0.990991,40,222,2,220,1,2,1,3,2,111,110,110,110,79
"6891",90,"[40]BIEHoIoJeBkoCDhcoexDiIiAJpHbKHtnJHqvbGqa",224,0.991189,40,227,2,225,1,2,1,3,2,121,120,105,105,79
"6892",91,"[40]BIEHoIoJeBkoCDhcoexDiIiAJpHbKHtnJHqvbGqa",229,0.991379,40,232,2,230,1,2,1,3,2,125,124,106,106,79
"6893",92,"[40]BIEHoIoJeBkoCDhcoexDiIiAJpHbKHtnJHqvbGqa",226,0.991266,40,229,2,227,1,2,1,3,2,123,122,105,105,79
"6894",93,"[40]BIEHoIoJeBkoCDhcoexDiIiAJpHbKHtnJHqvbGqa",209,0.990566,40,212,2,210,1,2,1,3,2,100,99,111,111,79
"6895",94,"[40]BIEHoIoJeBkoCDhcoexDiIiAJpHbKHtnJHqvbGqa",210,0.99061,40,213,2,211,1,2,1,3,2,103,102,109,109,79
"6896",95,"[40]BIEHoIoJeBkoCDhcoexDiIiAJpHbKHtnJHqvbGqa",220,0.991031,40,223,2,221,1,2,1,3,2,114,113,108,108,79
"6897",96,"[40]BIEHoIoJeBkoCDhcoexDiIiAJpHbKHtnJHqvbGqa",220,0.991031,40,223,2,221,1,2,1,3,2,114,113,108,108,79
"6898",97,"[40]BIEHoIoJeBkoCDhcoexDiIiAJpHbKHtnJHqvbGqa",224,0.991189,40,227,2,225,1,2,1,3,2,120,119,106,106,79
"6899",98,"[40]BIEHoIoJeBkoCDhcoexDiIiAJpHbKHtnJHqvbGqa",206,0.990431,40,209,2,207,1,2,1,3,2,95,94,113,113,79
"6900",99,"[40]BIEHoIoJeBkoCDhcoexDiIiAJpHbKHtnJHqvbGqa",221,0.991071,40,224,2,222,1,2,1,3,2,116,115,107,107,79
"6901",0,"[40]tIiHoIsdsBkDAbHdFdJenibKDeertHxnJHqvbGqa",209,0.990566,40,212,2,210,1,2,1,3,2,112,111,99,99,80
"6902",1,"[40]tIiHoIsdsBkDAbHdFdJenibKDeertHxnJHqvbGqa",203,0.990291,40,206,2,204,1,2,1,3,2,104,103,101,101,80
"6903",2,"[40]tIiHoIsdsBkDAbHdFdJenibKDeertHxnJHqvbGqa",215,0.990826,40,218,2,216,1,2,1,3,2,123,122,94,94,80
"6904",3,"[40]tIiHoIsdsBkDAbHdFdJenibKDeertHxnJHqvbGqa",197,0.99,40,200,2,198,1,2,1,3,2,95,94,104,104,80
"6905",4,"[40]tIiHoIsdsBkDAbHdFdJenibKDeertHxnJHqvbGqa",189,0.989583,40,192,2,190,1,2,1,3,2,86,85,105,105,80
"6906",5,"[40]tIiHoIsdsBkDAbHdFdJenibKDeertHxnJHqvbGqa",191,0.989691,40,194,2,192,1,2,1,3,2,87,86,106,106,80
"6907",6,"[40]tIiHoIsdsBkDAbHdFdJenibKDeertHxnJHqvbGqa",211,0.990654,40,214,2,212,1,2,1,3,2,116,115,97,97,80
"6908",7,"[40]tIiHoIsdsBkDAbHdFdJenibKDeertHxnJHqvbGqa",195,0.989899,40,198,2,196,1,2,1,3,2,92,91,105,105,80
"6909",8,"[40]tIiHoIsdsBkDAbHdFdJenibKDeertHxnJHqvbGqa",201,0.990196,40,204,2,202,1,2,1,3,2,103,102,100,100,80
"6910",9,"[40]tIiHoIsdsBkDAbHdFdJenibKDeertHxnJHqvbGqa",215,0.990826,40,218,2,216,1,2,1,3,2,121,120,96,96,80
"6911",10,"[40]tIiHoIsdsBkDAbHdFdJenibKDeertHxnJHqvbGqa",203,0.990291,40,206,2,204,1,2,1,3,2,104,103,101,101,80
"6912",11,"[40]tIiHoIsdsBkDAbHdFdJenibKDeertHxnJHqvbGqa",193,0.989796,40,196,2,194,1,2,1,3,2,92,91,103,103,80
"6913",12,"[40]tIiHoIsdsBkDAbHdFdJenibKDeertHxnJHqvbGqa",194,0.989848,40,197,2,195,1,2,1,3,2,91,90,105,105,80
"6914",13,"[40]tIiHoIsdsBkDAbHdFdJenibKDeertHxnJHqvbGqa",205,0.990385,40,208,2,206,1,2,1,3,2,109,108,98,98,80
"6915",14,"[40]tIiHoIsdsBkDAbHdFdJenibKDeertHxnJHqvbGqa",210,0.99061,40,213,2,211,1,2,1,3,2,113,112,99,99,80
"6916",15,"[40]tIiHoIsdsBkDAbHdFdJenibKDeertHxnJHqvbGqa",210,0.99061,40,213,2,211,1,2,1,3,2,112,111,100,100,80
"6917",16,"[40]tIiHoIsdsBkDAbHdFdJenibKDeertHxnJHqvbGqa",207,0.990476,40,210,2,208,1,2,1,3,2,112,111,97,97,80
"6918",17,"[40]tIiHoIsdsBkDAbHdFdJenibKDeertHxnJHqvbGqa",201,0.990196,40,204,2,202,1,2,1,3,2,101,100,102,102,80
"6919",18,"[40]tIiHoIsdsBkDAbHdFdJenibKDeertHxnJHqvbGqa",204,0.990338,40,207,2,205,1,2,1,3,2,107,106,99,99,80
"6920",19,"[40]tIiHoIsdsBkDAbHdFdJenibKDeertHxnJHqvbGqa",198,0.99005,40,201,2,199,1,2,1,3,2,98,97,102,102,80
"6921",20,"[40]tIiHoIsdsBkDAbHdFdJenibKDeertHxnJHqvbGqa",192,0.989744,40,195,2,193,1,2,1,3,2,89,88,105,105,80
"6922",21,"[40]tIiHoIsdsBkDAbHdFdJenibKDeertHxnJHqvbGqa",199,0.990099,40,202,2,200,1,2,1,3,2,99,98,102,102,80
"6923",22,"[40]tIiHoIsdsBkDAbHdFdJenibKDeertHxnJHqvbGqa",193,0.989796,40,196,2,194,1,2,1,3,2,93,92,102,102,80
"6924",23,"[40]tIiHoIsdsBkDAbHdFdJenibKDeertHxnJHqvbGqa",210,0.99061,40,213,2,211,1,2,1,3,2,113,112,99,99,80
"6925",24,"[40]tIiHoIsdsBkDAbHdFdJenibKDeertHxnJHqvbGqa",187,0.989474,40,190,2,188,1,2,1,3,2,84,83,105,105,80
"6926",25,"[40]tIiHoIsdsBkDAbHdFdJenibKDeertHxnJHqvbGqa",207,0.990476,40,210,2,208,1,2,1,3,2,110,109,99,99,80
"6927",26,"[40]tIiHoIsdsBkDAbHdFdJenibKDeertHxnJHqvbGqa",208,0.990521,40,211,2,209,1,2,1,3,2,113,112,97,97,80
"6928",27,"[40]tIiHoIsdsBkDAbHdFdJenibKDeertHxnJHqvbGqa",203,0.990291,40,206,2,204,1,2,1,3,2,105,104,100,100,80
"6929",28,"[40]tIiHoIsdsBkDAbHdFdJenibKDeertHxnJHqvbGqa",211,0.990654,40,214,2,212,1,2,1,3,2,114,113,99,99,80
"6930",29,"[40]tIiHoIsdsBkDAbHdFdJenibKDeertHxnJHqvbGqa",200,0.990148,40,203,2,201,1,2,1,3,2,102,101,100,100,80
"6931",30,"[40]tIiHoIsdsBkDAbHdFdJenibKDeertHxnJHqvbGqa",200,0.990148,40,203,2,201,1,2,1,3,2,100,99,102,102,80
"6932",31,"[40]tIiHoIsdsBkDAbHdFdJenibKDeertHxnJHqvbGqa",201,0.990196,40,204,2,202,1,2,1,3,2,102,101,101,101,80
"6933",32,"[40]tIiHoIsdsBkDAbHdFdJenibKDeertHxnJHqvbGqa",203,0.990291,40,206,2,204,1,2,1,3,2,105,104,100,100,80
"6934",33,"[40]tIiHoIsdsBkDAbHdFdJenibKDeertHxnJHqvbGqa",210,0.99061,40,213,2,211,1,2,1,3,2,114,113,98,98,80
"6935",34,"[40]tIiHoIsdsBkDAbHdFdJenibKDeertHxnJHqvbGqa",192,0.989744,40,195,2,193,1,2,1,3,2,88,87,106,106,80
"6936",35,"[40]tIiHoIsdsBkDAbHdFdJenibKDeertHxnJHqvbGqa",212,0.990698,40,215,2,213,1,2,1,3,2,116,115,98,98,80
"6937",36,"[40]tIiHoIsdsBkDAbHdFdJenibKDeertHxnJHqvbGqa",204,0.990338,40,207,2,205,1,2,1,3,2,106,105,100,100,80
"6938",37,"[40]tIiHoIsdsBkDAbHdFdJenibKDeertHxnJHqvbGqa",194,0.989848,40,197,2,195,1,2,1,3,2,94,93,102,102,80
"6939",38,"[40]tIiHoIsdsBkDAbHdFdJenibKDeertHxnJHqvbGqa",204,0.990338,40,207,2,205,1,2,1,3,2,106,105,100,100,80
"6940",39,"[40]tIiHoIsdsBkDAbHdFdJenibKDeertHxnJHqvbGqa",215,0.990826,40,218,2,216,1,2,1,3,2,122,121,95,95,80
"6941",40,"[40]tIiHoIsdsBkDAbHdFdJenibKDeertHxnJHqvbGqa",193,0.989796,40,196,2,194,1,2,1,3,2,91,90,104,104,80
"6942",41,"[40]tIiHoIsdsBkDAbHdFdJenibKDeertHxnJHqvbGqa",206,0.990431,40,209,2,207,1,2,1,3,2,109,108,99,99,80
"6943",42,"[40]tIiHoIsdsBkDAbHdFdJenibKDeertHxnJHqvbGqa",218,0.99095,40,221,2,219,1,2,1,3,2,125,124,95,95,80
"6944",43,"[40]tIiHoIsdsBkDAbHdFdJenibKDeertHxnJHqvbGqa",199,0.990099,40,202,2,200,1,2,1,3,2,100,99,101,101,80
"6945",44,"[40]tIiHoIsdsBkDAbHdFdJenibKDeertHxnJHqvbGqa",198,0.99005,40,201,2,199,1,2,1,3,2,97,96,103,103,80
"6946",45,"[40]tIiHoIsdsBkDAbHdFdJenibKDeertHxnJHqvbGqa",185,0.989362,40,188,2,186,1,2,1,3,2,82,81,105,105,80
"6947",46,"[40]tIiHoIsdsBkDAbHdFdJenibKDeertHxnJHqvbGqa",192,0.989744,40,195,2,193,1,2,1,3,2,92,91,102,102,80
"6948",47,"[40]tIiHoIsdsBkDAbHdFdJenibKDeertHxnJHqvbGqa",210,0.99061,40,213,2,211,1,2,1,3,2,114,113,98,98,80
"6949",48,"[40]tIiHoIsdsBkDAbHdFdJenibKDeertHxnJHqvbGqa",204,0.990338,40,207,2,205,1,2,1,3,2,104,103,102,102,80
"6950",49,"[40]tIiHoIsdsBkDAbHdFdJenibKDeertHxnJHqvbGqa",210,0.99061,40,213,2,211,1,2,1,3,2,110,109,102,102,80
"6951",50,"[40]tIiHoIsdsBkDAbHdFdJenibKDeertHxnJHqvbGqa",202,0.990244,40,205,2,203,1,2,1,3,2,106,105,98,98,80
"6952",51,"[40]tIiHoIsdsBkDAbHdFdJenibKDeertHxnJHqvbGqa",198,0.99005,40,201,2,199,1,2,1,3,2,97,96,103,103,80
"6953",52,"[40]tIiHoIsdsBkDAbHdFdJenibKDeertHxnJHqvbGqa",184,0.989305,40,187,2,185,1,2,1,3,2,81,80,105,105,80
"6954",53,"[40]tIiHoIsdsBkDAbHdFdJenibKDeertHxnJHqvbGqa",210,0.99061,40,213,2,211,1,2,1,3,2,115,114,97,97,80
"6955",54,"[40]tIiHoIsdsBkDAbHdFdJenibKDeertHxnJHqvbGqa",187,0.989474,40,190,2,188,1,2,1,3,2,83,82,106,106,80
"6956",55,"[40]tIiHoIsdsBkDAbHdFdJenibKDeertHxnJHqvbGqa",205,0.990385,40,208,2,206,1,2,1,3,2,108,107,99,99,80
"6957",56,"[40]tIiHoIsdsBkDAbHdFdJenibKDeertHxnJHqvbGqa",201,0.990196,40,204,2,202,1,2,1,3,2,101,100,102,102,80
"6958",57,"[40]tIiHoIsdsBkDAbHdFdJenibKDeertHxnJHqvbGqa",215,0.990826,40,218,2,216,1,2,1,3,2,121,120,96,96,80
"6959",58,"[40]tIiHoIsdsBkDAbHdFdJenibKDeertHxnJHqvbGqa",210,0.99061,40,213,2,211,1,2,1,3,2,113,112,99,99,80
"6960",59,"[40]tIiHoIsdsBkDAbHdFdJenibKDeertHxnJHqvbGqa",194,0.989848,40,197,2,195,1,2,1,3,2,95,94,101,101,80
"6961",60,"[40]tIiHoIsdsBkDAbHdFdJenibKDeertHxnJHqvbGqa",205,0.990385,40,208,2,206,1,2,1,3,2,106,105,101,101,80
"6962",61,"[40]tIiHoIsdsBkDAbHdFdJenibKDeertHxnJHqvbGqa",204,0.990338,40,207,2,205,1,2,1,3,2,106,105,100,100,80
"6963",62,"[40]tIiHoIsdsBkDAbHdFdJenibKDeertHxnJHqvbGqa",196,0.98995,40,199,2,197,1,2,1,3,2,95,94,103,103,80
"6964",63,"[40]tIiHoIsdsBkDAbHdFdJenibKDeertHxnJHqvbGqa",192,0.989744,40,195,2,193,1,2,1,3,2,92,91,102,102,80
"6965",64,"[40]tIiHoIsdsBkDAbHdFdJenibKDeertHxnJHqvbGqa",178,0.98895,40,181,2,179,1,2,1,3,2,70,69,110,110,80
"6966",65,"[40]tIiHoIsdsBkDAbHdFdJenibKDeertHxnJHqvbGqa",200,0.990148,40,203,2,201,1,2,1,3,2,103,102,99,99,80
"6967",66,"[40]tIiHoIsdsBkDAbHdFdJenibKDeertHxnJHqvbGqa",206,0.990431,40,209,2,207,1,2,1,3,2,109,108,99,99,80
"6968",67,"[40]tIiHoIsdsBkDAbHdFdJenibKDeertHxnJHqvbGqa",195,0.989899,40,198,2,196,1,2,1,3,2,93,92,104,104,80
"6969",68,"[40]tIiHoIsdsBkDAbHdFdJenibKDeertHxnJHqvbGqa",194,0.989848,40,197,2,195,1,2,1,3,2,91,90,105,105,80
"6970",69,"[40]tIiHoIsdsBkDAbHdFdJenibKDeertHxnJHqvbGqa",189,0.989583,40,192,2,190,1,2,1,3,2,86,85,105,105,80
"6971",70,"[40]tIiHoIsdsBkDAbHdFdJenibKDeertHxnJHqvbGqa",196,0.98995,40,199,2,197,1,2,1,3,2,95,94,103,103,80
"6972",71,"[40]tIiHoIsdsBkDAbHdFdJenibKDeertHxnJHqvbGqa",204,0.990338,40,207,2,205,1,2,1,3,2,107,106,99,99,80
"6973",72,"[40]tIiHoIsdsBkDAbHdFdJenibKDeertHxnJHqvbGqa",205,0.990385,40,208,2,206,1,2,1,3,2,109,108,98,98,80
"6974",73,"[40]tIiHoIsdsBkDAbHdFdJenibKDeertHxnJHqvbGqa",199,0.990099,40,202,2,200,1,2,1,3,2,98,97,103,103,80
"6975",74,"[40]tIiHoIsdsBkDAbHdFdJenibKDeertHxnJHqvbGqa",209,0.990566,40,212,2,210,1,2,1,3,2,111,110,100,100,80
"6976",75,"[40]tIiHoIsdsBkDAbHdFdJenibKDeertHxnJHqvbGqa",208,0.990521,40,211,2,209,1,2,1,3,2,113,112,97,97,80
"6977",76,"[40]tIiHoIsdsBkDAbHdFdJenibKDeertHxnJHqvbGqa",195,0.989899,40,198,2,196,1,2,1,3,2,95,94,102,102,80
"6978",77,"[40]tIiHoIsdsBkDAbHdFdJenibKDeertHxnJHqvbGqa",203,0.990291,40,206,2,204,1,2,1,3,2,103,102,102,102,80
"6979",78,"[40]tIiHoIsdsBkDAbHdFdJenibKDeertHxnJHqvbGqa",191,0.989691,40,194,2,192,1,2,1,3,2,88,87,105,105,80
"6980",79,"[40]tIiHoIsdsBkDAbHdFdJenibKDeertHxnJHqvbGqa",222,0.991111,40,225,2,223,1,2,1,3,2,133,132,91,91,80
"6981",80,"[40]tIiHoIsdsBkDAbHdFdJenibKDeertHxnJHqvbGqa",203,0.990291,40,206,2,204,1,2,1,3,2,107,106,98,98,80
"6982",81,"[40]tIiHoIsdsBkDAbHdFdJenibKDeertHxnJHqvbGqa",195,0.989899,40,198,2,196,1,2,1,3,2,95,94,102,102,80
"6983",82,"[40]tIiHoIsdsBkDAbHdFdJenibKDeertHxnJHqvbGqa",209,0.990566,40,212,2,210,1,2,1,3,2,112,111,99,99,80
"6984",83,"[40]tIiHoIsdsBkDAbHdFdJenibKDeertHxnJHqvbGqa",197,0.99,40,200,2,198,1,2,1,3,2,97,96,102,102,80
"6985",84,"[40]tIiHoIsdsBkDAbHdFdJenibKDeertHxnJHqvbGqa",199,0.990099,40,202,2,200,1,2,1,3,2,99,98,102,102,80
"6986",85,"[40]tIiHoIsdsBkDAbHdFdJenibKDeertHxnJHqvbGqa",206,0.990431,40,209,2,207,1,2,1,3,2,108,107,100,100,80
"6987",86,"[40]tIiHoIsdsBkDAbHdFdJenibKDeertHxnJHqvbGqa",187,0.989474,40,190,2,188,1,2,1,3,2,82,81,107,107,80
"6988",87,"[40]tIiHoIsdsBkDAbHdFdJenibKDeertHxnJHqvbGqa",212,0.990698,40,215,2,213,1,2,1,3,2,120,119,94,94,80
"6989",88,"[40]tIiHoIsdsBkDAbHdFdJenibKDeertHxnJHqvbGqa",194,0.989848,40,197,2,195,1,2,1,3,2,93,92,103,103,80
"6990",89,"[40]tIiHoIsdsBkDAbHdFdJenibKDeertHxnJHqvbGqa",211,0.990654,40,214,2,212,1,2,1,3,2,117,116,96,96,80
"6991",90,"[40]tIiHoIsdsBkDAbHdFdJenibKDeertHxnJHqvbGqa",201,0.990196,40,204,2,202,1,2,1,3,2,103,102,100,100,80
"6992",91,"[40]tIiHoIsdsBkDAbHdFdJenibKDeertHxnJHqvbGqa",198,0.99005,40,201,2,199,1,2,1,3,2,99,98,101,101,80
"6993",92,"[40]tIiHoIsdsBkDAbHdFdJenibKDeertHxnJHqvbGqa",202,0.990244,40,205,2,203,1,2,1,3,2,104,103,100,100,80
"6994",93,"[40]tIiHoIsdsBkDAbHdFdJenibKDeertHxnJHqvbGqa",191,0.989691,40,194,2,192,1,2,1,3,2,90,89,103,103,80
"6995",94,"[40]tIiHoIsdsBkDAbHdFdJenibKDeertHxnJHqvbGqa",200,0.990148,40,203,2,201,1,2,1,3,2,100,99,102,102,80
"6996",95,"[40]tIiHoIsdsBkDAbHdFdJenibKDeertHxnJHqvbGqa",192,0.989744,40,195,2,193,1,2,1,3,2,90,89,104,104,80
"6997",96,"[40]tIiHoIsdsBkDAbHdFdJenibKDeertHxnJHqvbGqa",196,0.98995,40,199,2,197,1,2,1,3,2,94,93,104,104,80
"6998",97,"[40]tIiHoIsdsBkDAbHdFdJenibKDeertHxnJHqvbGqa",204,0.990338,40,207,2,205,1,2,1,3,2,106,105,100,100,80
"6999",98,"[40]tIiHoIsdsBkDAbHdFdJenibKDeertHxnJHqvbGqa",192,0.989744,40,195,2,193,1,2,1,3,2,87,86,107,107,80
"7000",99,"[40]tIiHoIsdsBkDAbHdFdJenibKDeertHxnJHqvbGqa",192,0.989744,40,195,2,193,1,2,1,3,2,89,88,105,105,80
"7001",0,"[40]tItHoIayfBkDKljbmfrEfxbKDeehHHsnJHqvbGqa",219,0.990991,40,222,2,220,1,2,1,3,2,128,127,93,93,81
"7002",1,"[40]tItHoIayfBkDKljbmfrEfxbKDeehHHsnJHqvbGqa",200,0.990148,40,203,2,201,1,2,1,3,2,102,101,100,100,81
"7003",2,"[40]tItHoIayfBkDKljbmfrEfxbKDeehHHsnJHqvbGqa",200,0.990148,40,203,2,201,1,2,1,3,2,104,103,98,98,81
"7004",3,"[40]tItHoIayfBkDKljbmfrEfxbKDeehHHsnJHqvbGqa",205,0.990385,40,208,2,206,1,2,1,3,2,107,106,100,100,81
"7005",4,"[40]tItHoIayfBkDKljbmfrEfxbKDeehHHsnJHqvbGqa",201,0.990196,40,204,2,202,1,2,1,3,2,101,100,102,102,81
"7006",5,"[40]tItHoIayfBkDKljbmfrEfxbKDeehHHsnJHqvbGqa",198,0.99005,40,201,2,199,1,2,1,3,2,98,97,102,102,81
"7007",6,"[40]tItHoIayfBkDKljbmfrEfxbKDeehHHsnJHqvbGqa",205,0.990385,40,208,2,206,1,2,1,3,2,106,105,101,101,81
"7008",7,"[40]tItHoIayfBkDKljbmfrEfxbKDeehHHsnJHqvbGqa",213,0.990741,40,216,2,214,1,2,1,3,2,118,117,97,97,81
"7009",8,"[40]tItHoIayfBkDKljbmfrEfxbKDeehHHsnJHqvbGqa",187,0.989474,40,190,2,188,1,2,1,3,2,82,81,107,107,81
"7010",9,"[40]tItHoIayfBkDKljbmfrEfxbKDeehHHsnJHqvbGqa",189,0.989583,40,192,2,190,1,2,1,3,2,86,85,105,105,81
"7011",10,"[40]tItHoIayfBkDKljbmfrEfxbKDeehHHsnJHqvbGqa",214,0.990783,40,217,2,215,1,2,1,3,2,119,118,97,97,81
"7012",11,"[40]tItHoIayfBkDKljbmfrEfxbKDeehHHsnJHqvbGqa",199,0.990099,40,202,2,200,1,2,1,3,2,98,97,103,103,81
"7013",12,"[40]tItHoIayfBkDKljbmfrEfxbKDeehHHsnJHqvbGqa",196,0.98995,40,199,2,197,1,2,1,3,2,94,93,104,104,81
"7014",13,"[40]tItHoIayfBkDKljbmfrEfxbKDeehHHsnJHqvbGqa",201,0.990196,40,204,2,202,1,2,1,3,2,105,104,98,98,81
"7015",14,"[40]tItHoIayfBkDKljbmfrEfxbKDeehHHsnJHqvbGqa",198,0.99005,40,201,2,199,1,2,1,3,2,97,96,103,103,81
"7016",15,"[40]tItHoIayfBkDKljbmfrEfxbKDeehHHsnJHqvbGqa",205,0.990385,40,208,2,206,1,2,1,3,2,106,105,101,101,81
"7017",16,"[40]tItHoIayfBkDKljbmfrEfxbKDeehHHsnJHqvbGqa",205,0.990385,40,208,2,206,1,2,1,3,2,108,107,99,99,81
"7018",17,"[40]tItHoIayfBkDKljbmfrEfxbKDeehHHsnJHqvbGqa",211,0.990654,40,214,2,212,1,2,1,3,2,117,116,96,96,81
"7019",18,"[40]tItHoIayfBkDKljbmfrEfxbKDeehHHsnJHqvbGqa",212,0.990698,40,215,2,213,1,2,1,3,2,116,115,98,98,81
"7020",19,"[40]tItHoIayfBkDKljbmfrEfxbKDeehHHsnJHqvbGqa",199,0.990099,40,202,2,200,1,2,1,3,2,96,95,105,105,81
"7021",20,"[40]tItHoIayfBkDKljbmfrEfxbKDeehHHsnJHqvbGqa",199,0.990099,40,202,2,200,1,2,1,3,2,100,99,101,101,81
"7022",21,"[40]tItHoIayfBkDKljbmfrEfxbKDeehHHsnJHqvbGqa",207,0.990476,40,210,2,208,1,2,1,3,2,109,108,100,100,81
"7023",22,"[40]tItHoIayfBkDKljbmfrEfxbKDeehHHsnJHqvbGqa",198,0.99005,40,201,2,199,1,2,1,3,2,98,97,102,102,81
"7024",23,"[40]tItHoIayfBkDKljbmfrEfxbKDeehHHsnJHqvbGqa",207,0.990476,40,210,2,208,1,2,1,3,2,111,110,98,98,81
"7025",24,"[40]tItHoIayfBkDKljbmfrEfxbKDeehHHsnJHqvbGqa",199,0.990099,40,202,2,200,1,2,1,3,2,99,98,102,102,81
"7026",25,"[40]tItHoIayfBkDKljbmfrEfxbKDeehHHsnJHqvbGqa",214,0.990783,40,217,2,215,1,2,1,3,2,120,119,96,96,81
"7027",26,"[40]tItHoIayfBkDKljbmfrEfxbKDeehHHsnJHqvbGqa",200,0.990148,40,203,2,201,1,2,1,3,2,99,98,103,103,81
"7028",27,"[40]tItHoIayfBkDKljbmfrEfxbKDeehHHsnJHqvbGqa",190,0.989637,40,193,2,191,1,2,1,3,2,87,86,105,105,81
"7029",28,"[40]tItHoIayfBkDKljbmfrEfxbKDeehHHsnJHqvbGqa",190,0.989637,40,193,2,191,1,2,1,3,2,87,86,105,105,81
"7030",29,"[40]tItHoIayfBkDKljbmfrEfxbKDeehHHsnJHqvbGqa",194,0.989848,40,197,2,195,1,2,1,3,2,91,90,105,105,81
"7031",30,"[40]tItHoIayfBkDKljbmfrEfxbKDeehHHsnJHqvbGqa",219,0.990991,40,222,2,220,1,2,1,3,2,127,126,94,94,81
"7032",31,"[40]tItHoIayfBkDKljbmfrEfxbKDeehHHsnJHqvbGqa",202,0.990244,40,205,2,203,1,2,1,3,2,102,101,102,102,81
"7033",32,"[40]tItHoIayfBkDKljbmfrEfxbKDeehHHsnJHqvbGqa",179,0.989011,40,182,2,180,1,2,1,3,2,74,73,107,107,81
"7034",33,"[40]tItHoIayfBkDKljbmfrEfxbKDeehHHsnJHqvbGqa",200,0.990148,40,203,2,201,1,2,1,3,2,102,101,100,100,81
"7035",34,"[40]tItHoIayfBkDKljbmfrEfxbKDeehHHsnJHqvbGqa",205,0.990385,40,208,2,206,1,2,1,3,2,108,107,99,99,81
"7036",35,"[40]tItHoIayfBkDKljbmfrEfxbKDeehHHsnJHqvbGqa",211,0.990654,40,214,2,212,1,2,1,3,2,115,114,98,98,81
"7037",36,"[40]tItHoIayfBkDKljbmfrEfxbKDeehHHsnJHqvbGqa",204,0.990338,40,207,2,205,1,2,1,3,2,104,103,102,102,81
"7038",37,"[40]tItHoIayfBkDKljbmfrEfxbKDeehHHsnJHqvbGqa",203,0.990291,40,206,2,204,1,2,1,3,2,107,106,98,98,81
"7039",38,"[40]tItHoIayfBkDKljbmfrEfxbKDeehHHsnJHqvbGqa",196,0.98995,40,199,2,197,1,2,1,3,2,93,92,105,105,81
"7040",39,"[40]tItHoIayfBkDKljbmfrEfxbKDeehHHsnJHqvbGqa",218,0.99095,40,221,2,219,1,2,1,3,2,128,127,92,92,81
"7041",40,"[40]tItHoIayfBkDKljbmfrEfxbKDeehHHsnJHqvbGqa",204,0.990338,40,207,2,205,1,2,1,3,2,105,104,101,101,81
"7042",41,"[40]tItHoIayfBkDKljbmfrEfxbKDeehHHsnJHqvbGqa",201,0.990196,40,204,2,202,1,2,1,3,2,104,103,99,99,81
"7043",42,"[40]tItHoIayfBkDKljbmfrEfxbKDeehHHsnJHqvbGqa",193,0.989796,40,196,2,194,1,2,1,3,2,90,89,105,105,81
"7044",43,"[40]tItHoIayfBkDKljbmfrEfxbKDeehHHsnJHqvbGqa",202,0.990244,40,205,2,203,1,2,1,3,2,104,103,100,100,81
"7045",44,"[40]tItHoIayfBkDKljbmfrEfxbKDeehHHsnJHqvbGqa",206,0.990431,40,209,2,207,1,2,1,3,2,108,107,100,100,81
"7046",45,"[40]tItHoIayfBkDKljbmfrEfxbKDeehHHsnJHqvbGqa",202,0.990244,40,205,2,203,1,2,1,3,2,105,104,99,99,81
"7047",46,"[40]tItHoIayfBkDKljbmfrEfxbKDeehHHsnJHqvbGqa",198,0.99005,40,201,2,199,1,2,1,3,2,99,98,101,101,81
"7048",47,"[40]tItHoIayfBkDKljbmfrEfxbKDeehHHsnJHqvbGqa",200,0.990148,40,203,2,201,1,2,1,3,2,100,99,102,102,81
"7049",48,"[40]tItHoIayfBkDKljbmfrEfxbKDeehHHsnJHqvbGqa",206,0.990431,40,209,2,207,1,2,1,3,2,108,107,100,100,81
"7050",49,"[40]tItHoIayfBkDKljbmfrEfxbKDeehHHsnJHqvbGqa",200,0.990148,40,203,2,201,1,2,1,3,2,100,99,102,102,81
"7051",50,"[40]tItHoIayfBkDKljbmfrEfxbKDeehHHsnJHqvbGqa",194,0.989848,40,197,2,195,1,2,1,3,2,91,90,105,105,81
"7052",51,"[40]tItHoIayfBkDKljbmfrEfxbKDeehHHsnJHqvbGqa",207,0.990476,40,210,2,208,1,2,1,3,2,110,109,99,99,81
"7053",52,"[40]tItHoIayfBkDKljbmfrEfxbKDeehHHsnJHqvbGqa",210,0.99061,40,213,2,211,1,2,1,3,2,115,114,97,97,81
"7054",53,"[40]tItHoIayfBkDKljbmfrEfxbKDeehHHsnJHqvbGqa",204,0.990338,40,207,2,205,1,2,1,3,2,108,107,98,98,81
"7055",54,"[40]tItHoIayfBkDKljbmfrEfxbKDeehHHsnJHqvbGqa",204,0.990338,40,207,2,205,1,2,1,3,2,109,108,97,97,81
"7056",55,"[40]tItHoIayfBkDKljbmfrEfxbKDeehHHsnJHqvbGqa",218,0.99095,40,221,2,219,1,2,1,3,2,124,123,96,96,81
"7057",56,"[40]tItHoIayfBkDKljbmfrEfxbKDeehHHsnJHqvbGqa",195,0.989899,40,198,2,196,1,2,1,3,2,94,93,103,103,81
"7058",57,"[40]tItHoIayfBkDKljbmfrEfxbKDeehHHsnJHqvbGqa",212,0.990698,40,215,2,213,1,2,1,3,2,116,115,98,98,81
"7059",58,"[40]tItHoIayfBkDKljbmfrEfxbKDeehHHsnJHqvbGqa",210,0.99061,40,213,2,211,1,2,1,3,2,113,112,99,99,81
"7060",59,"[40]tItHoIayfBkDKljbmfrEfxbKDeehHHsnJHqvbGqa",204,0.990338,40,207,2,205,1,2,1,3,2,105,104,101,101,81
"7061",60,"[40]tItHoIayfBkDKljbmfrEfxbKDeehHHsnJHqvbGqa",200,0.990148,40,203,2,201,1,2,1,3,2,102,101,100,100,81
"7062",61,"[40]tItHoIayfBkDKljbmfrEfxbKDeehHHsnJHqvbGqa",204,0.990338,40,207,2,205,1,2,1,3,2,106,105,100,100,81
"7063",62,"[40]tItHoIayfBkDKljbmfrEfxbKDeehHHsnJHqvbGqa",208,0.990521,40,211,2,209,1,2,1,3,2,111,110,99,99,81
"7064",63,"[40]tItHoIayfBkDKljbmfrEfxbKDeehHHsnJHqvbGqa",201,0.990196,40,204,2,202,1,2,1,3,2,103,102,100,100,81
"7065",64,"[40]tItHoIayfBkDKljbmfrEfxbKDeehHHsnJHqvbGqa",199,0.990099,40,202,2,200,1,2,1,3,2,96,95,105,105,81
"7066",65,"[40]tItHoIayfBkDKljbmfrEfxbKDeehHHsnJHqvbGqa",200,0.990148,40,203,2,201,1,2,1,3,2,100,99,102,102,81
"7067",66,"[40]tItHoIayfBkDKljbmfrEfxbKDeehHHsnJHqvbGqa",200,0.990148,40,203,2,201,1,2,1,3,2,98,97,104,104,81
"7068",67,"[40]tItHoIayfBkDKljbmfrEfxbKDeehHHsnJHqvbGqa",201,0.990196,40,204,2,202,1,2,1,3,2,102,101,101,101,81
"7069",68,"[40]tItHoIayfBkDKljbmfrEfxbKDeehHHsnJHqvbGqa",213,0.990741,40,216,2,214,1,2,1,3,2,120,119,95,95,81
"7070",69,"[40]tItHoIayfBkDKljbmfrEfxbKDeehHHsnJHqvbGqa",209,0.990566,40,212,2,210,1,2,1,3,2,112,111,99,99,81
"7071",70,"[40]tItHoIayfBkDKljbmfrEfxbKDeehHHsnJHqvbGqa",208,0.990521,40,211,2,209,1,2,1,3,2,112,111,98,98,81
"7072",71,"[40]tItHoIayfBkDKljbmfrEfxbKDeehHHsnJHqvbGqa",193,0.989796,40,196,2,194,1,2,1,3,2,92,91,103,103,81
"7073",72,"[40]tItHoIayfBkDKljbmfrEfxbKDeehHHsnJHqvbGqa",206,0.990431,40,209,2,207,1,2,1,3,2,111,110,97,97,81
"7074",73,"[40]tItHoIayfBkDKljbmfrEfxbKDeehHHsnJHqvbGqa",204,0.990338,40,207,2,205,1,2,1,3,2,104,103,102,102,81
"7075",74,"[40]tItHoIayfBkDKljbmfrEfxbKDeehHHsnJHqvbGqa",205,0.990385,40,208,2,206,1,2,1,3,2,107,106,100,100,81
"7076",75,"[40]tItHoIayfBkDKljbmfrEfxbKDeehHHsnJHqvbGqa",211,0.990654,40,214,2,212,1,2,1,3,2,115,114,98,98,81
"7077",76,"[40]tItHoIayfBkDKljbmfrEfxbKDeehHHsnJHqvbGqa",199,0.990099,40,202,2,200,1,2,1,3,2,100,99,101,101,81
"7078",77,"[40]tItHoIayfBkDKljbmfrEfxbKDeehHHsnJHqvbGqa",209,0.990566,40,212,2,210,1,2,1,3,2,115,114,96,96,81
"7079",78,"[40]tItHoIayfBkDKljbmfrEfxbKDeehHHsnJHqvbGqa",198,0.99005,40,201,2,199,1,2,1,3,2,97,96,103,103,81
"7080",79,"[40]tItHoIayfBkDKljbmfrEfxbKDeehHHsnJHqvbGqa",204,0.990338,40,207,2,205,1,2,1,3,2,105,104,101,101,81
"7081",80,"[40]tItHoIayfBkDKljbmfrEfxbKDeehHHsnJHqvbGqa",203,0.990291,40,206,2,204,1,2,1,3,2,104,103,101,101,81
"7082",81,"[40]tItHoIayfBkDKljbmfrEfxbKDeehHHsnJHqvbGqa",198,0.99005,40,201,2,199,1,2,1,3,2,96,95,104,104,81
"7083",82,"[40]tItHoIayfBkDKljbmfrEfxbKDeehHHsnJHqvbGqa",211,0.990654,40,214,2,212,1,2,1,3,2,114,113,99,99,81
"7084",83,"[40]tItHoIayfBkDKljbmfrEfxbKDeehHHsnJHqvbGqa",191,0.989691,40,194,2,192,1,2,1,3,2,89,88,104,104,81
"7085",84,"[40]tItHoIayfBkDKljbmfrEfxbKDeehHHsnJHqvbGqa",195,0.989899,40,198,2,196,1,2,1,3,2,96,95,101,101,81
"7086",85,"[40]tItHoIayfBkDKljbmfrEfxbKDeehHHsnJHqvbGqa",202,0.990244,40,205,2,203,1,2,1,3,2,100,99,104,104,81
"7087",86,"[40]tItHoIayfBkDKljbmfrEfxbKDeehHHsnJHqvbGqa",211,0.990654,40,214,2,212,1,2,1,3,2,116,115,97,97,81
"7088",87,"[40]tItHoIayfBkDKljbmfrEfxbKDeehHHsnJHqvbGqa",194,0.989848,40,197,2,195,1,2,1,3,2,93,92,103,103,81
"7089",88,"[40]tItHoIayfBkDKljbmfrEfxbKDeehHHsnJHqvbGqa",191,0.989691,40,194,2,192,1,2,1,3,2,89,88,104,104,81
"7090",89,"[40]tItHoIayfBkDKljbmfrEfxbKDeehHHsnJHqvbGqa",192,0.989744,40,195,2,193,1,2,1,3,2,89,88,105,105,81
"7091",90,"[40]tItHoIayfBkDKljbmfrEfxbKDeehHHsnJHqvbGqa",205,0.990385,40,208,2,206,1,2,1,3,2,109,108,98,98,81
"7092",91,"[40]tItHoIayfBkDKljbmfrEfxbKDeehHHsnJHqvbGqa",184,0.989305,40,187,2,185,1,2,1,3,2,79,78,107,107,81
"7093",92,"[40]tItHoIayfBkDKljbmfrEfxbKDeehHHsnJHqvbGqa",182,0.989189,40,185,2,183,1,2,1,3,2,78,77,106,106,81
"7094",93,"[40]tItHoIayfBkDKljbmfrEfxbKDeehHHsnJHqvbGqa",203,0.990291,40,206,2,204,1,2,1,3,2,105,104,100,100,81
"7095",94,"[40]tItHoIayfBkDKljbmfrEfxbKDeehHHsnJHqvbGqa",204,0.990338,40,207,2,205,1,2,1,3,2,106,105,100,100,81
"7096",95,"[40]tItHoIayfBkDKljbmfrEfxbKDeehHHsnJHqvbGqa",192,0.989744,40,195,2,193,1,2,1,3,2,92,91,102,102,81
"7097",96,"[40]tItHoIayfBkDKljbmfrEfxbKDeehHHsnJHqvbGqa",205,0.990385,40,208,2,206,1,2,1,3,2,109,108,98,98,81
"7098",97,"[40]tItHoIayfBkDKljbmfrEfxbKDeehHHsnJHqvbGqa",194,0.989848,40,197,2,195,1,2,1,3,2,94,93,102,102,81
"7099",98,"[40]tItHoIayfBkDKljbmfrEfxbKDeehHHsnJHqvbGqa",204,0.990338,40,207,2,205,1,2,1,3,2,104,103,102,102,81
"7100",99,"[40]tItHoIayfBkDKljbmfrEfxbKDeehHHsnJHqvbGqa",191,0.989691,40,194,2,192,1,2,1,3,2,90,89,103,103,81
"7101",0,"[40]tIFHoIEovBkDrtqjhjhqGmbKDaeFlHxnJHqxbGqa",201,0.990196,40,204,2,202,1,2,1,3,2,103,102,100,100,82
"7102",1,"[40]tIFHoIEovBkDrtqjhjhqGmbKDaeFlHxnJHqxbGqa",208,0.990521,40,211,2,209,1,2,1,3,2,110,109,100,100,82
"7103",2,"[40]tIFHoIEovBkDrtqjhjhqGmbKDaeFlHxnJHqxbGqa",202,0.990244,40,205,2,203,1,2,1,3,2,104,103,100,100,82
"7104",3,"[40]tIFHoIEovBkDrtqjhjhqGmbKDaeFlHxnJHqxbGqa",199,0.990099,40,202,2,200,1,2,1,3,2,99,98,102,102,82
"7105",4,"[40]tIFHoIEovBkDrtqjhjhqGmbKDaeFlHxnJHqxbGqa",192,0.989744,40,195,2,193,1,2,1,3,2,86,85,108,108,82
"7106",5,"[40]tIFHoIEovBkDrtqjhjhqGmbKDaeFlHxnJHqxbGqa",211,0.990654,40,214,2,212,1,2,1,3,2,117,116,96,96,82
"7107",6,"[40]tIFHoIEovBkDrtqjhjhqGmbKDaeFlHxnJHqxbGqa",208,0.990521,40,211,2,209,1,2,1,3,2,111,110,99,99,82
"7108",7,"[40]tIFHoIEovBkDrtqjhjhqGmbKDaeFlHxnJHqxbGqa",200,0.990148,40,203,2,201,1,2,1,3,2,102,101,100,100,82
"7109",8,"[40]tIFHoIEovBkDrtqjhjhqGmbKDaeFlHxnJHqxbGqa",211,0.990654,40,214,2,212,1,2,1,3,2,112,111,101,101,82
"7110",9,"[40]tIFHoIEovBkDrtqjhjhqGmbKDaeFlHxnJHqxbGqa",200,0.990148,40,203,2,201,1,2,1,3,2,99,98,103,103,82
"7111",10,"[40]tIFHoIEovBkDrtqjhjhqGmbKDaeFlHxnJHqxbGqa",196,0.98995,40,199,2,197,1,2,1,3,2,95,94,103,103,82
"7112",11,"[40]tIFHoIEovBkDrtqjhjhqGmbKDaeFlHxnJHqxbGqa",201,0.990196,40,204,2,202,1,2,1,3,2,103,102,100,100,82
"7113",12,"[40]tIFHoIEovBkDrtqjhjhqGmbKDaeFlHxnJHqxbGqa",201,0.990196,40,204,2,202,1,2,1,3,2,102,101,101,101,82
"7114",13,"[40]tIFHoIEovBkDrtqjhjhqGmbKDaeFlHxnJHqxbGqa",190,0.989637,40,193,2,191,1,2,1,3,2,84,83,108,108,82
"7115",14,"[40]tIFHoIEovBkDrtqjhjhqGmbKDaeFlHxnJHqxbGqa",209,0.990566,40,212,2,210,1,2,1,3,2,117,116,94,94,82
"7116",15,"[40]tIFHoIEovBkDrtqjhjhqGmbKDaeFlHxnJHqxbGqa",193,0.989796,40,196,2,194,1,2,1,3,2,89,88,106,106,82
"7117",16,"[40]tIFHoIEovBkDrtqjhjhqGmbKDaeFlHxnJHqxbGqa",204,0.990338,40,207,2,205,1,2,1,3,2,105,104,101,101,82
"7118",17,"[40]tIFHoIEovBkDrtqjhjhqGmbKDaeFlHxnJHqxbGqa",194,0.989848,40,197,2,195,1,2,1,3,2,94,93,102,102,82
"7119",18,"[40]tIFHoIEovBkDrtqjhjhqGmbKDaeFlHxnJHqxbGqa",200,0.990148,40,203,2,201,1,2,1,3,2,103,102,99,99,82
"7120",19,"[40]tIFHoIEovBkDrtqjhjhqGmbKDaeFlHxnJHqxbGqa",200,0.990148,40,203,2,201,1,2,1,3,2,98,97,104,104,82
"7121",20,"[40]tIFHoIEovBkDrtqjhjhqGmbKDaeFlHxnJHqxbGqa",199,0.990099,40,202,2,200,1,2,1,3,2,97,96,104,104,82
"7122",21,"[40]tIFHoIEovBkDrtqjhjhqGmbKDaeFlHxnJHqxbGqa",202,0.990244,40,205,2,203,1,2,1,3,2,101,100,103,103,82
"7123",22,"[40]tIFHoIEovBkDrtqjhjhqGmbKDaeFlHxnJHqxbGqa",193,0.989796,40,196,2,194,1,2,1,3,2,92,91,103,103,82
"7124",23,"[40]tIFHoIEovBkDrtqjhjhqGmbKDaeFlHxnJHqxbGqa",194,0.989848,40,197,2,195,1,2,1,3,2,94,93,102,102,82
"7125",24,"[40]tIFHoIEovBkDrtqjhjhqGmbKDaeFlHxnJHqxbGqa",209,0.990566,40,212,2,210,1,2,1,3,2,113,112,98,98,82
"7126",25,"[40]tIFHoIEovBkDrtqjhjhqGmbKDaeFlHxnJHqxbGqa",213,0.990741,40,216,2,214,1,2,1,3,2,116,115,99,99,82
"7127",26,"[40]tIFHoIEovBkDrtqjhjhqGmbKDaeFlHxnJHqxbGqa",206,0.990431,40,209,2,207,1,2,1,3,2,107,106,101,101,82
"7128",27,"[40]tIFHoIEovBkDrtqjhjhqGmbKDaeFlHxnJHqxbGqa",215,0.990826,40,218,2,216,1,2,1,3,2,118,117,99,99,82
"7129",28,"[40]tIFHoIEovBkDrtqjhjhqGmbKDaeFlHxnJHqxbGqa",197,0.99,40,200,2,198,1,2,1,3,2,95,94,104,104,82
"7130",29,"[40]tIFHoIEovBkDrtqjhjhqGmbKDaeFlHxnJHqxbGqa",191,0.989691,40,194,2,192,1,2,1,3,2,86,85,107,107,82
"7131",30,"[40]tIFHoIEovBkDrtqjhjhqGmbKDaeFlHxnJHqxbGqa",192,0.989744,40,195,2,193,1,2,1,3,2,90,89,104,104,82
"7132",31,"[40]tIFHoIEovBkDrtqjhjhqGmbKDaeFlHxnJHqxbGqa",204,0.990338,40,207,2,205,1,2,1,3,2,105,104,101,101,82
"7133",32,"[40]tIFHoIEovBkDrtqjhjhqGmbKDaeFlHxnJHqxbGqa",202,0.990244,40,205,2,203,1,2,1,3,2,103,102,101,101,82
"7134",33,"[40]tIFHoIEovBkDrtqjhjhqGmbKDaeFlHxnJHqxbGqa",200,0.990148,40,203,2,201,1,2,1,3,2,99,98,103,103,82
"7135",34,"[40]tIFHoIEovBkDrtqjhjhqGmbKDaeFlHxnJHqxbGqa",193,0.989796,40,196,2,194,1,2,1,3,2,91,90,104,104,82
"7136",35,"[40]tIFHoIEovBkDrtqjhjhqGmbKDaeFlHxnJHqxbGqa",203,0.990291,40,206,2,204,1,2,1,3,2,103,102,102,102,82
"7137",36,"[40]tIFHoIEovBkDrtqjhjhqGmbKDaeFlHxnJHqxbGqa",196,0.98995,40,199,2,197,1,2,1,3,2,96,95,102,102,82
"7138",37,"[40]tIFHoIEovBkDrtqjhjhqGmbKDaeFlHxnJHqxbGqa",189,0.989583,40,192,2,190,1,2,1,3,2,86,85,105,105,82
"7139",38,"[40]tIFHoIEovBkDrtqjhjhqGmbKDaeFlHxnJHqxbGqa",193,0.989796,40,196,2,194,1,2,1,3,2,90,89,105,105,82
"7140",39,"[40]tIFHoIEovBkDrtqjhjhqGmbKDaeFlHxnJHqxbGqa",207,0.990476,40,210,2,208,1,2,1,3,2,111,110,98,98,82
"7141",40,"[40]tIFHoIEovBkDrtqjhjhqGmbKDaeFlHxnJHqxbGqa",212,0.990698,40,215,2,213,1,2,1,3,2,113,112,101,101,82
"7142",41,"[40]tIFHoIEovBkDrtqjhjhqGmbKDaeFlHxnJHqxbGqa",199,0.990099,40,202,2,200,1,2,1,3,2,99,98,102,102,82
"7143",42,"[40]tIFHoIEovBkDrtqjhjhqGmbKDaeFlHxnJHqxbGqa",204,0.990338,40,207,2,205,1,2,1,3,2,105,104,101,101,82
"7144",43,"[40]tIFHoIEovBkDrtqjhjhqGmbKDaeFlHxnJHqxbGqa",203,0.990291,40,206,2,204,1,2,1,3,2,104,103,101,101,82
"7145",44,"[40]tIFHoIEovBkDrtqjhjhqGmbKDaeFlHxnJHqxbGqa",191,0.989691,40,194,2,192,1,2,1,3,2,87,86,106,106,82
"7146",45,"[40]tIFHoIEovBkDrtqjhjhqGmbKDaeFlHxnJHqxbGqa",211,0.990654,40,214,2,212,1,2,1,3,2,114,113,99,99,82
"7147",46,"[40]tIFHoIEovBkDrtqjhjhqGmbKDaeFlHxnJHqxbGqa",202,0.990244,40,205,2,203,1,2,1,3,2,101,100,103,103,82
"7148",47,"[40]tIFHoIEovBkDrtqjhjhqGmbKDaeFlHxnJHqxbGqa",192,0.989744,40,195,2,193,1,2,1,3,2,90,89,104,104,82
"7149",48,"[40]tIFHoIEovBkDrtqjhjhqGmbKDaeFlHxnJHqxbGqa",198,0.99005,40,201,2,199,1,2,1,3,2,97,96,103,103,82
"7150",49,"[40]tIFHoIEovBkDrtqjhjhqGmbKDaeFlHxnJHqxbGqa",201,0.990196,40,204,2,202,1,2,1,3,2,104,103,99,99,82
"7151",50,"[40]tIFHoIEovBkDrtqjhjhqGmbKDaeFlHxnJHqxbGqa",208,0.990521,40,211,2,209,1,2,1,3,2,115,114,95,95,82
"7152",51,"[40]tIFHoIEovBkDrtqjhjhqGmbKDaeFlHxnJHqxbGqa",196,0.98995,40,199,2,197,1,2,1,3,2,93,92,105,105,82
"7153",52,"[40]tIFHoIEovBkDrtqjhjhqGmbKDaeFlHxnJHqxbGqa",214,0.990783,40,217,2,215,1,2,1,3,2,120,119,96,96,82
"7154",53,"[40]tIFHoIEovBkDrtqjhjhqGmbKDaeFlHxnJHqxbGqa",204,0.990338,40,207,2,205,1,2,1,3,2,106,105,100,100,82
"7155",54,"[40]tIFHoIEovBkDrtqjhjhqGmbKDaeFlHxnJHqxbGqa",210,0.99061,40,213,2,211,1,2,1,3,2,114,113,98,98,82
"7156",55,"[40]tIFHoIEovBkDrtqjhjhqGmbKDaeFlHxnJHqxbGqa",205,0.990385,40,208,2,206,1,2,1,3,2,109,108,98,98,82
"7157",56,"[40]tIFHoIEovBkDrtqjhjhqGmbKDaeFlHxnJHqxbGqa",212,0.990698,40,215,2,213,1,2,1,3,2,115,114,99,99,82
"7158",57,"[40]tIFHoIEovBkDrtqjhjhqGmbKDaeFlHxnJHqxbGqa",197,0.99,40,200,2,198,1,2,1,3,2,96,95,103,103,82
"7159",58,"[40]tIFHoIEovBkDrtqjhjhqGmbKDaeFlHxnJHqxbGqa",216,0.990868,40,219,2,217,1,2,1,3,2,125,124,93,93,82
"7160",59,"[40]tIFHoIEovBkDrtqjhjhqGmbKDaeFlHxnJHqxbGqa",211,0.990654,40,214,2,212,1,2,1,3,2,117,116,96,96,82
"7161",60,"[40]tIFHoIEovBkDrtqjhjhqGmbKDaeFlHxnJHqxbGqa",191,0.989691,40,194,2,192,1,2,1,3,2,88,87,105,105,82
"7162",61,"[40]tIFHoIEovBkDrtqjhjhqGmbKDaeFlHxnJHqxbGqa",213,0.990741,40,216,2,214,1,2,1,3,2,119,118,96,96,82
"7163",62,"[40]tIFHoIEovBkDrtqjhjhqGmbKDaeFlHxnJHqxbGqa",193,0.989796,40,196,2,194,1,2,1,3,2,90,89,105,105,82
"7164",63,"[40]tIFHoIEovBkDrtqjhjhqGmbKDaeFlHxnJHqxbGqa",195,0.989899,40,198,2,196,1,2,1,3,2,93,92,104,104,82
"7165",64,"[40]tIFHoIEovBkDrtqjhjhqGmbKDaeFlHxnJHqxbGqa",216,0.990868,40,219,2,217,1,2,1,3,2,119,118,99,99,82
"7166",65,"[40]tIFHoIEovBkDrtqjhjhqGmbKDaeFlHxnJHqxbGqa",195,0.989899,40,198,2,196,1,2,1,3,2,93,92,104,104,82
"7167",66,"[40]tIFHoIEovBkDrtqjhjhqGmbKDaeFlHxnJHqxbGqa",201,0.990196,40,204,2,202,1,2,1,3,2,101,100,102,102,82
"7168",67,"[40]tIFHoIEovBkDrtqjhjhqGmbKDaeFlHxnJHqxbGqa",215,0.990826,40,218,2,216,1,2,1,3,2,120,119,97,97,82
"7169",68,"[40]tIFHoIEovBkDrtqjhjhqGmbKDaeFlHxnJHqxbGqa",199,0.990099,40,202,2,200,1,2,1,3,2,98,97,103,103,82
"7170",69,"[40]tIFHoIEovBkDrtqjhjhqGmbKDaeFlHxnJHqxbGqa",208,0.990521,40,211,2,209,1,2,1,3,2,109,108,101,101,82
"7171",70,"[40]tIFHoIEovBkDrtqjhjhqGmbKDaeFlHxnJHqxbGqa",193,0.989796,40,196,2,194,1,2,1,3,2,92,91,103,103,82
"7172",71,"[40]tIFHoIEovBkDrtqjhjhqGmbKDaeFlHxnJHqxbGqa",216,0.990868,40,219,2,217,1,2,1,3,2,123,122,95,95,82
"7173",72,"[40]tIFHoIEovBkDrtqjhjhqGmbKDaeFlHxnJHqxbGqa",199,0.990099,40,202,2,200,1,2,1,3,2,100,99,101,101,82
"7174",73,"[40]tIFHoIEovBkDrtqjhjhqGmbKDaeFlHxnJHqxbGqa",203,0.990291,40,206,2,204,1,2,1,3,2,103,102,102,102,82
"7175",74,"[40]tIFHoIEovBkDrtqjhjhqGmbKDaeFlHxnJHqxbGqa",199,0.990099,40,202,2,200,1,2,1,3,2,98,97,103,103,82
"7176",75,"[40]tIFHoIEovBkDrtqjhjhqGmbKDaeFlHxnJHqxbGqa",209,0.990566,40,212,2,210,1,2,1,3,2,114,113,97,97,82
"7177",76,"[40]tIFHoIEovBkDrtqjhjhqGmbKDaeFlHxnJHqxbGqa",199,0.990099,40,202,2,200,1,2,1,3,2,95,94,106,106,82
"7178",77,"[40]tIFHoIEovBkDrtqjhjhqGmbKDaeFlHxnJHqxbGqa",204,0.990338,40,207,2,205,1,2,1,3,2,107,106,99,99,82
"7179",78,"[40]tIFHoIEovBkDrtqjhjhqGmbKDaeFlHxnJHqxbGqa",212,0.990698,40,215,2,213,1,2,1,3,2,118,117,96,96,82
"7180",79,"[40]tIFHoIEovBkDrtqjhjhqGmbKDaeFlHxnJHqxbGqa",190,0.989637,40,193,2,191,1,2,1,3,2,87,86,105,105,82
"7181",80,"[40]tIFHoIEovBkDrtqjhjhqGmbKDaeFlHxnJHqxbGqa",196,0.98995,40,199,2,197,1,2,1,3,2,92,91,106,106,82
"7182",81,"[40]tIFHoIEovBkDrtqjhjhqGmbKDaeFlHxnJHqxbGqa",196,0.98995,40,199,2,197,1,2,1,3,2,92,91,106,106,82
"7183",82,"[40]tIFHoIEovBkDrtqjhjhqGmbKDaeFlHxnJHqxbGqa",206,0.990431,40,209,2,207,1,2,1,3,2,108,107,100,100,82
"7184",83,"[40]tIFHoIEovBkDrtqjhjhqGmbKDaeFlHxnJHqxbGqa",204,0.990338,40,207,2,205,1,2,1,3,2,106,105,100,100,82
"7185",84,"[40]tIFHoIEovBkDrtqjhjhqGmbKDaeFlHxnJHqxbGqa",206,0.990431,40,209,2,207,1,2,1,3,2,105,104,103,103,82
"7186",85,"[40]tIFHoIEovBkDrtqjhjhqGmbKDaeFlHxnJHqxbGqa",211,0.990654,40,214,2,212,1,2,1,3,2,117,116,96,96,82
"7187",86,"[40]tIFHoIEovBkDrtqjhjhqGmbKDaeFlHxnJHqxbGqa",207,0.990476,40,210,2,208,1,2,1,3,2,109,108,100,100,82
"7188",87,"[40]tIFHoIEovBkDrtqjhjhqGmbKDaeFlHxnJHqxbGqa",208,0.990521,40,211,2,209,1,2,1,3,2,110,109,100,100,82
"7189",88,"[40]tIFHoIEovBkDrtqjhjhqGmbKDaeFlHxnJHqxbGqa",186,0.989418,40,189,2,187,1,2,1,3,2,83,82,105,105,82
"7190",89,"[40]tIFHoIEovBkDrtqjhjhqGmbKDaeFlHxnJHqxbGqa",199,0.990099,40,202,2,200,1,2,1,3,2,101,100,100,100,82
"7191",90,"[40]tIFHoIEovBkDrtqjhjhqGmbKDaeFlHxnJHqxbGqa",201,0.990196,40,204,2,202,1,2,1,3,2,103,102,100,100,82
"7192",91,"[40]tIFHoIEovBkDrtqjhjhqGmbKDaeFlHxnJHqxbGqa",192,0.989744,40,195,2,193,1,2,1,3,2,89,88,105,105,82
"7193",92,"[40]tIFHoIEovBkDrtqjhjhqGmbKDaeFlHxnJHqxbGqa",196,0.98995,40,199,2,197,1,2,1,3,2,98,97,100,100,82
"7194",93,"[40]tIFHoIEovBkDrtqjhjhqGmbKDaeFlHxnJHqxbGqa",206,0.990431,40,209,2,207,1,2,1,3,2,108,107,100,100,82
"7195",94,"[40]tIFHoIEovBkDrtqjhjhqGmbKDaeFlHxnJHqxbGqa",195,0.989899,40,198,2,196,1,2,1,3,2,95,94,102,102,82
"7196",95,"[40]tIFHoIEovBkDrtqjhjhqGmbKDaeFlHxnJHqxbGqa",203,0.990291,40,206,2,204,1,2,1,3,2,105,104,100,100,82
"7197",96,"[40]tIFHoIEovBkDrtqjhjhqGmbKDaeFlHxnJHqxbGqa",190,0.989637,40,193,2,191,1,2,1,3,2,88,87,104,104,82
"7198",97,"[40]tIFHoIEovBkDrtqjhjhqGmbKDaeFlHxnJHqxbGqa",202,0.990244,40,205,2,203,1,2,1,3,2,101,100,103,103,82
"7199",98,"[40]tIFHoIEovBkDrtqjhjhqGmbKDaeFlHxnJHqxbGqa",206,0.990431,40,209,2,207,1,2,1,3,2,106,105,102,102,82
"7200",99,"[40]tIFHoIEovBkDrtqjhjhqGmbKDaeFlHxnJHqxbGqa",206,0.990431,40,209,2,207,1,2,1,3,2,107,106,101,101,82
"7201",0,"[40]cIwHoIcaEBkpEDyGnJDHqjbKDeeKoHtnJHqwbGqa",198,0.99005,40,201,2,199,1,2,1,3,2,99,98,101,101,83
"7202",1,"[40]cIwHoIcaEBkpEDyGnJDHqjbKDeeKoHtnJHqwbGqa",205,0.990385,40,208,2,206,1,2,1,3,2,109,108,98,98,83
"7203",2,"[40]cIwHoIcaEBkpEDyGnJDHqjbKDeeKoHtnJHqwbGqa",215,0.990826,40,218,2,216,1,2,1,3,2,122,121,95,95,83
"7204",3,"[40]cIwHoIcaEBkpEDyGnJDHqjbKDeeKoHtnJHqwbGqa",199,0.990099,40,202,2,200,1,2,1,3,2,97,96,104,104,83
"7205",4,"[40]cIwHoIcaEBkpEDyGnJDHqjbKDeeKoHtnJHqwbGqa",200,0.990148,40,203,2,201,1,2,1,3,2,100,99,102,102,83
"7206",5,"[40]cIwHoIcaEBkpEDyGnJDHqjbKDeeKoHtnJHqwbGqa",205,0.990385,40,208,2,206,1,2,1,3,2,106,105,101,101,83
"7207",6,"[40]cIwHoIcaEBkpEDyGnJDHqjbKDeeKoHtnJHqwbGqa",198,0.99005,40,201,2,199,1,2,1,3,2,97,96,103,103,83
"7208",7,"[40]cIwHoIcaEBkpEDyGnJDHqjbKDeeKoHtnJHqwbGqa",210,0.99061,40,213,2,211,1,2,1,3,2,113,112,99,99,83
"7209",8,"[40]cIwHoIcaEBkpEDyGnJDHqjbKDeeKoHtnJHqwbGqa",195,0.989899,40,198,2,196,1,2,1,3,2,92,91,105,105,83
"7210",9,"[40]cIwHoIcaEBkpEDyGnJDHqjbKDeeKoHtnJHqwbGqa",205,0.990385,40,208,2,206,1,2,1,3,2,110,109,97,97,83
"7211",10,"[40]cIwHoIcaEBkpEDyGnJDHqjbKDeeKoHtnJHqwbGqa",218,0.99095,40,221,2,219,1,2,1,3,2,127,126,93,93,83
"7212",11,"[40]cIwHoIcaEBkpEDyGnJDHqjbKDeeKoHtnJHqwbGqa",198,0.99005,40,201,2,199,1,2,1,3,2,96,95,104,104,83
"7213",12,"[40]cIwHoIcaEBkpEDyGnJDHqjbKDeeKoHtnJHqwbGqa",193,0.989796,40,196,2,194,1,2,1,3,2,92,91,103,103,83
"7214",13,"[40]cIwHoIcaEBkpEDyGnJDHqjbKDeeKoHtnJHqwbGqa",189,0.989583,40,192,2,190,1,2,1,3,2,87,86,104,104,83
"7215",14,"[40]cIwHoIcaEBkpEDyGnJDHqjbKDeeKoHtnJHqwbGqa",195,0.989899,40,198,2,196,1,2,1,3,2,95,94,102,102,83
"7216",15,"[40]cIwHoIcaEBkpEDyGnJDHqjbKDeeKoHtnJHqwbGqa",195,0.989899,40,198,2,196,1,2,1,3,2,92,91,105,105,83
"7217",16,"[40]cIwHoIcaEBkpEDyGnJDHqjbKDeeKoHtnJHqwbGqa",202,0.990244,40,205,2,203,1,2,1,3,2,102,101,102,102,83
"7218",17,"[40]cIwHoIcaEBkpEDyGnJDHqjbKDeeKoHtnJHqwbGqa",198,0.99005,40,201,2,199,1,2,1,3,2,97,96,103,103,83
"7219",18,"[40]cIwHoIcaEBkpEDyGnJDHqjbKDeeKoHtnJHqwbGqa",200,0.990148,40,203,2,201,1,2,1,3,2,99,98,103,103,83
"7220",19,"[40]cIwHoIcaEBkpEDyGnJDHqjbKDeeKoHtnJHqwbGqa",194,0.989848,40,197,2,195,1,2,1,3,2,93,92,103,103,83
"7221",20,"[40]cIwHoIcaEBkpEDyGnJDHqjbKDeeKoHtnJHqwbGqa",192,0.989744,40,195,2,193,1,2,1,3,2,88,87,106,106,83
"7222",21,"[40]cIwHoIcaEBkpEDyGnJDHqjbKDeeKoHtnJHqwbGqa",210,0.99061,40,213,2,211,1,2,1,3,2,116,115,96,96,83
"7223",22,"[40]cIwHoIcaEBkpEDyGnJDHqjbKDeeKoHtnJHqwbGqa",199,0.990099,40,202,2,200,1,2,1,3,2,98,97,103,103,83
"7224",23,"[40]cIwHoIcaEBkpEDyGnJDHqjbKDeeKoHtnJHqwbGqa",203,0.990291,40,206,2,204,1,2,1,3,2,104,103,101,101,83
"7225",24,"[40]cIwHoIcaEBkpEDyGnJDHqjbKDeeKoHtnJHqwbGqa",206,0.990431,40,209,2,207,1,2,1,3,2,109,108,99,99,83
"7226",25,"[40]cIwHoIcaEBkpEDyGnJDHqjbKDeeKoHtnJHqwbGqa",195,0.989899,40,198,2,196,1,2,1,3,2,95,94,102,102,83
"7227",26,"[40]cIwHoIcaEBkpEDyGnJDHqjbKDeeKoHtnJHqwbGqa",202,0.990244,40,205,2,203,1,2,1,3,2,106,105,98,98,83
"7228",27,"[40]cIwHoIcaEBkpEDyGnJDHqjbKDeeKoHtnJHqwbGqa",205,0.990385,40,208,2,206,1,2,1,3,2,106,105,101,101,83
"7229",28,"[40]cIwHoIcaEBkpEDyGnJDHqjbKDeeKoHtnJHqwbGqa",195,0.989899,40,198,2,196,1,2,1,3,2,95,94,102,102,83
"7230",29,"[40]cIwHoIcaEBkpEDyGnJDHqjbKDeeKoHtnJHqwbGqa",211,0.990654,40,214,2,212,1,2,1,3,2,113,112,100,100,83
"7231",30,"[40]cIwHoIcaEBkpEDyGnJDHqjbKDeeKoHtnJHqwbGqa",201,0.990196,40,204,2,202,1,2,1,3,2,101,100,102,102,83
"7232",31,"[40]cIwHoIcaEBkpEDyGnJDHqjbKDeeKoHtnJHqwbGqa",219,0.990991,40,222,2,220,1,2,1,3,2,128,127,93,93,83
"7233",32,"[40]cIwHoIcaEBkpEDyGnJDHqjbKDeeKoHtnJHqwbGqa",197,0.99,40,200,2,198,1,2,1,3,2,94,93,105,105,83
"7234",33,"[40]cIwHoIcaEBkpEDyGnJDHqjbKDeeKoHtnJHqwbGqa",219,0.990991,40,222,2,220,1,2,1,3,2,127,126,94,94,83
"7235",34,"[40]cIwHoIcaEBkpEDyGnJDHqjbKDeeKoHtnJHqwbGqa",190,0.989637,40,193,2,191,1,2,1,3,2,88,87,104,104,83
"7236",35,"[40]cIwHoIcaEBkpEDyGnJDHqjbKDeeKoHtnJHqwbGqa",213,0.990741,40,216,2,214,1,2,1,3,2,121,120,94,94,83
"7237",36,"[40]cIwHoIcaEBkpEDyGnJDHqjbKDeeKoHtnJHqwbGqa",207,0.990476,40,210,2,208,1,2,1,3,2,110,109,99,99,83
"7238",37,"[40]cIwHoIcaEBkpEDyGnJDHqjbKDeeKoHtnJHqwbGqa",207,0.990476,40,210,2,208,1,2,1,3,2,111,110,98,98,83
"7239",38,"[40]cIwHoIcaEBkpEDyGnJDHqjbKDeeKoHtnJHqwbGqa",194,0.989848,40,197,2,195,1,2,1,3,2,89,88,107,107,83
"7240",39,"[40]cIwHoIcaEBkpEDyGnJDHqjbKDeeKoHtnJHqwbGqa",199,0.990099,40,202,2,200,1,2,1,3,2,98,97,103,103,83
"7241",40,"[40]cIwHoIcaEBkpEDyGnJDHqjbKDeeKoHtnJHqwbGqa",212,0.990698,40,215,2,213,1,2,1,3,2,119,118,95,95,83
"7242",41,"[40]cIwHoIcaEBkpEDyGnJDHqjbKDeeKoHtnJHqwbGqa",203,0.990291,40,206,2,204,1,2,1,3,2,105,104,100,100,83
"7243",42,"[40]cIwHoIcaEBkpEDyGnJDHqjbKDeeKoHtnJHqwbGqa",199,0.990099,40,202,2,200,1,2,1,3,2,100,99,101,101,83
"7244",43,"[40]cIwHoIcaEBkpEDyGnJDHqjbKDeeKoHtnJHqwbGqa",202,0.990244,40,205,2,203,1,2,1,3,2,103,102,101,101,83
"7245",44,"[40]cIwHoIcaEBkpEDyGnJDHqjbKDeeKoHtnJHqwbGqa",211,0.990654,40,214,2,212,1,2,1,3,2,114,113,99,99,83
"7246",45,"[40]cIwHoIcaEBkpEDyGnJDHqjbKDeeKoHtnJHqwbGqa",215,0.990826,40,218,2,216,1,2,1,3,2,118,117,99,99,83
"7247",46,"[40]cIwHoIcaEBkpEDyGnJDHqjbKDeeKoHtnJHqwbGqa",201,0.990196,40,204,2,202,1,2,1,3,2,101,100,102,102,83
"7248",47,"[40]cIwHoIcaEBkpEDyGnJDHqjbKDeeKoHtnJHqwbGqa",209,0.990566,40,212,2,210,1,2,1,3,2,116,115,95,95,83
"7249",48,"[40]cIwHoIcaEBkpEDyGnJDHqjbKDeeKoHtnJHqwbGqa",188,0.989529,40,191,2,189,1,2,1,3,2,86,85,104,104,83
"7250",49,"[40]cIwHoIcaEBkpEDyGnJDHqjbKDeeKoHtnJHqwbGqa",207,0.990476,40,210,2,208,1,2,1,3,2,110,109,99,99,83
"7251",50,"[40]cIwHoIcaEBkpEDyGnJDHqjbKDeeKoHtnJHqwbGqa",211,0.990654,40,214,2,212,1,2,1,3,2,114,113,99,99,83
"7252",51,"[40]cIwHoIcaEBkpEDyGnJDHqjbKDeeKoHtnJHqwbGqa",191,0.989691,40,194,2,192,1,2,1,3,2,87,86,106,106,83
"7253",52,"[40]cIwHoIcaEBkpEDyGnJDHqjbKDeeKoHtnJHqwbGqa",196,0.98995,40,199,2,197,1,2,1,3,2,95,94,103,103,83
"7254",53,"[40]cIwHoIcaEBkpEDyGnJDHqjbKDeeKoHtnJHqwbGqa",202,0.990244,40,205,2,203,1,2,1,3,2,104,103,100,100,83
"7255",54,"[40]cIwHoIcaEBkpEDyGnJDHqjbKDeeKoHtnJHqwbGqa",199,0.990099,40,202,2,200,1,2,1,3,2,98,97,103,103,83
"7256",55,"[40]cIwHoIcaEBkpEDyGnJDHqjbKDeeKoHtnJHqwbGqa",198,0.99005,40,201,2,199,1,2,1,3,2,97,96,103,103,83
"7257",56,"[40]cIwHoIcaEBkpEDyGnJDHqjbKDeeKoHtnJHqwbGqa",209,0.990566,40,212,2,210,1,2,1,3,2,113,112,98,98,83
"7258",57,"[40]cIwHoIcaEBkpEDyGnJDHqjbKDeeKoHtnJHqwbGqa",200,0.990148,40,203,2,201,1,2,1,3,2,102,101,100,100,83
"7259",58,"[40]cIwHoIcaEBkpEDyGnJDHqjbKDeeKoHtnJHqwbGqa",199,0.990099,40,202,2,200,1,2,1,3,2,100,99,101,101,83
"7260",59,"[40]cIwHoIcaEBkpEDyGnJDHqjbKDeeKoHtnJHqwbGqa",204,0.990338,40,207,2,205,1,2,1,3,2,106,105,100,100,83
"7261",60,"[40]cIwHoIcaEBkpEDyGnJDHqjbKDeeKoHtnJHqwbGqa",200,0.990148,40,203,2,201,1,2,1,3,2,102,101,100,100,83
"7262",61,"[40]cIwHoIcaEBkpEDyGnJDHqjbKDeeKoHtnJHqwbGqa",203,0.990291,40,206,2,204,1,2,1,3,2,103,102,102,102,83
"7263",62,"[40]cIwHoIcaEBkpEDyGnJDHqjbKDeeKoHtnJHqwbGqa",216,0.990868,40,219,2,217,1,2,1,3,2,119,118,99,99,83
"7264",63,"[40]cIwHoIcaEBkpEDyGnJDHqjbKDeeKoHtnJHqwbGqa",196,0.98995,40,199,2,197,1,2,1,3,2,93,92,105,105,83
"7265",64,"[40]cIwHoIcaEBkpEDyGnJDHqjbKDeeKoHtnJHqwbGqa",199,0.990099,40,202,2,200,1,2,1,3,2,98,97,103,103,83
"7266",65,"[40]cIwHoIcaEBkpEDyGnJDHqjbKDeeKoHtnJHqwbGqa",199,0.990099,40,202,2,200,1,2,1,3,2,97,96,104,104,83
"7267",66,"[40]cIwHoIcaEBkpEDyGnJDHqjbKDeeKoHtnJHqwbGqa",201,0.990196,40,204,2,202,1,2,1,3,2,103,102,100,100,83
"7268",67,"[40]cIwHoIcaEBkpEDyGnJDHqjbKDeeKoHtnJHqwbGqa",206,0.990431,40,209,2,207,1,2,1,3,2,109,108,99,99,83
"7269",68,"[40]cIwHoIcaEBkpEDyGnJDHqjbKDeeKoHtnJHqwbGqa",206,0.990431,40,209,2,207,1,2,1,3,2,107,106,101,101,83
"7270",69,"[40]cIwHoIcaEBkpEDyGnJDHqjbKDeeKoHtnJHqwbGqa",204,0.990338,40,207,2,205,1,2,1,3,2,107,106,99,99,83
"7271",70,"[40]cIwHoIcaEBkpEDyGnJDHqjbKDeeKoHtnJHqwbGqa",196,0.98995,40,199,2,197,1,2,1,3,2,95,94,103,103,83
"7272",71,"[40]cIwHoIcaEBkpEDyGnJDHqjbKDeeKoHtnJHqwbGqa",195,0.989899,40,198,2,196,1,2,1,3,2,94,93,103,103,83
"7273",72,"[40]cIwHoIcaEBkpEDyGnJDHqjbKDeeKoHtnJHqwbGqa",205,0.990385,40,208,2,206,1,2,1,3,2,107,106,100,100,83
"7274",73,"[40]cIwHoIcaEBkpEDyGnJDHqjbKDeeKoHtnJHqwbGqa",201,0.990196,40,204,2,202,1,2,1,3,2,101,100,102,102,83
"7275",74,"[40]cIwHoIcaEBkpEDyGnJDHqjbKDeeKoHtnJHqwbGqa",195,0.989899,40,198,2,196,1,2,1,3,2,96,95,101,101,83
"7276",75,"[40]cIwHoIcaEBkpEDyGnJDHqjbKDeeKoHtnJHqwbGqa",189,0.989583,40,192,2,190,1,2,1,3,2,85,84,106,106,83
"7277",76,"[40]cIwHoIcaEBkpEDyGnJDHqjbKDeeKoHtnJHqwbGqa",196,0.98995,40,199,2,197,1,2,1,3,2,96,95,102,102,83
"7278",77,"[40]cIwHoIcaEBkpEDyGnJDHqjbKDeeKoHtnJHqwbGqa",208,0.990521,40,211,2,209,1,2,1,3,2,113,112,97,97,83
"7279",78,"[40]cIwHoIcaEBkpEDyGnJDHqjbKDeeKoHtnJHqwbGqa",211,0.990654,40,214,2,212,1,2,1,3,2,116,115,97,97,83
"7280",79,"[40]cIwHoIcaEBkpEDyGnJDHqjbKDeeKoHtnJHqwbGqa",206,0.990431,40,209,2,207,1,2,1,3,2,110,109,98,98,83
"7281",80,"[40]cIwHoIcaEBkpEDyGnJDHqjbKDeeKoHtnJHqwbGqa",206,0.990431,40,209,2,207,1,2,1,3,2,106,105,102,102,83
"7282",81,"[40]cIwHoIcaEBkpEDyGnJDHqjbKDeeKoHtnJHqwbGqa",212,0.990698,40,215,2,213,1,2,1,3,2,116,115,98,98,83
"7283",82,"[40]cIwHoIcaEBkpEDyGnJDHqjbKDeeKoHtnJHqwbGqa",205,0.990385,40,208,2,206,1,2,1,3,2,104,103,103,103,83
"7284",83,"[40]cIwHoIcaEBkpEDyGnJDHqjbKDeeKoHtnJHqwbGqa",209,0.990566,40,212,2,210,1,2,1,3,2,111,110,100,100,83
"7285",84,"[40]cIwHoIcaEBkpEDyGnJDHqjbKDeeKoHtnJHqwbGqa",201,0.990196,40,204,2,202,1,2,1,3,2,99,98,104,104,83
"7286",85,"[40]cIwHoIcaEBkpEDyGnJDHqjbKDeeKoHtnJHqwbGqa",192,0.989744,40,195,2,193,1,2,1,3,2,89,88,105,105,83
"7287",86,"[40]cIwHoIcaEBkpEDyGnJDHqjbKDeeKoHtnJHqwbGqa",200,0.990148,40,203,2,201,1,2,1,3,2,100,99,102,102,83
"7288",87,"[40]cIwHoIcaEBkpEDyGnJDHqjbKDeeKoHtnJHqwbGqa",203,0.990291,40,206,2,204,1,2,1,3,2,108,107,97,97,83
"7289",88,"[40]cIwHoIcaEBkpEDyGnJDHqjbKDeeKoHtnJHqwbGqa",203,0.990291,40,206,2,204,1,2,1,3,2,103,102,102,102,83
"7290",89,"[40]cIwHoIcaEBkpEDyGnJDHqjbKDeeKoHtnJHqwbGqa",217,0.990909,40,220,2,218,1,2,1,3,2,124,123,95,95,83
"7291",90,"[40]cIwHoIcaEBkpEDyGnJDHqjbKDeeKoHtnJHqwbGqa",221,0.991071,40,224,2,222,1,2,1,3,2,127,126,96,96,83
"7292",91,"[40]cIwHoIcaEBkpEDyGnJDHqjbKDeeKoHtnJHqwbGqa",203,0.990291,40,206,2,204,1,2,1,3,2,102,101,103,103,83
"7293",92,"[40]cIwHoIcaEBkpEDyGnJDHqjbKDeeKoHtnJHqwbGqa",185,0.989362,40,188,2,186,1,2,1,3,2,81,80,106,106,83
"7294",93,"[40]cIwHoIcaEBkpEDyGnJDHqjbKDeeKoHtnJHqwbGqa",207,0.990476,40,210,2,208,1,2,1,3,2,104,103,105,105,83
"7295",94,"[40]cIwHoIcaEBkpEDyGnJDHqjbKDeeKoHtnJHqwbGqa",203,0.990291,40,206,2,204,1,2,1,3,2,104,103,101,101,83
"7296",95,"[40]cIwHoIcaEBkpEDyGnJDHqjbKDeeKoHtnJHqwbGqa",210,0.99061,40,213,2,211,1,2,1,3,2,115,114,97,97,83
"7297",96,"[40]cIwHoIcaEBkpEDyGnJDHqjbKDeeKoHtnJHqwbGqa",205,0.990385,40,208,2,206,1,2,1,3,2,107,106,100,100,83
"7298",97,"[40]cIwHoIcaEBkpEDyGnJDHqjbKDeeKoHtnJHqwbGqa",207,0.990476,40,210,2,208,1,2,1,3,2,108,107,101,101,83
"7299",98,"[40]cIwHoIcaEBkpEDyGnJDHqjbKDeeKoHtnJHqwbGqa",204,0.990338,40,207,2,205,1,2,1,3,2,105,104,101,101,83
"7300",99,"[40]cIwHoIcaEBkpEDyGnJDHqjbKDeeKoHtnJHqwbGqa",204,0.990338,40,207,2,205,1,2,1,3,2,105,104,101,101,83
"7301",0,"[40]bIdHoIvdGBkDtFCzfiGiKCbKDaejfHwnJHqxbGqa",206,0.990431,40,209,2,207,1,2,1,3,2,110,109,98,98,84
"7302",1,"[40]bIdHoIvdGBkDtFCzfiGiKCbKDaejfHwnJHqxbGqa",194,0.989848,40,197,2,195,1,2,1,3,2,91,90,105,105,84
"7303",2,"[40]bIdHoIvdGBkDtFCzfiGiKCbKDaejfHwnJHqxbGqa",203,0.990291,40,206,2,204,1,2,1,3,2,104,103,101,101,84
"7304",3,"[40]bIdHoIvdGBkDtFCzfiGiKCbKDaejfHwnJHqxbGqa",199,0.990099,40,202,2,200,1,2,1,3,2,99,98,102,102,84
"7305",4,"[40]bIdHoIvdGBkDtFCzfiGiKCbKDaejfHwnJHqxbGqa",197,0.99,40,200,2,198,1,2,1,3,2,97,96,102,102,84
"7306",5,"[40]bIdHoIvdGBkDtFCzfiGiKCbKDaejfHwnJHqxbGqa",209,0.990566,40,212,2,210,1,2,1,3,2,112,111,99,99,84
"7307",6,"[40]bIdHoIvdGBkDtFCzfiGiKCbKDaejfHwnJHqxbGqa",188,0.989529,40,191,2,189,1,2,1,3,2,86,85,104,104,84
"7308",7,"[40]bIdHoIvdGBkDtFCzfiGiKCbKDaejfHwnJHqxbGqa",202,0.990244,40,205,2,203,1,2,1,3,2,103,102,101,101,84
"7309",8,"[40]bIdHoIvdGBkDtFCzfiGiKCbKDaejfHwnJHqxbGqa",200,0.990148,40,203,2,201,1,2,1,3,2,101,100,101,101,84
"7310",9,"[40]bIdHoIvdGBkDtFCzfiGiKCbKDaejfHwnJHqxbGqa",203,0.990291,40,206,2,204,1,2,1,3,2,104,103,101,101,84
"7311",10,"[40]bIdHoIvdGBkDtFCzfiGiKCbKDaejfHwnJHqxbGqa",203,0.990291,40,206,2,204,1,2,1,3,2,105,104,100,100,84
"7312",11,"[40]bIdHoIvdGBkDtFCzfiGiKCbKDaejfHwnJHqxbGqa",197,0.99,40,200,2,198,1,2,1,3,2,97,96,102,102,84
"7313",12,"[40]bIdHoIvdGBkDtFCzfiGiKCbKDaejfHwnJHqxbGqa",202,0.990244,40,205,2,203,1,2,1,3,2,102,101,102,102,84
"7314",13,"[40]bIdHoIvdGBkDtFCzfiGiKCbKDaejfHwnJHqxbGqa",200,0.990148,40,203,2,201,1,2,1,3,2,101,100,101,101,84
"7315",14,"[40]bIdHoIvdGBkDtFCzfiGiKCbKDaejfHwnJHqxbGqa",216,0.990868,40,219,2,217,1,2,1,3,2,122,121,96,96,84
"7316",15,"[40]bIdHoIvdGBkDtFCzfiGiKCbKDaejfHwnJHqxbGqa",213,0.990741,40,216,2,214,1,2,1,3,2,119,118,96,96,84
"7317",16,"[40]bIdHoIvdGBkDtFCzfiGiKCbKDaejfHwnJHqxbGqa",203,0.990291,40,206,2,204,1,2,1,3,2,105,104,100,100,84
"7318",17,"[40]bIdHoIvdGBkDtFCzfiGiKCbKDaejfHwnJHqxbGqa",206,0.990431,40,209,2,207,1,2,1,3,2,108,107,100,100,84
"7319",18,"[40]bIdHoIvdGBkDtFCzfiGiKCbKDaejfHwnJHqxbGqa",195,0.989899,40,198,2,196,1,2,1,3,2,95,94,102,102,84
"7320",19,"[40]bIdHoIvdGBkDtFCzfiGiKCbKDaejfHwnJHqxbGqa",213,0.990741,40,216,2,214,1,2,1,3,2,118,117,97,97,84
"7321",20,"[40]bIdHoIvdGBkDtFCzfiGiKCbKDaejfHwnJHqxbGqa",197,0.99,40,200,2,198,1,2,1,3,2,96,95,103,103,84
"7322",21,"[40]bIdHoIvdGBkDtFCzfiGiKCbKDaejfHwnJHqxbGqa",197,0.99,40,200,2,198,1,2,1,3,2,95,94,104,104,84
"7323",22,"[40]bIdHoIvdGBkDtFCzfiGiKCbKDaejfHwnJHqxbGqa",206,0.990431,40,209,2,207,1,2,1,3,2,105,104,103,103,84
"7324",23,"[40]bIdHoIvdGBkDtFCzfiGiKCbKDaejfHwnJHqxbGqa",205,0.990385,40,208,2,206,1,2,1,3,2,108,107,99,99,84
"7325",24,"[40]bIdHoIvdGBkDtFCzfiGiKCbKDaejfHwnJHqxbGqa",214,0.990783,40,217,2,215,1,2,1,3,2,120,119,96,96,84
"7326",25,"[40]bIdHoIvdGBkDtFCzfiGiKCbKDaejfHwnJHqxbGqa",188,0.989529,40,191,2,189,1,2,1,3,2,85,84,105,105,84
"7327",26,"[40]bIdHoIvdGBkDtFCzfiGiKCbKDaejfHwnJHqxbGqa",190,0.989637,40,193,2,191,1,2,1,3,2,87,86,105,105,84
"7328",27,"[40]bIdHoIvdGBkDtFCzfiGiKCbKDaejfHwnJHqxbGqa",196,0.98995,40,199,2,197,1,2,1,3,2,95,94,103,103,84
"7329",28,"[40]bIdHoIvdGBkDtFCzfiGiKCbKDaejfHwnJHqxbGqa",210,0.99061,40,213,2,211,1,2,1,3,2,115,114,97,97,84
"7330",29,"[40]bIdHoIvdGBkDtFCzfiGiKCbKDaejfHwnJHqxbGqa",200,0.990148,40,203,2,201,1,2,1,3,2,97,96,105,105,84
"7331",30,"[40]bIdHoIvdGBkDtFCzfiGiKCbKDaejfHwnJHqxbGqa",205,0.990385,40,208,2,206,1,2,1,3,2,108,107,99,99,84
"7332",31,"[40]bIdHoIvdGBkDtFCzfiGiKCbKDaejfHwnJHqxbGqa",190,0.989637,40,193,2,191,1,2,1,3,2,87,86,105,105,84
"7333",32,"[40]bIdHoIvdGBkDtFCzfiGiKCbKDaejfHwnJHqxbGqa",193,0.989796,40,196,2,194,1,2,1,3,2,89,88,106,106,84
"7334",33,"[40]bIdHoIvdGBkDtFCzfiGiKCbKDaejfHwnJHqxbGqa",201,0.990196,40,204,2,202,1,2,1,3,2,103,102,100,100,84
"7335",34,"[40]bIdHoIvdGBkDtFCzfiGiKCbKDaejfHwnJHqxbGqa",208,0.990521,40,211,2,209,1,2,1,3,2,114,113,96,96,84
"7336",35,"[40]bIdHoIvdGBkDtFCzfiGiKCbKDaejfHwnJHqxbGqa",213,0.990741,40,216,2,214,1,2,1,3,2,117,116,98,98,84
"7337",36,"[40]bIdHoIvdGBkDtFCzfiGiKCbKDaejfHwnJHqxbGqa",188,0.989529,40,191,2,189,1,2,1,3,2,84,83,106,106,84
"7338",37,"[40]bIdHoIvdGBkDtFCzfiGiKCbKDaejfHwnJHqxbGqa",205,0.990385,40,208,2,206,1,2,1,3,2,108,107,99,99,84
"7339",38,"[40]bIdHoIvdGBkDtFCzfiGiKCbKDaejfHwnJHqxbGqa",191,0.989691,40,194,2,192,1,2,1,3,2,87,86,106,106,84
"7340",39,"[40]bIdHoIvdGBkDtFCzfiGiKCbKDaejfHwnJHqxbGqa",197,0.99,40,200,2,198,1,2,1,3,2,98,97,101,101,84
"7341",40,"[40]bIdHoIvdGBkDtFCzfiGiKCbKDaejfHwnJHqxbGqa",197,0.99,40,200,2,198,1,2,1,3,2,98,97,101,101,84
"7342",41,"[40]bIdHoIvdGBkDtFCzfiGiKCbKDaejfHwnJHqxbGqa",193,0.989796,40,196,2,194,1,2,1,3,2,92,91,103,103,84
"7343",42,"[40]bIdHoIvdGBkDtFCzfiGiKCbKDaejfHwnJHqxbGqa",192,0.989744,40,195,2,193,1,2,1,3,2,90,89,104,104,84
"7344",43,"[40]bIdHoIvdGBkDtFCzfiGiKCbKDaejfHwnJHqxbGqa",206,0.990431,40,209,2,207,1,2,1,3,2,108,107,100,100,84
"7345",44,"[40]bIdHoIvdGBkDtFCzfiGiKCbKDaejfHwnJHqxbGqa",210,0.99061,40,213,2,211,1,2,1,3,2,115,114,97,97,84
"7346",45,"[40]bIdHoIvdGBkDtFCzfiGiKCbKDaejfHwnJHqxbGqa",201,0.990196,40,204,2,202,1,2,1,3,2,102,101,101,101,84
"7347",46,"[40]bIdHoIvdGBkDtFCzfiGiKCbKDaejfHwnJHqxbGqa",188,0.989529,40,191,2,189,1,2,1,3,2,83,82,107,107,84
"7348",47,"[40]bIdHoIvdGBkDtFCzfiGiKCbKDaejfHwnJHqxbGqa",205,0.990385,40,208,2,206,1,2,1,3,2,108,107,99,99,84
"7349",48,"[40]bIdHoIvdGBkDtFCzfiGiKCbKDaejfHwnJHqxbGqa",191,0.989691,40,194,2,192,1,2,1,3,2,89,88,104,104,84
"7350",49,"[40]bIdHoIvdGBkDtFCzfiGiKCbKDaejfHwnJHqxbGqa",208,0.990521,40,211,2,209,1,2,1,3,2,110,109,100,100,84
"7351",50,"[40]bIdHoIvdGBkDtFCzfiGiKCbKDaejfHwnJHqxbGqa",217,0.990909,40,220,2,218,1,2,1,3,2,128,127,91,91,84
"7352",51,"[40]bIdHoIvdGBkDtFCzfiGiKCbKDaejfHwnJHqxbGqa",200,0.990148,40,203,2,201,1,2,1,3,2,101,100,101,101,84
"7353",52,"[40]bIdHoIvdGBkDtFCzfiGiKCbKDaejfHwnJHqxbGqa",203,0.990291,40,206,2,204,1,2,1,3,2,106,105,99,99,84
"7354",53,"[40]bIdHoIvdGBkDtFCzfiGiKCbKDaejfHwnJHqxbGqa",195,0.989899,40,198,2,196,1,2,1,3,2,95,94,102,102,84
"7355",54,"[40]bIdHoIvdGBkDtFCzfiGiKCbKDaejfHwnJHqxbGqa",202,0.990244,40,205,2,203,1,2,1,3,2,106,105,98,98,84
"7356",55,"[40]bIdHoIvdGBkDtFCzfiGiKCbKDaejfHwnJHqxbGqa",205,0.990385,40,208,2,206,1,2,1,3,2,109,108,98,98,84
"7357",56,"[40]bIdHoIvdGBkDtFCzfiGiKCbKDaejfHwnJHqxbGqa",186,0.989418,40,189,2,187,1,2,1,3,2,81,80,107,107,84
"7358",57,"[40]bIdHoIvdGBkDtFCzfiGiKCbKDaejfHwnJHqxbGqa",194,0.989848,40,197,2,195,1,2,1,3,2,94,93,102,102,84
"7359",58,"[40]bIdHoIvdGBkDtFCzfiGiKCbKDaejfHwnJHqxbGqa",194,0.989848,40,197,2,195,1,2,1,3,2,91,90,105,105,84
"7360",59,"[40]bIdHoIvdGBkDtFCzfiGiKCbKDaejfHwnJHqxbGqa",200,0.990148,40,203,2,201,1,2,1,3,2,100,99,102,102,84
"7361",60,"[40]bIdHoIvdGBkDtFCzfiGiKCbKDaejfHwnJHqxbGqa",203,0.990291,40,206,2,204,1,2,1,3,2,105,104,100,100,84
"7362",61,"[40]bIdHoIvdGBkDtFCzfiGiKCbKDaejfHwnJHqxbGqa",210,0.99061,40,213,2,211,1,2,1,3,2,118,117,94,94,84
"7363",62,"[40]bIdHoIvdGBkDtFCzfiGiKCbKDaejfHwnJHqxbGqa",206,0.990431,40,209,2,207,1,2,1,3,2,108,107,100,100,84
"7364",63,"[40]bIdHoIvdGBkDtFCzfiGiKCbKDaejfHwnJHqxbGqa",210,0.99061,40,213,2,211,1,2,1,3,2,113,112,99,99,84
"7365",64,"[40]bIdHoIvdGBkDtFCzfiGiKCbKDaejfHwnJHqxbGqa",209,0.990566,40,212,2,210,1,2,1,3,2,112,111,99,99,84
"7366",65,"[40]bIdHoIvdGBkDtFCzfiGiKCbKDaejfHwnJHqxbGqa",197,0.99,40,200,2,198,1,2,1,3,2,97,96,102,102,84
"7367",66,"[40]bIdHoIvdGBkDtFCzfiGiKCbKDaejfHwnJHqxbGqa",207,0.990476,40,210,2,208,1,2,1,3,2,108,107,101,101,84
"7368",67,"[40]bIdHoIvdGBkDtFCzfiGiKCbKDaejfHwnJHqxbGqa",203,0.990291,40,206,2,204,1,2,1,3,2,105,104,100,100,84
"7369",68,"[40]bIdHoIvdGBkDtFCzfiGiKCbKDaejfHwnJHqxbGqa",198,0.99005,40,201,2,199,1,2,1,3,2,99,98,101,101,84
"7370",69,"[40]bIdHoIvdGBkDtFCzfiGiKCbKDaejfHwnJHqxbGqa",210,0.99061,40,213,2,211,1,2,1,3,2,117,116,95,95,84
"7371",70,"[40]bIdHoIvdGBkDtFCzfiGiKCbKDaejfHwnJHqxbGqa",188,0.989529,40,191,2,189,1,2,1,3,2,83,82,107,107,84
"7372",71,"[40]bIdHoIvdGBkDtFCzfiGiKCbKDaejfHwnJHqxbGqa",196,0.98995,40,199,2,197,1,2,1,3,2,99,98,99,99,84
"7373",72,"[40]bIdHoIvdGBkDtFCzfiGiKCbKDaejfHwnJHqxbGqa",201,0.990196,40,204,2,202,1,2,1,3,2,102,101,101,101,84
"7374",73,"[40]bIdHoIvdGBkDtFCzfiGiKCbKDaejfHwnJHqxbGqa",202,0.990244,40,205,2,203,1,2,1,3,2,104,103,100,100,84
"7375",74,"[40]bIdHoIvdGBkDtFCzfiGiKCbKDaejfHwnJHqxbGqa",182,0.989189,40,185,2,183,1,2,1,3,2,75,74,109,109,84
"7376",75,"[40]bIdHoIvdGBkDtFCzfiGiKCbKDaejfHwnJHqxbGqa",199,0.990099,40,202,2,200,1,2,1,3,2,102,101,99,99,84
"7377",76,"[40]bIdHoIvdGBkDtFCzfiGiKCbKDaejfHwnJHqxbGqa",195,0.989899,40,198,2,196,1,2,1,3,2,93,92,104,104,84
"7378",77,"[40]bIdHoIvdGBkDtFCzfiGiKCbKDaejfHwnJHqxbGqa",198,0.99005,40,201,2,199,1,2,1,3,2,99,98,101,101,84
"7379",78,"[40]bIdHoIvdGBkDtFCzfiGiKCbKDaejfHwnJHqxbGqa",210,0.99061,40,213,2,211,1,2,1,3,2,116,115,96,96,84
"7380",79,"[40]bIdHoIvdGBkDtFCzfiGiKCbKDaejfHwnJHqxbGqa",202,0.990244,40,205,2,203,1,2,1,3,2,107,106,97,97,84
"7381",80,"[40]bIdHoIvdGBkDtFCzfiGiKCbKDaejfHwnJHqxbGqa",196,0.98995,40,199,2,197,1,2,1,3,2,95,94,103,103,84
"7382",81,"[40]bIdHoIvdGBkDtFCzfiGiKCbKDaejfHwnJHqxbGqa",196,0.98995,40,199,2,197,1,2,1,3,2,92,91,106,106,84
"7383",82,"[40]bIdHoIvdGBkDtFCzfiGiKCbKDaejfHwnJHqxbGqa",191,0.989691,40,194,2,192,1,2,1,3,2,90,89,103,103,84
"7384",83,"[40]bIdHoIvdGBkDtFCzfiGiKCbKDaejfHwnJHqxbGqa",192,0.989744,40,195,2,193,1,2,1,3,2,91,90,103,103,84
"7385",84,"[40]bIdHoIvdGBkDtFCzfiGiKCbKDaejfHwnJHqxbGqa",208,0.990521,40,211,2,209,1,2,1,3,2,113,112,97,97,84
"7386",85,"[40]bIdHoIvdGBkDtFCzfiGiKCbKDaejfHwnJHqxbGqa",199,0.990099,40,202,2,200,1,2,1,3,2,99,98,102,102,84
"7387",86,"[40]bIdHoIvdGBkDtFCzfiGiKCbKDaejfHwnJHqxbGqa",195,0.989899,40,198,2,196,1,2,1,3,2,94,93,103,103,84
"7388",87,"[40]bIdHoIvdGBkDtFCzfiGiKCbKDaejfHwnJHqxbGqa",195,0.989899,40,198,2,196,1,2,1,3,2,96,95,101,101,84
"7389",88,"[40]bIdHoIvdGBkDtFCzfiGiKCbKDaejfHwnJHqxbGqa",205,0.990385,40,208,2,206,1,2,1,3,2,106,105,101,101,84
"7390",89,"[40]bIdHoIvdGBkDtFCzfiGiKCbKDaejfHwnJHqxbGqa",199,0.990099,40,202,2,200,1,2,1,3,2,101,100,100,100,84
"7391",90,"[40]bIdHoIvdGBkDtFCzfiGiKCbKDaejfHwnJHqxbGqa",212,0.990698,40,215,2,213,1,2,1,3,2,117,116,97,97,84
"7392",91,"[40]bIdHoIvdGBkDtFCzfiGiKCbKDaejfHwnJHqxbGqa",208,0.990521,40,211,2,209,1,2,1,3,2,111,110,99,99,84
"7393",92,"[40]bIdHoIvdGBkDtFCzfiGiKCbKDaejfHwnJHqxbGqa",209,0.990566,40,212,2,210,1,2,1,3,2,113,112,98,98,84
"7394",93,"[40]bIdHoIvdGBkDtFCzfiGiKCbKDaejfHwnJHqxbGqa",191,0.989691,40,194,2,192,1,2,1,3,2,89,88,104,104,84
"7395",94,"[40]bIdHoIvdGBkDtFCzfiGiKCbKDaejfHwnJHqxbGqa",204,0.990338,40,207,2,205,1,2,1,3,2,108,107,98,98,84
"7396",95,"[40]bIdHoIvdGBkDtFCzfiGiKCbKDaejfHwnJHqxbGqa",192,0.989744,40,195,2,193,1,2,1,3,2,90,89,104,104,84
"7397",96,"[40]bIdHoIvdGBkDtFCzfiGiKCbKDaejfHwnJHqxbGqa",209,0.990566,40,212,2,210,1,2,1,3,2,114,113,97,97,84
"7398",97,"[40]bIdHoIvdGBkDtFCzfiGiKCbKDaejfHwnJHqxbGqa",202,0.990244,40,205,2,203,1,2,1,3,2,103,102,101,101,84
"7399",98,"[40]bIdHoIvdGBkDtFCzfiGiKCbKDaejfHwnJHqxbGqa",200,0.990148,40,203,2,201,1,2,1,3,2,101,100,101,101,84
"7400",99,"[40]bIdHoIvdGBkDtFCzfiGiKCbKDaejfHwnJHqxbGqa",200,0.990148,40,203,2,201,1,2,1,3,2,102,101,100,100,84
"7401",0,"[40]lIuHoIpFrBkDyaqoGtxfAJbKDeerrHvnJHqwbGqa",192,0.989744,40,195,2,193,1,2,1,3,2,90,89,104,104,85
"7402",1,"[40]lIuHoIpFrBkDyaqoGtxfAJbKDeerrHvnJHqwbGqa",190,0.989637,40,193,2,191,1,2,1,3,2,86,85,106,106,85
"7403",2,"[40]lIuHoIpFrBkDyaqoGtxfAJbKDeerrHvnJHqwbGqa",198,0.99005,40,201,2,199,1,2,1,3,2,97,96,103,103,85
"7404",3,"[40]lIuHoIpFrBkDyaqoGtxfAJbKDeerrHvnJHqwbGqa",207,0.990476,40,210,2,208,1,2,1,3,2,112,111,97,97,85
"7405",4,"[40]lIuHoIpFrBkDyaqoGtxfAJbKDeerrHvnJHqwbGqa",211,0.990654,40,214,2,212,1,2,1,3,2,114,113,99,99,85
"7406",5,"[40]lIuHoIpFrBkDyaqoGtxfAJbKDeerrHvnJHqwbGqa",200,0.990148,40,203,2,201,1,2,1,3,2,103,102,99,99,85
"7407",6,"[40]lIuHoIpFrBkDyaqoGtxfAJbKDeerrHvnJHqwbGqa",213,0.990741,40,216,2,214,1,2,1,3,2,119,118,96,96,85
"7408",7,"[40]lIuHoIpFrBkDyaqoGtxfAJbKDeerrHvnJHqwbGqa",199,0.990099,40,202,2,200,1,2,1,3,2,98,97,103,103,85
"7409",8,"[40]lIuHoIpFrBkDyaqoGtxfAJbKDeerrHvnJHqwbGqa",192,0.989744,40,195,2,193,1,2,1,3,2,89,88,105,105,85
"7410",9,"[40]lIuHoIpFrBkDyaqoGtxfAJbKDeerrHvnJHqwbGqa",214,0.990783,40,217,2,215,1,2,1,3,2,120,119,96,96,85
"7411",10,"[40]lIuHoIpFrBkDyaqoGtxfAJbKDeerrHvnJHqwbGqa",202,0.990244,40,205,2,203,1,2,1,3,2,104,103,100,100,85
"7412",11,"[40]lIuHoIpFrBkDyaqoGtxfAJbKDeerrHvnJHqwbGqa",194,0.989848,40,197,2,195,1,2,1,3,2,92,91,104,104,85
"7413",12,"[40]lIuHoIpFrBkDyaqoGtxfAJbKDeerrHvnJHqwbGqa",203,0.990291,40,206,2,204,1,2,1,3,2,103,102,102,102,85
"7414",13,"[40]lIuHoIpFrBkDyaqoGtxfAJbKDeerrHvnJHqwbGqa",204,0.990338,40,207,2,205,1,2,1,3,2,107,106,99,99,85
"7415",14,"[40]lIuHoIpFrBkDyaqoGtxfAJbKDeerrHvnJHqwbGqa",199,0.990099,40,202,2,200,1,2,1,3,2,100,99,101,101,85
"7416",15,"[40]lIuHoIpFrBkDyaqoGtxfAJbKDeerrHvnJHqwbGqa",202,0.990244,40,205,2,203,1,2,1,3,2,102,101,102,102,85
"7417",16,"[40]lIuHoIpFrBkDyaqoGtxfAJbKDeerrHvnJHqwbGqa",193,0.989796,40,196,2,194,1,2,1,3,2,90,89,105,105,85
"7418",17,"[40]lIuHoIpFrBkDyaqoGtxfAJbKDeerrHvnJHqwbGqa",212,0.990698,40,215,2,213,1,2,1,3,2,119,118,95,95,85
"7419",18,"[40]lIuHoIpFrBkDyaqoGtxfAJbKDeerrHvnJHqwbGqa",197,0.99,40,200,2,198,1,2,1,3,2,99,98,100,100,85
"7420",19,"[40]lIuHoIpFrBkDyaqoGtxfAJbKDeerrHvnJHqwbGqa",201,0.990196,40,204,2,202,1,2,1,3,2,104,103,99,99,85
"7421",20,"[40]lIuHoIpFrBkDyaqoGtxfAJbKDeerrHvnJHqwbGqa",182,0.989189,40,185,2,183,1,2,1,3,2,78,77,106,106,85
"7422",21,"[40]lIuHoIpFrBkDyaqoGtxfAJbKDeerrHvnJHqwbGqa",197,0.99,40,200,2,198,1,2,1,3,2,97,96,102,102,85
"7423",22,"[40]lIuHoIpFrBkDyaqoGtxfAJbKDeerrHvnJHqwbGqa",200,0.990148,40,203,2,201,1,2,1,3,2,101,100,101,101,85
"7424",23,"[40]lIuHoIpFrBkDyaqoGtxfAJbKDeerrHvnJHqwbGqa",198,0.99005,40,201,2,199,1,2,1,3,2,100,99,100,100,85
"7425",24,"[40]lIuHoIpFrBkDyaqoGtxfAJbKDeerrHvnJHqwbGqa",202,0.990244,40,205,2,203,1,2,1,3,2,101,100,103,103,85
"7426",25,"[40]lIuHoIpFrBkDyaqoGtxfAJbKDeerrHvnJHqwbGqa",218,0.99095,40,221,2,219,1,2,1,3,2,128,127,92,92,85
"7427",26,"[40]lIuHoIpFrBkDyaqoGtxfAJbKDeerrHvnJHqwbGqa",196,0.98995,40,199,2,197,1,2,1,3,2,93,92,105,105,85
"7428",27,"[40]lIuHoIpFrBkDyaqoGtxfAJbKDeerrHvnJHqwbGqa",208,0.990521,40,211,2,209,1,2,1,3,2,112,111,98,98,85
"7429",28,"[40]lIuHoIpFrBkDyaqoGtxfAJbKDeerrHvnJHqwbGqa",207,0.990476,40,210,2,208,1,2,1,3,2,109,108,100,100,85
"7430",29,"[40]lIuHoIpFrBkDyaqoGtxfAJbKDeerrHvnJHqwbGqa",216,0.990868,40,219,2,217,1,2,1,3,2,124,123,94,94,85
"7431",30,"[40]lIuHoIpFrBkDyaqoGtxfAJbKDeerrHvnJHqwbGqa",204,0.990338,40,207,2,205,1,2,1,3,2,106,105,100,100,85
"7432",31,"[40]lIuHoIpFrBkDyaqoGtxfAJbKDeerrHvnJHqwbGqa",192,0.989744,40,195,2,193,1,2,1,3,2,91,90,103,103,85
"7433",32,"[40]lIuHoIpFrBkDyaqoGtxfAJbKDeerrHvnJHqwbGqa",206,0.990431,40,209,2,207,1,2,1,3,2,111,110,97,97,85
"7434",33,"[40]lIuHoIpFrBkDyaqoGtxfAJbKDeerrHvnJHqwbGqa",195,0.989899,40,198,2,196,1,2,1,3,2,94,93,103,103,85
"7435",34,"[40]lIuHoIpFrBkDyaqoGtxfAJbKDeerrHvnJHqwbGqa",199,0.990099,40,202,2,200,1,2,1,3,2,99,98,102,102,85
"7436",35,"[40]lIuHoIpFrBkDyaqoGtxfAJbKDeerrHvnJHqwbGqa",194,0.989848,40,197,2,195,1,2,1,3,2,94,93,102,102,85
"7437",36,"[40]lIuHoIpFrBkDyaqoGtxfAJbKDeerrHvnJHqwbGqa",203,0.990291,40,206,2,204,1,2,1,3,2,103,102,102,102,85
"7438",37,"[40]lIuHoIpFrBkDyaqoGtxfAJbKDeerrHvnJHqwbGqa",197,0.99,40,200,2,198,1,2,1,3,2,99,98,100,100,85
"7439",38,"[40]lIuHoIpFrBkDyaqoGtxfAJbKDeerrHvnJHqwbGqa",209,0.990566,40,212,2,210,1,2,1,3,2,112,111,99,99,85
"7440",39,"[40]lIuHoIpFrBkDyaqoGtxfAJbKDeerrHvnJHqwbGqa",185,0.989362,40,188,2,186,1,2,1,3,2,78,77,109,109,85
"7441",40,"[40]lIuHoIpFrBkDyaqoGtxfAJbKDeerrHvnJHqwbGqa",204,0.990338,40,207,2,205,1,2,1,3,2,108,107,98,98,85
"7442",41,"[40]lIuHoIpFrBkDyaqoGtxfAJbKDeerrHvnJHqwbGqa",202,0.990244,40,205,2,203,1,2,1,3,2,104,103,100,100,85
"7443",42,"[40]lIuHoIpFrBkDyaqoGtxfAJbKDeerrHvnJHqwbGqa",199,0.990099,40,202,2,200,1,2,1,3,2,98,97,103,103,85
"7444",43,"[40]lIuHoIpFrBkDyaqoGtxfAJbKDeerrHvnJHqwbGqa",204,0.990338,40,207,2,205,1,2,1,3,2,106,105,100,100,85
"7445",44,"[40]lIuHoIpFrBkDyaqoGtxfAJbKDeerrHvnJHqwbGqa",206,0.990431,40,209,2,207,1,2,1,3,2,106,105,102,102,85
"7446",45,"[40]lIuHoIpFrBkDyaqoGtxfAJbKDeerrHvnJHqwbGqa",203,0.990291,40,206,2,204,1,2,1,3,2,104,103,101,101,85
"7447",46,"[40]lIuHoIpFrBkDyaqoGtxfAJbKDeerrHvnJHqwbGqa",200,0.990148,40,203,2,201,1,2,1,3,2,103,102,99,99,85
"7448",47,"[40]lIuHoIpFrBkDyaqoGtxfAJbKDeerrHvnJHqwbGqa",209,0.990566,40,212,2,210,1,2,1,3,2,112,111,99,99,85
"7449",48,"[40]lIuHoIpFrBkDyaqoGtxfAJbKDeerrHvnJHqwbGqa",203,0.990291,40,206,2,204,1,2,1,3,2,102,101,103,103,85
"7450",49,"[40]lIuHoIpFrBkDyaqoGtxfAJbKDeerrHvnJHqwbGqa",189,0.989583,40,192,2,190,1,2,1,3,2,86,85,105,105,85
"7451",50,"[40]lIuHoIpFrBkDyaqoGtxfAJbKDeerrHvnJHqwbGqa",210,0.99061,40,213,2,211,1,2,1,3,2,117,116,95,95,85
"7452",51,"[40]lIuHoIpFrBkDyaqoGtxfAJbKDeerrHvnJHqwbGqa",199,0.990099,40,202,2,200,1,2,1,3,2,99,98,102,102,85
"7453",52,"[40]lIuHoIpFrBkDyaqoGtxfAJbKDeerrHvnJHqwbGqa",201,0.990196,40,204,2,202,1,2,1,3,2,102,101,101,101,85
"7454",53,"[40]lIuHoIpFrBkDyaqoGtxfAJbKDeerrHvnJHqwbGqa",198,0.99005,40,201,2,199,1,2,1,3,2,97,96,103,103,85
"7455",54,"[40]lIuHoIpFrBkDyaqoGtxfAJbKDeerrHvnJHqwbGqa",203,0.990291,40,206,2,204,1,2,1,3,2,103,102,102,102,85
"7456",55,"[40]lIuHoIpFrBkDyaqoGtxfAJbKDeerrHvnJHqwbGqa",199,0.990099,40,202,2,200,1,2,1,3,2,100,99,101,101,85
"7457",56,"[40]lIuHoIpFrBkDyaqoGtxfAJbKDeerrHvnJHqwbGqa",213,0.990741,40,216,2,214,1,2,1,3,2,117,116,98,98,85
"7458",57,"[40]lIuHoIpFrBkDyaqoGtxfAJbKDeerrHvnJHqwbGqa",202,0.990244,40,205,2,203,1,2,1,3,2,105,104,99,99,85
"7459",58,"[40]lIuHoIpFrBkDyaqoGtxfAJbKDeerrHvnJHqwbGqa",204,0.990338,40,207,2,205,1,2,1,3,2,106,105,100,100,85
"7460",59,"[40]lIuHoIpFrBkDyaqoGtxfAJbKDeerrHvnJHqwbGqa",204,0.990338,40,207,2,205,1,2,1,3,2,107,106,99,99,85
"7461",60,"[40]lIuHoIpFrBkDyaqoGtxfAJbKDeerrHvnJHqwbGqa",195,0.989899,40,198,2,196,1,2,1,3,2,95,94,102,102,85
"7462",61,"[40]lIuHoIpFrBkDyaqoGtxfAJbKDeerrHvnJHqwbGqa",201,0.990196,40,204,2,202,1,2,1,3,2,102,101,101,101,85
"7463",62,"[40]lIuHoIpFrBkDyaqoGtxfAJbKDeerrHvnJHqwbGqa",205,0.990385,40,208,2,206,1,2,1,3,2,108,107,99,99,85
"7464",63,"[40]lIuHoIpFrBkDyaqoGtxfAJbKDeerrHvnJHqwbGqa",204,0.990338,40,207,2,205,1,2,1,3,2,108,107,98,98,85
"7465",64,"[40]lIuHoIpFrBkDyaqoGtxfAJbKDeerrHvnJHqwbGqa",210,0.99061,40,213,2,211,1,2,1,3,2,116,115,96,96,85
"7466",65,"[40]lIuHoIpFrBkDyaqoGtxfAJbKDeerrHvnJHqwbGqa",206,0.990431,40,209,2,207,1,2,1,3,2,108,107,100,100,85
"7467",66,"[40]lIuHoIpFrBkDyaqoGtxfAJbKDeerrHvnJHqwbGqa",208,0.990521,40,211,2,209,1,2,1,3,2,112,111,98,98,85
"7468",67,"[40]lIuHoIpFrBkDyaqoGtxfAJbKDeerrHvnJHqwbGqa",198,0.99005,40,201,2,199,1,2,1,3,2,98,97,102,102,85
"7469",68,"[40]lIuHoIpFrBkDyaqoGtxfAJbKDeerrHvnJHqwbGqa",211,0.990654,40,214,2,212,1,2,1,3,2,115,114,98,98,85
"7470",69,"[40]lIuHoIpFrBkDyaqoGtxfAJbKDeerrHvnJHqwbGqa",197,0.99,40,200,2,198,1,2,1,3,2,98,97,101,101,85
"7471",70,"[40]lIuHoIpFrBkDyaqoGtxfAJbKDeerrHvnJHqwbGqa",206,0.990431,40,209,2,207,1,2,1,3,2,106,105,102,102,85
"7472",71,"[40]lIuHoIpFrBkDyaqoGtxfAJbKDeerrHvnJHqwbGqa",203,0.990291,40,206,2,204,1,2,1,3,2,105,104,100,100,85
"7473",72,"[40]lIuHoIpFrBkDyaqoGtxfAJbKDeerrHvnJHqwbGqa",200,0.990148,40,203,2,201,1,2,1,3,2,101,100,101,101,85
"7474",73,"[40]lIuHoIpFrBkDyaqoGtxfAJbKDeerrHvnJHqwbGqa",214,0.990783,40,217,2,215,1,2,1,3,2,117,116,99,99,85
"7475",74,"[40]lIuHoIpFrBkDyaqoGtxfAJbKDeerrHvnJHqwbGqa",195,0.989899,40,198,2,196,1,2,1,3,2,96,95,101,101,85
"7476",75,"[40]lIuHoIpFrBkDyaqoGtxfAJbKDeerrHvnJHqwbGqa",193,0.989796,40,196,2,194,1,2,1,3,2,92,91,103,103,85
"7477",76,"[40]lIuHoIpFrBkDyaqoGtxfAJbKDeerrHvnJHqwbGqa",182,0.989189,40,185,2,183,1,2,1,3,2,74,73,110,110,85
"7478",77,"[40]lIuHoIpFrBkDyaqoGtxfAJbKDeerrHvnJHqwbGqa",185,0.989362,40,188,2,186,1,2,1,3,2,81,80,106,106,85
"7479",78,"[40]lIuHoIpFrBkDyaqoGtxfAJbKDeerrHvnJHqwbGqa",217,0.990909,40,220,2,218,1,2,1,3,2,125,124,94,94,85
"7480",79,"[40]lIuHoIpFrBkDyaqoGtxfAJbKDeerrHvnJHqwbGqa",201,0.990196,40,204,2,202,1,2,1,3,2,102,101,101,101,85
"7481",80,"[40]lIuHoIpFrBkDyaqoGtxfAJbKDeerrHvnJHqwbGqa",212,0.990698,40,215,2,213,1,2,1,3,2,118,117,96,96,85
"7482",81,"[40]lIuHoIpFrBkDyaqoGtxfAJbKDeerrHvnJHqwbGqa",197,0.99,40,200,2,198,1,2,1,3,2,99,98,100,100,85
"7483",82,"[40]lIuHoIpFrBkDyaqoGtxfAJbKDeerrHvnJHqwbGqa",209,0.990566,40,212,2,210,1,2,1,3,2,113,112,98,98,85
"7484",83,"[40]lIuHoIpFrBkDyaqoGtxfAJbKDeerrHvnJHqwbGqa",208,0.990521,40,211,2,209,1,2,1,3,2,109,108,101,101,85
"7485",84,"[40]lIuHoIpFrBkDyaqoGtxfAJbKDeerrHvnJHqwbGqa",194,0.989848,40,197,2,195,1,2,1,3,2,94,93,102,102,85
"7486",85,"[40]lIuHoIpFrBkDyaqoGtxfAJbKDeerrHvnJHqwbGqa",225,0.991228,40,228,2,226,1,2,1,3,2,134,133,93,93,85
"7487",86,"[40]lIuHoIpFrBkDyaqoGtxfAJbKDeerrHvnJHqwbGqa",187,0.989474,40,190,2,188,1,2,1,3,2,83,82,106,106,85
"7488",87,"[40]lIuHoIpFrBkDyaqoGtxfAJbKDeerrHvnJHqwbGqa",195,0.989899,40,198,2,196,1,2,1,3,2,94,93,103,103,85
"7489",88,"[40]lIuHoIpFrBkDyaqoGtxfAJbKDeerrHvnJHqwbGqa",204,0.990338,40,207,2,205,1,2,1,3,2,105,104,101,101,85
"7490",89,"[40]lIuHoIpFrBkDyaqoGtxfAJbKDeerrHvnJHqwbGqa",197,0.99,40,200,2,198,1,2,1,3,2,95,94,104,104,85
"7491",90,"[40]lIuHoIpFrBkDyaqoGtxfAJbKDeerrHvnJHqwbGqa",207,0.990476,40,210,2,208,1,2,1,3,2,112,111,97,97,85
"7492",91,"[40]lIuHoIpFrBkDyaqoGtxfAJbKDeerrHvnJHqwbGqa",214,0.990783,40,217,2,215,1,2,1,3,2,123,122,93,93,85
"7493",92,"[40]lIuHoIpFrBkDyaqoGtxfAJbKDeerrHvnJHqwbGqa",214,0.990783,40,217,2,215,1,2,1,3,2,121,120,95,95,85
"7494",93,"[40]lIuHoIpFrBkDyaqoGtxfAJbKDeerrHvnJHqwbGqa",196,0.98995,40,199,2,197,1,2,1,3,2,95,94,103,103,85
"7495",94,"[40]lIuHoIpFrBkDyaqoGtxfAJbKDeerrHvnJHqwbGqa",203,0.990291,40,206,2,204,1,2,1,3,2,105,104,100,100,85
"7496",95,"[40]lIuHoIpFrBkDyaqoGtxfAJbKDeerrHvnJHqwbGqa",212,0.990698,40,215,2,213,1,2,1,3,2,116,115,98,98,85
"7497",96,"[40]lIuHoIpFrBkDyaqoGtxfAJbKDeerrHvnJHqwbGqa",199,0.990099,40,202,2,200,1,2,1,3,2,99,98,102,102,85
"7498",97,"[40]lIuHoIpFrBkDyaqoGtxfAJbKDeerrHvnJHqwbGqa",200,0.990148,40,203,2,201,1,2,1,3,2,101,100,101,101,85
"7499",98,"[40]lIuHoIpFrBkDyaqoGtxfAJbKDeerrHvnJHqwbGqa",192,0.989744,40,195,2,193,1,2,1,3,2,91,90,103,103,85
"7500",99,"[40]lIuHoIpFrBkDyaqoGtxfAJbKDeerrHvnJHqwbGqa",202,0.990244,40,205,2,203,1,2,1,3,2,104,103,100,100,85
"7501",0,"[40]FIwHoIxuxBkDBkdjdlcIkDbKDeeozHwnJHqwbGqa",196,0.98995,40,199,2,197,1,2,1,3,2,95,94,103,103,87
"7502",1,"[40]FIwHoIxuxBkDBkdjdlcIkDbKDeeozHwnJHqwbGqa",200,0.990148,40,203,2,201,1,2,1,3,2,100,99,102,102,87
"7503",2,"[40]FIwHoIxuxBkDBkdjdlcIkDbKDeeozHwnJHqwbGqa",197,0.99,40,200,2,198,1,2,1,3,2,97,96,102,102,87
"7504",3,"[40]FIwHoIxuxBkDBkdjdlcIkDbKDeeozHwnJHqwbGqa",198,0.99005,40,201,2,199,1,2,1,3,2,99,98,101,101,87
"7505",4,"[40]FIwHoIxuxBkDBkdjdlcIkDbKDeeozHwnJHqwbGqa",210,0.99061,40,213,2,211,1,2,1,3,2,113,112,99,99,87
"7506",5,"[40]FIwHoIxuxBkDBkdjdlcIkDbKDeeozHwnJHqwbGqa",191,0.989691,40,194,2,192,1,2,1,3,2,90,89,103,103,87
"7507",6,"[40]FIwHoIxuxBkDBkdjdlcIkDbKDeeozHwnJHqwbGqa",195,0.989899,40,198,2,196,1,2,1,3,2,93,92,104,104,87
"7508",7,"[40]FIwHoIxuxBkDBkdjdlcIkDbKDeeozHwnJHqwbGqa",201,0.990196,40,204,2,202,1,2,1,3,2,102,101,101,101,87
"7509",8,"[40]FIwHoIxuxBkDBkdjdlcIkDbKDeeozHwnJHqwbGqa",203,0.990291,40,206,2,204,1,2,1,3,2,105,104,100,100,87
"7510",9,"[40]FIwHoIxuxBkDBkdjdlcIkDbKDeeozHwnJHqwbGqa",198,0.99005,40,201,2,199,1,2,1,3,2,96,95,104,104,87
"7511",10,"[40]FIwHoIxuxBkDBkdjdlcIkDbKDeeozHwnJHqwbGqa",202,0.990244,40,205,2,203,1,2,1,3,2,105,104,99,99,87
"7512",11,"[40]FIwHoIxuxBkDBkdjdlcIkDbKDeeozHwnJHqwbGqa",191,0.989691,40,194,2,192,1,2,1,3,2,90,89,103,103,87
"7513",12,"[40]FIwHoIxuxBkDBkdjdlcIkDbKDeeozHwnJHqwbGqa",205,0.990385,40,208,2,206,1,2,1,3,2,109,108,98,98,87
"7514",13,"[40]FIwHoIxuxBkDBkdjdlcIkDbKDeeozHwnJHqwbGqa",195,0.989899,40,198,2,196,1,2,1,3,2,93,92,104,104,87
"7515",14,"[40]FIwHoIxuxBkDBkdjdlcIkDbKDeeozHwnJHqwbGqa",196,0.98995,40,199,2,197,1,2,1,3,2,95,94,103,103,87
"7516",15,"[40]FIwHoIxuxBkDBkdjdlcIkDbKDeeozHwnJHqwbGqa",190,0.989637,40,193,2,191,1,2,1,3,2,87,86,105,105,87
"7517",16,"[40]FIwHoIxuxBkDBkdjdlcIkDbKDeeozHwnJHqwbGqa",194,0.989848,40,197,2,195,1,2,1,3,2,93,92,103,103,87
"7518",17,"[40]FIwHoIxuxBkDBkdjdlcIkDbKDeeozHwnJHqwbGqa",194,0.989848,40,197,2,195,1,2,1,3,2,92,91,104,104,87
"7519",18,"[40]FIwHoIxuxBkDBkdjdlcIkDbKDeeozHwnJHqwbGqa",224,0.991189,40,227,2,225,1,2,1,3,2,133,132,93,93,87
"7520",19,"[40]FIwHoIxuxBkDBkdjdlcIkDbKDeeozHwnJHqwbGqa",208,0.990521,40,211,2,209,1,2,1,3,2,111,110,99,99,87
"7521",20,"[40]FIwHoIxuxBkDBkdjdlcIkDbKDeeozHwnJHqwbGqa",190,0.989637,40,193,2,191,1,2,1,3,2,87,86,105,105,87
"7522",21,"[40]FIwHoIxuxBkDBkdjdlcIkDbKDeeozHwnJHqwbGqa",196,0.98995,40,199,2,197,1,2,1,3,2,95,94,103,103,87
"7523",22,"[40]FIwHoIxuxBkDBkdjdlcIkDbKDeeozHwnJHqwbGqa",211,0.990654,40,214,2,212,1,2,1,3,2,115,114,98,98,87
"7524",23,"[40]FIwHoIxuxBkDBkdjdlcIkDbKDeeozHwnJHqwbGqa",200,0.990148,40,203,2,201,1,2,1,3,2,99,98,103,103,87
"7525",24,"[40]FIwHoIxuxBkDBkdjdlcIkDbKDeeozHwnJHqwbGqa",191,0.989691,40,194,2,192,1,2,1,3,2,88,87,105,105,87
"7526",25,"[40]FIwHoIxuxBkDBkdjdlcIkDbKDeeozHwnJHqwbGqa",218,0.99095,40,221,2,219,1,2,1,3,2,124,123,96,96,87
"7527",26,"[40]FIwHoIxuxBkDBkdjdlcIkDbKDeeozHwnJHqwbGqa",215,0.990826,40,218,2,216,1,2,1,3,2,123,122,94,94,87
"7528",27,"[40]FIwHoIxuxBkDBkdjdlcIkDbKDeeozHwnJHqwbGqa",209,0.990566,40,212,2,210,1,2,1,3,2,113,112,98,98,87
"7529",28,"[40]FIwHoIxuxBkDBkdjdlcIkDbKDeeozHwnJHqwbGqa",207,0.990476,40,210,2,208,1,2,1,3,2,107,106,102,102,87
"7530",29,"[40]FIwHoIxuxBkDBkdjdlcIkDbKDeeozHwnJHqwbGqa",196,0.98995,40,199,2,197,1,2,1,3,2,94,93,104,104,87
"7531",30,"[40]FIwHoIxuxBkDBkdjdlcIkDbKDeeozHwnJHqwbGqa",201,0.990196,40,204,2,202,1,2,1,3,2,102,101,101,101,87
"7532",31,"[40]FIwHoIxuxBkDBkdjdlcIkDbKDeeozHwnJHqwbGqa",200,0.990148,40,203,2,201,1,2,1,3,2,100,99,102,102,87
"7533",32,"[40]FIwHoIxuxBkDBkdjdlcIkDbKDeeozHwnJHqwbGqa",202,0.990244,40,205,2,203,1,2,1,3,2,103,102,101,101,87
"7534",33,"[40]FIwHoIxuxBkDBkdjdlcIkDbKDeeozHwnJHqwbGqa",198,0.99005,40,201,2,199,1,2,1,3,2,96,95,104,104,87
"7535",34,"[40]FIwHoIxuxBkDBkdjdlcIkDbKDeeozHwnJHqwbGqa",190,0.989637,40,193,2,191,1,2,1,3,2,89,88,103,103,87
"7536",35,"[40]FIwHoIxuxBkDBkdjdlcIkDbKDeeozHwnJHqwbGqa",194,0.989848,40,197,2,195,1,2,1,3,2,93,92,103,103,87
"7537",36,"[40]FIwHoIxuxBkDBkdjdlcIkDbKDeeozHwnJHqwbGqa",198,0.99005,40,201,2,199,1,2,1,3,2,98,97,102,102,87
"7538",37,"[40]FIwHoIxuxBkDBkdjdlcIkDbKDeeozHwnJHqwbGqa",183,0.989247,40,186,2,184,1,2,1,3,2,76,75,109,109,87
"7539",38,"[40]FIwHoIxuxBkDBkdjdlcIkDbKDeeozHwnJHqwbGqa",196,0.98995,40,199,2,197,1,2,1,3,2,98,97,100,100,87
"7540",39,"[40]FIwHoIxuxBkDBkdjdlcIkDbKDeeozHwnJHqwbGqa",205,0.990385,40,208,2,206,1,2,1,3,2,107,106,100,100,87
"7541",40,"[40]FIwHoIxuxBkDBkdjdlcIkDbKDeeozHwnJHqwbGqa",188,0.989529,40,191,2,189,1,2,1,3,2,87,86,103,103,87
"7542",41,"[40]FIwHoIxuxBkDBkdjdlcIkDbKDeeozHwnJHqwbGqa",196,0.98995,40,199,2,197,1,2,1,3,2,95,94,103,103,87
"7543",42,"[40]FIwHoIxuxBkDBkdjdlcIkDbKDeeozHwnJHqwbGqa",191,0.989691,40,194,2,192,1,2,1,3,2,87,86,106,106,87
"7544",43,"[40]FIwHoIxuxBkDBkdjdlcIkDbKDeeozHwnJHqwbGqa",206,0.990431,40,209,2,207,1,2,1,3,2,108,107,100,100,87
"7545",44,"[40]FIwHoIxuxBkDBkdjdlcIkDbKDeeozHwnJHqwbGqa",197,0.99,40,200,2,198,1,2,1,3,2,97,96,102,102,87
"7546",45,"[40]FIwHoIxuxBkDBkdjdlcIkDbKDeeozHwnJHqwbGqa",203,0.990291,40,206,2,204,1,2,1,3,2,104,103,101,101,87
"7547",46,"[40]FIwHoIxuxBkDBkdjdlcIkDbKDeeozHwnJHqwbGqa",201,0.990196,40,204,2,202,1,2,1,3,2,103,102,100,100,87
"7548",47,"[40]FIwHoIxuxBkDBkdjdlcIkDbKDeeozHwnJHqwbGqa",199,0.990099,40,202,2,200,1,2,1,3,2,98,97,103,103,87
"7549",48,"[40]FIwHoIxuxBkDBkdjdlcIkDbKDeeozHwnJHqwbGqa",208,0.990521,40,211,2,209,1,2,1,3,2,110,109,100,100,87
"7550",49,"[40]FIwHoIxuxBkDBkdjdlcIkDbKDeeozHwnJHqwbGqa",193,0.989796,40,196,2,194,1,2,1,3,2,89,88,106,106,87
"7551",50,"[40]FIwHoIxuxBkDBkdjdlcIkDbKDeeozHwnJHqwbGqa",189,0.989583,40,192,2,190,1,2,1,3,2,87,86,104,104,87
"7552",51,"[40]FIwHoIxuxBkDBkdjdlcIkDbKDeeozHwnJHqwbGqa",191,0.989691,40,194,2,192,1,2,1,3,2,91,90,102,102,87
"7553",52,"[40]FIwHoIxuxBkDBkdjdlcIkDbKDeeozHwnJHqwbGqa",201,0.990196,40,204,2,202,1,2,1,3,2,102,101,101,101,87
"7554",53,"[40]FIwHoIxuxBkDBkdjdlcIkDbKDeeozHwnJHqwbGqa",202,0.990244,40,205,2,203,1,2,1,3,2,105,104,99,99,87
"7555",54,"[40]FIwHoIxuxBkDBkdjdlcIkDbKDeeozHwnJHqwbGqa",196,0.98995,40,199,2,197,1,2,1,3,2,97,96,101,101,87
"7556",55,"[40]FIwHoIxuxBkDBkdjdlcIkDbKDeeozHwnJHqwbGqa",201,0.990196,40,204,2,202,1,2,1,3,2,102,101,101,101,87
"7557",56,"[40]FIwHoIxuxBkDBkdjdlcIkDbKDeeozHwnJHqwbGqa",204,0.990338,40,207,2,205,1,2,1,3,2,103,102,103,103,87
"7558",57,"[40]FIwHoIxuxBkDBkdjdlcIkDbKDeeozHwnJHqwbGqa",198,0.99005,40,201,2,199,1,2,1,3,2,98,97,102,102,87
"7559",58,"[40]FIwHoIxuxBkDBkdjdlcIkDbKDeeozHwnJHqwbGqa",209,0.990566,40,212,2,210,1,2,1,3,2,113,112,98,98,87
"7560",59,"[40]FIwHoIxuxBkDBkdjdlcIkDbKDeeozHwnJHqwbGqa",202,0.990244,40,205,2,203,1,2,1,3,2,104,103,100,100,87
"7561",60,"[40]FIwHoIxuxBkDBkdjdlcIkDbKDeeozHwnJHqwbGqa",216,0.990868,40,219,2,217,1,2,1,3,2,123,122,95,95,87
"7562",61,"[40]FIwHoIxuxBkDBkdjdlcIkDbKDeeozHwnJHqwbGqa",189,0.989583,40,192,2,190,1,2,1,3,2,88,87,103,103,87
"7563",62,"[40]FIwHoIxuxBkDBkdjdlcIkDbKDeeozHwnJHqwbGqa",198,0.99005,40,201,2,199,1,2,1,3,2,97,96,103,103,87
"7564",63,"[40]FIwHoIxuxBkDBkdjdlcIkDbKDeeozHwnJHqwbGqa",214,0.990783,40,217,2,215,1,2,1,3,2,120,119,96,96,87
"7565",64,"[40]FIwHoIxuxBkDBkdjdlcIkDbKDeeozHwnJHqwbGqa",204,0.990338,40,207,2,205,1,2,1,3,2,107,106,99,99,87
"7566",65,"[40]FIwHoIxuxBkDBkdjdlcIkDbKDeeozHwnJHqwbGqa",205,0.990385,40,208,2,206,1,2,1,3,2,107,106,100,100,87
"7567",66,"[40]FIwHoIxuxBkDBkdjdlcIkDbKDeeozHwnJHqwbGqa",199,0.990099,40,202,2,200,1,2,1,3,2,98,97,103,103,87
"7568",67,"[40]FIwHoIxuxBkDBkdjdlcIkDbKDeeozHwnJHqwbGqa",202,0.990244,40,205,2,203,1,2,1,3,2,104,103,100,100,87
"7569",68,"[40]FIwHoIxuxBkDBkdjdlcIkDbKDeeozHwnJHqwbGqa",195,0.989899,40,198,2,196,1,2,1,3,2,93,92,104,104,87
"7570",69,"[40]FIwHoIxuxBkDBkdjdlcIkDbKDeeozHwnJHqwbGqa",192,0.989744,40,195,2,193,1,2,1,3,2,91,90,103,103,87
"7571",70,"[40]FIwHoIxuxBkDBkdjdlcIkDbKDeeozHwnJHqwbGqa",198,0.99005,40,201,2,199,1,2,1,3,2,99,98,101,101,87
"7572",71,"[40]FIwHoIxuxBkDBkdjdlcIkDbKDeeozHwnJHqwbGqa",203,0.990291,40,206,2,204,1,2,1,3,2,105,104,100,100,87
"7573",72,"[40]FIwHoIxuxBkDBkdjdlcIkDbKDeeozHwnJHqwbGqa",194,0.989848,40,197,2,195,1,2,1,3,2,94,93,102,102,87
"7574",73,"[40]FIwHoIxuxBkDBkdjdlcIkDbKDeeozHwnJHqwbGqa",200,0.990148,40,203,2,201,1,2,1,3,2,98,97,104,104,87
"7575",74,"[40]FIwHoIxuxBkDBkdjdlcIkDbKDeeozHwnJHqwbGqa",211,0.990654,40,214,2,212,1,2,1,3,2,116,115,97,97,87
"7576",75,"[40]FIwHoIxuxBkDBkdjdlcIkDbKDeeozHwnJHqwbGqa",200,0.990148,40,203,2,201,1,2,1,3,2,101,100,101,101,87
"7577",76,"[40]FIwHoIxuxBkDBkdjdlcIkDbKDeeozHwnJHqwbGqa",210,0.99061,40,213,2,211,1,2,1,3,2,115,114,97,97,87
"7578",77,"[40]FIwHoIxuxBkDBkdjdlcIkDbKDeeozHwnJHqwbGqa",204,0.990338,40,207,2,205,1,2,1,3,2,105,104,101,101,87
"7579",78,"[40]FIwHoIxuxBkDBkdjdlcIkDbKDeeozHwnJHqwbGqa",193,0.989796,40,196,2,194,1,2,1,3,2,90,89,105,105,87
"7580",79,"[40]FIwHoIxuxBkDBkdjdlcIkDbKDeeozHwnJHqwbGqa",208,0.990521,40,211,2,209,1,2,1,3,2,111,110,99,99,87
"7581",80,"[40]FIwHoIxuxBkDBkdjdlcIkDbKDeeozHwnJHqwbGqa",196,0.98995,40,199,2,197,1,2,1,3,2,95,94,103,103,87
"7582",81,"[40]FIwHoIxuxBkDBkdjdlcIkDbKDeeozHwnJHqwbGqa",194,0.989848,40,197,2,195,1,2,1,3,2,92,91,104,104,87
"7583",82,"[40]FIwHoIxuxBkDBkdjdlcIkDbKDeeozHwnJHqwbGqa",196,0.98995,40,199,2,197,1,2,1,3,2,95,94,103,103,87
"7584",83,"[40]FIwHoIxuxBkDBkdjdlcIkDbKDeeozHwnJHqwbGqa",203,0.990291,40,206,2,204,1,2,1,3,2,107,106,98,98,87
"7585",84,"[40]FIwHoIxuxBkDBkdjdlcIkDbKDeeozHwnJHqwbGqa",193,0.989796,40,196,2,194,1,2,1,3,2,90,89,105,105,87
"7586",85,"[40]FIwHoIxuxBkDBkdjdlcIkDbKDeeozHwnJHqwbGqa",204,0.990338,40,207,2,205,1,2,1,3,2,105,104,101,101,87
"7587",86,"[40]FIwHoIxuxBkDBkdjdlcIkDbKDeeozHwnJHqwbGqa",202,0.990244,40,205,2,203,1,2,1,3,2,104,103,100,100,87
"7588",87,"[40]FIwHoIxuxBkDBkdjdlcIkDbKDeeozHwnJHqwbGqa",194,0.989848,40,197,2,195,1,2,1,3,2,93,92,103,103,87
"7589",88,"[40]FIwHoIxuxBkDBkdjdlcIkDbKDeeozHwnJHqwbGqa",207,0.990476,40,210,2,208,1,2,1,3,2,107,106,102,102,87
"7590",89,"[40]FIwHoIxuxBkDBkdjdlcIkDbKDeeozHwnJHqwbGqa",201,0.990196,40,204,2,202,1,2,1,3,2,101,100,102,102,87
"7591",90,"[40]FIwHoIxuxBkDBkdjdlcIkDbKDeeozHwnJHqwbGqa",207,0.990476,40,210,2,208,1,2,1,3,2,111,110,98,98,87
"7592",91,"[40]FIwHoIxuxBkDBkdjdlcIkDbKDeeozHwnJHqwbGqa",200,0.990148,40,203,2,201,1,2,1,3,2,99,98,103,103,87
"7593",92,"[40]FIwHoIxuxBkDBkdjdlcIkDbKDeeozHwnJHqwbGqa",202,0.990244,40,205,2,203,1,2,1,3,2,104,103,100,100,87
"7594",93,"[40]FIwHoIxuxBkDBkdjdlcIkDbKDeeozHwnJHqwbGqa",183,0.989247,40,186,2,184,1,2,1,3,2,78,77,107,107,87
"7595",94,"[40]FIwHoIxuxBkDBkdjdlcIkDbKDeeozHwnJHqwbGqa",191,0.989691,40,194,2,192,1,2,1,3,2,88,87,105,105,87
"7596",95,"[40]FIwHoIxuxBkDBkdjdlcIkDbKDeeozHwnJHqwbGqa",206,0.990431,40,209,2,207,1,2,1,3,2,108,107,100,100,87
"7597",96,"[40]FIwHoIxuxBkDBkdjdlcIkDbKDeeozHwnJHqwbGqa",201,0.990196,40,204,2,202,1,2,1,3,2,99,98,104,104,87
"7598",97,"[40]FIwHoIxuxBkDBkdjdlcIkDbKDeeozHwnJHqwbGqa",206,0.990431,40,209,2,207,1,2,1,3,2,109,108,99,99,87
"7599",98,"[40]FIwHoIxuxBkDBkdjdlcIkDbKDeeozHwnJHqwbGqa",195,0.989899,40,198,2,196,1,2,1,3,2,94,93,103,103,87
"7600",99,"[40]FIwHoIxuxBkDBkdjdlcIkDbKDeeozHwnJHqwbGqa",192,0.989744,40,195,2,193,1,2,1,3,2,91,90,103,103,87
"7601",0,"[40]sIdHoIpwaBkxyDlztzxnpxbKDaenfHwnJHqvbGqa",197,0.99,40,200,2,198,1,2,1,3,2,97,96,102,102,88
"7602",1,"[40]sIdHoIpwaBkxyDlztzxnpxbKDaenfHwnJHqvbGqa",199,0.990099,40,202,2,200,1,2,1,3,2,99,98,102,102,88
"7603",2,"[40]sIdHoIpwaBkxyDlztzxnpxbKDaenfHwnJHqvbGqa",202,0.990244,40,205,2,203,1,2,1,3,2,105,104,99,99,88
"7604",3,"[40]sIdHoIpwaBkxyDlztzxnpxbKDaenfHwnJHqvbGqa",209,0.990566,40,212,2,210,1,2,1,3,2,111,110,100,100,88
"7605",4,"[40]sIdHoIpwaBkxyDlztzxnpxbKDaenfHwnJHqvbGqa",206,0.990431,40,209,2,207,1,2,1,3,2,109,108,99,99,88
"7606",5,"[40]sIdHoIpwaBkxyDlztzxnpxbKDaenfHwnJHqvbGqa",210,0.99061,40,213,2,211,1,2,1,3,2,115,114,97,97,88
"7607",6,"[40]sIdHoIpwaBkxyDlztzxnpxbKDaenfHwnJHqvbGqa",198,0.99005,40,201,2,199,1,2,1,3,2,97,96,103,103,88
"7608",7,"[40]sIdHoIpwaBkxyDlztzxnpxbKDaenfHwnJHqvbGqa",210,0.99061,40,213,2,211,1,2,1,3,2,115,114,97,97,88
"7609",8,"[40]sIdHoIpwaBkxyDlztzxnpxbKDaenfHwnJHqvbGqa",193,0.989796,40,196,2,194,1,2,1,3,2,93,92,102,102,88
"7610",9,"[40]sIdHoIpwaBkxyDlztzxnpxbKDaenfHwnJHqvbGqa",205,0.990385,40,208,2,206,1,2,1,3,2,106,105,101,101,88
"7611",10,"[40]sIdHoIpwaBkxyDlztzxnpxbKDaenfHwnJHqvbGqa",205,0.990385,40,208,2,206,1,2,1,3,2,108,107,99,99,88
"7612",11,"[40]sIdHoIpwaBkxyDlztzxnpxbKDaenfHwnJHqvbGqa",191,0.989691,40,194,2,192,1,2,1,3,2,90,89,103,103,88
"7613",12,"[40]sIdHoIpwaBkxyDlztzxnpxbKDaenfHwnJHqvbGqa",212,0.990698,40,215,2,213,1,2,1,3,2,117,116,97,97,88
"7614",13,"[40]sIdHoIpwaBkxyDlztzxnpxbKDaenfHwnJHqvbGqa",211,0.990654,40,214,2,212,1,2,1,3,2,117,116,96,96,88
"7615",14,"[40]sIdHoIpwaBkxyDlztzxnpxbKDaenfHwnJHqvbGqa",184,0.989305,40,187,2,185,1,2,1,3,2,77,76,109,109,88
"7616",15,"[40]sIdHoIpwaBkxyDlztzxnpxbKDaenfHwnJHqvbGqa",196,0.98995,40,199,2,197,1,2,1,3,2,96,95,102,102,88
"7617",16,"[40]sIdHoIpwaBkxyDlztzxnpxbKDaenfHwnJHqvbGqa",202,0.990244,40,205,2,203,1,2,1,3,2,102,101,102,102,88
"7618",17,"[40]sIdHoIpwaBkxyDlztzxnpxbKDaenfHwnJHqvbGqa",200,0.990148,40,203,2,201,1,2,1,3,2,102,101,100,100,88
"7619",18,"[40]sIdHoIpwaBkxyDlztzxnpxbKDaenfHwnJHqvbGqa",194,0.989848,40,197,2,195,1,2,1,3,2,94,93,102,102,88
"7620",19,"[40]sIdHoIpwaBkxyDlztzxnpxbKDaenfHwnJHqvbGqa",189,0.989583,40,192,2,190,1,2,1,3,2,86,85,105,105,88
"7621",20,"[40]sIdHoIpwaBkxyDlztzxnpxbKDaenfHwnJHqvbGqa",201,0.990196,40,204,2,202,1,2,1,3,2,101,100,102,102,88
"7622",21,"[40]sIdHoIpwaBkxyDlztzxnpxbKDaenfHwnJHqvbGqa",208,0.990521,40,211,2,209,1,2,1,3,2,114,113,96,96,88
"7623",22,"[40]sIdHoIpwaBkxyDlztzxnpxbKDaenfHwnJHqvbGqa",210,0.99061,40,213,2,211,1,2,1,3,2,115,114,97,97,88
"7624",23,"[40]sIdHoIpwaBkxyDlztzxnpxbKDaenfHwnJHqvbGqa",204,0.990338,40,207,2,205,1,2,1,3,2,109,108,97,97,88
"7625",24,"[40]sIdHoIpwaBkxyDlztzxnpxbKDaenfHwnJHqvbGqa",214,0.990783,40,217,2,215,1,2,1,3,2,121,120,95,95,88
"7626",25,"[40]sIdHoIpwaBkxyDlztzxnpxbKDaenfHwnJHqvbGqa",217,0.990909,40,220,2,218,1,2,1,3,2,123,122,96,96,88
"7627",26,"[40]sIdHoIpwaBkxyDlztzxnpxbKDaenfHwnJHqvbGqa",209,0.990566,40,212,2,210,1,2,1,3,2,113,112,98,98,88
"7628",27,"[40]sIdHoIpwaBkxyDlztzxnpxbKDaenfHwnJHqvbGqa",200,0.990148,40,203,2,201,1,2,1,3,2,99,98,103,103,88
"7629",28,"[40]sIdHoIpwaBkxyDlztzxnpxbKDaenfHwnJHqvbGqa",218,0.99095,40,221,2,219,1,2,1,3,2,125,124,95,95,88
"7630",29,"[40]sIdHoIpwaBkxyDlztzxnpxbKDaenfHwnJHqvbGqa",203,0.990291,40,206,2,204,1,2,1,3,2,106,105,99,99,88
"7631",30,"[40]sIdHoIpwaBkxyDlztzxnpxbKDaenfHwnJHqvbGqa",199,0.990099,40,202,2,200,1,2,1,3,2,99,98,102,102,88
"7632",31,"[40]sIdHoIpwaBkxyDlztzxnpxbKDaenfHwnJHqvbGqa",192,0.989744,40,195,2,193,1,2,1,3,2,88,87,106,106,88
"7633",32,"[40]sIdHoIpwaBkxyDlztzxnpxbKDaenfHwnJHqvbGqa",206,0.990431,40,209,2,207,1,2,1,3,2,108,107,100,100,88
"7634",33,"[40]sIdHoIpwaBkxyDlztzxnpxbKDaenfHwnJHqvbGqa",201,0.990196,40,204,2,202,1,2,1,3,2,102,101,101,101,88
"7635",34,"[40]sIdHoIpwaBkxyDlztzxnpxbKDaenfHwnJHqvbGqa",186,0.989418,40,189,2,187,1,2,1,3,2,82,81,106,106,88
"7636",35,"[40]sIdHoIpwaBkxyDlztzxnpxbKDaenfHwnJHqvbGqa",193,0.989796,40,196,2,194,1,2,1,3,2,91,90,104,104,88
"7637",36,"[40]sIdHoIpwaBkxyDlztzxnpxbKDaenfHwnJHqvbGqa",192,0.989744,40,195,2,193,1,2,1,3,2,90,89,104,104,88
"7638",37,"[40]sIdHoIpwaBkxyDlztzxnpxbKDaenfHwnJHqvbGqa",208,0.990521,40,211,2,209,1,2,1,3,2,111,110,99,99,88
"7639",38,"[40]sIdHoIpwaBkxyDlztzxnpxbKDaenfHwnJHqvbGqa",184,0.989305,40,187,2,185,1,2,1,3,2,80,79,106,106,88
"7640",39,"[40]sIdHoIpwaBkxyDlztzxnpxbKDaenfHwnJHqvbGqa",215,0.990826,40,218,2,216,1,2,1,3,2,119,118,98,98,88
"7641",40,"[40]sIdHoIpwaBkxyDlztzxnpxbKDaenfHwnJHqvbGqa",196,0.98995,40,199,2,197,1,2,1,3,2,94,93,104,104,88
"7642",41,"[40]sIdHoIpwaBkxyDlztzxnpxbKDaenfHwnJHqvbGqa",203,0.990291,40,206,2,204,1,2,1,3,2,106,105,99,99,88
"7643",42,"[40]sIdHoIpwaBkxyDlztzxnpxbKDaenfHwnJHqvbGqa",197,0.99,40,200,2,198,1,2,1,3,2,97,96,102,102,88
"7644",43,"[40]sIdHoIpwaBkxyDlztzxnpxbKDaenfHwnJHqvbGqa",195,0.989899,40,198,2,196,1,2,1,3,2,94,93,103,103,88
"7645",44,"[40]sIdHoIpwaBkxyDlztzxnpxbKDaenfHwnJHqvbGqa",199,0.990099,40,202,2,200,1,2,1,3,2,101,100,100,100,88
"7646",45,"[40]sIdHoIpwaBkxyDlztzxnpxbKDaenfHwnJHqvbGqa",204,0.990338,40,207,2,205,1,2,1,3,2,106,105,100,100,88
"7647",46,"[40]sIdHoIpwaBkxyDlztzxnpxbKDaenfHwnJHqvbGqa",193,0.989796,40,196,2,194,1,2,1,3,2,91,90,104,104,88
"7648",47,"[40]sIdHoIpwaBkxyDlztzxnpxbKDaenfHwnJHqvbGqa",200,0.990148,40,203,2,201,1,2,1,3,2,103,102,99,99,88
"7649",48,"[40]sIdHoIpwaBkxyDlztzxnpxbKDaenfHwnJHqvbGqa",202,0.990244,40,205,2,203,1,2,1,3,2,103,102,101,101,88
"7650",49,"[40]sIdHoIpwaBkxyDlztzxnpxbKDaenfHwnJHqvbGqa",206,0.990431,40,209,2,207,1,2,1,3,2,109,108,99,99,88
"7651",50,"[40]sIdHoIpwaBkxyDlztzxnpxbKDaenfHwnJHqvbGqa",211,0.990654,40,214,2,212,1,2,1,3,2,114,113,99,99,88
"7652",51,"[40]sIdHoIpwaBkxyDlztzxnpxbKDaenfHwnJHqvbGqa",208,0.990521,40,211,2,209,1,2,1,3,2,112,111,98,98,88
"7653",52,"[40]sIdHoIpwaBkxyDlztzxnpxbKDaenfHwnJHqvbGqa",221,0.991071,40,224,2,222,1,2,1,3,2,130,129,93,93,88
"7654",53,"[40]sIdHoIpwaBkxyDlztzxnpxbKDaenfHwnJHqvbGqa",202,0.990244,40,205,2,203,1,2,1,3,2,103,102,101,101,88
"7655",54,"[40]sIdHoIpwaBkxyDlztzxnpxbKDaenfHwnJHqvbGqa",192,0.989744,40,195,2,193,1,2,1,3,2,91,90,103,103,88
"7656",55,"[40]sIdHoIpwaBkxyDlztzxnpxbKDaenfHwnJHqvbGqa",216,0.990868,40,219,2,217,1,2,1,3,2,123,122,95,95,88
"7657",56,"[40]sIdHoIpwaBkxyDlztzxnpxbKDaenfHwnJHqvbGqa",205,0.990385,40,208,2,206,1,2,1,3,2,107,106,100,100,88
"7658",57,"[40]sIdHoIpwaBkxyDlztzxnpxbKDaenfHwnJHqvbGqa",183,0.989247,40,186,2,184,1,2,1,3,2,78,77,107,107,88
"7659",58,"[40]sIdHoIpwaBkxyDlztzxnpxbKDaenfHwnJHqvbGqa",198,0.99005,40,201,2,199,1,2,1,3,2,99,98,101,101,88
"7660",59,"[40]sIdHoIpwaBkxyDlztzxnpxbKDaenfHwnJHqvbGqa",204,0.990338,40,207,2,205,1,2,1,3,2,104,103,102,102,88
"7661",60,"[40]sIdHoIpwaBkxyDlztzxnpxbKDaenfHwnJHqvbGqa",205,0.990385,40,208,2,206,1,2,1,3,2,105,104,102,102,88
"7662",61,"[40]sIdHoIpwaBkxyDlztzxnpxbKDaenfHwnJHqvbGqa",184,0.989305,40,187,2,185,1,2,1,3,2,79,78,107,107,88
"7663",62,"[40]sIdHoIpwaBkxyDlztzxnpxbKDaenfHwnJHqvbGqa",210,0.99061,40,213,2,211,1,2,1,3,2,115,114,97,97,88
"7664",63,"[40]sIdHoIpwaBkxyDlztzxnpxbKDaenfHwnJHqvbGqa",208,0.990521,40,211,2,209,1,2,1,3,2,111,110,99,99,88
"7665",64,"[40]sIdHoIpwaBkxyDlztzxnpxbKDaenfHwnJHqvbGqa",202,0.990244,40,205,2,203,1,2,1,3,2,103,102,101,101,88
"7666",65,"[40]sIdHoIpwaBkxyDlztzxnpxbKDaenfHwnJHqvbGqa",211,0.990654,40,214,2,212,1,2,1,3,2,116,115,97,97,88
"7667",66,"[40]sIdHoIpwaBkxyDlztzxnpxbKDaenfHwnJHqvbGqa",196,0.98995,40,199,2,197,1,2,1,3,2,97,96,101,101,88
"7668",67,"[40]sIdHoIpwaBkxyDlztzxnpxbKDaenfHwnJHqvbGqa",189,0.989583,40,192,2,190,1,2,1,3,2,86,85,105,105,88
"7669",68,"[40]sIdHoIpwaBkxyDlztzxnpxbKDaenfHwnJHqvbGqa",205,0.990385,40,208,2,206,1,2,1,3,2,111,110,96,96,88
"7670",69,"[40]sIdHoIpwaBkxyDlztzxnpxbKDaenfHwnJHqvbGqa",209,0.990566,40,212,2,210,1,2,1,3,2,114,113,97,97,88
"7671",70,"[40]sIdHoIpwaBkxyDlztzxnpxbKDaenfHwnJHqvbGqa",211,0.990654,40,214,2,212,1,2,1,3,2,116,115,97,97,88
"7672",71,"[40]sIdHoIpwaBkxyDlztzxnpxbKDaenfHwnJHqvbGqa",203,0.990291,40,206,2,204,1,2,1,3,2,104,103,101,101,88
"7673",72,"[40]sIdHoIpwaBkxyDlztzxnpxbKDaenfHwnJHqvbGqa",190,0.989637,40,193,2,191,1,2,1,3,2,86,85,106,106,88
"7674",73,"[40]sIdHoIpwaBkxyDlztzxnpxbKDaenfHwnJHqvbGqa",196,0.98995,40,199,2,197,1,2,1,3,2,96,95,102,102,88
"7675",74,"[40]sIdHoIpwaBkxyDlztzxnpxbKDaenfHwnJHqvbGqa",209,0.990566,40,212,2,210,1,2,1,3,2,113,112,98,98,88
"7676",75,"[40]sIdHoIpwaBkxyDlztzxnpxbKDaenfHwnJHqvbGqa",210,0.99061,40,213,2,211,1,2,1,3,2,117,116,95,95,88
"7677",76,"[40]sIdHoIpwaBkxyDlztzxnpxbKDaenfHwnJHqvbGqa",190,0.989637,40,193,2,191,1,2,1,3,2,88,87,104,104,88
"7678",77,"[40]sIdHoIpwaBkxyDlztzxnpxbKDaenfHwnJHqvbGqa",208,0.990521,40,211,2,209,1,2,1,3,2,114,113,96,96,88
"7679",78,"[40]sIdHoIpwaBkxyDlztzxnpxbKDaenfHwnJHqvbGqa",207,0.990476,40,210,2,208,1,2,1,3,2,110,109,99,99,88
"7680",79,"[40]sIdHoIpwaBkxyDlztzxnpxbKDaenfHwnJHqvbGqa",197,0.99,40,200,2,198,1,2,1,3,2,97,96,102,102,88
"7681",80,"[40]sIdHoIpwaBkxyDlztzxnpxbKDaenfHwnJHqvbGqa",209,0.990566,40,212,2,210,1,2,1,3,2,114,113,97,97,88
"7682",81,"[40]sIdHoIpwaBkxyDlztzxnpxbKDaenfHwnJHqvbGqa",189,0.989583,40,192,2,190,1,2,1,3,2,83,82,108,108,88
"7683",82,"[40]sIdHoIpwaBkxyDlztzxnpxbKDaenfHwnJHqvbGqa",199,0.990099,40,202,2,200,1,2,1,3,2,100,99,101,101,88
"7684",83,"[40]sIdHoIpwaBkxyDlztzxnpxbKDaenfHwnJHqvbGqa",191,0.989691,40,194,2,192,1,2,1,3,2,88,87,105,105,88
"7685",84,"[40]sIdHoIpwaBkxyDlztzxnpxbKDaenfHwnJHqvbGqa",208,0.990521,40,211,2,209,1,2,1,3,2,113,112,97,97,88
"7686",85,"[40]sIdHoIpwaBkxyDlztzxnpxbKDaenfHwnJHqvbGqa",189,0.989583,40,192,2,190,1,2,1,3,2,84,83,107,107,88
"7687",86,"[40]sIdHoIpwaBkxyDlztzxnpxbKDaenfHwnJHqvbGqa",202,0.990244,40,205,2,203,1,2,1,3,2,105,104,99,99,88
"7688",87,"[40]sIdHoIpwaBkxyDlztzxnpxbKDaenfHwnJHqvbGqa",201,0.990196,40,204,2,202,1,2,1,3,2,105,104,98,98,88
"7689",88,"[40]sIdHoIpwaBkxyDlztzxnpxbKDaenfHwnJHqvbGqa",197,0.99,40,200,2,198,1,2,1,3,2,98,97,101,101,88
"7690",89,"[40]sIdHoIpwaBkxyDlztzxnpxbKDaenfHwnJHqvbGqa",210,0.99061,40,213,2,211,1,2,1,3,2,112,111,100,100,88
"7691",90,"[40]sIdHoIpwaBkxyDlztzxnpxbKDaenfHwnJHqvbGqa",197,0.99,40,200,2,198,1,2,1,3,2,96,95,103,103,88
"7692",91,"[40]sIdHoIpwaBkxyDlztzxnpxbKDaenfHwnJHqvbGqa",211,0.990654,40,214,2,212,1,2,1,3,2,120,119,93,93,88
"7693",92,"[40]sIdHoIpwaBkxyDlztzxnpxbKDaenfHwnJHqvbGqa",207,0.990476,40,210,2,208,1,2,1,3,2,107,106,102,102,88
"7694",93,"[40]sIdHoIpwaBkxyDlztzxnpxbKDaenfHwnJHqvbGqa",214,0.990783,40,217,2,215,1,2,1,3,2,117,116,99,99,88
"7695",94,"[40]sIdHoIpwaBkxyDlztzxnpxbKDaenfHwnJHqvbGqa",199,0.990099,40,202,2,200,1,2,1,3,2,100,99,101,101,88
"7696",95,"[40]sIdHoIpwaBkxyDlztzxnpxbKDaenfHwnJHqvbGqa",191,0.989691,40,194,2,192,1,2,1,3,2,88,87,105,105,88
"7697",96,"[40]sIdHoIpwaBkxyDlztzxnpxbKDaenfHwnJHqvbGqa",209,0.990566,40,212,2,210,1,2,1,3,2,112,111,99,99,88
"7698",97,"[40]sIdHoIpwaBkxyDlztzxnpxbKDaenfHwnJHqvbGqa",212,0.990698,40,215,2,213,1,2,1,3,2,119,118,95,95,88
"7699",98,"[40]sIdHoIpwaBkxyDlztzxnpxbKDaenfHwnJHqvbGqa",183,0.989247,40,186,2,184,1,2,1,3,2,78,77,107,107,88
"7700",99,"[40]sIdHoIpwaBkxyDlztzxnpxbKDaenfHwnJHqvbGqa",200,0.990148,40,203,2,201,1,2,1,3,2,102,101,100,100,88
"7701",0,"[40]FIlHoIyasBkDntzabxwvDmbKDaenmHvnJHqvbGqa",206,0.990431,40,209,2,207,1,2,1,3,2,109,108,99,99,89
"7702",1,"[40]FIlHoIyasBkDntzabxwvDmbKDaenmHvnJHqvbGqa",195,0.989899,40,198,2,196,1,2,1,3,2,92,91,105,105,89
"7703",2,"[40]FIlHoIyasBkDntzabxwvDmbKDaenmHvnJHqvbGqa",200,0.990148,40,203,2,201,1,2,1,3,2,101,100,101,101,89
"7704",3,"[40]FIlHoIyasBkDntzabxwvDmbKDaenmHvnJHqvbGqa",204,0.990338,40,207,2,205,1,2,1,3,2,105,104,101,101,89
"7705",4,"[40]FIlHoIyasBkDntzabxwvDmbKDaenmHvnJHqvbGqa",201,0.990196,40,204,2,202,1,2,1,3,2,104,103,99,99,89
"7706",5,"[40]FIlHoIyasBkDntzabxwvDmbKDaenmHvnJHqvbGqa",206,0.990431,40,209,2,207,1,2,1,3,2,110,109,98,98,89
"7707",6,"[40]FIlHoIyasBkDntzabxwvDmbKDaenmHvnJHqvbGqa",185,0.989362,40,188,2,186,1,2,1,3,2,82,81,105,105,89
"7708",7,"[40]FIlHoIyasBkDntzabxwvDmbKDaenmHvnJHqvbGqa",211,0.990654,40,214,2,212,1,2,1,3,2,116,115,97,97,89
"7709",8,"[40]FIlHoIyasBkDntzabxwvDmbKDaenmHvnJHqvbGqa",204,0.990338,40,207,2,205,1,2,1,3,2,108,107,98,98,89
"7710",9,"[40]FIlHoIyasBkDntzabxwvDmbKDaenmHvnJHqvbGqa",210,0.99061,40,213,2,211,1,2,1,3,2,116,115,96,96,89
"7711",10,"[40]FIlHoIyasBkDntzabxwvDmbKDaenmHvnJHqvbGqa",197,0.99,40,200,2,198,1,2,1,3,2,99,98,100,100,89
"7712",11,"[40]FIlHoIyasBkDntzabxwvDmbKDaenmHvnJHqvbGqa",205,0.990385,40,208,2,206,1,2,1,3,2,109,108,98,98,89
"7713",12,"[40]FIlHoIyasBkDntzabxwvDmbKDaenmHvnJHqvbGqa",192,0.989744,40,195,2,193,1,2,1,3,2,88,87,106,106,89
"7714",13,"[40]FIlHoIyasBkDntzabxwvDmbKDaenmHvnJHqvbGqa",199,0.990099,40,202,2,200,1,2,1,3,2,100,99,101,101,89
"7715",14,"[40]FIlHoIyasBkDntzabxwvDmbKDaenmHvnJHqvbGqa",185,0.989362,40,188,2,186,1,2,1,3,2,78,77,109,109,89
"7716",15,"[40]FIlHoIyasBkDntzabxwvDmbKDaenmHvnJHqvbGqa",212,0.990698,40,215,2,213,1,2,1,3,2,116,115,98,98,89
"7717",16,"[40]FIlHoIyasBkDntzabxwvDmbKDaenmHvnJHqvbGqa",218,0.99095,40,221,2,219,1,2,1,3,2,125,124,95,95,89
"7718",17,"[40]FIlHoIyasBkDntzabxwvDmbKDaenmHvnJHqvbGqa",210,0.99061,40,213,2,211,1,2,1,3,2,113,112,99,99,89
"7719",18,"[40]FIlHoIyasBkDntzabxwvDmbKDaenmHvnJHqvbGqa",202,0.990244,40,205,2,203,1,2,1,3,2,102,101,102,102,89
"7720",19,"[40]FIlHoIyasBkDntzabxwvDmbKDaenmHvnJHqvbGqa",198,0.99005,40,201,2,199,1,2,1,3,2,100,99,100,100,89
"7721",20,"[40]FIlHoIyasBkDntzabxwvDmbKDaenmHvnJHqvbGqa",200,0.990148,40,203,2,201,1,2,1,3,2,103,102,99,99,89
"7722",21,"[40]FIlHoIyasBkDntzabxwvDmbKDaenmHvnJHqvbGqa",223,0.99115,40,226,2,224,1,2,1,3,2,132,131,93,93,89
"7723",22,"[40]FIlHoIyasBkDntzabxwvDmbKDaenmHvnJHqvbGqa",201,0.990196,40,204,2,202,1,2,1,3,2,103,102,100,100,89
"7724",23,"[40]FIlHoIyasBkDntzabxwvDmbKDaenmHvnJHqvbGqa",209,0.990566,40,212,2,210,1,2,1,3,2,110,109,101,101,89
"7725",24,"[40]FIlHoIyasBkDntzabxwvDmbKDaenmHvnJHqvbGqa",197,0.99,40,200,2,198,1,2,1,3,2,97,96,102,102,89
"7726",25,"[40]FIlHoIyasBkDntzabxwvDmbKDaenmHvnJHqvbGqa",197,0.99,40,200,2,198,1,2,1,3,2,97,96,102,102,89
"7727",26,"[40]FIlHoIyasBkDntzabxwvDmbKDaenmHvnJHqvbGqa",199,0.990099,40,202,2,200,1,2,1,3,2,100,99,101,101,89
"7728",27,"[40]FIlHoIyasBkDntzabxwvDmbKDaenmHvnJHqvbGqa",208,0.990521,40,211,2,209,1,2,1,3,2,112,111,98,98,89
"7729",28,"[40]FIlHoIyasBkDntzabxwvDmbKDaenmHvnJHqvbGqa",211,0.990654,40,214,2,212,1,2,1,3,2,116,115,97,97,89
"7730",29,"[40]FIlHoIyasBkDntzabxwvDmbKDaenmHvnJHqvbGqa",208,0.990521,40,211,2,209,1,2,1,3,2,113,112,97,97,89
"7731",30,"[40]FIlHoIyasBkDntzabxwvDmbKDaenmHvnJHqvbGqa",195,0.989899,40,198,2,196,1,2,1,3,2,95,94,102,102,89
"7732",31,"[40]FIlHoIyasBkDntzabxwvDmbKDaenmHvnJHqvbGqa",196,0.98995,40,199,2,197,1,2,1,3,2,97,96,101,101,89
"7733",32,"[40]FIlHoIyasBkDntzabxwvDmbKDaenmHvnJHqvbGqa",213,0.990741,40,216,2,214,1,2,1,3,2,119,118,96,96,89
"7734",33,"[40]FIlHoIyasBkDntzabxwvDmbKDaenmHvnJHqvbGqa",197,0.99,40,200,2,198,1,2,1,3,2,95,94,104,104,89
"7735",34,"[40]FIlHoIyasBkDntzabxwvDmbKDaenmHvnJHqvbGqa",199,0.990099,40,202,2,200,1,2,1,3,2,101,100,100,100,89
"7736",35,"[40]FIlHoIyasBkDntzabxwvDmbKDaenmHvnJHqvbGqa",207,0.990476,40,210,2,208,1,2,1,3,2,110,109,99,99,89
"7737",36,"[40]FIlHoIyasBkDntzabxwvDmbKDaenmHvnJHqvbGqa",209,0.990566,40,212,2,210,1,2,1,3,2,111,110,100,100,89
"7738",37,"[40]FIlHoIyasBkDntzabxwvDmbKDaenmHvnJHqvbGqa",194,0.989848,40,197,2,195,1,2,1,3,2,93,92,103,103,89
"7739",38,"[40]FIlHoIyasBkDntzabxwvDmbKDaenmHvnJHqvbGqa",196,0.98995,40,199,2,197,1,2,1,3,2,94,93,104,104,89
"7740",39,"[40]FIlHoIyasBkDntzabxwvDmbKDaenmHvnJHqvbGqa",202,0.990244,40,205,2,203,1,2,1,3,2,106,105,98,98,89
"7741",40,"[40]FIlHoIyasBkDntzabxwvDmbKDaenmHvnJHqvbGqa",205,0.990385,40,208,2,206,1,2,1,3,2,108,107,99,99,89
"7742",41,"[40]FIlHoIyasBkDntzabxwvDmbKDaenmHvnJHqvbGqa",202,0.990244,40,205,2,203,1,2,1,3,2,101,100,103,103,89
"7743",42,"[40]FIlHoIyasBkDntzabxwvDmbKDaenmHvnJHqvbGqa",202,0.990244,40,205,2,203,1,2,1,3,2,105,104,99,99,89
"7744",43,"[40]FIlHoIyasBkDntzabxwvDmbKDaenmHvnJHqvbGqa",191,0.989691,40,194,2,192,1,2,1,3,2,88,87,105,105,89
"7745",44,"[40]FIlHoIyasBkDntzabxwvDmbKDaenmHvnJHqvbGqa",201,0.990196,40,204,2,202,1,2,1,3,2,104,103,99,99,89
"7746",45,"[40]FIlHoIyasBkDntzabxwvDmbKDaenmHvnJHqvbGqa",194,0.989848,40,197,2,195,1,2,1,3,2,92,91,104,104,89
"7747",46,"[40]FIlHoIyasBkDntzabxwvDmbKDaenmHvnJHqvbGqa",196,0.98995,40,199,2,197,1,2,1,3,2,94,93,104,104,89
"7748",47,"[40]FIlHoIyasBkDntzabxwvDmbKDaenmHvnJHqvbGqa",190,0.989637,40,193,2,191,1,2,1,3,2,86,85,106,106,89
"7749",48,"[40]FIlHoIyasBkDntzabxwvDmbKDaenmHvnJHqvbGqa",202,0.990244,40,205,2,203,1,2,1,3,2,104,103,100,100,89
"7750",49,"[40]FIlHoIyasBkDntzabxwvDmbKDaenmHvnJHqvbGqa",208,0.990521,40,211,2,209,1,2,1,3,2,113,112,97,97,89
"7751",50,"[40]FIlHoIyasBkDntzabxwvDmbKDaenmHvnJHqvbGqa",209,0.990566,40,212,2,210,1,2,1,3,2,116,115,95,95,89
"7752",51,"[40]FIlHoIyasBkDntzabxwvDmbKDaenmHvnJHqvbGqa",198,0.99005,40,201,2,199,1,2,1,3,2,98,97,102,102,89
"7753",52,"[40]FIlHoIyasBkDntzabxwvDmbKDaenmHvnJHqvbGqa",220,0.991031,40,223,2,221,1,2,1,3,2,127,126,95,95,89
"7754",53,"[40]FIlHoIyasBkDntzabxwvDmbKDaenmHvnJHqvbGqa",193,0.989796,40,196,2,194,1,2,1,3,2,90,89,105,105,89
"7755",54,"[40]FIlHoIyasBkDntzabxwvDmbKDaenmHvnJHqvbGqa",196,0.98995,40,199,2,197,1,2,1,3,2,94,93,104,104,89
"7756",55,"[40]FIlHoIyasBkDntzabxwvDmbKDaenmHvnJHqvbGqa",201,0.990196,40,204,2,202,1,2,1,3,2,101,100,102,102,89
"7757",56,"[40]FIlHoIyasBkDntzabxwvDmbKDaenmHvnJHqvbGqa",212,0.990698,40,215,2,213,1,2,1,3,2,116,115,98,98,89
"7758",57,"[40]FIlHoIyasBkDntzabxwvDmbKDaenmHvnJHqvbGqa",200,0.990148,40,203,2,201,1,2,1,3,2,104,103,98,98,89
"7759",58,"[40]FIlHoIyasBkDntzabxwvDmbKDaenmHvnJHqvbGqa",202,0.990244,40,205,2,203,1,2,1,3,2,102,101,102,102,89
"7760",59,"[40]FIlHoIyasBkDntzabxwvDmbKDaenmHvnJHqvbGqa",211,0.990654,40,214,2,212,1,2,1,3,2,117,116,96,96,89
"7761",60,"[40]FIlHoIyasBkDntzabxwvDmbKDaenmHvnJHqvbGqa",191,0.989691,40,194,2,192,1,2,1,3,2,89,88,104,104,89
"7762",61,"[40]FIlHoIyasBkDntzabxwvDmbKDaenmHvnJHqvbGqa",203,0.990291,40,206,2,204,1,2,1,3,2,104,103,101,101,89
"7763",62,"[40]FIlHoIyasBkDntzabxwvDmbKDaenmHvnJHqvbGqa",210,0.99061,40,213,2,211,1,2,1,3,2,114,113,98,98,89
"7764",63,"[40]FIlHoIyasBkDntzabxwvDmbKDaenmHvnJHqvbGqa",210,0.99061,40,213,2,211,1,2,1,3,2,113,112,99,99,89
"7765",64,"[40]FIlHoIyasBkDntzabxwvDmbKDaenmHvnJHqvbGqa",213,0.990741,40,216,2,214,1,2,1,3,2,119,118,96,96,89
"7766",65,"[40]FIlHoIyasBkDntzabxwvDmbKDaenmHvnJHqvbGqa",203,0.990291,40,206,2,204,1,2,1,3,2,103,102,102,102,89
"7767",66,"[40]FIlHoIyasBkDntzabxwvDmbKDaenmHvnJHqvbGqa",187,0.989474,40,190,2,188,1,2,1,3,2,84,83,105,105,89
"7768",67,"[40]FIlHoIyasBkDntzabxwvDmbKDaenmHvnJHqvbGqa",194,0.989848,40,197,2,195,1,2,1,3,2,95,94,101,101,89
"7769",68,"[40]FIlHoIyasBkDntzabxwvDmbKDaenmHvnJHqvbGqa",206,0.990431,40,209,2,207,1,2,1,3,2,111,110,97,97,89
"7770",69,"[40]FIlHoIyasBkDntzabxwvDmbKDaenmHvnJHqvbGqa",198,0.99005,40,201,2,199,1,2,1,3,2,98,97,102,102,89
"7771",70,"[40]FIlHoIyasBkDntzabxwvDmbKDaenmHvnJHqvbGqa",205,0.990385,40,208,2,206,1,2,1,3,2,107,106,100,100,89
"7772",71,"[40]FIlHoIyasBkDntzabxwvDmbKDaenmHvnJHqvbGqa",206,0.990431,40,209,2,207,1,2,1,3,2,110,109,98,98,89
"7773",72,"[40]FIlHoIyasBkDntzabxwvDmbKDaenmHvnJHqvbGqa",220,0.991031,40,223,2,221,1,2,1,3,2,129,128,93,93,89
"7774",73,"[40]FIlHoIyasBkDntzabxwvDmbKDaenmHvnJHqvbGqa",223,0.99115,40,226,2,224,1,2,1,3,2,133,132,92,92,89
"7775",74,"[40]FIlHoIyasBkDntzabxwvDmbKDaenmHvnJHqvbGqa",196,0.98995,40,199,2,197,1,2,1,3,2,94,93,104,104,89
"7776",75,"[40]FIlHoIyasBkDntzabxwvDmbKDaenmHvnJHqvbGqa",210,0.99061,40,213,2,211,1,2,1,3,2,116,115,96,96,89
"7777",76,"[40]FIlHoIyasBkDntzabxwvDmbKDaenmHvnJHqvbGqa",204,0.990338,40,207,2,205,1,2,1,3,2,106,105,100,100,89
"7778",77,"[40]FIlHoIyasBkDntzabxwvDmbKDaenmHvnJHqvbGqa",182,0.989189,40,185,2,183,1,2,1,3,2,76,75,108,108,89
"7779",78,"[40]FIlHoIyasBkDntzabxwvDmbKDaenmHvnJHqvbGqa",206,0.990431,40,209,2,207,1,2,1,3,2,107,106,101,101,89
"7780",79,"[40]FIlHoIyasBkDntzabxwvDmbKDaenmHvnJHqvbGqa",189,0.989583,40,192,2,190,1,2,1,3,2,88,87,103,103,89
"7781",80,"[40]FIlHoIyasBkDntzabxwvDmbKDaenmHvnJHqvbGqa",207,0.990476,40,210,2,208,1,2,1,3,2,113,112,96,96,89
"7782",81,"[40]FIlHoIyasBkDntzabxwvDmbKDaenmHvnJHqvbGqa",202,0.990244,40,205,2,203,1,2,1,3,2,105,104,99,99,89
"7783",82,"[40]FIlHoIyasBkDntzabxwvDmbKDaenmHvnJHqvbGqa",191,0.989691,40,194,2,192,1,2,1,3,2,90,89,103,103,89
"7784",83,"[40]FIlHoIyasBkDntzabxwvDmbKDaenmHvnJHqvbGqa",198,0.99005,40,201,2,199,1,2,1,3,2,99,98,101,101,89
"7785",84,"[40]FIlHoIyasBkDntzabxwvDmbKDaenmHvnJHqvbGqa",206,0.990431,40,209,2,207,1,2,1,3,2,109,108,99,99,89
"7786",85,"[40]FIlHoIyasBkDntzabxwvDmbKDaenmHvnJHqvbGqa",213,0.990741,40,216,2,214,1,2,1,3,2,117,116,98,98,89
"7787",86,"[40]FIlHoIyasBkDntzabxwvDmbKDaenmHvnJHqvbGqa",205,0.990385,40,208,2,206,1,2,1,3,2,105,104,102,102,89
"7788",87,"[40]FIlHoIyasBkDntzabxwvDmbKDaenmHvnJHqvbGqa",209,0.990566,40,212,2,210,1,2,1,3,2,112,111,99,99,89
"7789",88,"[40]FIlHoIyasBkDntzabxwvDmbKDaenmHvnJHqvbGqa",200,0.990148,40,203,2,201,1,2,1,3,2,102,101,100,100,89
"7790",89,"[40]FIlHoIyasBkDntzabxwvDmbKDaenmHvnJHqvbGqa",197,0.99,40,200,2,198,1,2,1,3,2,98,97,101,101,89
"7791",90,"[40]FIlHoIyasBkDntzabxwvDmbKDaenmHvnJHqvbGqa",199,0.990099,40,202,2,200,1,2,1,3,2,98,97,103,103,89
"7792",91,"[40]FIlHoIyasBkDntzabxwvDmbKDaenmHvnJHqvbGqa",191,0.989691,40,194,2,192,1,2,1,3,2,88,87,105,105,89
"7793",92,"[40]FIlHoIyasBkDntzabxwvDmbKDaenmHvnJHqvbGqa",210,0.99061,40,213,2,211,1,2,1,3,2,112,111,100,100,89
"7794",93,"[40]FIlHoIyasBkDntzabxwvDmbKDaenmHvnJHqvbGqa",191,0.989691,40,194,2,192,1,2,1,3,2,88,87,105,105,89
"7795",94,"[40]FIlHoIyasBkDntzabxwvDmbKDaenmHvnJHqvbGqa",188,0.989529,40,191,2,189,1,2,1,3,2,85,84,105,105,89
"7796",95,"[40]FIlHoIyasBkDntzabxwvDmbKDaenmHvnJHqvbGqa",195,0.989899,40,198,2,196,1,2,1,3,2,94,93,103,103,89
"7797",96,"[40]FIlHoIyasBkDntzabxwvDmbKDaenmHvnJHqvbGqa",218,0.99095,40,221,2,219,1,2,1,3,2,123,122,97,97,89
"7798",97,"[40]FIlHoIyasBkDntzabxwvDmbKDaenmHvnJHqvbGqa",195,0.989899,40,198,2,196,1,2,1,3,2,95,94,102,102,89
"7799",98,"[40]FIlHoIyasBkDntzabxwvDmbKDaenmHvnJHqvbGqa",199,0.990099,40,202,2,200,1,2,1,3,2,98,97,103,103,89
"7800",99,"[40]FIlHoIyasBkDntzabxwvDmbKDaenmHvnJHqvbGqa",205,0.990385,40,208,2,206,1,2,1,3,2,108,107,99,99,89
"7801",0,"[40]bIGHoIscFBkyzDIFAqspKIbKDeeadHtnJHqvbGqa",203,0.990291,40,206,2,204,1,2,1,3,2,105,104,100,100,90
"7802",1,"[40]bIGHoIscFBkyzDIFAqspKIbKDeeadHtnJHqvbGqa",195,0.989899,40,198,2,196,1,2,1,3,2,93,92,104,104,90
"7803",2,"[40]bIGHoIscFBkyzDIFAqspKIbKDeeadHtnJHqvbGqa",200,0.990148,40,203,2,201,1,2,1,3,2,100,99,102,102,90
"7804",3,"[40]bIGHoIscFBkyzDIFAqspKIbKDeeadHtnJHqvbGqa",201,0.990196,40,204,2,202,1,2,1,3,2,103,102,100,100,90
"7805",4,"[40]bIGHoIscFBkyzDIFAqspKIbKDeeadHtnJHqvbGqa",201,0.990196,40,204,2,202,1,2,1,3,2,102,101,101,101,90
"7806",5,"[40]bIGHoIscFBkyzDIFAqspKIbKDeeadHtnJHqvbGqa",199,0.990099,40,202,2,200,1,2,1,3,2,98,97,103,103,90
"7807",6,"[40]bIGHoIscFBkyzDIFAqspKIbKDeeadHtnJHqvbGqa",192,0.989744,40,195,2,193,1,2,1,3,2,94,93,100,100,90
"7808",7,"[40]bIGHoIscFBkyzDIFAqspKIbKDeeadHtnJHqvbGqa",201,0.990196,40,204,2,202,1,2,1,3,2,104,103,99,99,90
"7809",8,"[40]bIGHoIscFBkyzDIFAqspKIbKDeeadHtnJHqvbGqa",187,0.989474,40,190,2,188,1,2,1,3,2,85,84,104,104,90
"7810",9,"[40]bIGHoIscFBkyzDIFAqspKIbKDeeadHtnJHqvbGqa",191,0.989691,40,194,2,192,1,2,1,3,2,89,88,104,104,90
"7811",10,"[40]bIGHoIscFBkyzDIFAqspKIbKDeeadHtnJHqvbGqa",192,0.989744,40,195,2,193,1,2,1,3,2,91,90,103,103,90
"7812",11,"[40]bIGHoIscFBkyzDIFAqspKIbKDeeadHtnJHqvbGqa",201,0.990196,40,204,2,202,1,2,1,3,2,103,102,100,100,90
"7813",12,"[40]bIGHoIscFBkyzDIFAqspKIbKDeeadHtnJHqvbGqa",198,0.99005,40,201,2,199,1,2,1,3,2,97,96,103,103,90
"7814",13,"[40]bIGHoIscFBkyzDIFAqspKIbKDeeadHtnJHqvbGqa",207,0.990476,40,210,2,208,1,2,1,3,2,110,109,99,99,90
"7815",14,"[40]bIGHoIscFBkyzDIFAqspKIbKDeeadHtnJHqvbGqa",205,0.990385,40,208,2,206,1,2,1,3,2,109,108,98,98,90
"7816",15,"[40]bIGHoIscFBkyzDIFAqspKIbKDeeadHtnJHqvbGqa",202,0.990244,40,205,2,203,1,2,1,3,2,104,103,100,100,90
"7817",16,"[40]bIGHoIscFBkyzDIFAqspKIbKDeeadHtnJHqvbGqa",211,0.990654,40,214,2,212,1,2,1,3,2,115,114,98,98,90
"7818",17,"[40]bIGHoIscFBkyzDIFAqspKIbKDeeadHtnJHqvbGqa",207,0.990476,40,210,2,208,1,2,1,3,2,110,109,99,99,90
"7819",18,"[40]bIGHoIscFBkyzDIFAqspKIbKDeeadHtnJHqvbGqa",202,0.990244,40,205,2,203,1,2,1,3,2,101,100,103,103,90
"7820",19,"[40]bIGHoIscFBkyzDIFAqspKIbKDeeadHtnJHqvbGqa",205,0.990385,40,208,2,206,1,2,1,3,2,108,107,99,99,90
"7821",20,"[40]bIGHoIscFBkyzDIFAqspKIbKDeeadHtnJHqvbGqa",198,0.99005,40,201,2,199,1,2,1,3,2,97,96,103,103,90
"7822",21,"[40]bIGHoIscFBkyzDIFAqspKIbKDeeadHtnJHqvbGqa",194,0.989848,40,197,2,195,1,2,1,3,2,92,91,104,104,90
"7823",22,"[40]bIGHoIscFBkyzDIFAqspKIbKDeeadHtnJHqvbGqa",204,0.990338,40,207,2,205,1,2,1,3,2,106,105,100,100,90
"7824",23,"[40]bIGHoIscFBkyzDIFAqspKIbKDeeadHtnJHqvbGqa",209,0.990566,40,212,2,210,1,2,1,3,2,110,109,101,101,90
"7825",24,"[40]bIGHoIscFBkyzDIFAqspKIbKDeeadHtnJHqvbGqa",199,0.990099,40,202,2,200,1,2,1,3,2,98,97,103,103,90
"7826",25,"[40]bIGHoIscFBkyzDIFAqspKIbKDeeadHtnJHqvbGqa",192,0.989744,40,195,2,193,1,2,1,3,2,89,88,105,105,90
"7827",26,"[40]bIGHoIscFBkyzDIFAqspKIbKDeeadHtnJHqvbGqa",200,0.990148,40,203,2,201,1,2,1,3,2,101,100,101,101,90
"7828",27,"[40]bIGHoIscFBkyzDIFAqspKIbKDeeadHtnJHqvbGqa",196,0.98995,40,199,2,197,1,2,1,3,2,95,94,103,103,90
"7829",28,"[40]bIGHoIscFBkyzDIFAqspKIbKDeeadHtnJHqvbGqa",203,0.990291,40,206,2,204,1,2,1,3,2,102,101,103,103,90
"7830",29,"[40]bIGHoIscFBkyzDIFAqspKIbKDeeadHtnJHqvbGqa",192,0.989744,40,195,2,193,1,2,1,3,2,88,87,106,106,90
"7831",30,"[40]bIGHoIscFBkyzDIFAqspKIbKDeeadHtnJHqvbGqa",202,0.990244,40,205,2,203,1,2,1,3,2,106,105,98,98,90
"7832",31,"[40]bIGHoIscFBkyzDIFAqspKIbKDeeadHtnJHqvbGqa",197,0.99,40,200,2,198,1,2,1,3,2,98,97,101,101,90
"7833",32,"[40]bIGHoIscFBkyzDIFAqspKIbKDeeadHtnJHqvbGqa",182,0.989189,40,185,2,183,1,2,1,3,2,79,78,105,105,90
"7834",33,"[40]bIGHoIscFBkyzDIFAqspKIbKDeeadHtnJHqvbGqa",192,0.989744,40,195,2,193,1,2,1,3,2,92,91,102,102,90
"7835",34,"[40]bIGHoIscFBkyzDIFAqspKIbKDeeadHtnJHqvbGqa",194,0.989848,40,197,2,195,1,2,1,3,2,92,91,104,104,90
"7836",35,"[40]bIGHoIscFBkyzDIFAqspKIbKDeeadHtnJHqvbGqa",201,0.990196,40,204,2,202,1,2,1,3,2,100,99,103,103,90
"7837",36,"[40]bIGHoIscFBkyzDIFAqspKIbKDeeadHtnJHqvbGqa",218,0.99095,40,221,2,219,1,2,1,3,2,123,122,97,97,90
"7838",37,"[40]bIGHoIscFBkyzDIFAqspKIbKDeeadHtnJHqvbGqa",188,0.989529,40,191,2,189,1,2,1,3,2,84,83,106,106,90
"7839",38,"[40]bIGHoIscFBkyzDIFAqspKIbKDeeadHtnJHqvbGqa",210,0.99061,40,213,2,211,1,2,1,3,2,114,113,98,98,90
"7840",39,"[40]bIGHoIscFBkyzDIFAqspKIbKDeeadHtnJHqvbGqa",207,0.990476,40,210,2,208,1,2,1,3,2,110,109,99,99,90
"7841",40,"[40]bIGHoIscFBkyzDIFAqspKIbKDeeadHtnJHqvbGqa",209,0.990566,40,212,2,210,1,2,1,3,2,113,112,98,98,90
"7842",41,"[40]bIGHoIscFBkyzDIFAqspKIbKDeeadHtnJHqvbGqa",204,0.990338,40,207,2,205,1,2,1,3,2,108,107,98,98,90
"7843",42,"[40]bIGHoIscFBkyzDIFAqspKIbKDeeadHtnJHqvbGqa",207,0.990476,40,210,2,208,1,2,1,3,2,107,106,102,102,90
"7844",43,"[40]bIGHoIscFBkyzDIFAqspKIbKDeeadHtnJHqvbGqa",194,0.989848,40,197,2,195,1,2,1,3,2,92,91,104,104,90
"7845",44,"[40]bIGHoIscFBkyzDIFAqspKIbKDeeadHtnJHqvbGqa",204,0.990338,40,207,2,205,1,2,1,3,2,110,109,96,96,90
"7846",45,"[40]bIGHoIscFBkyzDIFAqspKIbKDeeadHtnJHqvbGqa",229,0.991379,40,232,2,230,1,2,1,3,2,142,141,89,89,90
"7847",46,"[40]bIGHoIscFBkyzDIFAqspKIbKDeeadHtnJHqvbGqa",189,0.989583,40,192,2,190,1,2,1,3,2,87,86,104,104,90
"7848",47,"[40]bIGHoIscFBkyzDIFAqspKIbKDeeadHtnJHqvbGqa",185,0.989362,40,188,2,186,1,2,1,3,2,79,78,108,108,90
"7849",48,"[40]bIGHoIscFBkyzDIFAqspKIbKDeeadHtnJHqvbGqa",206,0.990431,40,209,2,207,1,2,1,3,2,109,108,99,99,90
"7850",49,"[40]bIGHoIscFBkyzDIFAqspKIbKDeeadHtnJHqvbGqa",219,0.990991,40,222,2,220,1,2,1,3,2,126,125,95,95,90
"7851",50,"[40]bIGHoIscFBkyzDIFAqspKIbKDeeadHtnJHqvbGqa",203,0.990291,40,206,2,204,1,2,1,3,2,106,105,99,99,90
"7852",51,"[40]bIGHoIscFBkyzDIFAqspKIbKDeeadHtnJHqvbGqa",212,0.990698,40,215,2,213,1,2,1,3,2,115,114,99,99,90
"7853",52,"[40]bIGHoIscFBkyzDIFAqspKIbKDeeadHtnJHqvbGqa",203,0.990291,40,206,2,204,1,2,1,3,2,105,104,100,100,90
"7854",53,"[40]bIGHoIscFBkyzDIFAqspKIbKDeeadHtnJHqvbGqa",201,0.990196,40,204,2,202,1,2,1,3,2,104,103,99,99,90
"7855",54,"[40]bIGHoIscFBkyzDIFAqspKIbKDeeadHtnJHqvbGqa",203,0.990291,40,206,2,204,1,2,1,3,2,107,106,98,98,90
"7856",55,"[40]bIGHoIscFBkyzDIFAqspKIbKDeeadHtnJHqvbGqa",197,0.99,40,200,2,198,1,2,1,3,2,95,94,104,104,90
"7857",56,"[40]bIGHoIscFBkyzDIFAqspKIbKDeeadHtnJHqvbGqa",188,0.989529,40,191,2,189,1,2,1,3,2,86,85,104,104,90
"7858",57,"[40]bIGHoIscFBkyzDIFAqspKIbKDeeadHtnJHqvbGqa",201,0.990196,40,204,2,202,1,2,1,3,2,102,101,101,101,90
"7859",58,"[40]bIGHoIscFBkyzDIFAqspKIbKDeeadHtnJHqvbGqa",195,0.989899,40,198,2,196,1,2,1,3,2,93,92,104,104,90
"7860",59,"[40]bIGHoIscFBkyzDIFAqspKIbKDeeadHtnJHqvbGqa",201,0.990196,40,204,2,202,1,2,1,3,2,103,102,100,100,90
"7861",60,"[40]bIGHoIscFBkyzDIFAqspKIbKDeeadHtnJHqvbGqa",201,0.990196,40,204,2,202,1,2,1,3,2,102,101,101,101,90
"7862",61,"[40]bIGHoIscFBkyzDIFAqspKIbKDeeadHtnJHqvbGqa",201,0.990196,40,204,2,202,1,2,1,3,2,103,102,100,100,90
"7863",62,"[40]bIGHoIscFBkyzDIFAqspKIbKDeeadHtnJHqvbGqa",204,0.990338,40,207,2,205,1,2,1,3,2,104,103,102,102,90
"7864",63,"[40]bIGHoIscFBkyzDIFAqspKIbKDeeadHtnJHqvbGqa",173,0.988636,40,176,2,174,1,2,1,3,2,64,63,111,111,90
"7865",64,"[40]bIGHoIscFBkyzDIFAqspKIbKDeeadHtnJHqvbGqa",197,0.99,40,200,2,198,1,2,1,3,2,99,98,100,100,90
"7866",65,"[40]bIGHoIscFBkyzDIFAqspKIbKDeeadHtnJHqvbGqa",202,0.990244,40,205,2,203,1,2,1,3,2,104,103,100,100,90
"7867",66,"[40]bIGHoIscFBkyzDIFAqspKIbKDeeadHtnJHqvbGqa",188,0.989529,40,191,2,189,1,2,1,3,2,86,85,104,104,90
"7868",67,"[40]bIGHoIscFBkyzDIFAqspKIbKDeeadHtnJHqvbGqa",204,0.990338,40,207,2,205,1,2,1,3,2,106,105,100,100,90
"7869",68,"[40]bIGHoIscFBkyzDIFAqspKIbKDeeadHtnJHqvbGqa",212,0.990698,40,215,2,213,1,2,1,3,2,115,114,99,99,90
"7870",69,"[40]bIGHoIscFBkyzDIFAqspKIbKDeeadHtnJHqvbGqa",200,0.990148,40,203,2,201,1,2,1,3,2,102,101,100,100,90
"7871",70,"[40]bIGHoIscFBkyzDIFAqspKIbKDeeadHtnJHqvbGqa",206,0.990431,40,209,2,207,1,2,1,3,2,110,109,98,98,90
"7872",71,"[40]bIGHoIscFBkyzDIFAqspKIbKDeeadHtnJHqvbGqa",214,0.990783,40,217,2,215,1,2,1,3,2,118,117,98,98,90
"7873",72,"[40]bIGHoIscFBkyzDIFAqspKIbKDeeadHtnJHqvbGqa",201,0.990196,40,204,2,202,1,2,1,3,2,101,100,102,102,90
"7874",73,"[40]bIGHoIscFBkyzDIFAqspKIbKDeeadHtnJHqvbGqa",202,0.990244,40,205,2,203,1,2,1,3,2,105,104,99,99,90
"7875",74,"[40]bIGHoIscFBkyzDIFAqspKIbKDeeadHtnJHqvbGqa",215,0.990826,40,218,2,216,1,2,1,3,2,121,120,96,96,90
"7876",75,"[40]bIGHoIscFBkyzDIFAqspKIbKDeeadHtnJHqvbGqa",217,0.990909,40,220,2,218,1,2,1,3,2,125,124,94,94,90
"7877",76,"[40]bIGHoIscFBkyzDIFAqspKIbKDeeadHtnJHqvbGqa",200,0.990148,40,203,2,201,1,2,1,3,2,101,100,101,101,90
"7878",77,"[40]bIGHoIscFBkyzDIFAqspKIbKDeeadHtnJHqvbGqa",199,0.990099,40,202,2,200,1,2,1,3,2,100,99,101,101,90
"7879",78,"[40]bIGHoIscFBkyzDIFAqspKIbKDeeadHtnJHqvbGqa",193,0.989796,40,196,2,194,1,2,1,3,2,94,93,101,101,90
"7880",79,"[40]bIGHoIscFBkyzDIFAqspKIbKDeeadHtnJHqvbGqa",204,0.990338,40,207,2,205,1,2,1,3,2,106,105,100,100,90
"7881",80,"[40]bIGHoIscFBkyzDIFAqspKIbKDeeadHtnJHqvbGqa",205,0.990385,40,208,2,206,1,2,1,3,2,109,108,98,98,90
"7882",81,"[40]bIGHoIscFBkyzDIFAqspKIbKDeeadHtnJHqvbGqa",207,0.990476,40,210,2,208,1,2,1,3,2,112,111,97,97,90
"7883",82,"[40]bIGHoIscFBkyzDIFAqspKIbKDeeadHtnJHqvbGqa",211,0.990654,40,214,2,212,1,2,1,3,2,116,115,97,97,90
"7884",83,"[40]bIGHoIscFBkyzDIFAqspKIbKDeeadHtnJHqvbGqa",199,0.990099,40,202,2,200,1,2,1,3,2,98,97,103,103,90
"7885",84,"[40]bIGHoIscFBkyzDIFAqspKIbKDeeadHtnJHqvbGqa",207,0.990476,40,210,2,208,1,2,1,3,2,110,109,99,99,90
"7886",85,"[40]bIGHoIscFBkyzDIFAqspKIbKDeeadHtnJHqvbGqa",199,0.990099,40,202,2,200,1,2,1,3,2,101,100,100,100,90
"7887",86,"[40]bIGHoIscFBkyzDIFAqspKIbKDeeadHtnJHqvbGqa",193,0.989796,40,196,2,194,1,2,1,3,2,91,90,104,104,90
"7888",87,"[40]bIGHoIscFBkyzDIFAqspKIbKDeeadHtnJHqvbGqa",200,0.990148,40,203,2,201,1,2,1,3,2,100,99,102,102,90
"7889",88,"[40]bIGHoIscFBkyzDIFAqspKIbKDeeadHtnJHqvbGqa",207,0.990476,40,210,2,208,1,2,1,3,2,113,112,96,96,90
"7890",89,"[40]bIGHoIscFBkyzDIFAqspKIbKDeeadHtnJHqvbGqa",191,0.989691,40,194,2,192,1,2,1,3,2,90,89,103,103,90
"7891",90,"[40]bIGHoIscFBkyzDIFAqspKIbKDeeadHtnJHqvbGqa",172,0.988571,40,175,2,173,1,2,1,3,2,64,63,110,110,90
"7892",91,"[40]bIGHoIscFBkyzDIFAqspKIbKDeeadHtnJHqvbGqa",193,0.989796,40,196,2,194,1,2,1,3,2,91,90,104,104,90
"7893",92,"[40]bIGHoIscFBkyzDIFAqspKIbKDeeadHtnJHqvbGqa",208,0.990521,40,211,2,209,1,2,1,3,2,112,111,98,98,90
"7894",93,"[40]bIGHoIscFBkyzDIFAqspKIbKDeeadHtnJHqvbGqa",195,0.989899,40,198,2,196,1,2,1,3,2,95,94,102,102,90
"7895",94,"[40]bIGHoIscFBkyzDIFAqspKIbKDeeadHtnJHqvbGqa",201,0.990196,40,204,2,202,1,2,1,3,2,101,100,102,102,90
"7896",95,"[40]bIGHoIscFBkyzDIFAqspKIbKDeeadHtnJHqvbGqa",193,0.989796,40,196,2,194,1,2,1,3,2,92,91,103,103,90
"7897",96,"[40]bIGHoIscFBkyzDIFAqspKIbKDeeadHtnJHqvbGqa",188,0.989529,40,191,2,189,1,2,1,3,2,85,84,105,105,90
"7898",97,"[40]bIGHoIscFBkyzDIFAqspKIbKDeeadHtnJHqvbGqa",192,0.989744,40,195,2,193,1,2,1,3,2,90,89,104,104,90
"7899",98,"[40]bIGHoIscFBkyzDIFAqspKIbKDeeadHtnJHqvbGqa",184,0.989305,40,187,2,185,1,2,1,3,2,79,78,107,107,90
"7900",99,"[40]bIGHoIscFBkyzDIFAqspKIbKDeeadHtnJHqvbGqa",203,0.990291,40,206,2,204,1,2,1,3,2,104,103,101,101,90
"7901",0,"[36]IjiHoIwEBDGbmbwyyDpilcjbKHwnJHqvbGqa",217,0.990909,36,220,2,218,1,2,1,3,2,110,109,109,109,91
"7902",1,"[36]IjiHoIwEBDGbmbwyyDpilcjbKHwnJHqvbGqa",215,0.990826,36,218,2,216,1,2,1,3,2,108,107,109,109,91
"7903",2,"[36]IjiHoIwEBDGbmbwyyDpilcjbKHwnJHqvbGqa",223,0.99115,36,226,2,224,1,2,1,3,2,119,118,106,106,91
"7904",3,"[36]IjiHoIwEBDGbmbwyyDpilcjbKHwnJHqvbGqa",195,0.989899,36,198,2,196,1,2,1,3,2,80,79,117,117,91
"7905",4,"[36]IjiHoIwEBDGbmbwyyDpilcjbKHwnJHqvbGqa",216,0.990868,36,219,2,217,1,2,1,3,2,107,106,111,111,91
"7906",5,"[36]IjiHoIwEBDGbmbwyyDpilcjbKHwnJHqvbGqa",216,0.990868,36,219,2,217,1,2,1,3,2,109,108,109,109,91
"7907",6,"[36]IjiHoIwEBDGbmbwyyDpilcjbKHwnJHqvbGqa",203,0.990291,36,206,2,204,1,2,1,3,2,92,91,113,113,91
"7908",7,"[36]IjiHoIwEBDGbmbwyyDpilcjbKHwnJHqvbGqa",223,0.99115,36,226,2,224,1,2,1,3,2,120,119,105,105,91
"7909",8,"[36]IjiHoIwEBDGbmbwyyDpilcjbKHwnJHqvbGqa",219,0.990991,36,222,2,220,1,2,1,3,2,113,112,108,108,91
"7910",9,"[36]IjiHoIwEBDGbmbwyyDpilcjbKHwnJHqvbGqa",203,0.990291,36,206,2,204,1,2,1,3,2,92,91,113,113,91
"7911",10,"[36]IjiHoIwEBDGbmbwyyDpilcjbKHwnJHqvbGqa",217,0.990909,36,220,2,218,1,2,1,3,2,113,112,106,106,91
"7912",11,"[36]IjiHoIwEBDGbmbwyyDpilcjbKHwnJHqvbGqa",217,0.990909,36,220,2,218,1,2,1,3,2,109,108,110,110,91
"7913",12,"[36]IjiHoIwEBDGbmbwyyDpilcjbKHwnJHqvbGqa",211,0.990654,36,214,2,212,1,2,1,3,2,103,102,110,110,91
"7914",13,"[36]IjiHoIwEBDGbmbwyyDpilcjbKHwnJHqvbGqa",221,0.991071,36,224,2,222,1,2,1,3,2,116,115,107,107,91
"7915",14,"[36]IjiHoIwEBDGbmbwyyDpilcjbKHwnJHqvbGqa",201,0.990196,36,204,2,202,1,2,1,3,2,89,88,114,114,91
"7916",15,"[36]IjiHoIwEBDGbmbwyyDpilcjbKHwnJHqvbGqa",225,0.991228,36,228,2,226,1,2,1,3,2,121,120,106,106,91
"7917",16,"[36]IjiHoIwEBDGbmbwyyDpilcjbKHwnJHqvbGqa",225,0.991228,36,228,2,226,1,2,1,3,2,122,121,105,105,91
"7918",17,"[36]IjiHoIwEBDGbmbwyyDpilcjbKHwnJHqvbGqa",210,0.99061,36,213,2,211,1,2,1,3,2,102,101,110,110,91
"7919",18,"[36]IjiHoIwEBDGbmbwyyDpilcjbKHwnJHqvbGqa",220,0.991031,36,223,2,221,1,2,1,3,2,116,115,106,106,91
"7920",19,"[36]IjiHoIwEBDGbmbwyyDpilcjbKHwnJHqvbGqa",216,0.990868,36,219,2,217,1,2,1,3,2,107,106,111,111,91
"7921",20,"[36]IjiHoIwEBDGbmbwyyDpilcjbKHwnJHqvbGqa",196,0.98995,36,199,2,197,1,2,1,3,2,80,79,118,118,91
"7922",21,"[36]IjiHoIwEBDGbmbwyyDpilcjbKHwnJHqvbGqa",201,0.990196,36,204,2,202,1,2,1,3,2,86,85,117,117,91
"7923",22,"[36]IjiHoIwEBDGbmbwyyDpilcjbKHwnJHqvbGqa",217,0.990909,36,220,2,218,1,2,1,3,2,109,108,110,110,91
"7924",23,"[36]IjiHoIwEBDGbmbwyyDpilcjbKHwnJHqvbGqa",216,0.990868,36,219,2,217,1,2,1,3,2,111,110,107,107,91
"7925",24,"[36]IjiHoIwEBDGbmbwyyDpilcjbKHwnJHqvbGqa",206,0.990431,36,209,2,207,1,2,1,3,2,94,93,114,114,91
"7926",25,"[36]IjiHoIwEBDGbmbwyyDpilcjbKHwnJHqvbGqa",213,0.990741,36,216,2,214,1,2,1,3,2,102,101,113,113,91
"7927",26,"[36]IjiHoIwEBDGbmbwyyDpilcjbKHwnJHqvbGqa",214,0.990783,36,217,2,215,1,2,1,3,2,107,106,109,109,91
"7928",27,"[36]IjiHoIwEBDGbmbwyyDpilcjbKHwnJHqvbGqa",216,0.990868,36,219,2,217,1,2,1,3,2,108,107,110,110,91
"7929",28,"[36]IjiHoIwEBDGbmbwyyDpilcjbKHwnJHqvbGqa",215,0.990826,36,218,2,216,1,2,1,3,2,108,107,109,109,91
"7930",29,"[36]IjiHoIwEBDGbmbwyyDpilcjbKHwnJHqvbGqa",205,0.990385,36,208,2,206,1,2,1,3,2,91,90,116,116,91
"7931",30,"[36]IjiHoIwEBDGbmbwyyDpilcjbKHwnJHqvbGqa",216,0.990868,36,219,2,217,1,2,1,3,2,108,107,110,110,91
"7932",31,"[36]IjiHoIwEBDGbmbwyyDpilcjbKHwnJHqvbGqa",209,0.990566,36,212,2,210,1,2,1,3,2,97,96,114,114,91
"7933",32,"[36]IjiHoIwEBDGbmbwyyDpilcjbKHwnJHqvbGqa",215,0.990826,36,218,2,216,1,2,1,3,2,109,108,108,108,91
"7934",33,"[36]IjiHoIwEBDGbmbwyyDpilcjbKHwnJHqvbGqa",229,0.991379,36,232,2,230,1,2,1,3,2,128,127,103,103,91
"7935",34,"[36]IjiHoIwEBDGbmbwyyDpilcjbKHwnJHqvbGqa",232,0.991489,36,235,2,233,1,2,1,3,2,132,131,102,102,91
"7936",35,"[36]IjiHoIwEBDGbmbwyyDpilcjbKHwnJHqvbGqa",221,0.991071,36,224,2,222,1,2,1,3,2,117,116,106,106,91
"7937",36,"[36]IjiHoIwEBDGbmbwyyDpilcjbKHwnJHqvbGqa",225,0.991228,36,228,2,226,1,2,1,3,2,123,122,104,104,91
"7938",37,"[36]IjiHoIwEBDGbmbwyyDpilcjbKHwnJHqvbGqa",229,0.991379,36,232,2,230,1,2,1,3,2,131,130,100,100,91
"7939",38,"[36]IjiHoIwEBDGbmbwyyDpilcjbKHwnJHqvbGqa",216,0.990868,36,219,2,217,1,2,1,3,2,110,109,108,108,91
"7940",39,"[36]IjiHoIwEBDGbmbwyyDpilcjbKHwnJHqvbGqa",216,0.990868,36,219,2,217,1,2,1,3,2,109,108,109,109,91
"7941",40,"[36]IjiHoIwEBDGbmbwyyDpilcjbKHwnJHqvbGqa",212,0.990698,36,215,2,213,1,2,1,3,2,104,103,110,110,91
"7942",41,"[36]IjiHoIwEBDGbmbwyyDpilcjbKHwnJHqvbGqa",217,0.990909,36,220,2,218,1,2,1,3,2,109,108,110,110,91
"7943",42,"[36]IjiHoIwEBDGbmbwyyDpilcjbKHwnJHqvbGqa",218,0.99095,36,221,2,219,1,2,1,3,2,111,110,109,109,91
"7944",43,"[36]IjiHoIwEBDGbmbwyyDpilcjbKHwnJHqvbGqa",204,0.990338,36,207,2,205,1,2,1,3,2,93,92,113,113,91
"7945",44,"[36]IjiHoIwEBDGbmbwyyDpilcjbKHwnJHqvbGqa",219,0.990991,36,222,2,220,1,2,1,3,2,113,112,108,108,91
"7946",45,"[36]IjiHoIwEBDGbmbwyyDpilcjbKHwnJHqvbGqa",209,0.990566,36,212,2,210,1,2,1,3,2,99,98,112,112,91
"7947",46,"[36]IjiHoIwEBDGbmbwyyDpilcjbKHwnJHqvbGqa",203,0.990291,36,206,2,204,1,2,1,3,2,91,90,114,114,91
"7948",47,"[36]IjiHoIwEBDGbmbwyyDpilcjbKHwnJHqvbGqa",209,0.990566,36,212,2,210,1,2,1,3,2,99,98,112,112,91
"7949",48,"[36]IjiHoIwEBDGbmbwyyDpilcjbKHwnJHqvbGqa",209,0.990566,36,212,2,210,1,2,1,3,2,98,97,113,113,91
"7950",49,"[36]IjiHoIwEBDGbmbwyyDpilcjbKHwnJHqvbGqa",225,0.991228,36,228,2,226,1,2,1,3,2,117,116,110,110,91
"7951",50,"[36]IjiHoIwEBDGbmbwyyDpilcjbKHwnJHqvbGqa",217,0.990909,36,220,2,218,1,2,1,3,2,112,111,107,107,91
"7952",51,"[36]IjiHoIwEBDGbmbwyyDpilcjbKHwnJHqvbGqa",224,0.991189,36,227,2,225,1,2,1,3,2,122,121,104,104,91
"7953",52,"[36]IjiHoIwEBDGbmbwyyDpilcjbKHwnJHqvbGqa",227,0.991304,36,230,2,228,1,2,1,3,2,126,125,103,103,91
"7954",53,"[36]IjiHoIwEBDGbmbwyyDpilcjbKHwnJHqvbGqa",223,0.99115,36,226,2,224,1,2,1,3,2,116,115,109,109,91
"7955",54,"[36]IjiHoIwEBDGbmbwyyDpilcjbKHwnJHqvbGqa",207,0.990476,36,210,2,208,1,2,1,3,2,99,98,110,110,91
"7956",55,"[36]IjiHoIwEBDGbmbwyyDpilcjbKHwnJHqvbGqa",227,0.991304,36,230,2,228,1,2,1,3,2,125,124,104,104,91
"7957",56,"[36]IjiHoIwEBDGbmbwyyDpilcjbKHwnJHqvbGqa",225,0.991228,36,228,2,226,1,2,1,3,2,123,122,104,104,91
"7958",57,"[36]IjiHoIwEBDGbmbwyyDpilcjbKHwnJHqvbGqa",212,0.990698,36,215,2,213,1,2,1,3,2,102,101,112,112,91
"7959",58,"[36]IjiHoIwEBDGbmbwyyDpilcjbKHwnJHqvbGqa",237,0.991667,36,240,2,238,1,2,1,3,2,140,139,99,99,91
"7960",59,"[36]IjiHoIwEBDGbmbwyyDpilcjbKHwnJHqvbGqa",219,0.990991,36,222,2,220,1,2,1,3,2,113,112,108,108,91
"7961",60,"[36]IjiHoIwEBDGbmbwyyDpilcjbKHwnJHqvbGqa",233,0.991525,36,236,2,234,1,2,1,3,2,129,128,106,106,91
"7962",61,"[36]IjiHoIwEBDGbmbwyyDpilcjbKHwnJHqvbGqa",207,0.990476,36,210,2,208,1,2,1,3,2,96,95,113,113,91
"7963",62,"[36]IjiHoIwEBDGbmbwyyDpilcjbKHwnJHqvbGqa",212,0.990698,36,215,2,213,1,2,1,3,2,101,100,113,113,91
"7964",63,"[36]IjiHoIwEBDGbmbwyyDpilcjbKHwnJHqvbGqa",227,0.991304,36,230,2,228,1,2,1,3,2,125,124,104,104,91
"7965",64,"[36]IjiHoIwEBDGbmbwyyDpilcjbKHwnJHqvbGqa",210,0.99061,36,213,2,211,1,2,1,3,2,101,100,111,111,91
"7966",65,"[36]IjiHoIwEBDGbmbwyyDpilcjbKHwnJHqvbGqa",210,0.99061,36,213,2,211,1,2,1,3,2,100,99,112,112,91
"7967",66,"[36]IjiHoIwEBDGbmbwyyDpilcjbKHwnJHqvbGqa",206,0.990431,36,209,2,207,1,2,1,3,2,93,92,115,115,91
"7968",67,"[36]IjiHoIwEBDGbmbwyyDpilcjbKHwnJHqvbGqa",215,0.990826,36,218,2,216,1,2,1,3,2,108,107,109,109,91
"7969",68,"[36]IjiHoIwEBDGbmbwyyDpilcjbKHwnJHqvbGqa",215,0.990826,36,218,2,216,1,2,1,3,2,110,109,107,107,91
"7970",69,"[36]IjiHoIwEBDGbmbwyyDpilcjbKHwnJHqvbGqa",205,0.990385,36,208,2,206,1,2,1,3,2,97,96,110,110,91
"7971",70,"[36]IjiHoIwEBDGbmbwyyDpilcjbKHwnJHqvbGqa",212,0.990698,36,215,2,213,1,2,1,3,2,102,101,112,112,91
"7972",71,"[36]IjiHoIwEBDGbmbwyyDpilcjbKHwnJHqvbGqa",209,0.990566,36,212,2,210,1,2,1,3,2,103,102,108,108,91
"7973",72,"[36]IjiHoIwEBDGbmbwyyDpilcjbKHwnJHqvbGqa",219,0.990991,36,222,2,220,1,2,1,3,2,111,110,110,110,91
"7974",73,"[36]IjiHoIwEBDGbmbwyyDpilcjbKHwnJHqvbGqa",233,0.991525,36,236,2,234,1,2,1,3,2,130,129,105,105,91
"7975",74,"[36]IjiHoIwEBDGbmbwyyDpilcjbKHwnJHqvbGqa",224,0.991189,36,227,2,225,1,2,1,3,2,122,121,104,104,91
"7976",75,"[36]IjiHoIwEBDGbmbwyyDpilcjbKHwnJHqvbGqa",201,0.990196,36,204,2,202,1,2,1,3,2,89,88,114,114,91
"7977",76,"[36]IjiHoIwEBDGbmbwyyDpilcjbKHwnJHqvbGqa",211,0.990654,36,214,2,212,1,2,1,3,2,103,102,110,110,91
"7978",77,"[36]IjiHoIwEBDGbmbwyyDpilcjbKHwnJHqvbGqa",204,0.990338,36,207,2,205,1,2,1,3,2,93,92,113,113,91
"7979",78,"[36]IjiHoIwEBDGbmbwyyDpilcjbKHwnJHqvbGqa",218,0.99095,36,221,2,219,1,2,1,3,2,111,110,109,109,91
"7980",79,"[36]IjiHoIwEBDGbmbwyyDpilcjbKHwnJHqvbGqa",217,0.990909,36,220,2,218,1,2,1,3,2,113,112,106,106,91
"7981",80,"[36]IjiHoIwEBDGbmbwyyDpilcjbKHwnJHqvbGqa",210,0.99061,36,213,2,211,1,2,1,3,2,101,100,111,111,91
"7982",81,"[36]IjiHoIwEBDGbmbwyyDpilcjbKHwnJHqvbGqa",227,0.991304,36,230,2,228,1,2,1,3,2,125,124,104,104,91
"7983",82,"[36]IjiHoIwEBDGbmbwyyDpilcjbKHwnJHqvbGqa",226,0.991266,36,229,2,227,1,2,1,3,2,125,124,103,103,91
"7984",83,"[36]IjiHoIwEBDGbmbwyyDpilcjbKHwnJHqvbGqa",229,0.991379,36,232,2,230,1,2,1,3,2,125,124,106,106,91
"7985",84,"[36]IjiHoIwEBDGbmbwyyDpilcjbKHwnJHqvbGqa",209,0.990566,36,212,2,210,1,2,1,3,2,102,101,109,109,91
"7986",85,"[36]IjiHoIwEBDGbmbwyyDpilcjbKHwnJHqvbGqa",213,0.990741,36,216,2,214,1,2,1,3,2,103,102,112,112,91
"7987",86,"[36]IjiHoIwEBDGbmbwyyDpilcjbKHwnJHqvbGqa",210,0.99061,36,213,2,211,1,2,1,3,2,101,100,111,111,91
"7988",87,"[36]IjiHoIwEBDGbmbwyyDpilcjbKHwnJHqvbGqa",216,0.990868,36,219,2,217,1,2,1,3,2,110,109,108,108,91
"7989",88,"[36]IjiHoIwEBDGbmbwyyDpilcjbKHwnJHqvbGqa",208,0.990521,36,211,2,209,1,2,1,3,2,97,96,113,113,91
"7990",89,"[36]IjiHoIwEBDGbmbwyyDpilcjbKHwnJHqvbGqa",219,0.990991,36,222,2,220,1,2,1,3,2,113,112,108,108,91
"7991",90,"[36]IjiHoIwEBDGbmbwyyDpilcjbKHwnJHqvbGqa",207,0.990476,36,210,2,208,1,2,1,3,2,96,95,113,113,91
"7992",91,"[36]IjiHoIwEBDGbmbwyyDpilcjbKHwnJHqvbGqa",222,0.991111,36,225,2,223,1,2,1,3,2,119,118,105,105,91
"7993",92,"[36]IjiHoIwEBDGbmbwyyDpilcjbKHwnJHqvbGqa",224,0.991189,36,227,2,225,1,2,1,3,2,120,119,106,106,91
"7994",93,"[36]IjiHoIwEBDGbmbwyyDpilcjbKHwnJHqvbGqa",215,0.990826,36,218,2,216,1,2,1,3,2,111,110,106,106,91
"7995",94,"[36]IjiHoIwEBDGbmbwyyDpilcjbKHwnJHqvbGqa",214,0.990783,36,217,2,215,1,2,1,3,2,109,108,107,107,91
"7996",95,"[36]IjiHoIwEBDGbmbwyyDpilcjbKHwnJHqvbGqa",207,0.990476,36,210,2,208,1,2,1,3,2,97,96,112,112,91
"7997",96,"[36]IjiHoIwEBDGbmbwyyDpilcjbKHwnJHqvbGqa",219,0.990991,36,222,2,220,1,2,1,3,2,111,110,110,110,91
"7998",97,"[36]IjiHoIwEBDGbmbwyyDpilcjbKHwnJHqvbGqa",217,0.990909,36,220,2,218,1,2,1,3,2,110,109,109,109,91
"7999",98,"[36]IjiHoIwEBDGbmbwyyDpilcjbKHwnJHqvbGqa",229,0.991379,36,232,2,230,1,2,1,3,2,127,126,104,104,91
"8000",99,"[36]IjiHoIwEBDGbmbwyyDpilcjbKHwnJHqvbGqa",220,0.991031,36,223,2,221,1,2,1,3,2,117,116,105,105,91
"8001",0,"[40]iIvHoIpbqBkoADHvvIiwirbKDeellHtnJHqvbGqa",197,0.99,40,200,2,198,1,2,1,3,2,98,97,101,101,92
"8002",1,"[40]iIvHoIpbqBkoADHvvIiwirbKDeellHtnJHqvbGqa",209,0.990566,40,212,2,210,1,2,1,3,2,112,111,99,99,92
"8003",2,"[40]iIvHoIpbqBkoADHvvIiwirbKDeellHtnJHqvbGqa",204,0.990338,40,207,2,205,1,2,1,3,2,105,104,101,101,92
"8004",3,"[40]iIvHoIpbqBkoADHvvIiwirbKDeellHtnJHqvbGqa",197,0.99,40,200,2,198,1,2,1,3,2,95,94,104,104,92
"8005",4,"[40]iIvHoIpbqBkoADHvvIiwirbKDeellHtnJHqvbGqa",194,0.989848,40,197,2,195,1,2,1,3,2,92,91,104,104,92
"8006",5,"[40]iIvHoIpbqBkoADHvvIiwirbKDeellHtnJHqvbGqa",199,0.990099,40,202,2,200,1,2,1,3,2,98,97,103,103,92
"8007",6,"[40]iIvHoIpbqBkoADHvvIiwirbKDeellHtnJHqvbGqa",184,0.989305,40,187,2,185,1,2,1,3,2,77,76,109,109,92
"8008",7,"[40]iIvHoIpbqBkoADHvvIiwirbKDeellHtnJHqvbGqa",188,0.989529,40,191,2,189,1,2,1,3,2,87,86,103,103,92
"8009",8,"[40]iIvHoIpbqBkoADHvvIiwirbKDeellHtnJHqvbGqa",195,0.989899,40,198,2,196,1,2,1,3,2,94,93,103,103,92
"8010",9,"[40]iIvHoIpbqBkoADHvvIiwirbKDeellHtnJHqvbGqa",221,0.991071,40,224,2,222,1,2,1,3,2,128,127,95,95,92
"8011",10,"[40]iIvHoIpbqBkoADHvvIiwirbKDeellHtnJHqvbGqa",196,0.98995,40,199,2,197,1,2,1,3,2,91,90,107,107,92
"8012",11,"[40]iIvHoIpbqBkoADHvvIiwirbKDeellHtnJHqvbGqa",190,0.989637,40,193,2,191,1,2,1,3,2,87,86,105,105,92
"8013",12,"[40]iIvHoIpbqBkoADHvvIiwirbKDeellHtnJHqvbGqa",208,0.990521,40,211,2,209,1,2,1,3,2,110,109,100,100,92
"8014",13,"[40]iIvHoIpbqBkoADHvvIiwirbKDeellHtnJHqvbGqa",197,0.99,40,200,2,198,1,2,1,3,2,97,96,102,102,92
"8015",14,"[40]iIvHoIpbqBkoADHvvIiwirbKDeellHtnJHqvbGqa",211,0.990654,40,214,2,212,1,2,1,3,2,117,116,96,96,92
"8016",15,"[40]iIvHoIpbqBkoADHvvIiwirbKDeellHtnJHqvbGqa",211,0.990654,40,214,2,212,1,2,1,3,2,112,111,101,101,92
"8017",16,"[40]iIvHoIpbqBkoADHvvIiwirbKDeellHtnJHqvbGqa",193,0.989796,40,196,2,194,1,2,1,3,2,92,91,103,103,92
"8018",17,"[40]iIvHoIpbqBkoADHvvIiwirbKDeellHtnJHqvbGqa",206,0.990431,40,209,2,207,1,2,1,3,2,112,111,96,96,92
"8019",18,"[40]iIvHoIpbqBkoADHvvIiwirbKDeellHtnJHqvbGqa",195,0.989899,40,198,2,196,1,2,1,3,2,95,94,102,102,92
"8020",19,"[40]iIvHoIpbqBkoADHvvIiwirbKDeellHtnJHqvbGqa",210,0.99061,40,213,2,211,1,2,1,3,2,109,108,103,103,92
"8021",20,"[40]iIvHoIpbqBkoADHvvIiwirbKDeellHtnJHqvbGqa",206,0.990431,40,209,2,207,1,2,1,3,2,108,107,100,100,92
"8022",21,"[40]iIvHoIpbqBkoADHvvIiwirbKDeellHtnJHqvbGqa",198,0.99005,40,201,2,199,1,2,1,3,2,97,96,103,103,92
"8023",22,"[40]iIvHoIpbqBkoADHvvIiwirbKDeellHtnJHqvbGqa",217,0.990909,40,220,2,218,1,2,1,3,2,126,125,93,93,92
"8024",23,"[40]iIvHoIpbqBkoADHvvIiwirbKDeellHtnJHqvbGqa",198,0.99005,40,201,2,199,1,2,1,3,2,99,98,101,101,92
"8025",24,"[40]iIvHoIpbqBkoADHvvIiwirbKDeellHtnJHqvbGqa",195,0.989899,40,198,2,196,1,2,1,3,2,95,94,102,102,92
"8026",25,"[40]iIvHoIpbqBkoADHvvIiwirbKDeellHtnJHqvbGqa",191,0.989691,40,194,2,192,1,2,1,3,2,89,88,104,104,92
"8027",26,"[40]iIvHoIpbqBkoADHvvIiwirbKDeellHtnJHqvbGqa",220,0.991031,40,223,2,221,1,2,1,3,2,129,128,93,93,92
"8028",27,"[40]iIvHoIpbqBkoADHvvIiwirbKDeellHtnJHqvbGqa",208,0.990521,40,211,2,209,1,2,1,3,2,112,111,98,98,92
"8029",28,"[40]iIvHoIpbqBkoADHvvIiwirbKDeellHtnJHqvbGqa",190,0.989637,40,193,2,191,1,2,1,3,2,87,86,105,105,92
"8030",29,"[40]iIvHoIpbqBkoADHvvIiwirbKDeellHtnJHqvbGqa",203,0.990291,40,206,2,204,1,2,1,3,2,106,105,99,99,92
"8031",30,"[40]iIvHoIpbqBkoADHvvIiwirbKDeellHtnJHqvbGqa",195,0.989899,40,198,2,196,1,2,1,3,2,94,93,103,103,92
"8032",31,"[40]iIvHoIpbqBkoADHvvIiwirbKDeellHtnJHqvbGqa",191,0.989691,40,194,2,192,1,2,1,3,2,88,87,105,105,92
"8033",32,"[40]iIvHoIpbqBkoADHvvIiwirbKDeellHtnJHqvbGqa",200,0.990148,40,203,2,201,1,2,1,3,2,99,98,103,103,92
"8034",33,"[40]iIvHoIpbqBkoADHvvIiwirbKDeellHtnJHqvbGqa",196,0.98995,40,199,2,197,1,2,1,3,2,94,93,104,104,92
"8035",34,"[40]iIvHoIpbqBkoADHvvIiwirbKDeellHtnJHqvbGqa",213,0.990741,40,216,2,214,1,2,1,3,2,119,118,96,96,92
"8036",35,"[40]iIvHoIpbqBkoADHvvIiwirbKDeellHtnJHqvbGqa",190,0.989637,40,193,2,191,1,2,1,3,2,86,85,106,106,92
"8037",36,"[40]iIvHoIpbqBkoADHvvIiwirbKDeellHtnJHqvbGqa",200,0.990148,40,203,2,201,1,2,1,3,2,102,101,100,100,92
"8038",37,"[40]iIvHoIpbqBkoADHvvIiwirbKDeellHtnJHqvbGqa",208,0.990521,40,211,2,209,1,2,1,3,2,113,112,97,97,92
"8039",38,"[40]iIvHoIpbqBkoADHvvIiwirbKDeellHtnJHqvbGqa",211,0.990654,40,214,2,212,1,2,1,3,2,114,113,99,99,92
"8040",39,"[40]iIvHoIpbqBkoADHvvIiwirbKDeellHtnJHqvbGqa",206,0.990431,40,209,2,207,1,2,1,3,2,110,109,98,98,92
"8041",40,"[40]iIvHoIpbqBkoADHvvIiwirbKDeellHtnJHqvbGqa",203,0.990291,40,206,2,204,1,2,1,3,2,105,104,100,100,92
"8042",41,"[40]iIvHoIpbqBkoADHvvIiwirbKDeellHtnJHqvbGqa",201,0.990196,40,204,2,202,1,2,1,3,2,99,98,104,104,92
"8043",42,"[40]iIvHoIpbqBkoADHvvIiwirbKDeellHtnJHqvbGqa",209,0.990566,40,212,2,210,1,2,1,3,2,114,113,97,97,92
"8044",43,"[40]iIvHoIpbqBkoADHvvIiwirbKDeellHtnJHqvbGqa",199,0.990099,40,202,2,200,1,2,1,3,2,98,97,103,103,92
"8045",44,"[40]iIvHoIpbqBkoADHvvIiwirbKDeellHtnJHqvbGqa",190,0.989637,40,193,2,191,1,2,1,3,2,87,86,105,105,92
"8046",45,"[40]iIvHoIpbqBkoADHvvIiwirbKDeellHtnJHqvbGqa",200,0.990148,40,203,2,201,1,2,1,3,2,101,100,101,101,92
"8047",46,"[40]iIvHoIpbqBkoADHvvIiwirbKDeellHtnJHqvbGqa",193,0.989796,40,196,2,194,1,2,1,3,2,91,90,104,104,92
"8048",47,"[40]iIvHoIpbqBkoADHvvIiwirbKDeellHtnJHqvbGqa",200,0.990148,40,203,2,201,1,2,1,3,2,101,100,101,101,92
"8049",48,"[40]iIvHoIpbqBkoADHvvIiwirbKDeellHtnJHqvbGqa",189,0.989583,40,192,2,190,1,2,1,3,2,84,83,107,107,92
"8050",49,"[40]iIvHoIpbqBkoADHvvIiwirbKDeellHtnJHqvbGqa",201,0.990196,40,204,2,202,1,2,1,3,2,101,100,102,102,92
"8051",50,"[40]iIvHoIpbqBkoADHvvIiwirbKDeellHtnJHqvbGqa",203,0.990291,40,206,2,204,1,2,1,3,2,104,103,101,101,92
"8052",51,"[40]iIvHoIpbqBkoADHvvIiwirbKDeellHtnJHqvbGqa",193,0.989796,40,196,2,194,1,2,1,3,2,91,90,104,104,92
"8053",52,"[40]iIvHoIpbqBkoADHvvIiwirbKDeellHtnJHqvbGqa",212,0.990698,40,215,2,213,1,2,1,3,2,118,117,96,96,92
"8054",53,"[40]iIvHoIpbqBkoADHvvIiwirbKDeellHtnJHqvbGqa",202,0.990244,40,205,2,203,1,2,1,3,2,102,101,102,102,92
"8055",54,"[40]iIvHoIpbqBkoADHvvIiwirbKDeellHtnJHqvbGqa",197,0.99,40,200,2,198,1,2,1,3,2,97,96,102,102,92
"8056",55,"[40]iIvHoIpbqBkoADHvvIiwirbKDeellHtnJHqvbGqa",212,0.990698,40,215,2,213,1,2,1,3,2,115,114,99,99,92
"8057",56,"[40]iIvHoIpbqBkoADHvvIiwirbKDeellHtnJHqvbGqa",206,0.990431,40,209,2,207,1,2,1,3,2,106,105,102,102,92
"8058",57,"[40]iIvHoIpbqBkoADHvvIiwirbKDeellHtnJHqvbGqa",207,0.990476,40,210,2,208,1,2,1,3,2,108,107,101,101,92
"8059",58,"[40]iIvHoIpbqBkoADHvvIiwirbKDeellHtnJHqvbGqa",208,0.990521,40,211,2,209,1,2,1,3,2,110,109,100,100,92
"8060",59,"[40]iIvHoIpbqBkoADHvvIiwirbKDeellHtnJHqvbGqa",219,0.990991,40,222,2,220,1,2,1,3,2,129,128,92,92,92
"8061",60,"[40]iIvHoIpbqBkoADHvvIiwirbKDeellHtnJHqvbGqa",200,0.990148,40,203,2,201,1,2,1,3,2,100,99,102,102,92
"8062",61,"[40]iIvHoIpbqBkoADHvvIiwirbKDeellHtnJHqvbGqa",203,0.990291,40,206,2,204,1,2,1,3,2,103,102,102,102,92
"8063",62,"[40]iIvHoIpbqBkoADHvvIiwirbKDeellHtnJHqvbGqa",211,0.990654,40,214,2,212,1,2,1,3,2,114,113,99,99,92
"8064",63,"[40]iIvHoIpbqBkoADHvvIiwirbKDeellHtnJHqvbGqa",209,0.990566,40,212,2,210,1,2,1,3,2,112,111,99,99,92
"8065",64,"[40]iIvHoIpbqBkoADHvvIiwirbKDeellHtnJHqvbGqa",216,0.990868,40,219,2,217,1,2,1,3,2,124,123,94,94,92
"8066",65,"[40]iIvHoIpbqBkoADHvvIiwirbKDeellHtnJHqvbGqa",200,0.990148,40,203,2,201,1,2,1,3,2,100,99,102,102,92
"8067",66,"[40]iIvHoIpbqBkoADHvvIiwirbKDeellHtnJHqvbGqa",194,0.989848,40,197,2,195,1,2,1,3,2,90,89,106,106,92
"8068",67,"[40]iIvHoIpbqBkoADHvvIiwirbKDeellHtnJHqvbGqa",204,0.990338,40,207,2,205,1,2,1,3,2,106,105,100,100,92
"8069",68,"[40]iIvHoIpbqBkoADHvvIiwirbKDeellHtnJHqvbGqa",213,0.990741,40,216,2,214,1,2,1,3,2,117,116,98,98,92
"8070",69,"[40]iIvHoIpbqBkoADHvvIiwirbKDeellHtnJHqvbGqa",189,0.989583,40,192,2,190,1,2,1,3,2,85,84,106,106,92
"8071",70,"[40]iIvHoIpbqBkoADHvvIiwirbKDeellHtnJHqvbGqa",200,0.990148,40,203,2,201,1,2,1,3,2,99,98,103,103,92
"8072",71,"[40]iIvHoIpbqBkoADHvvIiwirbKDeellHtnJHqvbGqa",209,0.990566,40,212,2,210,1,2,1,3,2,113,112,98,98,92
"8073",72,"[40]iIvHoIpbqBkoADHvvIiwirbKDeellHtnJHqvbGqa",197,0.99,40,200,2,198,1,2,1,3,2,95,94,104,104,92
"8074",73,"[40]iIvHoIpbqBkoADHvvIiwirbKDeellHtnJHqvbGqa",209,0.990566,40,212,2,210,1,2,1,3,2,113,112,98,98,92
"8075",74,"[40]iIvHoIpbqBkoADHvvIiwirbKDeellHtnJHqvbGqa",205,0.990385,40,208,2,206,1,2,1,3,2,108,107,99,99,92
"8076",75,"[40]iIvHoIpbqBkoADHvvIiwirbKDeellHtnJHqvbGqa",196,0.98995,40,199,2,197,1,2,1,3,2,95,94,103,103,92
"8077",76,"[40]iIvHoIpbqBkoADHvvIiwirbKDeellHtnJHqvbGqa",212,0.990698,40,215,2,213,1,2,1,3,2,118,117,96,96,92
"8078",77,"[40]iIvHoIpbqBkoADHvvIiwirbKDeellHtnJHqvbGqa",198,0.99005,40,201,2,199,1,2,1,3,2,99,98,101,101,92
"8079",78,"[40]iIvHoIpbqBkoADHvvIiwirbKDeellHtnJHqvbGqa",204,0.990338,40,207,2,205,1,2,1,3,2,106,105,100,100,92
"8080",79,"[40]iIvHoIpbqBkoADHvvIiwirbKDeellHtnJHqvbGqa",204,0.990338,40,207,2,205,1,2,1,3,2,108,107,98,98,92
"8081",80,"[40]iIvHoIpbqBkoADHvvIiwirbKDeellHtnJHqvbGqa",216,0.990868,40,219,2,217,1,2,1,3,2,123,122,95,95,92
"8082",81,"[40]iIvHoIpbqBkoADHvvIiwirbKDeellHtnJHqvbGqa",194,0.989848,40,197,2,195,1,2,1,3,2,93,92,103,103,92
"8083",82,"[40]iIvHoIpbqBkoADHvvIiwirbKDeellHtnJHqvbGqa",210,0.99061,40,213,2,211,1,2,1,3,2,114,113,98,98,92
"8084",83,"[40]iIvHoIpbqBkoADHvvIiwirbKDeellHtnJHqvbGqa",202,0.990244,40,205,2,203,1,2,1,3,2,102,101,102,102,92
"8085",84,"[40]iIvHoIpbqBkoADHvvIiwirbKDeellHtnJHqvbGqa",204,0.990338,40,207,2,205,1,2,1,3,2,106,105,100,100,92
"8086",85,"[40]iIvHoIpbqBkoADHvvIiwirbKDeellHtnJHqvbGqa",196,0.98995,40,199,2,197,1,2,1,3,2,95,94,103,103,92
"8087",86,"[40]iIvHoIpbqBkoADHvvIiwirbKDeellHtnJHqvbGqa",208,0.990521,40,211,2,209,1,2,1,3,2,111,110,99,99,92
"8088",87,"[40]iIvHoIpbqBkoADHvvIiwirbKDeellHtnJHqvbGqa",216,0.990868,40,219,2,217,1,2,1,3,2,122,121,96,96,92
"8089",88,"[40]iIvHoIpbqBkoADHvvIiwirbKDeellHtnJHqvbGqa",198,0.99005,40,201,2,199,1,2,1,3,2,97,96,103,103,92
"8090",89,"[40]iIvHoIpbqBkoADHvvIiwirbKDeellHtnJHqvbGqa",191,0.989691,40,194,2,192,1,2,1,3,2,88,87,105,105,92
"8091",90,"[40]iIvHoIpbqBkoADHvvIiwirbKDeellHtnJHqvbGqa",195,0.989899,40,198,2,196,1,2,1,3,2,91,90,106,106,92
"8092",91,"[40]iIvHoIpbqBkoADHvvIiwirbKDeellHtnJHqvbGqa",204,0.990338,40,207,2,205,1,2,1,3,2,104,103,102,102,92
"8093",92,"[40]iIvHoIpbqBkoADHvvIiwirbKDeellHtnJHqvbGqa",205,0.990385,40,208,2,206,1,2,1,3,2,107,106,100,100,92
"8094",93,"[40]iIvHoIpbqBkoADHvvIiwirbKDeellHtnJHqvbGqa",207,0.990476,40,210,2,208,1,2,1,3,2,112,111,97,97,92
"8095",94,"[40]iIvHoIpbqBkoADHvvIiwirbKDeellHtnJHqvbGqa",202,0.990244,40,205,2,203,1,2,1,3,2,106,105,98,98,92
"8096",95,"[40]iIvHoIpbqBkoADHvvIiwirbKDeellHtnJHqvbGqa",209,0.990566,40,212,2,210,1,2,1,3,2,113,112,98,98,92
"8097",96,"[40]iIvHoIpbqBkoADHvvIiwirbKDeellHtnJHqvbGqa",207,0.990476,40,210,2,208,1,2,1,3,2,109,108,100,100,92
"8098",97,"[40]iIvHoIpbqBkoADHvvIiwirbKDeellHtnJHqvbGqa",199,0.990099,40,202,2,200,1,2,1,3,2,99,98,102,102,92
"8099",98,"[40]iIvHoIpbqBkoADHvvIiwirbKDeellHtnJHqvbGqa",200,0.990148,40,203,2,201,1,2,1,3,2,101,100,101,101,92
"8100",99,"[40]iIvHoIpbqBkoADHvvIiwirbKDeellHtnJHqvbGqa",191,0.989691,40,194,2,192,1,2,1,3,2,89,88,104,104,92
"8101",0,"[40]lIuHoIvfxBkDnHvqghqEDsbKDaelkHunJHqvbGqa",199,0.990099,40,202,2,200,1,2,1,3,2,101,100,100,100,93
"8102",1,"[40]lIuHoIvfxBkDnHvqghqEDsbKDaelkHunJHqvbGqa",194,0.989848,40,197,2,195,1,2,1,3,2,94,93,102,102,93
"8103",2,"[40]lIuHoIvfxBkDnHvqghqEDsbKDaelkHunJHqvbGqa",205,0.990385,40,208,2,206,1,2,1,3,2,110,109,97,97,93
"8104",3,"[40]lIuHoIvfxBkDnHvqghqEDsbKDaelkHunJHqvbGqa",183,0.989247,40,186,2,184,1,2,1,3,2,76,75,109,109,93
"8105",4,"[40]lIuHoIvfxBkDnHvqghqEDsbKDaelkHunJHqvbGqa",194,0.989848,40,197,2,195,1,2,1,3,2,94,93,102,102,93
"8106",5,"[40]lIuHoIvfxBkDnHvqghqEDsbKDaelkHunJHqvbGqa",205,0.990385,40,208,2,206,1,2,1,3,2,109,108,98,98,93
"8107",6,"[40]lIuHoIvfxBkDnHvqghqEDsbKDaelkHunJHqvbGqa",202,0.990244,40,205,2,203,1,2,1,3,2,101,100,103,103,93
"8108",7,"[40]lIuHoIvfxBkDnHvqghqEDsbKDaelkHunJHqvbGqa",195,0.989899,40,198,2,196,1,2,1,3,2,95,94,102,102,93
"8109",8,"[40]lIuHoIvfxBkDnHvqghqEDsbKDaelkHunJHqvbGqa",192,0.989744,40,195,2,193,1,2,1,3,2,91,90,103,103,93
"8110",9,"[40]lIuHoIvfxBkDnHvqghqEDsbKDaelkHunJHqvbGqa",201,0.990196,40,204,2,202,1,2,1,3,2,103,102,100,100,93
"8111",10,"[40]lIuHoIvfxBkDnHvqghqEDsbKDaelkHunJHqvbGqa",196,0.98995,40,199,2,197,1,2,1,3,2,96,95,102,102,93
"8112",11,"[40]lIuHoIvfxBkDnHvqghqEDsbKDaelkHunJHqvbGqa",194,0.989848,40,197,2,195,1,2,1,3,2,93,92,103,103,93
"8113",12,"[40]lIuHoIvfxBkDnHvqghqEDsbKDaelkHunJHqvbGqa",194,0.989848,40,197,2,195,1,2,1,3,2,93,92,103,103,93
"8114",13,"[40]lIuHoIvfxBkDnHvqghqEDsbKDaelkHunJHqvbGqa",203,0.990291,40,206,2,204,1,2,1,3,2,103,102,102,102,93
"8115",14,"[40]lIuHoIvfxBkDnHvqghqEDsbKDaelkHunJHqvbGqa",202,0.990244,40,205,2,203,1,2,1,3,2,104,103,100,100,93
"8116",15,"[40]lIuHoIvfxBkDnHvqghqEDsbKDaelkHunJHqvbGqa",200,0.990148,40,203,2,201,1,2,1,3,2,102,101,100,100,93
"8117",16,"[40]lIuHoIvfxBkDnHvqghqEDsbKDaelkHunJHqvbGqa",199,0.990099,40,202,2,200,1,2,1,3,2,99,98,102,102,93
"8118",17,"[40]lIuHoIvfxBkDnHvqghqEDsbKDaelkHunJHqvbGqa",211,0.990654,40,214,2,212,1,2,1,3,2,115,114,98,98,93
"8119",18,"[40]lIuHoIvfxBkDnHvqghqEDsbKDaelkHunJHqvbGqa",202,0.990244,40,205,2,203,1,2,1,3,2,104,103,100,100,93
"8120",19,"[40]lIuHoIvfxBkDnHvqghqEDsbKDaelkHunJHqvbGqa",181,0.98913,40,184,2,182,1,2,1,3,2,76,75,107,107,93
"8121",20,"[40]lIuHoIvfxBkDnHvqghqEDsbKDaelkHunJHqvbGqa",202,0.990244,40,205,2,203,1,2,1,3,2,103,102,101,101,93
"8122",21,"[40]lIuHoIvfxBkDnHvqghqEDsbKDaelkHunJHqvbGqa",199,0.990099,40,202,2,200,1,2,1,3,2,99,98,102,102,93
"8123",22,"[40]lIuHoIvfxBkDnHvqghqEDsbKDaelkHunJHqvbGqa",203,0.990291,40,206,2,204,1,2,1,3,2,105,104,100,100,93
"8124",23,"[40]lIuHoIvfxBkDnHvqghqEDsbKDaelkHunJHqvbGqa",204,0.990338,40,207,2,205,1,2,1,3,2,106,105,100,100,93
"8125",24,"[40]lIuHoIvfxBkDnHvqghqEDsbKDaelkHunJHqvbGqa",195,0.989899,40,198,2,196,1,2,1,3,2,95,94,102,102,93
"8126",25,"[40]lIuHoIvfxBkDnHvqghqEDsbKDaelkHunJHqvbGqa",193,0.989796,40,196,2,194,1,2,1,3,2,92,91,103,103,93
"8127",26,"[40]lIuHoIvfxBkDnHvqghqEDsbKDaelkHunJHqvbGqa",199,0.990099,40,202,2,200,1,2,1,3,2,99,98,102,102,93
"8128",27,"[40]lIuHoIvfxBkDnHvqghqEDsbKDaelkHunJHqvbGqa",206,0.990431,40,209,2,207,1,2,1,3,2,110,109,98,98,93
"8129",28,"[40]lIuHoIvfxBkDnHvqghqEDsbKDaelkHunJHqvbGqa",195,0.989899,40,198,2,196,1,2,1,3,2,94,93,103,103,93
"8130",29,"[40]lIuHoIvfxBkDnHvqghqEDsbKDaelkHunJHqvbGqa",188,0.989529,40,191,2,189,1,2,1,3,2,85,84,105,105,93
"8131",30,"[40]lIuHoIvfxBkDnHvqghqEDsbKDaelkHunJHqvbGqa",198,0.99005,40,201,2,199,1,2,1,3,2,102,101,98,98,93
"8132",31,"[40]lIuHoIvfxBkDnHvqghqEDsbKDaelkHunJHqvbGqa",200,0.990148,40,203,2,201,1,2,1,3,2,101,100,101,101,93
"8133",32,"[40]lIuHoIvfxBkDnHvqghqEDsbKDaelkHunJHqvbGqa",190,0.989637,40,193,2,191,1,2,1,3,2,87,86,105,105,93
"8134",33,"[40]lIuHoIvfxBkDnHvqghqEDsbKDaelkHunJHqvbGqa",187,0.989474,40,190,2,188,1,2,1,3,2,83,82,106,106,93
"8135",34,"[40]lIuHoIvfxBkDnHvqghqEDsbKDaelkHunJHqvbGqa",196,0.98995,40,199,2,197,1,2,1,3,2,94,93,104,104,93
"8136",35,"[40]lIuHoIvfxBkDnHvqghqEDsbKDaelkHunJHqvbGqa",196,0.98995,40,199,2,197,1,2,1,3,2,98,97,100,100,93
"8137",36,"[40]lIuHoIvfxBkDnHvqghqEDsbKDaelkHunJHqvbGqa",200,0.990148,40,203,2,201,1,2,1,3,2,101,100,101,101,93
"8138",37,"[40]lIuHoIvfxBkDnHvqghqEDsbKDaelkHunJHqvbGqa",196,0.98995,40,199,2,197,1,2,1,3,2,95,94,103,103,93
"8139",38,"[40]lIuHoIvfxBkDnHvqghqEDsbKDaelkHunJHqvbGqa",200,0.990148,40,203,2,201,1,2,1,3,2,101,100,101,101,93
"8140",39,"[40]lIuHoIvfxBkDnHvqghqEDsbKDaelkHunJHqvbGqa",207,0.990476,40,210,2,208,1,2,1,3,2,110,109,99,99,93
"8141",40,"[40]lIuHoIvfxBkDnHvqghqEDsbKDaelkHunJHqvbGqa",210,0.99061,40,213,2,211,1,2,1,3,2,114,113,98,98,93
"8142",41,"[40]lIuHoIvfxBkDnHvqghqEDsbKDaelkHunJHqvbGqa",196,0.98995,40,199,2,197,1,2,1,3,2,94,93,104,104,93
"8143",42,"[40]lIuHoIvfxBkDnHvqghqEDsbKDaelkHunJHqvbGqa",202,0.990244,40,205,2,203,1,2,1,3,2,104,103,100,100,93
"8144",43,"[40]lIuHoIvfxBkDnHvqghqEDsbKDaelkHunJHqvbGqa",207,0.990476,40,210,2,208,1,2,1,3,2,113,112,96,96,93
"8145",44,"[40]lIuHoIvfxBkDnHvqghqEDsbKDaelkHunJHqvbGqa",198,0.99005,40,201,2,199,1,2,1,3,2,97,96,103,103,93
"8146",45,"[40]lIuHoIvfxBkDnHvqghqEDsbKDaelkHunJHqvbGqa",210,0.99061,40,213,2,211,1,2,1,3,2,114,113,98,98,93
"8147",46,"[40]lIuHoIvfxBkDnHvqghqEDsbKDaelkHunJHqvbGqa",214,0.990783,40,217,2,215,1,2,1,3,2,118,117,98,98,93
"8148",47,"[40]lIuHoIvfxBkDnHvqghqEDsbKDaelkHunJHqvbGqa",205,0.990385,40,208,2,206,1,2,1,3,2,106,105,101,101,93
"8149",48,"[40]lIuHoIvfxBkDnHvqghqEDsbKDaelkHunJHqvbGqa",187,0.989474,40,190,2,188,1,2,1,3,2,82,81,107,107,93
"8150",49,"[40]lIuHoIvfxBkDnHvqghqEDsbKDaelkHunJHqvbGqa",212,0.990698,40,215,2,213,1,2,1,3,2,117,116,97,97,93
"8151",50,"[40]lIuHoIvfxBkDnHvqghqEDsbKDaelkHunJHqvbGqa",197,0.99,40,200,2,198,1,2,1,3,2,98,97,101,101,93
"8152",51,"[40]lIuHoIvfxBkDnHvqghqEDsbKDaelkHunJHqvbGqa",198,0.99005,40,201,2,199,1,2,1,3,2,98,97,102,102,93
"8153",52,"[40]lIuHoIvfxBkDnHvqghqEDsbKDaelkHunJHqvbGqa",200,0.990148,40,203,2,201,1,2,1,3,2,100,99,102,102,93
"8154",53,"[40]lIuHoIvfxBkDnHvqghqEDsbKDaelkHunJHqvbGqa",189,0.989583,40,192,2,190,1,2,1,3,2,84,83,107,107,93
"8155",54,"[40]lIuHoIvfxBkDnHvqghqEDsbKDaelkHunJHqvbGqa",193,0.989796,40,196,2,194,1,2,1,3,2,92,91,103,103,93
"8156",55,"[40]lIuHoIvfxBkDnHvqghqEDsbKDaelkHunJHqvbGqa",191,0.989691,40,194,2,192,1,2,1,3,2,89,88,104,104,93
"8157",56,"[40]lIuHoIvfxBkDnHvqghqEDsbKDaelkHunJHqvbGqa",204,0.990338,40,207,2,205,1,2,1,3,2,107,106,99,99,93
"8158",57,"[40]lIuHoIvfxBkDnHvqghqEDsbKDaelkHunJHqvbGqa",189,0.989583,40,192,2,190,1,2,1,3,2,87,86,104,104,93
"8159",58,"[40]lIuHoIvfxBkDnHvqghqEDsbKDaelkHunJHqvbGqa",189,0.989583,40,192,2,190,1,2,1,3,2,83,82,108,108,93
"8160",59,"[40]lIuHoIvfxBkDnHvqghqEDsbKDaelkHunJHqvbGqa",193,0.989796,40,196,2,194,1,2,1,3,2,88,87,107,107,93
"8161",60,"[40]lIuHoIvfxBkDnHvqghqEDsbKDaelkHunJHqvbGqa",191,0.989691,40,194,2,192,1,2,1,3,2,88,87,105,105,93
"8162",61,"[40]lIuHoIvfxBkDnHvqghqEDsbKDaelkHunJHqvbGqa",211,0.990654,40,214,2,212,1,2,1,3,2,117,116,96,96,93
"8163",62,"[40]lIuHoIvfxBkDnHvqghqEDsbKDaelkHunJHqvbGqa",208,0.990521,40,211,2,209,1,2,1,3,2,111,110,99,99,93
"8164",63,"[40]lIuHoIvfxBkDnHvqghqEDsbKDaelkHunJHqvbGqa",192,0.989744,40,195,2,193,1,2,1,3,2,92,91,102,102,93
"8165",64,"[40]lIuHoIvfxBkDnHvqghqEDsbKDaelkHunJHqvbGqa",193,0.989796,40,196,2,194,1,2,1,3,2,91,90,104,104,93
"8166",65,"[40]lIuHoIvfxBkDnHvqghqEDsbKDaelkHunJHqvbGqa",192,0.989744,40,195,2,193,1,2,1,3,2,90,89,104,104,93
"8167",66,"[40]lIuHoIvfxBkDnHvqghqEDsbKDaelkHunJHqvbGqa",200,0.990148,40,203,2,201,1,2,1,3,2,99,98,103,103,93
"8168",67,"[40]lIuHoIvfxBkDnHvqghqEDsbKDaelkHunJHqvbGqa",191,0.989691,40,194,2,192,1,2,1,3,2,89,88,104,104,93
"8169",68,"[40]lIuHoIvfxBkDnHvqghqEDsbKDaelkHunJHqvbGqa",199,0.990099,40,202,2,200,1,2,1,3,2,100,99,101,101,93
"8170",69,"[40]lIuHoIvfxBkDnHvqghqEDsbKDaelkHunJHqvbGqa",204,0.990338,40,207,2,205,1,2,1,3,2,109,108,97,97,93
"8171",70,"[40]lIuHoIvfxBkDnHvqghqEDsbKDaelkHunJHqvbGqa",190,0.989637,40,193,2,191,1,2,1,3,2,87,86,105,105,93
"8172",71,"[40]lIuHoIvfxBkDnHvqghqEDsbKDaelkHunJHqvbGqa",211,0.990654,40,214,2,212,1,2,1,3,2,118,117,95,95,93
"8173",72,"[40]lIuHoIvfxBkDnHvqghqEDsbKDaelkHunJHqvbGqa",199,0.990099,40,202,2,200,1,2,1,3,2,99,98,102,102,93
"8174",73,"[40]lIuHoIvfxBkDnHvqghqEDsbKDaelkHunJHqvbGqa",200,0.990148,40,203,2,201,1,2,1,3,2,102,101,100,100,93
"8175",74,"[40]lIuHoIvfxBkDnHvqghqEDsbKDaelkHunJHqvbGqa",215,0.990826,40,218,2,216,1,2,1,3,2,122,121,95,95,93
"8176",75,"[40]lIuHoIvfxBkDnHvqghqEDsbKDaelkHunJHqvbGqa",226,0.991266,40,229,2,227,1,2,1,3,2,141,140,87,87,93
"8177",76,"[40]lIuHoIvfxBkDnHvqghqEDsbKDaelkHunJHqvbGqa",201,0.990196,40,204,2,202,1,2,1,3,2,99,98,104,104,93
"8178",77,"[40]lIuHoIvfxBkDnHvqghqEDsbKDaelkHunJHqvbGqa",215,0.990826,40,218,2,216,1,2,1,3,2,123,122,94,94,93
"8179",78,"[40]lIuHoIvfxBkDnHvqghqEDsbKDaelkHunJHqvbGqa",206,0.990431,40,209,2,207,1,2,1,3,2,106,105,102,102,93
"8180",79,"[40]lIuHoIvfxBkDnHvqghqEDsbKDaelkHunJHqvbGqa",201,0.990196,40,204,2,202,1,2,1,3,2,103,102,100,100,93
"8181",80,"[40]lIuHoIvfxBkDnHvqghqEDsbKDaelkHunJHqvbGqa",207,0.990476,40,210,2,208,1,2,1,3,2,109,108,100,100,93
"8182",81,"[40]lIuHoIvfxBkDnHvqghqEDsbKDaelkHunJHqvbGqa",190,0.989637,40,193,2,191,1,2,1,3,2,83,82,109,109,93
"8183",82,"[40]lIuHoIvfxBkDnHvqghqEDsbKDaelkHunJHqvbGqa",208,0.990521,40,211,2,209,1,2,1,3,2,111,110,99,99,93
"8184",83,"[40]lIuHoIvfxBkDnHvqghqEDsbKDaelkHunJHqvbGqa",206,0.990431,40,209,2,207,1,2,1,3,2,111,110,97,97,93
"8185",84,"[40]lIuHoIvfxBkDnHvqghqEDsbKDaelkHunJHqvbGqa",196,0.98995,40,199,2,197,1,2,1,3,2,96,95,102,102,93
"8186",85,"[40]lIuHoIvfxBkDnHvqghqEDsbKDaelkHunJHqvbGqa",201,0.990196,40,204,2,202,1,2,1,3,2,103,102,100,100,93
"8187",86,"[40]lIuHoIvfxBkDnHvqghqEDsbKDaelkHunJHqvbGqa",214,0.990783,40,217,2,215,1,2,1,3,2,119,118,97,97,93
"8188",87,"[40]lIuHoIvfxBkDnHvqghqEDsbKDaelkHunJHqvbGqa",195,0.989899,40,198,2,196,1,2,1,3,2,94,93,103,103,93
"8189",88,"[40]lIuHoIvfxBkDnHvqghqEDsbKDaelkHunJHqvbGqa",212,0.990698,40,215,2,213,1,2,1,3,2,118,117,96,96,93
"8190",89,"[40]lIuHoIvfxBkDnHvqghqEDsbKDaelkHunJHqvbGqa",206,0.990431,40,209,2,207,1,2,1,3,2,109,108,99,99,93
"8191",90,"[40]lIuHoIvfxBkDnHvqghqEDsbKDaelkHunJHqvbGqa",199,0.990099,40,202,2,200,1,2,1,3,2,100,99,101,101,93
"8192",91,"[40]lIuHoIvfxBkDnHvqghqEDsbKDaelkHunJHqvbGqa",205,0.990385,40,208,2,206,1,2,1,3,2,109,108,98,98,93
"8193",92,"[40]lIuHoIvfxBkDnHvqghqEDsbKDaelkHunJHqvbGqa",197,0.99,40,200,2,198,1,2,1,3,2,97,96,102,102,93
"8194",93,"[40]lIuHoIvfxBkDnHvqghqEDsbKDaelkHunJHqvbGqa",204,0.990338,40,207,2,205,1,2,1,3,2,106,105,100,100,93
"8195",94,"[40]lIuHoIvfxBkDnHvqghqEDsbKDaelkHunJHqvbGqa",194,0.989848,40,197,2,195,1,2,1,3,2,94,93,102,102,93
"8196",95,"[40]lIuHoIvfxBkDnHvqghqEDsbKDaelkHunJHqvbGqa",202,0.990244,40,205,2,203,1,2,1,3,2,101,100,103,103,93
"8197",96,"[40]lIuHoIvfxBkDnHvqghqEDsbKDaelkHunJHqvbGqa",190,0.989637,40,193,2,191,1,2,1,3,2,88,87,104,104,93
"8198",97,"[40]lIuHoIvfxBkDnHvqghqEDsbKDaelkHunJHqvbGqa",211,0.990654,40,214,2,212,1,2,1,3,2,115,114,98,98,93
"8199",98,"[40]lIuHoIvfxBkDnHvqghqEDsbKDaelkHunJHqvbGqa",210,0.99061,40,213,2,211,1,2,1,3,2,114,113,98,98,93
"8200",99,"[40]lIuHoIvfxBkDnHvqghqEDsbKDaelkHunJHqvbGqa",209,0.990566,40,212,2,210,1,2,1,3,2,112,111,99,99,93
"8201",0,"[40]kIhHoIvtrBkDHznBpHEJbIbKDaeauHwnJHqvbGqa",199,0.990099,40,202,2,200,1,2,1,3,2,98,97,103,103,94
"8202",1,"[40]kIhHoIvtrBkDHznBpHEJbIbKDaeauHwnJHqvbGqa",200,0.990148,40,203,2,201,1,2,1,3,2,99,98,103,103,94
"8203",2,"[40]kIhHoIvtrBkDHznBpHEJbIbKDaeauHwnJHqvbGqa",213,0.990741,40,216,2,214,1,2,1,3,2,118,117,97,97,94
"8204",3,"[40]kIhHoIvtrBkDHznBpHEJbIbKDaeauHwnJHqvbGqa",205,0.990385,40,208,2,206,1,2,1,3,2,111,110,96,96,94
"8205",4,"[40]kIhHoIvtrBkDHznBpHEJbIbKDaeauHwnJHqvbGqa",207,0.990476,40,210,2,208,1,2,1,3,2,113,112,96,96,94
"8206",5,"[40]kIhHoIvtrBkDHznBpHEJbIbKDaeauHwnJHqvbGqa",216,0.990868,40,219,2,217,1,2,1,3,2,123,122,95,95,94
"8207",6,"[40]kIhHoIvtrBkDHznBpHEJbIbKDaeauHwnJHqvbGqa",203,0.990291,40,206,2,204,1,2,1,3,2,105,104,100,100,94
"8208",7,"[40]kIhHoIvtrBkDHznBpHEJbIbKDaeauHwnJHqvbGqa",211,0.990654,40,214,2,212,1,2,1,3,2,119,118,94,94,94
"8209",8,"[40]kIhHoIvtrBkDHznBpHEJbIbKDaeauHwnJHqvbGqa",202,0.990244,40,205,2,203,1,2,1,3,2,103,102,101,101,94
"8210",9,"[40]kIhHoIvtrBkDHznBpHEJbIbKDaeauHwnJHqvbGqa",200,0.990148,40,203,2,201,1,2,1,3,2,101,100,101,101,94
"8211",10,"[40]kIhHoIvtrBkDHznBpHEJbIbKDaeauHwnJHqvbGqa",196,0.98995,40,199,2,197,1,2,1,3,2,95,94,103,103,94
"8212",11,"[40]kIhHoIvtrBkDHznBpHEJbIbKDaeauHwnJHqvbGqa",207,0.990476,40,210,2,208,1,2,1,3,2,111,110,98,98,94
"8213",12,"[40]kIhHoIvtrBkDHznBpHEJbIbKDaeauHwnJHqvbGqa",202,0.990244,40,205,2,203,1,2,1,3,2,106,105,98,98,94
"8214",13,"[40]kIhHoIvtrBkDHznBpHEJbIbKDaeauHwnJHqvbGqa",200,0.990148,40,203,2,201,1,2,1,3,2,104,103,98,98,94
"8215",14,"[40]kIhHoIvtrBkDHznBpHEJbIbKDaeauHwnJHqvbGqa",213,0.990741,40,216,2,214,1,2,1,3,2,119,118,96,96,94
"8216",15,"[40]kIhHoIvtrBkDHznBpHEJbIbKDaeauHwnJHqvbGqa",191,0.989691,40,194,2,192,1,2,1,3,2,89,88,104,104,94
"8217",16,"[40]kIhHoIvtrBkDHznBpHEJbIbKDaeauHwnJHqvbGqa",199,0.990099,40,202,2,200,1,2,1,3,2,97,96,104,104,94
"8218",17,"[40]kIhHoIvtrBkDHznBpHEJbIbKDaeauHwnJHqvbGqa",200,0.990148,40,203,2,201,1,2,1,3,2,101,100,101,101,94
"8219",18,"[40]kIhHoIvtrBkDHznBpHEJbIbKDaeauHwnJHqvbGqa",212,0.990698,40,215,2,213,1,2,1,3,2,118,117,96,96,94
"8220",19,"[40]kIhHoIvtrBkDHznBpHEJbIbKDaeauHwnJHqvbGqa",203,0.990291,40,206,2,204,1,2,1,3,2,107,106,98,98,94
"8221",20,"[40]kIhHoIvtrBkDHznBpHEJbIbKDaeauHwnJHqvbGqa",201,0.990196,40,204,2,202,1,2,1,3,2,104,103,99,99,94
"8222",21,"[40]kIhHoIvtrBkDHznBpHEJbIbKDaeauHwnJHqvbGqa",197,0.99,40,200,2,198,1,2,1,3,2,96,95,103,103,94
"8223",22,"[40]kIhHoIvtrBkDHznBpHEJbIbKDaeauHwnJHqvbGqa",200,0.990148,40,203,2,201,1,2,1,3,2,101,100,101,101,94
"8224",23,"[40]kIhHoIvtrBkDHznBpHEJbIbKDaeauHwnJHqvbGqa",209,0.990566,40,212,2,210,1,2,1,3,2,114,113,97,97,94
"8225",24,"[40]kIhHoIvtrBkDHznBpHEJbIbKDaeauHwnJHqvbGqa",213,0.990741,40,216,2,214,1,2,1,3,2,120,119,95,95,94
"8226",25,"[40]kIhHoIvtrBkDHznBpHEJbIbKDaeauHwnJHqvbGqa",216,0.990868,40,219,2,217,1,2,1,3,2,125,124,93,93,94
"8227",26,"[40]kIhHoIvtrBkDHznBpHEJbIbKDaeauHwnJHqvbGqa",211,0.990654,40,214,2,212,1,2,1,3,2,118,117,95,95,94
"8228",27,"[40]kIhHoIvtrBkDHznBpHEJbIbKDaeauHwnJHqvbGqa",200,0.990148,40,203,2,201,1,2,1,3,2,98,97,104,104,94
"8229",28,"[40]kIhHoIvtrBkDHznBpHEJbIbKDaeauHwnJHqvbGqa",195,0.989899,40,198,2,196,1,2,1,3,2,95,94,102,102,94
"8230",29,"[40]kIhHoIvtrBkDHznBpHEJbIbKDaeauHwnJHqvbGqa",190,0.989637,40,193,2,191,1,2,1,3,2,86,85,106,106,94
"8231",30,"[40]kIhHoIvtrBkDHznBpHEJbIbKDaeauHwnJHqvbGqa",201,0.990196,40,204,2,202,1,2,1,3,2,101,100,102,102,94
"8232",31,"[40]kIhHoIvtrBkDHznBpHEJbIbKDaeauHwnJHqvbGqa",207,0.990476,40,210,2,208,1,2,1,3,2,111,110,98,98,94
"8233",32,"[40]kIhHoIvtrBkDHznBpHEJbIbKDaeauHwnJHqvbGqa",194,0.989848,40,197,2,195,1,2,1,3,2,91,90,105,105,94
"8234",33,"[40]kIhHoIvtrBkDHznBpHEJbIbKDaeauHwnJHqvbGqa",207,0.990476,40,210,2,208,1,2,1,3,2,114,113,95,95,94
"8235",34,"[40]kIhHoIvtrBkDHznBpHEJbIbKDaeauHwnJHqvbGqa",197,0.99,40,200,2,198,1,2,1,3,2,98,97,101,101,94
"8236",35,"[40]kIhHoIvtrBkDHznBpHEJbIbKDaeauHwnJHqvbGqa",187,0.989474,40,190,2,188,1,2,1,3,2,85,84,104,104,94
"8237",36,"[40]kIhHoIvtrBkDHznBpHEJbIbKDaeauHwnJHqvbGqa",198,0.99005,40,201,2,199,1,2,1,3,2,97,96,103,103,94
"8238",37,"[40]kIhHoIvtrBkDHznBpHEJbIbKDaeauHwnJHqvbGqa",211,0.990654,40,214,2,212,1,2,1,3,2,117,116,96,96,94
"8239",38,"[40]kIhHoIvtrBkDHznBpHEJbIbKDaeauHwnJHqvbGqa",212,0.990698,40,215,2,213,1,2,1,3,2,117,116,97,97,94
"8240",39,"[40]kIhHoIvtrBkDHznBpHEJbIbKDaeauHwnJHqvbGqa",204,0.990338,40,207,2,205,1,2,1,3,2,107,106,99,99,94
"8241",40,"[40]kIhHoIvtrBkDHznBpHEJbIbKDaeauHwnJHqvbGqa",196,0.98995,40,199,2,197,1,2,1,3,2,95,94,103,103,94
"8242",41,"[40]kIhHoIvtrBkDHznBpHEJbIbKDaeauHwnJHqvbGqa",201,0.990196,40,204,2,202,1,2,1,3,2,101,100,102,102,94
"8243",42,"[40]kIhHoIvtrBkDHznBpHEJbIbKDaeauHwnJHqvbGqa",206,0.990431,40,209,2,207,1,2,1,3,2,113,112,95,95,94
"8244",43,"[40]kIhHoIvtrBkDHznBpHEJbIbKDaeauHwnJHqvbGqa",207,0.990476,40,210,2,208,1,2,1,3,2,113,112,96,96,94
"8245",44,"[40]kIhHoIvtrBkDHznBpHEJbIbKDaeauHwnJHqvbGqa",198,0.99005,40,201,2,199,1,2,1,3,2,100,99,100,100,94
"8246",45,"[40]kIhHoIvtrBkDHznBpHEJbIbKDaeauHwnJHqvbGqa",210,0.99061,40,213,2,211,1,2,1,3,2,116,115,96,96,94
"8247",46,"[40]kIhHoIvtrBkDHznBpHEJbIbKDaeauHwnJHqvbGqa",209,0.990566,40,212,2,210,1,2,1,3,2,114,113,97,97,94
"8248",47,"[40]kIhHoIvtrBkDHznBpHEJbIbKDaeauHwnJHqvbGqa",209,0.990566,40,212,2,210,1,2,1,3,2,114,113,97,97,94
"8249",48,"[40]kIhHoIvtrBkDHznBpHEJbIbKDaeauHwnJHqvbGqa",216,0.990868,40,219,2,217,1,2,1,3,2,124,123,94,94,94
"8250",49,"[40]kIhHoIvtrBkDHznBpHEJbIbKDaeauHwnJHqvbGqa",184,0.989305,40,187,2,185,1,2,1,3,2,77,76,109,109,94
"8251",50,"[40]kIhHoIvtrBkDHznBpHEJbIbKDaeauHwnJHqvbGqa",198,0.99005,40,201,2,199,1,2,1,3,2,98,97,102,102,94
"8252",51,"[40]kIhHoIvtrBkDHznBpHEJbIbKDaeauHwnJHqvbGqa",205,0.990385,40,208,2,206,1,2,1,3,2,106,105,101,101,94
"8253",52,"[40]kIhHoIvtrBkDHznBpHEJbIbKDaeauHwnJHqvbGqa",216,0.990868,40,219,2,217,1,2,1,3,2,123,122,95,95,94
"8254",53,"[40]kIhHoIvtrBkDHznBpHEJbIbKDaeauHwnJHqvbGqa",200,0.990148,40,203,2,201,1,2,1,3,2,101,100,101,101,94
"8255",54,"[40]kIhHoIvtrBkDHznBpHEJbIbKDaeauHwnJHqvbGqa",189,0.989583,40,192,2,190,1,2,1,3,2,88,87,103,103,94
"8256",55,"[40]kIhHoIvtrBkDHznBpHEJbIbKDaeauHwnJHqvbGqa",187,0.989474,40,190,2,188,1,2,1,3,2,85,84,104,104,94
"8257",56,"[40]kIhHoIvtrBkDHznBpHEJbIbKDaeauHwnJHqvbGqa",200,0.990148,40,203,2,201,1,2,1,3,2,103,102,99,99,94
"8258",57,"[40]kIhHoIvtrBkDHznBpHEJbIbKDaeauHwnJHqvbGqa",202,0.990244,40,205,2,203,1,2,1,3,2,102,101,102,102,94
"8259",58,"[40]kIhHoIvtrBkDHznBpHEJbIbKDaeauHwnJHqvbGqa",199,0.990099,40,202,2,200,1,2,1,3,2,99,98,102,102,94
"8260",59,"[40]kIhHoIvtrBkDHznBpHEJbIbKDaeauHwnJHqvbGqa",202,0.990244,40,205,2,203,1,2,1,3,2,103,102,101,101,94
"8261",60,"[40]kIhHoIvtrBkDHznBpHEJbIbKDaeauHwnJHqvbGqa",187,0.989474,40,190,2,188,1,2,1,3,2,85,84,104,104,94
"8262",61,"[40]kIhHoIvtrBkDHznBpHEJbIbKDaeauHwnJHqvbGqa",198,0.99005,40,201,2,199,1,2,1,3,2,99,98,101,101,94
"8263",62,"[40]kIhHoIvtrBkDHznBpHEJbIbKDaeauHwnJHqvbGqa",193,0.989796,40,196,2,194,1,2,1,3,2,93,92,102,102,94
"8264",63,"[40]kIhHoIvtrBkDHznBpHEJbIbKDaeauHwnJHqvbGqa",182,0.989189,40,185,2,183,1,2,1,3,2,76,75,108,108,94
"8265",64,"[40]kIhHoIvtrBkDHznBpHEJbIbKDaeauHwnJHqvbGqa",212,0.990698,40,215,2,213,1,2,1,3,2,117,116,97,97,94
"8266",65,"[40]kIhHoIvtrBkDHznBpHEJbIbKDaeauHwnJHqvbGqa",205,0.990385,40,208,2,206,1,2,1,3,2,107,106,100,100,94
"8267",66,"[40]kIhHoIvtrBkDHznBpHEJbIbKDaeauHwnJHqvbGqa",204,0.990338,40,207,2,205,1,2,1,3,2,105,104,101,101,94
"8268",67,"[40]kIhHoIvtrBkDHznBpHEJbIbKDaeauHwnJHqvbGqa",202,0.990244,40,205,2,203,1,2,1,3,2,104,103,100,100,94
"8269",68,"[40]kIhHoIvtrBkDHznBpHEJbIbKDaeauHwnJHqvbGqa",203,0.990291,40,206,2,204,1,2,1,3,2,104,103,101,101,94
"8270",69,"[40]kIhHoIvtrBkDHznBpHEJbIbKDaeauHwnJHqvbGqa",190,0.989637,40,193,2,191,1,2,1,3,2,88,87,104,104,94
"8271",70,"[40]kIhHoIvtrBkDHznBpHEJbIbKDaeauHwnJHqvbGqa",203,0.990291,40,206,2,204,1,2,1,3,2,106,105,99,99,94
"8272",71,"[40]kIhHoIvtrBkDHznBpHEJbIbKDaeauHwnJHqvbGqa",209,0.990566,40,212,2,210,1,2,1,3,2,115,114,96,96,94
"8273",72,"[40]kIhHoIvtrBkDHznBpHEJbIbKDaeauHwnJHqvbGqa",196,0.98995,40,199,2,197,1,2,1,3,2,96,95,102,102,94
"8274",73,"[40]kIhHoIvtrBkDHznBpHEJbIbKDaeauHwnJHqvbGqa",194,0.989848,40,197,2,195,1,2,1,3,2,94,93,102,102,94
"8275",74,"[40]kIhHoIvtrBkDHznBpHEJbIbKDaeauHwnJHqvbGqa",205,0.990385,40,208,2,206,1,2,1,3,2,109,108,98,98,94
"8276",75,"[40]kIhHoIvtrBkDHznBpHEJbIbKDaeauHwnJHqvbGqa",203,0.990291,40,206,2,204,1,2,1,3,2,106,105,99,99,94
"8277",76,"[40]kIhHoIvtrBkDHznBpHEJbIbKDaeauHwnJHqvbGqa",211,0.990654,40,214,2,212,1,2,1,3,2,115,114,98,98,94
"8278",77,"[40]kIhHoIvtrBkDHznBpHEJbIbKDaeauHwnJHqvbGqa",204,0.990338,40,207,2,205,1,2,1,3,2,106,105,100,100,94
"8279",78,"[40]kIhHoIvtrBkDHznBpHEJbIbKDaeauHwnJHqvbGqa",204,0.990338,40,207,2,205,1,2,1,3,2,105,104,101,101,94
"8280",79,"[40]kIhHoIvtrBkDHznBpHEJbIbKDaeauHwnJHqvbGqa",207,0.990476,40,210,2,208,1,2,1,3,2,108,107,101,101,94
"8281",80,"[40]kIhHoIvtrBkDHznBpHEJbIbKDaeauHwnJHqvbGqa",195,0.989899,40,198,2,196,1,2,1,3,2,94,93,103,103,94
"8282",81,"[40]kIhHoIvtrBkDHznBpHEJbIbKDaeauHwnJHqvbGqa",205,0.990385,40,208,2,206,1,2,1,3,2,108,107,99,99,94
"8283",82,"[40]kIhHoIvtrBkDHznBpHEJbIbKDaeauHwnJHqvbGqa",202,0.990244,40,205,2,203,1,2,1,3,2,102,101,102,102,94
"8284",83,"[40]kIhHoIvtrBkDHznBpHEJbIbKDaeauHwnJHqvbGqa",211,0.990654,40,214,2,212,1,2,1,3,2,115,114,98,98,94
"8285",84,"[40]kIhHoIvtrBkDHznBpHEJbIbKDaeauHwnJHqvbGqa",208,0.990521,40,211,2,209,1,2,1,3,2,111,110,99,99,94
"8286",85,"[40]kIhHoIvtrBkDHznBpHEJbIbKDaeauHwnJHqvbGqa",216,0.990868,40,219,2,217,1,2,1,3,2,121,120,97,97,94
"8287",86,"[40]kIhHoIvtrBkDHznBpHEJbIbKDaeauHwnJHqvbGqa",197,0.99,40,200,2,198,1,2,1,3,2,98,97,101,101,94
"8288",87,"[40]kIhHoIvtrBkDHznBpHEJbIbKDaeauHwnJHqvbGqa",196,0.98995,40,199,2,197,1,2,1,3,2,95,94,103,103,94
"8289",88,"[40]kIhHoIvtrBkDHznBpHEJbIbKDaeauHwnJHqvbGqa",200,0.990148,40,203,2,201,1,2,1,3,2,101,100,101,101,94
"8290",89,"[40]kIhHoIvtrBkDHznBpHEJbIbKDaeauHwnJHqvbGqa",207,0.990476,40,210,2,208,1,2,1,3,2,112,111,97,97,94
"8291",90,"[40]kIhHoIvtrBkDHznBpHEJbIbKDaeauHwnJHqvbGqa",220,0.991031,40,223,2,221,1,2,1,3,2,128,127,94,94,94
"8292",91,"[40]kIhHoIvtrBkDHznBpHEJbIbKDaeauHwnJHqvbGqa",203,0.990291,40,206,2,204,1,2,1,3,2,103,102,102,102,94
"8293",92,"[40]kIhHoIvtrBkDHznBpHEJbIbKDaeauHwnJHqvbGqa",189,0.989583,40,192,2,190,1,2,1,3,2,86,85,105,105,94
"8294",93,"[40]kIhHoIvtrBkDHznBpHEJbIbKDaeauHwnJHqvbGqa",198,0.99005,40,201,2,199,1,2,1,3,2,100,99,100,100,94
"8295",94,"[40]kIhHoIvtrBkDHznBpHEJbIbKDaeauHwnJHqvbGqa",196,0.98995,40,199,2,197,1,2,1,3,2,96,95,102,102,94
"8296",95,"[40]kIhHoIvtrBkDHznBpHEJbIbKDaeauHwnJHqvbGqa",207,0.990476,40,210,2,208,1,2,1,3,2,109,108,100,100,94
"8297",96,"[40]kIhHoIvtrBkDHznBpHEJbIbKDaeauHwnJHqvbGqa",200,0.990148,40,203,2,201,1,2,1,3,2,101,100,101,101,94
"8298",97,"[40]kIhHoIvtrBkDHznBpHEJbIbKDaeauHwnJHqvbGqa",201,0.990196,40,204,2,202,1,2,1,3,2,101,100,102,102,94
"8299",98,"[40]kIhHoIvtrBkDHznBpHEJbIbKDaeauHwnJHqvbGqa",212,0.990698,40,215,2,213,1,2,1,3,2,117,116,97,97,94
"8300",99,"[40]kIhHoIvtrBkDHznBpHEJbIbKDaeauHwnJHqvbGqa",201,0.990196,40,204,2,202,1,2,1,3,2,106,105,97,97,94
"8301",0,"[40]cIfHoIAvBkDmfzwzhtvtGybKDaeGhHsnJHqvbGqa",190,0.989637,40,193,2,191,1,2,1,3,2,88,87,104,104,95
"8302",1,"[40]cIfHoIAvBkDmfzwzhtvtGybKDaeGhHsnJHqvbGqa",212,0.990698,40,215,2,213,1,2,1,3,2,116,115,98,98,95
"8303",2,"[40]cIfHoIAvBkDmfzwzhtvtGybKDaeGhHsnJHqvbGqa",187,0.989474,40,190,2,188,1,2,1,3,2,82,81,107,107,95
"8304",3,"[40]cIfHoIAvBkDmfzwzhtvtGybKDaeGhHsnJHqvbGqa",197,0.99,40,200,2,198,1,2,1,3,2,98,97,101,101,95
"8305",4,"[40]cIfHoIAvBkDmfzwzhtvtGybKDaeGhHsnJHqvbGqa",208,0.990521,40,211,2,209,1,2,1,3,2,111,110,99,99,95
"8306",5,"[40]cIfHoIAvBkDmfzwzhtvtGybKDaeGhHsnJHqvbGqa",209,0.990566,40,212,2,210,1,2,1,3,2,115,114,96,96,95
"8307",6,"[40]cIfHoIAvBkDmfzwzhtvtGybKDaeGhHsnJHqvbGqa",197,0.99,40,200,2,198,1,2,1,3,2,95,94,104,104,95
"8308",7,"[40]cIfHoIAvBkDmfzwzhtvtGybKDaeGhHsnJHqvbGqa",209,0.990566,40,212,2,210,1,2,1,3,2,112,111,99,99,95
"8309",8,"[40]cIfHoIAvBkDmfzwzhtvtGybKDaeGhHsnJHqvbGqa",204,0.990338,40,207,2,205,1,2,1,3,2,106,105,100,100,95
"8310",9,"[40]cIfHoIAvBkDmfzwzhtvtGybKDaeGhHsnJHqvbGqa",201,0.990196,40,204,2,202,1,2,1,3,2,103,102,100,100,95
"8311",10,"[40]cIfHoIAvBkDmfzwzhtvtGybKDaeGhHsnJHqvbGqa",197,0.99,40,200,2,198,1,2,1,3,2,99,98,100,100,95
"8312",11,"[40]cIfHoIAvBkDmfzwzhtvtGybKDaeGhHsnJHqvbGqa",205,0.990385,40,208,2,206,1,2,1,3,2,108,107,99,99,95
"8313",12,"[40]cIfHoIAvBkDmfzwzhtvtGybKDaeGhHsnJHqvbGqa",197,0.99,40,200,2,198,1,2,1,3,2,97,96,102,102,95
"8314",13,"[40]cIfHoIAvBkDmfzwzhtvtGybKDaeGhHsnJHqvbGqa",207,0.990476,40,210,2,208,1,2,1,3,2,111,110,98,98,95
"8315",14,"[40]cIfHoIAvBkDmfzwzhtvtGybKDaeGhHsnJHqvbGqa",214,0.990783,40,217,2,215,1,2,1,3,2,119,118,97,97,95
"8316",15,"[40]cIfHoIAvBkDmfzwzhtvtGybKDaeGhHsnJHqvbGqa",198,0.99005,40,201,2,199,1,2,1,3,2,97,96,103,103,95
"8317",16,"[40]cIfHoIAvBkDmfzwzhtvtGybKDaeGhHsnJHqvbGqa",191,0.989691,40,194,2,192,1,2,1,3,2,90,89,103,103,95
"8318",17,"[40]cIfHoIAvBkDmfzwzhtvtGybKDaeGhHsnJHqvbGqa",207,0.990476,40,210,2,208,1,2,1,3,2,109,108,100,100,95
"8319",18,"[40]cIfHoIAvBkDmfzwzhtvtGybKDaeGhHsnJHqvbGqa",191,0.989691,40,194,2,192,1,2,1,3,2,89,88,104,104,95
"8320",19,"[40]cIfHoIAvBkDmfzwzhtvtGybKDaeGhHsnJHqvbGqa",200,0.990148,40,203,2,201,1,2,1,3,2,101,100,101,101,95
"8321",20,"[40]cIfHoIAvBkDmfzwzhtvtGybKDaeGhHsnJHqvbGqa",191,0.989691,40,194,2,192,1,2,1,3,2,88,87,105,105,95
"8322",21,"[40]cIfHoIAvBkDmfzwzhtvtGybKDaeGhHsnJHqvbGqa",187,0.989474,40,190,2,188,1,2,1,3,2,83,82,106,106,95
"8323",22,"[40]cIfHoIAvBkDmfzwzhtvtGybKDaeGhHsnJHqvbGqa",216,0.990868,40,219,2,217,1,2,1,3,2,125,124,93,93,95
"8324",23,"[40]cIfHoIAvBkDmfzwzhtvtGybKDaeGhHsnJHqvbGqa",209,0.990566,40,212,2,210,1,2,1,3,2,116,115,95,95,95
"8325",24,"[40]cIfHoIAvBkDmfzwzhtvtGybKDaeGhHsnJHqvbGqa",210,0.99061,40,213,2,211,1,2,1,3,2,116,115,96,96,95
"8326",25,"[40]cIfHoIAvBkDmfzwzhtvtGybKDaeGhHsnJHqvbGqa",214,0.990783,40,217,2,215,1,2,1,3,2,121,120,95,95,95
"8327",26,"[40]cIfHoIAvBkDmfzwzhtvtGybKDaeGhHsnJHqvbGqa",213,0.990741,40,216,2,214,1,2,1,3,2,118,117,97,97,95
"8328",27,"[40]cIfHoIAvBkDmfzwzhtvtGybKDaeGhHsnJHqvbGqa",208,0.990521,40,211,2,209,1,2,1,3,2,111,110,99,99,95
"8329",28,"[40]cIfHoIAvBkDmfzwzhtvtGybKDaeGhHsnJHqvbGqa",197,0.99,40,200,2,198,1,2,1,3,2,97,96,102,102,95
"8330",29,"[40]cIfHoIAvBkDmfzwzhtvtGybKDaeGhHsnJHqvbGqa",210,0.99061,40,213,2,211,1,2,1,3,2,114,113,98,98,95
"8331",30,"[40]cIfHoIAvBkDmfzwzhtvtGybKDaeGhHsnJHqvbGqa",192,0.989744,40,195,2,193,1,2,1,3,2,90,89,104,104,95
"8332",31,"[40]cIfHoIAvBkDmfzwzhtvtGybKDaeGhHsnJHqvbGqa",222,0.991111,40,225,2,223,1,2,1,3,2,128,127,96,96,95
"8333",32,"[40]cIfHoIAvBkDmfzwzhtvtGybKDaeGhHsnJHqvbGqa",192,0.989744,40,195,2,193,1,2,1,3,2,91,90,103,103,95
"8334",33,"[40]cIfHoIAvBkDmfzwzhtvtGybKDaeGhHsnJHqvbGqa",207,0.990476,40,210,2,208,1,2,1,3,2,110,109,99,99,95
"8335",34,"[40]cIfHoIAvBkDmfzwzhtvtGybKDaeGhHsnJHqvbGqa",195,0.989899,40,198,2,196,1,2,1,3,2,95,94,102,102,95
"8336",35,"[40]cIfHoIAvBkDmfzwzhtvtGybKDaeGhHsnJHqvbGqa",200,0.990148,40,203,2,201,1,2,1,3,2,101,100,101,101,95
"8337",36,"[40]cIfHoIAvBkDmfzwzhtvtGybKDaeGhHsnJHqvbGqa",201,0.990196,40,204,2,202,1,2,1,3,2,104,103,99,99,95
"8338",37,"[40]cIfHoIAvBkDmfzwzhtvtGybKDaeGhHsnJHqvbGqa",205,0.990385,40,208,2,206,1,2,1,3,2,111,110,96,96,95
"8339",38,"[40]cIfHoIAvBkDmfzwzhtvtGybKDaeGhHsnJHqvbGqa",199,0.990099,40,202,2,200,1,2,1,3,2,101,100,100,100,95
"8340",39,"[40]cIfHoIAvBkDmfzwzhtvtGybKDaeGhHsnJHqvbGqa",209,0.990566,40,212,2,210,1,2,1,3,2,115,114,96,96,95
"8341",40,"[40]cIfHoIAvBkDmfzwzhtvtGybKDaeGhHsnJHqvbGqa",200,0.990148,40,203,2,201,1,2,1,3,2,100,99,102,102,95
"8342",41,"[40]cIfHoIAvBkDmfzwzhtvtGybKDaeGhHsnJHqvbGqa",191,0.989691,40,194,2,192,1,2,1,3,2,89,88,104,104,95
"8343",42,"[40]cIfHoIAvBkDmfzwzhtvtGybKDaeGhHsnJHqvbGqa",201,0.990196,40,204,2,202,1,2,1,3,2,101,100,102,102,95
"8344",43,"[40]cIfHoIAvBkDmfzwzhtvtGybKDaeGhHsnJHqvbGqa",211,0.990654,40,214,2,212,1,2,1,3,2,116,115,97,97,95
"8345",44,"[40]cIfHoIAvBkDmfzwzhtvtGybKDaeGhHsnJHqvbGqa",200,0.990148,40,203,2,201,1,2,1,3,2,100,99,102,102,95
"8346",45,"[40]cIfHoIAvBkDmfzwzhtvtGybKDaeGhHsnJHqvbGqa",195,0.989899,40,198,2,196,1,2,1,3,2,94,93,103,103,95
"8347",46,"[40]cIfHoIAvBkDmfzwzhtvtGybKDaeGhHsnJHqvbGqa",204,0.990338,40,207,2,205,1,2,1,3,2,107,106,99,99,95
"8348",47,"[40]cIfHoIAvBkDmfzwzhtvtGybKDaeGhHsnJHqvbGqa",204,0.990338,40,207,2,205,1,2,1,3,2,105,104,101,101,95
"8349",48,"[40]cIfHoIAvBkDmfzwzhtvtGybKDaeGhHsnJHqvbGqa",202,0.990244,40,205,2,203,1,2,1,3,2,104,103,100,100,95
"8350",49,"[40]cIfHoIAvBkDmfzwzhtvtGybKDaeGhHsnJHqvbGqa",213,0.990741,40,216,2,214,1,2,1,3,2,119,118,96,96,95
"8351",50,"[40]cIfHoIAvBkDmfzwzhtvtGybKDaeGhHsnJHqvbGqa",192,0.989744,40,195,2,193,1,2,1,3,2,88,87,106,106,95
"8352",51,"[40]cIfHoIAvBkDmfzwzhtvtGybKDaeGhHsnJHqvbGqa",205,0.990385,40,208,2,206,1,2,1,3,2,109,108,98,98,95
"8353",52,"[40]cIfHoIAvBkDmfzwzhtvtGybKDaeGhHsnJHqvbGqa",202,0.990244,40,205,2,203,1,2,1,3,2,103,102,101,101,95
"8354",53,"[40]cIfHoIAvBkDmfzwzhtvtGybKDaeGhHsnJHqvbGqa",192,0.989744,40,195,2,193,1,2,1,3,2,90,89,104,104,95
"8355",54,"[40]cIfHoIAvBkDmfzwzhtvtGybKDaeGhHsnJHqvbGqa",212,0.990698,40,215,2,213,1,2,1,3,2,118,117,96,96,95
"8356",55,"[40]cIfHoIAvBkDmfzwzhtvtGybKDaeGhHsnJHqvbGqa",198,0.99005,40,201,2,199,1,2,1,3,2,98,97,102,102,95
"8357",56,"[40]cIfHoIAvBkDmfzwzhtvtGybKDaeGhHsnJHqvbGqa",201,0.990196,40,204,2,202,1,2,1,3,2,99,98,104,104,95
"8358",57,"[40]cIfHoIAvBkDmfzwzhtvtGybKDaeGhHsnJHqvbGqa",207,0.990476,40,210,2,208,1,2,1,3,2,111,110,98,98,95
"8359",58,"[40]cIfHoIAvBkDmfzwzhtvtGybKDaeGhHsnJHqvbGqa",198,0.99005,40,201,2,199,1,2,1,3,2,99,98,101,101,95
"8360",59,"[40]cIfHoIAvBkDmfzwzhtvtGybKDaeGhHsnJHqvbGqa",201,0.990196,40,204,2,202,1,2,1,3,2,103,102,100,100,95
"8361",60,"[40]cIfHoIAvBkDmfzwzhtvtGybKDaeGhHsnJHqvbGqa",207,0.990476,40,210,2,208,1,2,1,3,2,109,108,100,100,95
"8362",61,"[40]cIfHoIAvBkDmfzwzhtvtGybKDaeGhHsnJHqvbGqa",201,0.990196,40,204,2,202,1,2,1,3,2,102,101,101,101,95
"8363",62,"[40]cIfHoIAvBkDmfzwzhtvtGybKDaeGhHsnJHqvbGqa",197,0.99,40,200,2,198,1,2,1,3,2,98,97,101,101,95
"8364",63,"[40]cIfHoIAvBkDmfzwzhtvtGybKDaeGhHsnJHqvbGqa",201,0.990196,40,204,2,202,1,2,1,3,2,104,103,99,99,95
"8365",64,"[40]cIfHoIAvBkDmfzwzhtvtGybKDaeGhHsnJHqvbGqa",202,0.990244,40,205,2,203,1,2,1,3,2,104,103,100,100,95
"8366",65,"[40]cIfHoIAvBkDmfzwzhtvtGybKDaeGhHsnJHqvbGqa",203,0.990291,40,206,2,204,1,2,1,3,2,107,106,98,98,95
"8367",66,"[40]cIfHoIAvBkDmfzwzhtvtGybKDaeGhHsnJHqvbGqa",208,0.990521,40,211,2,209,1,2,1,3,2,111,110,99,99,95
"8368",67,"[40]cIfHoIAvBkDmfzwzhtvtGybKDaeGhHsnJHqvbGqa",189,0.989583,40,192,2,190,1,2,1,3,2,84,83,107,107,95
"8369",68,"[40]cIfHoIAvBkDmfzwzhtvtGybKDaeGhHsnJHqvbGqa",200,0.990148,40,203,2,201,1,2,1,3,2,103,102,99,99,95
"8370",69,"[40]cIfHoIAvBkDmfzwzhtvtGybKDaeGhHsnJHqvbGqa",195,0.989899,40,198,2,196,1,2,1,3,2,95,94,102,102,95
"8371",70,"[40]cIfHoIAvBkDmfzwzhtvtGybKDaeGhHsnJHqvbGqa",191,0.989691,40,194,2,192,1,2,1,3,2,88,87,105,105,95
"8372",71,"[40]cIfHoIAvBkDmfzwzhtvtGybKDaeGhHsnJHqvbGqa",201,0.990196,40,204,2,202,1,2,1,3,2,98,97,105,105,95
"8373",72,"[40]cIfHoIAvBkDmfzwzhtvtGybKDaeGhHsnJHqvbGqa",196,0.98995,40,199,2,197,1,2,1,3,2,97,96,101,101,95
"8374",73,"[40]cIfHoIAvBkDmfzwzhtvtGybKDaeGhHsnJHqvbGqa",206,0.990431,40,209,2,207,1,2,1,3,2,111,110,97,97,95
"8375",74,"[40]cIfHoIAvBkDmfzwzhtvtGybKDaeGhHsnJHqvbGqa",221,0.991071,40,224,2,222,1,2,1,3,2,128,127,95,95,95
"8376",75,"[40]cIfHoIAvBkDmfzwzhtvtGybKDaeGhHsnJHqvbGqa",196,0.98995,40,199,2,197,1,2,1,3,2,97,96,101,101,95
"8377",76,"[40]cIfHoIAvBkDmfzwzhtvtGybKDaeGhHsnJHqvbGqa",211,0.990654,40,214,2,212,1,2,1,3,2,116,115,97,97,95
"8378",77,"[40]cIfHoIAvBkDmfzwzhtvtGybKDaeGhHsnJHqvbGqa",194,0.989848,40,197,2,195,1,2,1,3,2,91,90,105,105,95
"8379",78,"[40]cIfHoIAvBkDmfzwzhtvtGybKDaeGhHsnJHqvbGqa",206,0.990431,40,209,2,207,1,2,1,3,2,107,106,101,101,95
"8380",79,"[40]cIfHoIAvBkDmfzwzhtvtGybKDaeGhHsnJHqvbGqa",214,0.990783,40,217,2,215,1,2,1,3,2,121,120,95,95,95
"8381",80,"[40]cIfHoIAvBkDmfzwzhtvtGybKDaeGhHsnJHqvbGqa",193,0.989796,40,196,2,194,1,2,1,3,2,92,91,103,103,95
"8382",81,"[40]cIfHoIAvBkDmfzwzhtvtGybKDaeGhHsnJHqvbGqa",194,0.989848,40,197,2,195,1,2,1,3,2,93,92,103,103,95
"8383",82,"[40]cIfHoIAvBkDmfzwzhtvtGybKDaeGhHsnJHqvbGqa",198,0.99005,40,201,2,199,1,2,1,3,2,100,99,100,100,95
"8384",83,"[40]cIfHoIAvBkDmfzwzhtvtGybKDaeGhHsnJHqvbGqa",178,0.98895,40,181,2,179,1,2,1,3,2,71,70,109,109,95
"8385",84,"[40]cIfHoIAvBkDmfzwzhtvtGybKDaeGhHsnJHqvbGqa",198,0.99005,40,201,2,199,1,2,1,3,2,98,97,102,102,95
"8386",85,"[40]cIfHoIAvBkDmfzwzhtvtGybKDaeGhHsnJHqvbGqa",199,0.990099,40,202,2,200,1,2,1,3,2,99,98,102,102,95
"8387",86,"[40]cIfHoIAvBkDmfzwzhtvtGybKDaeGhHsnJHqvbGqa",210,0.99061,40,213,2,211,1,2,1,3,2,114,113,98,98,95
"8388",87,"[40]cIfHoIAvBkDmfzwzhtvtGybKDaeGhHsnJHqvbGqa",194,0.989848,40,197,2,195,1,2,1,3,2,93,92,103,103,95
"8389",88,"[40]cIfHoIAvBkDmfzwzhtvtGybKDaeGhHsnJHqvbGqa",200,0.990148,40,203,2,201,1,2,1,3,2,100,99,102,102,95
"8390",89,"[40]cIfHoIAvBkDmfzwzhtvtGybKDaeGhHsnJHqvbGqa",193,0.989796,40,196,2,194,1,2,1,3,2,92,91,103,103,95
"8391",90,"[40]cIfHoIAvBkDmfzwzhtvtGybKDaeGhHsnJHqvbGqa",187,0.989474,40,190,2,188,1,2,1,3,2,81,80,108,108,95
"8392",91,"[40]cIfHoIAvBkDmfzwzhtvtGybKDaeGhHsnJHqvbGqa",196,0.98995,40,199,2,197,1,2,1,3,2,95,94,103,103,95
"8393",92,"[40]cIfHoIAvBkDmfzwzhtvtGybKDaeGhHsnJHqvbGqa",195,0.989899,40,198,2,196,1,2,1,3,2,92,91,105,105,95
"8394",93,"[40]cIfHoIAvBkDmfzwzhtvtGybKDaeGhHsnJHqvbGqa",199,0.990099,40,202,2,200,1,2,1,3,2,99,98,102,102,95
"8395",94,"[40]cIfHoIAvBkDmfzwzhtvtGybKDaeGhHsnJHqvbGqa",191,0.989691,40,194,2,192,1,2,1,3,2,88,87,105,105,95
"8396",95,"[40]cIfHoIAvBkDmfzwzhtvtGybKDaeGhHsnJHqvbGqa",208,0.990521,40,211,2,209,1,2,1,3,2,110,109,100,100,95
"8397",96,"[40]cIfHoIAvBkDmfzwzhtvtGybKDaeGhHsnJHqvbGqa",212,0.990698,40,215,2,213,1,2,1,3,2,117,116,97,97,95
"8398",97,"[40]cIfHoIAvBkDmfzwzhtvtGybKDaeGhHsnJHqvbGqa",204,0.990338,40,207,2,205,1,2,1,3,2,104,103,102,102,95
"8399",98,"[40]cIfHoIAvBkDmfzwzhtvtGybKDaeGhHsnJHqvbGqa",195,0.989899,40,198,2,196,1,2,1,3,2,92,91,105,105,95
"8400",99,"[40]cIfHoIAvBkDmfzwzhtvtGybKDaeGhHsnJHqvbGqa",215,0.990826,40,218,2,216,1,2,1,3,2,121,120,96,96,95
"8401",0,"[40]gIfHoIyyvBkxsDwjkAyiKzKuKIleKHxnJHqveGqa",234,0.991561,40,237,2,235,1,2,1,3,2,135,134,101,101,96
"8402",1,"[40]gIfHoIyyvBkxsDwjkAyiKzKuKIleKHxnJHqveGqa",209,0.990566,40,212,2,210,1,2,1,3,2,101,100,110,110,96
"8403",2,"[40]gIfHoIyyvBkxsDwjkAyiKzKuKIleKHxnJHqveGqa",210,0.99061,40,213,2,211,1,2,1,3,2,99,98,113,113,96
"8404",3,"[40]gIfHoIyyvBkxsDwjkAyiKzKuKIleKHxnJHqveGqa",226,0.991266,40,229,2,227,1,2,1,3,2,123,122,105,105,96
"8405",4,"[40]gIfHoIyyvBkxsDwjkAyiKzKuKIleKHxnJHqveGqa",206,0.990431,40,209,2,207,1,2,1,3,2,95,94,113,113,96
"8406",5,"[40]gIfHoIyyvBkxsDwjkAyiKzKuKIleKHxnJHqveGqa",207,0.990476,40,210,2,208,1,2,1,3,2,95,94,114,114,96
"8407",6,"[40]gIfHoIyyvBkxsDwjkAyiKzKuKIleKHxnJHqveGqa",227,0.991304,40,230,2,228,1,2,1,3,2,127,126,102,102,96
"8408",7,"[40]gIfHoIyyvBkxsDwjkAyiKzKuKIleKHxnJHqveGqa",207,0.990476,40,210,2,208,1,2,1,3,2,97,96,112,112,96
"8409",8,"[40]gIfHoIyyvBkxsDwjkAyiKzKuKIleKHxnJHqveGqa",208,0.990521,40,211,2,209,1,2,1,3,2,98,97,112,112,96
"8410",9,"[40]gIfHoIyyvBkxsDwjkAyiKzKuKIleKHxnJHqveGqa",205,0.990385,40,208,2,206,1,2,1,3,2,94,93,113,113,96
"8411",10,"[40]gIfHoIyyvBkxsDwjkAyiKzKuKIleKHxnJHqveGqa",220,0.991031,40,223,2,221,1,2,1,3,2,117,116,105,105,96
"8412",11,"[40]gIfHoIyyvBkxsDwjkAyiKzKuKIleKHxnJHqveGqa",223,0.99115,40,226,2,224,1,2,1,3,2,118,117,107,107,96
"8413",12,"[40]gIfHoIyyvBkxsDwjkAyiKzKuKIleKHxnJHqveGqa",216,0.990868,40,219,2,217,1,2,1,3,2,109,108,109,109,96
"8414",13,"[40]gIfHoIyyvBkxsDwjkAyiKzKuKIleKHxnJHqveGqa",216,0.990868,40,219,2,217,1,2,1,3,2,112,111,106,106,96
"8415",14,"[40]gIfHoIyyvBkxsDwjkAyiKzKuKIleKHxnJHqveGqa",216,0.990868,40,219,2,217,1,2,1,3,2,110,109,108,108,96
"8416",15,"[40]gIfHoIyyvBkxsDwjkAyiKzKuKIleKHxnJHqveGqa",214,0.990783,40,217,2,215,1,2,1,3,2,106,105,110,110,96
"8417",16,"[40]gIfHoIyyvBkxsDwjkAyiKzKuKIleKHxnJHqveGqa",219,0.990991,40,222,2,220,1,2,1,3,2,111,110,110,110,96
"8418",17,"[40]gIfHoIyyvBkxsDwjkAyiKzKuKIleKHxnJHqveGqa",206,0.990431,40,209,2,207,1,2,1,3,2,94,93,114,114,96
"8419",18,"[40]gIfHoIyyvBkxsDwjkAyiKzKuKIleKHxnJHqveGqa",209,0.990566,40,212,2,210,1,2,1,3,2,102,101,109,109,96
"8420",19,"[40]gIfHoIyyvBkxsDwjkAyiKzKuKIleKHxnJHqveGqa",219,0.990991,40,222,2,220,1,2,1,3,2,114,113,107,107,96
"8421",20,"[40]gIfHoIyyvBkxsDwjkAyiKzKuKIleKHxnJHqveGqa",209,0.990566,40,212,2,210,1,2,1,3,2,99,98,112,112,96
"8422",21,"[40]gIfHoIyyvBkxsDwjkAyiKzKuKIleKHxnJHqveGqa",205,0.990385,40,208,2,206,1,2,1,3,2,96,95,111,111,96
"8423",22,"[40]gIfHoIyyvBkxsDwjkAyiKzKuKIleKHxnJHqveGqa",218,0.99095,40,221,2,219,1,2,1,3,2,114,113,106,106,96
"8424",23,"[40]gIfHoIyyvBkxsDwjkAyiKzKuKIleKHxnJHqveGqa",220,0.991031,40,223,2,221,1,2,1,3,2,112,111,110,110,96
"8425",24,"[40]gIfHoIyyvBkxsDwjkAyiKzKuKIleKHxnJHqveGqa",213,0.990741,40,216,2,214,1,2,1,3,2,105,104,110,110,96
"8426",25,"[40]gIfHoIyyvBkxsDwjkAyiKzKuKIleKHxnJHqveGqa",227,0.991304,40,230,2,228,1,2,1,3,2,125,124,104,104,96
"8427",26,"[40]gIfHoIyyvBkxsDwjkAyiKzKuKIleKHxnJHqveGqa",215,0.990826,40,218,2,216,1,2,1,3,2,107,106,110,110,96
"8428",27,"[40]gIfHoIyyvBkxsDwjkAyiKzKuKIleKHxnJHqveGqa",223,0.99115,40,226,2,224,1,2,1,3,2,121,120,104,104,96
"8429",28,"[40]gIfHoIyyvBkxsDwjkAyiKzKuKIleKHxnJHqveGqa",211,0.990654,40,214,2,212,1,2,1,3,2,105,104,108,108,96
"8430",29,"[40]gIfHoIyyvBkxsDwjkAyiKzKuKIleKHxnJHqveGqa",203,0.990291,40,206,2,204,1,2,1,3,2,92,91,113,113,96
"8431",30,"[40]gIfHoIyyvBkxsDwjkAyiKzKuKIleKHxnJHqveGqa",231,0.991453,40,234,2,232,1,2,1,3,2,133,132,100,100,96
"8432",31,"[40]gIfHoIyyvBkxsDwjkAyiKzKuKIleKHxnJHqveGqa",208,0.990521,40,211,2,209,1,2,1,3,2,97,96,113,113,96
"8433",32,"[40]gIfHoIyyvBkxsDwjkAyiKzKuKIleKHxnJHqveGqa",227,0.991304,40,230,2,228,1,2,1,3,2,128,127,101,101,96
"8434",33,"[40]gIfHoIyyvBkxsDwjkAyiKzKuKIleKHxnJHqveGqa",231,0.991453,40,234,2,232,1,2,1,3,2,130,129,103,103,96
"8435",34,"[40]gIfHoIyyvBkxsDwjkAyiKzKuKIleKHxnJHqveGqa",218,0.99095,40,221,2,219,1,2,1,3,2,115,114,105,105,96
"8436",35,"[40]gIfHoIyyvBkxsDwjkAyiKzKuKIleKHxnJHqveGqa",212,0.990698,40,215,2,213,1,2,1,3,2,106,105,108,108,96
"8437",36,"[40]gIfHoIyyvBkxsDwjkAyiKzKuKIleKHxnJHqveGqa",214,0.990783,40,217,2,215,1,2,1,3,2,105,104,111,111,96
"8438",37,"[40]gIfHoIyyvBkxsDwjkAyiKzKuKIleKHxnJHqveGqa",217,0.990909,40,220,2,218,1,2,1,3,2,109,108,110,110,96
"8439",38,"[40]gIfHoIyyvBkxsDwjkAyiKzKuKIleKHxnJHqveGqa",228,0.991342,40,231,2,229,1,2,1,3,2,125,124,105,105,96
"8440",39,"[40]gIfHoIyyvBkxsDwjkAyiKzKuKIleKHxnJHqveGqa",224,0.991189,40,227,2,225,1,2,1,3,2,123,122,103,103,96
"8441",40,"[40]gIfHoIyyvBkxsDwjkAyiKzKuKIleKHxnJHqveGqa",224,0.991189,40,227,2,225,1,2,1,3,2,123,122,103,103,96
"8442",41,"[40]gIfHoIyyvBkxsDwjkAyiKzKuKIleKHxnJHqveGqa",199,0.990099,40,202,2,200,1,2,1,3,2,85,84,116,116,96
"8443",42,"[40]gIfHoIyyvBkxsDwjkAyiKzKuKIleKHxnJHqveGqa",210,0.99061,40,213,2,211,1,2,1,3,2,103,102,109,109,96
"8444",43,"[40]gIfHoIyyvBkxsDwjkAyiKzKuKIleKHxnJHqveGqa",218,0.99095,40,221,2,219,1,2,1,3,2,114,113,106,106,96
"8445",44,"[40]gIfHoIyyvBkxsDwjkAyiKzKuKIleKHxnJHqveGqa",224,0.991189,40,227,2,225,1,2,1,3,2,123,122,103,103,96
"8446",45,"[40]gIfHoIyyvBkxsDwjkAyiKzKuKIleKHxnJHqveGqa",230,0.991416,40,233,2,231,1,2,1,3,2,131,130,101,101,96
"8447",46,"[40]gIfHoIyyvBkxsDwjkAyiKzKuKIleKHxnJHqveGqa",217,0.990909,40,220,2,218,1,2,1,3,2,111,110,108,108,96
"8448",47,"[40]gIfHoIyyvBkxsDwjkAyiKzKuKIleKHxnJHqveGqa",217,0.990909,40,220,2,218,1,2,1,3,2,110,109,109,109,96
"8449",48,"[40]gIfHoIyyvBkxsDwjkAyiKzKuKIleKHxnJHqveGqa",208,0.990521,40,211,2,209,1,2,1,3,2,96,95,114,114,96
"8450",49,"[40]gIfHoIyyvBkxsDwjkAyiKzKuKIleKHxnJHqveGqa",226,0.991266,40,229,2,227,1,2,1,3,2,124,123,104,104,96
"8451",50,"[40]gIfHoIyyvBkxsDwjkAyiKzKuKIleKHxnJHqveGqa",212,0.990698,40,215,2,213,1,2,1,3,2,104,103,110,110,96
"8452",51,"[40]gIfHoIyyvBkxsDwjkAyiKzKuKIleKHxnJHqveGqa",210,0.99061,40,213,2,211,1,2,1,3,2,103,102,109,109,96
"8453",52,"[40]gIfHoIyyvBkxsDwjkAyiKzKuKIleKHxnJHqveGqa",204,0.990338,40,207,2,205,1,2,1,3,2,95,94,111,111,96
"8454",53,"[40]gIfHoIyyvBkxsDwjkAyiKzKuKIleKHxnJHqveGqa",206,0.990431,40,209,2,207,1,2,1,3,2,95,94,113,113,96
"8455",54,"[40]gIfHoIyyvBkxsDwjkAyiKzKuKIleKHxnJHqveGqa",210,0.99061,40,213,2,211,1,2,1,3,2,102,101,110,110,96
"8456",55,"[40]gIfHoIyyvBkxsDwjkAyiKzKuKIleKHxnJHqveGqa",210,0.99061,40,213,2,211,1,2,1,3,2,101,100,111,111,96
"8457",56,"[40]gIfHoIyyvBkxsDwjkAyiKzKuKIleKHxnJHqveGqa",222,0.991111,40,225,2,223,1,2,1,3,2,118,117,106,106,96
"8458",57,"[40]gIfHoIyyvBkxsDwjkAyiKzKuKIleKHxnJHqveGqa",216,0.990868,40,219,2,217,1,2,1,3,2,110,109,108,108,96
"8459",58,"[40]gIfHoIyyvBkxsDwjkAyiKzKuKIleKHxnJHqveGqa",211,0.990654,40,214,2,212,1,2,1,3,2,101,100,112,112,96
"8460",59,"[40]gIfHoIyyvBkxsDwjkAyiKzKuKIleKHxnJHqveGqa",229,0.991379,40,232,2,230,1,2,1,3,2,131,130,100,100,96
"8461",60,"[40]gIfHoIyyvBkxsDwjkAyiKzKuKIleKHxnJHqveGqa",205,0.990385,40,208,2,206,1,2,1,3,2,96,95,111,111,96
"8462",61,"[40]gIfHoIyyvBkxsDwjkAyiKzKuKIleKHxnJHqveGqa",212,0.990698,40,215,2,213,1,2,1,3,2,104,103,110,110,96
"8463",62,"[40]gIfHoIyyvBkxsDwjkAyiKzKuKIleKHxnJHqveGqa",229,0.991379,40,232,2,230,1,2,1,3,2,131,130,100,100,96
"8464",63,"[40]gIfHoIyyvBkxsDwjkAyiKzKuKIleKHxnJHqveGqa",231,0.991453,40,234,2,232,1,2,1,3,2,130,129,103,103,96
"8465",64,"[40]gIfHoIyyvBkxsDwjkAyiKzKuKIleKHxnJHqveGqa",208,0.990521,40,211,2,209,1,2,1,3,2,98,97,112,112,96
"8466",65,"[40]gIfHoIyyvBkxsDwjkAyiKzKuKIleKHxnJHqveGqa",233,0.991525,40,236,2,234,1,2,1,3,2,131,130,104,104,96
"8467",66,"[40]gIfHoIyyvBkxsDwjkAyiKzKuKIleKHxnJHqveGqa",229,0.991379,40,232,2,230,1,2,1,3,2,125,124,106,106,96
"8468",67,"[40]gIfHoIyyvBkxsDwjkAyiKzKuKIleKHxnJHqveGqa",223,0.99115,40,226,2,224,1,2,1,3,2,119,118,106,106,96
"8469",68,"[40]gIfHoIyyvBkxsDwjkAyiKzKuKIleKHxnJHqveGqa",219,0.990991,40,222,2,220,1,2,1,3,2,115,114,106,106,96
"8470",69,"[40]gIfHoIyyvBkxsDwjkAyiKzKuKIleKHxnJHqveGqa",207,0.990476,40,210,2,208,1,2,1,3,2,98,97,111,111,96
"8471",70,"[40]gIfHoIyyvBkxsDwjkAyiKzKuKIleKHxnJHqveGqa",214,0.990783,40,217,2,215,1,2,1,3,2,103,102,113,113,96
"8472",71,"[40]gIfHoIyyvBkxsDwjkAyiKzKuKIleKHxnJHqveGqa",230,0.991416,40,233,2,231,1,2,1,3,2,127,126,105,105,96
"8473",72,"[40]gIfHoIyyvBkxsDwjkAyiKzKuKIleKHxnJHqveGqa",227,0.991304,40,230,2,228,1,2,1,3,2,124,123,105,105,96
"8474",73,"[40]gIfHoIyyvBkxsDwjkAyiKzKuKIleKHxnJHqveGqa",222,0.991111,40,225,2,223,1,2,1,3,2,119,118,105,105,96
"8475",74,"[40]gIfHoIyyvBkxsDwjkAyiKzKuKIleKHxnJHqveGqa",210,0.99061,40,213,2,211,1,2,1,3,2,102,101,110,110,96
"8476",75,"[40]gIfHoIyyvBkxsDwjkAyiKzKuKIleKHxnJHqveGqa",216,0.990868,40,219,2,217,1,2,1,3,2,110,109,108,108,96
"8477",76,"[40]gIfHoIyyvBkxsDwjkAyiKzKuKIleKHxnJHqveGqa",213,0.990741,40,216,2,214,1,2,1,3,2,105,104,110,110,96
"8478",77,"[40]gIfHoIyyvBkxsDwjkAyiKzKuKIleKHxnJHqveGqa",215,0.990826,40,218,2,216,1,2,1,3,2,110,109,107,107,96
"8479",78,"[40]gIfHoIyyvBkxsDwjkAyiKzKuKIleKHxnJHqveGqa",211,0.990654,40,214,2,212,1,2,1,3,2,103,102,110,110,96
"8480",79,"[40]gIfHoIyyvBkxsDwjkAyiKzKuKIleKHxnJHqveGqa",220,0.991031,40,223,2,221,1,2,1,3,2,115,114,107,107,96
"8481",80,"[40]gIfHoIyyvBkxsDwjkAyiKzKuKIleKHxnJHqveGqa",220,0.991031,40,223,2,221,1,2,1,3,2,113,112,109,109,96
"8482",81,"[40]gIfHoIyyvBkxsDwjkAyiKzKuKIleKHxnJHqveGqa",216,0.990868,40,219,2,217,1,2,1,3,2,111,110,107,107,96
"8483",82,"[40]gIfHoIyyvBkxsDwjkAyiKzKuKIleKHxnJHqveGqa",209,0.990566,40,212,2,210,1,2,1,3,2,102,101,109,109,96
"8484",83,"[40]gIfHoIyyvBkxsDwjkAyiKzKuKIleKHxnJHqveGqa",213,0.990741,40,216,2,214,1,2,1,3,2,106,105,109,109,96
"8485",84,"[40]gIfHoIyyvBkxsDwjkAyiKzKuKIleKHxnJHqveGqa",219,0.990991,40,222,2,220,1,2,1,3,2,112,111,109,109,96
"8486",85,"[40]gIfHoIyyvBkxsDwjkAyiKzKuKIleKHxnJHqveGqa",233,0.991525,40,236,2,234,1,2,1,3,2,136,135,99,99,96
"8487",86,"[40]gIfHoIyyvBkxsDwjkAyiKzKuKIleKHxnJHqveGqa",205,0.990385,40,208,2,206,1,2,1,3,2,95,94,112,112,96
"8488",87,"[40]gIfHoIyyvBkxsDwjkAyiKzKuKIleKHxnJHqveGqa",222,0.991111,40,225,2,223,1,2,1,3,2,117,116,107,107,96
"8489",88,"[40]gIfHoIyyvBkxsDwjkAyiKzKuKIleKHxnJHqveGqa",223,0.99115,40,226,2,224,1,2,1,3,2,122,121,103,103,96
"8490",89,"[40]gIfHoIyyvBkxsDwjkAyiKzKuKIleKHxnJHqveGqa",227,0.991304,40,230,2,228,1,2,1,3,2,126,125,103,103,96
"8491",90,"[40]gIfHoIyyvBkxsDwjkAyiKzKuKIleKHxnJHqveGqa",217,0.990909,40,220,2,218,1,2,1,3,2,111,110,108,108,96
"8492",91,"[40]gIfHoIyyvBkxsDwjkAyiKzKuKIleKHxnJHqveGqa",214,0.990783,40,217,2,215,1,2,1,3,2,106,105,110,110,96
"8493",92,"[40]gIfHoIyyvBkxsDwjkAyiKzKuKIleKHxnJHqveGqa",211,0.990654,40,214,2,212,1,2,1,3,2,103,102,110,110,96
"8494",93,"[40]gIfHoIyyvBkxsDwjkAyiKzKuKIleKHxnJHqveGqa",231,0.991453,40,234,2,232,1,2,1,3,2,129,128,104,104,96
"8495",94,"[40]gIfHoIyyvBkxsDwjkAyiKzKuKIleKHxnJHqveGqa",199,0.990099,40,202,2,200,1,2,1,3,2,85,84,116,116,96
"8496",95,"[40]gIfHoIyyvBkxsDwjkAyiKzKuKIleKHxnJHqveGqa",220,0.991031,40,223,2,221,1,2,1,3,2,116,115,106,106,96
"8497",96,"[40]gIfHoIyyvBkxsDwjkAyiKzKuKIleKHxnJHqveGqa",205,0.990385,40,208,2,206,1,2,1,3,2,94,93,113,113,96
"8498",97,"[40]gIfHoIyyvBkxsDwjkAyiKzKuKIleKHxnJHqveGqa",204,0.990338,40,207,2,205,1,2,1,3,2,95,94,111,111,96
"8499",98,"[40]gIfHoIyyvBkxsDwjkAyiKzKuKIleKHxnJHqveGqa",205,0.990385,40,208,2,206,1,2,1,3,2,95,94,112,112,96
"8500",99,"[40]gIfHoIyyvBkxsDwjkAyiKzKuKIleKHxnJHqveGqa",201,0.990196,40,204,2,202,1,2,1,3,2,89,88,114,114,96
"8501",0,"[42]bIeHoIsusEBlDlkEldyBBsfCfjdzCeKHwnJHqveGqa",209,0.990566,42,212,2,210,1,2,1,3,2,100,99,111,111,97
"8502",1,"[42]bIeHoIsusEBlDlkEldyBBsfCfjdzCeKHwnJHqveGqa",220,0.991031,42,223,2,221,1,2,1,3,2,116,115,106,106,97
"8503",2,"[42]bIeHoIsusEBlDlkEldyBBsfCfjdzCeKHwnJHqveGqa",223,0.99115,42,226,2,224,1,2,1,3,2,119,118,106,106,97
"8504",3,"[42]bIeHoIsusEBlDlkEldyBBsfCfjdzCeKHwnJHqveGqa",224,0.991189,42,227,2,225,1,2,1,3,2,121,120,105,105,97
"8505",4,"[42]bIeHoIsusEBlDlkEldyBBsfCfjdzCeKHwnJHqveGqa",219,0.990991,42,222,2,220,1,2,1,3,2,114,113,107,107,97
"8506",5,"[42]bIeHoIsusEBlDlkEldyBBsfCfjdzCeKHwnJHqveGqa",221,0.991071,42,224,2,222,1,2,1,3,2,116,115,107,107,97
"8507",6,"[42]bIeHoIsusEBlDlkEldyBBsfCfjdzCeKHwnJHqveGqa",224,0.991189,42,227,2,225,1,2,1,3,2,120,119,106,106,97
"8508",7,"[42]bIeHoIsusEBlDlkEldyBBsfCfjdzCeKHwnJHqveGqa",223,0.99115,42,226,2,224,1,2,1,3,2,118,117,107,107,97
"8509",8,"[42]bIeHoIsusEBlDlkEldyBBsfCfjdzCeKHwnJHqveGqa",210,0.99061,42,213,2,211,1,2,1,3,2,102,101,110,110,97
"8510",9,"[42]bIeHoIsusEBlDlkEldyBBsfCfjdzCeKHwnJHqveGqa",220,0.991031,42,223,2,221,1,2,1,3,2,116,115,106,106,97
"8511",10,"[42]bIeHoIsusEBlDlkEldyBBsfCfjdzCeKHwnJHqveGqa",230,0.991416,42,233,2,231,1,2,1,3,2,130,129,102,102,97
"8512",11,"[42]bIeHoIsusEBlDlkEldyBBsfCfjdzCeKHwnJHqveGqa",212,0.990698,42,215,2,213,1,2,1,3,2,106,105,108,108,97
"8513",12,"[42]bIeHoIsusEBlDlkEldyBBsfCfjdzCeKHwnJHqveGqa",207,0.990476,42,210,2,208,1,2,1,3,2,97,96,112,112,97
"8514",13,"[42]bIeHoIsusEBlDlkEldyBBsfCfjdzCeKHwnJHqveGqa",207,0.990476,42,210,2,208,1,2,1,3,2,100,99,109,109,97
"8515",14,"[42]bIeHoIsusEBlDlkEldyBBsfCfjdzCeKHwnJHqveGqa",212,0.990698,42,215,2,213,1,2,1,3,2,100,99,114,114,97
"8516",15,"[42]bIeHoIsusEBlDlkEldyBBsfCfjdzCeKHwnJHqveGqa",209,0.990566,42,212,2,210,1,2,1,3,2,100,99,111,111,97
"8517",16,"[42]bIeHoIsusEBlDlkEldyBBsfCfjdzCeKHwnJHqveGqa",222,0.991111,42,225,2,223,1,2,1,3,2,117,116,107,107,97
"8518",17,"[42]bIeHoIsusEBlDlkEldyBBsfCfjdzCeKHwnJHqveGqa",225,0.991228,42,228,2,226,1,2,1,3,2,123,122,104,104,97
"8519",18,"[42]bIeHoIsusEBlDlkEldyBBsfCfjdzCeKHwnJHqveGqa",222,0.991111,42,225,2,223,1,2,1,3,2,119,118,105,105,97
"8520",19,"[42]bIeHoIsusEBlDlkEldyBBsfCfjdzCeKHwnJHqveGqa",216,0.990868,42,219,2,217,1,2,1,3,2,112,111,106,106,97
"8521",20,"[42]bIeHoIsusEBlDlkEldyBBsfCfjdzCeKHwnJHqveGqa",227,0.991304,42,230,2,228,1,2,1,3,2,124,123,105,105,97
"8522",21,"[42]bIeHoIsusEBlDlkEldyBBsfCfjdzCeKHwnJHqveGqa",214,0.990783,42,217,2,215,1,2,1,3,2,109,108,107,107,97
"8523",22,"[42]bIeHoIsusEBlDlkEldyBBsfCfjdzCeKHwnJHqveGqa",206,0.990431,42,209,2,207,1,2,1,3,2,95,94,113,113,97
"8524",23,"[42]bIeHoIsusEBlDlkEldyBBsfCfjdzCeKHwnJHqveGqa",205,0.990385,42,208,2,206,1,2,1,3,2,95,94,112,112,97
"8525",24,"[42]bIeHoIsusEBlDlkEldyBBsfCfjdzCeKHwnJHqveGqa",213,0.990741,42,216,2,214,1,2,1,3,2,107,106,108,108,97
"8526",25,"[42]bIeHoIsusEBlDlkEldyBBsfCfjdzCeKHwnJHqveGqa",213,0.990741,42,216,2,214,1,2,1,3,2,106,105,109,109,97
"8527",26,"[42]bIeHoIsusEBlDlkEldyBBsfCfjdzCeKHwnJHqveGqa",222,0.991111,42,225,2,223,1,2,1,3,2,117,116,107,107,97
"8528",27,"[42]bIeHoIsusEBlDlkEldyBBsfCfjdzCeKHwnJHqveGqa",222,0.991111,42,225,2,223,1,2,1,3,2,120,119,104,104,97
"8529",28,"[42]bIeHoIsusEBlDlkEldyBBsfCfjdzCeKHwnJHqveGqa",224,0.991189,42,227,2,225,1,2,1,3,2,119,118,107,107,97
"8530",29,"[42]bIeHoIsusEBlDlkEldyBBsfCfjdzCeKHwnJHqveGqa",211,0.990654,42,214,2,212,1,2,1,3,2,104,103,109,109,97
"8531",30,"[42]bIeHoIsusEBlDlkEldyBBsfCfjdzCeKHwnJHqveGqa",216,0.990868,42,219,2,217,1,2,1,3,2,109,108,109,109,97
"8532",31,"[42]bIeHoIsusEBlDlkEldyBBsfCfjdzCeKHwnJHqveGqa",223,0.99115,42,226,2,224,1,2,1,3,2,120,119,105,105,97
"8533",32,"[42]bIeHoIsusEBlDlkEldyBBsfCfjdzCeKHwnJHqveGqa",227,0.991304,42,230,2,228,1,2,1,3,2,127,126,102,102,97
"8534",33,"[42]bIeHoIsusEBlDlkEldyBBsfCfjdzCeKHwnJHqveGqa",221,0.991071,42,224,2,222,1,2,1,3,2,117,116,106,106,97
"8535",34,"[42]bIeHoIsusEBlDlkEldyBBsfCfjdzCeKHwnJHqveGqa",220,0.991031,42,223,2,221,1,2,1,3,2,117,116,105,105,97
"8536",35,"[42]bIeHoIsusEBlDlkEldyBBsfCfjdzCeKHwnJHqveGqa",205,0.990385,42,208,2,206,1,2,1,3,2,95,94,112,112,97
"8537",36,"[42]bIeHoIsusEBlDlkEldyBBsfCfjdzCeKHwnJHqveGqa",213,0.990741,42,216,2,214,1,2,1,3,2,106,105,109,109,97
"8538",37,"[42]bIeHoIsusEBlDlkEldyBBsfCfjdzCeKHwnJHqveGqa",209,0.990566,42,212,2,210,1,2,1,3,2,99,98,112,112,97
"8539",38,"[42]bIeHoIsusEBlDlkEldyBBsfCfjdzCeKHwnJHqveGqa",215,0.990826,42,218,2,216,1,2,1,3,2,108,107,109,109,97
"8540",39,"[42]bIeHoIsusEBlDlkEldyBBsfCfjdzCeKHwnJHqveGqa",224,0.991189,42,227,2,225,1,2,1,3,2,123,122,103,103,97
"8541",40,"[42]bIeHoIsusEBlDlkEldyBBsfCfjdzCeKHwnJHqveGqa",217,0.990909,42,220,2,218,1,2,1,3,2,107,106,112,112,97
"8542",41,"[42]bIeHoIsusEBlDlkEldyBBsfCfjdzCeKHwnJHqveGqa",197,0.99,42,200,2,198,1,2,1,3,2,82,81,117,117,97
"8543",42,"[42]bIeHoIsusEBlDlkEldyBBsfCfjdzCeKHwnJHqveGqa",230,0.991416,42,233,2,231,1,2,1,3,2,130,129,102,102,97
"8544",43,"[42]bIeHoIsusEBlDlkEldyBBsfCfjdzCeKHwnJHqveGqa",221,0.991071,42,224,2,222,1,2,1,3,2,119,118,104,104,97
"8545",44,"[42]bIeHoIsusEBlDlkEldyBBsfCfjdzCeKHwnJHqveGqa",205,0.990385,42,208,2,206,1,2,1,3,2,95,94,112,112,97
"8546",45,"[42]bIeHoIsusEBlDlkEldyBBsfCfjdzCeKHwnJHqveGqa",229,0.991379,42,232,2,230,1,2,1,3,2,126,125,105,105,97
"8547",46,"[42]bIeHoIsusEBlDlkEldyBBsfCfjdzCeKHwnJHqveGqa",212,0.990698,42,215,2,213,1,2,1,3,2,103,102,111,111,97
"8548",47,"[42]bIeHoIsusEBlDlkEldyBBsfCfjdzCeKHwnJHqveGqa",209,0.990566,42,212,2,210,1,2,1,3,2,100,99,111,111,97
"8549",48,"[42]bIeHoIsusEBlDlkEldyBBsfCfjdzCeKHwnJHqveGqa",227,0.991304,42,230,2,228,1,2,1,3,2,126,125,103,103,97
"8550",49,"[42]bIeHoIsusEBlDlkEldyBBsfCfjdzCeKHwnJHqveGqa",215,0.990826,42,218,2,216,1,2,1,3,2,110,109,107,107,97
"8551",50,"[42]bIeHoIsusEBlDlkEldyBBsfCfjdzCeKHwnJHqveGqa",210,0.99061,42,213,2,211,1,2,1,3,2,100,99,112,112,97
"8552",51,"[42]bIeHoIsusEBlDlkEldyBBsfCfjdzCeKHwnJHqveGqa",218,0.99095,42,221,2,219,1,2,1,3,2,115,114,105,105,97
"8553",52,"[42]bIeHoIsusEBlDlkEldyBBsfCfjdzCeKHwnJHqveGqa",224,0.991189,42,227,2,225,1,2,1,3,2,123,122,103,103,97
"8554",53,"[42]bIeHoIsusEBlDlkEldyBBsfCfjdzCeKHwnJHqveGqa",211,0.990654,42,214,2,212,1,2,1,3,2,103,102,110,110,97
"8555",54,"[42]bIeHoIsusEBlDlkEldyBBsfCfjdzCeKHwnJHqveGqa",205,0.990385,42,208,2,206,1,2,1,3,2,94,93,113,113,97
"8556",55,"[42]bIeHoIsusEBlDlkEldyBBsfCfjdzCeKHwnJHqveGqa",222,0.991111,42,225,2,223,1,2,1,3,2,120,119,104,104,97
"8557",56,"[42]bIeHoIsusEBlDlkEldyBBsfCfjdzCeKHwnJHqveGqa",227,0.991304,42,230,2,228,1,2,1,3,2,125,124,104,104,97
"8558",57,"[42]bIeHoIsusEBlDlkEldyBBsfCfjdzCeKHwnJHqveGqa",224,0.991189,42,227,2,225,1,2,1,3,2,121,120,105,105,97
"8559",58,"[42]bIeHoIsusEBlDlkEldyBBsfCfjdzCeKHwnJHqveGqa",205,0.990385,42,208,2,206,1,2,1,3,2,94,93,113,113,97
"8560",59,"[42]bIeHoIsusEBlDlkEldyBBsfCfjdzCeKHwnJHqveGqa",214,0.990783,42,217,2,215,1,2,1,3,2,108,107,108,108,97
"8561",60,"[42]bIeHoIsusEBlDlkEldyBBsfCfjdzCeKHwnJHqveGqa",212,0.990698,42,215,2,213,1,2,1,3,2,104,103,110,110,97
"8562",61,"[42]bIeHoIsusEBlDlkEldyBBsfCfjdzCeKHwnJHqveGqa",228,0.991342,42,231,2,229,1,2,1,3,2,123,122,107,107,97
"8563",62,"[42]bIeHoIsusEBlDlkEldyBBsfCfjdzCeKHwnJHqveGqa",219,0.990991,42,222,2,220,1,2,1,3,2,114,113,107,107,97
"8564",63,"[42]bIeHoIsusEBlDlkEldyBBsfCfjdzCeKHwnJHqveGqa",218,0.99095,42,221,2,219,1,2,1,3,2,111,110,109,109,97
"8565",64,"[42]bIeHoIsusEBlDlkEldyBBsfCfjdzCeKHwnJHqveGqa",218,0.99095,42,221,2,219,1,2,1,3,2,114,113,106,106,97
"8566",65,"[42]bIeHoIsusEBlDlkEldyBBsfCfjdzCeKHwnJHqveGqa",212,0.990698,42,215,2,213,1,2,1,3,2,107,106,107,107,97
"8567",66,"[42]bIeHoIsusEBlDlkEldyBBsfCfjdzCeKHwnJHqveGqa",211,0.990654,42,214,2,212,1,2,1,3,2,104,103,109,109,97
"8568",67,"[42]bIeHoIsusEBlDlkEldyBBsfCfjdzCeKHwnJHqveGqa",220,0.991031,42,223,2,221,1,2,1,3,2,113,112,109,109,97
"8569",68,"[42]bIeHoIsusEBlDlkEldyBBsfCfjdzCeKHwnJHqveGqa",199,0.990099,42,202,2,200,1,2,1,3,2,88,87,113,113,97
"8570",69,"[42]bIeHoIsusEBlDlkEldyBBsfCfjdzCeKHwnJHqveGqa",218,0.99095,42,221,2,219,1,2,1,3,2,114,113,106,106,97
"8571",70,"[42]bIeHoIsusEBlDlkEldyBBsfCfjdzCeKHwnJHqveGqa",199,0.990099,42,202,2,200,1,2,1,3,2,87,86,114,114,97
"8572",71,"[42]bIeHoIsusEBlDlkEldyBBsfCfjdzCeKHwnJHqveGqa",209,0.990566,42,212,2,210,1,2,1,3,2,101,100,110,110,97
"8573",72,"[42]bIeHoIsusEBlDlkEldyBBsfCfjdzCeKHwnJHqveGqa",232,0.991489,42,235,2,233,1,2,1,3,2,130,129,104,104,97
"8574",73,"[42]bIeHoIsusEBlDlkEldyBBsfCfjdzCeKHwnJHqveGqa",219,0.990991,42,222,2,220,1,2,1,3,2,117,116,104,104,97
"8575",74,"[42]bIeHoIsusEBlDlkEldyBBsfCfjdzCeKHwnJHqveGqa",216,0.990868,42,219,2,217,1,2,1,3,2,108,107,110,110,97
"8576",75,"[42]bIeHoIsusEBlDlkEldyBBsfCfjdzCeKHwnJHqveGqa",223,0.99115,42,226,2,224,1,2,1,3,2,121,120,104,104,97
"8577",76,"[42]bIeHoIsusEBlDlkEldyBBsfCfjdzCeKHwnJHqveGqa",211,0.990654,42,214,2,212,1,2,1,3,2,102,101,111,111,97
"8578",77,"[42]bIeHoIsusEBlDlkEldyBBsfCfjdzCeKHwnJHqveGqa",228,0.991342,42,231,2,229,1,2,1,3,2,126,125,104,104,97
"8579",78,"[42]bIeHoIsusEBlDlkEldyBBsfCfjdzCeKHwnJHqveGqa",217,0.990909,42,220,2,218,1,2,1,3,2,113,112,106,106,97
"8580",79,"[42]bIeHoIsusEBlDlkEldyBBsfCfjdzCeKHwnJHqveGqa",215,0.990826,42,218,2,216,1,2,1,3,2,109,108,108,108,97
"8581",80,"[42]bIeHoIsusEBlDlkEldyBBsfCfjdzCeKHwnJHqveGqa",221,0.991071,42,224,2,222,1,2,1,3,2,119,118,104,104,97
"8582",81,"[42]bIeHoIsusEBlDlkEldyBBsfCfjdzCeKHwnJHqveGqa",221,0.991071,42,224,2,222,1,2,1,3,2,118,117,105,105,97
"8583",82,"[42]bIeHoIsusEBlDlkEldyBBsfCfjdzCeKHwnJHqveGqa",189,0.989583,42,192,2,190,1,2,1,3,2,75,74,116,116,97
"8584",83,"[42]bIeHoIsusEBlDlkEldyBBsfCfjdzCeKHwnJHqveGqa",219,0.990991,42,222,2,220,1,2,1,3,2,114,113,107,107,97
"8585",84,"[42]bIeHoIsusEBlDlkEldyBBsfCfjdzCeKHwnJHqveGqa",214,0.990783,42,217,2,215,1,2,1,3,2,106,105,110,110,97
"8586",85,"[42]bIeHoIsusEBlDlkEldyBBsfCfjdzCeKHwnJHqveGqa",213,0.990741,42,216,2,214,1,2,1,3,2,103,102,112,112,97
"8587",86,"[42]bIeHoIsusEBlDlkEldyBBsfCfjdzCeKHwnJHqveGqa",217,0.990909,42,220,2,218,1,2,1,3,2,113,112,106,106,97
"8588",87,"[42]bIeHoIsusEBlDlkEldyBBsfCfjdzCeKHwnJHqveGqa",204,0.990338,42,207,2,205,1,2,1,3,2,91,90,115,115,97
"8589",88,"[42]bIeHoIsusEBlDlkEldyBBsfCfjdzCeKHwnJHqveGqa",206,0.990431,42,209,2,207,1,2,1,3,2,96,95,112,112,97
"8590",89,"[42]bIeHoIsusEBlDlkEldyBBsfCfjdzCeKHwnJHqveGqa",216,0.990868,42,219,2,217,1,2,1,3,2,111,110,107,107,97
"8591",90,"[42]bIeHoIsusEBlDlkEldyBBsfCfjdzCeKHwnJHqveGqa",221,0.991071,42,224,2,222,1,2,1,3,2,117,116,106,106,97
"8592",91,"[42]bIeHoIsusEBlDlkEldyBBsfCfjdzCeKHwnJHqveGqa",216,0.990868,42,219,2,217,1,2,1,3,2,110,109,108,108,97
"8593",92,"[42]bIeHoIsusEBlDlkEldyBBsfCfjdzCeKHwnJHqveGqa",211,0.990654,42,214,2,212,1,2,1,3,2,103,102,110,110,97
"8594",93,"[42]bIeHoIsusEBlDlkEldyBBsfCfjdzCeKHwnJHqveGqa",214,0.990783,42,217,2,215,1,2,1,3,2,105,104,111,111,97
"8595",94,"[42]bIeHoIsusEBlDlkEldyBBsfCfjdzCeKHwnJHqveGqa",224,0.991189,42,227,2,225,1,2,1,3,2,124,123,102,102,97
"8596",95,"[42]bIeHoIsusEBlDlkEldyBBsfCfjdzCeKHwnJHqveGqa",224,0.991189,42,227,2,225,1,2,1,3,2,121,120,105,105,97
"8597",96,"[42]bIeHoIsusEBlDlkEldyBBsfCfjdzCeKHwnJHqveGqa",216,0.990868,42,219,2,217,1,2,1,3,2,111,110,107,107,97
"8598",97,"[42]bIeHoIsusEBlDlkEldyBBsfCfjdzCeKHwnJHqveGqa",219,0.990991,42,222,2,220,1,2,1,3,2,115,114,106,106,97
"8599",98,"[42]bIeHoIsusEBlDlkEldyBBsfCfjdzCeKHwnJHqveGqa",234,0.991561,42,237,2,235,1,2,1,3,2,137,136,99,99,97
"8600",99,"[42]bIeHoIsusEBlDlkEldyBBsfCfjdzCeKHwnJHqveGqa",219,0.990991,42,222,2,220,1,2,1,3,2,114,113,107,107,97
"8601",0,"[40]BIaHoIpgsBkDCntAJxCprgbKDaeghHxnJHqxbGqa",194,0.989848,40,197,2,195,1,2,1,3,2,91,90,105,105,98
"8602",1,"[40]BIaHoIpgsBkDCntAJxCprgbKDaeghHxnJHqxbGqa",203,0.990291,40,206,2,204,1,2,1,3,2,105,104,100,100,98
"8603",2,"[40]BIaHoIpgsBkDCntAJxCprgbKDaeghHxnJHqxbGqa",194,0.989848,40,197,2,195,1,2,1,3,2,94,93,102,102,98
"8604",3,"[40]BIaHoIpgsBkDCntAJxCprgbKDaeghHxnJHqxbGqa",202,0.990244,40,205,2,203,1,2,1,3,2,105,104,99,99,98
"8605",4,"[40]BIaHoIpgsBkDCntAJxCprgbKDaeghHxnJHqxbGqa",206,0.990431,40,209,2,207,1,2,1,3,2,109,108,99,99,98
"8606",5,"[40]BIaHoIpgsBkDCntAJxCprgbKDaeghHxnJHqxbGqa",207,0.990476,40,210,2,208,1,2,1,3,2,111,110,98,98,98
"8607",6,"[40]BIaHoIpgsBkDCntAJxCprgbKDaeghHxnJHqxbGqa",186,0.989418,40,189,2,187,1,2,1,3,2,79,78,109,109,98
"8608",7,"[40]BIaHoIpgsBkDCntAJxCprgbKDaeghHxnJHqxbGqa",203,0.990291,40,206,2,204,1,2,1,3,2,105,104,100,100,98
"8609",8,"[40]BIaHoIpgsBkDCntAJxCprgbKDaeghHxnJHqxbGqa",199,0.990099,40,202,2,200,1,2,1,3,2,98,97,103,103,98
"8610",9,"[40]BIaHoIpgsBkDCntAJxCprgbKDaeghHxnJHqxbGqa",200,0.990148,40,203,2,201,1,2,1,3,2,102,101,100,100,98
"8611",10,"[40]BIaHoIpgsBkDCntAJxCprgbKDaeghHxnJHqxbGqa",200,0.990148,40,203,2,201,1,2,1,3,2,104,103,98,98,98
"8612",11,"[40]BIaHoIpgsBkDCntAJxCprgbKDaeghHxnJHqxbGqa",193,0.989796,40,196,2,194,1,2,1,3,2,91,90,104,104,98
"8613",12,"[40]BIaHoIpgsBkDCntAJxCprgbKDaeghHxnJHqxbGqa",204,0.990338,40,207,2,205,1,2,1,3,2,107,106,99,99,98
"8614",13,"[40]BIaHoIpgsBkDCntAJxCprgbKDaeghHxnJHqxbGqa",197,0.99,40,200,2,198,1,2,1,3,2,97,96,102,102,98
"8615",14,"[40]BIaHoIpgsBkDCntAJxCprgbKDaeghHxnJHqxbGqa",199,0.990099,40,202,2,200,1,2,1,3,2,100,99,101,101,98
"8616",15,"[40]BIaHoIpgsBkDCntAJxCprgbKDaeghHxnJHqxbGqa",201,0.990196,40,204,2,202,1,2,1,3,2,103,102,100,100,98
"8617",16,"[40]BIaHoIpgsBkDCntAJxCprgbKDaeghHxnJHqxbGqa",201,0.990196,40,204,2,202,1,2,1,3,2,102,101,101,101,98
"8618",17,"[40]BIaHoIpgsBkDCntAJxCprgbKDaeghHxnJHqxbGqa",192,0.989744,40,195,2,193,1,2,1,3,2,89,88,105,105,98
"8619",18,"[40]BIaHoIpgsBkDCntAJxCprgbKDaeghHxnJHqxbGqa",201,0.990196,40,204,2,202,1,2,1,3,2,101,100,102,102,98
"8620",19,"[40]BIaHoIpgsBkDCntAJxCprgbKDaeghHxnJHqxbGqa",192,0.989744,40,195,2,193,1,2,1,3,2,87,86,107,107,98
"8621",20,"[40]BIaHoIpgsBkDCntAJxCprgbKDaeghHxnJHqxbGqa",207,0.990476,40,210,2,208,1,2,1,3,2,109,108,100,100,98
"8622",21,"[40]BIaHoIpgsBkDCntAJxCprgbKDaeghHxnJHqxbGqa",200,0.990148,40,203,2,201,1,2,1,3,2,100,99,102,102,98
"8623",22,"[40]BIaHoIpgsBkDCntAJxCprgbKDaeghHxnJHqxbGqa",185,0.989362,40,188,2,186,1,2,1,3,2,81,80,106,106,98
"8624",23,"[40]BIaHoIpgsBkDCntAJxCprgbKDaeghHxnJHqxbGqa",203,0.990291,40,206,2,204,1,2,1,3,2,106,105,99,99,98
"8625",24,"[40]BIaHoIpgsBkDCntAJxCprgbKDaeghHxnJHqxbGqa",204,0.990338,40,207,2,205,1,2,1,3,2,105,104,101,101,98
"8626",25,"[40]BIaHoIpgsBkDCntAJxCprgbKDaeghHxnJHqxbGqa",215,0.990826,40,218,2,216,1,2,1,3,2,124,123,93,93,98
"8627",26,"[40]BIaHoIpgsBkDCntAJxCprgbKDaeghHxnJHqxbGqa",199,0.990099,40,202,2,200,1,2,1,3,2,100,99,101,101,98
"8628",27,"[40]BIaHoIpgsBkDCntAJxCprgbKDaeghHxnJHqxbGqa",187,0.989474,40,190,2,188,1,2,1,3,2,81,80,108,108,98
"8629",28,"[40]BIaHoIpgsBkDCntAJxCprgbKDaeghHxnJHqxbGqa",197,0.99,40,200,2,198,1,2,1,3,2,98,97,101,101,98
"8630",29,"[40]BIaHoIpgsBkDCntAJxCprgbKDaeghHxnJHqxbGqa",200,0.990148,40,203,2,201,1,2,1,3,2,101,100,101,101,98
"8631",30,"[40]BIaHoIpgsBkDCntAJxCprgbKDaeghHxnJHqxbGqa",196,0.98995,40,199,2,197,1,2,1,3,2,97,96,101,101,98
"8632",31,"[40]BIaHoIpgsBkDCntAJxCprgbKDaeghHxnJHqxbGqa",205,0.990385,40,208,2,206,1,2,1,3,2,108,107,99,99,98
"8633",32,"[40]BIaHoIpgsBkDCntAJxCprgbKDaeghHxnJHqxbGqa",216,0.990868,40,219,2,217,1,2,1,3,2,125,124,93,93,98
"8634",33,"[40]BIaHoIpgsBkDCntAJxCprgbKDaeghHxnJHqxbGqa",212,0.990698,40,215,2,213,1,2,1,3,2,120,119,94,94,98
"8635",34,"[40]BIaHoIpgsBkDCntAJxCprgbKDaeghHxnJHqxbGqa",196,0.98995,40,199,2,197,1,2,1,3,2,94,93,104,104,98
"8636",35,"[40]BIaHoIpgsBkDCntAJxCprgbKDaeghHxnJHqxbGqa",201,0.990196,40,204,2,202,1,2,1,3,2,101,100,102,102,98
"8637",36,"[40]BIaHoIpgsBkDCntAJxCprgbKDaeghHxnJHqxbGqa",218,0.99095,40,221,2,219,1,2,1,3,2,125,124,95,95,98
"8638",37,"[40]BIaHoIpgsBkDCntAJxCprgbKDaeghHxnJHqxbGqa",196,0.98995,40,199,2,197,1,2,1,3,2,95,94,103,103,98
"8639",38,"[40]BIaHoIpgsBkDCntAJxCprgbKDaeghHxnJHqxbGqa",200,0.990148,40,203,2,201,1,2,1,3,2,101,100,101,101,98
"8640",39,"[40]BIaHoIpgsBkDCntAJxCprgbKDaeghHxnJHqxbGqa",194,0.989848,40,197,2,195,1,2,1,3,2,91,90,105,105,98
"8641",40,"[40]BIaHoIpgsBkDCntAJxCprgbKDaeghHxnJHqxbGqa",202,0.990244,40,205,2,203,1,2,1,3,2,102,101,102,102,98
"8642",41,"[40]BIaHoIpgsBkDCntAJxCprgbKDaeghHxnJHqxbGqa",200,0.990148,40,203,2,201,1,2,1,3,2,102,101,100,100,98
"8643",42,"[40]BIaHoIpgsBkDCntAJxCprgbKDaeghHxnJHqxbGqa",210,0.99061,40,213,2,211,1,2,1,3,2,113,112,99,99,98
"8644",43,"[40]BIaHoIpgsBkDCntAJxCprgbKDaeghHxnJHqxbGqa",204,0.990338,40,207,2,205,1,2,1,3,2,108,107,98,98,98
"8645",44,"[40]BIaHoIpgsBkDCntAJxCprgbKDaeghHxnJHqxbGqa",204,0.990338,40,207,2,205,1,2,1,3,2,106,105,100,100,98
"8646",45,"[40]BIaHoIpgsBkDCntAJxCprgbKDaeghHxnJHqxbGqa",199,0.990099,40,202,2,200,1,2,1,3,2,99,98,102,102,98
"8647",46,"[40]BIaHoIpgsBkDCntAJxCprgbKDaeghHxnJHqxbGqa",194,0.989848,40,197,2,195,1,2,1,3,2,92,91,104,104,98
"8648",47,"[40]BIaHoIpgsBkDCntAJxCprgbKDaeghHxnJHqxbGqa",188,0.989529,40,191,2,189,1,2,1,3,2,86,85,104,104,98
"8649",48,"[40]BIaHoIpgsBkDCntAJxCprgbKDaeghHxnJHqxbGqa",198,0.99005,40,201,2,199,1,2,1,3,2,96,95,104,104,98
"8650",49,"[40]BIaHoIpgsBkDCntAJxCprgbKDaeghHxnJHqxbGqa",210,0.99061,40,213,2,211,1,2,1,3,2,115,114,97,97,98
"8651",50,"[40]BIaHoIpgsBkDCntAJxCprgbKDaeghHxnJHqxbGqa",191,0.989691,40,194,2,192,1,2,1,3,2,87,86,106,106,98
"8652",51,"[40]BIaHoIpgsBkDCntAJxCprgbKDaeghHxnJHqxbGqa",207,0.990476,40,210,2,208,1,2,1,3,2,109,108,100,100,98
"8653",52,"[40]BIaHoIpgsBkDCntAJxCprgbKDaeghHxnJHqxbGqa",192,0.989744,40,195,2,193,1,2,1,3,2,90,89,104,104,98
"8654",53,"[40]BIaHoIpgsBkDCntAJxCprgbKDaeghHxnJHqxbGqa",211,0.990654,40,214,2,212,1,2,1,3,2,115,114,98,98,98
"8655",54,"[40]BIaHoIpgsBkDCntAJxCprgbKDaeghHxnJHqxbGqa",189,0.989583,40,192,2,190,1,2,1,3,2,85,84,106,106,98
"8656",55,"[40]BIaHoIpgsBkDCntAJxCprgbKDaeghHxnJHqxbGqa",201,0.990196,40,204,2,202,1,2,1,3,2,101,100,102,102,98
"8657",56,"[40]BIaHoIpgsBkDCntAJxCprgbKDaeghHxnJHqxbGqa",194,0.989848,40,197,2,195,1,2,1,3,2,94,93,102,102,98
"8658",57,"[40]BIaHoIpgsBkDCntAJxCprgbKDaeghHxnJHqxbGqa",203,0.990291,40,206,2,204,1,2,1,3,2,106,105,99,99,98
"8659",58,"[40]BIaHoIpgsBkDCntAJxCprgbKDaeghHxnJHqxbGqa",199,0.990099,40,202,2,200,1,2,1,3,2,98,97,103,103,98
"8660",59,"[40]BIaHoIpgsBkDCntAJxCprgbKDaeghHxnJHqxbGqa",194,0.989848,40,197,2,195,1,2,1,3,2,94,93,102,102,98
"8661",60,"[40]BIaHoIpgsBkDCntAJxCprgbKDaeghHxnJHqxbGqa",209,0.990566,40,212,2,210,1,2,1,3,2,112,111,99,99,98
"8662",61,"[40]BIaHoIpgsBkDCntAJxCprgbKDaeghHxnJHqxbGqa",203,0.990291,40,206,2,204,1,2,1,3,2,104,103,101,101,98
"8663",62,"[40]BIaHoIpgsBkDCntAJxCprgbKDaeghHxnJHqxbGqa",200,0.990148,40,203,2,201,1,2,1,3,2,100,99,102,102,98
"8664",63,"[40]BIaHoIpgsBkDCntAJxCprgbKDaeghHxnJHqxbGqa",206,0.990431,40,209,2,207,1,2,1,3,2,106,105,102,102,98
"8665",64,"[40]BIaHoIpgsBkDCntAJxCprgbKDaeghHxnJHqxbGqa",200,0.990148,40,203,2,201,1,2,1,3,2,100,99,102,102,98
"8666",65,"[40]BIaHoIpgsBkDCntAJxCprgbKDaeghHxnJHqxbGqa",191,0.989691,40,194,2,192,1,2,1,3,2,90,89,103,103,98
"8667",66,"[40]BIaHoIpgsBkDCntAJxCprgbKDaeghHxnJHqxbGqa",192,0.989744,40,195,2,193,1,2,1,3,2,91,90,103,103,98
"8668",67,"[40]BIaHoIpgsBkDCntAJxCprgbKDaeghHxnJHqxbGqa",212,0.990698,40,215,2,213,1,2,1,3,2,115,114,99,99,98
"8669",68,"[40]BIaHoIpgsBkDCntAJxCprgbKDaeghHxnJHqxbGqa",187,0.989474,40,190,2,188,1,2,1,3,2,83,82,106,106,98
"8670",69,"[40]BIaHoIpgsBkDCntAJxCprgbKDaeghHxnJHqxbGqa",196,0.98995,40,199,2,197,1,2,1,3,2,95,94,103,103,98
"8671",70,"[40]BIaHoIpgsBkDCntAJxCprgbKDaeghHxnJHqxbGqa",224,0.991189,40,227,2,225,1,2,1,3,2,135,134,91,91,98
"8672",71,"[40]BIaHoIpgsBkDCntAJxCprgbKDaeghHxnJHqxbGqa",203,0.990291,40,206,2,204,1,2,1,3,2,105,104,100,100,98
"8673",72,"[40]BIaHoIpgsBkDCntAJxCprgbKDaeghHxnJHqxbGqa",200,0.990148,40,203,2,201,1,2,1,3,2,99,98,103,103,98
"8674",73,"[40]BIaHoIpgsBkDCntAJxCprgbKDaeghHxnJHqxbGqa",207,0.990476,40,210,2,208,1,2,1,3,2,109,108,100,100,98
"8675",74,"[40]BIaHoIpgsBkDCntAJxCprgbKDaeghHxnJHqxbGqa",197,0.99,40,200,2,198,1,2,1,3,2,92,91,107,107,98
"8676",75,"[40]BIaHoIpgsBkDCntAJxCprgbKDaeghHxnJHqxbGqa",210,0.99061,40,213,2,211,1,2,1,3,2,113,112,99,99,98
"8677",76,"[40]BIaHoIpgsBkDCntAJxCprgbKDaeghHxnJHqxbGqa",188,0.989529,40,191,2,189,1,2,1,3,2,85,84,105,105,98
"8678",77,"[40]BIaHoIpgsBkDCntAJxCprgbKDaeghHxnJHqxbGqa",209,0.990566,40,212,2,210,1,2,1,3,2,113,112,98,98,98
"8679",78,"[40]BIaHoIpgsBkDCntAJxCprgbKDaeghHxnJHqxbGqa",204,0.990338,40,207,2,205,1,2,1,3,2,108,107,98,98,98
"8680",79,"[40]BIaHoIpgsBkDCntAJxCprgbKDaeghHxnJHqxbGqa",208,0.990521,40,211,2,209,1,2,1,3,2,112,111,98,98,98
"8681",80,"[40]BIaHoIpgsBkDCntAJxCprgbKDaeghHxnJHqxbGqa",192,0.989744,40,195,2,193,1,2,1,3,2,90,89,104,104,98
"8682",81,"[40]BIaHoIpgsBkDCntAJxCprgbKDaeghHxnJHqxbGqa",208,0.990521,40,211,2,209,1,2,1,3,2,110,109,100,100,98
"8683",82,"[40]BIaHoIpgsBkDCntAJxCprgbKDaeghHxnJHqxbGqa",200,0.990148,40,203,2,201,1,2,1,3,2,102,101,100,100,98
"8684",83,"[40]BIaHoIpgsBkDCntAJxCprgbKDaeghHxnJHqxbGqa",202,0.990244,40,205,2,203,1,2,1,3,2,105,104,99,99,98
"8685",84,"[40]BIaHoIpgsBkDCntAJxCprgbKDaeghHxnJHqxbGqa",199,0.990099,40,202,2,200,1,2,1,3,2,96,95,105,105,98
"8686",85,"[40]BIaHoIpgsBkDCntAJxCprgbKDaeghHxnJHqxbGqa",199,0.990099,40,202,2,200,1,2,1,3,2,98,97,103,103,98
"8687",86,"[40]BIaHoIpgsBkDCntAJxCprgbKDaeghHxnJHqxbGqa",192,0.989744,40,195,2,193,1,2,1,3,2,89,88,105,105,98
"8688",87,"[40]BIaHoIpgsBkDCntAJxCprgbKDaeghHxnJHqxbGqa",199,0.990099,40,202,2,200,1,2,1,3,2,100,99,101,101,98
"8689",88,"[40]BIaHoIpgsBkDCntAJxCprgbKDaeghHxnJHqxbGqa",217,0.990909,40,220,2,218,1,2,1,3,2,125,124,94,94,98
"8690",89,"[40]BIaHoIpgsBkDCntAJxCprgbKDaeghHxnJHqxbGqa",186,0.989418,40,189,2,187,1,2,1,3,2,81,80,107,107,98
"8691",90,"[40]BIaHoIpgsBkDCntAJxCprgbKDaeghHxnJHqxbGqa",208,0.990521,40,211,2,209,1,2,1,3,2,112,111,98,98,98
"8692",91,"[40]BIaHoIpgsBkDCntAJxCprgbKDaeghHxnJHqxbGqa",209,0.990566,40,212,2,210,1,2,1,3,2,114,113,97,97,98
"8693",92,"[40]BIaHoIpgsBkDCntAJxCprgbKDaeghHxnJHqxbGqa",188,0.989529,40,191,2,189,1,2,1,3,2,84,83,106,106,98
"8694",93,"[40]BIaHoIpgsBkDCntAJxCprgbKDaeghHxnJHqxbGqa",208,0.990521,40,211,2,209,1,2,1,3,2,111,110,99,99,98
"8695",94,"[40]BIaHoIpgsBkDCntAJxCprgbKDaeghHxnJHqxbGqa",200,0.990148,40,203,2,201,1,2,1,3,2,102,101,100,100,98
"8696",95,"[40]BIaHoIpgsBkDCntAJxCprgbKDaeghHxnJHqxbGqa",219,0.990991,40,222,2,220,1,2,1,3,2,128,127,93,93,98
"8697",96,"[40]BIaHoIpgsBkDCntAJxCprgbKDaeghHxnJHqxbGqa",202,0.990244,40,205,2,203,1,2,1,3,2,102,101,102,102,98
"8698",97,"[40]BIaHoIpgsBkDCntAJxCprgbKDaeghHxnJHqxbGqa",189,0.989583,40,192,2,190,1,2,1,3,2,86,85,105,105,98
"8699",98,"[40]BIaHoIpgsBkDCntAJxCprgbKDaeghHxnJHqxbGqa",188,0.989529,40,191,2,189,1,2,1,3,2,85,84,105,105,98
"8700",99,"[40]BIaHoIpgsBkDCntAJxCprgbKDaeghHxnJHqxbGqa",201,0.990196,40,204,2,202,1,2,1,3,2,104,103,99,99,98
"8701",0,"[38]IHoIveBCFufhsqHjnijfbKDeepkHunJHqvbGqa",207,0.990476,38,210,2,208,1,2,1,3,2,110,109,99,99,99
"8702",1,"[38]IHoIveBCFufhsqHjnijfbKDeepkHunJHqvbGqa",194,0.989848,38,197,2,195,1,2,1,3,2,93,92,103,103,99
"8703",2,"[38]IHoIveBCFufhsqHjnijfbKDeepkHunJHqvbGqa",189,0.989583,38,192,2,190,1,2,1,3,2,86,85,105,105,99
"8704",3,"[38]IHoIveBCFufhsqHjnijfbKDeepkHunJHqvbGqa",200,0.990148,38,203,2,201,1,2,1,3,2,100,99,102,102,99
"8705",4,"[38]IHoIveBCFufhsqHjnijfbKDeepkHunJHqvbGqa",196,0.98995,38,199,2,197,1,2,1,3,2,95,94,103,103,99
"8706",5,"[38]IHoIveBCFufhsqHjnijfbKDeepkHunJHqvbGqa",190,0.989637,38,193,2,191,1,2,1,3,2,85,84,107,107,99
"8707",6,"[38]IHoIveBCFufhsqHjnijfbKDeepkHunJHqvbGqa",197,0.99,38,200,2,198,1,2,1,3,2,97,96,102,102,99
"8708",7,"[38]IHoIveBCFufhsqHjnijfbKDeepkHunJHqvbGqa",218,0.99095,38,221,2,219,1,2,1,3,2,124,123,96,96,99
"8709",8,"[38]IHoIveBCFufhsqHjnijfbKDeepkHunJHqvbGqa",196,0.98995,38,199,2,197,1,2,1,3,2,95,94,103,103,99
"8710",9,"[38]IHoIveBCFufhsqHjnijfbKDeepkHunJHqvbGqa",202,0.990244,38,205,2,203,1,2,1,3,2,101,100,103,103,99
"8711",10,"[38]IHoIveBCFufhsqHjnijfbKDeepkHunJHqvbGqa",197,0.99,38,200,2,198,1,2,1,3,2,97,96,102,102,99
"8712",11,"[38]IHoIveBCFufhsqHjnijfbKDeepkHunJHqvbGqa",199,0.990099,38,202,2,200,1,2,1,3,2,97,96,104,104,99
"8713",12,"[38]IHoIveBCFufhsqHjnijfbKDeepkHunJHqvbGqa",198,0.99005,38,201,2,199,1,2,1,3,2,98,97,102,102,99
"8714",13,"[38]IHoIveBCFufhsqHjnijfbKDeepkHunJHqvbGqa",206,0.990431,38,209,2,207,1,2,1,3,2,109,108,99,99,99
"8715",14,"[38]IHoIveBCFufhsqHjnijfbKDeepkHunJHqvbGqa",202,0.990244,38,205,2,203,1,2,1,3,2,104,103,100,100,99
"8716",15,"[38]IHoIveBCFufhsqHjnijfbKDeepkHunJHqvbGqa",191,0.989691,38,194,2,192,1,2,1,3,2,88,87,105,105,99
"8717",16,"[38]IHoIveBCFufhsqHjnijfbKDeepkHunJHqvbGqa",210,0.99061,38,213,2,211,1,2,1,3,2,114,113,98,98,99
"8718",17,"[38]IHoIveBCFufhsqHjnijfbKDeepkHunJHqvbGqa",215,0.990826,38,218,2,216,1,2,1,3,2,120,119,97,97,99
"8719",18,"[38]IHoIveBCFufhsqHjnijfbKDeepkHunJHqvbGqa",189,0.989583,38,192,2,190,1,2,1,3,2,86,85,105,105,99
"8720",19,"[38]IHoIveBCFufhsqHjnijfbKDeepkHunJHqvbGqa",200,0.990148,38,203,2,201,1,2,1,3,2,101,100,101,101,99
"8721",20,"[38]IHoIveBCFufhsqHjnijfbKDeepkHunJHqvbGqa",194,0.989848,38,197,2,195,1,2,1,3,2,91,90,105,105,99
"8722",21,"[38]IHoIveBCFufhsqHjnijfbKDeepkHunJHqvbGqa",214,0.990783,38,217,2,215,1,2,1,3,2,120,119,96,96,99
"8723",22,"[38]IHoIveBCFufhsqHjnijfbKDeepkHunJHqvbGqa",188,0.989529,38,191,2,189,1,2,1,3,2,82,81,108,108,99
"8724",23,"[38]IHoIveBCFufhsqHjnijfbKDeepkHunJHqvbGqa",184,0.989305,38,187,2,185,1,2,1,3,2,78,77,108,108,99
"8725",24,"[38]IHoIveBCFufhsqHjnijfbKDeepkHunJHqvbGqa",227,0.991304,38,230,2,228,1,2,1,3,2,137,136,92,92,99
"8726",25,"[38]IHoIveBCFufhsqHjnijfbKDeepkHunJHqvbGqa",206,0.990431,38,209,2,207,1,2,1,3,2,110,109,98,98,99
"8727",26,"[38]IHoIveBCFufhsqHjnijfbKDeepkHunJHqvbGqa",183,0.989247,38,186,2,184,1,2,1,3,2,76,75,109,109,99
"8728",27,"[38]IHoIveBCFufhsqHjnijfbKDeepkHunJHqvbGqa",186,0.989418,38,189,2,187,1,2,1,3,2,81,80,107,107,99
"8729",28,"[38]IHoIveBCFufhsqHjnijfbKDeepkHunJHqvbGqa",191,0.989691,38,194,2,192,1,2,1,3,2,88,87,105,105,99
"8730",29,"[38]IHoIveBCFufhsqHjnijfbKDeepkHunJHqvbGqa",204,0.990338,38,207,2,205,1,2,1,3,2,108,107,98,98,99
"8731",30,"[38]IHoIveBCFufhsqHjnijfbKDeepkHunJHqvbGqa",205,0.990385,38,208,2,206,1,2,1,3,2,107,106,100,100,99
"8732",31,"[38]IHoIveBCFufhsqHjnijfbKDeepkHunJHqvbGqa",204,0.990338,38,207,2,205,1,2,1,3,2,106,105,100,100,99
"8733",32,"[38]IHoIveBCFufhsqHjnijfbKDeepkHunJHqvbGqa",211,0.990654,38,214,2,212,1,2,1,3,2,119,118,94,94,99
"8734",33,"[38]IHoIveBCFufhsqHjnijfbKDeepkHunJHqvbGqa",204,0.990338,38,207,2,205,1,2,1,3,2,107,106,99,99,99
"8735",34,"[38]IHoIveBCFufhsqHjnijfbKDeepkHunJHqvbGqa",200,0.990148,38,203,2,201,1,2,1,3,2,100,99,102,102,99
"8736",35,"[38]IHoIveBCFufhsqHjnijfbKDeepkHunJHqvbGqa",204,0.990338,38,207,2,205,1,2,1,3,2,106,105,100,100,99
"8737",36,"[38]IHoIveBCFufhsqHjnijfbKDeepkHunJHqvbGqa",213,0.990741,38,216,2,214,1,2,1,3,2,118,117,97,97,99
"8738",37,"[38]IHoIveBCFufhsqHjnijfbKDeepkHunJHqvbGqa",211,0.990654,38,214,2,212,1,2,1,3,2,116,115,97,97,99
"8739",38,"[38]IHoIveBCFufhsqHjnijfbKDeepkHunJHqvbGqa",199,0.990099,38,202,2,200,1,2,1,3,2,100,99,101,101,99
"8740",39,"[38]IHoIveBCFufhsqHjnijfbKDeepkHunJHqvbGqa",207,0.990476,38,210,2,208,1,2,1,3,2,112,111,97,97,99
"8741",40,"[38]IHoIveBCFufhsqHjnijfbKDeepkHunJHqvbGqa",188,0.989529,38,191,2,189,1,2,1,3,2,83,82,107,107,99
"8742",41,"[38]IHoIveBCFufhsqHjnijfbKDeepkHunJHqvbGqa",200,0.990148,38,203,2,201,1,2,1,3,2,99,98,103,103,99
"8743",42,"[38]IHoIveBCFufhsqHjnijfbKDeepkHunJHqvbGqa",213,0.990741,38,216,2,214,1,2,1,3,2,116,115,99,99,99
"8744",43,"[38]IHoIveBCFufhsqHjnijfbKDeepkHunJHqvbGqa",218,0.99095,38,221,2,219,1,2,1,3,2,125,124,95,95,99
"8745",44,"[38]IHoIveBCFufhsqHjnijfbKDeepkHunJHqvbGqa",208,0.990521,38,211,2,209,1,2,1,3,2,112,111,98,98,99
"8746",45,"[38]IHoIveBCFufhsqHjnijfbKDeepkHunJHqvbGqa",218,0.99095,38,221,2,219,1,2,1,3,2,127,126,93,93,99
"8747",46,"[38]IHoIveBCFufhsqHjnijfbKDeepkHunJHqvbGqa",200,0.990148,38,203,2,201,1,2,1,3,2,98,97,104,104,99
"8748",47,"[38]IHoIveBCFufhsqHjnijfbKDeepkHunJHqvbGqa",206,0.990431,38,209,2,207,1,2,1,3,2,109,108,99,99,99
"8749",48,"[38]IHoIveBCFufhsqHjnijfbKDeepkHunJHqvbGqa",214,0.990783,38,217,2,215,1,2,1,3,2,118,117,98,98,99
"8750",49,"[38]IHoIveBCFufhsqHjnijfbKDeepkHunJHqvbGqa",201,0.990196,38,204,2,202,1,2,1,3,2,101,100,102,102,99
"8751",50,"[38]IHoIveBCFufhsqHjnijfbKDeepkHunJHqvbGqa",204,0.990338,38,207,2,205,1,2,1,3,2,103,102,103,103,99
"8752",51,"[38]IHoIveBCFufhsqHjnijfbKDeepkHunJHqvbGqa",216,0.990868,38,219,2,217,1,2,1,3,2,124,123,94,94,99
"8753",52,"[38]IHoIveBCFufhsqHjnijfbKDeepkHunJHqvbGqa",207,0.990476,38,210,2,208,1,2,1,3,2,110,109,99,99,99
"8754",53,"[38]IHoIveBCFufhsqHjnijfbKDeepkHunJHqvbGqa",202,0.990244,38,205,2,203,1,2,1,3,2,101,100,103,103,99
"8755",54,"[38]IHoIveBCFufhsqHjnijfbKDeepkHunJHqvbGqa",196,0.98995,38,199,2,197,1,2,1,3,2,94,93,104,104,99
"8756",55,"[38]IHoIveBCFufhsqHjnijfbKDeepkHunJHqvbGqa",204,0.990338,38,207,2,205,1,2,1,3,2,105,104,101,101,99
"8757",56,"[38]IHoIveBCFufhsqHjnijfbKDeepkHunJHqvbGqa",200,0.990148,38,203,2,201,1,2,1,3,2,98,97,104,104,99
"8758",57,"[38]IHoIveBCFufhsqHjnijfbKDeepkHunJHqvbGqa",217,0.990909,38,220,2,218,1,2,1,3,2,126,125,93,93,99
"8759",58,"[38]IHoIveBCFufhsqHjnijfbKDeepkHunJHqvbGqa",196,0.98995,38,199,2,197,1,2,1,3,2,96,95,102,102,99
"8760",59,"[38]IHoIveBCFufhsqHjnijfbKDeepkHunJHqvbGqa",212,0.990698,38,215,2,213,1,2,1,3,2,113,112,101,101,99
"8761",60,"[38]IHoIveBCFufhsqHjnijfbKDeepkHunJHqvbGqa",202,0.990244,38,205,2,203,1,2,1,3,2,104,103,100,100,99
"8762",61,"[38]IHoIveBCFufhsqHjnijfbKDeepkHunJHqvbGqa",208,0.990521,38,211,2,209,1,2,1,3,2,113,112,97,97,99
"8763",62,"[38]IHoIveBCFufhsqHjnijfbKDeepkHunJHqvbGqa",193,0.989796,38,196,2,194,1,2,1,3,2,91,90,104,104,99
"8764",63,"[38]IHoIveBCFufhsqHjnijfbKDeepkHunJHqvbGqa",192,0.989744,38,195,2,193,1,2,1,3,2,90,89,104,104,99
"8765",64,"[38]IHoIveBCFufhsqHjnijfbKDeepkHunJHqvbGqa",199,0.990099,38,202,2,200,1,2,1,3,2,97,96,104,104,99
"8766",65,"[38]IHoIveBCFufhsqHjnijfbKDeepkHunJHqvbGqa",200,0.990148,38,203,2,201,1,2,1,3,2,102,101,100,100,99
"8767",66,"[38]IHoIveBCFufhsqHjnijfbKDeepkHunJHqvbGqa",199,0.990099,38,202,2,200,1,2,1,3,2,100,99,101,101,99
"8768",67,"[38]IHoIveBCFufhsqHjnijfbKDeepkHunJHqvbGqa",197,0.99,38,200,2,198,1,2,1,3,2,94,93,105,105,99
"8769",68,"[38]IHoIveBCFufhsqHjnijfbKDeepkHunJHqvbGqa",191,0.989691,38,194,2,192,1,2,1,3,2,89,88,104,104,99
"8770",69,"[38]IHoIveBCFufhsqHjnijfbKDeepkHunJHqvbGqa",199,0.990099,38,202,2,200,1,2,1,3,2,98,97,103,103,99
"8771",70,"[38]IHoIveBCFufhsqHjnijfbKDeepkHunJHqvbGqa",203,0.990291,38,206,2,204,1,2,1,3,2,103,102,102,102,99
"8772",71,"[38]IHoIveBCFufhsqHjnijfbKDeepkHunJHqvbGqa",199,0.990099,38,202,2,200,1,2,1,3,2,97,96,104,104,99
"8773",72,"[38]IHoIveBCFufhsqHjnijfbKDeepkHunJHqvbGqa",197,0.99,38,200,2,198,1,2,1,3,2,96,95,103,103,99
"8774",73,"[38]IHoIveBCFufhsqHjnijfbKDeepkHunJHqvbGqa",198,0.99005,38,201,2,199,1,2,1,3,2,98,97,102,102,99
"8775",74,"[38]IHoIveBCFufhsqHjnijfbKDeepkHunJHqvbGqa",202,0.990244,38,205,2,203,1,2,1,3,2,103,102,101,101,99
"8776",75,"[38]IHoIveBCFufhsqHjnijfbKDeepkHunJHqvbGqa",206,0.990431,38,209,2,207,1,2,1,3,2,107,106,101,101,99
"8777",76,"[38]IHoIveBCFufhsqHjnijfbKDeepkHunJHqvbGqa",196,0.98995,38,199,2,197,1,2,1,3,2,95,94,103,103,99
"8778",77,"[38]IHoIveBCFufhsqHjnijfbKDeepkHunJHqvbGqa",192,0.989744,38,195,2,193,1,2,1,3,2,90,89,104,104,99
"8779",78,"[38]IHoIveBCFufhsqHjnijfbKDeepkHunJHqvbGqa",198,0.99005,38,201,2,199,1,2,1,3,2,99,98,101,101,99
"8780",79,"[38]IHoIveBCFufhsqHjnijfbKDeepkHunJHqvbGqa",190,0.989637,38,193,2,191,1,2,1,3,2,86,85,106,106,99
"8781",80,"[38]IHoIveBCFufhsqHjnijfbKDeepkHunJHqvbGqa",198,0.99005,38,201,2,199,1,2,1,3,2,94,93,106,106,99
"8782",81,"[38]IHoIveBCFufhsqHjnijfbKDeepkHunJHqvbGqa",201,0.990196,38,204,2,202,1,2,1,3,2,100,99,103,103,99
"8783",82,"[38]IHoIveBCFufhsqHjnijfbKDeepkHunJHqvbGqa",200,0.990148,38,203,2,201,1,2,1,3,2,98,97,104,104,99
"8784",83,"[38]IHoIveBCFufhsqHjnijfbKDeepkHunJHqvbGqa",201,0.990196,38,204,2,202,1,2,1,3,2,101,100,102,102,99
"8785",84,"[38]IHoIveBCFufhsqHjnijfbKDeepkHunJHqvbGqa",187,0.989474,38,190,2,188,1,2,1,3,2,85,84,104,104,99
"8786",85,"[38]IHoIveBCFufhsqHjnijfbKDeepkHunJHqvbGqa",214,0.990783,38,217,2,215,1,2,1,3,2,119,118,97,97,99
"8787",86,"[38]IHoIveBCFufhsqHjnijfbKDeepkHunJHqvbGqa",193,0.989796,38,196,2,194,1,2,1,3,2,90,89,105,105,99
"8788",87,"[38]IHoIveBCFufhsqHjnijfbKDeepkHunJHqvbGqa",197,0.99,38,200,2,198,1,2,1,3,2,98,97,101,101,99
"8789",88,"[38]IHoIveBCFufhsqHjnijfbKDeepkHunJHqvbGqa",203,0.990291,38,206,2,204,1,2,1,3,2,102,101,103,103,99
"8790",89,"[38]IHoIveBCFufhsqHjnijfbKDeepkHunJHqvbGqa",194,0.989848,38,197,2,195,1,2,1,3,2,90,89,106,106,99
"8791",90,"[38]IHoIveBCFufhsqHjnijfbKDeepkHunJHqvbGqa",207,0.990476,38,210,2,208,1,2,1,3,2,106,105,103,103,99
"8792",91,"[38]IHoIveBCFufhsqHjnijfbKDeepkHunJHqvbGqa",204,0.990338,38,207,2,205,1,2,1,3,2,105,104,101,101,99
"8793",92,"[38]IHoIveBCFufhsqHjnijfbKDeepkHunJHqvbGqa",199,0.990099,38,202,2,200,1,2,1,3,2,100,99,101,101,99
"8794",93,"[38]IHoIveBCFufhsqHjnijfbKDeepkHunJHqvbGqa",203,0.990291,38,206,2,204,1,2,1,3,2,104,103,101,101,99
"8795",94,"[38]IHoIveBCFufhsqHjnijfbKDeepkHunJHqvbGqa",199,0.990099,38,202,2,200,1,2,1,3,2,100,99,101,101,99
"8796",95,"[38]IHoIveBCFufhsqHjnijfbKDeepkHunJHqvbGqa",206,0.990431,38,209,2,207,1,2,1,3,2,109,108,99,99,99
"8797",96,"[38]IHoIveBCFufhsqHjnijfbKDeepkHunJHqvbGqa",191,0.989691,38,194,2,192,1,2,1,3,2,89,88,104,104,99
"8798",97,"[38]IHoIveBCFufhsqHjnijfbKDeepkHunJHqvbGqa",200,0.990148,38,203,2,201,1,2,1,3,2,99,98,103,103,99
"8799",98,"[38]IHoIveBCFufhsqHjnijfbKDeepkHunJHqvbGqa",206,0.990431,38,209,2,207,1,2,1,3,2,109,108,99,99,99
"8800",99,"[38]IHoIveBCFufhsqHjnijfbKDeepkHunJHqvbGqa",204,0.990338,38,207,2,205,1,2,1,3,2,105,104,101,101,99
"8801",0,"[39]wIiHoIphEBlDubsJzcycBzckvseKHxnJHqweGqa",200,0.990148,39,203,2,201,1,2,1,3,2,89,88,113,113,100
"8802",1,"[39]wIiHoIphEBlDubsJzcycBzckvseKHxnJHqweGqa",219,0.990991,39,222,2,220,1,2,1,3,2,113,112,108,108,100
"8803",2,"[39]wIiHoIphEBlDubsJzcycBzckvseKHxnJHqweGqa",223,0.99115,39,226,2,224,1,2,1,3,2,118,117,107,107,100
"8804",3,"[39]wIiHoIphEBlDubsJzcycBzckvseKHxnJHqweGqa",222,0.991111,39,225,2,223,1,2,1,3,2,120,119,104,104,100
"8805",4,"[39]wIiHoIphEBlDubsJzcycBzckvseKHxnJHqweGqa",224,0.991189,39,227,2,225,1,2,1,3,2,120,119,106,106,100
"8806",5,"[39]wIiHoIphEBlDubsJzcycBzckvseKHxnJHqweGqa",227,0.991304,39,230,2,228,1,2,1,3,2,125,124,104,104,100
"8807",6,"[39]wIiHoIphEBlDubsJzcycBzckvseKHxnJHqweGqa",209,0.990566,39,212,2,210,1,2,1,3,2,96,95,115,115,100
"8808",7,"[39]wIiHoIphEBlDubsJzcycBzckvseKHxnJHqweGqa",205,0.990385,39,208,2,206,1,2,1,3,2,93,92,114,114,100
"8809",8,"[39]wIiHoIphEBlDubsJzcycBzckvseKHxnJHqweGqa",227,0.991304,39,230,2,228,1,2,1,3,2,127,126,102,102,100
"8810",9,"[39]wIiHoIphEBlDubsJzcycBzckvseKHxnJHqweGqa",211,0.990654,39,214,2,212,1,2,1,3,2,100,99,113,113,100
"8811",10,"[39]wIiHoIphEBlDubsJzcycBzckvseKHxnJHqweGqa",228,0.991342,39,231,2,229,1,2,1,3,2,126,125,104,104,100
"8812",11,"[39]wIiHoIphEBlDubsJzcycBzckvseKHxnJHqweGqa",223,0.99115,39,226,2,224,1,2,1,3,2,122,121,103,103,100
"8813",12,"[39]wIiHoIphEBlDubsJzcycBzckvseKHxnJHqweGqa",213,0.990741,39,216,2,214,1,2,1,3,2,106,105,109,109,100
"8814",13,"[39]wIiHoIphEBlDubsJzcycBzckvseKHxnJHqweGqa",213,0.990741,39,216,2,214,1,2,1,3,2,107,106,108,108,100
"8815",14,"[39]wIiHoIphEBlDubsJzcycBzckvseKHxnJHqweGqa",214,0.990783,39,217,2,215,1,2,1,3,2,108,107,108,108,100
"8816",15,"[39]wIiHoIphEBlDubsJzcycBzckvseKHxnJHqweGqa",224,0.991189,39,227,2,225,1,2,1,3,2,120,119,106,106,100
"8817",16,"[39]wIiHoIphEBlDubsJzcycBzckvseKHxnJHqweGqa",226,0.991266,39,229,2,227,1,2,1,3,2,122,121,106,106,100
"8818",17,"[39]wIiHoIphEBlDubsJzcycBzckvseKHxnJHqweGqa",217,0.990909,39,220,2,218,1,2,1,3,2,110,109,109,109,100
"8819",18,"[39]wIiHoIphEBlDubsJzcycBzckvseKHxnJHqweGqa",223,0.99115,39,226,2,224,1,2,1,3,2,119,118,106,106,100
"8820",19,"[39]wIiHoIphEBlDubsJzcycBzckvseKHxnJHqweGqa",216,0.990868,39,219,2,217,1,2,1,3,2,110,109,108,108,100
"8821",20,"[39]wIiHoIphEBlDubsJzcycBzckvseKHxnJHqweGqa",224,0.991189,39,227,2,225,1,2,1,3,2,119,118,107,107,100
"8822",21,"[39]wIiHoIphEBlDubsJzcycBzckvseKHxnJHqweGqa",205,0.990385,39,208,2,206,1,2,1,3,2,92,91,115,115,100
"8823",22,"[39]wIiHoIphEBlDubsJzcycBzckvseKHxnJHqweGqa",220,0.991031,39,223,2,221,1,2,1,3,2,115,114,107,107,100
"8824",23,"[39]wIiHoIphEBlDubsJzcycBzckvseKHxnJHqweGqa",206,0.990431,39,209,2,207,1,2,1,3,2,94,93,114,114,100
"8825",24,"[39]wIiHoIphEBlDubsJzcycBzckvseKHxnJHqweGqa",215,0.990826,39,218,2,216,1,2,1,3,2,105,104,112,112,100
"8826",25,"[39]wIiHoIphEBlDubsJzcycBzckvseKHxnJHqweGqa",211,0.990654,39,214,2,212,1,2,1,3,2,101,100,112,112,100
"8827",26,"[39]wIiHoIphEBlDubsJzcycBzckvseKHxnJHqweGqa",219,0.990991,39,222,2,220,1,2,1,3,2,114,113,107,107,100
"8828",27,"[39]wIiHoIphEBlDubsJzcycBzckvseKHxnJHqweGqa",217,0.990909,39,220,2,218,1,2,1,3,2,112,111,107,107,100
"8829",28,"[39]wIiHoIphEBlDubsJzcycBzckvseKHxnJHqweGqa",222,0.991111,39,225,2,223,1,2,1,3,2,117,116,107,107,100
"8830",29,"[39]wIiHoIphEBlDubsJzcycBzckvseKHxnJHqweGqa",228,0.991342,39,231,2,229,1,2,1,3,2,128,127,102,102,100
"8831",30,"[39]wIiHoIphEBlDubsJzcycBzckvseKHxnJHqweGqa",223,0.99115,39,226,2,224,1,2,1,3,2,118,117,107,107,100
"8832",31,"[39]wIiHoIphEBlDubsJzcycBzckvseKHxnJHqweGqa",218,0.99095,39,221,2,219,1,2,1,3,2,111,110,109,109,100
"8833",32,"[39]wIiHoIphEBlDubsJzcycBzckvseKHxnJHqweGqa",211,0.990654,39,214,2,212,1,2,1,3,2,101,100,112,112,100
"8834",33,"[39]wIiHoIphEBlDubsJzcycBzckvseKHxnJHqweGqa",220,0.991031,39,223,2,221,1,2,1,3,2,113,112,109,109,100
"8835",34,"[39]wIiHoIphEBlDubsJzcycBzckvseKHxnJHqweGqa",209,0.990566,39,212,2,210,1,2,1,3,2,98,97,113,113,100
"8836",35,"[39]wIiHoIphEBlDubsJzcycBzckvseKHxnJHqweGqa",212,0.990698,39,215,2,213,1,2,1,3,2,100,99,114,114,100
"8837",36,"[39]wIiHoIphEBlDubsJzcycBzckvseKHxnJHqweGqa",224,0.991189,39,227,2,225,1,2,1,3,2,121,120,105,105,100
"8838",37,"[39]wIiHoIphEBlDubsJzcycBzckvseKHxnJHqweGqa",209,0.990566,39,212,2,210,1,2,1,3,2,99,98,112,112,100
"8839",38,"[39]wIiHoIphEBlDubsJzcycBzckvseKHxnJHqweGqa",221,0.991071,39,224,2,222,1,2,1,3,2,115,114,108,108,100
"8840",39,"[39]wIiHoIphEBlDubsJzcycBzckvseKHxnJHqweGqa",217,0.990909,39,220,2,218,1,2,1,3,2,111,110,108,108,100
"8841",40,"[39]wIiHoIphEBlDubsJzcycBzckvseKHxnJHqweGqa",212,0.990698,39,215,2,213,1,2,1,3,2,103,102,111,111,100
"8842",41,"[39]wIiHoIphEBlDubsJzcycBzckvseKHxnJHqweGqa",215,0.990826,39,218,2,216,1,2,1,3,2,109,108,108,108,100
"8843",42,"[39]wIiHoIphEBlDubsJzcycBzckvseKHxnJHqweGqa",212,0.990698,39,215,2,213,1,2,1,3,2,102,101,112,112,100
"8844",43,"[39]wIiHoIphEBlDubsJzcycBzckvseKHxnJHqweGqa",205,0.990385,39,208,2,206,1,2,1,3,2,94,93,113,113,100
"8845",44,"[39]wIiHoIphEBlDubsJzcycBzckvseKHxnJHqweGqa",212,0.990698,39,215,2,213,1,2,1,3,2,102,101,112,112,100
"8846",45,"[39]wIiHoIphEBlDubsJzcycBzckvseKHxnJHqweGqa",217,0.990909,39,220,2,218,1,2,1,3,2,112,111,107,107,100
"8847",46,"[39]wIiHoIphEBlDubsJzcycBzckvseKHxnJHqweGqa",225,0.991228,39,228,2,226,1,2,1,3,2,122,121,105,105,100
"8848",47,"[39]wIiHoIphEBlDubsJzcycBzckvseKHxnJHqweGqa",201,0.990196,39,204,2,202,1,2,1,3,2,88,87,115,115,100
"8849",48,"[39]wIiHoIphEBlDubsJzcycBzckvseKHxnJHqweGqa",209,0.990566,39,212,2,210,1,2,1,3,2,98,97,113,113,100
"8850",49,"[39]wIiHoIphEBlDubsJzcycBzckvseKHxnJHqweGqa",212,0.990698,39,215,2,213,1,2,1,3,2,100,99,114,114,100
"8851",50,"[39]wIiHoIphEBlDubsJzcycBzckvseKHxnJHqweGqa",213,0.990741,39,216,2,214,1,2,1,3,2,107,106,108,108,100
"8852",51,"[39]wIiHoIphEBlDubsJzcycBzckvseKHxnJHqweGqa",212,0.990698,39,215,2,213,1,2,1,3,2,104,103,110,110,100
"8853",52,"[39]wIiHoIphEBlDubsJzcycBzckvseKHxnJHqweGqa",225,0.991228,39,228,2,226,1,2,1,3,2,122,121,105,105,100
"8854",53,"[39]wIiHoIphEBlDubsJzcycBzckvseKHxnJHqweGqa",223,0.99115,39,226,2,224,1,2,1,3,2,119,118,106,106,100
"8855",54,"[39]wIiHoIphEBlDubsJzcycBzckvseKHxnJHqweGqa",225,0.991228,39,228,2,226,1,2,1,3,2,119,118,108,108,100
"8856",55,"[39]wIiHoIphEBlDubsJzcycBzckvseKHxnJHqweGqa",217,0.990909,39,220,2,218,1,2,1,3,2,111,110,108,108,100
"8857",56,"[39]wIiHoIphEBlDubsJzcycBzckvseKHxnJHqweGqa",218,0.99095,39,221,2,219,1,2,1,3,2,112,111,108,108,100
"8858",57,"[39]wIiHoIphEBlDubsJzcycBzckvseKHxnJHqweGqa",218,0.99095,39,221,2,219,1,2,1,3,2,111,110,109,109,100
"8859",58,"[39]wIiHoIphEBlDubsJzcycBzckvseKHxnJHqweGqa",209,0.990566,39,212,2,210,1,2,1,3,2,102,101,109,109,100
"8860",59,"[39]wIiHoIphEBlDubsJzcycBzckvseKHxnJHqweGqa",225,0.991228,39,228,2,226,1,2,1,3,2,125,124,102,102,100
"8861",60,"[39]wIiHoIphEBlDubsJzcycBzckvseKHxnJHqweGqa",214,0.990783,39,217,2,215,1,2,1,3,2,109,108,107,107,100
"8862",61,"[39]wIiHoIphEBlDubsJzcycBzckvseKHxnJHqweGqa",225,0.991228,39,228,2,226,1,2,1,3,2,121,120,106,106,100
"8863",62,"[39]wIiHoIphEBlDubsJzcycBzckvseKHxnJHqweGqa",208,0.990521,39,211,2,209,1,2,1,3,2,101,100,109,109,100
"8864",63,"[39]wIiHoIphEBlDubsJzcycBzckvseKHxnJHqweGqa",217,0.990909,39,220,2,218,1,2,1,3,2,110,109,109,109,100
"8865",64,"[39]wIiHoIphEBlDubsJzcycBzckvseKHxnJHqweGqa",217,0.990909,39,220,2,218,1,2,1,3,2,111,110,108,108,100
"8866",65,"[39]wIiHoIphEBlDubsJzcycBzckvseKHxnJHqweGqa",208,0.990521,39,211,2,209,1,2,1,3,2,96,95,114,114,100
"8867",66,"[39]wIiHoIphEBlDubsJzcycBzckvseKHxnJHqweGqa",207,0.990476,39,210,2,208,1,2,1,3,2,99,98,110,110,100
"8868",67,"[39]wIiHoIphEBlDubsJzcycBzckvseKHxnJHqweGqa",234,0.991561,39,237,2,235,1,2,1,3,2,132,131,104,104,100
"8869",68,"[39]wIiHoIphEBlDubsJzcycBzckvseKHxnJHqweGqa",209,0.990566,39,212,2,210,1,2,1,3,2,99,98,112,112,100
"8870",69,"[39]wIiHoIphEBlDubsJzcycBzckvseKHxnJHqweGqa",233,0.991525,39,236,2,234,1,2,1,3,2,131,130,104,104,100
"8871",70,"[39]wIiHoIphEBlDubsJzcycBzckvseKHxnJHqweGqa",216,0.990868,39,219,2,217,1,2,1,3,2,109,108,109,109,100
"8872",71,"[39]wIiHoIphEBlDubsJzcycBzckvseKHxnJHqweGqa",218,0.99095,39,221,2,219,1,2,1,3,2,115,114,105,105,100
"8873",72,"[39]wIiHoIphEBlDubsJzcycBzckvseKHxnJHqweGqa",216,0.990868,39,219,2,217,1,2,1,3,2,108,107,110,110,100
"8874",73,"[39]wIiHoIphEBlDubsJzcycBzckvseKHxnJHqweGqa",208,0.990521,39,211,2,209,1,2,1,3,2,98,97,112,112,100
"8875",74,"[39]wIiHoIphEBlDubsJzcycBzckvseKHxnJHqweGqa",221,0.991071,39,224,2,222,1,2,1,3,2,118,117,105,105,100
"8876",75,"[39]wIiHoIphEBlDubsJzcycBzckvseKHxnJHqweGqa",220,0.991031,39,223,2,221,1,2,1,3,2,116,115,106,106,100
"8877",76,"[39]wIiHoIphEBlDubsJzcycBzckvseKHxnJHqweGqa",235,0.991597,39,238,2,236,1,2,1,3,2,136,135,101,101,100
"8878",77,"[39]wIiHoIphEBlDubsJzcycBzckvseKHxnJHqweGqa",222,0.991111,39,225,2,223,1,2,1,3,2,115,114,109,109,100
"8879",78,"[39]wIiHoIphEBlDubsJzcycBzckvseKHxnJHqweGqa",227,0.991304,39,230,2,228,1,2,1,3,2,124,123,105,105,100
"8880",79,"[39]wIiHoIphEBlDubsJzcycBzckvseKHxnJHqweGqa",217,0.990909,39,220,2,218,1,2,1,3,2,111,110,108,108,100
"8881",80,"[39]wIiHoIphEBlDubsJzcycBzckvseKHxnJHqweGqa",210,0.99061,39,213,2,211,1,2,1,3,2,99,98,113,113,100
"8882",81,"[39]wIiHoIphEBlDubsJzcycBzckvseKHxnJHqweGqa",226,0.991266,39,229,2,227,1,2,1,3,2,122,121,106,106,100
"8883",82,"[39]wIiHoIphEBlDubsJzcycBzckvseKHxnJHqweGqa",209,0.990566,39,212,2,210,1,2,1,3,2,101,100,110,110,100
"8884",83,"[39]wIiHoIphEBlDubsJzcycBzckvseKHxnJHqweGqa",212,0.990698,39,215,2,213,1,2,1,3,2,104,103,110,110,100
"8885",84,"[39]wIiHoIphEBlDubsJzcycBzckvseKHxnJHqweGqa",212,0.990698,39,215,2,213,1,2,1,3,2,106,105,108,108,100
"8886",85,"[39]wIiHoIphEBlDubsJzcycBzckvseKHxnJHqweGqa",202,0.990244,39,205,2,203,1,2,1,3,2,90,89,114,114,100
"8887",86,"[39]wIiHoIphEBlDubsJzcycBzckvseKHxnJHqweGqa",207,0.990476,39,210,2,208,1,2,1,3,2,96,95,113,113,100
"8888",87,"[39]wIiHoIphEBlDubsJzcycBzckvseKHxnJHqweGqa",214,0.990783,39,217,2,215,1,2,1,3,2,105,104,111,111,100
"8889",88,"[39]wIiHoIphEBlDubsJzcycBzckvseKHxnJHqweGqa",213,0.990741,39,216,2,214,1,2,1,3,2,104,103,111,111,100
"8890",89,"[39]wIiHoIphEBlDubsJzcycBzckvseKHxnJHqweGqa",220,0.991031,39,223,2,221,1,2,1,3,2,114,113,108,108,100
"8891",90,"[39]wIiHoIphEBlDubsJzcycBzckvseKHxnJHqweGqa",212,0.990698,39,215,2,213,1,2,1,3,2,101,100,113,113,100
"8892",91,"[39]wIiHoIphEBlDubsJzcycBzckvseKHxnJHqweGqa",228,0.991342,39,231,2,229,1,2,1,3,2,128,127,102,102,100
"8893",92,"[39]wIiHoIphEBlDubsJzcycBzckvseKHxnJHqweGqa",227,0.991304,39,230,2,228,1,2,1,3,2,123,122,106,106,100
"8894",93,"[39]wIiHoIphEBlDubsJzcycBzckvseKHxnJHqweGqa",210,0.99061,39,213,2,211,1,2,1,3,2,103,102,109,109,100
"8895",94,"[39]wIiHoIphEBlDubsJzcycBzckvseKHxnJHqweGqa",220,0.991031,39,223,2,221,1,2,1,3,2,116,115,106,106,100
"8896",95,"[39]wIiHoIphEBlDubsJzcycBzckvseKHxnJHqweGqa",221,0.991071,39,224,2,222,1,2,1,3,2,116,115,107,107,100
"8897",96,"[39]wIiHoIphEBlDubsJzcycBzckvseKHxnJHqweGqa",226,0.991266,39,229,2,227,1,2,1,3,2,128,127,100,100,100
"8898",97,"[39]wIiHoIphEBlDubsJzcycBzckvseKHxnJHqweGqa",214,0.990783,39,217,2,215,1,2,1,3,2,107,106,109,109,100
"8899",98,"[39]wIiHoIphEBlDubsJzcycBzckvseKHxnJHqweGqa",220,0.991031,39,223,2,221,1,2,1,3,2,119,118,103,103,100
"8900",99,"[39]wIiHoIphEBlDubsJzcycBzckvseKHxnJHqweGqa",217,0.990909,39,220,2,218,1,2,1,3,2,112,111,107,107,100
