"","trial_number","genome","merit","accuracy","genome_length","door_rooms","exit_rooms","correct_doors","incorrect_doors","correct_exits","incorrect_exits","doors_taken_0","doors_correct_0","doors_taken_1","doors_correct_1","doors_taken_2","doors_correct_2","seed"
"1",0,"[22]BoIoHcotHnJHGqKCrjnrtI",275,0.996377,22,276,1,275,1,1,0,1,1,132,131,144,144,1
"2",1,"[22]BoIoHcotHnJHGqKCrjnrtI",279,0.996429,22,280,1,279,1,1,0,1,1,142,141,138,138,1
"3",2,"[22]BoIoHcotHnJHGqKCrjnrtI",276,0.99639,22,277,1,276,1,1,0,1,1,128,127,149,149,1
"4",3,"[22]BoIoHcotHnJHGqKCrjnrtI",276,0.99639,22,277,1,276,1,1,0,1,1,135,134,142,142,1
"5",4,"[22]BoIoHcotHnJHGqKCrjnrtI",279,0.996429,22,280,1,279,1,1,0,1,1,138,137,142,142,1
"6",5,"[22]BoIoHcotHnJHGqKCrjnrtI",277,0.996403,22,278,1,277,1,1,0,1,1,153,152,125,125,1
"7",6,"[22]BoIoHcotHnJHGqKCrjnrtI",284,0.996491,22,285,1,284,1,1,0,1,1,149,148,136,136,1
"8",7,"[22]BoIoHcotHnJHGqKCrjnrtI",284,0.996491,22,285,1,284,1,1,0,1,1,147,146,138,138,1
"9",8,"[22]BoIoHcotHnJHGqKCrjnrtI",279,0.996429,22,280,1,279,1,1,0,1,1,143,142,137,137,1
"10",9,"[22]BoIoHcotHnJHGqKCrjnrtI",278,0.996416,22,279,1,278,1,1,0,1,1,149,148,130,130,1
"11",10,"[22]BoIoHcotHnJHGqKCrjnrtI",285,0.996503,22,286,1,285,1,1,0,1,1,161,160,125,125,1
"12",11,"[22]BoIoHcotHnJHGqKCrjnrtI",285,0.996503,22,286,1,285,1,1,0,1,1,139,138,147,147,1
"13",12,"[22]BoIoHcotHnJHGqKCrjnrtI",279,0.996429,22,280,1,279,1,1,0,1,1,141,140,139,139,1
"14",13,"[22]BoIoHcotHnJHGqKCrjnrtI",287,0.996528,22,288,1,287,1,1,0,1,1,144,143,144,144,1
"15",14,"[22]BoIoHcotHnJHGqKCrjnrtI",282,0.996466,22,283,1,282,1,1,0,1,1,141,140,142,142,1
"16",15,"[22]BoIoHcotHnJHGqKCrjnrtI",287,0.996528,22,288,1,287,1,1,0,1,1,161,160,127,127,1
"17",16,"[22]BoIoHcotHnJHGqKCrjnrtI",277,0.996403,22,278,1,277,1,1,0,1,1,133,132,145,145,1
"18",17,"[22]BoIoHcotHnJHGqKCrjnrtI",280,0.996441,22,281,1,280,1,1,0,1,1,139,138,142,142,1
"19",18,"[22]BoIoHcotHnJHGqKCrjnrtI",280,0.996441,22,281,1,280,1,1,0,1,1,142,141,139,139,1
"20",19,"[22]BoIoHcotHnJHGqKCrjnrtI",290,0.996564,22,291,1,290,1,1,0,1,1,156,155,135,135,1
"21",20,"[22]BoIoHcotHnJHGqKCrjnrtI",285,0.996503,22,286,1,285,1,1,0,1,1,166,165,120,120,1
"22",21,"[22]BoIoHcotHnJHGqKCrjnrtI",273,0.99635,22,274,1,273,1,1,0,1,1,121,120,153,153,1
"23",22,"[22]BoIoHcotHnJHGqKCrjnrtI",283,0.996479,22,284,1,283,1,1,0,1,1,147,146,137,137,1
"24",23,"[22]BoIoHcotHnJHGqKCrjnrtI",286,0.996516,22,287,1,286,1,1,0,1,1,150,149,137,137,1
"25",24,"[22]BoIoHcotHnJHGqKCrjnrtI",282,0.996466,22,283,1,282,1,1,0,1,1,142,141,141,141,1
"26",25,"[22]BoIoHcotHnJHGqKCrjnrtI",286,0.996516,22,287,1,286,1,1,0,1,1,153,152,134,134,1
"27",26,"[22]BoIoHcotHnJHGqKCrjnrtI",285,0.996503,22,286,1,285,1,1,0,1,1,149,148,137,137,1
"28",27,"[22]BoIoHcotHnJHGqKCrjnrtI",284,0.996491,22,285,1,284,1,1,0,1,1,143,142,142,142,1
"29",28,"[22]BoIoHcotHnJHGqKCrjnrtI",284,0.996491,22,285,1,284,1,1,0,1,1,150,149,135,135,1
"30",29,"[22]BoIoHcotHnJHGqKCrjnrtI",277,0.996403,22,278,1,277,1,1,0,1,1,125,124,153,153,1
"31",30,"[22]BoIoHcotHnJHGqKCrjnrtI",279,0.996429,22,280,1,279,1,1,0,1,1,129,128,151,151,1
"32",31,"[22]BoIoHcotHnJHGqKCrjnrtI",279,0.996429,22,280,1,279,1,1,0,1,1,139,138,141,141,1
"33",32,"[22]BoIoHcotHnJHGqKCrjnrtI",270,0.99631,22,271,1,270,1,1,0,1,1,118,117,153,153,1
"34",33,"[22]BoIoHcotHnJHGqKCrjnrtI",281,0.996454,22,282,1,281,1,1,0,1,1,141,140,141,141,1
"35",34,"[22]BoIoHcotHnJHGqKCrjnrtI",285,0.996503,22,286,1,285,1,1,0,1,1,133,132,153,153,1
"36",35,"[22]BoIoHcotHnJHGqKCrjnrtI",275,0.996377,22,276,1,275,1,1,0,1,1,134,133,142,142,1
"37",36,"[22]BoIoHcotHnJHGqKCrjnrtI",287,0.996528,22,288,1,287,1,1,0,1,1,144,143,144,144,1
"38",37,"[22]BoIoHcotHnJHGqKCrjnrtI",276,0.99639,22,277,1,276,1,1,0,1,1,128,127,149,149,1
"39",38,"[22]BoIoHcotHnJHGqKCrjnrtI",279,0.996429,22,280,1,279,1,1,0,1,1,144,143,136,136,1
"40",39,"[22]BoIoHcotHnJHGqKCrjnrtI",277,0.996403,22,278,1,277,1,1,0,1,1,134,133,144,144,1
"41",40,"[22]BoIoHcotHnJHGqKCrjnrtI",284,0.996491,22,285,1,284,1,1,0,1,1,150,149,135,135,1
"42",41,"[22]BoIoHcotHnJHGqKCrjnrtI",281,0.996454,22,282,1,281,1,1,0,1,1,153,152,129,129,1
"43",42,"[22]BoIoHcotHnJHGqKCrjnrtI",279,0.996429,22,280,1,279,1,1,0,1,1,130,129,150,150,1
"44",43,"[22]BoIoHcotHnJHGqKCrjnrtI",280,0.996441,22,281,1,280,1,1,0,1,1,136,135,145,145,1
"45",44,"[22]BoIoHcotHnJHGqKCrjnrtI",281,0.996454,22,282,1,281,1,1,0,1,1,148,147,134,134,1
"46",45,"[22]BoIoHcotHnJHGqKCrjnrtI",285,0.996503,22,286,1,285,1,1,0,1,1,151,150,135,135,1
"47",46,"[22]BoIoHcotHnJHGqKCrjnrtI",283,0.996479,22,284,1,283,1,1,0,1,1,147,146,137,137,1
"48",47,"[22]BoIoHcotHnJHGqKCrjnrtI",281,0.996454,22,282,1,281,1,1,0,1,1,141,140,141,141,1
"49",48,"[22]BoIoHcotHnJHGqKCrjnrtI",276,0.99639,22,277,1,276,1,1,0,1,1,129,128,148,148,1
"50",49,"[22]BoIoHcotHnJHGqKCrjnrtI",283,0.996479,22,284,1,283,1,1,0,1,1,158,157,126,126,1
"51",50,"[22]BoIoHcotHnJHGqKCrjnrtI",284,0.996491,22,285,1,284,1,1,0,1,1,124,123,161,161,1
"52",51,"[22]BoIoHcotHnJHGqKCrjnrtI",284,0.996491,22,285,1,284,1,1,0,1,1,140,139,145,145,1
"53",52,"[22]BoIoHcotHnJHGqKCrjnrtI",281,0.996454,22,282,1,281,1,1,0,1,1,151,150,131,131,1
"54",53,"[22]BoIoHcotHnJHGqKCrjnrtI",282,0.996466,22,283,1,282,1,1,0,1,1,156,155,127,127,1
"55",54,"[22]BoIoHcotHnJHGqKCrjnrtI",284,0.996491,22,285,1,284,1,1,0,1,1,144,143,141,141,1
"56",55,"[22]BoIoHcotHnJHGqKCrjnrtI",273,0.99635,22,274,1,273,1,1,0,1,1,152,151,122,122,1
"57",56,"[22]BoIoHcotHnJHGqKCrjnrtI",280,0.996441,22,281,1,280,1,1,0,1,1,132,131,149,149,1
"58",57,"[22]BoIoHcotHnJHGqKCrjnrtI",282,0.996466,22,283,1,282,1,1,0,1,1,137,136,146,146,1
"59",58,"[22]BoIoHcotHnJHGqKCrjnrtI",278,0.996416,22,279,1,278,1,1,0,1,1,141,140,138,138,1
"60",59,"[22]BoIoHcotHnJHGqKCrjnrtI",276,0.99639,22,277,1,276,1,1,0,1,1,145,144,132,132,1
"61",60,"[22]BoIoHcotHnJHGqKCrjnrtI",284,0.996491,22,285,1,284,1,1,0,1,1,144,143,141,141,1
"62",61,"[22]BoIoHcotHnJHGqKCrjnrtI",274,0.996364,22,275,1,274,1,1,0,1,1,134,133,141,141,1
"63",62,"[22]BoIoHcotHnJHGqKCrjnrtI",282,0.996466,22,283,1,282,1,1,0,1,1,151,150,132,132,1
"64",63,"[22]BoIoHcotHnJHGqKCrjnrtI",278,0.996416,22,279,1,278,1,1,0,1,1,137,136,142,142,1
"65",64,"[22]BoIoHcotHnJHGqKCrjnrtI",274,0.996364,22,275,1,274,1,1,0,1,1,130,129,145,145,1
"66",65,"[22]BoIoHcotHnJHGqKCrjnrtI",283,0.996479,22,284,1,283,1,1,0,1,1,145,144,139,139,1
"67",66,"[22]BoIoHcotHnJHGqKCrjnrtI",289,0.996552,22,290,1,289,1,1,0,1,1,172,171,118,118,1
"68",67,"[22]BoIoHcotHnJHGqKCrjnrtI",282,0.996466,22,283,1,282,1,1,0,1,1,147,146,136,136,1
"69",68,"[22]BoIoHcotHnJHGqKCrjnrtI",288,0.99654,22,289,1,288,1,1,0,1,1,153,152,136,136,1
"70",69,"[22]BoIoHcotHnJHGqKCrjnrtI",280,0.996441,22,281,1,280,1,1,0,1,1,151,150,130,130,1
"71",70,"[22]BoIoHcotHnJHGqKCrjnrtI",278,0.996416,22,279,1,278,1,1,0,1,1,147,146,132,132,1
"72",71,"[22]BoIoHcotHnJHGqKCrjnrtI",279,0.996429,22,280,1,279,1,1,0,1,1,124,123,156,156,1
"73",72,"[22]BoIoHcotHnJHGqKCrjnrtI",280,0.996441,22,281,1,280,1,1,0,1,1,138,137,143,143,1
"74",73,"[22]BoIoHcotHnJHGqKCrjnrtI",287,0.996528,22,288,1,287,1,1,0,1,1,138,137,150,150,1
"75",74,"[22]BoIoHcotHnJHGqKCrjnrtI",279,0.996429,22,280,1,279,1,1,0,1,1,148,147,132,132,1
"76",75,"[22]BoIoHcotHnJHGqKCrjnrtI",291,0.996575,22,292,1,291,1,1,0,1,1,154,153,138,138,1
"77",76,"[22]BoIoHcotHnJHGqKCrjnrtI",281,0.996454,22,282,1,281,1,1,0,1,1,132,131,150,150,1
"78",77,"[22]BoIoHcotHnJHGqKCrjnrtI",276,0.99639,22,277,1,276,1,1,0,1,1,138,137,139,139,1
"79",78,"[22]BoIoHcotHnJHGqKCrjnrtI",281,0.996454,22,282,1,281,1,1,0,1,1,146,145,136,136,1
"80",79,"[22]BoIoHcotHnJHGqKCrjnrtI",280,0.996441,22,281,1,280,1,1,0,1,1,145,144,136,136,1
"81",80,"[22]BoIoHcotHnJHGqKCrjnrtI",283,0.996479,22,284,1,283,1,1,0,1,1,146,145,138,138,1
"82",81,"[22]BoIoHcotHnJHGqKCrjnrtI",277,0.996403,22,278,1,277,1,1,0,1,1,126,125,152,152,1
"83",82,"[22]BoIoHcotHnJHGqKCrjnrtI",280,0.996441,22,281,1,280,1,1,0,1,1,147,146,134,134,1
"84",83,"[22]BoIoHcotHnJHGqKCrjnrtI",288,0.99654,22,289,1,288,1,1,0,1,1,136,135,153,153,1
"85",84,"[22]BoIoHcotHnJHGqKCrjnrtI",285,0.996503,22,286,1,285,1,1,0,1,1,141,140,145,145,1
"86",85,"[22]BoIoHcotHnJHGqKCrjnrtI",283,0.996479,22,284,1,283,1,1,0,1,1,150,149,134,134,1
"87",86,"[22]BoIoHcotHnJHGqKCrjnrtI",287,0.996528,22,288,1,287,1,1,0,1,1,147,146,141,141,1
"88",87,"[22]BoIoHcotHnJHGqKCrjnrtI",286,0.996516,22,287,1,286,1,1,0,1,1,158,157,129,129,1
"89",88,"[22]BoIoHcotHnJHGqKCrjnrtI",282,0.996466,22,283,1,282,1,1,0,1,1,145,144,138,138,1
"90",89,"[22]BoIoHcotHnJHGqKCrjnrtI",289,0.996552,22,290,1,289,1,1,0,1,1,159,158,131,131,1
"91",90,"[22]BoIoHcotHnJHGqKCrjnrtI",279,0.996429,22,280,1,279,1,1,0,1,1,156,155,124,124,1
"92",91,"[22]BoIoHcotHnJHGqKCrjnrtI",284,0.996491,22,285,1,284,1,1,0,1,1,144,143,141,141,1
"93",92,"[22]BoIoHcotHnJHGqKCrjnrtI",276,0.99639,22,277,1,276,1,1,0,1,1,132,131,145,145,1
"94",93,"[22]BoIoHcotHnJHGqKCrjnrtI",281,0.996454,22,282,1,281,1,1,0,1,1,155,154,127,127,1
"95",94,"[22]BoIoHcotHnJHGqKCrjnrtI",281,0.996454,22,282,1,281,1,1,0,1,1,139,138,143,143,1
"96",95,"[22]BoIoHcotHnJHGqKCrjnrtI",279,0.996429,22,280,1,279,1,1,0,1,1,157,156,123,123,1
"97",96,"[22]BoIoHcotHnJHGqKCrjnrtI",281,0.996454,22,282,1,281,1,1,0,1,1,132,131,150,150,1
"98",97,"[22]BoIoHcotHnJHGqKCrjnrtI",287,0.996528,22,288,1,287,1,1,0,1,1,136,135,152,152,1
"99",98,"[22]BoIoHcotHnJHGqKCrjnrtI",277,0.996403,22,278,1,277,1,1,0,1,1,153,152,125,125,1
"100",99,"[22]BoIoHcotHnJHGqKCrjnrtI",279,0.996429,22,280,1,279,1,1,0,1,1,151,150,129,129,1
"101",0,"[29]vJHqaIkbhHcuHnJHGqKCgbFnmnetj",284,0.996491,29,285,1,284,1,1,0,1,1,141,140,144,144,2
"102",1,"[29]vJHqaIkbhHcuHnJHGqKCgbFnmnetj",286,0.996516,29,287,1,286,1,1,0,1,1,144,143,143,143,2
"103",2,"[29]vJHqaIkbhHcuHnJHGqKCgbFnmnetj",285,0.996503,29,286,1,285,1,1,0,1,1,148,147,138,138,2
"104",3,"[29]vJHqaIkbhHcuHnJHGqKCgbFnmnetj",288,0.99654,29,289,1,288,1,1,0,1,1,133,132,156,156,2
"105",4,"[29]vJHqaIkbhHcuHnJHGqKCgbFnmnetj",284,0.996491,29,285,1,284,1,1,0,1,1,139,138,146,146,2
"106",5,"[29]vJHqaIkbhHcuHnJHGqKCgbFnmnetj",277,0.996403,29,278,1,277,1,1,0,1,1,130,129,148,148,2
"107",6,"[29]vJHqaIkbhHcuHnJHGqKCgbFnmnetj",285,0.996503,29,286,1,285,1,1,0,1,1,143,142,143,143,2
"108",7,"[29]vJHqaIkbhHcuHnJHGqKCgbFnmnetj",279,0.996429,29,280,1,279,1,1,0,1,1,139,138,141,141,2
"109",8,"[29]vJHqaIkbhHcuHnJHGqKCgbFnmnetj",285,0.996503,29,286,1,285,1,1,0,1,1,147,146,139,139,2
"110",9,"[29]vJHqaIkbhHcuHnJHGqKCgbFnmnetj",282,0.996466,29,283,1,282,1,1,0,1,1,139,138,144,144,2
"111",10,"[29]vJHqaIkbhHcuHnJHGqKCgbFnmnetj",279,0.996429,29,280,1,279,1,1,0,1,1,133,132,147,147,2
"112",11,"[29]vJHqaIkbhHcuHnJHGqKCgbFnmnetj",286,0.996516,29,287,1,286,1,1,0,1,1,145,144,142,142,2
"113",12,"[29]vJHqaIkbhHcuHnJHGqKCgbFnmnetj",279,0.996429,29,280,1,279,1,1,0,1,1,143,142,137,137,2
"114",13,"[29]vJHqaIkbhHcuHnJHGqKCgbFnmnetj",282,0.996466,29,283,1,282,1,1,0,1,1,133,132,150,150,2
"115",14,"[29]vJHqaIkbhHcuHnJHGqKCgbFnmnetj",292,0.996587,29,293,1,292,1,1,0,1,1,157,156,136,136,2
"116",15,"[29]vJHqaIkbhHcuHnJHGqKCgbFnmnetj",279,0.996429,29,280,1,279,1,1,0,1,1,135,134,145,145,2
"117",16,"[29]vJHqaIkbhHcuHnJHGqKCgbFnmnetj",296,0.996633,29,297,1,296,1,1,0,1,1,165,164,132,132,2
"118",17,"[29]vJHqaIkbhHcuHnJHGqKCgbFnmnetj",295,0.996622,29,296,1,295,1,1,0,1,1,148,147,148,148,2
"119",18,"[29]vJHqaIkbhHcuHnJHGqKCgbFnmnetj",282,0.996466,29,283,1,282,1,1,0,1,1,135,134,148,148,2
"120",19,"[29]vJHqaIkbhHcuHnJHGqKCgbFnmnetj",292,0.996587,29,293,1,292,1,1,0,1,1,142,141,151,151,2
"121",20,"[29]vJHqaIkbhHcuHnJHGqKCgbFnmnetj",289,0.996552,29,290,1,289,1,1,0,1,1,151,150,139,139,2
"122",21,"[29]vJHqaIkbhHcuHnJHGqKCgbFnmnetj",276,0.99639,29,277,1,276,1,1,0,1,1,125,124,152,152,2
"123",22,"[29]vJHqaIkbhHcuHnJHGqKCgbFnmnetj",281,0.996454,29,282,1,281,1,1,0,1,1,137,136,145,145,2
"124",23,"[29]vJHqaIkbhHcuHnJHGqKCgbFnmnetj",287,0.996528,29,288,1,287,1,1,0,1,1,145,144,143,143,2
"125",24,"[29]vJHqaIkbhHcuHnJHGqKCgbFnmnetj",287,0.996528,29,288,1,287,1,1,0,1,1,139,138,149,149,2
"126",25,"[29]vJHqaIkbhHcuHnJHGqKCgbFnmnetj",277,0.996403,29,278,1,277,1,1,0,1,1,153,152,125,125,2
"127",26,"[29]vJHqaIkbhHcuHnJHGqKCgbFnmnetj",282,0.996466,29,283,1,282,1,1,0,1,1,134,133,149,149,2
"128",27,"[29]vJHqaIkbhHcuHnJHGqKCgbFnmnetj",281,0.996454,29,282,1,281,1,1,0,1,1,143,142,139,139,2
"129",28,"[29]vJHqaIkbhHcuHnJHGqKCgbFnmnetj",286,0.996516,29,287,1,286,1,1,0,1,1,145,144,142,142,2
"130",29,"[29]vJHqaIkbhHcuHnJHGqKCgbFnmnetj",274,0.996364,29,275,1,274,1,1,0,1,1,119,118,156,156,2
"131",30,"[29]vJHqaIkbhHcuHnJHGqKCgbFnmnetj",283,0.996479,29,284,1,283,1,1,0,1,1,142,141,142,142,2
"132",31,"[29]vJHqaIkbhHcuHnJHGqKCgbFnmnetj",286,0.996516,29,287,1,286,1,1,0,1,1,160,159,127,127,2
"133",32,"[29]vJHqaIkbhHcuHnJHGqKCgbFnmnetj",285,0.996503,29,286,1,285,1,1,0,1,1,156,155,130,130,2
"134",33,"[29]vJHqaIkbhHcuHnJHGqKCgbFnmnetj",279,0.996429,29,280,1,279,1,1,0,1,1,124,123,156,156,2
"135",34,"[29]vJHqaIkbhHcuHnJHGqKCgbFnmnetj",280,0.996441,29,281,1,280,1,1,0,1,1,143,142,138,138,2
"136",35,"[29]vJHqaIkbhHcuHnJHGqKCgbFnmnetj",283,0.996479,29,284,1,283,1,1,0,1,1,147,146,137,137,2
"137",36,"[29]vJHqaIkbhHcuHnJHGqKCgbFnmnetj",282,0.996466,29,283,1,282,1,1,0,1,1,159,158,124,124,2
"138",37,"[29]vJHqaIkbhHcuHnJHGqKCgbFnmnetj",288,0.99654,29,289,1,288,1,1,0,1,1,140,139,149,149,2
"139",38,"[29]vJHqaIkbhHcuHnJHGqKCgbFnmnetj",276,0.99639,29,277,1,276,1,1,0,1,1,128,127,149,149,2
"140",39,"[29]vJHqaIkbhHcuHnJHGqKCgbFnmnetj",277,0.996403,29,278,1,277,1,1,0,1,1,127,126,151,151,2
"141",40,"[29]vJHqaIkbhHcuHnJHGqKCgbFnmnetj",286,0.996516,29,287,1,286,1,1,0,1,1,146,145,141,141,2
"142",41,"[29]vJHqaIkbhHcuHnJHGqKCgbFnmnetj",288,0.99654,29,289,1,288,1,1,0,1,1,141,140,148,148,2
"143",42,"[29]vJHqaIkbhHcuHnJHGqKCgbFnmnetj",272,0.996337,29,273,1,272,1,1,0,1,1,132,131,141,141,2
"144",43,"[29]vJHqaIkbhHcuHnJHGqKCgbFnmnetj",285,0.996503,29,286,1,285,1,1,0,1,1,131,130,155,155,2
"145",44,"[29]vJHqaIkbhHcuHnJHGqKCgbFnmnetj",272,0.996337,29,273,1,272,1,1,0,1,1,128,127,145,145,2
"146",45,"[29]vJHqaIkbhHcuHnJHGqKCgbFnmnetj",287,0.996528,29,288,1,287,1,1,0,1,1,150,149,138,138,2
"147",46,"[29]vJHqaIkbhHcuHnJHGqKCgbFnmnetj",287,0.996528,29,288,1,287,1,1,0,1,1,147,146,141,141,2
"148",47,"[29]vJHqaIkbhHcuHnJHGqKCgbFnmnetj",278,0.996416,29,279,1,278,1,1,0,1,1,143,142,136,136,2
"149",48,"[29]vJHqaIkbhHcuHnJHGqKCgbFnmnetj",283,0.996479,29,284,1,283,1,1,0,1,1,146,145,138,138,2
"150",49,"[29]vJHqaIkbhHcuHnJHGqKCgbFnmnetj",286,0.996516,29,287,1,286,1,1,0,1,1,150,149,137,137,2
"151",50,"[29]vJHqaIkbhHcuHnJHGqKCgbFnmnetj",280,0.996441,29,281,1,280,1,1,0,1,1,153,152,128,128,2
"152",51,"[29]vJHqaIkbhHcuHnJHGqKCgbFnmnetj",291,0.996575,29,292,1,291,1,1,0,1,1,148,147,144,144,2
"153",52,"[29]vJHqaIkbhHcuHnJHGqKCgbFnmnetj",283,0.996479,29,284,1,283,1,1,0,1,1,134,133,150,150,2
"154",53,"[29]vJHqaIkbhHcuHnJHGqKCgbFnmnetj",283,0.996479,29,284,1,283,1,1,0,1,1,150,149,134,134,2
"155",54,"[29]vJHqaIkbhHcuHnJHGqKCgbFnmnetj",286,0.996516,29,287,1,286,1,1,0,1,1,147,146,140,140,2
"156",55,"[29]vJHqaIkbhHcuHnJHGqKCgbFnmnetj",286,0.996516,29,287,1,286,1,1,0,1,1,161,160,126,126,2
"157",56,"[29]vJHqaIkbhHcuHnJHGqKCgbFnmnetj",283,0.996479,29,284,1,283,1,1,0,1,1,135,134,149,149,2
"158",57,"[29]vJHqaIkbhHcuHnJHGqKCgbFnmnetj",289,0.996552,29,290,1,289,1,1,0,1,1,145,144,145,145,2
"159",58,"[29]vJHqaIkbhHcuHnJHGqKCgbFnmnetj",291,0.996575,29,292,1,291,1,1,0,1,1,145,144,147,147,2
"160",59,"[29]vJHqaIkbhHcuHnJHGqKCgbFnmnetj",288,0.99654,29,289,1,288,1,1,0,1,1,146,145,143,143,2
"161",60,"[29]vJHqaIkbhHcuHnJHGqKCgbFnmnetj",287,0.996528,29,288,1,287,1,1,0,1,1,148,147,140,140,2
"162",61,"[29]vJHqaIkbhHcuHnJHGqKCgbFnmnetj",283,0.996479,29,284,1,283,1,1,0,1,1,138,137,146,146,2
"163",62,"[29]vJHqaIkbhHcuHnJHGqKCgbFnmnetj",284,0.996491,29,285,1,284,1,1,0,1,1,145,144,140,140,2
"164",63,"[29]vJHqaIkbhHcuHnJHGqKCgbFnmnetj",288,0.99654,29,289,1,288,1,1,0,1,1,159,158,130,130,2
"165",64,"[29]vJHqaIkbhHcuHnJHGqKCgbFnmnetj",282,0.996466,29,283,1,282,1,1,0,1,1,141,140,142,142,2
"166",65,"[29]vJHqaIkbhHcuHnJHGqKCgbFnmnetj",274,0.996364,29,275,1,274,1,1,0,1,1,130,129,145,145,2
"167",66,"[29]vJHqaIkbhHcuHnJHGqKCgbFnmnetj",283,0.996479,29,284,1,283,1,1,0,1,1,143,142,141,141,2
"168",67,"[29]vJHqaIkbhHcuHnJHGqKCgbFnmnetj",292,0.996587,29,293,1,292,1,1,0,1,1,148,147,145,145,2
"169",68,"[29]vJHqaIkbhHcuHnJHGqKCgbFnmnetj",278,0.996416,29,279,1,278,1,1,0,1,1,138,137,141,141,2
"170",69,"[29]vJHqaIkbhHcuHnJHGqKCgbFnmnetj",283,0.996479,29,284,1,283,1,1,0,1,1,147,146,137,137,2
"171",70,"[29]vJHqaIkbhHcuHnJHGqKCgbFnmnetj",280,0.996441,29,281,1,280,1,1,0,1,1,124,123,157,157,2
"172",71,"[29]vJHqaIkbhHcuHnJHGqKCgbFnmnetj",280,0.996441,29,281,1,280,1,1,0,1,1,139,138,142,142,2
"173",72,"[29]vJHqaIkbhHcuHnJHGqKCgbFnmnetj",281,0.996454,29,282,1,281,1,1,0,1,1,132,131,150,150,2
"174",73,"[29]vJHqaIkbhHcuHnJHGqKCgbFnmnetj",290,0.996564,29,291,1,290,1,1,0,1,1,146,145,145,145,2
"175",74,"[29]vJHqaIkbhHcuHnJHGqKCgbFnmnetj",281,0.996454,29,282,1,281,1,1,0,1,1,143,142,139,139,2
"176",75,"[29]vJHqaIkbhHcuHnJHGqKCgbFnmnetj",284,0.996491,29,285,1,284,1,1,0,1,1,143,142,142,142,2
"177",76,"[29]vJHqaIkbhHcuHnJHGqKCgbFnmnetj",282,0.996466,29,283,1,282,1,1,0,1,1,143,142,140,140,2
"178",77,"[29]vJHqaIkbhHcuHnJHGqKCgbFnmnetj",290,0.996564,29,291,1,290,1,1,0,1,1,148,147,143,143,2
"179",78,"[29]vJHqaIkbhHcuHnJHGqKCgbFnmnetj",284,0.996491,29,285,1,284,1,1,0,1,1,136,135,149,149,2
"180",79,"[29]vJHqaIkbhHcuHnJHGqKCgbFnmnetj",281,0.996454,29,282,1,281,1,1,0,1,1,137,136,145,145,2
"181",80,"[29]vJHqaIkbhHcuHnJHGqKCgbFnmnetj",295,0.996622,29,296,1,295,1,1,0,1,1,161,160,135,135,2
"182",81,"[29]vJHqaIkbhHcuHnJHGqKCgbFnmnetj",282,0.996466,29,283,1,282,1,1,0,1,1,150,149,133,133,2
"183",82,"[29]vJHqaIkbhHcuHnJHGqKCgbFnmnetj",281,0.996454,29,282,1,281,1,1,0,1,1,147,146,135,135,2
"184",83,"[29]vJHqaIkbhHcuHnJHGqKCgbFnmnetj",293,0.996599,29,294,1,293,1,1,0,1,1,163,162,131,131,2
"185",84,"[29]vJHqaIkbhHcuHnJHGqKCgbFnmnetj",285,0.996503,29,286,1,285,1,1,0,1,1,140,139,146,146,2
"186",85,"[29]vJHqaIkbhHcuHnJHGqKCgbFnmnetj",281,0.996454,29,282,1,281,1,1,0,1,1,141,140,141,141,2
"187",86,"[29]vJHqaIkbhHcuHnJHGqKCgbFnmnetj",288,0.99654,29,289,1,288,1,1,0,1,1,142,141,147,147,2
"188",87,"[29]vJHqaIkbhHcuHnJHGqKCgbFnmnetj",286,0.996516,29,287,1,286,1,1,0,1,1,125,124,162,162,2
"189",88,"[29]vJHqaIkbhHcuHnJHGqKCgbFnmnetj",287,0.996528,29,288,1,287,1,1,0,1,1,145,144,143,143,2
"190",89,"[29]vJHqaIkbhHcuHnJHGqKCgbFnmnetj",276,0.99639,29,277,1,276,1,1,0,1,1,118,117,159,159,2
"191",90,"[29]vJHqaIkbhHcuHnJHGqKCgbFnmnetj",287,0.996528,29,288,1,287,1,1,0,1,1,161,160,127,127,2
"192",91,"[29]vJHqaIkbhHcuHnJHGqKCgbFnmnetj",289,0.996552,29,290,1,289,1,1,0,1,1,147,146,143,143,2
"193",92,"[29]vJHqaIkbhHcuHnJHGqKCgbFnmnetj",288,0.99654,29,289,1,288,1,1,0,1,1,143,142,146,146,2
"194",93,"[29]vJHqaIkbhHcuHnJHGqKCgbFnmnetj",289,0.996552,29,290,1,289,1,1,0,1,1,152,151,138,138,2
"195",94,"[29]vJHqaIkbhHcuHnJHGqKCgbFnmnetj",284,0.996491,29,285,1,284,1,1,0,1,1,130,129,155,155,2
"196",95,"[29]vJHqaIkbhHcuHnJHGqKCgbFnmnetj",284,0.996491,29,285,1,284,1,1,0,1,1,142,141,143,143,2
"197",96,"[29]vJHqaIkbhHcuHnJHGqKCgbFnmnetj",283,0.996479,29,284,1,283,1,1,0,1,1,133,132,151,151,2
"198",97,"[29]vJHqaIkbhHcuHnJHGqKCgbFnmnetj",280,0.996441,29,281,1,280,1,1,0,1,1,126,125,155,155,2
"199",98,"[29]vJHqaIkbhHcuHnJHGqKCgbFnmnetj",284,0.996491,29,285,1,284,1,1,0,1,1,127,126,158,158,2
"200",99,"[29]vJHqaIkbhHcuHnJHGqKCgbFnmnetj",278,0.996416,29,279,1,278,1,1,0,1,1,146,145,133,133,2
"201",0,"[29]rEHoIoHcotHnJHGqKCzxgEhyHihlc",280,0.996441,29,281,1,280,1,1,0,1,1,150,149,131,131,3
"202",1,"[29]rEHoIoHcotHnJHGqKCzxgEhyHihlc",280,0.996441,29,281,1,280,1,1,0,1,1,149,148,132,132,3
"203",2,"[29]rEHoIoHcotHnJHGqKCzxgEhyHihlc",279,0.996429,29,280,1,279,1,1,0,1,1,153,152,127,127,3
"204",3,"[29]rEHoIoHcotHnJHGqKCzxgEhyHihlc",278,0.996416,29,279,1,278,1,1,0,1,1,144,143,135,135,3
"205",4,"[29]rEHoIoHcotHnJHGqKCzxgEhyHihlc",279,0.996429,29,280,1,279,1,1,0,1,1,132,131,148,148,3
"206",5,"[29]rEHoIoHcotHnJHGqKCzxgEhyHihlc",272,0.996337,29,273,1,272,1,1,0,1,1,135,134,138,138,3
"207",6,"[29]rEHoIoHcotHnJHGqKCzxgEhyHihlc",283,0.996479,29,284,1,283,1,1,0,1,1,141,140,143,143,3
"208",7,"[29]rEHoIoHcotHnJHGqKCzxgEhyHihlc",275,0.996377,29,276,1,275,1,1,0,1,1,145,144,131,131,3
"209",8,"[29]rEHoIoHcotHnJHGqKCzxgEhyHihlc",282,0.996466,29,283,1,282,1,1,0,1,1,141,140,142,142,3
"210",9,"[29]rEHoIoHcotHnJHGqKCzxgEhyHihlc",276,0.99639,29,277,1,276,1,1,0,1,1,146,145,131,131,3
"211",10,"[29]rEHoIoHcotHnJHGqKCzxgEhyHihlc",275,0.996377,29,276,1,275,1,1,0,1,1,144,143,132,132,3
"212",11,"[29]rEHoIoHcotHnJHGqKCzxgEhyHihlc",279,0.996429,29,280,1,279,1,1,0,1,1,134,133,146,146,3
"213",12,"[29]rEHoIoHcotHnJHGqKCzxgEhyHihlc",275,0.996377,29,276,1,275,1,1,0,1,1,141,140,135,135,3
"214",13,"[29]rEHoIoHcotHnJHGqKCzxgEhyHihlc",276,0.99639,29,277,1,276,1,1,0,1,1,134,133,143,143,3
"215",14,"[29]rEHoIoHcotHnJHGqKCzxgEhyHihlc",285,0.996503,29,286,1,285,1,1,0,1,1,154,153,132,132,3
"216",15,"[29]rEHoIoHcotHnJHGqKCzxgEhyHihlc",268,0.996283,29,269,1,268,1,1,0,1,1,143,142,126,126,3
"217",16,"[29]rEHoIoHcotHnJHGqKCzxgEhyHihlc",285,0.996503,29,286,1,285,1,1,0,1,1,148,147,138,138,3
"218",17,"[29]rEHoIoHcotHnJHGqKCzxgEhyHihlc",278,0.996416,29,279,1,278,1,1,0,1,1,149,148,130,130,3
"219",18,"[29]rEHoIoHcotHnJHGqKCzxgEhyHihlc",286,0.996516,29,287,1,286,1,1,0,1,1,160,159,127,127,3
"220",19,"[29]rEHoIoHcotHnJHGqKCzxgEhyHihlc",276,0.99639,29,277,1,276,1,1,0,1,1,137,136,140,140,3
"221",20,"[29]rEHoIoHcotHnJHGqKCzxgEhyHihlc",286,0.996516,29,287,1,286,1,1,0,1,1,159,158,128,128,3
"222",21,"[29]rEHoIoHcotHnJHGqKCzxgEhyHihlc",282,0.996466,29,283,1,282,1,1,0,1,1,136,135,147,147,3
"223",22,"[29]rEHoIoHcotHnJHGqKCzxgEhyHihlc",280,0.996441,29,281,1,280,1,1,0,1,1,127,126,154,154,3
"224",23,"[29]rEHoIoHcotHnJHGqKCzxgEhyHihlc",287,0.996528,29,288,1,287,1,1,0,1,1,140,139,148,148,3
"225",24,"[29]rEHoIoHcotHnJHGqKCzxgEhyHihlc",281,0.996454,29,282,1,281,1,1,0,1,1,144,143,138,138,3
"226",25,"[29]rEHoIoHcotHnJHGqKCzxgEhyHihlc",279,0.996429,29,280,1,279,1,1,0,1,1,146,145,134,134,3
"227",26,"[29]rEHoIoHcotHnJHGqKCzxgEhyHihlc",282,0.996466,29,283,1,282,1,1,0,1,1,156,155,127,127,3
"228",27,"[29]rEHoIoHcotHnJHGqKCzxgEhyHihlc",288,0.99654,29,289,1,288,1,1,0,1,1,163,162,126,126,3
"229",28,"[29]rEHoIoHcotHnJHGqKCzxgEhyHihlc",278,0.996416,29,279,1,278,1,1,0,1,1,140,139,139,139,3
"230",29,"[29]rEHoIoHcotHnJHGqKCzxgEhyHihlc",284,0.996491,29,285,1,284,1,1,0,1,1,130,129,155,155,3
"231",30,"[29]rEHoIoHcotHnJHGqKCzxgEhyHihlc",287,0.996528,29,288,1,287,1,1,0,1,1,150,149,138,138,3
"232",31,"[29]rEHoIoHcotHnJHGqKCzxgEhyHihlc",279,0.996429,29,280,1,279,1,1,0,1,1,131,130,149,149,3
"233",32,"[29]rEHoIoHcotHnJHGqKCzxgEhyHihlc",271,0.996324,29,272,1,271,1,1,0,1,1,143,142,129,129,3
"234",33,"[29]rEHoIoHcotHnJHGqKCzxgEhyHihlc",281,0.996454,29,282,1,281,1,1,0,1,1,138,137,144,144,3
"235",34,"[29]rEHoIoHcotHnJHGqKCzxgEhyHihlc",272,0.996337,29,273,1,272,1,1,0,1,1,128,127,145,145,3
"236",35,"[29]rEHoIoHcotHnJHGqKCzxgEhyHihlc",289,0.996552,29,290,1,289,1,1,0,1,1,152,151,138,138,3
"237",36,"[29]rEHoIoHcotHnJHGqKCzxgEhyHihlc",275,0.996377,29,276,1,275,1,1,0,1,1,134,133,142,142,3
"238",37,"[29]rEHoIoHcotHnJHGqKCzxgEhyHihlc",279,0.996429,29,280,1,279,1,1,0,1,1,135,134,145,145,3
"239",38,"[29]rEHoIoHcotHnJHGqKCzxgEhyHihlc",274,0.996364,29,275,1,274,1,1,0,1,1,124,123,151,151,3
"240",39,"[29]rEHoIoHcotHnJHGqKCzxgEhyHihlc",270,0.99631,29,271,1,270,1,1,0,1,1,146,145,125,125,3
"241",40,"[29]rEHoIoHcotHnJHGqKCzxgEhyHihlc",279,0.996429,29,280,1,279,1,1,0,1,1,144,143,136,136,3
"242",41,"[29]rEHoIoHcotHnJHGqKCzxgEhyHihlc",287,0.996528,29,288,1,287,1,1,0,1,1,143,142,145,145,3
"243",42,"[29]rEHoIoHcotHnJHGqKCzxgEhyHihlc",280,0.996441,29,281,1,280,1,1,0,1,1,158,157,123,123,3
"244",43,"[29]rEHoIoHcotHnJHGqKCzxgEhyHihlc",279,0.996429,29,280,1,279,1,1,0,1,1,154,153,126,126,3
"245",44,"[29]rEHoIoHcotHnJHGqKCzxgEhyHihlc",277,0.996403,29,278,1,277,1,1,0,1,1,130,129,148,148,3
"246",45,"[29]rEHoIoHcotHnJHGqKCzxgEhyHihlc",279,0.996429,29,280,1,279,1,1,0,1,1,125,124,155,155,3
"247",46,"[29]rEHoIoHcotHnJHGqKCzxgEhyHihlc",286,0.996516,29,287,1,286,1,1,0,1,1,155,154,132,132,3
"248",47,"[29]rEHoIoHcotHnJHGqKCzxgEhyHihlc",280,0.996441,29,281,1,280,1,1,0,1,1,150,149,131,131,3
"249",48,"[29]rEHoIoHcotHnJHGqKCzxgEhyHihlc",281,0.996454,29,282,1,281,1,1,0,1,1,142,141,140,140,3
"250",49,"[29]rEHoIoHcotHnJHGqKCzxgEhyHihlc",280,0.996441,29,281,1,280,1,1,0,1,1,142,141,139,139,3
"251",50,"[29]rEHoIoHcotHnJHGqKCzxgEhyHihlc",278,0.996416,29,279,1,278,1,1,0,1,1,130,129,149,149,3
"252",51,"[29]rEHoIoHcotHnJHGqKCzxgEhyHihlc",277,0.996403,29,278,1,277,1,1,0,1,1,136,135,142,142,3
"253",52,"[29]rEHoIoHcotHnJHGqKCzxgEhyHihlc",277,0.996403,29,278,1,277,1,1,0,1,1,124,123,154,154,3
"254",53,"[29]rEHoIoHcotHnJHGqKCzxgEhyHihlc",281,0.996454,29,282,1,281,1,1,0,1,1,147,146,135,135,3
"255",54,"[29]rEHoIoHcotHnJHGqKCzxgEhyHihlc",273,0.99635,29,274,1,273,1,1,0,1,1,127,126,147,147,3
"256",55,"[29]rEHoIoHcotHnJHGqKCzxgEhyHihlc",283,0.996479,29,284,1,283,1,1,0,1,1,151,150,133,133,3
"257",56,"[29]rEHoIoHcotHnJHGqKCzxgEhyHihlc",283,0.996479,29,284,1,283,1,1,0,1,1,142,141,142,142,3
"258",57,"[29]rEHoIoHcotHnJHGqKCzxgEhyHihlc",282,0.996466,29,283,1,282,1,1,0,1,1,139,138,144,144,3
"259",58,"[29]rEHoIoHcotHnJHGqKCzxgEhyHihlc",284,0.996491,29,285,1,284,1,1,0,1,1,143,142,142,142,3
"260",59,"[29]rEHoIoHcotHnJHGqKCzxgEhyHihlc",287,0.996528,29,288,1,287,1,1,0,1,1,160,159,128,128,3
"261",60,"[29]rEHoIoHcotHnJHGqKCzxgEhyHihlc",277,0.996403,29,278,1,277,1,1,0,1,1,133,132,145,145,3
"262",61,"[29]rEHoIoHcotHnJHGqKCzxgEhyHihlc",275,0.996377,29,276,1,275,1,1,0,1,1,122,121,154,154,3
"263",62,"[29]rEHoIoHcotHnJHGqKCzxgEhyHihlc",278,0.996416,29,279,1,278,1,1,0,1,1,143,142,136,136,3
"264",63,"[29]rEHoIoHcotHnJHGqKCzxgEhyHihlc",280,0.996441,29,281,1,280,1,1,0,1,1,145,144,136,136,3
"265",64,"[29]rEHoIoHcotHnJHGqKCzxgEhyHihlc",291,0.996575,29,292,1,291,1,1,0,1,1,143,142,149,149,3
"266",65,"[29]rEHoIoHcotHnJHGqKCzxgEhyHihlc",283,0.996479,29,284,1,283,1,1,0,1,1,139,138,145,145,3
"267",66,"[29]rEHoIoHcotHnJHGqKCzxgEhyHihlc",277,0.996403,29,278,1,277,1,1,0,1,1,141,140,137,137,3
"268",67,"[29]rEHoIoHcotHnJHGqKCzxgEhyHihlc",273,0.99635,29,274,1,273,1,1,0,1,1,146,145,128,128,3
"269",68,"[29]rEHoIoHcotHnJHGqKCzxgEhyHihlc",276,0.99639,29,277,1,276,1,1,0,1,1,142,141,135,135,3
"270",69,"[29]rEHoIoHcotHnJHGqKCzxgEhyHihlc",279,0.996429,29,280,1,279,1,1,0,1,1,144,143,136,136,3
"271",70,"[29]rEHoIoHcotHnJHGqKCzxgEhyHihlc",285,0.996503,29,286,1,285,1,1,0,1,1,141,140,145,145,3
"272",71,"[29]rEHoIoHcotHnJHGqKCzxgEhyHihlc",275,0.996377,29,276,1,275,1,1,0,1,1,150,149,126,126,3
"273",72,"[29]rEHoIoHcotHnJHGqKCzxgEhyHihlc",278,0.996416,29,279,1,278,1,1,0,1,1,140,139,139,139,3
"274",73,"[29]rEHoIoHcotHnJHGqKCzxgEhyHihlc",278,0.996416,29,279,1,278,1,1,0,1,1,127,126,152,152,3
"275",74,"[29]rEHoIoHcotHnJHGqKCzxgEhyHihlc",280,0.996441,29,281,1,280,1,1,0,1,1,133,132,148,148,3
"276",75,"[29]rEHoIoHcotHnJHGqKCzxgEhyHihlc",278,0.996416,29,279,1,278,1,1,0,1,1,144,143,135,135,3
"277",76,"[29]rEHoIoHcotHnJHGqKCzxgEhyHihlc",280,0.996441,29,281,1,280,1,1,0,1,1,139,138,142,142,3
"278",77,"[29]rEHoIoHcotHnJHGqKCzxgEhyHihlc",283,0.996479,29,284,1,283,1,1,0,1,1,146,145,138,138,3
"279",78,"[29]rEHoIoHcotHnJHGqKCzxgEhyHihlc",284,0.996491,29,285,1,284,1,1,0,1,1,140,139,145,145,3
"280",79,"[29]rEHoIoHcotHnJHGqKCzxgEhyHihlc",270,0.99631,29,271,1,270,1,1,0,1,1,135,134,136,136,3
"281",80,"[29]rEHoIoHcotHnJHGqKCzxgEhyHihlc",273,0.99635,29,274,1,273,1,1,0,1,1,130,129,144,144,3
"282",81,"[29]rEHoIoHcotHnJHGqKCzxgEhyHihlc",282,0.996466,29,283,1,282,1,1,0,1,1,137,136,146,146,3
"283",82,"[29]rEHoIoHcotHnJHGqKCzxgEhyHihlc",275,0.996377,29,276,1,275,1,1,0,1,1,145,144,131,131,3
"284",83,"[29]rEHoIoHcotHnJHGqKCzxgEhyHihlc",280,0.996441,29,281,1,280,1,1,0,1,1,147,146,134,134,3
"285",84,"[29]rEHoIoHcotHnJHGqKCzxgEhyHihlc",274,0.996364,29,275,1,274,1,1,0,1,1,134,133,141,141,3
"286",85,"[29]rEHoIoHcotHnJHGqKCzxgEhyHihlc",278,0.996416,29,279,1,278,1,1,0,1,1,146,145,133,133,3
"287",86,"[29]rEHoIoHcotHnJHGqKCzxgEhyHihlc",279,0.996429,29,280,1,279,1,1,0,1,1,134,133,146,146,3
"288",87,"[29]rEHoIoHcotHnJHGqKCzxgEhyHihlc",283,0.996479,29,284,1,283,1,1,0,1,1,139,138,145,145,3
"289",88,"[29]rEHoIoHcotHnJHGqKCzxgEhyHihlc",282,0.996466,29,283,1,282,1,1,0,1,1,141,140,142,142,3
"290",89,"[29]rEHoIoHcotHnJHGqKCzxgEhyHihlc",288,0.99654,29,289,1,288,1,1,0,1,1,146,145,143,143,3
"291",90,"[29]rEHoIoHcotHnJHGqKCzxgEhyHihlc",270,0.99631,29,271,1,270,1,1,0,1,1,128,127,143,143,3
"292",91,"[29]rEHoIoHcotHnJHGqKCzxgEhyHihlc",277,0.996403,29,278,1,277,1,1,0,1,1,141,140,137,137,3
"293",92,"[29]rEHoIoHcotHnJHGqKCzxgEhyHihlc",285,0.996503,29,286,1,285,1,1,0,1,1,145,144,141,141,3
"294",93,"[29]rEHoIoHcotHnJHGqKCzxgEhyHihlc",271,0.996324,29,272,1,271,1,1,0,1,1,136,135,136,136,3
"295",94,"[29]rEHoIoHcotHnJHGqKCzxgEhyHihlc",286,0.996516,29,287,1,286,1,1,0,1,1,142,141,145,145,3
"296",95,"[29]rEHoIoHcotHnJHGqKCzxgEhyHihlc",280,0.996441,29,281,1,280,1,1,0,1,1,146,145,135,135,3
"297",96,"[29]rEHoIoHcotHnJHGqKCzxgEhyHihlc",281,0.996454,29,282,1,281,1,1,0,1,1,147,146,135,135,3
"298",97,"[29]rEHoIoHcotHnJHGqKCzxgEhyHihlc",275,0.996377,29,276,1,275,1,1,0,1,1,134,133,142,142,3
"299",98,"[29]rEHoIoHcotHnJHGqKCzxgEhyHihlc",279,0.996429,29,280,1,279,1,1,0,1,1,153,152,127,127,3
"300",99,"[29]rEHoIoHcotHnJHGqKCzxgEhyHihlc",287,0.996528,29,288,1,287,1,1,0,1,1,148,147,140,140,3
"301",0,"[23]dgoIoHcoxHnJHGqKCpkwAhK",281,0.996454,23,282,1,281,1,1,0,1,1,150,149,132,132,4
"302",1,"[23]dgoIoHcoxHnJHGqKCpkwAhK",282,0.996466,23,283,1,282,1,1,0,1,1,137,136,146,146,4
"303",2,"[23]dgoIoHcoxHnJHGqKCpkwAhK",277,0.996403,23,278,1,277,1,1,0,1,1,137,136,141,141,4
"304",3,"[23]dgoIoHcoxHnJHGqKCpkwAhK",277,0.996403,23,278,1,277,1,1,0,1,1,139,138,139,139,4
"305",4,"[23]dgoIoHcoxHnJHGqKCpkwAhK",280,0.996441,23,281,1,280,1,1,0,1,1,143,142,138,138,4
"306",5,"[23]dgoIoHcoxHnJHGqKCpkwAhK",275,0.996377,23,276,1,275,1,1,0,1,1,128,127,148,148,4
"307",6,"[23]dgoIoHcoxHnJHGqKCpkwAhK",285,0.996503,23,286,1,285,1,1,0,1,1,137,136,149,149,4
"308",7,"[23]dgoIoHcoxHnJHGqKCpkwAhK",287,0.996528,23,288,1,287,1,1,0,1,1,148,147,140,140,4
"309",8,"[23]dgoIoHcoxHnJHGqKCpkwAhK",288,0.99654,23,289,1,288,1,1,0,1,1,152,151,137,137,4
"310",9,"[23]dgoIoHcoxHnJHGqKCpkwAhK",286,0.996516,23,287,1,286,1,1,0,1,1,147,146,140,140,4
"311",10,"[23]dgoIoHcoxHnJHGqKCpkwAhK",281,0.996454,23,282,1,281,1,1,0,1,1,146,145,136,136,4
"312",11,"[23]dgoIoHcoxHnJHGqKCpkwAhK",287,0.996528,23,288,1,287,1,1,0,1,1,137,136,151,151,4
"313",12,"[23]dgoIoHcoxHnJHGqKCpkwAhK",283,0.996479,23,284,1,283,1,1,0,1,1,141,140,143,143,4
"314",13,"[23]dgoIoHcoxHnJHGqKCpkwAhK",289,0.996552,23,290,1,289,1,1,0,1,1,141,140,149,149,4
"315",14,"[23]dgoIoHcoxHnJHGqKCpkwAhK",287,0.996528,23,288,1,287,1,1,0,1,1,143,142,145,145,4
"316",15,"[23]dgoIoHcoxHnJHGqKCpkwAhK",285,0.996503,23,286,1,285,1,1,0,1,1,143,142,143,143,4
"317",16,"[23]dgoIoHcoxHnJHGqKCpkwAhK",287,0.996528,23,288,1,287,1,1,0,1,1,141,140,147,147,4
"318",17,"[23]dgoIoHcoxHnJHGqKCpkwAhK",279,0.996429,23,280,1,279,1,1,0,1,1,137,136,143,143,4
"319",18,"[23]dgoIoHcoxHnJHGqKCpkwAhK",284,0.996491,23,285,1,284,1,1,0,1,1,156,155,129,129,4
"320",19,"[23]dgoIoHcoxHnJHGqKCpkwAhK",277,0.996403,23,278,1,277,1,1,0,1,1,135,134,143,143,4
"321",20,"[23]dgoIoHcoxHnJHGqKCpkwAhK",286,0.996516,23,287,1,286,1,1,0,1,1,149,148,138,138,4
"322",21,"[23]dgoIoHcoxHnJHGqKCpkwAhK",285,0.996503,23,286,1,285,1,1,0,1,1,140,139,146,146,4
"323",22,"[23]dgoIoHcoxHnJHGqKCpkwAhK",283,0.996479,23,284,1,283,1,1,0,1,1,145,144,139,139,4
"324",23,"[23]dgoIoHcoxHnJHGqKCpkwAhK",280,0.996441,23,281,1,280,1,1,0,1,1,124,123,157,157,4
"325",24,"[23]dgoIoHcoxHnJHGqKCpkwAhK",285,0.996503,23,286,1,285,1,1,0,1,1,149,148,137,137,4
"326",25,"[23]dgoIoHcoxHnJHGqKCpkwAhK",283,0.996479,23,284,1,283,1,1,0,1,1,139,138,145,145,4
"327",26,"[23]dgoIoHcoxHnJHGqKCpkwAhK",275,0.996377,23,276,1,275,1,1,0,1,1,124,123,152,152,4
"328",27,"[23]dgoIoHcoxHnJHGqKCpkwAhK",290,0.996564,23,291,1,290,1,1,0,1,1,147,146,144,144,4
"329",28,"[23]dgoIoHcoxHnJHGqKCpkwAhK",282,0.996466,23,283,1,282,1,1,0,1,1,147,146,136,136,4
"330",29,"[23]dgoIoHcoxHnJHGqKCpkwAhK",281,0.996454,23,282,1,281,1,1,0,1,1,140,139,142,142,4
"331",30,"[23]dgoIoHcoxHnJHGqKCpkwAhK",281,0.996454,23,282,1,281,1,1,0,1,1,160,159,122,122,4
"332",31,"[23]dgoIoHcoxHnJHGqKCpkwAhK",284,0.996491,23,285,1,284,1,1,0,1,1,146,145,139,139,4
"333",32,"[23]dgoIoHcoxHnJHGqKCpkwAhK",283,0.996479,23,284,1,283,1,1,0,1,1,145,144,139,139,4
"334",33,"[23]dgoIoHcoxHnJHGqKCpkwAhK",285,0.996503,23,286,1,285,1,1,0,1,1,150,149,136,136,4
"335",34,"[23]dgoIoHcoxHnJHGqKCpkwAhK",274,0.996364,23,275,1,274,1,1,0,1,1,141,140,134,134,4
"336",35,"[23]dgoIoHcoxHnJHGqKCpkwAhK",279,0.996429,23,280,1,279,1,1,0,1,1,152,151,128,128,4
"337",36,"[23]dgoIoHcoxHnJHGqKCpkwAhK",285,0.996503,23,286,1,285,1,1,0,1,1,137,136,149,149,4
"338",37,"[23]dgoIoHcoxHnJHGqKCpkwAhK",283,0.996479,23,284,1,283,1,1,0,1,1,149,148,135,135,4
"339",38,"[23]dgoIoHcoxHnJHGqKCpkwAhK",275,0.996377,23,276,1,275,1,1,0,1,1,133,132,143,143,4
"340",39,"[23]dgoIoHcoxHnJHGqKCpkwAhK",276,0.99639,23,277,1,276,1,1,0,1,1,145,144,132,132,4
"341",40,"[23]dgoIoHcoxHnJHGqKCpkwAhK",280,0.996441,23,281,1,280,1,1,0,1,1,139,138,142,142,4
"342",41,"[23]dgoIoHcoxHnJHGqKCpkwAhK",286,0.996516,23,287,1,286,1,1,0,1,1,160,159,127,127,4
"343",42,"[23]dgoIoHcoxHnJHGqKCpkwAhK",290,0.996564,23,291,1,290,1,1,0,1,1,149,148,142,142,4
"344",43,"[23]dgoIoHcoxHnJHGqKCpkwAhK",290,0.996564,23,291,1,290,1,1,0,1,1,156,155,135,135,4
"345",44,"[23]dgoIoHcoxHnJHGqKCpkwAhK",274,0.996364,23,275,1,274,1,1,0,1,1,150,149,125,125,4
"346",45,"[23]dgoIoHcoxHnJHGqKCpkwAhK",282,0.996466,23,283,1,282,1,1,0,1,1,137,136,146,146,4
"347",46,"[23]dgoIoHcoxHnJHGqKCpkwAhK",275,0.996377,23,276,1,275,1,1,0,1,1,127,126,149,149,4
"348",47,"[23]dgoIoHcoxHnJHGqKCpkwAhK",281,0.996454,23,282,1,281,1,1,0,1,1,148,147,134,134,4
"349",48,"[23]dgoIoHcoxHnJHGqKCpkwAhK",292,0.996587,23,293,1,292,1,1,0,1,1,137,136,156,156,4
"350",49,"[23]dgoIoHcoxHnJHGqKCpkwAhK",279,0.996429,23,280,1,279,1,1,0,1,1,146,145,134,134,4
"351",50,"[23]dgoIoHcoxHnJHGqKCpkwAhK",270,0.99631,23,271,1,270,1,1,0,1,1,134,133,137,137,4
"352",51,"[23]dgoIoHcoxHnJHGqKCpkwAhK",276,0.99639,23,277,1,276,1,1,0,1,1,136,135,141,141,4
"353",52,"[23]dgoIoHcoxHnJHGqKCpkwAhK",277,0.996403,23,278,1,277,1,1,0,1,1,150,149,128,128,4
"354",53,"[23]dgoIoHcoxHnJHGqKCpkwAhK",280,0.996441,23,281,1,280,1,1,0,1,1,136,135,145,145,4
"355",54,"[23]dgoIoHcoxHnJHGqKCpkwAhK",287,0.996528,23,288,1,287,1,1,0,1,1,156,155,132,132,4
"356",55,"[23]dgoIoHcoxHnJHGqKCpkwAhK",270,0.99631,23,271,1,270,1,1,0,1,1,139,138,132,132,4
"357",56,"[23]dgoIoHcoxHnJHGqKCpkwAhK",275,0.996377,23,276,1,275,1,1,0,1,1,132,131,144,144,4
"358",57,"[23]dgoIoHcoxHnJHGqKCpkwAhK",287,0.996528,23,288,1,287,1,1,0,1,1,145,144,143,143,4
"359",58,"[23]dgoIoHcoxHnJHGqKCpkwAhK",283,0.996479,23,284,1,283,1,1,0,1,1,141,140,143,143,4
"360",59,"[23]dgoIoHcoxHnJHGqKCpkwAhK",283,0.996479,23,284,1,283,1,1,0,1,1,142,141,142,142,4
"361",60,"[23]dgoIoHcoxHnJHGqKCpkwAhK",286,0.996516,23,287,1,286,1,1,0,1,1,152,151,135,135,4
"362",61,"[23]dgoIoHcoxHnJHGqKCpkwAhK",282,0.996466,23,283,1,282,1,1,0,1,1,144,143,139,139,4
"363",62,"[23]dgoIoHcoxHnJHGqKCpkwAhK",273,0.99635,23,274,1,273,1,1,0,1,1,130,129,144,144,4
"364",63,"[23]dgoIoHcoxHnJHGqKCpkwAhK",271,0.996324,23,272,1,271,1,1,0,1,1,132,131,140,140,4
"365",64,"[23]dgoIoHcoxHnJHGqKCpkwAhK",280,0.996441,23,281,1,280,1,1,0,1,1,149,148,132,132,4
"366",65,"[23]dgoIoHcoxHnJHGqKCpkwAhK",285,0.996503,23,286,1,285,1,1,0,1,1,144,143,142,142,4
"367",66,"[23]dgoIoHcoxHnJHGqKCpkwAhK",275,0.996377,23,276,1,275,1,1,0,1,1,152,151,124,124,4
"368",67,"[23]dgoIoHcoxHnJHGqKCpkwAhK",287,0.996528,23,288,1,287,1,1,0,1,1,138,137,150,150,4
"369",68,"[23]dgoIoHcoxHnJHGqKCpkwAhK",276,0.99639,23,277,1,276,1,1,0,1,1,126,125,151,151,4
"370",69,"[23]dgoIoHcoxHnJHGqKCpkwAhK",281,0.996454,23,282,1,281,1,1,0,1,1,137,136,145,145,4
"371",70,"[23]dgoIoHcoxHnJHGqKCpkwAhK",274,0.996364,23,275,1,274,1,1,0,1,1,144,143,131,131,4
"372",71,"[23]dgoIoHcoxHnJHGqKCpkwAhK",274,0.996364,23,275,1,274,1,1,0,1,1,149,148,126,126,4
"373",72,"[23]dgoIoHcoxHnJHGqKCpkwAhK",288,0.99654,23,289,1,288,1,1,0,1,1,155,154,134,134,4
"374",73,"[23]dgoIoHcoxHnJHGqKCpkwAhK",282,0.996466,23,283,1,282,1,1,0,1,1,166,165,117,117,4
"375",74,"[23]dgoIoHcoxHnJHGqKCpkwAhK",283,0.996479,23,284,1,283,1,1,0,1,1,150,149,134,134,4
"376",75,"[23]dgoIoHcoxHnJHGqKCpkwAhK",280,0.996441,23,281,1,280,1,1,0,1,1,157,156,124,124,4
"377",76,"[23]dgoIoHcoxHnJHGqKCpkwAhK",278,0.996416,23,279,1,278,1,1,0,1,1,134,133,145,145,4
"378",77,"[23]dgoIoHcoxHnJHGqKCpkwAhK",283,0.996479,23,284,1,283,1,1,0,1,1,140,139,144,144,4
"379",78,"[23]dgoIoHcoxHnJHGqKCpkwAhK",287,0.996528,23,288,1,287,1,1,0,1,1,151,150,137,137,4
"380",79,"[23]dgoIoHcoxHnJHGqKCpkwAhK",277,0.996403,23,278,1,277,1,1,0,1,1,128,127,150,150,4
"381",80,"[23]dgoIoHcoxHnJHGqKCpkwAhK",283,0.996479,23,284,1,283,1,1,0,1,1,140,139,144,144,4
"382",81,"[23]dgoIoHcoxHnJHGqKCpkwAhK",285,0.996503,23,286,1,285,1,1,0,1,1,129,128,157,157,4
"383",82,"[23]dgoIoHcoxHnJHGqKCpkwAhK",284,0.996491,23,285,1,284,1,1,0,1,1,152,151,133,133,4
"384",83,"[23]dgoIoHcoxHnJHGqKCpkwAhK",286,0.996516,23,287,1,286,1,1,0,1,1,152,151,135,135,4
"385",84,"[23]dgoIoHcoxHnJHGqKCpkwAhK",281,0.996454,23,282,1,281,1,1,0,1,1,147,146,135,135,4
"386",85,"[23]dgoIoHcoxHnJHGqKCpkwAhK",280,0.996441,23,281,1,280,1,1,0,1,1,145,144,136,136,4
"387",86,"[23]dgoIoHcoxHnJHGqKCpkwAhK",283,0.996479,23,284,1,283,1,1,0,1,1,151,150,133,133,4
"388",87,"[23]dgoIoHcoxHnJHGqKCpkwAhK",287,0.996528,23,288,1,287,1,1,0,1,1,144,143,144,144,4
"389",88,"[23]dgoIoHcoxHnJHGqKCpkwAhK",276,0.99639,23,277,1,276,1,1,0,1,1,147,146,130,130,4
"390",89,"[23]dgoIoHcoxHnJHGqKCpkwAhK",279,0.996429,23,280,1,279,1,1,0,1,1,133,132,147,147,4
"391",90,"[23]dgoIoHcoxHnJHGqKCpkwAhK",281,0.996454,23,282,1,281,1,1,0,1,1,136,135,146,146,4
"392",91,"[23]dgoIoHcoxHnJHGqKCpkwAhK",283,0.996479,23,284,1,283,1,1,0,1,1,146,145,138,138,4
"393",92,"[23]dgoIoHcoxHnJHGqKCpkwAhK",273,0.99635,23,274,1,273,1,1,0,1,1,138,137,136,136,4
"394",93,"[23]dgoIoHcoxHnJHGqKCpkwAhK",287,0.996528,23,288,1,287,1,1,0,1,1,158,157,130,130,4
"395",94,"[23]dgoIoHcoxHnJHGqKCpkwAhK",286,0.996516,23,287,1,286,1,1,0,1,1,152,151,135,135,4
"396",95,"[23]dgoIoHcoxHnJHGqKCpkwAhK",283,0.996479,23,284,1,283,1,1,0,1,1,134,133,150,150,4
"397",96,"[23]dgoIoHcoxHnJHGqKCpkwAhK",282,0.996466,23,283,1,282,1,1,0,1,1,124,123,159,159,4
"398",97,"[23]dgoIoHcoxHnJHGqKCpkwAhK",276,0.99639,23,277,1,276,1,1,0,1,1,140,139,137,137,4
"399",98,"[23]dgoIoHcoxHnJHGqKCpkwAhK",279,0.996429,23,280,1,279,1,1,0,1,1,138,137,142,142,4
"400",99,"[23]dgoIoHcoxHnJHGqKCpkwAhK",283,0.996479,23,284,1,283,1,1,0,1,1,162,161,122,122,4
"401",0,"[28]iuHoInoHcowHnJqGKChwxpBcIcIj",298,0.996656,28,299,1,298,1,1,0,1,1,154,153,145,145,5
"402",1,"[28]iuHoInoHcowHnJqGKChwxpBcIcIj",295,0.996622,28,296,1,295,1,1,0,1,1,146,145,150,150,5
"403",2,"[28]iuHoInoHcowHnJqGKChwxpBcIcIj",293,0.996599,28,294,1,293,1,1,0,1,1,150,149,144,144,5
"404",3,"[28]iuHoInoHcowHnJqGKChwxpBcIcIj",301,0.996689,28,302,1,301,1,1,0,1,1,158,157,144,144,5
"405",4,"[28]iuHoInoHcowHnJqGKChwxpBcIcIj",284,0.996491,28,285,1,284,1,1,0,1,1,122,121,163,163,5
"406",5,"[28]iuHoInoHcowHnJqGKChwxpBcIcIj",296,0.996633,28,297,1,296,1,1,0,1,1,151,150,146,146,5
"407",6,"[28]iuHoInoHcowHnJqGKChwxpBcIcIj",300,0.996678,28,301,1,300,1,1,0,1,1,160,159,141,141,5
"408",7,"[28]iuHoInoHcowHnJqGKChwxpBcIcIj",293,0.996599,28,294,1,293,1,1,0,1,1,141,140,153,153,5
"409",8,"[28]iuHoInoHcowHnJqGKChwxpBcIcIj",297,0.996644,28,298,1,297,1,1,0,1,1,152,151,146,146,5
"410",9,"[28]iuHoInoHcowHnJqGKChwxpBcIcIj",294,0.99661,28,295,1,294,1,1,0,1,1,145,144,150,150,5
"411",10,"[28]iuHoInoHcowHnJqGKChwxpBcIcIj",287,0.996528,28,288,1,287,1,1,0,1,1,123,122,165,165,5
"412",11,"[28]iuHoInoHcowHnJqGKChwxpBcIcIj",294,0.99661,28,295,1,294,1,1,0,1,1,144,143,151,151,5
"413",12,"[28]iuHoInoHcowHnJqGKChwxpBcIcIj",293,0.996599,28,294,1,293,1,1,0,1,1,138,137,156,156,5
"414",13,"[28]iuHoInoHcowHnJqGKChwxpBcIcIj",296,0.996633,28,297,1,296,1,1,0,1,1,150,149,147,147,5
"415",14,"[28]iuHoInoHcowHnJqGKChwxpBcIcIj",290,0.996564,28,291,1,290,1,1,0,1,1,132,131,159,159,5
"416",15,"[28]iuHoInoHcowHnJqGKChwxpBcIcIj",296,0.996633,28,297,1,296,1,1,0,1,1,154,153,143,143,5
"417",16,"[28]iuHoInoHcowHnJqGKChwxpBcIcIj",295,0.996622,28,296,1,295,1,1,0,1,1,149,148,147,147,5
"418",17,"[28]iuHoInoHcowHnJqGKChwxpBcIcIj",301,0.996689,28,302,1,301,1,1,0,1,1,165,164,137,137,5
"419",18,"[28]iuHoInoHcowHnJqGKChwxpBcIcIj",293,0.996599,28,294,1,293,1,1,0,1,1,144,143,150,150,5
"420",19,"[28]iuHoInoHcowHnJqGKChwxpBcIcIj",293,0.996599,28,294,1,293,1,1,0,1,1,137,136,157,157,5
"421",20,"[28]iuHoInoHcowHnJqGKChwxpBcIcIj",301,0.996689,28,302,1,301,1,1,0,1,1,161,160,141,141,5
"422",21,"[28]iuHoInoHcowHnJqGKChwxpBcIcIj",297,0.996644,28,298,1,297,1,1,0,1,1,157,156,141,141,5
"423",22,"[28]iuHoInoHcowHnJqGKChwxpBcIcIj",292,0.996587,28,293,1,292,1,1,0,1,1,139,138,154,154,5
"424",23,"[28]iuHoInoHcowHnJqGKChwxpBcIcIj",294,0.99661,28,295,1,294,1,1,0,1,1,144,143,151,151,5
"425",24,"[28]iuHoInoHcowHnJqGKChwxpBcIcIj",295,0.996622,28,296,1,295,1,1,0,1,1,147,146,149,149,5
"426",25,"[28]iuHoInoHcowHnJqGKChwxpBcIcIj",289,0.996552,28,290,1,289,1,1,0,1,1,130,129,160,160,5
"427",26,"[28]iuHoInoHcowHnJqGKChwxpBcIcIj",299,0.996667,28,300,1,299,1,1,0,1,1,154,153,146,146,5
"428",27,"[28]iuHoInoHcowHnJqGKChwxpBcIcIj",297,0.996644,28,298,1,297,1,1,0,1,1,144,143,154,154,5
"429",28,"[28]iuHoInoHcowHnJqGKChwxpBcIcIj",300,0.996678,28,301,1,300,1,1,0,1,1,164,163,137,137,5
"430",29,"[28]iuHoInoHcowHnJqGKChwxpBcIcIj",286,0.996516,28,287,1,286,1,1,0,1,1,124,123,163,163,5
"431",30,"[28]iuHoInoHcowHnJqGKChwxpBcIcIj",296,0.996633,28,297,1,296,1,1,0,1,1,149,148,148,148,5
"432",31,"[28]iuHoInoHcowHnJqGKChwxpBcIcIj",302,0.9967,28,303,1,302,1,1,0,1,1,161,160,142,142,5
"433",32,"[28]iuHoInoHcowHnJqGKChwxpBcIcIj",291,0.996575,28,292,1,291,1,1,0,1,1,136,135,156,156,5
"434",33,"[28]iuHoInoHcowHnJqGKChwxpBcIcIj",297,0.996644,28,298,1,297,1,1,0,1,1,154,153,144,144,5
"435",34,"[28]iuHoInoHcowHnJqGKChwxpBcIcIj",296,0.996633,28,297,1,296,1,1,0,1,1,157,156,140,140,5
"436",35,"[28]iuHoInoHcowHnJqGKChwxpBcIcIj",298,0.996656,28,299,1,298,1,1,0,1,1,158,157,141,141,5
"437",36,"[28]iuHoInoHcowHnJqGKChwxpBcIcIj",290,0.996564,28,291,1,290,1,1,0,1,1,133,132,158,158,5
"438",37,"[28]iuHoInoHcowHnJqGKChwxpBcIcIj",298,0.996656,28,299,1,298,1,1,0,1,1,158,157,141,141,5
"439",38,"[28]iuHoInoHcowHnJqGKChwxpBcIcIj",298,0.996656,28,299,1,298,1,1,0,1,1,153,152,146,146,5
"440",39,"[28]iuHoInoHcowHnJqGKChwxpBcIcIj",300,0.996678,28,301,1,300,1,1,0,1,1,167,166,134,134,5
"441",40,"[28]iuHoInoHcowHnJqGKChwxpBcIcIj",293,0.996599,28,294,1,293,1,1,0,1,1,152,151,142,142,5
"442",41,"[28]iuHoInoHcowHnJqGKChwxpBcIcIj",283,0.996479,28,284,1,283,1,1,0,1,1,109,108,175,175,5
"443",42,"[28]iuHoInoHcowHnJqGKChwxpBcIcIj",296,0.996633,28,297,1,296,1,1,0,1,1,150,149,147,147,5
"444",43,"[28]iuHoInoHcowHnJqGKChwxpBcIcIj",292,0.996587,28,293,1,292,1,1,0,1,1,137,136,156,156,5
"445",44,"[28]iuHoInoHcowHnJqGKChwxpBcIcIj",296,0.996633,28,297,1,296,1,1,0,1,1,151,150,146,146,5
"446",45,"[28]iuHoInoHcowHnJqGKChwxpBcIcIj",287,0.996528,28,288,1,287,1,1,0,1,1,139,138,149,149,5
"447",46,"[28]iuHoInoHcowHnJqGKChwxpBcIcIj",297,0.996644,28,298,1,297,1,1,0,1,1,153,152,145,145,5
"448",47,"[28]iuHoInoHcowHnJqGKChwxpBcIcIj",290,0.996564,28,291,1,290,1,1,0,1,1,133,132,158,158,5
"449",48,"[28]iuHoInoHcowHnJqGKChwxpBcIcIj",295,0.996622,28,296,1,295,1,1,0,1,1,144,143,152,152,5
"450",49,"[28]iuHoInoHcowHnJqGKChwxpBcIcIj",289,0.996552,28,290,1,289,1,1,0,1,1,130,129,160,160,5
"451",50,"[28]iuHoInoHcowHnJqGKChwxpBcIcIj",286,0.996516,28,287,1,286,1,1,0,1,1,124,123,163,163,5
"452",51,"[28]iuHoInoHcowHnJqGKChwxpBcIcIj",295,0.996622,28,296,1,295,1,1,0,1,1,143,142,153,153,5
"453",52,"[28]iuHoInoHcowHnJqGKChwxpBcIcIj",299,0.996667,28,300,1,299,1,1,0,1,1,158,157,142,142,5
"454",53,"[28]iuHoInoHcowHnJqGKChwxpBcIcIj",296,0.996633,28,297,1,296,1,1,0,1,1,155,154,142,142,5
"455",54,"[28]iuHoInoHcowHnJqGKChwxpBcIcIj",289,0.996552,28,290,1,289,1,1,0,1,1,138,137,152,152,5
"456",55,"[28]iuHoInoHcowHnJqGKChwxpBcIcIj",294,0.99661,28,295,1,294,1,1,0,1,1,143,142,152,152,5
"457",56,"[28]iuHoInoHcowHnJqGKChwxpBcIcIj",300,0.996678,28,301,1,300,1,1,0,1,1,166,165,135,135,5
"458",57,"[28]iuHoInoHcowHnJqGKChwxpBcIcIj",293,0.996599,28,294,1,293,1,1,0,1,1,147,146,147,147,5
"459",58,"[28]iuHoInoHcowHnJqGKChwxpBcIcIj",293,0.996599,28,294,1,293,1,1,0,1,1,154,153,140,140,5
"460",59,"[28]iuHoInoHcowHnJqGKChwxpBcIcIj",291,0.996575,28,292,1,291,1,1,0,1,1,134,133,158,158,5
"461",60,"[28]iuHoInoHcowHnJqGKChwxpBcIcIj",292,0.996587,28,293,1,292,1,1,0,1,1,136,135,157,157,5
"462",61,"[28]iuHoInoHcowHnJqGKChwxpBcIcIj",295,0.996622,28,296,1,295,1,1,0,1,1,147,146,149,149,5
"463",62,"[28]iuHoInoHcowHnJqGKChwxpBcIcIj",292,0.996587,28,293,1,292,1,1,0,1,1,148,147,145,145,5
"464",63,"[28]iuHoInoHcowHnJqGKChwxpBcIcIj",297,0.996644,28,298,1,297,1,1,0,1,1,157,156,141,141,5
"465",64,"[28]iuHoInoHcowHnJqGKChwxpBcIcIj",304,0.996721,28,305,1,304,1,1,0,1,1,169,168,136,136,5
"466",65,"[28]iuHoInoHcowHnJqGKChwxpBcIcIj",303,0.996711,28,304,1,303,1,1,0,1,1,167,166,137,137,5
"467",66,"[28]iuHoInoHcowHnJqGKChwxpBcIcIj",294,0.99661,28,295,1,294,1,1,0,1,1,143,142,152,152,5
"468",67,"[28]iuHoInoHcowHnJqGKChwxpBcIcIj",296,0.996633,28,297,1,296,1,1,0,1,1,149,148,148,148,5
"469",68,"[28]iuHoInoHcowHnJqGKChwxpBcIcIj",290,0.996564,28,291,1,290,1,1,0,1,1,136,135,155,155,5
"470",69,"[28]iuHoInoHcowHnJqGKChwxpBcIcIj",301,0.996689,28,302,1,301,1,1,0,1,1,160,159,142,142,5
"471",70,"[28]iuHoInoHcowHnJqGKChwxpBcIcIj",292,0.996587,28,293,1,292,1,1,0,1,1,138,137,155,155,5
"472",71,"[28]iuHoInoHcowHnJqGKChwxpBcIcIj",292,0.996587,28,293,1,292,1,1,0,1,1,136,135,157,157,5
"473",72,"[28]iuHoInoHcowHnJqGKChwxpBcIcIj",292,0.996587,28,293,1,292,1,1,0,1,1,138,137,155,155,5
"474",73,"[28]iuHoInoHcowHnJqGKChwxpBcIcIj",283,0.996479,28,284,1,283,1,1,0,1,1,118,117,166,166,5
"475",74,"[28]iuHoInoHcowHnJqGKChwxpBcIcIj",291,0.996575,28,292,1,291,1,1,0,1,1,130,129,162,162,5
"476",75,"[28]iuHoInoHcowHnJqGKChwxpBcIcIj",302,0.9967,28,303,1,302,1,1,0,1,1,166,165,137,137,5
"477",76,"[28]iuHoInoHcowHnJqGKChwxpBcIcIj",300,0.996678,28,301,1,300,1,1,0,1,1,161,160,140,140,5
"478",77,"[28]iuHoInoHcowHnJqGKChwxpBcIcIj",292,0.996587,28,293,1,292,1,1,0,1,1,135,134,158,158,5
"479",78,"[28]iuHoInoHcowHnJqGKChwxpBcIcIj",300,0.996678,28,301,1,300,1,1,0,1,1,166,165,135,135,5
"480",79,"[28]iuHoInoHcowHnJqGKChwxpBcIcIj",287,0.996528,28,288,1,287,1,1,0,1,1,131,130,157,157,5
"481",80,"[28]iuHoInoHcowHnJqGKChwxpBcIcIj",299,0.996667,28,300,1,299,1,1,0,1,1,159,158,141,141,5
"482",81,"[28]iuHoInoHcowHnJqGKChwxpBcIcIj",294,0.99661,28,295,1,294,1,1,0,1,1,148,147,147,147,5
"483",82,"[28]iuHoInoHcowHnJqGKChwxpBcIcIj",292,0.996587,28,293,1,292,1,1,0,1,1,131,130,162,162,5
"484",83,"[28]iuHoInoHcowHnJqGKChwxpBcIcIj",294,0.99661,28,295,1,294,1,1,0,1,1,143,142,152,152,5
"485",84,"[28]iuHoInoHcowHnJqGKChwxpBcIcIj",301,0.996689,28,302,1,301,1,1,0,1,1,153,152,149,149,5
"486",85,"[28]iuHoInoHcowHnJqGKChwxpBcIcIj",301,0.996689,28,302,1,301,1,1,0,1,1,165,164,137,137,5
"487",86,"[28]iuHoInoHcowHnJqGKChwxpBcIcIj",294,0.99661,28,295,1,294,1,1,0,1,1,143,142,152,152,5
"488",87,"[28]iuHoInoHcowHnJqGKChwxpBcIcIj",296,0.996633,28,297,1,296,1,1,0,1,1,151,150,146,146,5
"489",88,"[28]iuHoInoHcowHnJqGKChwxpBcIcIj",296,0.996633,28,297,1,296,1,1,0,1,1,156,155,141,141,5
"490",89,"[28]iuHoInoHcowHnJqGKChwxpBcIcIj",295,0.996622,28,296,1,295,1,1,0,1,1,146,145,150,150,5
"491",90,"[28]iuHoInoHcowHnJqGKChwxpBcIcIj",296,0.996633,28,297,1,296,1,1,0,1,1,154,153,143,143,5
"492",91,"[28]iuHoInoHcowHnJqGKChwxpBcIcIj",301,0.996689,28,302,1,301,1,1,0,1,1,162,161,140,140,5
"493",92,"[28]iuHoInoHcowHnJqGKChwxpBcIcIj",287,0.996528,28,288,1,287,1,1,0,1,1,124,123,164,164,5
"494",93,"[28]iuHoInoHcowHnJqGKChwxpBcIcIj",292,0.996587,28,293,1,292,1,1,0,1,1,136,135,157,157,5
"495",94,"[28]iuHoInoHcowHnJqGKChwxpBcIcIj",292,0.996587,28,293,1,292,1,1,0,1,1,137,136,156,156,5
"496",95,"[28]iuHoInoHcowHnJqGKChwxpBcIcIj",294,0.99661,28,295,1,294,1,1,0,1,1,143,142,152,152,5
"497",96,"[28]iuHoInoHcowHnJqGKChwxpBcIcIj",301,0.996689,28,302,1,301,1,1,0,1,1,162,161,140,140,5
"498",97,"[28]iuHoInoHcowHnJqGKChwxpBcIcIj",293,0.996599,28,294,1,293,1,1,0,1,1,141,140,153,153,5
"499",98,"[28]iuHoInoHcowHnJqGKChwxpBcIcIj",304,0.996721,28,305,1,304,1,1,0,1,1,168,167,137,137,5
"500",99,"[28]iuHoInoHcowHnJqGKChwxpBcIcIj",297,0.996644,28,298,1,297,1,1,0,1,1,148,147,150,150,5
"501",0,"[20]BxoIoHcosHnJHGqKCaqq",279,0.996429,20,280,1,279,1,1,0,1,1,123,122,157,157,6
"502",1,"[20]BxoIoHcosHnJHGqKCaqq",289,0.996552,20,290,1,289,1,1,0,1,1,140,139,150,150,6
"503",2,"[20]BxoIoHcosHnJHGqKCaqq",287,0.996528,20,288,1,287,1,1,0,1,1,147,146,141,141,6
"504",3,"[20]BxoIoHcosHnJHGqKCaqq",282,0.996466,20,283,1,282,1,1,0,1,1,149,148,134,134,6
"505",4,"[20]BxoIoHcosHnJHGqKCaqq",276,0.99639,20,277,1,276,1,1,0,1,1,137,136,140,140,6
"506",5,"[20]BxoIoHcosHnJHGqKCaqq",282,0.996466,20,283,1,282,1,1,0,1,1,141,140,142,142,6
"507",6,"[20]BxoIoHcosHnJHGqKCaqq",277,0.996403,20,278,1,277,1,1,0,1,1,139,138,139,139,6
"508",7,"[20]BxoIoHcosHnJHGqKCaqq",280,0.996441,20,281,1,280,1,1,0,1,1,133,132,148,148,6
"509",8,"[20]BxoIoHcosHnJHGqKCaqq",282,0.996466,20,283,1,282,1,1,0,1,1,147,146,136,136,6
"510",9,"[20]BxoIoHcosHnJHGqKCaqq",288,0.99654,20,289,1,288,1,1,0,1,1,146,145,143,143,6
"511",10,"[20]BxoIoHcosHnJHGqKCaqq",276,0.99639,20,277,1,276,1,1,0,1,1,132,131,145,145,6
"512",11,"[20]BxoIoHcosHnJHGqKCaqq",280,0.996441,20,281,1,280,1,1,0,1,1,137,136,144,144,6
"513",12,"[20]BxoIoHcosHnJHGqKCaqq",279,0.996429,20,280,1,279,1,1,0,1,1,126,125,154,154,6
"514",13,"[20]BxoIoHcosHnJHGqKCaqq",277,0.996403,20,278,1,277,1,1,0,1,1,135,134,143,143,6
"515",14,"[20]BxoIoHcosHnJHGqKCaqq",284,0.996491,20,285,1,284,1,1,0,1,1,147,146,138,138,6
"516",15,"[20]BxoIoHcosHnJHGqKCaqq",284,0.996491,20,285,1,284,1,1,0,1,1,145,144,140,140,6
"517",16,"[20]BxoIoHcosHnJHGqKCaqq",273,0.99635,20,274,1,273,1,1,0,1,1,128,127,146,146,6
"518",17,"[20]BxoIoHcosHnJHGqKCaqq",283,0.996479,20,284,1,283,1,1,0,1,1,137,136,147,147,6
"519",18,"[20]BxoIoHcosHnJHGqKCaqq",287,0.996528,20,288,1,287,1,1,0,1,1,136,135,152,152,6
"520",19,"[20]BxoIoHcosHnJHGqKCaqq",278,0.996416,20,279,1,278,1,1,0,1,1,149,148,130,130,6
"521",20,"[20]BxoIoHcosHnJHGqKCaqq",287,0.996528,20,288,1,287,1,1,0,1,1,153,152,135,135,6
"522",21,"[20]BxoIoHcosHnJHGqKCaqq",287,0.996528,20,288,1,287,1,1,0,1,1,166,165,122,122,6
"523",22,"[20]BxoIoHcosHnJHGqKCaqq",277,0.996403,20,278,1,277,1,1,0,1,1,136,135,142,142,6
"524",23,"[20]BxoIoHcosHnJHGqKCaqq",286,0.996516,20,287,1,286,1,1,0,1,1,144,143,143,143,6
"525",24,"[20]BxoIoHcosHnJHGqKCaqq",274,0.996364,20,275,1,274,1,1,0,1,1,124,123,151,151,6
"526",25,"[20]BxoIoHcosHnJHGqKCaqq",279,0.996429,20,280,1,279,1,1,0,1,1,147,146,133,133,6
"527",26,"[20]BxoIoHcosHnJHGqKCaqq",280,0.996441,20,281,1,280,1,1,0,1,1,145,144,136,136,6
"528",27,"[20]BxoIoHcosHnJHGqKCaqq",281,0.996454,20,282,1,281,1,1,0,1,1,139,138,143,143,6
"529",28,"[20]BxoIoHcosHnJHGqKCaqq",286,0.996516,20,287,1,286,1,1,0,1,1,136,135,151,151,6
"530",29,"[20]BxoIoHcosHnJHGqKCaqq",285,0.996503,20,286,1,285,1,1,0,1,1,143,142,143,143,6
"531",30,"[20]BxoIoHcosHnJHGqKCaqq",276,0.99639,20,277,1,276,1,1,0,1,1,130,129,147,147,6
"532",31,"[20]BxoIoHcosHnJHGqKCaqq",283,0.996479,20,284,1,283,1,1,0,1,1,136,135,148,148,6
"533",32,"[20]BxoIoHcosHnJHGqKCaqq",278,0.996416,20,279,1,278,1,1,0,1,1,139,138,140,140,6
"534",33,"[20]BxoIoHcosHnJHGqKCaqq",282,0.996466,20,283,1,282,1,1,0,1,1,135,134,148,148,6
"535",34,"[20]BxoIoHcosHnJHGqKCaqq",277,0.996403,20,278,1,277,1,1,0,1,1,142,141,136,136,6
"536",35,"[20]BxoIoHcosHnJHGqKCaqq",286,0.996516,20,287,1,286,1,1,0,1,1,143,142,144,144,6
"537",36,"[20]BxoIoHcosHnJHGqKCaqq",280,0.996441,20,281,1,280,1,1,0,1,1,154,153,127,127,6
"538",37,"[20]BxoIoHcosHnJHGqKCaqq",285,0.996503,20,286,1,285,1,1,0,1,1,160,159,126,126,6
"539",38,"[20]BxoIoHcosHnJHGqKCaqq",279,0.996429,20,280,1,279,1,1,0,1,1,134,133,146,146,6
"540",39,"[20]BxoIoHcosHnJHGqKCaqq",279,0.996429,20,280,1,279,1,1,0,1,1,134,133,146,146,6
"541",40,"[20]BxoIoHcosHnJHGqKCaqq",287,0.996528,20,288,1,287,1,1,0,1,1,137,136,151,151,6
"542",41,"[20]BxoIoHcosHnJHGqKCaqq",289,0.996552,20,290,1,289,1,1,0,1,1,155,154,135,135,6
"543",42,"[20]BxoIoHcosHnJHGqKCaqq",287,0.996528,20,288,1,287,1,1,0,1,1,144,143,144,144,6
"544",43,"[20]BxoIoHcosHnJHGqKCaqq",288,0.99654,20,289,1,288,1,1,0,1,1,152,151,137,137,6
"545",44,"[20]BxoIoHcosHnJHGqKCaqq",285,0.996503,20,286,1,285,1,1,0,1,1,138,137,148,148,6
"546",45,"[20]BxoIoHcosHnJHGqKCaqq",287,0.996528,20,288,1,287,1,1,0,1,1,142,141,146,146,6
"547",46,"[20]BxoIoHcosHnJHGqKCaqq",281,0.996454,20,282,1,281,1,1,0,1,1,132,131,150,150,6
"548",47,"[20]BxoIoHcosHnJHGqKCaqq",279,0.996429,20,280,1,279,1,1,0,1,1,141,140,139,139,6
"549",48,"[20]BxoIoHcosHnJHGqKCaqq",270,0.99631,20,271,1,270,1,1,0,1,1,126,125,145,145,6
"550",49,"[20]BxoIoHcosHnJHGqKCaqq",276,0.99639,20,277,1,276,1,1,0,1,1,140,139,137,137,6
"551",50,"[20]BxoIoHcosHnJHGqKCaqq",279,0.996429,20,280,1,279,1,1,0,1,1,164,163,116,116,6
"552",51,"[20]BxoIoHcosHnJHGqKCaqq",282,0.996466,20,283,1,282,1,1,0,1,1,149,148,134,134,6
"553",52,"[20]BxoIoHcosHnJHGqKCaqq",281,0.996454,20,282,1,281,1,1,0,1,1,148,147,134,134,6
"554",53,"[20]BxoIoHcosHnJHGqKCaqq",280,0.996441,20,281,1,280,1,1,0,1,1,149,148,132,132,6
"555",54,"[20]BxoIoHcosHnJHGqKCaqq",287,0.996528,20,288,1,287,1,1,0,1,1,157,156,131,131,6
"556",55,"[20]BxoIoHcosHnJHGqKCaqq",284,0.996491,20,285,1,284,1,1,0,1,1,150,149,135,135,6
"557",56,"[20]BxoIoHcosHnJHGqKCaqq",279,0.996429,20,280,1,279,1,1,0,1,1,145,144,135,135,6
"558",57,"[20]BxoIoHcosHnJHGqKCaqq",287,0.996528,20,288,1,287,1,1,0,1,1,153,152,135,135,6
"559",58,"[20]BxoIoHcosHnJHGqKCaqq",290,0.996564,20,291,1,290,1,1,0,1,1,142,141,149,149,6
"560",59,"[20]BxoIoHcosHnJHGqKCaqq",272,0.996337,20,273,1,272,1,1,0,1,1,131,130,142,142,6
"561",60,"[20]BxoIoHcosHnJHGqKCaqq",284,0.996491,20,285,1,284,1,1,0,1,1,145,144,140,140,6
"562",61,"[20]BxoIoHcosHnJHGqKCaqq",279,0.996429,20,280,1,279,1,1,0,1,1,155,154,125,125,6
"563",62,"[20]BxoIoHcosHnJHGqKCaqq",280,0.996441,20,281,1,280,1,1,0,1,1,138,137,143,143,6
"564",63,"[20]BxoIoHcosHnJHGqKCaqq",280,0.996441,20,281,1,280,1,1,0,1,1,142,141,139,139,6
"565",64,"[20]BxoIoHcosHnJHGqKCaqq",281,0.996454,20,282,1,281,1,1,0,1,1,141,140,141,141,6
"566",65,"[20]BxoIoHcosHnJHGqKCaqq",282,0.996466,20,283,1,282,1,1,0,1,1,135,134,148,148,6
"567",66,"[20]BxoIoHcosHnJHGqKCaqq",291,0.996575,20,292,1,291,1,1,0,1,1,151,150,141,141,6
"568",67,"[20]BxoIoHcosHnJHGqKCaqq",283,0.996479,20,284,1,283,1,1,0,1,1,132,131,152,152,6
"569",68,"[20]BxoIoHcosHnJHGqKCaqq",277,0.996403,20,278,1,277,1,1,0,1,1,136,135,142,142,6
"570",69,"[20]BxoIoHcosHnJHGqKCaqq",286,0.996516,20,287,1,286,1,1,0,1,1,140,139,147,147,6
"571",70,"[20]BxoIoHcosHnJHGqKCaqq",279,0.996429,20,280,1,279,1,1,0,1,1,133,132,147,147,6
"572",71,"[20]BxoIoHcosHnJHGqKCaqq",282,0.996466,20,283,1,282,1,1,0,1,1,143,142,140,140,6
"573",72,"[20]BxoIoHcosHnJHGqKCaqq",281,0.996454,20,282,1,281,1,1,0,1,1,135,134,147,147,6
"574",73,"[20]BxoIoHcosHnJHGqKCaqq",281,0.996454,20,282,1,281,1,1,0,1,1,131,130,151,151,6
"575",74,"[20]BxoIoHcosHnJHGqKCaqq",275,0.996377,20,276,1,275,1,1,0,1,1,127,126,149,149,6
"576",75,"[20]BxoIoHcosHnJHGqKCaqq",277,0.996403,20,278,1,277,1,1,0,1,1,125,124,153,153,6
"577",76,"[20]BxoIoHcosHnJHGqKCaqq",286,0.996516,20,287,1,286,1,1,0,1,1,148,147,139,139,6
"578",77,"[20]BxoIoHcosHnJHGqKCaqq",279,0.996429,20,280,1,279,1,1,0,1,1,155,154,125,125,6
"579",78,"[20]BxoIoHcosHnJHGqKCaqq",283,0.996479,20,284,1,283,1,1,0,1,1,144,143,140,140,6
"580",79,"[20]BxoIoHcosHnJHGqKCaqq",285,0.996503,20,286,1,285,1,1,0,1,1,148,147,138,138,6
"581",80,"[20]BxoIoHcosHnJHGqKCaqq",280,0.996441,20,281,1,280,1,1,0,1,1,140,139,141,141,6
"582",81,"[20]BxoIoHcosHnJHGqKCaqq",287,0.996528,20,288,1,287,1,1,0,1,1,156,155,132,132,6
"583",82,"[20]BxoIoHcosHnJHGqKCaqq",274,0.996364,20,275,1,274,1,1,0,1,1,148,147,127,127,6
"584",83,"[20]BxoIoHcosHnJHGqKCaqq",284,0.996491,20,285,1,284,1,1,0,1,1,147,146,138,138,6
"585",84,"[20]BxoIoHcosHnJHGqKCaqq",280,0.996441,20,281,1,280,1,1,0,1,1,137,136,144,144,6
"586",85,"[20]BxoIoHcosHnJHGqKCaqq",278,0.996416,20,279,1,278,1,1,0,1,1,142,141,137,137,6
"587",86,"[20]BxoIoHcosHnJHGqKCaqq",280,0.996441,20,281,1,280,1,1,0,1,1,134,133,147,147,6
"588",87,"[20]BxoIoHcosHnJHGqKCaqq",275,0.996377,20,276,1,275,1,1,0,1,1,130,129,146,146,6
"589",88,"[20]BxoIoHcosHnJHGqKCaqq",276,0.99639,20,277,1,276,1,1,0,1,1,131,130,146,146,6
"590",89,"[20]BxoIoHcosHnJHGqKCaqq",279,0.996429,20,280,1,279,1,1,0,1,1,144,143,136,136,6
"591",90,"[20]BxoIoHcosHnJHGqKCaqq",280,0.996441,20,281,1,280,1,1,0,1,1,129,128,152,152,6
"592",91,"[20]BxoIoHcosHnJHGqKCaqq",280,0.996441,20,281,1,280,1,1,0,1,1,141,140,140,140,6
"593",92,"[20]BxoIoHcosHnJHGqKCaqq",280,0.996441,20,281,1,280,1,1,0,1,1,134,133,147,147,6
"594",93,"[20]BxoIoHcosHnJHGqKCaqq",281,0.996454,20,282,1,281,1,1,0,1,1,157,156,125,125,6
"595",94,"[20]BxoIoHcosHnJHGqKCaqq",273,0.99635,20,274,1,273,1,1,0,1,1,127,126,147,147,6
"596",95,"[20]BxoIoHcosHnJHGqKCaqq",284,0.996491,20,285,1,284,1,1,0,1,1,156,155,129,129,6
"597",96,"[20]BxoIoHcosHnJHGqKCaqq",279,0.996429,20,280,1,279,1,1,0,1,1,144,143,136,136,6
"598",97,"[20]BxoIoHcosHnJHGqKCaqq",282,0.996466,20,283,1,282,1,1,0,1,1,135,134,148,148,6
"599",98,"[20]BxoIoHcosHnJHGqKCaqq",282,0.996466,20,283,1,282,1,1,0,1,1,140,139,143,143,6
"600",99,"[20]BxoIoHcosHnJHGqKCaqq",273,0.99635,20,274,1,273,1,1,0,1,1,140,139,134,134,6
"601",0,"[24]zHoIoHcloxHnJqGKCjiyDodl",297,0.996644,24,298,1,297,1,1,0,1,1,142,141,156,156,7
"602",1,"[24]zHoIoHcloxHnJqGKCjiyDodl",305,0.996732,24,306,1,305,1,1,0,1,1,171,170,135,135,7
"603",2,"[24]zHoIoHcloxHnJqGKCjiyDodl",302,0.9967,24,303,1,302,1,1,0,1,1,161,160,142,142,7
"604",3,"[24]zHoIoHcloxHnJqGKCjiyDodl",295,0.996622,24,296,1,295,1,1,0,1,1,143,142,153,153,7
"605",4,"[24]zHoIoHcloxHnJqGKCjiyDodl",299,0.996667,24,300,1,299,1,1,0,1,1,150,149,150,150,7
"606",5,"[24]zHoIoHcloxHnJqGKCjiyDodl",296,0.996633,24,297,1,296,1,1,0,1,1,146,145,151,151,7
"607",6,"[24]zHoIoHcloxHnJqGKCjiyDodl",295,0.996622,24,296,1,295,1,1,0,1,1,154,153,142,142,7
"608",7,"[24]zHoIoHcloxHnJqGKCjiyDodl",296,0.996633,24,297,1,296,1,1,0,1,1,155,154,142,142,7
"609",8,"[24]zHoIoHcloxHnJqGKCjiyDodl",295,0.996622,24,296,1,295,1,1,0,1,1,144,143,152,152,7
"610",9,"[24]zHoIoHcloxHnJqGKCjiyDodl",295,0.996622,24,296,1,295,1,1,0,1,1,146,145,150,150,7
"611",10,"[24]zHoIoHcloxHnJqGKCjiyDodl",296,0.996633,24,297,1,296,1,1,0,1,1,158,157,139,139,7
"612",11,"[24]zHoIoHcloxHnJqGKCjiyDodl",298,0.996656,24,299,1,298,1,1,0,1,1,164,163,135,135,7
"613",12,"[24]zHoIoHcloxHnJqGKCjiyDodl",292,0.996587,24,293,1,292,1,1,0,1,1,133,132,160,160,7
"614",13,"[24]zHoIoHcloxHnJqGKCjiyDodl",295,0.996622,24,296,1,295,1,1,0,1,1,143,142,153,153,7
"615",14,"[24]zHoIoHcloxHnJqGKCjiyDodl",302,0.9967,24,303,1,302,1,1,0,1,1,165,164,138,138,7
"616",15,"[24]zHoIoHcloxHnJqGKCjiyDodl",298,0.996656,24,299,1,298,1,1,0,1,1,144,143,155,155,7
"617",16,"[24]zHoIoHcloxHnJqGKCjiyDodl",292,0.996587,24,293,1,292,1,1,0,1,1,137,136,156,156,7
"618",17,"[24]zHoIoHcloxHnJqGKCjiyDodl",296,0.996633,24,297,1,296,1,1,0,1,1,147,146,150,150,7
"619",18,"[24]zHoIoHcloxHnJqGKCjiyDodl",298,0.996656,24,299,1,298,1,1,0,1,1,162,161,137,137,7
"620",19,"[24]zHoIoHcloxHnJqGKCjiyDodl",296,0.996633,24,297,1,296,1,1,0,1,1,152,151,145,145,7
"621",20,"[24]zHoIoHcloxHnJqGKCjiyDodl",303,0.996711,24,304,1,303,1,1,0,1,1,171,170,133,133,7
"622",21,"[24]zHoIoHcloxHnJqGKCjiyDodl",292,0.996587,24,293,1,292,1,1,0,1,1,138,137,155,155,7
"623",22,"[24]zHoIoHcloxHnJqGKCjiyDodl",294,0.99661,24,295,1,294,1,1,0,1,1,144,143,151,151,7
"624",23,"[24]zHoIoHcloxHnJqGKCjiyDodl",293,0.996599,24,294,1,293,1,1,0,1,1,139,138,155,155,7
"625",24,"[24]zHoIoHcloxHnJqGKCjiyDodl",298,0.996656,24,299,1,298,1,1,0,1,1,153,152,146,146,7
"626",25,"[24]zHoIoHcloxHnJqGKCjiyDodl",305,0.996732,24,306,1,305,1,1,0,1,1,163,162,143,143,7
"627",26,"[24]zHoIoHcloxHnJqGKCjiyDodl",295,0.996622,24,296,1,295,1,1,0,1,1,152,151,144,144,7
"628",27,"[24]zHoIoHcloxHnJqGKCjiyDodl",296,0.996633,24,297,1,296,1,1,0,1,1,149,148,148,148,7
"629",28,"[24]zHoIoHcloxHnJqGKCjiyDodl",294,0.99661,24,295,1,294,1,1,0,1,1,135,134,160,160,7
"630",29,"[24]zHoIoHcloxHnJqGKCjiyDodl",296,0.996633,24,297,1,296,1,1,0,1,1,149,148,148,148,7
"631",30,"[24]zHoIoHcloxHnJqGKCjiyDodl",294,0.99661,24,295,1,294,1,1,0,1,1,146,145,149,149,7
"632",31,"[24]zHoIoHcloxHnJqGKCjiyDodl",299,0.996667,24,300,1,299,1,1,0,1,1,152,151,148,148,7
"633",32,"[24]zHoIoHcloxHnJqGKCjiyDodl",299,0.996667,24,300,1,299,1,1,0,1,1,160,159,140,140,7
"634",33,"[24]zHoIoHcloxHnJqGKCjiyDodl",289,0.996552,24,290,1,289,1,1,0,1,1,132,131,158,158,7
"635",34,"[24]zHoIoHcloxHnJqGKCjiyDodl",293,0.996599,24,294,1,293,1,1,0,1,1,140,139,154,154,7
"636",35,"[24]zHoIoHcloxHnJqGKCjiyDodl",293,0.996599,24,294,1,293,1,1,0,1,1,140,139,154,154,7
"637",36,"[24]zHoIoHcloxHnJqGKCjiyDodl",297,0.996644,24,298,1,297,1,1,0,1,1,148,147,150,150,7
"638",37,"[24]zHoIoHcloxHnJqGKCjiyDodl",299,0.996667,24,300,1,299,1,1,0,1,1,158,157,142,142,7
"639",38,"[24]zHoIoHcloxHnJqGKCjiyDodl",298,0.996656,24,299,1,298,1,1,0,1,1,155,154,144,144,7
"640",39,"[24]zHoIoHcloxHnJqGKCjiyDodl",298,0.996656,24,299,1,298,1,1,0,1,1,154,153,145,145,7
"641",40,"[24]zHoIoHcloxHnJqGKCjiyDodl",299,0.996667,24,300,1,299,1,1,0,1,1,155,154,145,145,7
"642",41,"[24]zHoIoHcloxHnJqGKCjiyDodl",292,0.996587,24,293,1,292,1,1,0,1,1,143,142,150,150,7
"643",42,"[24]zHoIoHcloxHnJqGKCjiyDodl",292,0.996587,24,293,1,292,1,1,0,1,1,137,136,156,156,7
"644",43,"[24]zHoIoHcloxHnJqGKCjiyDodl",295,0.996622,24,296,1,295,1,1,0,1,1,142,141,154,154,7
"645",44,"[24]zHoIoHcloxHnJqGKCjiyDodl",299,0.996667,24,300,1,299,1,1,0,1,1,153,152,147,147,7
"646",45,"[24]zHoIoHcloxHnJqGKCjiyDodl",295,0.996622,24,296,1,295,1,1,0,1,1,152,151,144,144,7
"647",46,"[24]zHoIoHcloxHnJqGKCjiyDodl",290,0.996564,24,291,1,290,1,1,0,1,1,140,139,151,151,7
"648",47,"[24]zHoIoHcloxHnJqGKCjiyDodl",294,0.99661,24,295,1,294,1,1,0,1,1,147,146,148,148,7
"649",48,"[24]zHoIoHcloxHnJqGKCjiyDodl",298,0.996656,24,299,1,298,1,1,0,1,1,153,152,146,146,7
"650",49,"[24]zHoIoHcloxHnJqGKCjiyDodl",297,0.996644,24,298,1,297,1,1,0,1,1,151,150,147,147,7
"651",50,"[24]zHoIoHcloxHnJqGKCjiyDodl",303,0.996711,24,304,1,303,1,1,0,1,1,169,168,135,135,7
"652",51,"[24]zHoIoHcloxHnJqGKCjiyDodl",294,0.99661,24,295,1,294,1,1,0,1,1,142,141,153,153,7
"653",52,"[24]zHoIoHcloxHnJqGKCjiyDodl",298,0.996656,24,299,1,298,1,1,0,1,1,149,148,150,150,7
"654",53,"[24]zHoIoHcloxHnJqGKCjiyDodl",297,0.996644,24,298,1,297,1,1,0,1,1,155,154,143,143,7
"655",54,"[24]zHoIoHcloxHnJqGKCjiyDodl",298,0.996656,24,299,1,298,1,1,0,1,1,152,151,147,147,7
"656",55,"[24]zHoIoHcloxHnJqGKCjiyDodl",290,0.996564,24,291,1,290,1,1,0,1,1,134,133,157,157,7
"657",56,"[24]zHoIoHcloxHnJqGKCjiyDodl",297,0.996644,24,298,1,297,1,1,0,1,1,152,151,146,146,7
"658",57,"[24]zHoIoHcloxHnJqGKCjiyDodl",298,0.996656,24,299,1,298,1,1,0,1,1,155,154,144,144,7
"659",58,"[24]zHoIoHcloxHnJqGKCjiyDodl",290,0.996564,24,291,1,290,1,1,0,1,1,146,145,145,145,7
"660",59,"[24]zHoIoHcloxHnJqGKCjiyDodl",292,0.996587,24,293,1,292,1,1,0,1,1,143,142,150,150,7
"661",60,"[24]zHoIoHcloxHnJqGKCjiyDodl",298,0.996656,24,299,1,298,1,1,0,1,1,154,153,145,145,7
"662",61,"[24]zHoIoHcloxHnJqGKCjiyDodl",286,0.996516,24,287,1,286,1,1,0,1,1,128,127,159,159,7
"663",62,"[24]zHoIoHcloxHnJqGKCjiyDodl",296,0.996633,24,297,1,296,1,1,0,1,1,151,150,146,146,7
"664",63,"[24]zHoIoHcloxHnJqGKCjiyDodl",288,0.99654,24,289,1,288,1,1,0,1,1,145,144,144,144,7
"665",64,"[24]zHoIoHcloxHnJqGKCjiyDodl",296,0.996633,24,297,1,296,1,1,0,1,1,153,152,144,144,7
"666",65,"[24]zHoIoHcloxHnJqGKCjiyDodl",302,0.9967,24,303,1,302,1,1,0,1,1,166,165,137,137,7
"667",66,"[24]zHoIoHcloxHnJqGKCjiyDodl",285,0.996503,24,286,1,285,1,1,0,1,1,130,129,156,156,7
"668",67,"[24]zHoIoHcloxHnJqGKCjiyDodl",291,0.996575,24,292,1,291,1,1,0,1,1,140,139,152,152,7
"669",68,"[24]zHoIoHcloxHnJqGKCjiyDodl",297,0.996644,24,298,1,297,1,1,0,1,1,151,150,147,147,7
"670",69,"[24]zHoIoHcloxHnJqGKCjiyDodl",297,0.996644,24,298,1,297,1,1,0,1,1,151,150,147,147,7
"671",70,"[24]zHoIoHcloxHnJqGKCjiyDodl",305,0.996732,24,306,1,305,1,1,0,1,1,177,176,129,129,7
"672",71,"[24]zHoIoHcloxHnJqGKCjiyDodl",293,0.996599,24,294,1,293,1,1,0,1,1,142,141,152,152,7
"673",72,"[24]zHoIoHcloxHnJqGKCjiyDodl",303,0.996711,24,304,1,303,1,1,0,1,1,165,164,139,139,7
"674",73,"[24]zHoIoHcloxHnJqGKCjiyDodl",295,0.996622,24,296,1,295,1,1,0,1,1,149,148,147,147,7
"675",74,"[24]zHoIoHcloxHnJqGKCjiyDodl",295,0.996622,24,296,1,295,1,1,0,1,1,143,142,153,153,7
"676",75,"[24]zHoIoHcloxHnJqGKCjiyDodl",295,0.996622,24,296,1,295,1,1,0,1,1,145,144,151,151,7
"677",76,"[24]zHoIoHcloxHnJqGKCjiyDodl",296,0.996633,24,297,1,296,1,1,0,1,1,146,145,151,151,7
"678",77,"[24]zHoIoHcloxHnJqGKCjiyDodl",295,0.996622,24,296,1,295,1,1,0,1,1,146,145,150,150,7
"679",78,"[24]zHoIoHcloxHnJqGKCjiyDodl",295,0.996622,24,296,1,295,1,1,0,1,1,146,145,150,150,7
"680",79,"[24]zHoIoHcloxHnJqGKCjiyDodl",301,0.996689,24,302,1,301,1,1,0,1,1,168,167,134,134,7
"681",80,"[24]zHoIoHcloxHnJqGKCjiyDodl",291,0.996575,24,292,1,291,1,1,0,1,1,137,136,155,155,7
"682",81,"[24]zHoIoHcloxHnJqGKCjiyDodl",288,0.99654,24,289,1,288,1,1,0,1,1,128,127,161,161,7
"683",82,"[24]zHoIoHcloxHnJqGKCjiyDodl",295,0.996622,24,296,1,295,1,1,0,1,1,150,149,146,146,7
"684",83,"[24]zHoIoHcloxHnJqGKCjiyDodl",296,0.996633,24,297,1,296,1,1,0,1,1,145,144,152,152,7
"685",84,"[24]zHoIoHcloxHnJqGKCjiyDodl",298,0.996656,24,299,1,298,1,1,0,1,1,155,154,144,144,7
"686",85,"[24]zHoIoHcloxHnJqGKCjiyDodl",291,0.996575,24,292,1,291,1,1,0,1,1,147,146,145,145,7
"687",86,"[24]zHoIoHcloxHnJqGKCjiyDodl",293,0.996599,24,294,1,293,1,1,0,1,1,141,140,153,153,7
"688",87,"[24]zHoIoHcloxHnJqGKCjiyDodl",301,0.996689,24,302,1,301,1,1,0,1,1,170,169,132,132,7
"689",88,"[24]zHoIoHcloxHnJqGKCjiyDodl",291,0.996575,24,292,1,291,1,1,0,1,1,133,132,159,159,7
"690",89,"[24]zHoIoHcloxHnJqGKCjiyDodl",295,0.996622,24,296,1,295,1,1,0,1,1,155,154,141,141,7
"691",90,"[24]zHoIoHcloxHnJqGKCjiyDodl",293,0.996599,24,294,1,293,1,1,0,1,1,150,149,144,144,7
"692",91,"[24]zHoIoHcloxHnJqGKCjiyDodl",288,0.99654,24,289,1,288,1,1,0,1,1,135,134,154,154,7
"693",92,"[24]zHoIoHcloxHnJqGKCjiyDodl",293,0.996599,24,294,1,293,1,1,0,1,1,148,147,146,146,7
"694",93,"[24]zHoIoHcloxHnJqGKCjiyDodl",299,0.996667,24,300,1,299,1,1,0,1,1,158,157,142,142,7
"695",94,"[24]zHoIoHcloxHnJqGKCjiyDodl",294,0.99661,24,295,1,294,1,1,0,1,1,140,139,155,155,7
"696",95,"[24]zHoIoHcloxHnJqGKCjiyDodl",293,0.996599,24,294,1,293,1,1,0,1,1,141,140,153,153,7
"697",96,"[24]zHoIoHcloxHnJqGKCjiyDodl",299,0.996667,24,300,1,299,1,1,0,1,1,153,152,147,147,7
"698",97,"[24]zHoIoHcloxHnJqGKCjiyDodl",294,0.99661,24,295,1,294,1,1,0,1,1,145,144,150,150,7
"699",98,"[24]zHoIoHcloxHnJqGKCjiyDodl",297,0.996644,24,298,1,297,1,1,0,1,1,149,148,149,149,7
"700",99,"[24]zHoIoHcloxHnJqGKCjiyDodl",298,0.996656,24,299,1,298,1,1,0,1,1,159,158,140,140,7
"701",0,"[24]HoIpDoHcotHnJHGqKColIusy",285,0.996503,24,286,1,285,1,1,0,1,1,145,144,141,141,8
"702",1,"[24]HoIpDoHcotHnJHGqKColIusy",284,0.996491,24,285,1,284,1,1,0,1,1,152,151,133,133,8
"703",2,"[24]HoIpDoHcotHnJHGqKColIusy",281,0.996454,24,282,1,281,1,1,0,1,1,121,120,161,161,8
"704",3,"[24]HoIpDoHcotHnJHGqKColIusy",281,0.996454,24,282,1,281,1,1,0,1,1,144,143,138,138,8
"705",4,"[24]HoIpDoHcotHnJHGqKColIusy",284,0.996491,24,285,1,284,1,1,0,1,1,146,145,139,139,8
"706",5,"[24]HoIpDoHcotHnJHGqKColIusy",279,0.996429,24,280,1,279,1,1,0,1,1,137,136,143,143,8
"707",6,"[24]HoIpDoHcotHnJHGqKColIusy",283,0.996479,24,284,1,283,1,1,0,1,1,130,129,154,154,8
"708",7,"[24]HoIpDoHcotHnJHGqKColIusy",283,0.996479,24,284,1,283,1,1,0,1,1,143,142,141,141,8
"709",8,"[24]HoIpDoHcotHnJHGqKColIusy",287,0.996528,24,288,1,287,1,1,0,1,1,147,146,141,141,8
"710",9,"[24]HoIpDoHcotHnJHGqKColIusy",276,0.99639,24,277,1,276,1,1,0,1,1,131,130,146,146,8
"711",10,"[24]HoIpDoHcotHnJHGqKColIusy",280,0.996441,24,281,1,280,1,1,0,1,1,142,141,139,139,8
"712",11,"[24]HoIpDoHcotHnJHGqKColIusy",277,0.996403,24,278,1,277,1,1,0,1,1,128,127,150,150,8
"713",12,"[24]HoIpDoHcotHnJHGqKColIusy",281,0.996454,24,282,1,281,1,1,0,1,1,136,135,146,146,8
"714",13,"[24]HoIpDoHcotHnJHGqKColIusy",281,0.996454,24,282,1,281,1,1,0,1,1,151,150,131,131,8
"715",14,"[24]HoIpDoHcotHnJHGqKColIusy",277,0.996403,24,278,1,277,1,1,0,1,1,121,120,157,157,8
"716",15,"[24]HoIpDoHcotHnJHGqKColIusy",286,0.996516,24,287,1,286,1,1,0,1,1,150,149,137,137,8
"717",16,"[24]HoIpDoHcotHnJHGqKColIusy",279,0.996429,24,280,1,279,1,1,0,1,1,156,155,124,124,8
"718",17,"[24]HoIpDoHcotHnJHGqKColIusy",277,0.996403,24,278,1,277,1,1,0,1,1,143,142,135,135,8
"719",18,"[24]HoIpDoHcotHnJHGqKColIusy",282,0.996466,24,283,1,282,1,1,0,1,1,142,141,141,141,8
"720",19,"[24]HoIpDoHcotHnJHGqKColIusy",278,0.996416,24,279,1,278,1,1,0,1,1,141,140,138,138,8
"721",20,"[24]HoIpDoHcotHnJHGqKColIusy",284,0.996491,24,285,1,284,1,1,0,1,1,138,137,147,147,8
"722",21,"[24]HoIpDoHcotHnJHGqKColIusy",274,0.996364,24,275,1,274,1,1,0,1,1,136,135,139,139,8
"723",22,"[24]HoIpDoHcotHnJHGqKColIusy",281,0.996454,24,282,1,281,1,1,0,1,1,139,138,143,143,8
"724",23,"[24]HoIpDoHcotHnJHGqKColIusy",283,0.996479,24,284,1,283,1,1,0,1,1,137,136,147,147,8
"725",24,"[24]HoIpDoHcotHnJHGqKColIusy",277,0.996403,24,278,1,277,1,1,0,1,1,131,130,147,147,8
"726",25,"[24]HoIpDoHcotHnJHGqKColIusy",280,0.996441,24,281,1,280,1,1,0,1,1,137,136,144,144,8
"727",26,"[24]HoIpDoHcotHnJHGqKColIusy",274,0.996364,24,275,1,274,1,1,0,1,1,128,127,147,147,8
"728",27,"[24]HoIpDoHcotHnJHGqKColIusy",275,0.996377,24,276,1,275,1,1,0,1,1,129,128,147,147,8
"729",28,"[24]HoIpDoHcotHnJHGqKColIusy",279,0.996429,24,280,1,279,1,1,0,1,1,142,141,138,138,8
"730",29,"[24]HoIpDoHcotHnJHGqKColIusy",279,0.996429,24,280,1,279,1,1,0,1,1,142,141,138,138,8
"731",30,"[24]HoIpDoHcotHnJHGqKColIusy",280,0.996441,24,281,1,280,1,1,0,1,1,144,143,137,137,8
"732",31,"[24]HoIpDoHcotHnJHGqKColIusy",275,0.996377,24,276,1,275,1,1,0,1,1,129,128,147,147,8
"733",32,"[24]HoIpDoHcotHnJHGqKColIusy",285,0.996503,24,286,1,285,1,1,0,1,1,149,148,137,137,8
"734",33,"[24]HoIpDoHcotHnJHGqKColIusy",274,0.996364,24,275,1,274,1,1,0,1,1,132,131,143,143,8
"735",34,"[24]HoIpDoHcotHnJHGqKColIusy",289,0.996552,24,290,1,289,1,1,0,1,1,147,146,143,143,8
"736",35,"[24]HoIpDoHcotHnJHGqKColIusy",284,0.996491,24,285,1,284,1,1,0,1,1,142,141,143,143,8
"737",36,"[24]HoIpDoHcotHnJHGqKColIusy",274,0.996364,24,275,1,274,1,1,0,1,1,138,137,137,137,8
"738",37,"[24]HoIpDoHcotHnJHGqKColIusy",282,0.996466,24,283,1,282,1,1,0,1,1,141,140,142,142,8
"739",38,"[24]HoIpDoHcotHnJHGqKColIusy",285,0.996503,24,286,1,285,1,1,0,1,1,134,133,152,152,8
"740",39,"[24]HoIpDoHcotHnJHGqKColIusy",283,0.996479,24,284,1,283,1,1,0,1,1,145,144,139,139,8
"741",40,"[24]HoIpDoHcotHnJHGqKColIusy",283,0.996479,24,284,1,283,1,1,0,1,1,159,158,125,125,8
"742",41,"[24]HoIpDoHcotHnJHGqKColIusy",285,0.996503,24,286,1,285,1,1,0,1,1,147,146,139,139,8
"743",42,"[24]HoIpDoHcotHnJHGqKColIusy",279,0.996429,24,280,1,279,1,1,0,1,1,143,142,137,137,8
"744",43,"[24]HoIpDoHcotHnJHGqKColIusy",277,0.996403,24,278,1,277,1,1,0,1,1,148,147,130,130,8
"745",44,"[24]HoIpDoHcotHnJHGqKColIusy",280,0.996441,24,281,1,280,1,1,0,1,1,126,125,155,155,8
"746",45,"[24]HoIpDoHcotHnJHGqKColIusy",286,0.996516,24,287,1,286,1,1,0,1,1,150,149,137,137,8
"747",46,"[24]HoIpDoHcotHnJHGqKColIusy",278,0.996416,24,279,1,278,1,1,0,1,1,147,146,132,132,8
"748",47,"[24]HoIpDoHcotHnJHGqKColIusy",282,0.996466,24,283,1,282,1,1,0,1,1,128,127,155,155,8
"749",48,"[24]HoIpDoHcotHnJHGqKColIusy",283,0.996479,24,284,1,283,1,1,0,1,1,144,143,140,140,8
"750",49,"[24]HoIpDoHcotHnJHGqKColIusy",281,0.996454,24,282,1,281,1,1,0,1,1,126,125,156,156,8
"751",50,"[24]HoIpDoHcotHnJHGqKColIusy",280,0.996441,24,281,1,280,1,1,0,1,1,145,144,136,136,8
"752",51,"[24]HoIpDoHcotHnJHGqKColIusy",288,0.99654,24,289,1,288,1,1,0,1,1,149,148,140,140,8
"753",52,"[24]HoIpDoHcotHnJHGqKColIusy",284,0.996491,24,285,1,284,1,1,0,1,1,127,126,158,158,8
"754",53,"[24]HoIpDoHcotHnJHGqKColIusy",283,0.996479,24,284,1,283,1,1,0,1,1,153,152,131,131,8
"755",54,"[24]HoIpDoHcotHnJHGqKColIusy",278,0.996416,24,279,1,278,1,1,0,1,1,135,134,144,144,8
"756",55,"[24]HoIpDoHcotHnJHGqKColIusy",290,0.996564,24,291,1,290,1,1,0,1,1,151,150,140,140,8
"757",56,"[24]HoIpDoHcotHnJHGqKColIusy",273,0.99635,24,274,1,273,1,1,0,1,1,133,132,141,141,8
"758",57,"[24]HoIpDoHcotHnJHGqKColIusy",273,0.99635,24,274,1,273,1,1,0,1,1,120,119,154,154,8
"759",58,"[24]HoIpDoHcotHnJHGqKColIusy",274,0.996364,24,275,1,274,1,1,0,1,1,141,140,134,134,8
"760",59,"[24]HoIpDoHcotHnJHGqKColIusy",275,0.996377,24,276,1,275,1,1,0,1,1,139,138,137,137,8
"761",60,"[24]HoIpDoHcotHnJHGqKColIusy",277,0.996403,24,278,1,277,1,1,0,1,1,143,142,135,135,8
"762",61,"[24]HoIpDoHcotHnJHGqKColIusy",282,0.996466,24,283,1,282,1,1,0,1,1,143,142,140,140,8
"763",62,"[24]HoIpDoHcotHnJHGqKColIusy",272,0.996337,24,273,1,272,1,1,0,1,1,127,126,146,146,8
"764",63,"[24]HoIpDoHcotHnJHGqKColIusy",280,0.996441,24,281,1,280,1,1,0,1,1,132,131,149,149,8
"765",64,"[24]HoIpDoHcotHnJHGqKColIusy",283,0.996479,24,284,1,283,1,1,0,1,1,145,144,139,139,8
"766",65,"[24]HoIpDoHcotHnJHGqKColIusy",287,0.996528,24,288,1,287,1,1,0,1,1,133,132,155,155,8
"767",66,"[24]HoIpDoHcotHnJHGqKColIusy",289,0.996552,24,290,1,289,1,1,0,1,1,159,158,131,131,8
"768",67,"[24]HoIpDoHcotHnJHGqKColIusy",281,0.996454,24,282,1,281,1,1,0,1,1,152,151,130,130,8
"769",68,"[24]HoIpDoHcotHnJHGqKColIusy",280,0.996441,24,281,1,280,1,1,0,1,1,139,138,142,142,8
"770",69,"[24]HoIpDoHcotHnJHGqKColIusy",275,0.996377,24,276,1,275,1,1,0,1,1,137,136,139,139,8
"771",70,"[24]HoIpDoHcotHnJHGqKColIusy",287,0.996528,24,288,1,287,1,1,0,1,1,135,134,153,153,8
"772",71,"[24]HoIpDoHcotHnJHGqKColIusy",281,0.996454,24,282,1,281,1,1,0,1,1,141,140,141,141,8
"773",72,"[24]HoIpDoHcotHnJHGqKColIusy",281,0.996454,24,282,1,281,1,1,0,1,1,139,138,143,143,8
"774",73,"[24]HoIpDoHcotHnJHGqKColIusy",280,0.996441,24,281,1,280,1,1,0,1,1,154,153,127,127,8
"775",74,"[24]HoIpDoHcotHnJHGqKColIusy",282,0.996466,24,283,1,282,1,1,0,1,1,142,141,141,141,8
"776",75,"[24]HoIpDoHcotHnJHGqKColIusy",277,0.996403,24,278,1,277,1,1,0,1,1,142,141,136,136,8
"777",76,"[24]HoIpDoHcotHnJHGqKColIusy",291,0.996575,24,292,1,291,1,1,0,1,1,150,149,142,142,8
"778",77,"[24]HoIpDoHcotHnJHGqKColIusy",281,0.996454,24,282,1,281,1,1,0,1,1,139,138,143,143,8
"779",78,"[24]HoIpDoHcotHnJHGqKColIusy",286,0.996516,24,287,1,286,1,1,0,1,1,141,140,146,146,8
"780",79,"[24]HoIpDoHcotHnJHGqKColIusy",283,0.996479,24,284,1,283,1,1,0,1,1,158,157,126,126,8
"781",80,"[24]HoIpDoHcotHnJHGqKColIusy",281,0.996454,24,282,1,281,1,1,0,1,1,130,129,152,152,8
"782",81,"[24]HoIpDoHcotHnJHGqKColIusy",277,0.996403,24,278,1,277,1,1,0,1,1,139,138,139,139,8
"783",82,"[24]HoIpDoHcotHnJHGqKColIusy",279,0.996429,24,280,1,279,1,1,0,1,1,142,141,138,138,8
"784",83,"[24]HoIpDoHcotHnJHGqKColIusy",280,0.996441,24,281,1,280,1,1,0,1,1,159,158,122,122,8
"785",84,"[24]HoIpDoHcotHnJHGqKColIusy",275,0.996377,24,276,1,275,1,1,0,1,1,124,123,152,152,8
"786",85,"[24]HoIpDoHcotHnJHGqKColIusy",273,0.99635,24,274,1,273,1,1,0,1,1,149,148,125,125,8
"787",86,"[24]HoIpDoHcotHnJHGqKColIusy",285,0.996503,24,286,1,285,1,1,0,1,1,131,130,155,155,8
"788",87,"[24]HoIpDoHcotHnJHGqKColIusy",275,0.996377,24,276,1,275,1,1,0,1,1,141,140,135,135,8
"789",88,"[24]HoIpDoHcotHnJHGqKColIusy",277,0.996403,24,278,1,277,1,1,0,1,1,145,144,133,133,8
"790",89,"[24]HoIpDoHcotHnJHGqKColIusy",272,0.996337,24,273,1,272,1,1,0,1,1,130,129,143,143,8
"791",90,"[24]HoIpDoHcotHnJHGqKColIusy",276,0.99639,24,277,1,276,1,1,0,1,1,126,125,151,151,8
"792",91,"[24]HoIpDoHcotHnJHGqKColIusy",287,0.996528,24,288,1,287,1,1,0,1,1,159,158,129,129,8
"793",92,"[24]HoIpDoHcotHnJHGqKColIusy",274,0.996364,24,275,1,274,1,1,0,1,1,139,138,136,136,8
"794",93,"[24]HoIpDoHcotHnJHGqKColIusy",280,0.996441,24,281,1,280,1,1,0,1,1,145,144,136,136,8
"795",94,"[24]HoIpDoHcotHnJHGqKColIusy",291,0.996575,24,292,1,291,1,1,0,1,1,154,153,138,138,8
"796",95,"[24]HoIpDoHcotHnJHGqKColIusy",281,0.996454,24,282,1,281,1,1,0,1,1,143,142,139,139,8
"797",96,"[24]HoIpDoHcotHnJHGqKColIusy",280,0.996441,24,281,1,280,1,1,0,1,1,149,148,132,132,8
"798",97,"[24]HoIpDoHcotHnJHGqKColIusy",287,0.996528,24,288,1,287,1,1,0,1,1,141,140,147,147,8
"799",98,"[24]HoIpDoHcotHnJHGqKColIusy",285,0.996503,24,286,1,285,1,1,0,1,1,139,138,147,147,8
"800",99,"[24]HoIpDoHcotHnJHGqKColIusy",292,0.996587,24,293,1,292,1,1,0,1,1,162,161,131,131,8
"801",0,"[28]azHoIloHcowHnJHGqKCoAaeceAqs",277,0.996403,28,278,1,277,1,1,0,1,1,148,147,130,130,9
"802",1,"[28]azHoIloHcowHnJHGqKCoAaeceAqs",286,0.996516,28,287,1,286,1,1,0,1,1,138,137,149,149,9
"803",2,"[28]azHoIloHcowHnJHGqKCoAaeceAqs",267,0.996269,28,268,1,267,1,1,0,1,1,121,120,147,147,9
"804",3,"[28]azHoIloHcowHnJHGqKCoAaeceAqs",279,0.996429,28,280,1,279,1,1,0,1,1,127,126,153,153,9
"805",4,"[28]azHoIloHcowHnJHGqKCoAaeceAqs",273,0.99635,28,274,1,273,1,1,0,1,1,124,123,150,150,9
"806",5,"[28]azHoIloHcowHnJHGqKCoAaeceAqs",284,0.996491,28,285,1,284,1,1,0,1,1,152,151,133,133,9
"807",6,"[28]azHoIloHcowHnJHGqKCoAaeceAqs",269,0.996296,28,270,1,269,1,1,0,1,1,129,128,141,141,9
"808",7,"[28]azHoIloHcowHnJHGqKCoAaeceAqs",262,0.996198,28,263,1,262,1,1,0,1,1,133,132,130,130,9
"809",8,"[28]azHoIloHcowHnJHGqKCoAaeceAqs",283,0.996479,28,284,1,283,1,1,0,1,1,155,154,129,129,9
"810",9,"[28]azHoIloHcowHnJHGqKCoAaeceAqs",278,0.996416,28,279,1,278,1,1,0,1,1,144,143,135,135,9
"811",10,"[28]azHoIloHcowHnJHGqKCoAaeceAqs",277,0.996403,28,278,1,277,1,1,0,1,1,129,128,149,149,9
"812",11,"[28]azHoIloHcowHnJHGqKCoAaeceAqs",288,0.99654,28,289,1,288,1,1,0,1,1,157,156,132,132,9
"813",12,"[28]azHoIloHcowHnJHGqKCoAaeceAqs",274,0.996364,28,275,1,274,1,1,0,1,1,129,128,146,146,9
"814",13,"[28]azHoIloHcowHnJHGqKCoAaeceAqs",274,0.996364,28,275,1,274,1,1,0,1,1,138,137,137,137,9
"815",14,"[28]azHoIloHcowHnJHGqKCoAaeceAqs",274,0.996364,28,275,1,274,1,1,0,1,1,130,129,145,145,9
"816",15,"[28]azHoIloHcowHnJHGqKCoAaeceAqs",282,0.996466,28,283,1,282,1,1,0,1,1,147,146,136,136,9
"817",16,"[28]azHoIloHcowHnJHGqKCoAaeceAqs",286,0.996516,28,287,1,286,1,1,0,1,1,156,155,131,131,9
"818",17,"[28]azHoIloHcowHnJHGqKCoAaeceAqs",280,0.996441,28,281,1,280,1,1,0,1,1,140,139,141,141,9
"819",18,"[28]azHoIloHcowHnJHGqKCoAaeceAqs",278,0.996416,28,279,1,278,1,1,0,1,1,159,158,120,120,9
"820",19,"[28]azHoIloHcowHnJHGqKCoAaeceAqs",280,0.996441,28,281,1,280,1,1,0,1,1,137,136,144,144,9
"821",20,"[28]azHoIloHcowHnJHGqKCoAaeceAqs",272,0.996337,28,273,1,272,1,1,0,1,1,140,139,133,133,9
"822",21,"[28]azHoIloHcowHnJHGqKCoAaeceAqs",280,0.996441,28,281,1,280,1,1,0,1,1,169,168,112,112,9
"823",22,"[28]azHoIloHcowHnJHGqKCoAaeceAqs",274,0.996364,28,275,1,274,1,1,0,1,1,135,134,140,140,9
"824",23,"[28]azHoIloHcowHnJHGqKCoAaeceAqs",291,0.996575,28,292,1,291,1,1,0,1,1,149,148,143,143,9
"825",24,"[28]azHoIloHcowHnJHGqKCoAaeceAqs",271,0.996324,28,272,1,271,1,1,0,1,1,133,132,139,139,9
"826",25,"[28]azHoIloHcowHnJHGqKCoAaeceAqs",280,0.996441,28,281,1,280,1,1,0,1,1,129,128,152,152,9
"827",26,"[28]azHoIloHcowHnJHGqKCoAaeceAqs",287,0.996528,28,288,1,287,1,1,0,1,1,144,143,144,144,9
"828",27,"[28]azHoIloHcowHnJHGqKCoAaeceAqs",281,0.996454,28,282,1,281,1,1,0,1,1,150,149,132,132,9
"829",28,"[28]azHoIloHcowHnJHGqKCoAaeceAqs",275,0.996377,28,276,1,275,1,1,0,1,1,126,125,150,150,9
"830",29,"[28]azHoIloHcowHnJHGqKCoAaeceAqs",279,0.996429,28,280,1,279,1,1,0,1,1,145,144,135,135,9
"831",30,"[28]azHoIloHcowHnJHGqKCoAaeceAqs",288,0.99654,28,289,1,288,1,1,0,1,1,155,154,134,134,9
"832",31,"[28]azHoIloHcowHnJHGqKCoAaeceAqs",280,0.996441,28,281,1,280,1,1,0,1,1,145,144,136,136,9
"833",32,"[28]azHoIloHcowHnJHGqKCoAaeceAqs",285,0.996503,28,286,1,285,1,1,0,1,1,156,155,130,130,9
"834",33,"[28]azHoIloHcowHnJHGqKCoAaeceAqs",275,0.996377,28,276,1,275,1,1,0,1,1,131,130,145,145,9
"835",34,"[28]azHoIloHcowHnJHGqKCoAaeceAqs",281,0.996454,28,282,1,281,1,1,0,1,1,134,133,148,148,9
"836",35,"[28]azHoIloHcowHnJHGqKCoAaeceAqs",276,0.99639,28,277,1,276,1,1,0,1,1,143,142,134,134,9
"837",36,"[28]azHoIloHcowHnJHGqKCoAaeceAqs",279,0.996429,28,280,1,279,1,1,0,1,1,154,153,126,126,9
"838",37,"[28]azHoIloHcowHnJHGqKCoAaeceAqs",276,0.99639,28,277,1,276,1,1,0,1,1,126,125,151,151,9
"839",38,"[28]azHoIloHcowHnJHGqKCoAaeceAqs",275,0.996377,28,276,1,275,1,1,0,1,1,132,131,144,144,9
"840",39,"[28]azHoIloHcowHnJHGqKCoAaeceAqs",288,0.99654,28,289,1,288,1,1,0,1,1,158,157,131,131,9
"841",40,"[28]azHoIloHcowHnJHGqKCoAaeceAqs",276,0.99639,28,277,1,276,1,1,0,1,1,147,146,130,130,9
"842",41,"[28]azHoIloHcowHnJHGqKCoAaeceAqs",282,0.996466,28,283,1,282,1,1,0,1,1,152,151,131,131,9
"843",42,"[28]azHoIloHcowHnJHGqKCoAaeceAqs",279,0.996429,28,280,1,279,1,1,0,1,1,157,156,123,123,9
"844",43,"[28]azHoIloHcowHnJHGqKCoAaeceAqs",281,0.996454,28,282,1,281,1,1,0,1,1,137,136,145,145,9
"845",44,"[28]azHoIloHcowHnJHGqKCoAaeceAqs",271,0.996324,28,272,1,271,1,1,0,1,1,137,136,135,135,9
"846",45,"[28]azHoIloHcowHnJHGqKCoAaeceAqs",285,0.996503,28,286,1,285,1,1,0,1,1,142,141,144,144,9
"847",46,"[28]azHoIloHcowHnJHGqKCoAaeceAqs",280,0.996441,28,281,1,280,1,1,0,1,1,155,154,126,126,9
"848",47,"[28]azHoIloHcowHnJHGqKCoAaeceAqs",281,0.996454,28,282,1,281,1,1,0,1,1,144,143,138,138,9
"849",48,"[28]azHoIloHcowHnJHGqKCoAaeceAqs",289,0.996552,28,290,1,289,1,1,0,1,1,143,142,147,147,9
"850",49,"[28]azHoIloHcowHnJHGqKCoAaeceAqs",277,0.996403,28,278,1,277,1,1,0,1,1,118,117,160,160,9
"851",50,"[28]azHoIloHcowHnJHGqKCoAaeceAqs",283,0.996479,28,284,1,283,1,1,0,1,1,150,149,134,134,9
"852",51,"[28]azHoIloHcowHnJHGqKCoAaeceAqs",282,0.996466,28,283,1,282,1,1,0,1,1,143,142,140,140,9
"853",52,"[28]azHoIloHcowHnJHGqKCoAaeceAqs",283,0.996479,28,284,1,283,1,1,0,1,1,154,153,130,130,9
"854",53,"[28]azHoIloHcowHnJHGqKCoAaeceAqs",281,0.996454,28,282,1,281,1,1,0,1,1,135,134,147,147,9
"855",54,"[28]azHoIloHcowHnJHGqKCoAaeceAqs",277,0.996403,28,278,1,277,1,1,0,1,1,130,129,148,148,9
"856",55,"[28]azHoIloHcowHnJHGqKCoAaeceAqs",284,0.996491,28,285,1,284,1,1,0,1,1,161,160,124,124,9
"857",56,"[28]azHoIloHcowHnJHGqKCoAaeceAqs",281,0.996454,28,282,1,281,1,1,0,1,1,128,127,154,154,9
"858",57,"[28]azHoIloHcowHnJHGqKCoAaeceAqs",280,0.996441,28,281,1,280,1,1,0,1,1,135,134,146,146,9
"859",58,"[28]azHoIloHcowHnJHGqKCoAaeceAqs",280,0.996441,28,281,1,280,1,1,0,1,1,136,135,145,145,9
"860",59,"[28]azHoIloHcowHnJHGqKCoAaeceAqs",279,0.996429,28,280,1,279,1,1,0,1,1,151,150,129,129,9
"861",60,"[28]azHoIloHcowHnJHGqKCoAaeceAqs",271,0.996324,28,272,1,271,1,1,0,1,1,141,140,131,131,9
"862",61,"[28]azHoIloHcowHnJHGqKCoAaeceAqs",282,0.996466,28,283,1,282,1,1,0,1,1,145,144,138,138,9
"863",62,"[28]azHoIloHcowHnJHGqKCoAaeceAqs",280,0.996441,28,281,1,280,1,1,0,1,1,144,143,137,137,9
"864",63,"[28]azHoIloHcowHnJHGqKCoAaeceAqs",279,0.996429,28,280,1,279,1,1,0,1,1,145,144,135,135,9
"865",64,"[28]azHoIloHcowHnJHGqKCoAaeceAqs",284,0.996491,28,285,1,284,1,1,0,1,1,142,141,143,143,9
"866",65,"[28]azHoIloHcowHnJHGqKCoAaeceAqs",286,0.996516,28,287,1,286,1,1,0,1,1,151,150,136,136,9
"867",66,"[28]azHoIloHcowHnJHGqKCoAaeceAqs",286,0.996516,28,287,1,286,1,1,0,1,1,148,147,139,139,9
"868",67,"[28]azHoIloHcowHnJHGqKCoAaeceAqs",279,0.996429,28,280,1,279,1,1,0,1,1,131,130,149,149,9
"869",68,"[28]azHoIloHcowHnJHGqKCoAaeceAqs",281,0.996454,28,282,1,281,1,1,0,1,1,140,139,142,142,9
"870",69,"[28]azHoIloHcowHnJHGqKCoAaeceAqs",282,0.996466,28,283,1,282,1,1,0,1,1,135,134,148,148,9
"871",70,"[28]azHoIloHcowHnJHGqKCoAaeceAqs",281,0.996454,28,282,1,281,1,1,0,1,1,129,128,153,153,9
"872",71,"[28]azHoIloHcowHnJHGqKCoAaeceAqs",279,0.996429,28,280,1,279,1,1,0,1,1,142,141,138,138,9
"873",72,"[28]azHoIloHcowHnJHGqKCoAaeceAqs",285,0.996503,28,286,1,285,1,1,0,1,1,157,156,129,129,9
"874",73,"[28]azHoIloHcowHnJHGqKCoAaeceAqs",277,0.996403,28,278,1,277,1,1,0,1,1,132,131,146,146,9
"875",74,"[28]azHoIloHcowHnJHGqKCoAaeceAqs",277,0.996403,28,278,1,277,1,1,0,1,1,138,137,140,140,9
"876",75,"[28]azHoIloHcowHnJHGqKCoAaeceAqs",282,0.996466,28,283,1,282,1,1,0,1,1,138,137,145,145,9
"877",76,"[28]azHoIloHcowHnJHGqKCoAaeceAqs",283,0.996479,28,284,1,283,1,1,0,1,1,142,141,142,142,9
"878",77,"[28]azHoIloHcowHnJHGqKCoAaeceAqs",285,0.996503,28,286,1,285,1,1,0,1,1,163,162,123,123,9
"879",78,"[28]azHoIloHcowHnJHGqKCoAaeceAqs",285,0.996503,28,286,1,285,1,1,0,1,1,152,151,134,134,9
"880",79,"[28]azHoIloHcowHnJHGqKCoAaeceAqs",286,0.996516,28,287,1,286,1,1,0,1,1,164,163,123,123,9
"881",80,"[28]azHoIloHcowHnJHGqKCoAaeceAqs",280,0.996441,28,281,1,280,1,1,0,1,1,155,154,126,126,9
"882",81,"[28]azHoIloHcowHnJHGqKCoAaeceAqs",285,0.996503,28,286,1,285,1,1,0,1,1,140,139,146,146,9
"883",82,"[28]azHoIloHcowHnJHGqKCoAaeceAqs",284,0.996491,28,285,1,284,1,1,0,1,1,136,135,149,149,9
"884",83,"[28]azHoIloHcowHnJHGqKCoAaeceAqs",279,0.996429,28,280,1,279,1,1,0,1,1,143,142,137,137,9
"885",84,"[28]azHoIloHcowHnJHGqKCoAaeceAqs",279,0.996429,28,280,1,279,1,1,0,1,1,159,158,121,121,9
"886",85,"[28]azHoIloHcowHnJHGqKCoAaeceAqs",275,0.996377,28,276,1,275,1,1,0,1,1,128,127,148,148,9
"887",86,"[28]azHoIloHcowHnJHGqKCoAaeceAqs",278,0.996416,28,279,1,278,1,1,0,1,1,142,141,137,137,9
"888",87,"[28]azHoIloHcowHnJHGqKCoAaeceAqs",279,0.996429,28,280,1,279,1,1,0,1,1,134,133,146,146,9
"889",88,"[28]azHoIloHcowHnJHGqKCoAaeceAqs",282,0.996466,28,283,1,282,1,1,0,1,1,134,133,149,149,9
"890",89,"[28]azHoIloHcowHnJHGqKCoAaeceAqs",273,0.99635,28,274,1,273,1,1,0,1,1,128,127,146,146,9
"891",90,"[28]azHoIloHcowHnJHGqKCoAaeceAqs",277,0.996403,28,278,1,277,1,1,0,1,1,140,139,138,138,9
"892",91,"[28]azHoIloHcowHnJHGqKCoAaeceAqs",283,0.996479,28,284,1,283,1,1,0,1,1,141,140,143,143,9
"893",92,"[28]azHoIloHcowHnJHGqKCoAaeceAqs",282,0.996466,28,283,1,282,1,1,0,1,1,143,142,140,140,9
"894",93,"[28]azHoIloHcowHnJHGqKCoAaeceAqs",275,0.996377,28,276,1,275,1,1,0,1,1,151,150,125,125,9
"895",94,"[28]azHoIloHcowHnJHGqKCoAaeceAqs",282,0.996466,28,283,1,282,1,1,0,1,1,145,144,138,138,9
"896",95,"[28]azHoIloHcowHnJHGqKCoAaeceAqs",276,0.99639,28,277,1,276,1,1,0,1,1,128,127,149,149,9
"897",96,"[28]azHoIloHcowHnJHGqKCoAaeceAqs",276,0.99639,28,277,1,276,1,1,0,1,1,142,141,135,135,9
"898",97,"[28]azHoIloHcowHnJHGqKCoAaeceAqs",281,0.996454,28,282,1,281,1,1,0,1,1,141,140,141,141,9
"899",98,"[28]azHoIloHcowHnJHGqKCoAaeceAqs",273,0.99635,28,274,1,273,1,1,0,1,1,147,146,127,127,9
"900",99,"[28]azHoIloHcowHnJHGqKCoAaeceAqs",274,0.996364,28,275,1,274,1,1,0,1,1,127,126,148,148,9
"901",0,"[29]tgHoIbEoHcosHnJHGqKCvbfJKxgDz",276,0.99639,29,277,1,276,1,1,0,1,1,119,118,158,158,10
"902",1,"[29]tgHoIbEoHcosHnJHGqKCvbfJKxgDz",269,0.996296,29,270,1,269,1,1,0,1,1,130,129,140,140,10
"903",2,"[29]tgHoIbEoHcosHnJHGqKCvbfJKxgDz",283,0.996479,29,284,1,283,1,1,0,1,1,132,131,152,152,10
"904",3,"[29]tgHoIbEoHcosHnJHGqKCvbfJKxgDz",272,0.996337,29,273,1,272,1,1,0,1,1,142,141,131,131,10
"905",4,"[29]tgHoIbEoHcosHnJHGqKCvbfJKxgDz",276,0.99639,29,277,1,276,1,1,0,1,1,134,133,143,143,10
"906",5,"[29]tgHoIbEoHcosHnJHGqKCvbfJKxgDz",285,0.996503,29,286,1,285,1,1,0,1,1,151,150,135,135,10
"907",6,"[29]tgHoIbEoHcosHnJHGqKCvbfJKxgDz",270,0.99631,29,271,1,270,1,1,0,1,1,130,129,141,141,10
"908",7,"[29]tgHoIbEoHcosHnJHGqKCvbfJKxgDz",269,0.996296,29,270,1,269,1,1,0,1,1,131,130,139,139,10
"909",8,"[29]tgHoIbEoHcosHnJHGqKCvbfJKxgDz",280,0.996441,29,281,1,280,1,1,0,1,1,143,142,138,138,10
"910",9,"[29]tgHoIbEoHcosHnJHGqKCvbfJKxgDz",287,0.996528,29,288,1,287,1,1,0,1,1,150,149,138,138,10
"911",10,"[29]tgHoIbEoHcosHnJHGqKCvbfJKxgDz",279,0.996429,29,280,1,279,1,1,0,1,1,138,137,142,142,10
"912",11,"[29]tgHoIbEoHcosHnJHGqKCvbfJKxgDz",278,0.996416,29,279,1,278,1,1,0,1,1,133,132,146,146,10
"913",12,"[29]tgHoIbEoHcosHnJHGqKCvbfJKxgDz",276,0.99639,29,277,1,276,1,1,0,1,1,134,133,143,143,10
"914",13,"[29]tgHoIbEoHcosHnJHGqKCvbfJKxgDz",279,0.996429,29,280,1,279,1,1,0,1,1,144,143,136,136,10
"915",14,"[29]tgHoIbEoHcosHnJHGqKCvbfJKxgDz",278,0.996416,29,279,1,278,1,1,0,1,1,124,123,155,155,10
"916",15,"[29]tgHoIbEoHcosHnJHGqKCvbfJKxgDz",277,0.996403,29,278,1,277,1,1,0,1,1,157,156,121,121,10
"917",16,"[29]tgHoIbEoHcosHnJHGqKCvbfJKxgDz",279,0.996429,29,280,1,279,1,1,0,1,1,130,129,150,150,10
"918",17,"[29]tgHoIbEoHcosHnJHGqKCvbfJKxgDz",270,0.99631,29,271,1,270,1,1,0,1,1,110,109,161,161,10
"919",18,"[29]tgHoIbEoHcosHnJHGqKCvbfJKxgDz",271,0.996324,29,272,1,271,1,1,0,1,1,162,161,110,110,10
"920",19,"[29]tgHoIbEoHcosHnJHGqKCvbfJKxgDz",276,0.99639,29,277,1,276,1,1,0,1,1,149,148,128,128,10
"921",20,"[29]tgHoIbEoHcosHnJHGqKCvbfJKxgDz",286,0.996516,29,287,1,286,1,1,0,1,1,158,157,129,129,10
"922",21,"[29]tgHoIbEoHcosHnJHGqKCvbfJKxgDz",277,0.996403,29,278,1,277,1,1,0,1,1,129,128,149,149,10
"923",22,"[29]tgHoIbEoHcosHnJHGqKCvbfJKxgDz",283,0.996479,29,284,1,283,1,1,0,1,1,139,138,145,145,10
"924",23,"[29]tgHoIbEoHcosHnJHGqKCvbfJKxgDz",282,0.996466,29,283,1,282,1,1,0,1,1,143,142,140,140,10
"925",24,"[29]tgHoIbEoHcosHnJHGqKCvbfJKxgDz",279,0.996429,29,280,1,279,1,1,0,1,1,143,142,137,137,10
"926",25,"[29]tgHoIbEoHcosHnJHGqKCvbfJKxgDz",285,0.996503,29,286,1,285,1,1,0,1,1,155,154,131,131,10
"927",26,"[29]tgHoIbEoHcosHnJHGqKCvbfJKxgDz",281,0.996454,29,282,1,281,1,1,0,1,1,144,143,138,138,10
"928",27,"[29]tgHoIbEoHcosHnJHGqKCvbfJKxgDz",279,0.996429,29,280,1,279,1,1,0,1,1,141,140,139,139,10
"929",28,"[29]tgHoIbEoHcosHnJHGqKCvbfJKxgDz",277,0.996403,29,278,1,277,1,1,0,1,1,137,136,141,141,10
"930",29,"[29]tgHoIbEoHcosHnJHGqKCvbfJKxgDz",281,0.996454,29,282,1,281,1,1,0,1,1,148,147,134,134,10
"931",30,"[29]tgHoIbEoHcosHnJHGqKCvbfJKxgDz",274,0.996364,29,275,1,274,1,1,0,1,1,146,145,129,129,10
"932",31,"[29]tgHoIbEoHcosHnJHGqKCvbfJKxgDz",274,0.996364,29,275,1,274,1,1,0,1,1,123,122,152,152,10
"933",32,"[29]tgHoIbEoHcosHnJHGqKCvbfJKxgDz",283,0.996479,29,284,1,283,1,1,0,1,1,146,145,138,138,10
"934",33,"[29]tgHoIbEoHcosHnJHGqKCvbfJKxgDz",282,0.996466,29,283,1,282,1,1,0,1,1,134,133,149,149,10
"935",34,"[29]tgHoIbEoHcosHnJHGqKCvbfJKxgDz",288,0.99654,29,289,1,288,1,1,0,1,1,142,141,147,147,10
"936",35,"[29]tgHoIbEoHcosHnJHGqKCvbfJKxgDz",284,0.996491,29,285,1,284,1,1,0,1,1,160,159,125,125,10
"937",36,"[29]tgHoIbEoHcosHnJHGqKCvbfJKxgDz",274,0.996364,29,275,1,274,1,1,0,1,1,145,144,130,130,10
"938",37,"[29]tgHoIbEoHcosHnJHGqKCvbfJKxgDz",281,0.996454,29,282,1,281,1,1,0,1,1,137,136,145,145,10
"939",38,"[29]tgHoIbEoHcosHnJHGqKCvbfJKxgDz",280,0.996441,29,281,1,280,1,1,0,1,1,133,132,148,148,10
"940",39,"[29]tgHoIbEoHcosHnJHGqKCvbfJKxgDz",286,0.996516,29,287,1,286,1,1,0,1,1,148,147,139,139,10
"941",40,"[29]tgHoIbEoHcosHnJHGqKCvbfJKxgDz",274,0.996364,29,275,1,274,1,1,0,1,1,142,141,133,133,10
"942",41,"[29]tgHoIbEoHcosHnJHGqKCvbfJKxgDz",286,0.996516,29,287,1,286,1,1,0,1,1,148,147,139,139,10
"943",42,"[29]tgHoIbEoHcosHnJHGqKCvbfJKxgDz",279,0.996429,29,280,1,279,1,1,0,1,1,132,131,148,148,10
"944",43,"[29]tgHoIbEoHcosHnJHGqKCvbfJKxgDz",277,0.996403,29,278,1,277,1,1,0,1,1,132,131,146,146,10
"945",44,"[29]tgHoIbEoHcosHnJHGqKCvbfJKxgDz",281,0.996454,29,282,1,281,1,1,0,1,1,137,136,145,145,10
"946",45,"[29]tgHoIbEoHcosHnJHGqKCvbfJKxgDz",277,0.996403,29,278,1,277,1,1,0,1,1,131,130,147,147,10
"947",46,"[29]tgHoIbEoHcosHnJHGqKCvbfJKxgDz",269,0.996296,29,270,1,269,1,1,0,1,1,123,122,147,147,10
"948",47,"[29]tgHoIbEoHcosHnJHGqKCvbfJKxgDz",277,0.996403,29,278,1,277,1,1,0,1,1,135,134,143,143,10
"949",48,"[29]tgHoIbEoHcosHnJHGqKCvbfJKxgDz",276,0.99639,29,277,1,276,1,1,0,1,1,127,126,150,150,10
"950",49,"[29]tgHoIbEoHcosHnJHGqKCvbfJKxgDz",276,0.99639,29,277,1,276,1,1,0,1,1,129,128,148,148,10
"951",50,"[29]tgHoIbEoHcosHnJHGqKCvbfJKxgDz",277,0.996403,29,278,1,277,1,1,0,1,1,134,133,144,144,10
"952",51,"[29]tgHoIbEoHcosHnJHGqKCvbfJKxgDz",281,0.996454,29,282,1,281,1,1,0,1,1,136,135,146,146,10
"953",52,"[29]tgHoIbEoHcosHnJHGqKCvbfJKxgDz",281,0.996454,29,282,1,281,1,1,0,1,1,152,151,130,130,10
"954",53,"[29]tgHoIbEoHcosHnJHGqKCvbfJKxgDz",281,0.996454,29,282,1,281,1,1,0,1,1,144,143,138,138,10
"955",54,"[29]tgHoIbEoHcosHnJHGqKCvbfJKxgDz",282,0.996466,29,283,1,282,1,1,0,1,1,139,138,144,144,10
"956",55,"[29]tgHoIbEoHcosHnJHGqKCvbfJKxgDz",279,0.996429,29,280,1,279,1,1,0,1,1,134,133,146,146,10
"957",56,"[29]tgHoIbEoHcosHnJHGqKCvbfJKxgDz",280,0.996441,29,281,1,280,1,1,0,1,1,144,143,137,137,10
"958",57,"[29]tgHoIbEoHcosHnJHGqKCvbfJKxgDz",283,0.996479,29,284,1,283,1,1,0,1,1,136,135,148,148,10
"959",58,"[29]tgHoIbEoHcosHnJHGqKCvbfJKxgDz",268,0.996283,29,269,1,268,1,1,0,1,1,134,133,135,135,10
"960",59,"[29]tgHoIbEoHcosHnJHGqKCvbfJKxgDz",279,0.996429,29,280,1,279,1,1,0,1,1,143,142,137,137,10
"961",60,"[29]tgHoIbEoHcosHnJHGqKCvbfJKxgDz",282,0.996466,29,283,1,282,1,1,0,1,1,138,137,145,145,10
"962",61,"[29]tgHoIbEoHcosHnJHGqKCvbfJKxgDz",278,0.996416,29,279,1,278,1,1,0,1,1,154,153,125,125,10
"963",62,"[29]tgHoIbEoHcosHnJHGqKCvbfJKxgDz",272,0.996337,29,273,1,272,1,1,0,1,1,125,124,148,148,10
"964",63,"[29]tgHoIbEoHcosHnJHGqKCvbfJKxgDz",276,0.99639,29,277,1,276,1,1,0,1,1,142,141,135,135,10
"965",64,"[29]tgHoIbEoHcosHnJHGqKCvbfJKxgDz",283,0.996479,29,284,1,283,1,1,0,1,1,153,152,131,131,10
"966",65,"[29]tgHoIbEoHcosHnJHGqKCvbfJKxgDz",270,0.99631,29,271,1,270,1,1,0,1,1,144,143,127,127,10
"967",66,"[29]tgHoIbEoHcosHnJHGqKCvbfJKxgDz",274,0.996364,29,275,1,274,1,1,0,1,1,138,137,137,137,10
"968",67,"[29]tgHoIbEoHcosHnJHGqKCvbfJKxgDz",285,0.996503,29,286,1,285,1,1,0,1,1,157,156,129,129,10
"969",68,"[29]tgHoIbEoHcosHnJHGqKCvbfJKxgDz",277,0.996403,29,278,1,277,1,1,0,1,1,133,132,145,145,10
"970",69,"[29]tgHoIbEoHcosHnJHGqKCvbfJKxgDz",283,0.996479,29,284,1,283,1,1,0,1,1,144,143,140,140,10
"971",70,"[29]tgHoIbEoHcosHnJHGqKCvbfJKxgDz",284,0.996491,29,285,1,284,1,1,0,1,1,151,150,134,134,10
"972",71,"[29]tgHoIbEoHcosHnJHGqKCvbfJKxgDz",279,0.996429,29,280,1,279,1,1,0,1,1,152,151,128,128,10
"973",72,"[29]tgHoIbEoHcosHnJHGqKCvbfJKxgDz",280,0.996441,29,281,1,280,1,1,0,1,1,142,141,139,139,10
"974",73,"[29]tgHoIbEoHcosHnJHGqKCvbfJKxgDz",281,0.996454,29,282,1,281,1,1,0,1,1,139,138,143,143,10
"975",74,"[29]tgHoIbEoHcosHnJHGqKCvbfJKxgDz",282,0.996466,29,283,1,282,1,1,0,1,1,143,142,140,140,10
"976",75,"[29]tgHoIbEoHcosHnJHGqKCvbfJKxgDz",276,0.99639,29,277,1,276,1,1,0,1,1,148,147,129,129,10
"977",76,"[29]tgHoIbEoHcosHnJHGqKCvbfJKxgDz",286,0.996516,29,287,1,286,1,1,0,1,1,143,142,144,144,10
"978",77,"[29]tgHoIbEoHcosHnJHGqKCvbfJKxgDz",278,0.996416,29,279,1,278,1,1,0,1,1,141,140,138,138,10
"979",78,"[29]tgHoIbEoHcosHnJHGqKCvbfJKxgDz",282,0.996466,29,283,1,282,1,1,0,1,1,133,132,150,150,10
"980",79,"[29]tgHoIbEoHcosHnJHGqKCvbfJKxgDz",283,0.996479,29,284,1,283,1,1,0,1,1,146,145,138,138,10
"981",80,"[29]tgHoIbEoHcosHnJHGqKCvbfJKxgDz",274,0.996364,29,275,1,274,1,1,0,1,1,138,137,137,137,10
"982",81,"[29]tgHoIbEoHcosHnJHGqKCvbfJKxgDz",279,0.996429,29,280,1,279,1,1,0,1,1,134,133,146,146,10
"983",82,"[29]tgHoIbEoHcosHnJHGqKCvbfJKxgDz",278,0.996416,29,279,1,278,1,1,0,1,1,133,132,146,146,10
"984",83,"[29]tgHoIbEoHcosHnJHGqKCvbfJKxgDz",277,0.996403,29,278,1,277,1,1,0,1,1,141,140,137,137,10
"985",84,"[29]tgHoIbEoHcosHnJHGqKCvbfJKxgDz",276,0.99639,29,277,1,276,1,1,0,1,1,133,132,144,144,10
"986",85,"[29]tgHoIbEoHcosHnJHGqKCvbfJKxgDz",281,0.996454,29,282,1,281,1,1,0,1,1,137,136,145,145,10
"987",86,"[29]tgHoIbEoHcosHnJHGqKCvbfJKxgDz",281,0.996454,29,282,1,281,1,1,0,1,1,137,136,145,145,10
"988",87,"[29]tgHoIbEoHcosHnJHGqKCvbfJKxgDz",277,0.996403,29,278,1,277,1,1,0,1,1,147,146,131,131,10
"989",88,"[29]tgHoIbEoHcosHnJHGqKCvbfJKxgDz",279,0.996429,29,280,1,279,1,1,0,1,1,136,135,144,144,10
"990",89,"[29]tgHoIbEoHcosHnJHGqKCvbfJKxgDz",284,0.996491,29,285,1,284,1,1,0,1,1,148,147,137,137,10
"991",90,"[29]tgHoIbEoHcosHnJHGqKCvbfJKxgDz",274,0.996364,29,275,1,274,1,1,0,1,1,138,137,137,137,10
"992",91,"[29]tgHoIbEoHcosHnJHGqKCvbfJKxgDz",277,0.996403,29,278,1,277,1,1,0,1,1,155,154,123,123,10
"993",92,"[29]tgHoIbEoHcosHnJHGqKCvbfJKxgDz",280,0.996441,29,281,1,280,1,1,0,1,1,138,137,143,143,10
"994",93,"[29]tgHoIbEoHcosHnJHGqKCvbfJKxgDz",278,0.996416,29,279,1,278,1,1,0,1,1,145,144,134,134,10
"995",94,"[29]tgHoIbEoHcosHnJHGqKCvbfJKxgDz",286,0.996516,29,287,1,286,1,1,0,1,1,147,146,140,140,10
"996",95,"[29]tgHoIbEoHcosHnJHGqKCvbfJKxgDz",270,0.99631,29,271,1,270,1,1,0,1,1,155,154,116,116,10
"997",96,"[29]tgHoIbEoHcosHnJHGqKCvbfJKxgDz",274,0.996364,29,275,1,274,1,1,0,1,1,145,144,130,130,10
"998",97,"[29]tgHoIbEoHcosHnJHGqKCvbfJKxgDz",275,0.996377,29,276,1,275,1,1,0,1,1,137,136,139,139,10
"999",98,"[29]tgHoIbEoHcosHnJHGqKCvbfJKxgDz",284,0.996491,29,285,1,284,1,1,0,1,1,154,153,131,131,10
"1000",99,"[29]tgHoIbEoHcosHnJHGqKCvbfJKxgDz",281,0.996454,29,282,1,281,1,1,0,1,1,146,145,136,136,10
"1001",0,"[22]loIyoHcoxHnJHGqKCvsrDI",279,0.996429,22,280,1,279,1,1,0,1,1,144,143,136,136,11
"1002",1,"[22]loIyoHcoxHnJHGqKCvsrDI",281,0.996454,22,282,1,281,1,1,0,1,1,135,134,147,147,11
"1003",2,"[22]loIyoHcoxHnJHGqKCvsrDI",278,0.996416,22,279,1,278,1,1,0,1,1,130,129,149,149,11
"1004",3,"[22]loIyoHcoxHnJHGqKCvsrDI",275,0.996377,22,276,1,275,1,1,0,1,1,145,144,131,131,11
"1005",4,"[22]loIyoHcoxHnJHGqKCvsrDI",281,0.996454,22,282,1,281,1,1,0,1,1,141,140,141,141,11
"1006",5,"[22]loIyoHcoxHnJHGqKCvsrDI",285,0.996503,22,286,1,285,1,1,0,1,1,136,135,150,150,11
"1007",6,"[22]loIyoHcoxHnJHGqKCvsrDI",269,0.996296,22,270,1,269,1,1,0,1,1,113,112,157,157,11
"1008",7,"[22]loIyoHcoxHnJHGqKCvsrDI",270,0.99631,22,271,1,270,1,1,0,1,1,122,121,149,149,11
"1009",8,"[22]loIyoHcoxHnJHGqKCvsrDI",284,0.996491,22,285,1,284,1,1,0,1,1,132,131,153,153,11
"1010",9,"[22]loIyoHcoxHnJHGqKCvsrDI",284,0.996491,22,285,1,284,1,1,0,1,1,138,137,147,147,11
"1011",10,"[22]loIyoHcoxHnJHGqKCvsrDI",279,0.996429,22,280,1,279,1,1,0,1,1,126,125,154,154,11
"1012",11,"[22]loIyoHcoxHnJHGqKCvsrDI",280,0.996441,22,281,1,280,1,1,0,1,1,131,130,150,150,11
"1013",12,"[22]loIyoHcoxHnJHGqKCvsrDI",278,0.996416,22,279,1,278,1,1,0,1,1,151,150,128,128,11
"1014",13,"[22]loIyoHcoxHnJHGqKCvsrDI",280,0.996441,22,281,1,280,1,1,0,1,1,152,151,129,129,11
"1015",14,"[22]loIyoHcoxHnJHGqKCvsrDI",281,0.996454,22,282,1,281,1,1,0,1,1,130,129,152,152,11
"1016",15,"[22]loIyoHcoxHnJHGqKCvsrDI",272,0.996337,22,273,1,272,1,1,0,1,1,135,134,138,138,11
"1017",16,"[22]loIyoHcoxHnJHGqKCvsrDI",283,0.996479,22,284,1,283,1,1,0,1,1,148,147,136,136,11
"1018",17,"[22]loIyoHcoxHnJHGqKCvsrDI",285,0.996503,22,286,1,285,1,1,0,1,1,164,163,122,122,11
"1019",18,"[22]loIyoHcoxHnJHGqKCvsrDI",283,0.996479,22,284,1,283,1,1,0,1,1,150,149,134,134,11
"1020",19,"[22]loIyoHcoxHnJHGqKCvsrDI",284,0.996491,22,285,1,284,1,1,0,1,1,137,136,148,148,11
"1021",20,"[22]loIyoHcoxHnJHGqKCvsrDI",279,0.996429,22,280,1,279,1,1,0,1,1,139,138,141,141,11
"1022",21,"[22]loIyoHcoxHnJHGqKCvsrDI",278,0.996416,22,279,1,278,1,1,0,1,1,129,128,150,150,11
"1023",22,"[22]loIyoHcoxHnJHGqKCvsrDI",285,0.996503,22,286,1,285,1,1,0,1,1,145,144,141,141,11
"1024",23,"[22]loIyoHcoxHnJHGqKCvsrDI",281,0.996454,22,282,1,281,1,1,0,1,1,145,144,137,137,11
"1025",24,"[22]loIyoHcoxHnJHGqKCvsrDI",271,0.996324,22,272,1,271,1,1,0,1,1,126,125,146,146,11
"1026",25,"[22]loIyoHcoxHnJHGqKCvsrDI",272,0.996337,22,273,1,272,1,1,0,1,1,115,114,158,158,11
"1027",26,"[22]loIyoHcoxHnJHGqKCvsrDI",282,0.996466,22,283,1,282,1,1,0,1,1,123,122,160,160,11
"1028",27,"[22]loIyoHcoxHnJHGqKCvsrDI",282,0.996466,22,283,1,282,1,1,0,1,1,137,136,146,146,11
"1029",28,"[22]loIyoHcoxHnJHGqKCvsrDI",282,0.996466,22,283,1,282,1,1,0,1,1,123,122,160,160,11
"1030",29,"[22]loIyoHcoxHnJHGqKCvsrDI",282,0.996466,22,283,1,282,1,1,0,1,1,138,137,145,145,11
"1031",30,"[22]loIyoHcoxHnJHGqKCvsrDI",278,0.996416,22,279,1,278,1,1,0,1,1,138,137,141,141,11
"1032",31,"[22]loIyoHcoxHnJHGqKCvsrDI",288,0.99654,22,289,1,288,1,1,0,1,1,162,161,127,127,11
"1033",32,"[22]loIyoHcoxHnJHGqKCvsrDI",278,0.996416,22,279,1,278,1,1,0,1,1,118,117,161,161,11
"1034",33,"[22]loIyoHcoxHnJHGqKCvsrDI",278,0.996416,22,279,1,278,1,1,0,1,1,140,139,139,139,11
"1035",34,"[22]loIyoHcoxHnJHGqKCvsrDI",281,0.996454,22,282,1,281,1,1,0,1,1,140,139,142,142,11
"1036",35,"[22]loIyoHcoxHnJHGqKCvsrDI",276,0.99639,22,277,1,276,1,1,0,1,1,145,144,132,132,11
"1037",36,"[22]loIyoHcoxHnJHGqKCvsrDI",287,0.996528,22,288,1,287,1,1,0,1,1,147,146,141,141,11
"1038",37,"[22]loIyoHcoxHnJHGqKCvsrDI",278,0.996416,22,279,1,278,1,1,0,1,1,129,128,150,150,11
"1039",38,"[22]loIyoHcoxHnJHGqKCvsrDI",277,0.996403,22,278,1,277,1,1,0,1,1,153,152,125,125,11
"1040",39,"[22]loIyoHcoxHnJHGqKCvsrDI",282,0.996466,22,283,1,282,1,1,0,1,1,153,152,130,130,11
"1041",40,"[22]loIyoHcoxHnJHGqKCvsrDI",281,0.996454,22,282,1,281,1,1,0,1,1,146,145,136,136,11
"1042",41,"[22]loIyoHcoxHnJHGqKCvsrDI",290,0.996564,22,291,1,290,1,1,0,1,1,159,158,132,132,11
"1043",42,"[22]loIyoHcoxHnJHGqKCvsrDI",282,0.996466,22,283,1,282,1,1,0,1,1,141,140,142,142,11
"1044",43,"[22]loIyoHcoxHnJHGqKCvsrDI",277,0.996403,22,278,1,277,1,1,0,1,1,130,129,148,148,11
"1045",44,"[22]loIyoHcoxHnJHGqKCvsrDI",285,0.996503,22,286,1,285,1,1,0,1,1,133,132,153,153,11
"1046",45,"[22]loIyoHcoxHnJHGqKCvsrDI",283,0.996479,22,284,1,283,1,1,0,1,1,154,153,130,130,11
"1047",46,"[22]loIyoHcoxHnJHGqKCvsrDI",279,0.996429,22,280,1,279,1,1,0,1,1,130,129,150,150,11
"1048",47,"[22]loIyoHcoxHnJHGqKCvsrDI",278,0.996416,22,279,1,278,1,1,0,1,1,140,139,139,139,11
"1049",48,"[22]loIyoHcoxHnJHGqKCvsrDI",280,0.996441,22,281,1,280,1,1,0,1,1,139,138,142,142,11
"1050",49,"[22]loIyoHcoxHnJHGqKCvsrDI",282,0.996466,22,283,1,282,1,1,0,1,1,142,141,141,141,11
"1051",50,"[22]loIyoHcoxHnJHGqKCvsrDI",283,0.996479,22,284,1,283,1,1,0,1,1,140,139,144,144,11
"1052",51,"[22]loIyoHcoxHnJHGqKCvsrDI",281,0.996454,22,282,1,281,1,1,0,1,1,139,138,143,143,11
"1053",52,"[22]loIyoHcoxHnJHGqKCvsrDI",287,0.996528,22,288,1,287,1,1,0,1,1,153,152,135,135,11
"1054",53,"[22]loIyoHcoxHnJHGqKCvsrDI",279,0.996429,22,280,1,279,1,1,0,1,1,147,146,133,133,11
"1055",54,"[22]loIyoHcoxHnJHGqKCvsrDI",286,0.996516,22,287,1,286,1,1,0,1,1,145,144,142,142,11
"1056",55,"[22]loIyoHcoxHnJHGqKCvsrDI",279,0.996429,22,280,1,279,1,1,0,1,1,130,129,150,150,11
"1057",56,"[22]loIyoHcoxHnJHGqKCvsrDI",289,0.996552,22,290,1,289,1,1,0,1,1,162,161,128,128,11
"1058",57,"[22]loIyoHcoxHnJHGqKCvsrDI",282,0.996466,22,283,1,282,1,1,0,1,1,151,150,132,132,11
"1059",58,"[22]loIyoHcoxHnJHGqKCvsrDI",295,0.996622,22,296,1,295,1,1,0,1,1,172,171,124,124,11
"1060",59,"[22]loIyoHcoxHnJHGqKCvsrDI",281,0.996454,22,282,1,281,1,1,0,1,1,154,153,128,128,11
"1061",60,"[22]loIyoHcoxHnJHGqKCvsrDI",288,0.99654,22,289,1,288,1,1,0,1,1,145,144,144,144,11
"1062",61,"[22]loIyoHcoxHnJHGqKCvsrDI",282,0.996466,22,283,1,282,1,1,0,1,1,157,156,126,126,11
"1063",62,"[22]loIyoHcoxHnJHGqKCvsrDI",277,0.996403,22,278,1,277,1,1,0,1,1,139,138,139,139,11
"1064",63,"[22]loIyoHcoxHnJHGqKCvsrDI",283,0.996479,22,284,1,283,1,1,0,1,1,150,149,134,134,11
"1065",64,"[22]loIyoHcoxHnJHGqKCvsrDI",279,0.996429,22,280,1,279,1,1,0,1,1,135,134,145,145,11
"1066",65,"[22]loIyoHcoxHnJHGqKCvsrDI",282,0.996466,22,283,1,282,1,1,0,1,1,143,142,140,140,11
"1067",66,"[22]loIyoHcoxHnJHGqKCvsrDI",283,0.996479,22,284,1,283,1,1,0,1,1,145,144,139,139,11
"1068",67,"[22]loIyoHcoxHnJHGqKCvsrDI",281,0.996454,22,282,1,281,1,1,0,1,1,150,149,132,132,11
"1069",68,"[22]loIyoHcoxHnJHGqKCvsrDI",281,0.996454,22,282,1,281,1,1,0,1,1,145,144,137,137,11
"1070",69,"[22]loIyoHcoxHnJHGqKCvsrDI",282,0.996466,22,283,1,282,1,1,0,1,1,140,139,143,143,11
"1071",70,"[22]loIyoHcoxHnJHGqKCvsrDI",284,0.996491,22,285,1,284,1,1,0,1,1,154,153,131,131,11
"1072",71,"[22]loIyoHcoxHnJHGqKCvsrDI",283,0.996479,22,284,1,283,1,1,0,1,1,140,139,144,144,11
"1073",72,"[22]loIyoHcoxHnJHGqKCvsrDI",279,0.996429,22,280,1,279,1,1,0,1,1,148,147,132,132,11
"1074",73,"[22]loIyoHcoxHnJHGqKCvsrDI",282,0.996466,22,283,1,282,1,1,0,1,1,147,146,136,136,11
"1075",74,"[22]loIyoHcoxHnJHGqKCvsrDI",280,0.996441,22,281,1,280,1,1,0,1,1,146,145,135,135,11
"1076",75,"[22]loIyoHcoxHnJHGqKCvsrDI",286,0.996516,22,287,1,286,1,1,0,1,1,149,148,138,138,11
"1077",76,"[22]loIyoHcoxHnJHGqKCvsrDI",273,0.99635,22,274,1,273,1,1,0,1,1,158,157,116,116,11
"1078",77,"[22]loIyoHcoxHnJHGqKCvsrDI",287,0.996528,22,288,1,287,1,1,0,1,1,154,153,134,134,11
"1079",78,"[22]loIyoHcoxHnJHGqKCvsrDI",279,0.996429,22,280,1,279,1,1,0,1,1,142,141,138,138,11
"1080",79,"[22]loIyoHcoxHnJHGqKCvsrDI",281,0.996454,22,282,1,281,1,1,0,1,1,141,140,141,141,11
"1081",80,"[22]loIyoHcoxHnJHGqKCvsrDI",279,0.996429,22,280,1,279,1,1,0,1,1,127,126,153,153,11
"1082",81,"[22]loIyoHcoxHnJHGqKCvsrDI",277,0.996403,22,278,1,277,1,1,0,1,1,132,131,146,146,11
"1083",82,"[22]loIyoHcoxHnJHGqKCvsrDI",273,0.99635,22,274,1,273,1,1,0,1,1,131,130,143,143,11
"1084",83,"[22]loIyoHcoxHnJHGqKCvsrDI",280,0.996441,22,281,1,280,1,1,0,1,1,148,147,133,133,11
"1085",84,"[22]loIyoHcoxHnJHGqKCvsrDI",282,0.996466,22,283,1,282,1,1,0,1,1,142,141,141,141,11
"1086",85,"[22]loIyoHcoxHnJHGqKCvsrDI",285,0.996503,22,286,1,285,1,1,0,1,1,167,166,119,119,11
"1087",86,"[22]loIyoHcoxHnJHGqKCvsrDI",291,0.996575,22,292,1,291,1,1,0,1,1,147,146,145,145,11
"1088",87,"[22]loIyoHcoxHnJHGqKCvsrDI",276,0.99639,22,277,1,276,1,1,0,1,1,134,133,143,143,11
"1089",88,"[22]loIyoHcoxHnJHGqKCvsrDI",279,0.996429,22,280,1,279,1,1,0,1,1,147,146,133,133,11
"1090",89,"[22]loIyoHcoxHnJHGqKCvsrDI",281,0.996454,22,282,1,281,1,1,0,1,1,132,131,150,150,11
"1091",90,"[22]loIyoHcoxHnJHGqKCvsrDI",273,0.99635,22,274,1,273,1,1,0,1,1,128,127,146,146,11
"1092",91,"[22]loIyoHcoxHnJHGqKCvsrDI",282,0.996466,22,283,1,282,1,1,0,1,1,142,141,141,141,11
"1093",92,"[22]loIyoHcoxHnJHGqKCvsrDI",288,0.99654,22,289,1,288,1,1,0,1,1,134,133,155,155,11
"1094",93,"[22]loIyoHcoxHnJHGqKCvsrDI",279,0.996429,22,280,1,279,1,1,0,1,1,132,131,148,148,11
"1095",94,"[22]loIyoHcoxHnJHGqKCvsrDI",277,0.996403,22,278,1,277,1,1,0,1,1,152,151,126,126,11
"1096",95,"[22]loIyoHcoxHnJHGqKCvsrDI",292,0.996587,22,293,1,292,1,1,0,1,1,166,165,127,127,11
"1097",96,"[22]loIyoHcoxHnJHGqKCvsrDI",279,0.996429,22,280,1,279,1,1,0,1,1,150,149,130,130,11
"1098",97,"[22]loIyoHcoxHnJHGqKCvsrDI",283,0.996479,22,284,1,283,1,1,0,1,1,149,148,135,135,11
"1099",98,"[22]loIyoHcoxHnJHGqKCvsrDI",280,0.996441,22,281,1,280,1,1,0,1,1,136,135,145,145,11
"1100",99,"[22]loIyoHcoxHnJHGqKCvsrDI",281,0.996454,22,282,1,281,1,1,0,1,1,135,134,147,147,11
"1101",0,"[24]HoIoHcowHnJHGqKCmnavFrIH",282,0.996466,24,283,1,282,1,1,0,1,1,131,130,152,152,12
"1102",1,"[24]HoIoHcowHnJHGqKCmnavFrIH",278,0.996416,24,279,1,278,1,1,0,1,1,138,137,141,141,12
"1103",2,"[24]HoIoHcowHnJHGqKCmnavFrIH",271,0.996324,24,272,1,271,1,1,0,1,1,132,131,140,140,12
"1104",3,"[24]HoIoHcowHnJHGqKCmnavFrIH",279,0.996429,24,280,1,279,1,1,0,1,1,141,140,139,139,12
"1105",4,"[24]HoIoHcowHnJHGqKCmnavFrIH",283,0.996479,24,284,1,283,1,1,0,1,1,163,162,121,121,12
"1106",5,"[24]HoIoHcowHnJHGqKCmnavFrIH",275,0.996377,24,276,1,275,1,1,0,1,1,136,135,140,140,12
"1107",6,"[24]HoIoHcowHnJHGqKCmnavFrIH",282,0.996466,24,283,1,282,1,1,0,1,1,150,149,133,133,12
"1108",7,"[24]HoIoHcowHnJHGqKCmnavFrIH",281,0.996454,24,282,1,281,1,1,0,1,1,138,137,144,144,12
"1109",8,"[24]HoIoHcowHnJHGqKCmnavFrIH",282,0.996466,24,283,1,282,1,1,0,1,1,142,141,141,141,12
"1110",9,"[24]HoIoHcowHnJHGqKCmnavFrIH",283,0.996479,24,284,1,283,1,1,0,1,1,146,145,138,138,12
"1111",10,"[24]HoIoHcowHnJHGqKCmnavFrIH",283,0.996479,24,284,1,283,1,1,0,1,1,152,151,132,132,12
"1112",11,"[24]HoIoHcowHnJHGqKCmnavFrIH",282,0.996466,24,283,1,282,1,1,0,1,1,149,148,134,134,12
"1113",12,"[24]HoIoHcowHnJHGqKCmnavFrIH",282,0.996466,24,283,1,282,1,1,0,1,1,138,137,145,145,12
"1114",13,"[24]HoIoHcowHnJHGqKCmnavFrIH",287,0.996528,24,288,1,287,1,1,0,1,1,154,153,134,134,12
"1115",14,"[24]HoIoHcowHnJHGqKCmnavFrIH",284,0.996491,24,285,1,284,1,1,0,1,1,151,150,134,134,12
"1116",15,"[24]HoIoHcowHnJHGqKCmnavFrIH",277,0.996403,24,278,1,277,1,1,0,1,1,144,143,134,134,12
"1117",16,"[24]HoIoHcowHnJHGqKCmnavFrIH",282,0.996466,24,283,1,282,1,1,0,1,1,129,128,154,154,12
"1118",17,"[24]HoIoHcowHnJHGqKCmnavFrIH",279,0.996429,24,280,1,279,1,1,0,1,1,141,140,139,139,12
"1119",18,"[24]HoIoHcowHnJHGqKCmnavFrIH",278,0.996416,24,279,1,278,1,1,0,1,1,141,140,138,138,12
"1120",19,"[24]HoIoHcowHnJHGqKCmnavFrIH",282,0.996466,24,283,1,282,1,1,0,1,1,132,131,151,151,12
"1121",20,"[24]HoIoHcowHnJHGqKCmnavFrIH",284,0.996491,24,285,1,284,1,1,0,1,1,147,146,138,138,12
"1122",21,"[24]HoIoHcowHnJHGqKCmnavFrIH",282,0.996466,24,283,1,282,1,1,0,1,1,151,150,132,132,12
"1123",22,"[24]HoIoHcowHnJHGqKCmnavFrIH",280,0.996441,24,281,1,280,1,1,0,1,1,135,134,146,146,12
"1124",23,"[24]HoIoHcowHnJHGqKCmnavFrIH",285,0.996503,24,286,1,285,1,1,0,1,1,137,136,149,149,12
"1125",24,"[24]HoIoHcowHnJHGqKCmnavFrIH",280,0.996441,24,281,1,280,1,1,0,1,1,129,128,152,152,12
"1126",25,"[24]HoIoHcowHnJHGqKCmnavFrIH",286,0.996516,24,287,1,286,1,1,0,1,1,130,129,157,157,12
"1127",26,"[24]HoIoHcowHnJHGqKCmnavFrIH",278,0.996416,24,279,1,278,1,1,0,1,1,137,136,142,142,12
"1128",27,"[24]HoIoHcowHnJHGqKCmnavFrIH",286,0.996516,24,287,1,286,1,1,0,1,1,161,160,126,126,12
"1129",28,"[24]HoIoHcowHnJHGqKCmnavFrIH",286,0.996516,24,287,1,286,1,1,0,1,1,150,149,137,137,12
"1130",29,"[24]HoIoHcowHnJHGqKCmnavFrIH",275,0.996377,24,276,1,275,1,1,0,1,1,126,125,150,150,12
"1131",30,"[24]HoIoHcowHnJHGqKCmnavFrIH",283,0.996479,24,284,1,283,1,1,0,1,1,138,137,146,146,12
"1132",31,"[24]HoIoHcowHnJHGqKCmnavFrIH",288,0.99654,24,289,1,288,1,1,0,1,1,141,140,148,148,12
"1133",32,"[24]HoIoHcowHnJHGqKCmnavFrIH",281,0.996454,24,282,1,281,1,1,0,1,1,136,135,146,146,12
"1134",33,"[24]HoIoHcowHnJHGqKCmnavFrIH",279,0.996429,24,280,1,279,1,1,0,1,1,124,123,156,156,12
"1135",34,"[24]HoIoHcowHnJHGqKCmnavFrIH",285,0.996503,24,286,1,285,1,1,0,1,1,153,152,133,133,12
"1136",35,"[24]HoIoHcowHnJHGqKCmnavFrIH",274,0.996364,24,275,1,274,1,1,0,1,1,119,118,156,156,12
"1137",36,"[24]HoIoHcowHnJHGqKCmnavFrIH",279,0.996429,24,280,1,279,1,1,0,1,1,137,136,143,143,12
"1138",37,"[24]HoIoHcowHnJHGqKCmnavFrIH",276,0.99639,24,277,1,276,1,1,0,1,1,137,136,140,140,12
"1139",38,"[24]HoIoHcowHnJHGqKCmnavFrIH",276,0.99639,24,277,1,276,1,1,0,1,1,135,134,142,142,12
"1140",39,"[24]HoIoHcowHnJHGqKCmnavFrIH",284,0.996491,24,285,1,284,1,1,0,1,1,144,143,141,141,12
"1141",40,"[24]HoIoHcowHnJHGqKCmnavFrIH",282,0.996466,24,283,1,282,1,1,0,1,1,161,160,122,122,12
"1142",41,"[24]HoIoHcowHnJHGqKCmnavFrIH",290,0.996564,24,291,1,290,1,1,0,1,1,156,155,135,135,12
"1143",42,"[24]HoIoHcowHnJHGqKCmnavFrIH",280,0.996441,24,281,1,280,1,1,0,1,1,134,133,147,147,12
"1144",43,"[24]HoIoHcowHnJHGqKCmnavFrIH",293,0.996599,24,294,1,293,1,1,0,1,1,158,157,136,136,12
"1145",44,"[24]HoIoHcowHnJHGqKCmnavFrIH",278,0.996416,24,279,1,278,1,1,0,1,1,148,147,131,131,12
"1146",45,"[24]HoIoHcowHnJHGqKCmnavFrIH",286,0.996516,24,287,1,286,1,1,0,1,1,161,160,126,126,12
"1147",46,"[24]HoIoHcowHnJHGqKCmnavFrIH",281,0.996454,24,282,1,281,1,1,0,1,1,145,144,137,137,12
"1148",47,"[24]HoIoHcowHnJHGqKCmnavFrIH",271,0.996324,24,272,1,271,1,1,0,1,1,143,142,129,129,12
"1149",48,"[24]HoIoHcowHnJHGqKCmnavFrIH",278,0.996416,24,279,1,278,1,1,0,1,1,139,138,140,140,12
"1150",49,"[24]HoIoHcowHnJHGqKCmnavFrIH",276,0.99639,24,277,1,276,1,1,0,1,1,123,122,154,154,12
"1151",50,"[24]HoIoHcowHnJHGqKCmnavFrIH",284,0.996491,24,285,1,284,1,1,0,1,1,154,153,131,131,12
"1152",51,"[24]HoIoHcowHnJHGqKCmnavFrIH",286,0.996516,24,287,1,286,1,1,0,1,1,136,135,151,151,12
"1153",52,"[24]HoIoHcowHnJHGqKCmnavFrIH",283,0.996479,24,284,1,283,1,1,0,1,1,139,138,145,145,12
"1154",53,"[24]HoIoHcowHnJHGqKCmnavFrIH",287,0.996528,24,288,1,287,1,1,0,1,1,149,148,139,139,12
"1155",54,"[24]HoIoHcowHnJHGqKCmnavFrIH",274,0.996364,24,275,1,274,1,1,0,1,1,136,135,139,139,12
"1156",55,"[24]HoIoHcowHnJHGqKCmnavFrIH",282,0.996466,24,283,1,282,1,1,0,1,1,149,148,134,134,12
"1157",56,"[24]HoIoHcowHnJHGqKCmnavFrIH",290,0.996564,24,291,1,290,1,1,0,1,1,146,145,145,145,12
"1158",57,"[24]HoIoHcowHnJHGqKCmnavFrIH",283,0.996479,24,284,1,283,1,1,0,1,1,137,136,147,147,12
"1159",58,"[24]HoIoHcowHnJHGqKCmnavFrIH",285,0.996503,24,286,1,285,1,1,0,1,1,145,144,141,141,12
"1160",59,"[24]HoIoHcowHnJHGqKCmnavFrIH",284,0.996491,24,285,1,284,1,1,0,1,1,153,152,132,132,12
"1161",60,"[24]HoIoHcowHnJHGqKCmnavFrIH",287,0.996528,24,288,1,287,1,1,0,1,1,146,145,142,142,12
"1162",61,"[24]HoIoHcowHnJHGqKCmnavFrIH",278,0.996416,24,279,1,278,1,1,0,1,1,135,134,144,144,12
"1163",62,"[24]HoIoHcowHnJHGqKCmnavFrIH",276,0.99639,24,277,1,276,1,1,0,1,1,130,129,147,147,12
"1164",63,"[24]HoIoHcowHnJHGqKCmnavFrIH",282,0.996466,24,283,1,282,1,1,0,1,1,147,146,136,136,12
"1165",64,"[24]HoIoHcowHnJHGqKCmnavFrIH",278,0.996416,24,279,1,278,1,1,0,1,1,144,143,135,135,12
"1166",65,"[24]HoIoHcowHnJHGqKCmnavFrIH",280,0.996441,24,281,1,280,1,1,0,1,1,142,141,139,139,12
"1167",66,"[24]HoIoHcowHnJHGqKCmnavFrIH",282,0.996466,24,283,1,282,1,1,0,1,1,152,151,131,131,12
"1168",67,"[24]HoIoHcowHnJHGqKCmnavFrIH",284,0.996491,24,285,1,284,1,1,0,1,1,142,141,143,143,12
"1169",68,"[24]HoIoHcowHnJHGqKCmnavFrIH",289,0.996552,24,290,1,289,1,1,0,1,1,159,158,131,131,12
"1170",69,"[24]HoIoHcowHnJHGqKCmnavFrIH",290,0.996564,24,291,1,290,1,1,0,1,1,151,150,140,140,12
"1171",70,"[24]HoIoHcowHnJHGqKCmnavFrIH",272,0.996337,24,273,1,272,1,1,0,1,1,125,124,148,148,12
"1172",71,"[24]HoIoHcowHnJHGqKCmnavFrIH",277,0.996403,24,278,1,277,1,1,0,1,1,143,142,135,135,12
"1173",72,"[24]HoIoHcowHnJHGqKCmnavFrIH",279,0.996429,24,280,1,279,1,1,0,1,1,135,134,145,145,12
"1174",73,"[24]HoIoHcowHnJHGqKCmnavFrIH",280,0.996441,24,281,1,280,1,1,0,1,1,132,131,149,149,12
"1175",74,"[24]HoIoHcowHnJHGqKCmnavFrIH",276,0.99639,24,277,1,276,1,1,0,1,1,131,130,146,146,12
"1176",75,"[24]HoIoHcowHnJHGqKCmnavFrIH",284,0.996491,24,285,1,284,1,1,0,1,1,149,148,136,136,12
"1177",76,"[24]HoIoHcowHnJHGqKCmnavFrIH",274,0.996364,24,275,1,274,1,1,0,1,1,134,133,141,141,12
"1178",77,"[24]HoIoHcowHnJHGqKCmnavFrIH",281,0.996454,24,282,1,281,1,1,0,1,1,140,139,142,142,12
"1179",78,"[24]HoIoHcowHnJHGqKCmnavFrIH",280,0.996441,24,281,1,280,1,1,0,1,1,148,147,133,133,12
"1180",79,"[24]HoIoHcowHnJHGqKCmnavFrIH",287,0.996528,24,288,1,287,1,1,0,1,1,142,141,146,146,12
"1181",80,"[24]HoIoHcowHnJHGqKCmnavFrIH",282,0.996466,24,283,1,282,1,1,0,1,1,151,150,132,132,12
"1182",81,"[24]HoIoHcowHnJHGqKCmnavFrIH",276,0.99639,24,277,1,276,1,1,0,1,1,138,137,139,139,12
"1183",82,"[24]HoIoHcowHnJHGqKCmnavFrIH",283,0.996479,24,284,1,283,1,1,0,1,1,143,142,141,141,12
"1184",83,"[24]HoIoHcowHnJHGqKCmnavFrIH",290,0.996564,24,291,1,290,1,1,0,1,1,145,144,146,146,12
"1185",84,"[24]HoIoHcowHnJHGqKCmnavFrIH",283,0.996479,24,284,1,283,1,1,0,1,1,154,153,130,130,12
"1186",85,"[24]HoIoHcowHnJHGqKCmnavFrIH",281,0.996454,24,282,1,281,1,1,0,1,1,144,143,138,138,12
"1187",86,"[24]HoIoHcowHnJHGqKCmnavFrIH",277,0.996403,24,278,1,277,1,1,0,1,1,126,125,152,152,12
"1188",87,"[24]HoIoHcowHnJHGqKCmnavFrIH",277,0.996403,24,278,1,277,1,1,0,1,1,144,143,134,134,12
"1189",88,"[24]HoIoHcowHnJHGqKCmnavFrIH",277,0.996403,24,278,1,277,1,1,0,1,1,144,143,134,134,12
"1190",89,"[24]HoIoHcowHnJHGqKCmnavFrIH",281,0.996454,24,282,1,281,1,1,0,1,1,144,143,138,138,12
"1191",90,"[24]HoIoHcowHnJHGqKCmnavFrIH",284,0.996491,24,285,1,284,1,1,0,1,1,148,147,137,137,12
"1192",91,"[24]HoIoHcowHnJHGqKCmnavFrIH",281,0.996454,24,282,1,281,1,1,0,1,1,154,153,128,128,12
"1193",92,"[24]HoIoHcowHnJHGqKCmnavFrIH",287,0.996528,24,288,1,287,1,1,0,1,1,152,151,136,136,12
"1194",93,"[24]HoIoHcowHnJHGqKCmnavFrIH",280,0.996441,24,281,1,280,1,1,0,1,1,138,137,143,143,12
"1195",94,"[24]HoIoHcowHnJHGqKCmnavFrIH",295,0.996622,24,296,1,295,1,1,0,1,1,153,152,143,143,12
"1196",95,"[24]HoIoHcowHnJHGqKCmnavFrIH",287,0.996528,24,288,1,287,1,1,0,1,1,165,164,123,123,12
"1197",96,"[24]HoIoHcowHnJHGqKCmnavFrIH",285,0.996503,24,286,1,285,1,1,0,1,1,154,153,132,132,12
"1198",97,"[24]HoIoHcowHnJHGqKCmnavFrIH",285,0.996503,24,286,1,285,1,1,0,1,1,136,135,150,150,12
"1199",98,"[24]HoIoHcowHnJHGqKCmnavFrIH",278,0.996416,24,279,1,278,1,1,0,1,1,140,139,139,139,12
"1200",99,"[24]HoIoHcowHnJHGqKCmnavFrIH",284,0.996491,24,285,1,284,1,1,0,1,1,148,147,137,137,12
"1201",0,"[22]HoIoHcouHnJHGqKCryuaoh",287,0.996528,22,288,1,287,1,1,0,1,1,143,142,145,145,13
"1202",1,"[22]HoIoHcouHnJHGqKCryuaoh",277,0.996403,22,278,1,277,1,1,0,1,1,145,144,133,133,13
"1203",2,"[22]HoIoHcouHnJHGqKCryuaoh",285,0.996503,22,286,1,285,1,1,0,1,1,138,137,148,148,13
"1204",3,"[22]HoIoHcouHnJHGqKCryuaoh",285,0.996503,22,286,1,285,1,1,0,1,1,141,140,145,145,13
"1205",4,"[22]HoIoHcouHnJHGqKCryuaoh",288,0.99654,22,289,1,288,1,1,0,1,1,146,145,143,143,13
"1206",5,"[22]HoIoHcouHnJHGqKCryuaoh",292,0.996587,22,293,1,292,1,1,0,1,1,156,155,137,137,13
"1207",6,"[22]HoIoHcouHnJHGqKCryuaoh",283,0.996479,22,284,1,283,1,1,0,1,1,146,145,138,138,13
"1208",7,"[22]HoIoHcouHnJHGqKCryuaoh",281,0.996454,22,282,1,281,1,1,0,1,1,135,134,147,147,13
"1209",8,"[22]HoIoHcouHnJHGqKCryuaoh",279,0.996429,22,280,1,279,1,1,0,1,1,143,142,137,137,13
"1210",9,"[22]HoIoHcouHnJHGqKCryuaoh",276,0.99639,22,277,1,276,1,1,0,1,1,132,131,145,145,13
"1211",10,"[22]HoIoHcouHnJHGqKCryuaoh",281,0.996454,22,282,1,281,1,1,0,1,1,137,136,145,145,13
"1212",11,"[22]HoIoHcouHnJHGqKCryuaoh",280,0.996441,22,281,1,280,1,1,0,1,1,140,139,141,141,13
"1213",12,"[22]HoIoHcouHnJHGqKCryuaoh",280,0.996441,22,281,1,280,1,1,0,1,1,154,153,127,127,13
"1214",13,"[22]HoIoHcouHnJHGqKCryuaoh",282,0.996466,22,283,1,282,1,1,0,1,1,137,136,146,146,13
"1215",14,"[22]HoIoHcouHnJHGqKCryuaoh",282,0.996466,22,283,1,282,1,1,0,1,1,130,129,153,153,13
"1216",15,"[22]HoIoHcouHnJHGqKCryuaoh",282,0.996466,22,283,1,282,1,1,0,1,1,135,134,148,148,13
"1217",16,"[22]HoIoHcouHnJHGqKCryuaoh",281,0.996454,22,282,1,281,1,1,0,1,1,131,130,151,151,13
"1218",17,"[22]HoIoHcouHnJHGqKCryuaoh",273,0.99635,22,274,1,273,1,1,0,1,1,137,136,137,137,13
"1219",18,"[22]HoIoHcouHnJHGqKCryuaoh",282,0.996466,22,283,1,282,1,1,0,1,1,153,152,130,130,13
"1220",19,"[22]HoIoHcouHnJHGqKCryuaoh",278,0.996416,22,279,1,278,1,1,0,1,1,124,123,155,155,13
"1221",20,"[22]HoIoHcouHnJHGqKCryuaoh",286,0.996516,22,287,1,286,1,1,0,1,1,142,141,145,145,13
"1222",21,"[22]HoIoHcouHnJHGqKCryuaoh",286,0.996516,22,287,1,286,1,1,0,1,1,138,137,149,149,13
"1223",22,"[22]HoIoHcouHnJHGqKCryuaoh",282,0.996466,22,283,1,282,1,1,0,1,1,135,134,148,148,13
"1224",23,"[22]HoIoHcouHnJHGqKCryuaoh",283,0.996479,22,284,1,283,1,1,0,1,1,157,156,127,127,13
"1225",24,"[22]HoIoHcouHnJHGqKCryuaoh",278,0.996416,22,279,1,278,1,1,0,1,1,132,131,147,147,13
"1226",25,"[22]HoIoHcouHnJHGqKCryuaoh",279,0.996429,22,280,1,279,1,1,0,1,1,132,131,148,148,13
"1227",26,"[22]HoIoHcouHnJHGqKCryuaoh",279,0.996429,22,280,1,279,1,1,0,1,1,128,127,152,152,13
"1228",27,"[22]HoIoHcouHnJHGqKCryuaoh",281,0.996454,22,282,1,281,1,1,0,1,1,139,138,143,143,13
"1229",28,"[22]HoIoHcouHnJHGqKCryuaoh",282,0.996466,22,283,1,282,1,1,0,1,1,149,148,134,134,13
"1230",29,"[22]HoIoHcouHnJHGqKCryuaoh",283,0.996479,22,284,1,283,1,1,0,1,1,142,141,142,142,13
"1231",30,"[22]HoIoHcouHnJHGqKCryuaoh",275,0.996377,22,276,1,275,1,1,0,1,1,133,132,143,143,13
"1232",31,"[22]HoIoHcouHnJHGqKCryuaoh",290,0.996564,22,291,1,290,1,1,0,1,1,152,151,139,139,13
"1233",32,"[22]HoIoHcouHnJHGqKCryuaoh",286,0.996516,22,287,1,286,1,1,0,1,1,147,146,140,140,13
"1234",33,"[22]HoIoHcouHnJHGqKCryuaoh",281,0.996454,22,282,1,281,1,1,0,1,1,143,142,139,139,13
"1235",34,"[22]HoIoHcouHnJHGqKCryuaoh",285,0.996503,22,286,1,285,1,1,0,1,1,145,144,141,141,13
"1236",35,"[22]HoIoHcouHnJHGqKCryuaoh",283,0.996479,22,284,1,283,1,1,0,1,1,156,155,128,128,13
"1237",36,"[22]HoIoHcouHnJHGqKCryuaoh",275,0.996377,22,276,1,275,1,1,0,1,1,129,128,147,147,13
"1238",37,"[22]HoIoHcouHnJHGqKCryuaoh",274,0.996364,22,275,1,274,1,1,0,1,1,140,139,135,135,13
"1239",38,"[22]HoIoHcouHnJHGqKCryuaoh",281,0.996454,22,282,1,281,1,1,0,1,1,141,140,141,141,13
"1240",39,"[22]HoIoHcouHnJHGqKCryuaoh",290,0.996564,22,291,1,290,1,1,0,1,1,144,143,147,147,13
"1241",40,"[22]HoIoHcouHnJHGqKCryuaoh",278,0.996416,22,279,1,278,1,1,0,1,1,134,133,145,145,13
"1242",41,"[22]HoIoHcouHnJHGqKCryuaoh",287,0.996528,22,288,1,287,1,1,0,1,1,148,147,140,140,13
"1243",42,"[22]HoIoHcouHnJHGqKCryuaoh",279,0.996429,22,280,1,279,1,1,0,1,1,136,135,144,144,13
"1244",43,"[22]HoIoHcouHnJHGqKCryuaoh",279,0.996429,22,280,1,279,1,1,0,1,1,137,136,143,143,13
"1245",44,"[22]HoIoHcouHnJHGqKCryuaoh",287,0.996528,22,288,1,287,1,1,0,1,1,156,155,132,132,13
"1246",45,"[22]HoIoHcouHnJHGqKCryuaoh",278,0.996416,22,279,1,278,1,1,0,1,1,146,145,133,133,13
"1247",46,"[22]HoIoHcouHnJHGqKCryuaoh",278,0.996416,22,279,1,278,1,1,0,1,1,144,143,135,135,13
"1248",47,"[22]HoIoHcouHnJHGqKCryuaoh",279,0.996429,22,280,1,279,1,1,0,1,1,134,133,146,146,13
"1249",48,"[22]HoIoHcouHnJHGqKCryuaoh",282,0.996466,22,283,1,282,1,1,0,1,1,154,153,129,129,13
"1250",49,"[22]HoIoHcouHnJHGqKCryuaoh",281,0.996454,22,282,1,281,1,1,0,1,1,140,139,142,142,13
"1251",50,"[22]HoIoHcouHnJHGqKCryuaoh",280,0.996441,22,281,1,280,1,1,0,1,1,149,148,132,132,13
"1252",51,"[22]HoIoHcouHnJHGqKCryuaoh",284,0.996491,22,285,1,284,1,1,0,1,1,150,149,135,135,13
"1253",52,"[22]HoIoHcouHnJHGqKCryuaoh",283,0.996479,22,284,1,283,1,1,0,1,1,131,130,153,153,13
"1254",53,"[22]HoIoHcouHnJHGqKCryuaoh",280,0.996441,22,281,1,280,1,1,0,1,1,135,134,146,146,13
"1255",54,"[22]HoIoHcouHnJHGqKCryuaoh",280,0.996441,22,281,1,280,1,1,0,1,1,141,140,140,140,13
"1256",55,"[22]HoIoHcouHnJHGqKCryuaoh",283,0.996479,22,284,1,283,1,1,0,1,1,143,142,141,141,13
"1257",56,"[22]HoIoHcouHnJHGqKCryuaoh",278,0.996416,22,279,1,278,1,1,0,1,1,127,126,152,152,13
"1258",57,"[22]HoIoHcouHnJHGqKCryuaoh",282,0.996466,22,283,1,282,1,1,0,1,1,142,141,141,141,13
"1259",58,"[22]HoIoHcouHnJHGqKCryuaoh",282,0.996466,22,283,1,282,1,1,0,1,1,145,144,138,138,13
"1260",59,"[22]HoIoHcouHnJHGqKCryuaoh",274,0.996364,22,275,1,274,1,1,0,1,1,133,132,142,142,13
"1261",60,"[22]HoIoHcouHnJHGqKCryuaoh",283,0.996479,22,284,1,283,1,1,0,1,1,140,139,144,144,13
"1262",61,"[22]HoIoHcouHnJHGqKCryuaoh",278,0.996416,22,279,1,278,1,1,0,1,1,142,141,137,137,13
"1263",62,"[22]HoIoHcouHnJHGqKCryuaoh",284,0.996491,22,285,1,284,1,1,0,1,1,140,139,145,145,13
"1264",63,"[22]HoIoHcouHnJHGqKCryuaoh",284,0.996491,22,285,1,284,1,1,0,1,1,148,147,137,137,13
"1265",64,"[22]HoIoHcouHnJHGqKCryuaoh",278,0.996416,22,279,1,278,1,1,0,1,1,135,134,144,144,13
"1266",65,"[22]HoIoHcouHnJHGqKCryuaoh",282,0.996466,22,283,1,282,1,1,0,1,1,135,134,148,148,13
"1267",66,"[22]HoIoHcouHnJHGqKCryuaoh",281,0.996454,22,282,1,281,1,1,0,1,1,142,141,140,140,13
"1268",67,"[22]HoIoHcouHnJHGqKCryuaoh",282,0.996466,22,283,1,282,1,1,0,1,1,137,136,146,146,13
"1269",68,"[22]HoIoHcouHnJHGqKCryuaoh",284,0.996491,22,285,1,284,1,1,0,1,1,148,147,137,137,13
"1270",69,"[22]HoIoHcouHnJHGqKCryuaoh",288,0.99654,22,289,1,288,1,1,0,1,1,154,153,135,135,13
"1271",70,"[22]HoIoHcouHnJHGqKCryuaoh",279,0.996429,22,280,1,279,1,1,0,1,1,140,139,140,140,13
"1272",71,"[22]HoIoHcouHnJHGqKCryuaoh",279,0.996429,22,280,1,279,1,1,0,1,1,141,140,139,139,13
"1273",72,"[22]HoIoHcouHnJHGqKCryuaoh",275,0.996377,22,276,1,275,1,1,0,1,1,139,138,137,137,13
"1274",73,"[22]HoIoHcouHnJHGqKCryuaoh",280,0.996441,22,281,1,280,1,1,0,1,1,131,130,150,150,13
"1275",74,"[22]HoIoHcouHnJHGqKCryuaoh",287,0.996528,22,288,1,287,1,1,0,1,1,152,151,136,136,13
"1276",75,"[22]HoIoHcouHnJHGqKCryuaoh",278,0.996416,22,279,1,278,1,1,0,1,1,136,135,143,143,13
"1277",76,"[22]HoIoHcouHnJHGqKCryuaoh",284,0.996491,22,285,1,284,1,1,0,1,1,149,148,136,136,13
"1278",77,"[22]HoIoHcouHnJHGqKCryuaoh",275,0.996377,22,276,1,275,1,1,0,1,1,132,131,144,144,13
"1279",78,"[22]HoIoHcouHnJHGqKCryuaoh",283,0.996479,22,284,1,283,1,1,0,1,1,142,141,142,142,13
"1280",79,"[22]HoIoHcouHnJHGqKCryuaoh",279,0.996429,22,280,1,279,1,1,0,1,1,135,134,145,145,13
"1281",80,"[22]HoIoHcouHnJHGqKCryuaoh",285,0.996503,22,286,1,285,1,1,0,1,1,142,141,144,144,13
"1282",81,"[22]HoIoHcouHnJHGqKCryuaoh",281,0.996454,22,282,1,281,1,1,0,1,1,146,145,136,136,13
"1283",82,"[22]HoIoHcouHnJHGqKCryuaoh",285,0.996503,22,286,1,285,1,1,0,1,1,154,153,132,132,13
"1284",83,"[22]HoIoHcouHnJHGqKCryuaoh",274,0.996364,22,275,1,274,1,1,0,1,1,137,136,138,138,13
"1285",84,"[22]HoIoHcouHnJHGqKCryuaoh",281,0.996454,22,282,1,281,1,1,0,1,1,138,137,144,144,13
"1286",85,"[22]HoIoHcouHnJHGqKCryuaoh",280,0.996441,22,281,1,280,1,1,0,1,1,139,138,142,142,13
"1287",86,"[22]HoIoHcouHnJHGqKCryuaoh",283,0.996479,22,284,1,283,1,1,0,1,1,161,160,123,123,13
"1288",87,"[22]HoIoHcouHnJHGqKCryuaoh",292,0.996587,22,293,1,292,1,1,0,1,1,144,143,149,149,13
"1289",88,"[22]HoIoHcouHnJHGqKCryuaoh",285,0.996503,22,286,1,285,1,1,0,1,1,131,130,155,155,13
"1290",89,"[22]HoIoHcouHnJHGqKCryuaoh",291,0.996575,22,292,1,291,1,1,0,1,1,165,164,127,127,13
"1291",90,"[22]HoIoHcouHnJHGqKCryuaoh",283,0.996479,22,284,1,283,1,1,0,1,1,162,161,122,122,13
"1292",91,"[22]HoIoHcouHnJHGqKCryuaoh",281,0.996454,22,282,1,281,1,1,0,1,1,142,141,140,140,13
"1293",92,"[22]HoIoHcouHnJHGqKCryuaoh",286,0.996516,22,287,1,286,1,1,0,1,1,156,155,131,131,13
"1294",93,"[22]HoIoHcouHnJHGqKCryuaoh",275,0.996377,22,276,1,275,1,1,0,1,1,125,124,151,151,13
"1295",94,"[22]HoIoHcouHnJHGqKCryuaoh",282,0.996466,22,283,1,282,1,1,0,1,1,142,141,141,141,13
"1296",95,"[22]HoIoHcouHnJHGqKCryuaoh",287,0.996528,22,288,1,287,1,1,0,1,1,146,145,142,142,13
"1297",96,"[22]HoIoHcouHnJHGqKCryuaoh",290,0.996564,22,291,1,290,1,1,0,1,1,158,157,133,133,13
"1298",97,"[22]HoIoHcouHnJHGqKCryuaoh",279,0.996429,22,280,1,279,1,1,0,1,1,143,142,137,137,13
"1299",98,"[22]HoIoHcouHnJHGqKCryuaoh",281,0.996454,22,282,1,281,1,1,0,1,1,143,142,139,139,13
"1300",99,"[22]HoIoHcouHnJHGqKCryuaoh",279,0.996429,22,280,1,279,1,1,0,1,1,141,140,139,139,13
"1301",0,"[26]JHoIoHcoxHnJHGqKCnArxCKjhd",290,0.996564,26,291,1,290,1,1,0,1,1,162,161,129,129,14
"1302",1,"[26]JHoIoHcoxHnJHGqKCnArxCKjhd",281,0.996454,26,282,1,281,1,1,0,1,1,150,149,132,132,14
"1303",2,"[26]JHoIoHcoxHnJHGqKCnArxCKjhd",282,0.996466,26,283,1,282,1,1,0,1,1,128,127,155,155,14
"1304",3,"[26]JHoIoHcoxHnJHGqKCnArxCKjhd",289,0.996552,26,290,1,289,1,1,0,1,1,144,143,146,146,14
"1305",4,"[26]JHoIoHcoxHnJHGqKCnArxCKjhd",295,0.996622,26,296,1,295,1,1,0,1,1,152,151,144,144,14
"1306",5,"[26]JHoIoHcoxHnJHGqKCnArxCKjhd",283,0.996479,26,284,1,283,1,1,0,1,1,141,140,143,143,14
"1307",6,"[26]JHoIoHcoxHnJHGqKCnArxCKjhd",286,0.996516,26,287,1,286,1,1,0,1,1,139,138,148,148,14
"1308",7,"[26]JHoIoHcoxHnJHGqKCnArxCKjhd",278,0.996416,26,279,1,278,1,1,0,1,1,144,143,135,135,14
"1309",8,"[26]JHoIoHcoxHnJHGqKCnArxCKjhd",285,0.996503,26,286,1,285,1,1,0,1,1,146,145,140,140,14
"1310",9,"[26]JHoIoHcoxHnJHGqKCnArxCKjhd",283,0.996479,26,284,1,283,1,1,0,1,1,140,139,144,144,14
"1311",10,"[26]JHoIoHcoxHnJHGqKCnArxCKjhd",283,0.996479,26,284,1,283,1,1,0,1,1,147,146,137,137,14
"1312",11,"[26]JHoIoHcoxHnJHGqKCnArxCKjhd",271,0.996324,26,272,1,271,1,1,0,1,1,124,123,148,148,14
"1313",12,"[26]JHoIoHcoxHnJHGqKCnArxCKjhd",281,0.996454,26,282,1,281,1,1,0,1,1,163,162,119,119,14
"1314",13,"[26]JHoIoHcoxHnJHGqKCnArxCKjhd",279,0.996429,26,280,1,279,1,1,0,1,1,144,143,136,136,14
"1315",14,"[26]JHoIoHcoxHnJHGqKCnArxCKjhd",285,0.996503,26,286,1,285,1,1,0,1,1,153,152,133,133,14
"1316",15,"[26]JHoIoHcoxHnJHGqKCnArxCKjhd",275,0.996377,26,276,1,275,1,1,0,1,1,133,132,143,143,14
"1317",16,"[26]JHoIoHcoxHnJHGqKCnArxCKjhd",274,0.996364,26,275,1,274,1,1,0,1,1,140,139,135,135,14
"1318",17,"[26]JHoIoHcoxHnJHGqKCnArxCKjhd",282,0.996466,26,283,1,282,1,1,0,1,1,141,140,142,142,14
"1319",18,"[26]JHoIoHcoxHnJHGqKCnArxCKjhd",286,0.996516,26,287,1,286,1,1,0,1,1,154,153,133,133,14
"1320",19,"[26]JHoIoHcoxHnJHGqKCnArxCKjhd",284,0.996491,26,285,1,284,1,1,0,1,1,147,146,138,138,14
"1321",20,"[26]JHoIoHcoxHnJHGqKCnArxCKjhd",286,0.996516,26,287,1,286,1,1,0,1,1,145,144,142,142,14
"1322",21,"[26]JHoIoHcoxHnJHGqKCnArxCKjhd",287,0.996528,26,288,1,287,1,1,0,1,1,167,166,121,121,14
"1323",22,"[26]JHoIoHcoxHnJHGqKCnArxCKjhd",285,0.996503,26,286,1,285,1,1,0,1,1,142,141,144,144,14
"1324",23,"[26]JHoIoHcoxHnJHGqKCnArxCKjhd",285,0.996503,26,286,1,285,1,1,0,1,1,156,155,130,130,14
"1325",24,"[26]JHoIoHcoxHnJHGqKCnArxCKjhd",285,0.996503,26,286,1,285,1,1,0,1,1,159,158,127,127,14
"1326",25,"[26]JHoIoHcoxHnJHGqKCnArxCKjhd",280,0.996441,26,281,1,280,1,1,0,1,1,127,126,154,154,14
"1327",26,"[26]JHoIoHcoxHnJHGqKCnArxCKjhd",287,0.996528,26,288,1,287,1,1,0,1,1,155,154,133,133,14
"1328",27,"[26]JHoIoHcoxHnJHGqKCnArxCKjhd",287,0.996528,26,288,1,287,1,1,0,1,1,157,156,131,131,14
"1329",28,"[26]JHoIoHcoxHnJHGqKCnArxCKjhd",288,0.99654,26,289,1,288,1,1,0,1,1,153,152,136,136,14
"1330",29,"[26]JHoIoHcoxHnJHGqKCnArxCKjhd",274,0.996364,26,275,1,274,1,1,0,1,1,142,141,133,133,14
"1331",30,"[26]JHoIoHcoxHnJHGqKCnArxCKjhd",277,0.996403,26,278,1,277,1,1,0,1,1,133,132,145,145,14
"1332",31,"[26]JHoIoHcoxHnJHGqKCnArxCKjhd",281,0.996454,26,282,1,281,1,1,0,1,1,141,140,141,141,14
"1333",32,"[26]JHoIoHcoxHnJHGqKCnArxCKjhd",288,0.99654,26,289,1,288,1,1,0,1,1,148,147,141,141,14
"1334",33,"[26]JHoIoHcoxHnJHGqKCnArxCKjhd",289,0.996552,26,290,1,289,1,1,0,1,1,146,145,144,144,14
"1335",34,"[26]JHoIoHcoxHnJHGqKCnArxCKjhd",285,0.996503,26,286,1,285,1,1,0,1,1,148,147,138,138,14
"1336",35,"[26]JHoIoHcoxHnJHGqKCnArxCKjhd",276,0.99639,26,277,1,276,1,1,0,1,1,135,134,142,142,14
"1337",36,"[26]JHoIoHcoxHnJHGqKCnArxCKjhd",282,0.996466,26,283,1,282,1,1,0,1,1,135,134,148,148,14
"1338",37,"[26]JHoIoHcoxHnJHGqKCnArxCKjhd",282,0.996466,26,283,1,282,1,1,0,1,1,142,141,141,141,14
"1339",38,"[26]JHoIoHcoxHnJHGqKCnArxCKjhd",286,0.996516,26,287,1,286,1,1,0,1,1,134,133,153,153,14
"1340",39,"[26]JHoIoHcoxHnJHGqKCnArxCKjhd",283,0.996479,26,284,1,283,1,1,0,1,1,143,142,141,141,14
"1341",40,"[26]JHoIoHcoxHnJHGqKCnArxCKjhd",280,0.996441,26,281,1,280,1,1,0,1,1,129,128,152,152,14
"1342",41,"[26]JHoIoHcoxHnJHGqKCnArxCKjhd",280,0.996441,26,281,1,280,1,1,0,1,1,129,128,152,152,14
"1343",42,"[26]JHoIoHcoxHnJHGqKCnArxCKjhd",283,0.996479,26,284,1,283,1,1,0,1,1,160,159,124,124,14
"1344",43,"[26]JHoIoHcoxHnJHGqKCnArxCKjhd",280,0.996441,26,281,1,280,1,1,0,1,1,149,148,132,132,14
"1345",44,"[26]JHoIoHcoxHnJHGqKCnArxCKjhd",282,0.996466,26,283,1,282,1,1,0,1,1,131,130,152,152,14
"1346",45,"[26]JHoIoHcoxHnJHGqKCnArxCKjhd",269,0.996296,26,270,1,269,1,1,0,1,1,135,134,135,135,14
"1347",46,"[26]JHoIoHcoxHnJHGqKCnArxCKjhd",286,0.996516,26,287,1,286,1,1,0,1,1,145,144,142,142,14
"1348",47,"[26]JHoIoHcoxHnJHGqKCnArxCKjhd",288,0.99654,26,289,1,288,1,1,0,1,1,154,153,135,135,14
"1349",48,"[26]JHoIoHcoxHnJHGqKCnArxCKjhd",290,0.996564,26,291,1,290,1,1,0,1,1,149,148,142,142,14
"1350",49,"[26]JHoIoHcoxHnJHGqKCnArxCKjhd",280,0.996441,26,281,1,280,1,1,0,1,1,142,141,139,139,14
"1351",50,"[26]JHoIoHcoxHnJHGqKCnArxCKjhd",277,0.996403,26,278,1,277,1,1,0,1,1,126,125,152,152,14
"1352",51,"[26]JHoIoHcoxHnJHGqKCnArxCKjhd",278,0.996416,26,279,1,278,1,1,0,1,1,135,134,144,144,14
"1353",52,"[26]JHoIoHcoxHnJHGqKCnArxCKjhd",291,0.996575,26,292,1,291,1,1,0,1,1,140,139,152,152,14
"1354",53,"[26]JHoIoHcoxHnJHGqKCnArxCKjhd",281,0.996454,26,282,1,281,1,1,0,1,1,142,141,140,140,14
"1355",54,"[26]JHoIoHcoxHnJHGqKCnArxCKjhd",282,0.996466,26,283,1,282,1,1,0,1,1,140,139,143,143,14
"1356",55,"[26]JHoIoHcoxHnJHGqKCnArxCKjhd",286,0.996516,26,287,1,286,1,1,0,1,1,141,140,146,146,14
"1357",56,"[26]JHoIoHcoxHnJHGqKCnArxCKjhd",282,0.996466,26,283,1,282,1,1,0,1,1,145,144,138,138,14
"1358",57,"[26]JHoIoHcoxHnJHGqKCnArxCKjhd",279,0.996429,26,280,1,279,1,1,0,1,1,142,141,138,138,14
"1359",58,"[26]JHoIoHcoxHnJHGqKCnArxCKjhd",287,0.996528,26,288,1,287,1,1,0,1,1,134,133,154,154,14
"1360",59,"[26]JHoIoHcoxHnJHGqKCnArxCKjhd",286,0.996516,26,287,1,286,1,1,0,1,1,153,152,134,134,14
"1361",60,"[26]JHoIoHcoxHnJHGqKCnArxCKjhd",285,0.996503,26,286,1,285,1,1,0,1,1,136,135,150,150,14
"1362",61,"[26]JHoIoHcoxHnJHGqKCnArxCKjhd",284,0.996491,26,285,1,284,1,1,0,1,1,138,137,147,147,14
"1363",62,"[26]JHoIoHcoxHnJHGqKCnArxCKjhd",285,0.996503,26,286,1,285,1,1,0,1,1,153,152,133,133,14
"1364",63,"[26]JHoIoHcoxHnJHGqKCnArxCKjhd",283,0.996479,26,284,1,283,1,1,0,1,1,137,136,147,147,14
"1365",64,"[26]JHoIoHcoxHnJHGqKCnArxCKjhd",278,0.996416,26,279,1,278,1,1,0,1,1,132,131,147,147,14
"1366",65,"[26]JHoIoHcoxHnJHGqKCnArxCKjhd",283,0.996479,26,284,1,283,1,1,0,1,1,143,142,141,141,14
"1367",66,"[26]JHoIoHcoxHnJHGqKCnArxCKjhd",282,0.996466,26,283,1,282,1,1,0,1,1,133,132,150,150,14
"1368",67,"[26]JHoIoHcoxHnJHGqKCnArxCKjhd",287,0.996528,26,288,1,287,1,1,0,1,1,173,172,115,115,14
"1369",68,"[26]JHoIoHcoxHnJHGqKCnArxCKjhd",285,0.996503,26,286,1,285,1,1,0,1,1,143,142,143,143,14
"1370",69,"[26]JHoIoHcoxHnJHGqKCnArxCKjhd",280,0.996441,26,281,1,280,1,1,0,1,1,148,147,133,133,14
"1371",70,"[26]JHoIoHcoxHnJHGqKCnArxCKjhd",282,0.996466,26,283,1,282,1,1,0,1,1,170,169,113,113,14
"1372",71,"[26]JHoIoHcoxHnJHGqKCnArxCKjhd",283,0.996479,26,284,1,283,1,1,0,1,1,134,133,150,150,14
"1373",72,"[26]JHoIoHcoxHnJHGqKCnArxCKjhd",286,0.996516,26,287,1,286,1,1,0,1,1,156,155,131,131,14
"1374",73,"[26]JHoIoHcoxHnJHGqKCnArxCKjhd",283,0.996479,26,284,1,283,1,1,0,1,1,139,138,145,145,14
"1375",74,"[26]JHoIoHcoxHnJHGqKCnArxCKjhd",277,0.996403,26,278,1,277,1,1,0,1,1,136,135,142,142,14
"1376",75,"[26]JHoIoHcoxHnJHGqKCnArxCKjhd",281,0.996454,26,282,1,281,1,1,0,1,1,140,139,142,142,14
"1377",76,"[26]JHoIoHcoxHnJHGqKCnArxCKjhd",284,0.996491,26,285,1,284,1,1,0,1,1,149,148,136,136,14
"1378",77,"[26]JHoIoHcoxHnJHGqKCnArxCKjhd",285,0.996503,26,286,1,285,1,1,0,1,1,169,168,117,117,14
"1379",78,"[26]JHoIoHcoxHnJHGqKCnArxCKjhd",288,0.99654,26,289,1,288,1,1,0,1,1,140,139,149,149,14
"1380",79,"[26]JHoIoHcoxHnJHGqKCnArxCKjhd",284,0.996491,26,285,1,284,1,1,0,1,1,149,148,136,136,14
"1381",80,"[26]JHoIoHcoxHnJHGqKCnArxCKjhd",284,0.996491,26,285,1,284,1,1,0,1,1,140,139,145,145,14
"1382",81,"[26]JHoIoHcoxHnJHGqKCnArxCKjhd",281,0.996454,26,282,1,281,1,1,0,1,1,135,134,147,147,14
"1383",82,"[26]JHoIoHcoxHnJHGqKCnArxCKjhd",286,0.996516,26,287,1,286,1,1,0,1,1,151,150,136,136,14
"1384",83,"[26]JHoIoHcoxHnJHGqKCnArxCKjhd",286,0.996516,26,287,1,286,1,1,0,1,1,143,142,144,144,14
"1385",84,"[26]JHoIoHcoxHnJHGqKCnArxCKjhd",277,0.996403,26,278,1,277,1,1,0,1,1,110,109,168,168,14
"1386",85,"[26]JHoIoHcoxHnJHGqKCnArxCKjhd",280,0.996441,26,281,1,280,1,1,0,1,1,126,125,155,155,14
"1387",86,"[26]JHoIoHcoxHnJHGqKCnArxCKjhd",280,0.996441,26,281,1,280,1,1,0,1,1,147,146,134,134,14
"1388",87,"[26]JHoIoHcoxHnJHGqKCnArxCKjhd",281,0.996454,26,282,1,281,1,1,0,1,1,139,138,143,143,14
"1389",88,"[26]JHoIoHcoxHnJHGqKCnArxCKjhd",279,0.996429,26,280,1,279,1,1,0,1,1,138,137,142,142,14
"1390",89,"[26]JHoIoHcoxHnJHGqKCnArxCKjhd",289,0.996552,26,290,1,289,1,1,0,1,1,159,158,131,131,14
"1391",90,"[26]JHoIoHcoxHnJHGqKCnArxCKjhd",278,0.996416,26,279,1,278,1,1,0,1,1,130,129,149,149,14
"1392",91,"[26]JHoIoHcoxHnJHGqKCnArxCKjhd",287,0.996528,26,288,1,287,1,1,0,1,1,162,161,126,126,14
"1393",92,"[26]JHoIoHcoxHnJHGqKCnArxCKjhd",287,0.996528,26,288,1,287,1,1,0,1,1,135,134,153,153,14
"1394",93,"[26]JHoIoHcoxHnJHGqKCnArxCKjhd",274,0.996364,26,275,1,274,1,1,0,1,1,135,134,140,140,14
"1395",94,"[26]JHoIoHcoxHnJHGqKCnArxCKjhd",289,0.996552,26,290,1,289,1,1,0,1,1,161,160,129,129,14
"1396",95,"[26]JHoIoHcoxHnJHGqKCnArxCKjhd",285,0.996503,26,286,1,285,1,1,0,1,1,142,141,144,144,14
"1397",96,"[26]JHoIoHcoxHnJHGqKCnArxCKjhd",284,0.996491,26,285,1,284,1,1,0,1,1,159,158,126,126,14
"1398",97,"[26]JHoIoHcoxHnJHGqKCnArxCKjhd",283,0.996479,26,284,1,283,1,1,0,1,1,139,138,145,145,14
"1399",98,"[26]JHoIoHcoxHnJHGqKCnArxCKjhd",280,0.996441,26,281,1,280,1,1,0,1,1,139,138,142,142,14
"1400",99,"[26]JHoIoHcoxHnJHGqKCnArxCKjhd",279,0.996429,26,280,1,279,1,1,0,1,1,151,150,129,129,14
"1401",0,"[25]lHoIoHcotHnJHGqKCwetxqdwc",277,0.996403,25,278,1,277,1,1,0,1,1,148,147,130,130,16
"1402",1,"[25]lHoIoHcotHnJHGqKCwetxqdwc",297,0.996644,25,298,1,297,1,1,0,1,1,148,147,150,150,16
"1403",2,"[25]lHoIoHcotHnJHGqKCwetxqdwc",282,0.996466,25,283,1,282,1,1,0,1,1,135,134,148,148,16
"1404",3,"[25]lHoIoHcotHnJHGqKCwetxqdwc",281,0.996454,25,282,1,281,1,1,0,1,1,151,150,131,131,16
"1405",4,"[25]lHoIoHcotHnJHGqKCwetxqdwc",282,0.996466,25,283,1,282,1,1,0,1,1,133,132,150,150,16
"1406",5,"[25]lHoIoHcotHnJHGqKCwetxqdwc",286,0.996516,25,287,1,286,1,1,0,1,1,137,136,150,150,16
"1407",6,"[25]lHoIoHcotHnJHGqKCwetxqdwc",283,0.996479,25,284,1,283,1,1,0,1,1,146,145,138,138,16
"1408",7,"[25]lHoIoHcotHnJHGqKCwetxqdwc",272,0.996337,25,273,1,272,1,1,0,1,1,132,131,141,141,16
"1409",8,"[25]lHoIoHcotHnJHGqKCwetxqdwc",280,0.996441,25,281,1,280,1,1,0,1,1,131,130,150,150,16
"1410",9,"[25]lHoIoHcotHnJHGqKCwetxqdwc",287,0.996528,25,288,1,287,1,1,0,1,1,147,146,141,141,16
"1411",10,"[25]lHoIoHcotHnJHGqKCwetxqdwc",282,0.996466,25,283,1,282,1,1,0,1,1,134,133,149,149,16
"1412",11,"[25]lHoIoHcotHnJHGqKCwetxqdwc",279,0.996429,25,280,1,279,1,1,0,1,1,148,147,132,132,16
"1413",12,"[25]lHoIoHcotHnJHGqKCwetxqdwc",281,0.996454,25,282,1,281,1,1,0,1,1,149,148,133,133,16
"1414",13,"[25]lHoIoHcotHnJHGqKCwetxqdwc",280,0.996441,25,281,1,280,1,1,0,1,1,139,138,142,142,16
"1415",14,"[25]lHoIoHcotHnJHGqKCwetxqdwc",279,0.996429,25,280,1,279,1,1,0,1,1,131,130,149,149,16
"1416",15,"[25]lHoIoHcotHnJHGqKCwetxqdwc",276,0.99639,25,277,1,276,1,1,0,1,1,148,147,129,129,16
"1417",16,"[25]lHoIoHcotHnJHGqKCwetxqdwc",283,0.996479,25,284,1,283,1,1,0,1,1,153,152,131,131,16
"1418",17,"[25]lHoIoHcotHnJHGqKCwetxqdwc",285,0.996503,25,286,1,285,1,1,0,1,1,148,147,138,138,16
"1419",18,"[25]lHoIoHcotHnJHGqKCwetxqdwc",268,0.996283,25,269,1,268,1,1,0,1,1,140,139,129,129,16
"1420",19,"[25]lHoIoHcotHnJHGqKCwetxqdwc",283,0.996479,25,284,1,283,1,1,0,1,1,149,148,135,135,16
"1421",20,"[25]lHoIoHcotHnJHGqKCwetxqdwc",282,0.996466,25,283,1,282,1,1,0,1,1,143,142,140,140,16
"1422",21,"[25]lHoIoHcotHnJHGqKCwetxqdwc",282,0.996466,25,283,1,282,1,1,0,1,1,132,131,151,151,16
"1423",22,"[25]lHoIoHcotHnJHGqKCwetxqdwc",285,0.996503,25,286,1,285,1,1,0,1,1,147,146,139,139,16
"1424",23,"[25]lHoIoHcotHnJHGqKCwetxqdwc",280,0.996441,25,281,1,280,1,1,0,1,1,146,145,135,135,16
"1425",24,"[25]lHoIoHcotHnJHGqKCwetxqdwc",285,0.996503,25,286,1,285,1,1,0,1,1,155,154,131,131,16
"1426",25,"[25]lHoIoHcotHnJHGqKCwetxqdwc",270,0.99631,25,271,1,270,1,1,0,1,1,135,134,136,136,16
"1427",26,"[25]lHoIoHcotHnJHGqKCwetxqdwc",284,0.996491,25,285,1,284,1,1,0,1,1,125,124,160,160,16
"1428",27,"[25]lHoIoHcotHnJHGqKCwetxqdwc",283,0.996479,25,284,1,283,1,1,0,1,1,140,139,144,144,16
"1429",28,"[25]lHoIoHcotHnJHGqKCwetxqdwc",283,0.996479,25,284,1,283,1,1,0,1,1,125,124,159,159,16
"1430",29,"[25]lHoIoHcotHnJHGqKCwetxqdwc",281,0.996454,25,282,1,281,1,1,0,1,1,143,142,139,139,16
"1431",30,"[25]lHoIoHcotHnJHGqKCwetxqdwc",284,0.996491,25,285,1,284,1,1,0,1,1,151,150,134,134,16
"1432",31,"[25]lHoIoHcotHnJHGqKCwetxqdwc",277,0.996403,25,278,1,277,1,1,0,1,1,126,125,152,152,16
"1433",32,"[25]lHoIoHcotHnJHGqKCwetxqdwc",279,0.996429,25,280,1,279,1,1,0,1,1,150,149,130,130,16
"1434",33,"[25]lHoIoHcotHnJHGqKCwetxqdwc",284,0.996491,25,285,1,284,1,1,0,1,1,132,131,153,153,16
"1435",34,"[25]lHoIoHcotHnJHGqKCwetxqdwc",288,0.99654,25,289,1,288,1,1,0,1,1,157,156,132,132,16
"1436",35,"[25]lHoIoHcotHnJHGqKCwetxqdwc",282,0.996466,25,283,1,282,1,1,0,1,1,132,131,151,151,16
"1437",36,"[25]lHoIoHcotHnJHGqKCwetxqdwc",282,0.996466,25,283,1,282,1,1,0,1,1,121,120,162,162,16
"1438",37,"[25]lHoIoHcotHnJHGqKCwetxqdwc",278,0.996416,25,279,1,278,1,1,0,1,1,134,133,145,145,16
"1439",38,"[25]lHoIoHcotHnJHGqKCwetxqdwc",281,0.996454,25,282,1,281,1,1,0,1,1,144,143,138,138,16
"1440",39,"[25]lHoIoHcotHnJHGqKCwetxqdwc",287,0.996528,25,288,1,287,1,1,0,1,1,145,144,143,143,16
"1441",40,"[25]lHoIoHcotHnJHGqKCwetxqdwc",279,0.996429,25,280,1,279,1,1,0,1,1,136,135,144,144,16
"1442",41,"[25]lHoIoHcotHnJHGqKCwetxqdwc",274,0.996364,25,275,1,274,1,1,0,1,1,142,141,133,133,16
"1443",42,"[25]lHoIoHcotHnJHGqKCwetxqdwc",281,0.996454,25,282,1,281,1,1,0,1,1,138,137,144,144,16
"1444",43,"[25]lHoIoHcotHnJHGqKCwetxqdwc",277,0.996403,25,278,1,277,1,1,0,1,1,143,142,135,135,16
"1445",44,"[25]lHoIoHcotHnJHGqKCwetxqdwc",283,0.996479,25,284,1,283,1,1,0,1,1,128,127,156,156,16
"1446",45,"[25]lHoIoHcotHnJHGqKCwetxqdwc",286,0.996516,25,287,1,286,1,1,0,1,1,142,141,145,145,16
"1447",46,"[25]lHoIoHcotHnJHGqKCwetxqdwc",283,0.996479,25,284,1,283,1,1,0,1,1,145,144,139,139,16
"1448",47,"[25]lHoIoHcotHnJHGqKCwetxqdwc",274,0.996364,25,275,1,274,1,1,0,1,1,126,125,149,149,16
"1449",48,"[25]lHoIoHcotHnJHGqKCwetxqdwc",275,0.996377,25,276,1,275,1,1,0,1,1,152,151,124,124,16
"1450",49,"[25]lHoIoHcotHnJHGqKCwetxqdwc",279,0.996429,25,280,1,279,1,1,0,1,1,143,142,137,137,16
"1451",50,"[25]lHoIoHcotHnJHGqKCwetxqdwc",274,0.996364,25,275,1,274,1,1,0,1,1,127,126,148,148,16
"1452",51,"[25]lHoIoHcotHnJHGqKCwetxqdwc",281,0.996454,25,282,1,281,1,1,0,1,1,145,144,137,137,16
"1453",52,"[25]lHoIoHcotHnJHGqKCwetxqdwc",272,0.996337,25,273,1,272,1,1,0,1,1,144,143,129,129,16
"1454",53,"[25]lHoIoHcotHnJHGqKCwetxqdwc",288,0.99654,25,289,1,288,1,1,0,1,1,163,162,126,126,16
"1455",54,"[25]lHoIoHcotHnJHGqKCwetxqdwc",277,0.996403,25,278,1,277,1,1,0,1,1,132,131,146,146,16
"1456",55,"[25]lHoIoHcotHnJHGqKCwetxqdwc",285,0.996503,25,286,1,285,1,1,0,1,1,137,136,149,149,16
"1457",56,"[25]lHoIoHcotHnJHGqKCwetxqdwc",283,0.996479,25,284,1,283,1,1,0,1,1,140,139,144,144,16
"1458",57,"[25]lHoIoHcotHnJHGqKCwetxqdwc",283,0.996479,25,284,1,283,1,1,0,1,1,150,149,134,134,16
"1459",58,"[25]lHoIoHcotHnJHGqKCwetxqdwc",284,0.996491,25,285,1,284,1,1,0,1,1,147,146,138,138,16
"1460",59,"[25]lHoIoHcotHnJHGqKCwetxqdwc",281,0.996454,25,282,1,281,1,1,0,1,1,152,151,130,130,16
"1461",60,"[25]lHoIoHcotHnJHGqKCwetxqdwc",286,0.996516,25,287,1,286,1,1,0,1,1,150,149,137,137,16
"1462",61,"[25]lHoIoHcotHnJHGqKCwetxqdwc",282,0.996466,25,283,1,282,1,1,0,1,1,148,147,135,135,16
"1463",62,"[25]lHoIoHcotHnJHGqKCwetxqdwc",283,0.996479,25,284,1,283,1,1,0,1,1,155,154,129,129,16
"1464",63,"[25]lHoIoHcotHnJHGqKCwetxqdwc",288,0.99654,25,289,1,288,1,1,0,1,1,144,143,145,145,16
"1465",64,"[25]lHoIoHcotHnJHGqKCwetxqdwc",280,0.996441,25,281,1,280,1,1,0,1,1,148,147,133,133,16
"1466",65,"[25]lHoIoHcotHnJHGqKCwetxqdwc",284,0.996491,25,285,1,284,1,1,0,1,1,148,147,137,137,16
"1467",66,"[25]lHoIoHcotHnJHGqKCwetxqdwc",283,0.996479,25,284,1,283,1,1,0,1,1,140,139,144,144,16
"1468",67,"[25]lHoIoHcotHnJHGqKCwetxqdwc",287,0.996528,25,288,1,287,1,1,0,1,1,143,142,145,145,16
"1469",68,"[25]lHoIoHcotHnJHGqKCwetxqdwc",279,0.996429,25,280,1,279,1,1,0,1,1,145,144,135,135,16
"1470",69,"[25]lHoIoHcotHnJHGqKCwetxqdwc",280,0.996441,25,281,1,280,1,1,0,1,1,143,142,138,138,16
"1471",70,"[25]lHoIoHcotHnJHGqKCwetxqdwc",291,0.996575,25,292,1,291,1,1,0,1,1,149,148,143,143,16
"1472",71,"[25]lHoIoHcotHnJHGqKCwetxqdwc",273,0.99635,25,274,1,273,1,1,0,1,1,139,138,135,135,16
"1473",72,"[25]lHoIoHcotHnJHGqKCwetxqdwc",277,0.996403,25,278,1,277,1,1,0,1,1,157,156,121,121,16
"1474",73,"[25]lHoIoHcotHnJHGqKCwetxqdwc",281,0.996454,25,282,1,281,1,1,0,1,1,134,133,148,148,16
"1475",74,"[25]lHoIoHcotHnJHGqKCwetxqdwc",273,0.99635,25,274,1,273,1,1,0,1,1,137,136,137,137,16
"1476",75,"[25]lHoIoHcotHnJHGqKCwetxqdwc",280,0.996441,25,281,1,280,1,1,0,1,1,138,137,143,143,16
"1477",76,"[25]lHoIoHcotHnJHGqKCwetxqdwc",283,0.996479,25,284,1,283,1,1,0,1,1,142,141,142,142,16
"1478",77,"[25]lHoIoHcotHnJHGqKCwetxqdwc",294,0.99661,25,295,1,294,1,1,0,1,1,146,145,149,149,16
"1479",78,"[25]lHoIoHcotHnJHGqKCwetxqdwc",283,0.996479,25,284,1,283,1,1,0,1,1,150,149,134,134,16
"1480",79,"[25]lHoIoHcotHnJHGqKCwetxqdwc",284,0.996491,25,285,1,284,1,1,0,1,1,147,146,138,138,16
"1481",80,"[25]lHoIoHcotHnJHGqKCwetxqdwc",283,0.996479,25,284,1,283,1,1,0,1,1,145,144,139,139,16
"1482",81,"[25]lHoIoHcotHnJHGqKCwetxqdwc",278,0.996416,25,279,1,278,1,1,0,1,1,125,124,154,154,16
"1483",82,"[25]lHoIoHcotHnJHGqKCwetxqdwc",284,0.996491,25,285,1,284,1,1,0,1,1,135,134,150,150,16
"1484",83,"[25]lHoIoHcotHnJHGqKCwetxqdwc",279,0.996429,25,280,1,279,1,1,0,1,1,119,118,161,161,16
"1485",84,"[25]lHoIoHcotHnJHGqKCwetxqdwc",277,0.996403,25,278,1,277,1,1,0,1,1,138,137,140,140,16
"1486",85,"[25]lHoIoHcotHnJHGqKCwetxqdwc",279,0.996429,25,280,1,279,1,1,0,1,1,137,136,143,143,16
"1487",86,"[25]lHoIoHcotHnJHGqKCwetxqdwc",292,0.996587,25,293,1,292,1,1,0,1,1,143,142,150,150,16
"1488",87,"[25]lHoIoHcotHnJHGqKCwetxqdwc",271,0.996324,25,272,1,271,1,1,0,1,1,135,134,137,137,16
"1489",88,"[25]lHoIoHcotHnJHGqKCwetxqdwc",272,0.996337,25,273,1,272,1,1,0,1,1,132,131,141,141,16
"1490",89,"[25]lHoIoHcotHnJHGqKCwetxqdwc",285,0.996503,25,286,1,285,1,1,0,1,1,139,138,147,147,16
"1491",90,"[25]lHoIoHcotHnJHGqKCwetxqdwc",279,0.996429,25,280,1,279,1,1,0,1,1,137,136,143,143,16
"1492",91,"[25]lHoIoHcotHnJHGqKCwetxqdwc",282,0.996466,25,283,1,282,1,1,0,1,1,141,140,142,142,16
"1493",92,"[25]lHoIoHcotHnJHGqKCwetxqdwc",280,0.996441,25,281,1,280,1,1,0,1,1,144,143,137,137,16
"1494",93,"[25]lHoIoHcotHnJHGqKCwetxqdwc",281,0.996454,25,282,1,281,1,1,0,1,1,136,135,146,146,16
"1495",94,"[25]lHoIoHcotHnJHGqKCwetxqdwc",277,0.996403,25,278,1,277,1,1,0,1,1,147,146,131,131,16
"1496",95,"[25]lHoIoHcotHnJHGqKCwetxqdwc",281,0.996454,25,282,1,281,1,1,0,1,1,136,135,146,146,16
"1497",96,"[25]lHoIoHcotHnJHGqKCwetxqdwc",273,0.99635,25,274,1,273,1,1,0,1,1,134,133,140,140,16
"1498",97,"[25]lHoIoHcotHnJHGqKCwetxqdwc",277,0.996403,25,278,1,277,1,1,0,1,1,133,132,145,145,16
"1499",98,"[25]lHoIoHcotHnJHGqKCwetxqdwc",276,0.99639,25,277,1,276,1,1,0,1,1,141,140,136,136,16
"1500",99,"[25]lHoIoHcotHnJHGqKCwetxqdwc",273,0.99635,25,274,1,273,1,1,0,1,1,121,120,153,153,16
"1501",0,"[26]qEtoIoHcosHnJHGqKCeFnoDjBH",280,0.996441,26,281,1,280,1,1,0,1,1,149,148,132,132,17
"1502",1,"[26]qEtoIoHcosHnJHGqKCeFnoDjBH",274,0.996364,26,275,1,274,1,1,0,1,1,146,145,129,129,17
"1503",2,"[26]qEtoIoHcosHnJHGqKCeFnoDjBH",287,0.996528,26,288,1,287,1,1,0,1,1,160,159,128,128,17
"1504",3,"[26]qEtoIoHcosHnJHGqKCeFnoDjBH",277,0.996403,26,278,1,277,1,1,0,1,1,142,141,136,136,17
"1505",4,"[26]qEtoIoHcosHnJHGqKCeFnoDjBH",285,0.996503,26,286,1,285,1,1,0,1,1,152,151,134,134,17
"1506",5,"[26]qEtoIoHcosHnJHGqKCeFnoDjBH",277,0.996403,26,278,1,277,1,1,0,1,1,134,133,144,144,17
"1507",6,"[26]qEtoIoHcosHnJHGqKCeFnoDjBH",279,0.996429,26,280,1,279,1,1,0,1,1,147,146,133,133,17
"1508",7,"[26]qEtoIoHcosHnJHGqKCeFnoDjBH",270,0.99631,26,271,1,270,1,1,0,1,1,146,145,125,125,17
"1509",8,"[26]qEtoIoHcosHnJHGqKCeFnoDjBH",288,0.99654,26,289,1,288,1,1,0,1,1,159,158,130,130,17
"1510",9,"[26]qEtoIoHcosHnJHGqKCeFnoDjBH",284,0.996491,26,285,1,284,1,1,0,1,1,140,139,145,145,17
"1511",10,"[26]qEtoIoHcosHnJHGqKCeFnoDjBH",274,0.996364,26,275,1,274,1,1,0,1,1,132,131,143,143,17
"1512",11,"[26]qEtoIoHcosHnJHGqKCeFnoDjBH",289,0.996552,26,290,1,289,1,1,0,1,1,146,145,144,144,17
"1513",12,"[26]qEtoIoHcosHnJHGqKCeFnoDjBH",286,0.996516,26,287,1,286,1,1,0,1,1,161,160,126,126,17
"1514",13,"[26]qEtoIoHcosHnJHGqKCeFnoDjBH",289,0.996552,26,290,1,289,1,1,0,1,1,151,150,139,139,17
"1515",14,"[26]qEtoIoHcosHnJHGqKCeFnoDjBH",283,0.996479,26,284,1,283,1,1,0,1,1,144,143,140,140,17
"1516",15,"[26]qEtoIoHcosHnJHGqKCeFnoDjBH",279,0.996429,26,280,1,279,1,1,0,1,1,145,144,135,135,17
"1517",16,"[26]qEtoIoHcosHnJHGqKCeFnoDjBH",285,0.996503,26,286,1,285,1,1,0,1,1,139,138,147,147,17
"1518",17,"[26]qEtoIoHcosHnJHGqKCeFnoDjBH",284,0.996491,26,285,1,284,1,1,0,1,1,155,154,130,130,17
"1519",18,"[26]qEtoIoHcosHnJHGqKCeFnoDjBH",280,0.996441,26,281,1,280,1,1,0,1,1,137,136,144,144,17
"1520",19,"[26]qEtoIoHcosHnJHGqKCeFnoDjBH",282,0.996466,26,283,1,282,1,1,0,1,1,137,136,146,146,17
"1521",20,"[26]qEtoIoHcosHnJHGqKCeFnoDjBH",287,0.996528,26,288,1,287,1,1,0,1,1,152,151,136,136,17
"1522",21,"[26]qEtoIoHcosHnJHGqKCeFnoDjBH",282,0.996466,26,283,1,282,1,1,0,1,1,150,149,133,133,17
"1523",22,"[26]qEtoIoHcosHnJHGqKCeFnoDjBH",280,0.996441,26,281,1,280,1,1,0,1,1,140,139,141,141,17
"1524",23,"[26]qEtoIoHcosHnJHGqKCeFnoDjBH",283,0.996479,26,284,1,283,1,1,0,1,1,145,144,139,139,17
"1525",24,"[26]qEtoIoHcosHnJHGqKCeFnoDjBH",284,0.996491,26,285,1,284,1,1,0,1,1,137,136,148,148,17
"1526",25,"[26]qEtoIoHcosHnJHGqKCeFnoDjBH",277,0.996403,26,278,1,277,1,1,0,1,1,143,142,135,135,17
"1527",26,"[26]qEtoIoHcosHnJHGqKCeFnoDjBH",276,0.99639,26,277,1,276,1,1,0,1,1,139,138,138,138,17
"1528",27,"[26]qEtoIoHcosHnJHGqKCeFnoDjBH",274,0.996364,26,275,1,274,1,1,0,1,1,133,132,142,142,17
"1529",28,"[26]qEtoIoHcosHnJHGqKCeFnoDjBH",286,0.996516,26,287,1,286,1,1,0,1,1,134,133,153,153,17
"1530",29,"[26]qEtoIoHcosHnJHGqKCeFnoDjBH",282,0.996466,26,283,1,282,1,1,0,1,1,146,145,137,137,17
"1531",30,"[26]qEtoIoHcosHnJHGqKCeFnoDjBH",288,0.99654,26,289,1,288,1,1,0,1,1,159,158,130,130,17
"1532",31,"[26]qEtoIoHcosHnJHGqKCeFnoDjBH",274,0.996364,26,275,1,274,1,1,0,1,1,138,137,137,137,17
"1533",32,"[26]qEtoIoHcosHnJHGqKCeFnoDjBH",276,0.99639,26,277,1,276,1,1,0,1,1,126,125,151,151,17
"1534",33,"[26]qEtoIoHcosHnJHGqKCeFnoDjBH",281,0.996454,26,282,1,281,1,1,0,1,1,132,131,150,150,17
"1535",34,"[26]qEtoIoHcosHnJHGqKCeFnoDjBH",279,0.996429,26,280,1,279,1,1,0,1,1,148,147,132,132,17
"1536",35,"[26]qEtoIoHcosHnJHGqKCeFnoDjBH",281,0.996454,26,282,1,281,1,1,0,1,1,141,140,141,141,17
"1537",36,"[26]qEtoIoHcosHnJHGqKCeFnoDjBH",277,0.996403,26,278,1,277,1,1,0,1,1,148,147,130,130,17
"1538",37,"[26]qEtoIoHcosHnJHGqKCeFnoDjBH",287,0.996528,26,288,1,287,1,1,0,1,1,143,142,145,145,17
"1539",38,"[26]qEtoIoHcosHnJHGqKCeFnoDjBH",285,0.996503,26,286,1,285,1,1,0,1,1,143,142,143,143,17
"1540",39,"[26]qEtoIoHcosHnJHGqKCeFnoDjBH",284,0.996491,26,285,1,284,1,1,0,1,1,144,143,141,141,17
"1541",40,"[26]qEtoIoHcosHnJHGqKCeFnoDjBH",282,0.996466,26,283,1,282,1,1,0,1,1,149,148,134,134,17
"1542",41,"[26]qEtoIoHcosHnJHGqKCeFnoDjBH",286,0.996516,26,287,1,286,1,1,0,1,1,164,163,123,123,17
"1543",42,"[26]qEtoIoHcosHnJHGqKCeFnoDjBH",284,0.996491,26,285,1,284,1,1,0,1,1,147,146,138,138,17
"1544",43,"[26]qEtoIoHcosHnJHGqKCeFnoDjBH",272,0.996337,26,273,1,272,1,1,0,1,1,136,135,137,137,17
"1545",44,"[26]qEtoIoHcosHnJHGqKCeFnoDjBH",280,0.996441,26,281,1,280,1,1,0,1,1,130,129,151,151,17
"1546",45,"[26]qEtoIoHcosHnJHGqKCeFnoDjBH",282,0.996466,26,283,1,282,1,1,0,1,1,141,140,142,142,17
"1547",46,"[26]qEtoIoHcosHnJHGqKCeFnoDjBH",280,0.996441,26,281,1,280,1,1,0,1,1,141,140,140,140,17
"1548",47,"[26]qEtoIoHcosHnJHGqKCeFnoDjBH",270,0.99631,26,271,1,270,1,1,0,1,1,129,128,142,142,17
"1549",48,"[26]qEtoIoHcosHnJHGqKCeFnoDjBH",274,0.996364,26,275,1,274,1,1,0,1,1,134,133,141,141,17
"1550",49,"[26]qEtoIoHcosHnJHGqKCeFnoDjBH",281,0.996454,26,282,1,281,1,1,0,1,1,149,148,133,133,17
"1551",50,"[26]qEtoIoHcosHnJHGqKCeFnoDjBH",279,0.996429,26,280,1,279,1,1,0,1,1,141,140,139,139,17
"1552",51,"[26]qEtoIoHcosHnJHGqKCeFnoDjBH",272,0.996337,26,273,1,272,1,1,0,1,1,122,121,151,151,17
"1553",52,"[26]qEtoIoHcosHnJHGqKCeFnoDjBH",289,0.996552,26,290,1,289,1,1,0,1,1,162,161,128,128,17
"1554",53,"[26]qEtoIoHcosHnJHGqKCeFnoDjBH",280,0.996441,26,281,1,280,1,1,0,1,1,143,142,138,138,17
"1555",54,"[26]qEtoIoHcosHnJHGqKCeFnoDjBH",287,0.996528,26,288,1,287,1,1,0,1,1,149,148,139,139,17
"1556",55,"[26]qEtoIoHcosHnJHGqKCeFnoDjBH",282,0.996466,26,283,1,282,1,1,0,1,1,145,144,138,138,17
"1557",56,"[26]qEtoIoHcosHnJHGqKCeFnoDjBH",289,0.996552,26,290,1,289,1,1,0,1,1,147,146,143,143,17
"1558",57,"[26]qEtoIoHcosHnJHGqKCeFnoDjBH",281,0.996454,26,282,1,281,1,1,0,1,1,143,142,139,139,17
"1559",58,"[26]qEtoIoHcosHnJHGqKCeFnoDjBH",281,0.996454,26,282,1,281,1,1,0,1,1,135,134,147,147,17
"1560",59,"[26]qEtoIoHcosHnJHGqKCeFnoDjBH",291,0.996575,26,292,1,291,1,1,0,1,1,150,149,142,142,17
"1561",60,"[26]qEtoIoHcosHnJHGqKCeFnoDjBH",281,0.996454,26,282,1,281,1,1,0,1,1,135,134,147,147,17
"1562",61,"[26]qEtoIoHcosHnJHGqKCeFnoDjBH",284,0.996491,26,285,1,284,1,1,0,1,1,139,138,146,146,17
"1563",62,"[26]qEtoIoHcosHnJHGqKCeFnoDjBH",276,0.99639,26,277,1,276,1,1,0,1,1,144,143,133,133,17
"1564",63,"[26]qEtoIoHcosHnJHGqKCeFnoDjBH",283,0.996479,26,284,1,283,1,1,0,1,1,148,147,136,136,17
"1565",64,"[26]qEtoIoHcosHnJHGqKCeFnoDjBH",282,0.996466,26,283,1,282,1,1,0,1,1,144,143,139,139,17
"1566",65,"[26]qEtoIoHcosHnJHGqKCeFnoDjBH",283,0.996479,26,284,1,283,1,1,0,1,1,140,139,144,144,17
"1567",66,"[26]qEtoIoHcosHnJHGqKCeFnoDjBH",277,0.996403,26,278,1,277,1,1,0,1,1,140,139,138,138,17
"1568",67,"[26]qEtoIoHcosHnJHGqKCeFnoDjBH",286,0.996516,26,287,1,286,1,1,0,1,1,140,139,147,147,17
"1569",68,"[26]qEtoIoHcosHnJHGqKCeFnoDjBH",286,0.996516,26,287,1,286,1,1,0,1,1,152,151,135,135,17
"1570",69,"[26]qEtoIoHcosHnJHGqKCeFnoDjBH",283,0.996479,26,284,1,283,1,1,0,1,1,136,135,148,148,17
"1571",70,"[26]qEtoIoHcosHnJHGqKCeFnoDjBH",282,0.996466,26,283,1,282,1,1,0,1,1,146,145,137,137,17
"1572",71,"[26]qEtoIoHcosHnJHGqKCeFnoDjBH",284,0.996491,26,285,1,284,1,1,0,1,1,153,152,132,132,17
"1573",72,"[26]qEtoIoHcosHnJHGqKCeFnoDjBH",283,0.996479,26,284,1,283,1,1,0,1,1,131,130,153,153,17
"1574",73,"[26]qEtoIoHcosHnJHGqKCeFnoDjBH",277,0.996403,26,278,1,277,1,1,0,1,1,148,147,130,130,17
"1575",74,"[26]qEtoIoHcosHnJHGqKCeFnoDjBH",281,0.996454,26,282,1,281,1,1,0,1,1,149,148,133,133,17
"1576",75,"[26]qEtoIoHcosHnJHGqKCeFnoDjBH",282,0.996466,26,283,1,282,1,1,0,1,1,141,140,142,142,17
"1577",76,"[26]qEtoIoHcosHnJHGqKCeFnoDjBH",282,0.996466,26,283,1,282,1,1,0,1,1,136,135,147,147,17
"1578",77,"[26]qEtoIoHcosHnJHGqKCeFnoDjBH",285,0.996503,26,286,1,285,1,1,0,1,1,144,143,142,142,17
"1579",78,"[26]qEtoIoHcosHnJHGqKCeFnoDjBH",272,0.996337,26,273,1,272,1,1,0,1,1,116,115,157,157,17
"1580",79,"[26]qEtoIoHcosHnJHGqKCeFnoDjBH",282,0.996466,26,283,1,282,1,1,0,1,1,146,145,137,137,17
"1581",80,"[26]qEtoIoHcosHnJHGqKCeFnoDjBH",284,0.996491,26,285,1,284,1,1,0,1,1,149,148,136,136,17
"1582",81,"[26]qEtoIoHcosHnJHGqKCeFnoDjBH",274,0.996364,26,275,1,274,1,1,0,1,1,146,145,129,129,17
"1583",82,"[26]qEtoIoHcosHnJHGqKCeFnoDjBH",285,0.996503,26,286,1,285,1,1,0,1,1,148,147,138,138,17
"1584",83,"[26]qEtoIoHcosHnJHGqKCeFnoDjBH",276,0.99639,26,277,1,276,1,1,0,1,1,141,140,136,136,17
"1585",84,"[26]qEtoIoHcosHnJHGqKCeFnoDjBH",287,0.996528,26,288,1,287,1,1,0,1,1,154,153,134,134,17
"1586",85,"[26]qEtoIoHcosHnJHGqKCeFnoDjBH",273,0.99635,26,274,1,273,1,1,0,1,1,148,147,126,126,17
"1587",86,"[26]qEtoIoHcosHnJHGqKCeFnoDjBH",280,0.996441,26,281,1,280,1,1,0,1,1,140,139,141,141,17
"1588",87,"[26]qEtoIoHcosHnJHGqKCeFnoDjBH",282,0.996466,26,283,1,282,1,1,0,1,1,131,130,152,152,17
"1589",88,"[26]qEtoIoHcosHnJHGqKCeFnoDjBH",283,0.996479,26,284,1,283,1,1,0,1,1,143,142,141,141,17
"1590",89,"[26]qEtoIoHcosHnJHGqKCeFnoDjBH",281,0.996454,26,282,1,281,1,1,0,1,1,134,133,148,148,17
"1591",90,"[26]qEtoIoHcosHnJHGqKCeFnoDjBH",277,0.996403,26,278,1,277,1,1,0,1,1,132,131,146,146,17
"1592",91,"[26]qEtoIoHcosHnJHGqKCeFnoDjBH",280,0.996441,26,281,1,280,1,1,0,1,1,131,130,150,150,17
"1593",92,"[26]qEtoIoHcosHnJHGqKCeFnoDjBH",281,0.996454,26,282,1,281,1,1,0,1,1,141,140,141,141,17
"1594",93,"[26]qEtoIoHcosHnJHGqKCeFnoDjBH",290,0.996564,26,291,1,290,1,1,0,1,1,162,161,129,129,17
"1595",94,"[26]qEtoIoHcosHnJHGqKCeFnoDjBH",275,0.996377,26,276,1,275,1,1,0,1,1,132,131,144,144,17
"1596",95,"[26]qEtoIoHcosHnJHGqKCeFnoDjBH",287,0.996528,26,288,1,287,1,1,0,1,1,148,147,140,140,17
"1597",96,"[26]qEtoIoHcosHnJHGqKCeFnoDjBH",280,0.996441,26,281,1,280,1,1,0,1,1,151,150,130,130,17
"1598",97,"[26]qEtoIoHcosHnJHGqKCeFnoDjBH",277,0.996403,26,278,1,277,1,1,0,1,1,151,150,127,127,17
"1599",98,"[26]qEtoIoHcosHnJHGqKCeFnoDjBH",278,0.996416,26,279,1,278,1,1,0,1,1,145,144,134,134,17
"1600",99,"[26]qEtoIoHcosHnJHGqKCeFnoDjBH",277,0.996403,26,278,1,277,1,1,0,1,1,139,138,139,139,17
"1601",0,"[22]hcHoIoHcowHnJqGKCtgxEK",301,0.996689,22,302,1,301,1,1,0,1,1,165,164,137,137,18
"1602",1,"[22]hcHoIoHcowHnJqGKCtgxEK",294,0.99661,22,295,1,294,1,1,0,1,1,144,143,151,151,18
"1603",2,"[22]hcHoIoHcowHnJqGKCtgxEK",296,0.996633,22,297,1,296,1,1,0,1,1,153,152,144,144,18
"1604",3,"[22]hcHoIoHcowHnJqGKCtgxEK",295,0.996622,22,296,1,295,1,1,0,1,1,149,148,147,147,18
"1605",4,"[22]hcHoIoHcowHnJqGKCtgxEK",293,0.996599,22,294,1,293,1,1,0,1,1,139,138,155,155,18
"1606",5,"[22]hcHoIoHcowHnJqGKCtgxEK",293,0.996599,22,294,1,293,1,1,0,1,1,146,145,148,148,18
"1607",6,"[22]hcHoIoHcowHnJqGKCtgxEK",298,0.996656,22,299,1,298,1,1,0,1,1,154,153,145,145,18
"1608",7,"[22]hcHoIoHcowHnJqGKCtgxEK",296,0.996633,22,297,1,296,1,1,0,1,1,149,148,148,148,18
"1609",8,"[22]hcHoIoHcowHnJqGKCtgxEK",292,0.996587,22,293,1,292,1,1,0,1,1,138,137,155,155,18
"1610",9,"[22]hcHoIoHcowHnJqGKCtgxEK",293,0.996599,22,294,1,293,1,1,0,1,1,145,144,149,149,18
"1611",10,"[22]hcHoIoHcowHnJqGKCtgxEK",298,0.996656,22,299,1,298,1,1,0,1,1,156,155,143,143,18
"1612",11,"[22]hcHoIoHcowHnJqGKCtgxEK",295,0.996622,22,296,1,295,1,1,0,1,1,144,143,152,152,18
"1613",12,"[22]hcHoIoHcowHnJqGKCtgxEK",299,0.996667,22,300,1,299,1,1,0,1,1,159,158,141,141,18
"1614",13,"[22]hcHoIoHcowHnJqGKCtgxEK",295,0.996622,22,296,1,295,1,1,0,1,1,162,161,134,134,18
"1615",14,"[22]hcHoIoHcowHnJqGKCtgxEK",294,0.99661,22,295,1,294,1,1,0,1,1,150,149,145,145,18
"1616",15,"[22]hcHoIoHcowHnJqGKCtgxEK",301,0.996689,22,302,1,301,1,1,0,1,1,166,165,136,136,18
"1617",16,"[22]hcHoIoHcowHnJqGKCtgxEK",293,0.996599,22,294,1,293,1,1,0,1,1,146,145,148,148,18
"1618",17,"[22]hcHoIoHcowHnJqGKCtgxEK",294,0.99661,22,295,1,294,1,1,0,1,1,143,142,152,152,18
"1619",18,"[22]hcHoIoHcowHnJqGKCtgxEK",294,0.99661,22,295,1,294,1,1,0,1,1,143,142,152,152,18
"1620",19,"[22]hcHoIoHcowHnJqGKCtgxEK",301,0.996689,22,302,1,301,1,1,0,1,1,164,163,138,138,18
"1621",20,"[22]hcHoIoHcowHnJqGKCtgxEK",295,0.996622,22,296,1,295,1,1,0,1,1,147,146,149,149,18
"1622",21,"[22]hcHoIoHcowHnJqGKCtgxEK",294,0.99661,22,295,1,294,1,1,0,1,1,136,135,159,159,18
"1623",22,"[22]hcHoIoHcowHnJqGKCtgxEK",291,0.996575,22,292,1,291,1,1,0,1,1,136,135,156,156,18
"1624",23,"[22]hcHoIoHcowHnJqGKCtgxEK",298,0.996656,22,299,1,298,1,1,0,1,1,159,158,140,140,18
"1625",24,"[22]hcHoIoHcowHnJqGKCtgxEK",295,0.996622,22,296,1,295,1,1,0,1,1,159,158,137,137,18
"1626",25,"[22]hcHoIoHcowHnJqGKCtgxEK",290,0.996564,22,291,1,290,1,1,0,1,1,141,140,150,150,18
"1627",26,"[22]hcHoIoHcowHnJqGKCtgxEK",302,0.9967,22,303,1,302,1,1,0,1,1,165,164,138,138,18
"1628",27,"[22]hcHoIoHcowHnJqGKCtgxEK",294,0.99661,22,295,1,294,1,1,0,1,1,143,142,152,152,18
"1629",28,"[22]hcHoIoHcowHnJqGKCtgxEK",296,0.996633,22,297,1,296,1,1,0,1,1,151,150,146,146,18
"1630",29,"[22]hcHoIoHcowHnJqGKCtgxEK",293,0.996599,22,294,1,293,1,1,0,1,1,141,140,153,153,18
"1631",30,"[22]hcHoIoHcowHnJqGKCtgxEK",297,0.996644,22,298,1,297,1,1,0,1,1,149,148,149,149,18
"1632",31,"[22]hcHoIoHcowHnJqGKCtgxEK",292,0.996587,22,293,1,292,1,1,0,1,1,141,140,152,152,18
"1633",32,"[22]hcHoIoHcowHnJqGKCtgxEK",295,0.996622,22,296,1,295,1,1,0,1,1,145,144,151,151,18
"1634",33,"[22]hcHoIoHcowHnJqGKCtgxEK",294,0.99661,22,295,1,294,1,1,0,1,1,143,142,152,152,18
"1635",34,"[22]hcHoIoHcowHnJqGKCtgxEK",296,0.996633,22,297,1,296,1,1,0,1,1,149,148,148,148,18
"1636",35,"[22]hcHoIoHcowHnJqGKCtgxEK",296,0.996633,22,297,1,296,1,1,0,1,1,148,147,149,149,18
"1637",36,"[22]hcHoIoHcowHnJqGKCtgxEK",293,0.996599,22,294,1,293,1,1,0,1,1,139,138,155,155,18
"1638",37,"[22]hcHoIoHcowHnJqGKCtgxEK",295,0.996622,22,296,1,295,1,1,0,1,1,147,146,149,149,18
"1639",38,"[22]hcHoIoHcowHnJqGKCtgxEK",293,0.996599,22,294,1,293,1,1,0,1,1,141,140,153,153,18
"1640",39,"[22]hcHoIoHcowHnJqGKCtgxEK",289,0.996552,22,290,1,289,1,1,0,1,1,133,132,157,157,18
"1641",40,"[22]hcHoIoHcowHnJqGKCtgxEK",290,0.996564,22,291,1,290,1,1,0,1,1,129,128,162,162,18
"1642",41,"[22]hcHoIoHcowHnJqGKCtgxEK",298,0.996656,22,299,1,298,1,1,0,1,1,152,151,147,147,18
"1643",42,"[22]hcHoIoHcowHnJqGKCtgxEK",291,0.996575,22,292,1,291,1,1,0,1,1,135,134,157,157,18
"1644",43,"[22]hcHoIoHcowHnJqGKCtgxEK",299,0.996667,22,300,1,299,1,1,0,1,1,158,157,142,142,18
"1645",44,"[22]hcHoIoHcowHnJqGKCtgxEK",292,0.996587,22,293,1,292,1,1,0,1,1,138,137,155,155,18
"1646",45,"[22]hcHoIoHcowHnJqGKCtgxEK",294,0.99661,22,295,1,294,1,1,0,1,1,145,144,150,150,18
"1647",46,"[22]hcHoIoHcowHnJqGKCtgxEK",289,0.996552,22,290,1,289,1,1,0,1,1,130,129,160,160,18
"1648",47,"[22]hcHoIoHcowHnJqGKCtgxEK",295,0.996622,22,296,1,295,1,1,0,1,1,149,148,147,147,18
"1649",48,"[22]hcHoIoHcowHnJqGKCtgxEK",296,0.996633,22,297,1,296,1,1,0,1,1,145,144,152,152,18
"1650",49,"[22]hcHoIoHcowHnJqGKCtgxEK",293,0.996599,22,294,1,293,1,1,0,1,1,144,143,150,150,18
"1651",50,"[22]hcHoIoHcowHnJqGKCtgxEK",295,0.996622,22,296,1,295,1,1,0,1,1,141,140,155,155,18
"1652",51,"[22]hcHoIoHcowHnJqGKCtgxEK",296,0.996633,22,297,1,296,1,1,0,1,1,155,154,142,142,18
"1653",52,"[22]hcHoIoHcowHnJqGKCtgxEK",290,0.996564,22,291,1,290,1,1,0,1,1,142,141,149,149,18
"1654",53,"[22]hcHoIoHcowHnJqGKCtgxEK",296,0.996633,22,297,1,296,1,1,0,1,1,153,152,144,144,18
"1655",54,"[22]hcHoIoHcowHnJqGKCtgxEK",291,0.996575,22,292,1,291,1,1,0,1,1,134,133,158,158,18
"1656",55,"[22]hcHoIoHcowHnJqGKCtgxEK",293,0.996599,22,294,1,293,1,1,0,1,1,137,136,157,157,18
"1657",56,"[22]hcHoIoHcowHnJqGKCtgxEK",296,0.996633,22,297,1,296,1,1,0,1,1,150,149,147,147,18
"1658",57,"[22]hcHoIoHcowHnJqGKCtgxEK",292,0.996587,22,293,1,292,1,1,0,1,1,155,154,138,138,18
"1659",58,"[22]hcHoIoHcowHnJqGKCtgxEK",297,0.996644,22,298,1,297,1,1,0,1,1,146,145,152,152,18
"1660",59,"[22]hcHoIoHcowHnJqGKCtgxEK",295,0.996622,22,296,1,295,1,1,0,1,1,148,147,148,148,18
"1661",60,"[22]hcHoIoHcowHnJqGKCtgxEK",295,0.996622,22,296,1,295,1,1,0,1,1,142,141,154,154,18
"1662",61,"[22]hcHoIoHcowHnJqGKCtgxEK",296,0.996633,22,297,1,296,1,1,0,1,1,145,144,152,152,18
"1663",62,"[22]hcHoIoHcowHnJqGKCtgxEK",297,0.996644,22,298,1,297,1,1,0,1,1,151,150,147,147,18
"1664",63,"[22]hcHoIoHcowHnJqGKCtgxEK",296,0.996633,22,297,1,296,1,1,0,1,1,159,158,138,138,18
"1665",64,"[22]hcHoIoHcowHnJqGKCtgxEK",294,0.99661,22,295,1,294,1,1,0,1,1,143,142,152,152,18
"1666",65,"[22]hcHoIoHcowHnJqGKCtgxEK",294,0.99661,22,295,1,294,1,1,0,1,1,141,140,154,154,18
"1667",66,"[22]hcHoIoHcowHnJqGKCtgxEK",306,0.996743,22,307,1,306,1,1,0,1,1,171,170,136,136,18
"1668",67,"[22]hcHoIoHcowHnJqGKCtgxEK",296,0.996633,22,297,1,296,1,1,0,1,1,158,157,139,139,18
"1669",68,"[22]hcHoIoHcowHnJqGKCtgxEK",293,0.996599,22,294,1,293,1,1,0,1,1,147,146,147,147,18
"1670",69,"[22]hcHoIoHcowHnJqGKCtgxEK",292,0.996587,22,293,1,292,1,1,0,1,1,153,152,140,140,18
"1671",70,"[22]hcHoIoHcowHnJqGKCtgxEK",294,0.99661,22,295,1,294,1,1,0,1,1,147,146,148,148,18
"1672",71,"[22]hcHoIoHcowHnJqGKCtgxEK",297,0.996644,22,298,1,297,1,1,0,1,1,150,149,148,148,18
"1673",72,"[22]hcHoIoHcowHnJqGKCtgxEK",289,0.996552,22,290,1,289,1,1,0,1,1,135,134,155,155,18
"1674",73,"[22]hcHoIoHcowHnJqGKCtgxEK",291,0.996575,22,292,1,291,1,1,0,1,1,136,135,156,156,18
"1675",74,"[22]hcHoIoHcowHnJqGKCtgxEK",295,0.996622,22,296,1,295,1,1,0,1,1,146,145,150,150,18
"1676",75,"[22]hcHoIoHcowHnJqGKCtgxEK",298,0.996656,22,299,1,298,1,1,0,1,1,156,155,143,143,18
"1677",76,"[22]hcHoIoHcowHnJqGKCtgxEK",297,0.996644,22,298,1,297,1,1,0,1,1,149,148,149,149,18
"1678",77,"[22]hcHoIoHcowHnJqGKCtgxEK",298,0.996656,22,299,1,298,1,1,0,1,1,159,158,140,140,18
"1679",78,"[22]hcHoIoHcowHnJqGKCtgxEK",291,0.996575,22,292,1,291,1,1,0,1,1,141,140,151,151,18
"1680",79,"[22]hcHoIoHcowHnJqGKCtgxEK",294,0.99661,22,295,1,294,1,1,0,1,1,147,146,148,148,18
"1681",80,"[22]hcHoIoHcowHnJqGKCtgxEK",292,0.996587,22,293,1,292,1,1,0,1,1,138,137,155,155,18
"1682",81,"[22]hcHoIoHcowHnJqGKCtgxEK",296,0.996633,22,297,1,296,1,1,0,1,1,148,147,149,149,18
"1683",82,"[22]hcHoIoHcowHnJqGKCtgxEK",293,0.996599,22,294,1,293,1,1,0,1,1,137,136,157,157,18
"1684",83,"[22]hcHoIoHcowHnJqGKCtgxEK",295,0.996622,22,296,1,295,1,1,0,1,1,148,147,148,148,18
"1685",84,"[22]hcHoIoHcowHnJqGKCtgxEK",292,0.996587,22,293,1,292,1,1,0,1,1,150,149,143,143,18
"1686",85,"[22]hcHoIoHcowHnJqGKCtgxEK",297,0.996644,22,298,1,297,1,1,0,1,1,155,154,143,143,18
"1687",86,"[22]hcHoIoHcowHnJqGKCtgxEK",294,0.99661,22,295,1,294,1,1,0,1,1,140,139,155,155,18
"1688",87,"[22]hcHoIoHcowHnJqGKCtgxEK",303,0.996711,22,304,1,303,1,1,0,1,1,180,179,124,124,18
"1689",88,"[22]hcHoIoHcowHnJqGKCtgxEK",292,0.996587,22,293,1,292,1,1,0,1,1,138,137,155,155,18
"1690",89,"[22]hcHoIoHcowHnJqGKCtgxEK",302,0.9967,22,303,1,302,1,1,0,1,1,171,170,132,132,18
"1691",90,"[22]hcHoIoHcowHnJqGKCtgxEK",295,0.996622,22,296,1,295,1,1,0,1,1,147,146,149,149,18
"1692",91,"[22]hcHoIoHcowHnJqGKCtgxEK",290,0.996564,22,291,1,290,1,1,0,1,1,137,136,154,154,18
"1693",92,"[22]hcHoIoHcowHnJqGKCtgxEK",299,0.996667,22,300,1,299,1,1,0,1,1,161,160,139,139,18
"1694",93,"[22]hcHoIoHcowHnJqGKCtgxEK",295,0.996622,22,296,1,295,1,1,0,1,1,147,146,149,149,18
"1695",94,"[22]hcHoIoHcowHnJqGKCtgxEK",293,0.996599,22,294,1,293,1,1,0,1,1,143,142,151,151,18
"1696",95,"[22]hcHoIoHcowHnJqGKCtgxEK",296,0.996633,22,297,1,296,1,1,0,1,1,154,153,143,143,18
"1697",96,"[22]hcHoIoHcowHnJqGKCtgxEK",297,0.996644,22,298,1,297,1,1,0,1,1,153,152,145,145,18
"1698",97,"[22]hcHoIoHcowHnJqGKCtgxEK",302,0.9967,22,303,1,302,1,1,0,1,1,161,160,142,142,18
"1699",98,"[22]hcHoIoHcowHnJqGKCtgxEK",303,0.996711,22,304,1,303,1,1,0,1,1,166,165,138,138,18
"1700",99,"[22]hcHoIoHcowHnJqGKCtgxEK",287,0.996528,22,288,1,287,1,1,0,1,1,132,131,156,156,18
"1701",0,"[26]rnHoIoHcowHnJHGqKCukDyFiut",283,0.996479,26,284,1,283,1,1,0,1,1,145,144,139,139,19
"1702",1,"[26]rnHoIoHcowHnJHGqKCukDyFiut",279,0.996429,26,280,1,279,1,1,0,1,1,135,134,145,145,19
"1703",2,"[26]rnHoIoHcowHnJHGqKCukDyFiut",275,0.996377,26,276,1,275,1,1,0,1,1,129,128,147,147,19
"1704",3,"[26]rnHoIoHcowHnJHGqKCukDyFiut",287,0.996528,26,288,1,287,1,1,0,1,1,148,147,140,140,19
"1705",4,"[26]rnHoIoHcowHnJHGqKCukDyFiut",282,0.996466,26,283,1,282,1,1,0,1,1,153,152,130,130,19
"1706",5,"[26]rnHoIoHcowHnJHGqKCukDyFiut",278,0.996416,26,279,1,278,1,1,0,1,1,145,144,134,134,19
"1707",6,"[26]rnHoIoHcowHnJHGqKCukDyFiut",283,0.996479,26,284,1,283,1,1,0,1,1,145,144,139,139,19
"1708",7,"[26]rnHoIoHcowHnJHGqKCukDyFiut",281,0.996454,26,282,1,281,1,1,0,1,1,136,135,146,146,19
"1709",8,"[26]rnHoIoHcowHnJHGqKCukDyFiut",284,0.996491,26,285,1,284,1,1,0,1,1,145,144,140,140,19
"1710",9,"[26]rnHoIoHcowHnJHGqKCukDyFiut",279,0.996429,26,280,1,279,1,1,0,1,1,133,132,147,147,19
"1711",10,"[26]rnHoIoHcowHnJHGqKCukDyFiut",280,0.996441,26,281,1,280,1,1,0,1,1,147,146,134,134,19
"1712",11,"[26]rnHoIoHcowHnJHGqKCukDyFiut",279,0.996429,26,280,1,279,1,1,0,1,1,155,154,125,125,19
"1713",12,"[26]rnHoIoHcowHnJHGqKCukDyFiut",287,0.996528,26,288,1,287,1,1,0,1,1,156,155,132,132,19
"1714",13,"[26]rnHoIoHcowHnJHGqKCukDyFiut",278,0.996416,26,279,1,278,1,1,0,1,1,126,125,153,153,19
"1715",14,"[26]rnHoIoHcowHnJHGqKCukDyFiut",284,0.996491,26,285,1,284,1,1,0,1,1,142,141,143,143,19
"1716",15,"[26]rnHoIoHcowHnJHGqKCukDyFiut",275,0.996377,26,276,1,275,1,1,0,1,1,136,135,140,140,19
"1717",16,"[26]rnHoIoHcowHnJHGqKCukDyFiut",283,0.996479,26,284,1,283,1,1,0,1,1,128,127,156,156,19
"1718",17,"[26]rnHoIoHcowHnJHGqKCukDyFiut",284,0.996491,26,285,1,284,1,1,0,1,1,151,150,134,134,19
"1719",18,"[26]rnHoIoHcowHnJHGqKCukDyFiut",279,0.996429,26,280,1,279,1,1,0,1,1,132,131,148,148,19
"1720",19,"[26]rnHoIoHcowHnJHGqKCukDyFiut",277,0.996403,26,278,1,277,1,1,0,1,1,119,118,159,159,19
"1721",20,"[26]rnHoIoHcowHnJHGqKCukDyFiut",277,0.996403,26,278,1,277,1,1,0,1,1,145,144,133,133,19
"1722",21,"[26]rnHoIoHcowHnJHGqKCukDyFiut",279,0.996429,26,280,1,279,1,1,0,1,1,135,134,145,145,19
"1723",22,"[26]rnHoIoHcowHnJHGqKCukDyFiut",279,0.996429,26,280,1,279,1,1,0,1,1,135,134,145,145,19
"1724",23,"[26]rnHoIoHcowHnJHGqKCukDyFiut",278,0.996416,26,279,1,278,1,1,0,1,1,149,148,130,130,19
"1725",24,"[26]rnHoIoHcowHnJHGqKCukDyFiut",284,0.996491,26,285,1,284,1,1,0,1,1,142,141,143,143,19
"1726",25,"[26]rnHoIoHcowHnJHGqKCukDyFiut",282,0.996466,26,283,1,282,1,1,0,1,1,155,154,128,128,19
"1727",26,"[26]rnHoIoHcowHnJHGqKCukDyFiut",285,0.996503,26,286,1,285,1,1,0,1,1,145,144,141,141,19
"1728",27,"[26]rnHoIoHcowHnJHGqKCukDyFiut",280,0.996441,26,281,1,280,1,1,0,1,1,144,143,137,137,19
"1729",28,"[26]rnHoIoHcowHnJHGqKCukDyFiut",278,0.996416,26,279,1,278,1,1,0,1,1,137,136,142,142,19
"1730",29,"[26]rnHoIoHcowHnJHGqKCukDyFiut",281,0.996454,26,282,1,281,1,1,0,1,1,144,143,138,138,19
"1731",30,"[26]rnHoIoHcowHnJHGqKCukDyFiut",283,0.996479,26,284,1,283,1,1,0,1,1,150,149,134,134,19
"1732",31,"[26]rnHoIoHcowHnJHGqKCukDyFiut",286,0.996516,26,287,1,286,1,1,0,1,1,147,146,140,140,19
"1733",32,"[26]rnHoIoHcowHnJHGqKCukDyFiut",287,0.996528,26,288,1,287,1,1,0,1,1,154,153,134,134,19
"1734",33,"[26]rnHoIoHcowHnJHGqKCukDyFiut",279,0.996429,26,280,1,279,1,1,0,1,1,131,130,149,149,19
"1735",34,"[26]rnHoIoHcowHnJHGqKCukDyFiut",281,0.996454,26,282,1,281,1,1,0,1,1,134,133,148,148,19
"1736",35,"[26]rnHoIoHcowHnJHGqKCukDyFiut",286,0.996516,26,287,1,286,1,1,0,1,1,151,150,136,136,19
"1737",36,"[26]rnHoIoHcowHnJHGqKCukDyFiut",280,0.996441,26,281,1,280,1,1,0,1,1,133,132,148,148,19
"1738",37,"[26]rnHoIoHcowHnJHGqKCukDyFiut",283,0.996479,26,284,1,283,1,1,0,1,1,155,154,129,129,19
"1739",38,"[26]rnHoIoHcowHnJHGqKCukDyFiut",280,0.996441,26,281,1,280,1,1,0,1,1,142,141,139,139,19
"1740",39,"[26]rnHoIoHcowHnJHGqKCukDyFiut",276,0.99639,26,277,1,276,1,1,0,1,1,157,156,120,120,19
"1741",40,"[26]rnHoIoHcowHnJHGqKCukDyFiut",278,0.996416,26,279,1,278,1,1,0,1,1,137,136,142,142,19
"1742",41,"[26]rnHoIoHcowHnJHGqKCukDyFiut",280,0.996441,26,281,1,280,1,1,0,1,1,125,124,156,156,19
"1743",42,"[26]rnHoIoHcowHnJHGqKCukDyFiut",282,0.996466,26,283,1,282,1,1,0,1,1,150,149,133,133,19
"1744",43,"[26]rnHoIoHcowHnJHGqKCukDyFiut",283,0.996479,26,284,1,283,1,1,0,1,1,143,142,141,141,19
"1745",44,"[26]rnHoIoHcowHnJHGqKCukDyFiut",282,0.996466,26,283,1,282,1,1,0,1,1,145,144,138,138,19
"1746",45,"[26]rnHoIoHcowHnJHGqKCukDyFiut",278,0.996416,26,279,1,278,1,1,0,1,1,142,141,137,137,19
"1747",46,"[26]rnHoIoHcowHnJHGqKCukDyFiut",279,0.996429,26,280,1,279,1,1,0,1,1,131,130,149,149,19
"1748",47,"[26]rnHoIoHcowHnJHGqKCukDyFiut",285,0.996503,26,286,1,285,1,1,0,1,1,134,133,152,152,19
"1749",48,"[26]rnHoIoHcowHnJHGqKCukDyFiut",277,0.996403,26,278,1,277,1,1,0,1,1,126,125,152,152,19
"1750",49,"[26]rnHoIoHcowHnJHGqKCukDyFiut",279,0.996429,26,280,1,279,1,1,0,1,1,143,142,137,137,19
"1751",50,"[26]rnHoIoHcowHnJHGqKCukDyFiut",281,0.996454,26,282,1,281,1,1,0,1,1,143,142,139,139,19
"1752",51,"[26]rnHoIoHcowHnJHGqKCukDyFiut",274,0.996364,26,275,1,274,1,1,0,1,1,124,123,151,151,19
"1753",52,"[26]rnHoIoHcowHnJHGqKCukDyFiut",277,0.996403,26,278,1,277,1,1,0,1,1,145,144,133,133,19
"1754",53,"[26]rnHoIoHcowHnJHGqKCukDyFiut",285,0.996503,26,286,1,285,1,1,0,1,1,147,146,139,139,19
"1755",54,"[26]rnHoIoHcowHnJHGqKCukDyFiut",290,0.996564,26,291,1,290,1,1,0,1,1,157,156,134,134,19
"1756",55,"[26]rnHoIoHcowHnJHGqKCukDyFiut",279,0.996429,26,280,1,279,1,1,0,1,1,152,151,128,128,19
"1757",56,"[26]rnHoIoHcowHnJHGqKCukDyFiut",279,0.996429,26,280,1,279,1,1,0,1,1,125,124,155,155,19
"1758",57,"[26]rnHoIoHcowHnJHGqKCukDyFiut",274,0.996364,26,275,1,274,1,1,0,1,1,133,132,142,142,19
"1759",58,"[26]rnHoIoHcowHnJHGqKCukDyFiut",275,0.996377,26,276,1,275,1,1,0,1,1,130,129,146,146,19
"1760",59,"[26]rnHoIoHcowHnJHGqKCukDyFiut",286,0.996516,26,287,1,286,1,1,0,1,1,153,152,134,134,19
"1761",60,"[26]rnHoIoHcowHnJHGqKCukDyFiut",278,0.996416,26,279,1,278,1,1,0,1,1,141,140,138,138,19
"1762",61,"[26]rnHoIoHcowHnJHGqKCukDyFiut",280,0.996441,26,281,1,280,1,1,0,1,1,149,148,132,132,19
"1763",62,"[26]rnHoIoHcowHnJHGqKCukDyFiut",276,0.99639,26,277,1,276,1,1,0,1,1,141,140,136,136,19
"1764",63,"[26]rnHoIoHcowHnJHGqKCukDyFiut",281,0.996454,26,282,1,281,1,1,0,1,1,134,133,148,148,19
"1765",64,"[26]rnHoIoHcowHnJHGqKCukDyFiut",283,0.996479,26,284,1,283,1,1,0,1,1,135,134,149,149,19
"1766",65,"[26]rnHoIoHcowHnJHGqKCukDyFiut",285,0.996503,26,286,1,285,1,1,0,1,1,141,140,145,145,19
"1767",66,"[26]rnHoIoHcowHnJHGqKCukDyFiut",283,0.996479,26,284,1,283,1,1,0,1,1,139,138,145,145,19
"1768",67,"[26]rnHoIoHcowHnJHGqKCukDyFiut",280,0.996441,26,281,1,280,1,1,0,1,1,154,153,127,127,19
"1769",68,"[26]rnHoIoHcowHnJHGqKCukDyFiut",286,0.996516,26,287,1,286,1,1,0,1,1,151,150,136,136,19
"1770",69,"[26]rnHoIoHcowHnJHGqKCukDyFiut",279,0.996429,26,280,1,279,1,1,0,1,1,140,139,140,140,19
"1771",70,"[26]rnHoIoHcowHnJHGqKCukDyFiut",272,0.996337,26,273,1,272,1,1,0,1,1,130,129,143,143,19
"1772",71,"[26]rnHoIoHcowHnJHGqKCukDyFiut",277,0.996403,26,278,1,277,1,1,0,1,1,130,129,148,148,19
"1773",72,"[26]rnHoIoHcowHnJHGqKCukDyFiut",279,0.996429,26,280,1,279,1,1,0,1,1,140,139,140,140,19
"1774",73,"[26]rnHoIoHcowHnJHGqKCukDyFiut",275,0.996377,26,276,1,275,1,1,0,1,1,133,132,143,143,19
"1775",74,"[26]rnHoIoHcowHnJHGqKCukDyFiut",276,0.99639,26,277,1,276,1,1,0,1,1,139,138,138,138,19
"1776",75,"[26]rnHoIoHcowHnJHGqKCukDyFiut",281,0.996454,26,282,1,281,1,1,0,1,1,139,138,143,143,19
"1777",76,"[26]rnHoIoHcowHnJHGqKCukDyFiut",283,0.996479,26,284,1,283,1,1,0,1,1,142,141,142,142,19
"1778",77,"[26]rnHoIoHcowHnJHGqKCukDyFiut",273,0.99635,26,274,1,273,1,1,0,1,1,147,146,127,127,19
"1779",78,"[26]rnHoIoHcowHnJHGqKCukDyFiut",281,0.996454,26,282,1,281,1,1,0,1,1,149,148,133,133,19
"1780",79,"[26]rnHoIoHcowHnJHGqKCukDyFiut",274,0.996364,26,275,1,274,1,1,0,1,1,125,124,150,150,19
"1781",80,"[26]rnHoIoHcowHnJHGqKCukDyFiut",288,0.99654,26,289,1,288,1,1,0,1,1,140,139,149,149,19
"1782",81,"[26]rnHoIoHcowHnJHGqKCukDyFiut",275,0.996377,26,276,1,275,1,1,0,1,1,122,121,154,154,19
"1783",82,"[26]rnHoIoHcowHnJHGqKCukDyFiut",278,0.996416,26,279,1,278,1,1,0,1,1,151,150,128,128,19
"1784",83,"[26]rnHoIoHcowHnJHGqKCukDyFiut",281,0.996454,26,282,1,281,1,1,0,1,1,144,143,138,138,19
"1785",84,"[26]rnHoIoHcowHnJHGqKCukDyFiut",282,0.996466,26,283,1,282,1,1,0,1,1,145,144,138,138,19
"1786",85,"[26]rnHoIoHcowHnJHGqKCukDyFiut",272,0.996337,26,273,1,272,1,1,0,1,1,129,128,144,144,19
"1787",86,"[26]rnHoIoHcowHnJHGqKCukDyFiut",282,0.996466,26,283,1,282,1,1,0,1,1,161,160,122,122,19
"1788",87,"[26]rnHoIoHcowHnJHGqKCukDyFiut",278,0.996416,26,279,1,278,1,1,0,1,1,134,133,145,145,19
"1789",88,"[26]rnHoIoHcowHnJHGqKCukDyFiut",280,0.996441,26,281,1,280,1,1,0,1,1,151,150,130,130,19
"1790",89,"[26]rnHoIoHcowHnJHGqKCukDyFiut",283,0.996479,26,284,1,283,1,1,0,1,1,135,134,149,149,19
"1791",90,"[26]rnHoIoHcowHnJHGqKCukDyFiut",285,0.996503,26,286,1,285,1,1,0,1,1,155,154,131,131,19
"1792",91,"[26]rnHoIoHcowHnJHGqKCukDyFiut",279,0.996429,26,280,1,279,1,1,0,1,1,149,148,131,131,19
"1793",92,"[26]rnHoIoHcowHnJHGqKCukDyFiut",288,0.99654,26,289,1,288,1,1,0,1,1,148,147,141,141,19
"1794",93,"[26]rnHoIoHcowHnJHGqKCukDyFiut",275,0.996377,26,276,1,275,1,1,0,1,1,134,133,142,142,19
"1795",94,"[26]rnHoIoHcowHnJHGqKCukDyFiut",290,0.996564,26,291,1,290,1,1,0,1,1,152,151,139,139,19
"1796",95,"[26]rnHoIoHcowHnJHGqKCukDyFiut",277,0.996403,26,278,1,277,1,1,0,1,1,137,136,141,141,19
"1797",96,"[26]rnHoIoHcowHnJHGqKCukDyFiut",268,0.996283,26,269,1,268,1,1,0,1,1,133,132,136,136,19
"1798",97,"[26]rnHoIoHcowHnJHGqKCukDyFiut",271,0.996324,26,272,1,271,1,1,0,1,1,127,126,145,145,19
"1799",98,"[26]rnHoIoHcowHnJHGqKCukDyFiut",276,0.99639,26,277,1,276,1,1,0,1,1,132,131,145,145,19
"1800",99,"[26]rnHoIoHcowHnJHGqKCukDyFiut",279,0.996429,26,280,1,279,1,1,0,1,1,134,133,146,146,19
"1801",0,"[25]joIoHcoxHnJHGqKCaCHbBBBJe",283,0.996479,25,284,1,283,1,1,0,1,1,161,160,123,123,20
"1802",1,"[25]joIoHcoxHnJHGqKCaCHbBBBJe",288,0.99654,25,289,1,288,1,1,0,1,1,161,160,128,128,20
"1803",2,"[25]joIoHcoxHnJHGqKCaCHbBBBJe",270,0.99631,25,271,1,270,1,1,0,1,1,138,137,133,133,20
"1804",3,"[25]joIoHcoxHnJHGqKCaCHbBBBJe",281,0.996454,25,282,1,281,1,1,0,1,1,142,141,140,140,20
"1805",4,"[25]joIoHcoxHnJHGqKCaCHbBBBJe",274,0.996364,25,275,1,274,1,1,0,1,1,136,135,139,139,20
"1806",5,"[25]joIoHcoxHnJHGqKCaCHbBBBJe",290,0.996564,25,291,1,290,1,1,0,1,1,159,158,132,132,20
"1807",6,"[25]joIoHcoxHnJHGqKCaCHbBBBJe",282,0.996466,25,283,1,282,1,1,0,1,1,151,150,132,132,20
"1808",7,"[25]joIoHcoxHnJHGqKCaCHbBBBJe",281,0.996454,25,282,1,281,1,1,0,1,1,135,134,147,147,20
"1809",8,"[25]joIoHcoxHnJHGqKCaCHbBBBJe",281,0.996454,25,282,1,281,1,1,0,1,1,133,132,149,149,20
"1810",9,"[25]joIoHcoxHnJHGqKCaCHbBBBJe",275,0.996377,25,276,1,275,1,1,0,1,1,143,142,133,133,20
"1811",10,"[25]joIoHcoxHnJHGqKCaCHbBBBJe",276,0.99639,25,277,1,276,1,1,0,1,1,129,128,148,148,20
"1812",11,"[25]joIoHcoxHnJHGqKCaCHbBBBJe",283,0.996479,25,284,1,283,1,1,0,1,1,138,137,146,146,20
"1813",12,"[25]joIoHcoxHnJHGqKCaCHbBBBJe",277,0.996403,25,278,1,277,1,1,0,1,1,134,133,144,144,20
"1814",13,"[25]joIoHcoxHnJHGqKCaCHbBBBJe",284,0.996491,25,285,1,284,1,1,0,1,1,144,143,141,141,20
"1815",14,"[25]joIoHcoxHnJHGqKCaCHbBBBJe",291,0.996575,25,292,1,291,1,1,0,1,1,153,152,139,139,20
"1816",15,"[25]joIoHcoxHnJHGqKCaCHbBBBJe",280,0.996441,25,281,1,280,1,1,0,1,1,140,139,141,141,20
"1817",16,"[25]joIoHcoxHnJHGqKCaCHbBBBJe",282,0.996466,25,283,1,282,1,1,0,1,1,129,128,154,154,20
"1818",17,"[25]joIoHcoxHnJHGqKCaCHbBBBJe",279,0.996429,25,280,1,279,1,1,0,1,1,150,149,130,130,20
"1819",18,"[25]joIoHcoxHnJHGqKCaCHbBBBJe",281,0.996454,25,282,1,281,1,1,0,1,1,142,141,140,140,20
"1820",19,"[25]joIoHcoxHnJHGqKCaCHbBBBJe",284,0.996491,25,285,1,284,1,1,0,1,1,147,146,138,138,20
"1821",20,"[25]joIoHcoxHnJHGqKCaCHbBBBJe",284,0.996491,25,285,1,284,1,1,0,1,1,145,144,140,140,20
"1822",21,"[25]joIoHcoxHnJHGqKCaCHbBBBJe",277,0.996403,25,278,1,277,1,1,0,1,1,134,133,144,144,20
"1823",22,"[25]joIoHcoxHnJHGqKCaCHbBBBJe",279,0.996429,25,280,1,279,1,1,0,1,1,138,137,142,142,20
"1824",23,"[25]joIoHcoxHnJHGqKCaCHbBBBJe",279,0.996429,25,280,1,279,1,1,0,1,1,154,153,126,126,20
"1825",24,"[25]joIoHcoxHnJHGqKCaCHbBBBJe",279,0.996429,25,280,1,279,1,1,0,1,1,122,121,158,158,20
"1826",25,"[25]joIoHcoxHnJHGqKCaCHbBBBJe",284,0.996491,25,285,1,284,1,1,0,1,1,161,160,124,124,20
"1827",26,"[25]joIoHcoxHnJHGqKCaCHbBBBJe",280,0.996441,25,281,1,280,1,1,0,1,1,130,129,151,151,20
"1828",27,"[25]joIoHcoxHnJHGqKCaCHbBBBJe",283,0.996479,25,284,1,283,1,1,0,1,1,139,138,145,145,20
"1829",28,"[25]joIoHcoxHnJHGqKCaCHbBBBJe",285,0.996503,25,286,1,285,1,1,0,1,1,148,147,138,138,20
"1830",29,"[25]joIoHcoxHnJHGqKCaCHbBBBJe",286,0.996516,25,287,1,286,1,1,0,1,1,151,150,136,136,20
"1831",30,"[25]joIoHcoxHnJHGqKCaCHbBBBJe",280,0.996441,25,281,1,280,1,1,0,1,1,142,141,139,139,20
"1832",31,"[25]joIoHcoxHnJHGqKCaCHbBBBJe",283,0.996479,25,284,1,283,1,1,0,1,1,158,157,126,126,20
"1833",32,"[25]joIoHcoxHnJHGqKCaCHbBBBJe",276,0.99639,25,277,1,276,1,1,0,1,1,142,141,135,135,20
"1834",33,"[25]joIoHcoxHnJHGqKCaCHbBBBJe",296,0.996633,25,297,1,296,1,1,0,1,1,158,157,139,139,20
"1835",34,"[25]joIoHcoxHnJHGqKCaCHbBBBJe",276,0.99639,25,277,1,276,1,1,0,1,1,151,150,126,126,20
"1836",35,"[25]joIoHcoxHnJHGqKCaCHbBBBJe",279,0.996429,25,280,1,279,1,1,0,1,1,139,138,141,141,20
"1837",36,"[25]joIoHcoxHnJHGqKCaCHbBBBJe",271,0.996324,25,272,1,271,1,1,0,1,1,133,132,139,139,20
"1838",37,"[25]joIoHcoxHnJHGqKCaCHbBBBJe",282,0.996466,25,283,1,282,1,1,0,1,1,137,136,146,146,20
"1839",38,"[25]joIoHcoxHnJHGqKCaCHbBBBJe",279,0.996429,25,280,1,279,1,1,0,1,1,129,128,151,151,20
"1840",39,"[25]joIoHcoxHnJHGqKCaCHbBBBJe",278,0.996416,25,279,1,278,1,1,0,1,1,138,137,141,141,20
"1841",40,"[25]joIoHcoxHnJHGqKCaCHbBBBJe",283,0.996479,25,284,1,283,1,1,0,1,1,151,150,133,133,20
"1842",41,"[25]joIoHcoxHnJHGqKCaCHbBBBJe",279,0.996429,25,280,1,279,1,1,0,1,1,145,144,135,135,20
"1843",42,"[25]joIoHcoxHnJHGqKCaCHbBBBJe",281,0.996454,25,282,1,281,1,1,0,1,1,127,126,155,155,20
"1844",43,"[25]joIoHcoxHnJHGqKCaCHbBBBJe",279,0.996429,25,280,1,279,1,1,0,1,1,143,142,137,137,20
"1845",44,"[25]joIoHcoxHnJHGqKCaCHbBBBJe",287,0.996528,25,288,1,287,1,1,0,1,1,156,155,132,132,20
"1846",45,"[25]joIoHcoxHnJHGqKCaCHbBBBJe",265,0.996241,25,266,1,265,1,1,0,1,1,135,134,131,131,20
"1847",46,"[25]joIoHcoxHnJHGqKCaCHbBBBJe",281,0.996454,25,282,1,281,1,1,0,1,1,144,143,138,138,20
"1848",47,"[25]joIoHcoxHnJHGqKCaCHbBBBJe",283,0.996479,25,284,1,283,1,1,0,1,1,151,150,133,133,20
"1849",48,"[25]joIoHcoxHnJHGqKCaCHbBBBJe",287,0.996528,25,288,1,287,1,1,0,1,1,143,142,145,145,20
"1850",49,"[25]joIoHcoxHnJHGqKCaCHbBBBJe",286,0.996516,25,287,1,286,1,1,0,1,1,154,153,133,133,20
"1851",50,"[25]joIoHcoxHnJHGqKCaCHbBBBJe",282,0.996466,25,283,1,282,1,1,0,1,1,138,137,145,145,20
"1852",51,"[25]joIoHcoxHnJHGqKCaCHbBBBJe",280,0.996441,25,281,1,280,1,1,0,1,1,144,143,137,137,20
"1853",52,"[25]joIoHcoxHnJHGqKCaCHbBBBJe",278,0.996416,25,279,1,278,1,1,0,1,1,133,132,146,146,20
"1854",53,"[25]joIoHcoxHnJHGqKCaCHbBBBJe",281,0.996454,25,282,1,281,1,1,0,1,1,150,149,132,132,20
"1855",54,"[25]joIoHcoxHnJHGqKCaCHbBBBJe",285,0.996503,25,286,1,285,1,1,0,1,1,160,159,126,126,20
"1856",55,"[25]joIoHcoxHnJHGqKCaCHbBBBJe",283,0.996479,25,284,1,283,1,1,0,1,1,145,144,139,139,20
"1857",56,"[25]joIoHcoxHnJHGqKCaCHbBBBJe",287,0.996528,25,288,1,287,1,1,0,1,1,147,146,141,141,20
"1858",57,"[25]joIoHcoxHnJHGqKCaCHbBBBJe",290,0.996564,25,291,1,290,1,1,0,1,1,167,166,124,124,20
"1859",58,"[25]joIoHcoxHnJHGqKCaCHbBBBJe",276,0.99639,25,277,1,276,1,1,0,1,1,152,151,125,125,20
"1860",59,"[25]joIoHcoxHnJHGqKCaCHbBBBJe",287,0.996528,25,288,1,287,1,1,0,1,1,140,139,148,148,20
"1861",60,"[25]joIoHcoxHnJHGqKCaCHbBBBJe",274,0.996364,25,275,1,274,1,1,0,1,1,130,129,145,145,20
"1862",61,"[25]joIoHcoxHnJHGqKCaCHbBBBJe",283,0.996479,25,284,1,283,1,1,0,1,1,141,140,143,143,20
"1863",62,"[25]joIoHcoxHnJHGqKCaCHbBBBJe",286,0.996516,25,287,1,286,1,1,0,1,1,142,141,145,145,20
"1864",63,"[25]joIoHcoxHnJHGqKCaCHbBBBJe",283,0.996479,25,284,1,283,1,1,0,1,1,139,138,145,145,20
"1865",64,"[25]joIoHcoxHnJHGqKCaCHbBBBJe",282,0.996466,25,283,1,282,1,1,0,1,1,128,127,155,155,20
"1866",65,"[25]joIoHcoxHnJHGqKCaCHbBBBJe",281,0.996454,25,282,1,281,1,1,0,1,1,139,138,143,143,20
"1867",66,"[25]joIoHcoxHnJHGqKCaCHbBBBJe",282,0.996466,25,283,1,282,1,1,0,1,1,145,144,138,138,20
"1868",67,"[25]joIoHcoxHnJHGqKCaCHbBBBJe",271,0.996324,25,272,1,271,1,1,0,1,1,137,136,135,135,20
"1869",68,"[25]joIoHcoxHnJHGqKCaCHbBBBJe",279,0.996429,25,280,1,279,1,1,0,1,1,126,125,154,154,20
"1870",69,"[25]joIoHcoxHnJHGqKCaCHbBBBJe",280,0.996441,25,281,1,280,1,1,0,1,1,130,129,151,151,20
"1871",70,"[25]joIoHcoxHnJHGqKCaCHbBBBJe",279,0.996429,25,280,1,279,1,1,0,1,1,132,131,148,148,20
"1872",71,"[25]joIoHcoxHnJHGqKCaCHbBBBJe",282,0.996466,25,283,1,282,1,1,0,1,1,143,142,140,140,20
"1873",72,"[25]joIoHcoxHnJHGqKCaCHbBBBJe",284,0.996491,25,285,1,284,1,1,0,1,1,171,170,114,114,20
"1874",73,"[25]joIoHcoxHnJHGqKCaCHbBBBJe",283,0.996479,25,284,1,283,1,1,0,1,1,142,141,142,142,20
"1875",74,"[25]joIoHcoxHnJHGqKCaCHbBBBJe",281,0.996454,25,282,1,281,1,1,0,1,1,142,141,140,140,20
"1876",75,"[25]joIoHcoxHnJHGqKCaCHbBBBJe",277,0.996403,25,278,1,277,1,1,0,1,1,135,134,143,143,20
"1877",76,"[25]joIoHcoxHnJHGqKCaCHbBBBJe",286,0.996516,25,287,1,286,1,1,0,1,1,144,143,143,143,20
"1878",77,"[25]joIoHcoxHnJHGqKCaCHbBBBJe",278,0.996416,25,279,1,278,1,1,0,1,1,139,138,140,140,20
"1879",78,"[25]joIoHcoxHnJHGqKCaCHbBBBJe",279,0.996429,25,280,1,279,1,1,0,1,1,143,142,137,137,20
"1880",79,"[25]joIoHcoxHnJHGqKCaCHbBBBJe",277,0.996403,25,278,1,277,1,1,0,1,1,135,134,143,143,20
"1881",80,"[25]joIoHcoxHnJHGqKCaCHbBBBJe",281,0.996454,25,282,1,281,1,1,0,1,1,139,138,143,143,20
"1882",81,"[25]joIoHcoxHnJHGqKCaCHbBBBJe",281,0.996454,25,282,1,281,1,1,0,1,1,133,132,149,149,20
"1883",82,"[25]joIoHcoxHnJHGqKCaCHbBBBJe",276,0.99639,25,277,1,276,1,1,0,1,1,141,140,136,136,20
"1884",83,"[25]joIoHcoxHnJHGqKCaCHbBBBJe",282,0.996466,25,283,1,282,1,1,0,1,1,146,145,137,137,20
"1885",84,"[25]joIoHcoxHnJHGqKCaCHbBBBJe",284,0.996491,25,285,1,284,1,1,0,1,1,147,146,138,138,20
"1886",85,"[25]joIoHcoxHnJHGqKCaCHbBBBJe",283,0.996479,25,284,1,283,1,1,0,1,1,144,143,140,140,20
"1887",86,"[25]joIoHcoxHnJHGqKCaCHbBBBJe",283,0.996479,25,284,1,283,1,1,0,1,1,134,133,150,150,20
"1888",87,"[25]joIoHcoxHnJHGqKCaCHbBBBJe",289,0.996552,25,290,1,289,1,1,0,1,1,150,149,140,140,20
"1889",88,"[25]joIoHcoxHnJHGqKCaCHbBBBJe",272,0.996337,25,273,1,272,1,1,0,1,1,148,147,125,125,20
"1890",89,"[25]joIoHcoxHnJHGqKCaCHbBBBJe",284,0.996491,25,285,1,284,1,1,0,1,1,148,147,137,137,20
"1891",90,"[25]joIoHcoxHnJHGqKCaCHbBBBJe",289,0.996552,25,290,1,289,1,1,0,1,1,154,153,136,136,20
"1892",91,"[25]joIoHcoxHnJHGqKCaCHbBBBJe",279,0.996429,25,280,1,279,1,1,0,1,1,141,140,139,139,20
"1893",92,"[25]joIoHcoxHnJHGqKCaCHbBBBJe",278,0.996416,25,279,1,278,1,1,0,1,1,153,152,126,126,20
"1894",93,"[25]joIoHcoxHnJHGqKCaCHbBBBJe",284,0.996491,25,285,1,284,1,1,0,1,1,157,156,128,128,20
"1895",94,"[25]joIoHcoxHnJHGqKCaCHbBBBJe",288,0.99654,25,289,1,288,1,1,0,1,1,150,149,139,139,20
"1896",95,"[25]joIoHcoxHnJHGqKCaCHbBBBJe",281,0.996454,25,282,1,281,1,1,0,1,1,139,138,143,143,20
"1897",96,"[25]joIoHcoxHnJHGqKCaCHbBBBJe",278,0.996416,25,279,1,278,1,1,0,1,1,138,137,141,141,20
"1898",97,"[25]joIoHcoxHnJHGqKCaCHbBBBJe",278,0.996416,25,279,1,278,1,1,0,1,1,133,132,146,146,20
"1899",98,"[25]joIoHcoxHnJHGqKCaCHbBBBJe",284,0.996491,25,285,1,284,1,1,0,1,1,144,143,141,141,20
"1900",99,"[25]joIoHcoxHnJHGqKCaCHbBBBJe",282,0.996466,25,283,1,282,1,1,0,1,1,139,138,144,144,20
"1901",0,"[22]mzHoIoHcotHnJqGKCgtrBd",301,0.996689,22,302,1,301,1,1,0,1,1,160,159,142,142,21
"1902",1,"[22]mzHoIoHcotHnJqGKCgtrBd",298,0.996656,22,299,1,298,1,1,0,1,1,147,146,152,152,21
"1903",2,"[22]mzHoIoHcotHnJqGKCgtrBd",300,0.996678,22,301,1,300,1,1,0,1,1,162,161,139,139,21
"1904",3,"[22]mzHoIoHcotHnJqGKCgtrBd",297,0.996644,22,298,1,297,1,1,0,1,1,153,152,145,145,21
"1905",4,"[22]mzHoIoHcotHnJqGKCgtrBd",292,0.996587,22,293,1,292,1,1,0,1,1,138,137,155,155,21
"1906",5,"[22]mzHoIoHcotHnJqGKCgtrBd",293,0.996599,22,294,1,293,1,1,0,1,1,139,138,155,155,21
"1907",6,"[22]mzHoIoHcotHnJqGKCgtrBd",297,0.996644,22,298,1,297,1,1,0,1,1,152,151,146,146,21
"1908",7,"[22]mzHoIoHcotHnJqGKCgtrBd",292,0.996587,22,293,1,292,1,1,0,1,1,136,135,157,157,21
"1909",8,"[22]mzHoIoHcotHnJqGKCgtrBd",296,0.996633,22,297,1,296,1,1,0,1,1,151,150,146,146,21
"1910",9,"[22]mzHoIoHcotHnJqGKCgtrBd",290,0.996564,22,291,1,290,1,1,0,1,1,131,130,160,160,21
"1911",10,"[22]mzHoIoHcotHnJqGKCgtrBd",288,0.99654,22,289,1,288,1,1,0,1,1,141,140,148,148,21
"1912",11,"[22]mzHoIoHcotHnJqGKCgtrBd",303,0.996711,22,304,1,303,1,1,0,1,1,166,165,138,138,21
"1913",12,"[22]mzHoIoHcotHnJqGKCgtrBd",291,0.996575,22,292,1,291,1,1,0,1,1,135,134,157,157,21
"1914",13,"[22]mzHoIoHcotHnJqGKCgtrBd",300,0.996678,22,301,1,300,1,1,0,1,1,157,156,144,144,21
"1915",14,"[22]mzHoIoHcotHnJqGKCgtrBd",298,0.996656,22,299,1,298,1,1,0,1,1,154,153,145,145,21
"1916",15,"[22]mzHoIoHcotHnJqGKCgtrBd",294,0.99661,22,295,1,294,1,1,0,1,1,144,143,151,151,21
"1917",16,"[22]mzHoIoHcotHnJqGKCgtrBd",295,0.996622,22,296,1,295,1,1,0,1,1,142,141,154,154,21
"1918",17,"[22]mzHoIoHcotHnJqGKCgtrBd",293,0.996599,22,294,1,293,1,1,0,1,1,143,142,151,151,21
"1919",18,"[22]mzHoIoHcotHnJqGKCgtrBd",300,0.996678,22,301,1,300,1,1,0,1,1,156,155,145,145,21
"1920",19,"[22]mzHoIoHcotHnJqGKCgtrBd",292,0.996587,22,293,1,292,1,1,0,1,1,143,142,150,150,21
"1921",20,"[22]mzHoIoHcotHnJqGKCgtrBd",292,0.996587,22,293,1,292,1,1,0,1,1,136,135,157,157,21
"1922",21,"[22]mzHoIoHcotHnJqGKCgtrBd",290,0.996564,22,291,1,290,1,1,0,1,1,131,130,160,160,21
"1923",22,"[22]mzHoIoHcotHnJqGKCgtrBd",293,0.996599,22,294,1,293,1,1,0,1,1,153,152,141,141,21
"1924",23,"[22]mzHoIoHcotHnJqGKCgtrBd",292,0.996587,22,293,1,292,1,1,0,1,1,148,147,145,145,21
"1925",24,"[22]mzHoIoHcotHnJqGKCgtrBd",295,0.996622,22,296,1,295,1,1,0,1,1,145,144,151,151,21
"1926",25,"[22]mzHoIoHcotHnJqGKCgtrBd",293,0.996599,22,294,1,293,1,1,0,1,1,139,138,155,155,21
"1927",26,"[22]mzHoIoHcotHnJqGKCgtrBd",291,0.996575,22,292,1,291,1,1,0,1,1,135,134,157,157,21
"1928",27,"[22]mzHoIoHcotHnJqGKCgtrBd",293,0.996599,22,294,1,293,1,1,0,1,1,139,138,155,155,21
"1929",28,"[22]mzHoIoHcotHnJqGKCgtrBd",293,0.996599,22,294,1,293,1,1,0,1,1,141,140,153,153,21
"1930",29,"[22]mzHoIoHcotHnJqGKCgtrBd",296,0.996633,22,297,1,296,1,1,0,1,1,152,151,145,145,21
"1931",30,"[22]mzHoIoHcotHnJqGKCgtrBd",296,0.996633,22,297,1,296,1,1,0,1,1,148,147,149,149,21
"1932",31,"[22]mzHoIoHcotHnJqGKCgtrBd",293,0.996599,22,294,1,293,1,1,0,1,1,142,141,152,152,21
"1933",32,"[22]mzHoIoHcotHnJqGKCgtrBd",298,0.996656,22,299,1,298,1,1,0,1,1,159,158,140,140,21
"1934",33,"[22]mzHoIoHcotHnJqGKCgtrBd",294,0.99661,22,295,1,294,1,1,0,1,1,150,149,145,145,21
"1935",34,"[22]mzHoIoHcotHnJqGKCgtrBd",294,0.99661,22,295,1,294,1,1,0,1,1,146,145,149,149,21
"1936",35,"[22]mzHoIoHcotHnJqGKCgtrBd",306,0.996743,22,307,1,306,1,1,0,1,1,170,169,137,137,21
"1937",36,"[22]mzHoIoHcotHnJqGKCgtrBd",293,0.996599,22,294,1,293,1,1,0,1,1,153,152,141,141,21
"1938",37,"[22]mzHoIoHcotHnJqGKCgtrBd",296,0.996633,22,297,1,296,1,1,0,1,1,149,148,148,148,21
"1939",38,"[22]mzHoIoHcotHnJqGKCgtrBd",298,0.996656,22,299,1,298,1,1,0,1,1,154,153,145,145,21
"1940",39,"[22]mzHoIoHcotHnJqGKCgtrBd",292,0.996587,22,293,1,292,1,1,0,1,1,137,136,156,156,21
"1941",40,"[22]mzHoIoHcotHnJqGKCgtrBd",302,0.9967,22,303,1,302,1,1,0,1,1,167,166,136,136,21
"1942",41,"[22]mzHoIoHcotHnJqGKCgtrBd",295,0.996622,22,296,1,295,1,1,0,1,1,146,145,150,150,21
"1943",42,"[22]mzHoIoHcotHnJqGKCgtrBd",289,0.996552,22,290,1,289,1,1,0,1,1,132,131,158,158,21
"1944",43,"[22]mzHoIoHcotHnJqGKCgtrBd",298,0.996656,22,299,1,298,1,1,0,1,1,152,151,147,147,21
"1945",44,"[22]mzHoIoHcotHnJqGKCgtrBd",299,0.996667,22,300,1,299,1,1,0,1,1,157,156,143,143,21
"1946",45,"[22]mzHoIoHcotHnJqGKCgtrBd",296,0.996633,22,297,1,296,1,1,0,1,1,151,150,146,146,21
"1947",46,"[22]mzHoIoHcotHnJqGKCgtrBd",293,0.996599,22,294,1,293,1,1,0,1,1,142,141,152,152,21
"1948",47,"[22]mzHoIoHcotHnJqGKCgtrBd",297,0.996644,22,298,1,297,1,1,0,1,1,150,149,148,148,21
"1949",48,"[22]mzHoIoHcotHnJqGKCgtrBd",294,0.99661,22,295,1,294,1,1,0,1,1,139,138,156,156,21
"1950",49,"[22]mzHoIoHcotHnJqGKCgtrBd",294,0.99661,22,295,1,294,1,1,0,1,1,144,143,151,151,21
"1951",50,"[22]mzHoIoHcotHnJqGKCgtrBd",291,0.996575,22,292,1,291,1,1,0,1,1,143,142,149,149,21
"1952",51,"[22]mzHoIoHcotHnJqGKCgtrBd",295,0.996622,22,296,1,295,1,1,0,1,1,147,146,149,149,21
"1953",52,"[22]mzHoIoHcotHnJqGKCgtrBd",296,0.996633,22,297,1,296,1,1,0,1,1,152,151,145,145,21
"1954",53,"[22]mzHoIoHcotHnJqGKCgtrBd",295,0.996622,22,296,1,295,1,1,0,1,1,150,149,146,146,21
"1955",54,"[22]mzHoIoHcotHnJqGKCgtrBd",293,0.996599,22,294,1,293,1,1,0,1,1,149,148,145,145,21
"1956",55,"[22]mzHoIoHcotHnJqGKCgtrBd",299,0.996667,22,300,1,299,1,1,0,1,1,161,160,139,139,21
"1957",56,"[22]mzHoIoHcotHnJqGKCgtrBd",297,0.996644,22,298,1,297,1,1,0,1,1,146,145,152,152,21
"1958",57,"[22]mzHoIoHcotHnJqGKCgtrBd",293,0.996599,22,294,1,293,1,1,0,1,1,150,149,144,144,21
"1959",58,"[22]mzHoIoHcotHnJqGKCgtrBd",294,0.99661,22,295,1,294,1,1,0,1,1,143,142,152,152,21
"1960",59,"[22]mzHoIoHcotHnJqGKCgtrBd",299,0.996667,22,300,1,299,1,1,0,1,1,160,159,140,140,21
"1961",60,"[22]mzHoIoHcotHnJqGKCgtrBd",288,0.99654,22,289,1,288,1,1,0,1,1,124,123,165,165,21
"1962",61,"[22]mzHoIoHcotHnJqGKCgtrBd",294,0.99661,22,295,1,294,1,1,0,1,1,150,149,145,145,21
"1963",62,"[22]mzHoIoHcotHnJqGKCgtrBd",301,0.996689,22,302,1,301,1,1,0,1,1,165,164,137,137,21
"1964",63,"[22]mzHoIoHcotHnJqGKCgtrBd",306,0.996743,22,307,1,306,1,1,0,1,1,179,178,128,128,21
"1965",64,"[22]mzHoIoHcotHnJqGKCgtrBd",293,0.996599,22,294,1,293,1,1,0,1,1,143,142,151,151,21
"1966",65,"[22]mzHoIoHcotHnJqGKCgtrBd",291,0.996575,22,292,1,291,1,1,0,1,1,139,138,153,153,21
"1967",66,"[22]mzHoIoHcotHnJqGKCgtrBd",299,0.996667,22,300,1,299,1,1,0,1,1,166,165,134,134,21
"1968",67,"[22]mzHoIoHcotHnJqGKCgtrBd",295,0.996622,22,296,1,295,1,1,0,1,1,149,148,147,147,21
"1969",68,"[22]mzHoIoHcotHnJqGKCgtrBd",297,0.996644,22,298,1,297,1,1,0,1,1,158,157,140,140,21
"1970",69,"[22]mzHoIoHcotHnJqGKCgtrBd",297,0.996644,22,298,1,297,1,1,0,1,1,153,152,145,145,21
"1971",70,"[22]mzHoIoHcotHnJqGKCgtrBd",299,0.996667,22,300,1,299,1,1,0,1,1,159,158,141,141,21
"1972",71,"[22]mzHoIoHcotHnJqGKCgtrBd",300,0.996678,22,301,1,300,1,1,0,1,1,160,159,141,141,21
"1973",72,"[22]mzHoIoHcotHnJqGKCgtrBd",293,0.996599,22,294,1,293,1,1,0,1,1,136,135,158,158,21
"1974",73,"[22]mzHoIoHcotHnJqGKCgtrBd",297,0.996644,22,298,1,297,1,1,0,1,1,147,146,151,151,21
"1975",74,"[22]mzHoIoHcotHnJqGKCgtrBd",296,0.996633,22,297,1,296,1,1,0,1,1,159,158,138,138,21
"1976",75,"[22]mzHoIoHcotHnJqGKCgtrBd",288,0.99654,22,289,1,288,1,1,0,1,1,128,127,161,161,21
"1977",76,"[22]mzHoIoHcotHnJqGKCgtrBd",299,0.996667,22,300,1,299,1,1,0,1,1,154,153,146,146,21
"1978",77,"[22]mzHoIoHcotHnJqGKCgtrBd",302,0.9967,22,303,1,302,1,1,0,1,1,167,166,136,136,21
"1979",78,"[22]mzHoIoHcotHnJqGKCgtrBd",302,0.9967,22,303,1,302,1,1,0,1,1,168,167,135,135,21
"1980",79,"[22]mzHoIoHcotHnJqGKCgtrBd",300,0.996678,22,301,1,300,1,1,0,1,1,165,164,136,136,21
"1981",80,"[22]mzHoIoHcotHnJqGKCgtrBd",291,0.996575,22,292,1,291,1,1,0,1,1,140,139,152,152,21
"1982",81,"[22]mzHoIoHcotHnJqGKCgtrBd",299,0.996667,22,300,1,299,1,1,0,1,1,154,153,146,146,21
"1983",82,"[22]mzHoIoHcotHnJqGKCgtrBd",295,0.996622,22,296,1,295,1,1,0,1,1,150,149,146,146,21
"1984",83,"[22]mzHoIoHcotHnJqGKCgtrBd",294,0.99661,22,295,1,294,1,1,0,1,1,143,142,152,152,21
"1985",84,"[22]mzHoIoHcotHnJqGKCgtrBd",295,0.996622,22,296,1,295,1,1,0,1,1,148,147,148,148,21
"1986",85,"[22]mzHoIoHcotHnJqGKCgtrBd",295,0.996622,22,296,1,295,1,1,0,1,1,144,143,152,152,21
"1987",86,"[22]mzHoIoHcotHnJqGKCgtrBd",296,0.996633,22,297,1,296,1,1,0,1,1,153,152,144,144,21
"1988",87,"[22]mzHoIoHcotHnJqGKCgtrBd",298,0.996656,22,299,1,298,1,1,0,1,1,158,157,141,141,21
"1989",88,"[22]mzHoIoHcotHnJqGKCgtrBd",299,0.996667,22,300,1,299,1,1,0,1,1,161,160,139,139,21
"1990",89,"[22]mzHoIoHcotHnJqGKCgtrBd",297,0.996644,22,298,1,297,1,1,0,1,1,155,154,143,143,21
"1991",90,"[22]mzHoIoHcotHnJqGKCgtrBd",300,0.996678,22,301,1,300,1,1,0,1,1,160,159,141,141,21
"1992",91,"[22]mzHoIoHcotHnJqGKCgtrBd",295,0.996622,22,296,1,295,1,1,0,1,1,149,148,147,147,21
"1993",92,"[22]mzHoIoHcotHnJqGKCgtrBd",289,0.996552,22,290,1,289,1,1,0,1,1,127,126,163,163,21
"1994",93,"[22]mzHoIoHcotHnJqGKCgtrBd",292,0.996587,22,293,1,292,1,1,0,1,1,137,136,156,156,21
"1995",94,"[22]mzHoIoHcotHnJqGKCgtrBd",286,0.996516,22,287,1,286,1,1,0,1,1,133,132,154,154,21
"1996",95,"[22]mzHoIoHcotHnJqGKCgtrBd",298,0.996656,22,299,1,298,1,1,0,1,1,157,156,142,142,21
"1997",96,"[22]mzHoIoHcotHnJqGKCgtrBd",293,0.996599,22,294,1,293,1,1,0,1,1,143,142,151,151,21
"1998",97,"[22]mzHoIoHcotHnJqGKCgtrBd",295,0.996622,22,296,1,295,1,1,0,1,1,146,145,150,150,21
"1999",98,"[22]mzHoIoHcotHnJqGKCgtrBd",294,0.99661,22,295,1,294,1,1,0,1,1,144,143,151,151,21
"2000",99,"[22]mzHoIoHcotHnJqGKCgtrBd",297,0.996644,22,298,1,297,1,1,0,1,1,150,149,148,148,21
"2001",0,"[19]BHoIoHcoxHnJqGKCHIj",301,0.996689,19,302,1,301,1,1,0,1,1,162,161,140,140,22
"2002",1,"[19]BHoIoHcoxHnJqGKCHIj",295,0.996622,19,296,1,295,1,1,0,1,1,146,145,150,150,22
"2003",2,"[19]BHoIoHcoxHnJqGKCHIj",300,0.996678,19,301,1,300,1,1,0,1,1,157,156,144,144,22
"2004",3,"[19]BHoIoHcoxHnJqGKCHIj",298,0.996656,19,299,1,298,1,1,0,1,1,151,150,148,148,22
"2005",4,"[19]BHoIoHcoxHnJqGKCHIj",299,0.996667,19,300,1,299,1,1,0,1,1,150,149,150,150,22
"2006",5,"[19]BHoIoHcoxHnJqGKCHIj",292,0.996587,19,293,1,292,1,1,0,1,1,135,134,158,158,22
"2007",6,"[19]BHoIoHcoxHnJqGKCHIj",299,0.996667,19,300,1,299,1,1,0,1,1,155,154,145,145,22
"2008",7,"[19]BHoIoHcoxHnJqGKCHIj",299,0.996667,19,300,1,299,1,1,0,1,1,156,155,144,144,22
"2009",8,"[19]BHoIoHcoxHnJqGKCHIj",293,0.996599,19,294,1,293,1,1,0,1,1,139,138,155,155,22
"2010",9,"[19]BHoIoHcoxHnJqGKCHIj",295,0.996622,19,296,1,295,1,1,0,1,1,148,147,148,148,22
"2011",10,"[19]BHoIoHcoxHnJqGKCHIj",296,0.996633,19,297,1,296,1,1,0,1,1,150,149,147,147,22
"2012",11,"[19]BHoIoHcoxHnJqGKCHIj",296,0.996633,19,297,1,296,1,1,0,1,1,150,149,147,147,22
"2013",12,"[19]BHoIoHcoxHnJqGKCHIj",293,0.996599,19,294,1,293,1,1,0,1,1,139,138,155,155,22
"2014",13,"[19]BHoIoHcoxHnJqGKCHIj",297,0.996644,19,298,1,297,1,1,0,1,1,152,151,146,146,22
"2015",14,"[19]BHoIoHcoxHnJqGKCHIj",295,0.996622,19,296,1,295,1,1,0,1,1,146,145,150,150,22
"2016",15,"[19]BHoIoHcoxHnJqGKCHIj",295,0.996622,19,296,1,295,1,1,0,1,1,142,141,154,154,22
"2017",16,"[19]BHoIoHcoxHnJqGKCHIj",296,0.996633,19,297,1,296,1,1,0,1,1,145,144,152,152,22
"2018",17,"[19]BHoIoHcoxHnJqGKCHIj",293,0.996599,19,294,1,293,1,1,0,1,1,143,142,151,151,22
"2019",18,"[19]BHoIoHcoxHnJqGKCHIj",292,0.996587,19,293,1,292,1,1,0,1,1,137,136,156,156,22
"2020",19,"[19]BHoIoHcoxHnJqGKCHIj",304,0.996721,19,305,1,304,1,1,0,1,1,177,176,128,128,22
"2021",20,"[19]BHoIoHcoxHnJqGKCHIj",300,0.996678,19,301,1,300,1,1,0,1,1,161,160,140,140,22
"2022",21,"[19]BHoIoHcoxHnJqGKCHIj",296,0.996633,19,297,1,296,1,1,0,1,1,143,142,154,154,22
"2023",22,"[19]BHoIoHcoxHnJqGKCHIj",301,0.996689,19,302,1,301,1,1,0,1,1,162,161,140,140,22
"2024",23,"[19]BHoIoHcoxHnJqGKCHIj",288,0.99654,19,289,1,288,1,1,0,1,1,129,128,160,160,22
"2025",24,"[19]BHoIoHcoxHnJqGKCHIj",296,0.996633,19,297,1,296,1,1,0,1,1,151,150,146,146,22
"2026",25,"[19]BHoIoHcoxHnJqGKCHIj",294,0.99661,19,295,1,294,1,1,0,1,1,147,146,148,148,22
"2027",26,"[19]BHoIoHcoxHnJqGKCHIj",295,0.996622,19,296,1,295,1,1,0,1,1,149,148,147,147,22
"2028",27,"[19]BHoIoHcoxHnJqGKCHIj",297,0.996644,19,298,1,297,1,1,0,1,1,150,149,148,148,22
"2029",28,"[19]BHoIoHcoxHnJqGKCHIj",291,0.996575,19,292,1,291,1,1,0,1,1,138,137,154,154,22
"2030",29,"[19]BHoIoHcoxHnJqGKCHIj",313,0.996815,19,314,1,313,1,1,0,1,1,186,185,128,128,22
"2031",30,"[19]BHoIoHcoxHnJqGKCHIj",295,0.996622,19,296,1,295,1,1,0,1,1,147,146,149,149,22
"2032",31,"[19]BHoIoHcoxHnJqGKCHIj",304,0.996721,19,305,1,304,1,1,0,1,1,170,169,135,135,22
"2033",32,"[19]BHoIoHcoxHnJqGKCHIj",295,0.996622,19,296,1,295,1,1,0,1,1,144,143,152,152,22
"2034",33,"[19]BHoIoHcoxHnJqGKCHIj",296,0.996633,19,297,1,296,1,1,0,1,1,147,146,150,150,22
"2035",34,"[19]BHoIoHcoxHnJqGKCHIj",292,0.996587,19,293,1,292,1,1,0,1,1,139,138,154,154,22
"2036",35,"[19]BHoIoHcoxHnJqGKCHIj",292,0.996587,19,293,1,292,1,1,0,1,1,143,142,150,150,22
"2037",36,"[19]BHoIoHcoxHnJqGKCHIj",298,0.996656,19,299,1,298,1,1,0,1,1,168,167,131,131,22
"2038",37,"[19]BHoIoHcoxHnJqGKCHIj",297,0.996644,19,298,1,297,1,1,0,1,1,162,161,136,136,22
"2039",38,"[19]BHoIoHcoxHnJqGKCHIj",291,0.996575,19,292,1,291,1,1,0,1,1,142,141,150,150,22
"2040",39,"[19]BHoIoHcoxHnJqGKCHIj",296,0.996633,19,297,1,296,1,1,0,1,1,152,151,145,145,22
"2041",40,"[19]BHoIoHcoxHnJqGKCHIj",294,0.99661,19,295,1,294,1,1,0,1,1,145,144,150,150,22
"2042",41,"[19]BHoIoHcoxHnJqGKCHIj",299,0.996667,19,300,1,299,1,1,0,1,1,154,153,146,146,22
"2043",42,"[19]BHoIoHcoxHnJqGKCHIj",301,0.996689,19,302,1,301,1,1,0,1,1,163,162,139,139,22
"2044",43,"[19]BHoIoHcoxHnJqGKCHIj",303,0.996711,19,304,1,303,1,1,0,1,1,161,160,143,143,22
"2045",44,"[19]BHoIoHcoxHnJqGKCHIj",302,0.9967,19,303,1,302,1,1,0,1,1,167,166,136,136,22
"2046",45,"[19]BHoIoHcoxHnJqGKCHIj",293,0.996599,19,294,1,293,1,1,0,1,1,138,137,156,156,22
"2047",46,"[19]BHoIoHcoxHnJqGKCHIj",295,0.996622,19,296,1,295,1,1,0,1,1,142,141,154,154,22
"2048",47,"[19]BHoIoHcoxHnJqGKCHIj",299,0.996667,19,300,1,299,1,1,0,1,1,159,158,141,141,22
"2049",48,"[19]BHoIoHcoxHnJqGKCHIj",294,0.99661,19,295,1,294,1,1,0,1,1,145,144,150,150,22
"2050",49,"[19]BHoIoHcoxHnJqGKCHIj",292,0.996587,19,293,1,292,1,1,0,1,1,137,136,156,156,22
"2051",50,"[19]BHoIoHcoxHnJqGKCHIj",298,0.996656,19,299,1,298,1,1,0,1,1,145,144,154,154,22
"2052",51,"[19]BHoIoHcoxHnJqGKCHIj",296,0.996633,19,297,1,296,1,1,0,1,1,148,147,149,149,22
"2053",52,"[19]BHoIoHcoxHnJqGKCHIj",294,0.99661,19,295,1,294,1,1,0,1,1,141,140,154,154,22
"2054",53,"[19]BHoIoHcoxHnJqGKCHIj",294,0.99661,19,295,1,294,1,1,0,1,1,142,141,153,153,22
"2055",54,"[19]BHoIoHcoxHnJqGKCHIj",296,0.996633,19,297,1,296,1,1,0,1,1,148,147,149,149,22
"2056",55,"[19]BHoIoHcoxHnJqGKCHIj",297,0.996644,19,298,1,297,1,1,0,1,1,151,150,147,147,22
"2057",56,"[19]BHoIoHcoxHnJqGKCHIj",297,0.996644,19,298,1,297,1,1,0,1,1,155,154,143,143,22
"2058",57,"[19]BHoIoHcoxHnJqGKCHIj",299,0.996667,19,300,1,299,1,1,0,1,1,154,153,146,146,22
"2059",58,"[19]BHoIoHcoxHnJqGKCHIj",299,0.996667,19,300,1,299,1,1,0,1,1,156,155,144,144,22
"2060",59,"[19]BHoIoHcoxHnJqGKCHIj",296,0.996633,19,297,1,296,1,1,0,1,1,147,146,150,150,22
"2061",60,"[19]BHoIoHcoxHnJqGKCHIj",298,0.996656,19,299,1,298,1,1,0,1,1,151,150,148,148,22
"2062",61,"[19]BHoIoHcoxHnJqGKCHIj",291,0.996575,19,292,1,291,1,1,0,1,1,134,133,158,158,22
"2063",62,"[19]BHoIoHcoxHnJqGKCHIj",295,0.996622,19,296,1,295,1,1,0,1,1,149,148,147,147,22
"2064",63,"[19]BHoIoHcoxHnJqGKCHIj",297,0.996644,19,298,1,297,1,1,0,1,1,151,150,147,147,22
"2065",64,"[19]BHoIoHcoxHnJqGKCHIj",303,0.996711,19,304,1,303,1,1,0,1,1,171,170,133,133,22
"2066",65,"[19]BHoIoHcoxHnJqGKCHIj",300,0.996678,19,301,1,300,1,1,0,1,1,163,162,138,138,22
"2067",66,"[19]BHoIoHcoxHnJqGKCHIj",293,0.996599,19,294,1,293,1,1,0,1,1,148,147,146,146,22
"2068",67,"[19]BHoIoHcoxHnJqGKCHIj",292,0.996587,19,293,1,292,1,1,0,1,1,135,134,158,158,22
"2069",68,"[19]BHoIoHcoxHnJqGKCHIj",296,0.996633,19,297,1,296,1,1,0,1,1,150,149,147,147,22
"2070",69,"[19]BHoIoHcoxHnJqGKCHIj",298,0.996656,19,299,1,298,1,1,0,1,1,153,152,146,146,22
"2071",70,"[19]BHoIoHcoxHnJqGKCHIj",299,0.996667,19,300,1,299,1,1,0,1,1,152,151,148,148,22
"2072",71,"[19]BHoIoHcoxHnJqGKCHIj",293,0.996599,19,294,1,293,1,1,0,1,1,139,138,155,155,22
"2073",72,"[19]BHoIoHcoxHnJqGKCHIj",291,0.996575,19,292,1,291,1,1,0,1,1,138,137,154,154,22
"2074",73,"[19]BHoIoHcoxHnJqGKCHIj",297,0.996644,19,298,1,297,1,1,0,1,1,146,145,152,152,22
"2075",74,"[19]BHoIoHcoxHnJqGKCHIj",293,0.996599,19,294,1,293,1,1,0,1,1,138,137,156,156,22
"2076",75,"[19]BHoIoHcoxHnJqGKCHIj",295,0.996622,19,296,1,295,1,1,0,1,1,144,143,152,152,22
"2077",76,"[19]BHoIoHcoxHnJqGKCHIj",302,0.9967,19,303,1,302,1,1,0,1,1,166,165,137,137,22
"2078",77,"[19]BHoIoHcoxHnJqGKCHIj",297,0.996644,19,298,1,297,1,1,0,1,1,151,150,147,147,22
"2079",78,"[19]BHoIoHcoxHnJqGKCHIj",295,0.996622,19,296,1,295,1,1,0,1,1,144,143,152,152,22
"2080",79,"[19]BHoIoHcoxHnJqGKCHIj",293,0.996599,19,294,1,293,1,1,0,1,1,145,144,149,149,22
"2081",80,"[19]BHoIoHcoxHnJqGKCHIj",287,0.996528,19,288,1,287,1,1,0,1,1,125,124,163,163,22
"2082",81,"[19]BHoIoHcoxHnJqGKCHIj",298,0.996656,19,299,1,298,1,1,0,1,1,154,153,145,145,22
"2083",82,"[19]BHoIoHcoxHnJqGKCHIj",300,0.996678,19,301,1,300,1,1,0,1,1,160,159,141,141,22
"2084",83,"[19]BHoIoHcoxHnJqGKCHIj",299,0.996667,19,300,1,299,1,1,0,1,1,168,167,132,132,22
"2085",84,"[19]BHoIoHcoxHnJqGKCHIj",299,0.996667,19,300,1,299,1,1,0,1,1,158,157,142,142,22
"2086",85,"[19]BHoIoHcoxHnJqGKCHIj",297,0.996644,19,298,1,297,1,1,0,1,1,152,151,146,146,22
"2087",86,"[19]BHoIoHcoxHnJqGKCHIj",303,0.996711,19,304,1,303,1,1,0,1,1,165,164,139,139,22
"2088",87,"[19]BHoIoHcoxHnJqGKCHIj",299,0.996667,19,300,1,299,1,1,0,1,1,146,145,154,154,22
"2089",88,"[19]BHoIoHcoxHnJqGKCHIj",296,0.996633,19,297,1,296,1,1,0,1,1,149,148,148,148,22
"2090",89,"[19]BHoIoHcoxHnJqGKCHIj",304,0.996721,19,305,1,304,1,1,0,1,1,173,172,132,132,22
"2091",90,"[19]BHoIoHcoxHnJqGKCHIj",297,0.996644,19,298,1,297,1,1,0,1,1,163,162,135,135,22
"2092",91,"[19]BHoIoHcoxHnJqGKCHIj",297,0.996644,19,298,1,297,1,1,0,1,1,150,149,148,148,22
"2093",92,"[19]BHoIoHcoxHnJqGKCHIj",295,0.996622,19,296,1,295,1,1,0,1,1,153,152,143,143,22
"2094",93,"[19]BHoIoHcoxHnJqGKCHIj",295,0.996622,19,296,1,295,1,1,0,1,1,147,146,149,149,22
"2095",94,"[19]BHoIoHcoxHnJqGKCHIj",293,0.996599,19,294,1,293,1,1,0,1,1,140,139,154,154,22
"2096",95,"[19]BHoIoHcoxHnJqGKCHIj",300,0.996678,19,301,1,300,1,1,0,1,1,153,152,148,148,22
"2097",96,"[19]BHoIoHcoxHnJqGKCHIj",298,0.996656,19,299,1,298,1,1,0,1,1,155,154,144,144,22
"2098",97,"[19]BHoIoHcoxHnJqGKCHIj",295,0.996622,19,296,1,295,1,1,0,1,1,149,148,147,147,22
"2099",98,"[19]BHoIoHcoxHnJqGKCHIj",301,0.996689,19,302,1,301,1,1,0,1,1,155,154,147,147,22
"2100",99,"[19]BHoIoHcoxHnJqGKCHIj",296,0.996633,19,297,1,296,1,1,0,1,1,150,149,147,147,22
"2101",0,"[26]gpFHoIoHcoxHnJHGqKChlEtmgj",279,0.996429,26,280,1,279,1,1,0,1,1,140,139,140,140,23
"2102",1,"[26]gpFHoIoHcoxHnJHGqKChlEtmgj",278,0.996416,26,279,1,278,1,1,0,1,1,146,145,133,133,23
"2103",2,"[26]gpFHoIoHcoxHnJHGqKChlEtmgj",283,0.996479,26,284,1,283,1,1,0,1,1,140,139,144,144,23
"2104",3,"[26]gpFHoIoHcoxHnJHGqKChlEtmgj",276,0.99639,26,277,1,276,1,1,0,1,1,141,140,136,136,23
"2105",4,"[26]gpFHoIoHcoxHnJHGqKChlEtmgj",280,0.996441,26,281,1,280,1,1,0,1,1,141,140,140,140,23
"2106",5,"[26]gpFHoIoHcoxHnJHGqKChlEtmgj",279,0.996429,26,280,1,279,1,1,0,1,1,140,139,140,140,23
"2107",6,"[26]gpFHoIoHcoxHnJHGqKChlEtmgj",274,0.996364,26,275,1,274,1,1,0,1,1,134,133,141,141,23
"2108",7,"[26]gpFHoIoHcoxHnJHGqKChlEtmgj",283,0.996479,26,284,1,283,1,1,0,1,1,154,153,130,130,23
"2109",8,"[26]gpFHoIoHcoxHnJHGqKChlEtmgj",281,0.996454,26,282,1,281,1,1,0,1,1,138,137,144,144,23
"2110",9,"[26]gpFHoIoHcoxHnJHGqKChlEtmgj",277,0.996403,26,278,1,277,1,1,0,1,1,129,128,149,149,23
"2111",10,"[26]gpFHoIoHcoxHnJHGqKChlEtmgj",278,0.996416,26,279,1,278,1,1,0,1,1,147,146,132,132,23
"2112",11,"[26]gpFHoIoHcoxHnJHGqKChlEtmgj",281,0.996454,26,282,1,281,1,1,0,1,1,162,161,120,120,23
"2113",12,"[26]gpFHoIoHcoxHnJHGqKChlEtmgj",279,0.996429,26,280,1,279,1,1,0,1,1,134,133,146,146,23
"2114",13,"[26]gpFHoIoHcoxHnJHGqKChlEtmgj",284,0.996491,26,285,1,284,1,1,0,1,1,143,142,142,142,23
"2115",14,"[26]gpFHoIoHcoxHnJHGqKChlEtmgj",274,0.996364,26,275,1,274,1,1,0,1,1,123,122,152,152,23
"2116",15,"[26]gpFHoIoHcoxHnJHGqKChlEtmgj",283,0.996479,26,284,1,283,1,1,0,1,1,148,147,136,136,23
"2117",16,"[26]gpFHoIoHcoxHnJHGqKChlEtmgj",274,0.996364,26,275,1,274,1,1,0,1,1,136,135,139,139,23
"2118",17,"[26]gpFHoIoHcoxHnJHGqKChlEtmgj",281,0.996454,26,282,1,281,1,1,0,1,1,142,141,140,140,23
"2119",18,"[26]gpFHoIoHcoxHnJHGqKChlEtmgj",281,0.996454,26,282,1,281,1,1,0,1,1,130,129,152,152,23
"2120",19,"[26]gpFHoIoHcoxHnJHGqKChlEtmgj",278,0.996416,26,279,1,278,1,1,0,1,1,159,158,120,120,23
"2121",20,"[26]gpFHoIoHcoxHnJHGqKChlEtmgj",273,0.99635,26,274,1,273,1,1,0,1,1,149,148,125,125,23
"2122",21,"[26]gpFHoIoHcoxHnJHGqKChlEtmgj",282,0.996466,26,283,1,282,1,1,0,1,1,145,144,138,138,23
"2123",22,"[26]gpFHoIoHcoxHnJHGqKChlEtmgj",285,0.996503,26,286,1,285,1,1,0,1,1,158,157,128,128,23
"2124",23,"[26]gpFHoIoHcoxHnJHGqKChlEtmgj",289,0.996552,26,290,1,289,1,1,0,1,1,141,140,149,149,23
"2125",24,"[26]gpFHoIoHcoxHnJHGqKChlEtmgj",276,0.99639,26,277,1,276,1,1,0,1,1,132,131,145,145,23
"2126",25,"[26]gpFHoIoHcoxHnJHGqKChlEtmgj",283,0.996479,26,284,1,283,1,1,0,1,1,142,141,142,142,23
"2127",26,"[26]gpFHoIoHcoxHnJHGqKChlEtmgj",272,0.996337,26,273,1,272,1,1,0,1,1,134,133,139,139,23
"2128",27,"[26]gpFHoIoHcoxHnJHGqKChlEtmgj",287,0.996528,26,288,1,287,1,1,0,1,1,155,154,133,133,23
"2129",28,"[26]gpFHoIoHcoxHnJHGqKChlEtmgj",276,0.99639,26,277,1,276,1,1,0,1,1,129,128,148,148,23
"2130",29,"[26]gpFHoIoHcoxHnJHGqKChlEtmgj",272,0.996337,26,273,1,272,1,1,0,1,1,132,131,141,141,23
"2131",30,"[26]gpFHoIoHcoxHnJHGqKChlEtmgj",282,0.996466,26,283,1,282,1,1,0,1,1,150,149,133,133,23
"2132",31,"[26]gpFHoIoHcoxHnJHGqKChlEtmgj",276,0.99639,26,277,1,276,1,1,0,1,1,145,144,132,132,23
"2133",32,"[26]gpFHoIoHcoxHnJHGqKChlEtmgj",281,0.996454,26,282,1,281,1,1,0,1,1,140,139,142,142,23
"2134",33,"[26]gpFHoIoHcoxHnJHGqKChlEtmgj",286,0.996516,26,287,1,286,1,1,0,1,1,147,146,140,140,23
"2135",34,"[26]gpFHoIoHcoxHnJHGqKChlEtmgj",281,0.996454,26,282,1,281,1,1,0,1,1,151,150,131,131,23
"2136",35,"[26]gpFHoIoHcoxHnJHGqKChlEtmgj",283,0.996479,26,284,1,283,1,1,0,1,1,137,136,147,147,23
"2137",36,"[26]gpFHoIoHcoxHnJHGqKChlEtmgj",288,0.99654,26,289,1,288,1,1,0,1,1,157,156,132,132,23
"2138",37,"[26]gpFHoIoHcoxHnJHGqKChlEtmgj",282,0.996466,26,283,1,282,1,1,0,1,1,143,142,140,140,23
"2139",38,"[26]gpFHoIoHcoxHnJHGqKChlEtmgj",282,0.996466,26,283,1,282,1,1,0,1,1,153,152,130,130,23
"2140",39,"[26]gpFHoIoHcoxHnJHGqKChlEtmgj",279,0.996429,26,280,1,279,1,1,0,1,1,146,145,134,134,23
"2141",40,"[26]gpFHoIoHcoxHnJHGqKChlEtmgj",280,0.996441,26,281,1,280,1,1,0,1,1,142,141,139,139,23
"2142",41,"[26]gpFHoIoHcoxHnJHGqKChlEtmgj",281,0.996454,26,282,1,281,1,1,0,1,1,150,149,132,132,23
"2143",42,"[26]gpFHoIoHcoxHnJHGqKChlEtmgj",284,0.996491,26,285,1,284,1,1,0,1,1,148,147,137,137,23
"2144",43,"[26]gpFHoIoHcoxHnJHGqKChlEtmgj",277,0.996403,26,278,1,277,1,1,0,1,1,138,137,140,140,23
"2145",44,"[26]gpFHoIoHcoxHnJHGqKChlEtmgj",279,0.996429,26,280,1,279,1,1,0,1,1,136,135,144,144,23
"2146",45,"[26]gpFHoIoHcoxHnJHGqKChlEtmgj",284,0.996491,26,285,1,284,1,1,0,1,1,133,132,152,152,23
"2147",46,"[26]gpFHoIoHcoxHnJHGqKChlEtmgj",277,0.996403,26,278,1,277,1,1,0,1,1,129,128,149,149,23
"2148",47,"[26]gpFHoIoHcoxHnJHGqKChlEtmgj",275,0.996377,26,276,1,275,1,1,0,1,1,141,140,135,135,23
"2149",48,"[26]gpFHoIoHcoxHnJHGqKChlEtmgj",284,0.996491,26,285,1,284,1,1,0,1,1,144,143,141,141,23
"2150",49,"[26]gpFHoIoHcoxHnJHGqKChlEtmgj",275,0.996377,26,276,1,275,1,1,0,1,1,140,139,136,136,23
"2151",50,"[26]gpFHoIoHcoxHnJHGqKChlEtmgj",289,0.996552,26,290,1,289,1,1,0,1,1,156,155,134,134,23
"2152",51,"[26]gpFHoIoHcoxHnJHGqKChlEtmgj",277,0.996403,26,278,1,277,1,1,0,1,1,134,133,144,144,23
"2153",52,"[26]gpFHoIoHcoxHnJHGqKChlEtmgj",276,0.99639,26,277,1,276,1,1,0,1,1,132,131,145,145,23
"2154",53,"[26]gpFHoIoHcoxHnJHGqKChlEtmgj",281,0.996454,26,282,1,281,1,1,0,1,1,138,137,144,144,23
"2155",54,"[26]gpFHoIoHcoxHnJHGqKChlEtmgj",279,0.996429,26,280,1,279,1,1,0,1,1,139,138,141,141,23
"2156",55,"[26]gpFHoIoHcoxHnJHGqKChlEtmgj",282,0.996466,26,283,1,282,1,1,0,1,1,145,144,138,138,23
"2157",56,"[26]gpFHoIoHcoxHnJHGqKChlEtmgj",281,0.996454,26,282,1,281,1,1,0,1,1,137,136,145,145,23
"2158",57,"[26]gpFHoIoHcoxHnJHGqKChlEtmgj",272,0.996337,26,273,1,272,1,1,0,1,1,138,137,135,135,23
"2159",58,"[26]gpFHoIoHcoxHnJHGqKChlEtmgj",279,0.996429,26,280,1,279,1,1,0,1,1,142,141,138,138,23
"2160",59,"[26]gpFHoIoHcoxHnJHGqKChlEtmgj",274,0.996364,26,275,1,274,1,1,0,1,1,138,137,137,137,23
"2161",60,"[26]gpFHoIoHcoxHnJHGqKChlEtmgj",284,0.996491,26,285,1,284,1,1,0,1,1,147,146,138,138,23
"2162",61,"[26]gpFHoIoHcoxHnJHGqKChlEtmgj",288,0.99654,26,289,1,288,1,1,0,1,1,148,147,141,141,23
"2163",62,"[26]gpFHoIoHcoxHnJHGqKChlEtmgj",282,0.996466,26,283,1,282,1,1,0,1,1,150,149,133,133,23
"2164",63,"[26]gpFHoIoHcoxHnJHGqKChlEtmgj",284,0.996491,26,285,1,284,1,1,0,1,1,153,152,132,132,23
"2165",64,"[26]gpFHoIoHcoxHnJHGqKChlEtmgj",285,0.996503,26,286,1,285,1,1,0,1,1,137,136,149,149,23
"2166",65,"[26]gpFHoIoHcoxHnJHGqKChlEtmgj",279,0.996429,26,280,1,279,1,1,0,1,1,127,126,153,153,23
"2167",66,"[26]gpFHoIoHcoxHnJHGqKChlEtmgj",275,0.996377,26,276,1,275,1,1,0,1,1,128,127,148,148,23
"2168",67,"[26]gpFHoIoHcoxHnJHGqKChlEtmgj",279,0.996429,26,280,1,279,1,1,0,1,1,132,131,148,148,23
"2169",68,"[26]gpFHoIoHcoxHnJHGqKChlEtmgj",269,0.996296,26,270,1,269,1,1,0,1,1,125,124,145,145,23
"2170",69,"[26]gpFHoIoHcoxHnJHGqKChlEtmgj",288,0.99654,26,289,1,288,1,1,0,1,1,142,141,147,147,23
"2171",70,"[26]gpFHoIoHcoxHnJHGqKChlEtmgj",279,0.996429,26,280,1,279,1,1,0,1,1,146,145,134,134,23
"2172",71,"[26]gpFHoIoHcoxHnJHGqKChlEtmgj",279,0.996429,26,280,1,279,1,1,0,1,1,153,152,127,127,23
"2173",72,"[26]gpFHoIoHcoxHnJHGqKChlEtmgj",275,0.996377,26,276,1,275,1,1,0,1,1,139,138,137,137,23
"2174",73,"[26]gpFHoIoHcoxHnJHGqKChlEtmgj",285,0.996503,26,286,1,285,1,1,0,1,1,147,146,139,139,23
"2175",74,"[26]gpFHoIoHcoxHnJHGqKChlEtmgj",280,0.996441,26,281,1,280,1,1,0,1,1,136,135,145,145,23
"2176",75,"[26]gpFHoIoHcoxHnJHGqKChlEtmgj",283,0.996479,26,284,1,283,1,1,0,1,1,143,142,141,141,23
"2177",76,"[26]gpFHoIoHcoxHnJHGqKChlEtmgj",281,0.996454,26,282,1,281,1,1,0,1,1,125,124,157,157,23
"2178",77,"[26]gpFHoIoHcoxHnJHGqKChlEtmgj",284,0.996491,26,285,1,284,1,1,0,1,1,150,149,135,135,23
"2179",78,"[26]gpFHoIoHcoxHnJHGqKChlEtmgj",279,0.996429,26,280,1,279,1,1,0,1,1,141,140,139,139,23
"2180",79,"[26]gpFHoIoHcoxHnJHGqKChlEtmgj",279,0.996429,26,280,1,279,1,1,0,1,1,134,133,146,146,23
"2181",80,"[26]gpFHoIoHcoxHnJHGqKChlEtmgj",281,0.996454,26,282,1,281,1,1,0,1,1,145,144,137,137,23
"2182",81,"[26]gpFHoIoHcoxHnJHGqKChlEtmgj",280,0.996441,26,281,1,280,1,1,0,1,1,131,130,150,150,23
"2183",82,"[26]gpFHoIoHcoxHnJHGqKChlEtmgj",284,0.996491,26,285,1,284,1,1,0,1,1,152,151,133,133,23
"2184",83,"[26]gpFHoIoHcoxHnJHGqKChlEtmgj",281,0.996454,26,282,1,281,1,1,0,1,1,142,141,140,140,23
"2185",84,"[26]gpFHoIoHcoxHnJHGqKChlEtmgj",283,0.996479,26,284,1,283,1,1,0,1,1,147,146,137,137,23
"2186",85,"[26]gpFHoIoHcoxHnJHGqKChlEtmgj",282,0.996466,26,283,1,282,1,1,0,1,1,153,152,130,130,23
"2187",86,"[26]gpFHoIoHcoxHnJHGqKChlEtmgj",279,0.996429,26,280,1,279,1,1,0,1,1,157,156,123,123,23
"2188",87,"[26]gpFHoIoHcoxHnJHGqKChlEtmgj",280,0.996441,26,281,1,280,1,1,0,1,1,132,131,149,149,23
"2189",88,"[26]gpFHoIoHcoxHnJHGqKChlEtmgj",270,0.99631,26,271,1,270,1,1,0,1,1,130,129,141,141,23
"2190",89,"[26]gpFHoIoHcoxHnJHGqKChlEtmgj",278,0.996416,26,279,1,278,1,1,0,1,1,155,154,124,124,23
"2191",90,"[26]gpFHoIoHcoxHnJHGqKChlEtmgj",284,0.996491,26,285,1,284,1,1,0,1,1,151,150,134,134,23
"2192",91,"[26]gpFHoIoHcoxHnJHGqKChlEtmgj",274,0.996364,26,275,1,274,1,1,0,1,1,136,135,139,139,23
"2193",92,"[26]gpFHoIoHcoxHnJHGqKChlEtmgj",274,0.996364,26,275,1,274,1,1,0,1,1,144,143,131,131,23
"2194",93,"[26]gpFHoIoHcoxHnJHGqKChlEtmgj",274,0.996364,26,275,1,274,1,1,0,1,1,142,141,133,133,23
"2195",94,"[26]gpFHoIoHcoxHnJHGqKChlEtmgj",282,0.996466,26,283,1,282,1,1,0,1,1,136,135,147,147,23
"2196",95,"[26]gpFHoIoHcoxHnJHGqKChlEtmgj",274,0.996364,26,275,1,274,1,1,0,1,1,131,130,144,144,23
"2197",96,"[26]gpFHoIoHcoxHnJHGqKChlEtmgj",275,0.996377,26,276,1,275,1,1,0,1,1,129,128,147,147,23
"2198",97,"[26]gpFHoIoHcoxHnJHGqKChlEtmgj",285,0.996503,26,286,1,285,1,1,0,1,1,154,153,132,132,23
"2199",98,"[26]gpFHoIoHcoxHnJHGqKChlEtmgj",277,0.996403,26,278,1,277,1,1,0,1,1,150,149,128,128,23
"2200",99,"[26]gpFHoIoHcoxHnJHGqKChlEtmgj",278,0.996416,26,279,1,278,1,1,0,1,1,143,142,136,136,23
"2201",0,"[25]qHoIoHcouHnJHGqKCIfAgoIdi",276,0.99639,25,277,1,276,1,1,0,1,1,152,151,125,125,24
"2202",1,"[25]qHoIoHcouHnJHGqKCIfAgoIdi",285,0.996503,25,286,1,285,1,1,0,1,1,152,151,134,134,24
"2203",2,"[25]qHoIoHcouHnJHGqKCIfAgoIdi",282,0.996466,25,283,1,282,1,1,0,1,1,144,143,139,139,24
"2204",3,"[25]qHoIoHcouHnJHGqKCIfAgoIdi",286,0.996516,25,287,1,286,1,1,0,1,1,158,157,129,129,24
"2205",4,"[25]qHoIoHcouHnJHGqKCIfAgoIdi",284,0.996491,25,285,1,284,1,1,0,1,1,139,138,146,146,24
"2206",5,"[25]qHoIoHcouHnJHGqKCIfAgoIdi",283,0.996479,25,284,1,283,1,1,0,1,1,140,139,144,144,24
"2207",6,"[25]qHoIoHcouHnJHGqKCIfAgoIdi",283,0.996479,25,284,1,283,1,1,0,1,1,145,144,139,139,24
"2208",7,"[25]qHoIoHcouHnJHGqKCIfAgoIdi",276,0.99639,25,277,1,276,1,1,0,1,1,152,151,125,125,24
"2209",8,"[25]qHoIoHcouHnJHGqKCIfAgoIdi",282,0.996466,25,283,1,282,1,1,0,1,1,142,141,141,141,24
"2210",9,"[25]qHoIoHcouHnJHGqKCIfAgoIdi",272,0.996337,25,273,1,272,1,1,0,1,1,142,141,131,131,24
"2211",10,"[25]qHoIoHcouHnJHGqKCIfAgoIdi",275,0.996377,25,276,1,275,1,1,0,1,1,145,144,131,131,24
"2212",11,"[25]qHoIoHcouHnJHGqKCIfAgoIdi",282,0.996466,25,283,1,282,1,1,0,1,1,143,142,140,140,24
"2213",12,"[25]qHoIoHcouHnJHGqKCIfAgoIdi",284,0.996491,25,285,1,284,1,1,0,1,1,139,138,146,146,24
"2214",13,"[25]qHoIoHcouHnJHGqKCIfAgoIdi",279,0.996429,25,280,1,279,1,1,0,1,1,140,139,140,140,24
"2215",14,"[25]qHoIoHcouHnJHGqKCIfAgoIdi",278,0.996416,25,279,1,278,1,1,0,1,1,141,140,138,138,24
"2216",15,"[25]qHoIoHcouHnJHGqKCIfAgoIdi",284,0.996491,25,285,1,284,1,1,0,1,1,147,146,138,138,24
"2217",16,"[25]qHoIoHcouHnJHGqKCIfAgoIdi",278,0.996416,25,279,1,278,1,1,0,1,1,146,145,133,133,24
"2218",17,"[25]qHoIoHcouHnJHGqKCIfAgoIdi",275,0.996377,25,276,1,275,1,1,0,1,1,137,136,139,139,24
"2219",18,"[25]qHoIoHcouHnJHGqKCIfAgoIdi",277,0.996403,25,278,1,277,1,1,0,1,1,133,132,145,145,24
"2220",19,"[25]qHoIoHcouHnJHGqKCIfAgoIdi",286,0.996516,25,287,1,286,1,1,0,1,1,164,163,123,123,24
"2221",20,"[25]qHoIoHcouHnJHGqKCIfAgoIdi",284,0.996491,25,285,1,284,1,1,0,1,1,154,153,131,131,24
"2222",21,"[25]qHoIoHcouHnJHGqKCIfAgoIdi",286,0.996516,25,287,1,286,1,1,0,1,1,171,170,116,116,24
"2223",22,"[25]qHoIoHcouHnJHGqKCIfAgoIdi",277,0.996403,25,278,1,277,1,1,0,1,1,112,111,166,166,24
"2224",23,"[25]qHoIoHcouHnJHGqKCIfAgoIdi",281,0.996454,25,282,1,281,1,1,0,1,1,146,145,136,136,24
"2225",24,"[25]qHoIoHcouHnJHGqKCIfAgoIdi",281,0.996454,25,282,1,281,1,1,0,1,1,136,135,146,146,24
"2226",25,"[25]qHoIoHcouHnJHGqKCIfAgoIdi",271,0.996324,25,272,1,271,1,1,0,1,1,118,117,154,154,24
"2227",26,"[25]qHoIoHcouHnJHGqKCIfAgoIdi",283,0.996479,25,284,1,283,1,1,0,1,1,152,151,132,132,24
"2228",27,"[25]qHoIoHcouHnJHGqKCIfAgoIdi",277,0.996403,25,278,1,277,1,1,0,1,1,138,137,140,140,24
"2229",28,"[25]qHoIoHcouHnJHGqKCIfAgoIdi",277,0.996403,25,278,1,277,1,1,0,1,1,136,135,142,142,24
"2230",29,"[25]qHoIoHcouHnJHGqKCIfAgoIdi",281,0.996454,25,282,1,281,1,1,0,1,1,128,127,154,154,24
"2231",30,"[25]qHoIoHcouHnJHGqKCIfAgoIdi",282,0.996466,25,283,1,282,1,1,0,1,1,156,155,127,127,24
"2232",31,"[25]qHoIoHcouHnJHGqKCIfAgoIdi",284,0.996491,25,285,1,284,1,1,0,1,1,153,152,132,132,24
"2233",32,"[25]qHoIoHcouHnJHGqKCIfAgoIdi",292,0.996587,25,293,1,292,1,1,0,1,1,152,151,141,141,24
"2234",33,"[25]qHoIoHcouHnJHGqKCIfAgoIdi",280,0.996441,25,281,1,280,1,1,0,1,1,127,126,154,154,24
"2235",34,"[25]qHoIoHcouHnJHGqKCIfAgoIdi",284,0.996491,25,285,1,284,1,1,0,1,1,141,140,144,144,24
"2236",35,"[25]qHoIoHcouHnJHGqKCIfAgoIdi",280,0.996441,25,281,1,280,1,1,0,1,1,154,153,127,127,24
"2237",36,"[25]qHoIoHcouHnJHGqKCIfAgoIdi",283,0.996479,25,284,1,283,1,1,0,1,1,137,136,147,147,24
"2238",37,"[25]qHoIoHcouHnJHGqKCIfAgoIdi",282,0.996466,25,283,1,282,1,1,0,1,1,136,135,147,147,24
"2239",38,"[25]qHoIoHcouHnJHGqKCIfAgoIdi",283,0.996479,25,284,1,283,1,1,0,1,1,139,138,145,145,24
"2240",39,"[25]qHoIoHcouHnJHGqKCIfAgoIdi",278,0.996416,25,279,1,278,1,1,0,1,1,130,129,149,149,24
"2241",40,"[25]qHoIoHcouHnJHGqKCIfAgoIdi",285,0.996503,25,286,1,285,1,1,0,1,1,147,146,139,139,24
"2242",41,"[25]qHoIoHcouHnJHGqKCIfAgoIdi",285,0.996503,25,286,1,285,1,1,0,1,1,147,146,139,139,24
"2243",42,"[25]qHoIoHcouHnJHGqKCIfAgoIdi",287,0.996528,25,288,1,287,1,1,0,1,1,139,138,149,149,24
"2244",43,"[25]qHoIoHcouHnJHGqKCIfAgoIdi",282,0.996466,25,283,1,282,1,1,0,1,1,152,151,131,131,24
"2245",44,"[25]qHoIoHcouHnJHGqKCIfAgoIdi",284,0.996491,25,285,1,284,1,1,0,1,1,126,125,159,159,24
"2246",45,"[25]qHoIoHcouHnJHGqKCIfAgoIdi",271,0.996324,25,272,1,271,1,1,0,1,1,133,132,139,139,24
"2247",46,"[25]qHoIoHcouHnJHGqKCIfAgoIdi",281,0.996454,25,282,1,281,1,1,0,1,1,148,147,134,134,24
"2248",47,"[25]qHoIoHcouHnJHGqKCIfAgoIdi",282,0.996466,25,283,1,282,1,1,0,1,1,148,147,135,135,24
"2249",48,"[25]qHoIoHcouHnJHGqKCIfAgoIdi",287,0.996528,25,288,1,287,1,1,0,1,1,143,142,145,145,24
"2250",49,"[25]qHoIoHcouHnJHGqKCIfAgoIdi",274,0.996364,25,275,1,274,1,1,0,1,1,131,130,144,144,24
"2251",50,"[25]qHoIoHcouHnJHGqKCIfAgoIdi",282,0.996466,25,283,1,282,1,1,0,1,1,135,134,148,148,24
"2252",51,"[25]qHoIoHcouHnJHGqKCIfAgoIdi",288,0.99654,25,289,1,288,1,1,0,1,1,154,153,135,135,24
"2253",52,"[25]qHoIoHcouHnJHGqKCIfAgoIdi",285,0.996503,25,286,1,285,1,1,0,1,1,143,142,143,143,24
"2254",53,"[25]qHoIoHcouHnJHGqKCIfAgoIdi",281,0.996454,25,282,1,281,1,1,0,1,1,151,150,131,131,24
"2255",54,"[25]qHoIoHcouHnJHGqKCIfAgoIdi",286,0.996516,25,287,1,286,1,1,0,1,1,131,130,156,156,24
"2256",55,"[25]qHoIoHcouHnJHGqKCIfAgoIdi",282,0.996466,25,283,1,282,1,1,0,1,1,147,146,136,136,24
"2257",56,"[25]qHoIoHcouHnJHGqKCIfAgoIdi",280,0.996441,25,281,1,280,1,1,0,1,1,148,147,133,133,24
"2258",57,"[25]qHoIoHcouHnJHGqKCIfAgoIdi",283,0.996479,25,284,1,283,1,1,0,1,1,148,147,136,136,24
"2259",58,"[25]qHoIoHcouHnJHGqKCIfAgoIdi",290,0.996564,25,291,1,290,1,1,0,1,1,142,141,149,149,24
"2260",59,"[25]qHoIoHcouHnJHGqKCIfAgoIdi",285,0.996503,25,286,1,285,1,1,0,1,1,145,144,141,141,24
"2261",60,"[25]qHoIoHcouHnJHGqKCIfAgoIdi",280,0.996441,25,281,1,280,1,1,0,1,1,143,142,138,138,24
"2262",61,"[25]qHoIoHcouHnJHGqKCIfAgoIdi",279,0.996429,25,280,1,279,1,1,0,1,1,136,135,144,144,24
"2263",62,"[25]qHoIoHcouHnJHGqKCIfAgoIdi",276,0.99639,25,277,1,276,1,1,0,1,1,134,133,143,143,24
"2264",63,"[25]qHoIoHcouHnJHGqKCIfAgoIdi",283,0.996479,25,284,1,283,1,1,0,1,1,140,139,144,144,24
"2265",64,"[25]qHoIoHcouHnJHGqKCIfAgoIdi",283,0.996479,25,284,1,283,1,1,0,1,1,149,148,135,135,24
"2266",65,"[25]qHoIoHcouHnJHGqKCIfAgoIdi",284,0.996491,25,285,1,284,1,1,0,1,1,160,159,125,125,24
"2267",66,"[25]qHoIoHcouHnJHGqKCIfAgoIdi",288,0.99654,25,289,1,288,1,1,0,1,1,149,148,140,140,24
"2268",67,"[25]qHoIoHcouHnJHGqKCIfAgoIdi",274,0.996364,25,275,1,274,1,1,0,1,1,129,128,146,146,24
"2269",68,"[25]qHoIoHcouHnJHGqKCIfAgoIdi",281,0.996454,25,282,1,281,1,1,0,1,1,150,149,132,132,24
"2270",69,"[25]qHoIoHcouHnJHGqKCIfAgoIdi",289,0.996552,25,290,1,289,1,1,0,1,1,157,156,133,133,24
"2271",70,"[25]qHoIoHcouHnJHGqKCIfAgoIdi",282,0.996466,25,283,1,282,1,1,0,1,1,146,145,137,137,24
"2272",71,"[25]qHoIoHcouHnJHGqKCIfAgoIdi",275,0.996377,25,276,1,275,1,1,0,1,1,133,132,143,143,24
"2273",72,"[25]qHoIoHcouHnJHGqKCIfAgoIdi",280,0.996441,25,281,1,280,1,1,0,1,1,145,144,136,136,24
"2274",73,"[25]qHoIoHcouHnJHGqKCIfAgoIdi",293,0.996599,25,294,1,293,1,1,0,1,1,159,158,135,135,24
"2275",74,"[25]qHoIoHcouHnJHGqKCIfAgoIdi",275,0.996377,25,276,1,275,1,1,0,1,1,128,127,148,148,24
"2276",75,"[25]qHoIoHcouHnJHGqKCIfAgoIdi",287,0.996528,25,288,1,287,1,1,0,1,1,163,162,125,125,24
"2277",76,"[25]qHoIoHcouHnJHGqKCIfAgoIdi",278,0.996416,25,279,1,278,1,1,0,1,1,150,149,129,129,24
"2278",77,"[25]qHoIoHcouHnJHGqKCIfAgoIdi",278,0.996416,25,279,1,278,1,1,0,1,1,120,119,159,159,24
"2279",78,"[25]qHoIoHcouHnJHGqKCIfAgoIdi",284,0.996491,25,285,1,284,1,1,0,1,1,144,143,141,141,24
"2280",79,"[25]qHoIoHcouHnJHGqKCIfAgoIdi",282,0.996466,25,283,1,282,1,1,0,1,1,141,140,142,142,24
"2281",80,"[25]qHoIoHcouHnJHGqKCIfAgoIdi",285,0.996503,25,286,1,285,1,1,0,1,1,135,134,151,151,24
"2282",81,"[25]qHoIoHcouHnJHGqKCIfAgoIdi",289,0.996552,25,290,1,289,1,1,0,1,1,146,145,144,144,24
"2283",82,"[25]qHoIoHcouHnJHGqKCIfAgoIdi",280,0.996441,25,281,1,280,1,1,0,1,1,130,129,151,151,24
"2284",83,"[25]qHoIoHcouHnJHGqKCIfAgoIdi",280,0.996441,25,281,1,280,1,1,0,1,1,147,146,134,134,24
"2285",84,"[25]qHoIoHcouHnJHGqKCIfAgoIdi",287,0.996528,25,288,1,287,1,1,0,1,1,133,132,155,155,24
"2286",85,"[25]qHoIoHcouHnJHGqKCIfAgoIdi",281,0.996454,25,282,1,281,1,1,0,1,1,136,135,146,146,24
"2287",86,"[25]qHoIoHcouHnJHGqKCIfAgoIdi",268,0.996283,25,269,1,268,1,1,0,1,1,137,136,132,132,24
"2288",87,"[25]qHoIoHcouHnJHGqKCIfAgoIdi",280,0.996441,25,281,1,280,1,1,0,1,1,140,139,141,141,24
"2289",88,"[25]qHoIoHcouHnJHGqKCIfAgoIdi",277,0.996403,25,278,1,277,1,1,0,1,1,138,137,140,140,24
"2290",89,"[25]qHoIoHcouHnJHGqKCIfAgoIdi",280,0.996441,25,281,1,280,1,1,0,1,1,126,125,155,155,24
"2291",90,"[25]qHoIoHcouHnJHGqKCIfAgoIdi",282,0.996466,25,283,1,282,1,1,0,1,1,147,146,136,136,24
"2292",91,"[25]qHoIoHcouHnJHGqKCIfAgoIdi",273,0.99635,25,274,1,273,1,1,0,1,1,143,142,131,131,24
"2293",92,"[25]qHoIoHcouHnJHGqKCIfAgoIdi",283,0.996479,25,284,1,283,1,1,0,1,1,152,151,132,132,24
"2294",93,"[25]qHoIoHcouHnJHGqKCIfAgoIdi",284,0.996491,25,285,1,284,1,1,0,1,1,146,145,139,139,24
"2295",94,"[25]qHoIoHcouHnJHGqKCIfAgoIdi",276,0.99639,25,277,1,276,1,1,0,1,1,144,143,133,133,24
"2296",95,"[25]qHoIoHcouHnJHGqKCIfAgoIdi",275,0.996377,25,276,1,275,1,1,0,1,1,134,133,142,142,24
"2297",96,"[25]qHoIoHcouHnJHGqKCIfAgoIdi",280,0.996441,25,281,1,280,1,1,0,1,1,136,135,145,145,24
"2298",97,"[25]qHoIoHcouHnJHGqKCIfAgoIdi",287,0.996528,25,288,1,287,1,1,0,1,1,148,147,140,140,24
"2299",98,"[25]qHoIoHcouHnJHGqKCIfAgoIdi",281,0.996454,25,282,1,281,1,1,0,1,1,141,140,141,141,24
"2300",99,"[25]qHoIoHcouHnJHGqKCIfAgoIdi",286,0.996516,25,287,1,286,1,1,0,1,1,144,143,143,143,24
"2301",0,"[25]HoIpkoHcotHnJHGqKChJFAnpF",283,0.996479,25,284,1,283,1,1,0,1,1,149,148,135,135,25
"2302",1,"[25]HoIpkoHcotHnJHGqKChJFAnpF",285,0.996503,25,286,1,285,1,1,0,1,1,142,141,144,144,25
"2303",2,"[25]HoIpkoHcotHnJHGqKChJFAnpF",281,0.996454,25,282,1,281,1,1,0,1,1,151,150,131,131,25
"2304",3,"[25]HoIpkoHcotHnJHGqKChJFAnpF",287,0.996528,25,288,1,287,1,1,0,1,1,157,156,131,131,25
"2305",4,"[25]HoIpkoHcotHnJHGqKChJFAnpF",285,0.996503,25,286,1,285,1,1,0,1,1,163,162,123,123,25
"2306",5,"[25]HoIpkoHcotHnJHGqKChJFAnpF",286,0.996516,25,287,1,286,1,1,0,1,1,136,135,151,151,25
"2307",6,"[25]HoIpkoHcotHnJHGqKChJFAnpF",285,0.996503,25,286,1,285,1,1,0,1,1,135,134,151,151,25
"2308",7,"[25]HoIpkoHcotHnJHGqKChJFAnpF",283,0.996479,25,284,1,283,1,1,0,1,1,145,144,139,139,25
"2309",8,"[25]HoIpkoHcotHnJHGqKChJFAnpF",287,0.996528,25,288,1,287,1,1,0,1,1,147,146,141,141,25
"2310",9,"[25]HoIpkoHcotHnJHGqKChJFAnpF",281,0.996454,25,282,1,281,1,1,0,1,1,153,152,129,129,25
"2311",10,"[25]HoIpkoHcotHnJHGqKChJFAnpF",287,0.996528,25,288,1,287,1,1,0,1,1,137,136,151,151,25
"2312",11,"[25]HoIpkoHcotHnJHGqKChJFAnpF",278,0.996416,25,279,1,278,1,1,0,1,1,136,135,143,143,25
"2313",12,"[25]HoIpkoHcotHnJHGqKChJFAnpF",288,0.99654,25,289,1,288,1,1,0,1,1,143,142,146,146,25
"2314",13,"[25]HoIpkoHcotHnJHGqKChJFAnpF",275,0.996377,25,276,1,275,1,1,0,1,1,131,130,145,145,25
"2315",14,"[25]HoIpkoHcotHnJHGqKChJFAnpF",287,0.996528,25,288,1,287,1,1,0,1,1,143,142,145,145,25
"2316",15,"[25]HoIpkoHcotHnJHGqKChJFAnpF",277,0.996403,25,278,1,277,1,1,0,1,1,134,133,144,144,25
"2317",16,"[25]HoIpkoHcotHnJHGqKChJFAnpF",284,0.996491,25,285,1,284,1,1,0,1,1,156,155,129,129,25
"2318",17,"[25]HoIpkoHcotHnJHGqKChJFAnpF",286,0.996516,25,287,1,286,1,1,0,1,1,144,143,143,143,25
"2319",18,"[25]HoIpkoHcotHnJHGqKChJFAnpF",273,0.99635,25,274,1,273,1,1,0,1,1,144,143,130,130,25
"2320",19,"[25]HoIpkoHcotHnJHGqKChJFAnpF",282,0.996466,25,283,1,282,1,1,0,1,1,146,145,137,137,25
"2321",20,"[25]HoIpkoHcotHnJHGqKChJFAnpF",291,0.996575,25,292,1,291,1,1,0,1,1,155,154,137,137,25
"2322",21,"[25]HoIpkoHcotHnJHGqKChJFAnpF",285,0.996503,25,286,1,285,1,1,0,1,1,147,146,139,139,25
"2323",22,"[25]HoIpkoHcotHnJHGqKChJFAnpF",288,0.99654,25,289,1,288,1,1,0,1,1,149,148,140,140,25
"2324",23,"[25]HoIpkoHcotHnJHGqKChJFAnpF",279,0.996429,25,280,1,279,1,1,0,1,1,126,125,154,154,25
"2325",24,"[25]HoIpkoHcotHnJHGqKChJFAnpF",284,0.996491,25,285,1,284,1,1,0,1,1,153,152,132,132,25
"2326",25,"[25]HoIpkoHcotHnJHGqKChJFAnpF",283,0.996479,25,284,1,283,1,1,0,1,1,148,147,136,136,25
"2327",26,"[25]HoIpkoHcotHnJHGqKChJFAnpF",281,0.996454,25,282,1,281,1,1,0,1,1,156,155,126,126,25
"2328",27,"[25]HoIpkoHcotHnJHGqKChJFAnpF",276,0.99639,25,277,1,276,1,1,0,1,1,130,129,147,147,25
"2329",28,"[25]HoIpkoHcotHnJHGqKChJFAnpF",283,0.996479,25,284,1,283,1,1,0,1,1,138,137,146,146,25
"2330",29,"[25]HoIpkoHcotHnJHGqKChJFAnpF",282,0.996466,25,283,1,282,1,1,0,1,1,148,147,135,135,25
"2331",30,"[25]HoIpkoHcotHnJHGqKChJFAnpF",280,0.996441,25,281,1,280,1,1,0,1,1,141,140,140,140,25
"2332",31,"[25]HoIpkoHcotHnJHGqKChJFAnpF",272,0.996337,25,273,1,272,1,1,0,1,1,134,133,139,139,25
"2333",32,"[25]HoIpkoHcotHnJHGqKChJFAnpF",281,0.996454,25,282,1,281,1,1,0,1,1,150,149,132,132,25
"2334",33,"[25]HoIpkoHcotHnJHGqKChJFAnpF",278,0.996416,25,279,1,278,1,1,0,1,1,134,133,145,145,25
"2335",34,"[25]HoIpkoHcotHnJHGqKChJFAnpF",282,0.996466,25,283,1,282,1,1,0,1,1,143,142,140,140,25
"2336",35,"[25]HoIpkoHcotHnJHGqKChJFAnpF",285,0.996503,25,286,1,285,1,1,0,1,1,141,140,145,145,25
"2337",36,"[25]HoIpkoHcotHnJHGqKChJFAnpF",279,0.996429,25,280,1,279,1,1,0,1,1,141,140,139,139,25
"2338",37,"[25]HoIpkoHcotHnJHGqKChJFAnpF",280,0.996441,25,281,1,280,1,1,0,1,1,141,140,140,140,25
"2339",38,"[25]HoIpkoHcotHnJHGqKChJFAnpF",282,0.996466,25,283,1,282,1,1,0,1,1,156,155,127,127,25
"2340",39,"[25]HoIpkoHcotHnJHGqKChJFAnpF",276,0.99639,25,277,1,276,1,1,0,1,1,140,139,137,137,25
"2341",40,"[25]HoIpkoHcotHnJHGqKChJFAnpF",278,0.996416,25,279,1,278,1,1,0,1,1,144,143,135,135,25
"2342",41,"[25]HoIpkoHcotHnJHGqKChJFAnpF",284,0.996491,25,285,1,284,1,1,0,1,1,153,152,132,132,25
"2343",42,"[25]HoIpkoHcotHnJHGqKChJFAnpF",277,0.996403,25,278,1,277,1,1,0,1,1,141,140,137,137,25
"2344",43,"[25]HoIpkoHcotHnJHGqKChJFAnpF",278,0.996416,25,279,1,278,1,1,0,1,1,138,137,141,141,25
"2345",44,"[25]HoIpkoHcotHnJHGqKChJFAnpF",273,0.99635,25,274,1,273,1,1,0,1,1,139,138,135,135,25
"2346",45,"[25]HoIpkoHcotHnJHGqKChJFAnpF",287,0.996528,25,288,1,287,1,1,0,1,1,158,157,130,130,25
"2347",46,"[25]HoIpkoHcotHnJHGqKChJFAnpF",282,0.996466,25,283,1,282,1,1,0,1,1,143,142,140,140,25
"2348",47,"[25]HoIpkoHcotHnJHGqKChJFAnpF",285,0.996503,25,286,1,285,1,1,0,1,1,159,158,127,127,25
"2349",48,"[25]HoIpkoHcotHnJHGqKChJFAnpF",271,0.996324,25,272,1,271,1,1,0,1,1,126,125,146,146,25
"2350",49,"[25]HoIpkoHcotHnJHGqKChJFAnpF",281,0.996454,25,282,1,281,1,1,0,1,1,157,156,125,125,25
"2351",50,"[25]HoIpkoHcotHnJHGqKChJFAnpF",283,0.996479,25,284,1,283,1,1,0,1,1,150,149,134,134,25
"2352",51,"[25]HoIpkoHcotHnJHGqKChJFAnpF",279,0.996429,25,280,1,279,1,1,0,1,1,129,128,151,151,25
"2353",52,"[25]HoIpkoHcotHnJHGqKChJFAnpF",282,0.996466,25,283,1,282,1,1,0,1,1,138,137,145,145,25
"2354",53,"[25]HoIpkoHcotHnJHGqKChJFAnpF",286,0.996516,25,287,1,286,1,1,0,1,1,155,154,132,132,25
"2355",54,"[25]HoIpkoHcotHnJHGqKChJFAnpF",282,0.996466,25,283,1,282,1,1,0,1,1,141,140,142,142,25
"2356",55,"[25]HoIpkoHcotHnJHGqKChJFAnpF",276,0.99639,25,277,1,276,1,1,0,1,1,136,135,141,141,25
"2357",56,"[25]HoIpkoHcotHnJHGqKChJFAnpF",287,0.996528,25,288,1,287,1,1,0,1,1,145,144,143,143,25
"2358",57,"[25]HoIpkoHcotHnJHGqKChJFAnpF",276,0.99639,25,277,1,276,1,1,0,1,1,126,125,151,151,25
"2359",58,"[25]HoIpkoHcotHnJHGqKChJFAnpF",282,0.996466,25,283,1,282,1,1,0,1,1,134,133,149,149,25
"2360",59,"[25]HoIpkoHcotHnJHGqKChJFAnpF",275,0.996377,25,276,1,275,1,1,0,1,1,133,132,143,143,25
"2361",60,"[25]HoIpkoHcotHnJHGqKChJFAnpF",280,0.996441,25,281,1,280,1,1,0,1,1,143,142,138,138,25
"2362",61,"[25]HoIpkoHcotHnJHGqKChJFAnpF",279,0.996429,25,280,1,279,1,1,0,1,1,139,138,141,141,25
"2363",62,"[25]HoIpkoHcotHnJHGqKChJFAnpF",279,0.996429,25,280,1,279,1,1,0,1,1,147,146,133,133,25
"2364",63,"[25]HoIpkoHcotHnJHGqKChJFAnpF",275,0.996377,25,276,1,275,1,1,0,1,1,133,132,143,143,25
"2365",64,"[25]HoIpkoHcotHnJHGqKChJFAnpF",284,0.996491,25,285,1,284,1,1,0,1,1,155,154,130,130,25
"2366",65,"[25]HoIpkoHcotHnJHGqKChJFAnpF",278,0.996416,25,279,1,278,1,1,0,1,1,126,125,153,153,25
"2367",66,"[25]HoIpkoHcotHnJHGqKChJFAnpF",276,0.99639,25,277,1,276,1,1,0,1,1,151,150,126,126,25
"2368",67,"[25]HoIpkoHcotHnJHGqKChJFAnpF",270,0.99631,25,271,1,270,1,1,0,1,1,126,125,145,145,25
"2369",68,"[25]HoIpkoHcotHnJHGqKChJFAnpF",281,0.996454,25,282,1,281,1,1,0,1,1,123,122,159,159,25
"2370",69,"[25]HoIpkoHcotHnJHGqKChJFAnpF",284,0.996491,25,285,1,284,1,1,0,1,1,131,130,154,154,25
"2371",70,"[25]HoIpkoHcotHnJHGqKChJFAnpF",277,0.996403,25,278,1,277,1,1,0,1,1,134,133,144,144,25
"2372",71,"[25]HoIpkoHcotHnJHGqKChJFAnpF",280,0.996441,25,281,1,280,1,1,0,1,1,152,151,129,129,25
"2373",72,"[25]HoIpkoHcotHnJHGqKChJFAnpF",281,0.996454,25,282,1,281,1,1,0,1,1,140,139,142,142,25
"2374",73,"[25]HoIpkoHcotHnJHGqKChJFAnpF",281,0.996454,25,282,1,281,1,1,0,1,1,153,152,129,129,25
"2375",74,"[25]HoIpkoHcotHnJHGqKChJFAnpF",269,0.996296,25,270,1,269,1,1,0,1,1,125,124,145,145,25
"2376",75,"[25]HoIpkoHcotHnJHGqKChJFAnpF",282,0.996466,25,283,1,282,1,1,0,1,1,147,146,136,136,25
"2377",76,"[25]HoIpkoHcotHnJHGqKChJFAnpF",279,0.996429,25,280,1,279,1,1,0,1,1,146,145,134,134,25
"2378",77,"[25]HoIpkoHcotHnJHGqKChJFAnpF",276,0.99639,25,277,1,276,1,1,0,1,1,121,120,156,156,25
"2379",78,"[25]HoIpkoHcotHnJHGqKChJFAnpF",278,0.996416,25,279,1,278,1,1,0,1,1,141,140,138,138,25
"2380",79,"[25]HoIpkoHcotHnJHGqKChJFAnpF",285,0.996503,25,286,1,285,1,1,0,1,1,155,154,131,131,25
"2381",80,"[25]HoIpkoHcotHnJHGqKChJFAnpF",272,0.996337,25,273,1,272,1,1,0,1,1,128,127,145,145,25
"2382",81,"[25]HoIpkoHcotHnJHGqKChJFAnpF",283,0.996479,25,284,1,283,1,1,0,1,1,127,126,157,157,25
"2383",82,"[25]HoIpkoHcotHnJHGqKChJFAnpF",276,0.99639,25,277,1,276,1,1,0,1,1,156,155,121,121,25
"2384",83,"[25]HoIpkoHcotHnJHGqKChJFAnpF",284,0.996491,25,285,1,284,1,1,0,1,1,140,139,145,145,25
"2385",84,"[25]HoIpkoHcotHnJHGqKChJFAnpF",285,0.996503,25,286,1,285,1,1,0,1,1,143,142,143,143,25
"2386",85,"[25]HoIpkoHcotHnJHGqKChJFAnpF",279,0.996429,25,280,1,279,1,1,0,1,1,142,141,138,138,25
"2387",86,"[25]HoIpkoHcotHnJHGqKChJFAnpF",288,0.99654,25,289,1,288,1,1,0,1,1,152,151,137,137,25
"2388",87,"[25]HoIpkoHcotHnJHGqKChJFAnpF",281,0.996454,25,282,1,281,1,1,0,1,1,138,137,144,144,25
"2389",88,"[25]HoIpkoHcotHnJHGqKChJFAnpF",276,0.99639,25,277,1,276,1,1,0,1,1,140,139,137,137,25
"2390",89,"[25]HoIpkoHcotHnJHGqKChJFAnpF",278,0.996416,25,279,1,278,1,1,0,1,1,141,140,138,138,25
"2391",90,"[25]HoIpkoHcotHnJHGqKChJFAnpF",289,0.996552,25,290,1,289,1,1,0,1,1,152,151,138,138,25
"2392",91,"[25]HoIpkoHcotHnJHGqKChJFAnpF",277,0.996403,25,278,1,277,1,1,0,1,1,140,139,138,138,25
"2393",92,"[25]HoIpkoHcotHnJHGqKChJFAnpF",273,0.99635,25,274,1,273,1,1,0,1,1,150,149,124,124,25
"2394",93,"[25]HoIpkoHcotHnJHGqKChJFAnpF",280,0.996441,25,281,1,280,1,1,0,1,1,131,130,150,150,25
"2395",94,"[25]HoIpkoHcotHnJHGqKChJFAnpF",282,0.996466,25,283,1,282,1,1,0,1,1,150,149,133,133,25
"2396",95,"[25]HoIpkoHcotHnJHGqKChJFAnpF",279,0.996429,25,280,1,279,1,1,0,1,1,152,151,128,128,25
"2397",96,"[25]HoIpkoHcotHnJHGqKChJFAnpF",275,0.996377,25,276,1,275,1,1,0,1,1,149,148,127,127,25
"2398",97,"[25]HoIpkoHcotHnJHGqKChJFAnpF",284,0.996491,25,285,1,284,1,1,0,1,1,141,140,144,144,25
"2399",98,"[25]HoIpkoHcotHnJHGqKChJFAnpF",284,0.996491,25,285,1,284,1,1,0,1,1,140,139,145,145,25
"2400",99,"[25]HoIpkoHcotHnJHGqKChJFAnpF",283,0.996479,25,284,1,283,1,1,0,1,1,156,155,128,128,25
"2401",0,"[23]yHoIloHcotHnJqKGCuBBqAJ",296,0.996633,23,297,1,296,1,1,0,1,1,151,150,146,146,26
"2402",1,"[23]yHoIloHcotHnJqKGCuBBqAJ",296,0.996633,23,297,1,296,1,1,0,1,1,150,149,147,147,26
"2403",2,"[23]yHoIloHcotHnJqKGCuBBqAJ",296,0.996633,23,297,1,296,1,1,0,1,1,147,146,150,150,26
"2404",3,"[23]yHoIloHcotHnJqKGCuBBqAJ",297,0.996644,23,298,1,297,1,1,0,1,1,150,149,148,148,26
"2405",4,"[23]yHoIloHcotHnJqKGCuBBqAJ",296,0.996633,23,297,1,296,1,1,0,1,1,153,152,144,144,26
"2406",5,"[23]yHoIloHcotHnJqKGCuBBqAJ",293,0.996599,23,294,1,293,1,1,0,1,1,137,136,157,157,26
"2407",6,"[23]yHoIloHcotHnJqKGCuBBqAJ",294,0.99661,23,295,1,294,1,1,0,1,1,141,140,154,154,26
"2408",7,"[23]yHoIloHcotHnJqKGCuBBqAJ",298,0.996656,23,299,1,298,1,1,0,1,1,153,152,146,146,26
"2409",8,"[23]yHoIloHcotHnJqKGCuBBqAJ",301,0.996689,23,302,1,301,1,1,0,1,1,168,167,134,134,26
"2410",9,"[23]yHoIloHcotHnJqKGCuBBqAJ",294,0.99661,23,295,1,294,1,1,0,1,1,141,140,154,154,26
"2411",10,"[23]yHoIloHcotHnJqKGCuBBqAJ",293,0.996599,23,294,1,293,1,1,0,1,1,136,135,158,158,26
"2412",11,"[23]yHoIloHcotHnJqKGCuBBqAJ",297,0.996644,23,298,1,297,1,1,0,1,1,148,147,150,150,26
"2413",12,"[23]yHoIloHcotHnJqKGCuBBqAJ",291,0.996575,23,292,1,291,1,1,0,1,1,138,137,154,154,26
"2414",13,"[23]yHoIloHcotHnJqKGCuBBqAJ",299,0.996667,23,300,1,299,1,1,0,1,1,157,156,143,143,26
"2415",14,"[23]yHoIloHcotHnJqKGCuBBqAJ",296,0.996633,23,297,1,296,1,1,0,1,1,147,146,150,150,26
"2416",15,"[23]yHoIloHcotHnJqKGCuBBqAJ",296,0.996633,23,297,1,296,1,1,0,1,1,148,147,149,149,26
"2417",16,"[23]yHoIloHcotHnJqKGCuBBqAJ",298,0.996656,23,299,1,298,1,1,0,1,1,149,148,150,150,26
"2418",17,"[23]yHoIloHcotHnJqKGCuBBqAJ",296,0.996633,23,297,1,296,1,1,0,1,1,148,147,149,149,26
"2419",18,"[23]yHoIloHcotHnJqKGCuBBqAJ",296,0.996633,23,297,1,296,1,1,0,1,1,146,145,151,151,26
"2420",19,"[23]yHoIloHcotHnJqKGCuBBqAJ",298,0.996656,23,299,1,298,1,1,0,1,1,157,156,142,142,26
"2421",20,"[23]yHoIloHcotHnJqKGCuBBqAJ",290,0.996564,23,291,1,290,1,1,0,1,1,129,128,162,162,26
"2422",21,"[23]yHoIloHcotHnJqKGCuBBqAJ",296,0.996633,23,297,1,296,1,1,0,1,1,147,146,150,150,26
"2423",22,"[23]yHoIloHcotHnJqKGCuBBqAJ",294,0.99661,23,295,1,294,1,1,0,1,1,138,137,157,157,26
"2424",23,"[23]yHoIloHcotHnJqKGCuBBqAJ",291,0.996575,23,292,1,291,1,1,0,1,1,133,132,159,159,26
"2425",24,"[23]yHoIloHcotHnJqKGCuBBqAJ",307,0.996753,23,308,1,307,1,1,0,1,1,180,179,128,128,26
"2426",25,"[23]yHoIloHcotHnJqKGCuBBqAJ",293,0.996599,23,294,1,293,1,1,0,1,1,138,137,156,156,26
"2427",26,"[23]yHoIloHcotHnJqKGCuBBqAJ",300,0.996678,23,301,1,300,1,1,0,1,1,158,157,143,143,26
"2428",27,"[23]yHoIloHcotHnJqKGCuBBqAJ",295,0.996622,23,296,1,295,1,1,0,1,1,142,141,154,154,26
"2429",28,"[23]yHoIloHcotHnJqKGCuBBqAJ",305,0.996732,23,306,1,305,1,1,0,1,1,176,175,130,130,26
"2430",29,"[23]yHoIloHcotHnJqKGCuBBqAJ",295,0.996622,23,296,1,295,1,1,0,1,1,149,148,147,147,26
"2431",30,"[23]yHoIloHcotHnJqKGCuBBqAJ",296,0.996633,23,297,1,296,1,1,0,1,1,151,150,146,146,26
"2432",31,"[23]yHoIloHcotHnJqKGCuBBqAJ",298,0.996656,23,299,1,298,1,1,0,1,1,152,151,147,147,26
"2433",32,"[23]yHoIloHcotHnJqKGCuBBqAJ",296,0.996633,23,297,1,296,1,1,0,1,1,148,147,149,149,26
"2434",33,"[23]yHoIloHcotHnJqKGCuBBqAJ",302,0.9967,23,303,1,302,1,1,0,1,1,158,157,145,145,26
"2435",34,"[23]yHoIloHcotHnJqKGCuBBqAJ",302,0.9967,23,303,1,302,1,1,0,1,1,160,159,143,143,26
"2436",35,"[23]yHoIloHcotHnJqKGCuBBqAJ",299,0.996667,23,300,1,299,1,1,0,1,1,162,161,138,138,26
"2437",36,"[23]yHoIloHcotHnJqKGCuBBqAJ",295,0.996622,23,296,1,295,1,1,0,1,1,142,141,154,154,26
"2438",37,"[23]yHoIloHcotHnJqKGCuBBqAJ",295,0.996622,23,296,1,295,1,1,0,1,1,150,149,146,146,26
"2439",38,"[23]yHoIloHcotHnJqKGCuBBqAJ",287,0.996528,23,288,1,287,1,1,0,1,1,135,134,153,153,26
"2440",39,"[23]yHoIloHcotHnJqKGCuBBqAJ",294,0.99661,23,295,1,294,1,1,0,1,1,140,139,155,155,26
"2441",40,"[23]yHoIloHcotHnJqKGCuBBqAJ",292,0.996587,23,293,1,292,1,1,0,1,1,138,137,155,155,26
"2442",41,"[23]yHoIloHcotHnJqKGCuBBqAJ",297,0.996644,23,298,1,297,1,1,0,1,1,147,146,151,151,26
"2443",42,"[23]yHoIloHcotHnJqKGCuBBqAJ",293,0.996599,23,294,1,293,1,1,0,1,1,141,140,153,153,26
"2444",43,"[23]yHoIloHcotHnJqKGCuBBqAJ",296,0.996633,23,297,1,296,1,1,0,1,1,145,144,152,152,26
"2445",44,"[23]yHoIloHcotHnJqKGCuBBqAJ",295,0.996622,23,296,1,295,1,1,0,1,1,155,154,141,141,26
"2446",45,"[23]yHoIloHcotHnJqKGCuBBqAJ",296,0.996633,23,297,1,296,1,1,0,1,1,145,144,152,152,26
"2447",46,"[23]yHoIloHcotHnJqKGCuBBqAJ",293,0.996599,23,294,1,293,1,1,0,1,1,138,137,156,156,26
"2448",47,"[23]yHoIloHcotHnJqKGCuBBqAJ",292,0.996587,23,293,1,292,1,1,0,1,1,136,135,157,157,26
"2449",48,"[23]yHoIloHcotHnJqKGCuBBqAJ",303,0.996711,23,304,1,303,1,1,0,1,1,165,164,139,139,26
"2450",49,"[23]yHoIloHcotHnJqKGCuBBqAJ",290,0.996564,23,291,1,290,1,1,0,1,1,130,129,161,161,26
"2451",50,"[23]yHoIloHcotHnJqKGCuBBqAJ",292,0.996587,23,293,1,292,1,1,0,1,1,142,141,151,151,26
"2452",51,"[23]yHoIloHcotHnJqKGCuBBqAJ",293,0.996599,23,294,1,293,1,1,0,1,1,149,148,145,145,26
"2453",52,"[23]yHoIloHcotHnJqKGCuBBqAJ",290,0.996564,23,291,1,290,1,1,0,1,1,130,129,161,161,26
"2454",53,"[23]yHoIloHcotHnJqKGCuBBqAJ",300,0.996678,23,301,1,300,1,1,0,1,1,156,155,145,145,26
"2455",54,"[23]yHoIloHcotHnJqKGCuBBqAJ",299,0.996667,23,300,1,299,1,1,0,1,1,160,159,140,140,26
"2456",55,"[23]yHoIloHcotHnJqKGCuBBqAJ",291,0.996575,23,292,1,291,1,1,0,1,1,131,130,161,161,26
"2457",56,"[23]yHoIloHcotHnJqKGCuBBqAJ",300,0.996678,23,301,1,300,1,1,0,1,1,150,149,151,151,26
"2458",57,"[23]yHoIloHcotHnJqKGCuBBqAJ",292,0.996587,23,293,1,292,1,1,0,1,1,134,133,159,159,26
"2459",58,"[23]yHoIloHcotHnJqKGCuBBqAJ",294,0.99661,23,295,1,294,1,1,0,1,1,151,150,144,144,26
"2460",59,"[23]yHoIloHcotHnJqKGCuBBqAJ",297,0.996644,23,298,1,297,1,1,0,1,1,150,149,148,148,26
"2461",60,"[23]yHoIloHcotHnJqKGCuBBqAJ",297,0.996644,23,298,1,297,1,1,0,1,1,150,149,148,148,26
"2462",61,"[23]yHoIloHcotHnJqKGCuBBqAJ",297,0.996644,23,298,1,297,1,1,0,1,1,149,148,149,149,26
"2463",62,"[23]yHoIloHcotHnJqKGCuBBqAJ",295,0.996622,23,296,1,295,1,1,0,1,1,144,143,152,152,26
"2464",63,"[23]yHoIloHcotHnJqKGCuBBqAJ",296,0.996633,23,297,1,296,1,1,0,1,1,151,150,146,146,26
"2465",64,"[23]yHoIloHcotHnJqKGCuBBqAJ",300,0.996678,23,301,1,300,1,1,0,1,1,158,157,143,143,26
"2466",65,"[23]yHoIloHcotHnJqKGCuBBqAJ",296,0.996633,23,297,1,296,1,1,0,1,1,150,149,147,147,26
"2467",66,"[23]yHoIloHcotHnJqKGCuBBqAJ",301,0.996689,23,302,1,301,1,1,0,1,1,158,157,144,144,26
"2468",67,"[23]yHoIloHcotHnJqKGCuBBqAJ",295,0.996622,23,296,1,295,1,1,0,1,1,147,146,149,149,26
"2469",68,"[23]yHoIloHcotHnJqKGCuBBqAJ",296,0.996633,23,297,1,296,1,1,0,1,1,156,155,141,141,26
"2470",69,"[23]yHoIloHcotHnJqKGCuBBqAJ",291,0.996575,23,292,1,291,1,1,0,1,1,133,132,159,159,26
"2471",70,"[23]yHoIloHcotHnJqKGCuBBqAJ",293,0.996599,23,294,1,293,1,1,0,1,1,143,142,151,151,26
"2472",71,"[23]yHoIloHcotHnJqKGCuBBqAJ",294,0.99661,23,295,1,294,1,1,0,1,1,140,139,155,155,26
"2473",72,"[23]yHoIloHcotHnJqKGCuBBqAJ",297,0.996644,23,298,1,297,1,1,0,1,1,149,148,149,149,26
"2474",73,"[23]yHoIloHcotHnJqKGCuBBqAJ",297,0.996644,23,298,1,297,1,1,0,1,1,147,146,151,151,26
"2475",74,"[23]yHoIloHcotHnJqKGCuBBqAJ",294,0.99661,23,295,1,294,1,1,0,1,1,143,142,152,152,26
"2476",75,"[23]yHoIloHcotHnJqKGCuBBqAJ",300,0.996678,23,301,1,300,1,1,0,1,1,166,165,135,135,26
"2477",76,"[23]yHoIloHcotHnJqKGCuBBqAJ",294,0.99661,23,295,1,294,1,1,0,1,1,145,144,150,150,26
"2478",77,"[23]yHoIloHcotHnJqKGCuBBqAJ",298,0.996656,23,299,1,298,1,1,0,1,1,151,150,148,148,26
"2479",78,"[23]yHoIloHcotHnJqKGCuBBqAJ",293,0.996599,23,294,1,293,1,1,0,1,1,138,137,156,156,26
"2480",79,"[23]yHoIloHcotHnJqKGCuBBqAJ",300,0.996678,23,301,1,300,1,1,0,1,1,168,167,133,133,26
"2481",80,"[23]yHoIloHcotHnJqKGCuBBqAJ",296,0.996633,23,297,1,296,1,1,0,1,1,148,147,149,149,26
"2482",81,"[23]yHoIloHcotHnJqKGCuBBqAJ",297,0.996644,23,298,1,297,1,1,0,1,1,148,147,150,150,26
"2483",82,"[23]yHoIloHcotHnJqKGCuBBqAJ",293,0.996599,23,294,1,293,1,1,0,1,1,142,141,152,152,26
"2484",83,"[23]yHoIloHcotHnJqKGCuBBqAJ",295,0.996622,23,296,1,295,1,1,0,1,1,150,149,146,146,26
"2485",84,"[23]yHoIloHcotHnJqKGCuBBqAJ",286,0.996516,23,287,1,286,1,1,0,1,1,118,117,169,169,26
"2486",85,"[23]yHoIloHcotHnJqKGCuBBqAJ",296,0.996633,23,297,1,296,1,1,0,1,1,150,149,147,147,26
"2487",86,"[23]yHoIloHcotHnJqKGCuBBqAJ",297,0.996644,23,298,1,297,1,1,0,1,1,146,145,152,152,26
"2488",87,"[23]yHoIloHcotHnJqKGCuBBqAJ",294,0.99661,23,295,1,294,1,1,0,1,1,143,142,152,152,26
"2489",88,"[23]yHoIloHcotHnJqKGCuBBqAJ",296,0.996633,23,297,1,296,1,1,0,1,1,148,147,149,149,26
"2490",89,"[23]yHoIloHcotHnJqKGCuBBqAJ",297,0.996644,23,298,1,297,1,1,0,1,1,153,152,145,145,26
"2491",90,"[23]yHoIloHcotHnJqKGCuBBqAJ",297,0.996644,23,298,1,297,1,1,0,1,1,152,151,146,146,26
"2492",91,"[23]yHoIloHcotHnJqKGCuBBqAJ",306,0.996743,23,307,1,306,1,1,0,1,1,177,176,130,130,26
"2493",92,"[23]yHoIloHcotHnJqKGCuBBqAJ",290,0.996564,23,291,1,290,1,1,0,1,1,151,150,140,140,26
"2494",93,"[23]yHoIloHcotHnJqKGCuBBqAJ",294,0.99661,23,295,1,294,1,1,0,1,1,158,157,137,137,26
"2495",94,"[23]yHoIloHcotHnJqKGCuBBqAJ",295,0.996622,23,296,1,295,1,1,0,1,1,144,143,152,152,26
"2496",95,"[23]yHoIloHcotHnJqKGCuBBqAJ",299,0.996667,23,300,1,299,1,1,0,1,1,149,148,151,151,26
"2497",96,"[23]yHoIloHcotHnJqKGCuBBqAJ",297,0.996644,23,298,1,297,1,1,0,1,1,148,147,150,150,26
"2498",97,"[23]yHoIloHcotHnJqKGCuBBqAJ",298,0.996656,23,299,1,298,1,1,0,1,1,158,157,141,141,26
"2499",98,"[23]yHoIloHcotHnJqKGCuBBqAJ",297,0.996644,23,298,1,297,1,1,0,1,1,147,146,151,151,26
"2500",99,"[23]yHoIloHcotHnJqKGCuBBqAJ",294,0.99661,23,295,1,294,1,1,0,1,1,147,146,148,148,26
"2501",0,"[23]FwHoIoHcosHnJHGqKCFlbbc",282,0.996466,23,283,1,282,1,1,0,1,1,136,135,147,147,27
"2502",1,"[23]FwHoIoHcosHnJHGqKCFlbbc",281,0.996454,23,282,1,281,1,1,0,1,1,140,139,142,142,27
"2503",2,"[23]FwHoIoHcosHnJHGqKCFlbbc",272,0.996337,23,273,1,272,1,1,0,1,1,139,138,134,134,27
"2504",3,"[23]FwHoIoHcosHnJHGqKCFlbbc",269,0.996296,23,270,1,269,1,1,0,1,1,137,136,133,133,27
"2505",4,"[23]FwHoIoHcosHnJHGqKCFlbbc",289,0.996552,23,290,1,289,1,1,0,1,1,151,150,139,139,27
"2506",5,"[23]FwHoIoHcosHnJHGqKCFlbbc",284,0.996491,23,285,1,284,1,1,0,1,1,133,132,152,152,27
"2507",6,"[23]FwHoIoHcosHnJHGqKCFlbbc",277,0.996403,23,278,1,277,1,1,0,1,1,127,126,151,151,27
"2508",7,"[23]FwHoIoHcosHnJHGqKCFlbbc",283,0.996479,23,284,1,283,1,1,0,1,1,131,130,153,153,27
"2509",8,"[23]FwHoIoHcosHnJHGqKCFlbbc",284,0.996491,23,285,1,284,1,1,0,1,1,149,148,136,136,27
"2510",9,"[23]FwHoIoHcosHnJHGqKCFlbbc",283,0.996479,23,284,1,283,1,1,0,1,1,145,144,139,139,27
"2511",10,"[23]FwHoIoHcosHnJHGqKCFlbbc",288,0.99654,23,289,1,288,1,1,0,1,1,149,148,140,140,27
"2512",11,"[23]FwHoIoHcosHnJHGqKCFlbbc",281,0.996454,23,282,1,281,1,1,0,1,1,129,128,153,153,27
"2513",12,"[23]FwHoIoHcosHnJHGqKCFlbbc",277,0.996403,23,278,1,277,1,1,0,1,1,133,132,145,145,27
"2514",13,"[23]FwHoIoHcosHnJHGqKCFlbbc",274,0.996364,23,275,1,274,1,1,0,1,1,121,120,154,154,27
"2515",14,"[23]FwHoIoHcosHnJHGqKCFlbbc",286,0.996516,23,287,1,286,1,1,0,1,1,147,146,140,140,27
"2516",15,"[23]FwHoIoHcosHnJHGqKCFlbbc",291,0.996575,23,292,1,291,1,1,0,1,1,156,155,136,136,27
"2517",16,"[23]FwHoIoHcosHnJHGqKCFlbbc",286,0.996516,23,287,1,286,1,1,0,1,1,137,136,150,150,27
"2518",17,"[23]FwHoIoHcosHnJHGqKCFlbbc",278,0.996416,23,279,1,278,1,1,0,1,1,139,138,140,140,27
"2519",18,"[23]FwHoIoHcosHnJHGqKCFlbbc",282,0.996466,23,283,1,282,1,1,0,1,1,150,149,133,133,27
"2520",19,"[23]FwHoIoHcosHnJHGqKCFlbbc",286,0.996516,23,287,1,286,1,1,0,1,1,147,146,140,140,27
"2521",20,"[23]FwHoIoHcosHnJHGqKCFlbbc",274,0.996364,23,275,1,274,1,1,0,1,1,141,140,134,134,27
"2522",21,"[23]FwHoIoHcosHnJHGqKCFlbbc",277,0.996403,23,278,1,277,1,1,0,1,1,141,140,137,137,27
"2523",22,"[23]FwHoIoHcosHnJHGqKCFlbbc",283,0.996479,23,284,1,283,1,1,0,1,1,138,137,146,146,27
"2524",23,"[23]FwHoIoHcosHnJHGqKCFlbbc",279,0.996429,23,280,1,279,1,1,0,1,1,138,137,142,142,27
"2525",24,"[23]FwHoIoHcosHnJHGqKCFlbbc",277,0.996403,23,278,1,277,1,1,0,1,1,128,127,150,150,27
"2526",25,"[23]FwHoIoHcosHnJHGqKCFlbbc",281,0.996454,23,282,1,281,1,1,0,1,1,145,144,137,137,27
"2527",26,"[23]FwHoIoHcosHnJHGqKCFlbbc",284,0.996491,23,285,1,284,1,1,0,1,1,143,142,142,142,27
"2528",27,"[23]FwHoIoHcosHnJHGqKCFlbbc",283,0.996479,23,284,1,283,1,1,0,1,1,145,144,139,139,27
"2529",28,"[23]FwHoIoHcosHnJHGqKCFlbbc",287,0.996528,23,288,1,287,1,1,0,1,1,160,159,128,128,27
"2530",29,"[23]FwHoIoHcosHnJHGqKCFlbbc",287,0.996528,23,288,1,287,1,1,0,1,1,162,161,126,126,27
"2531",30,"[23]FwHoIoHcosHnJHGqKCFlbbc",283,0.996479,23,284,1,283,1,1,0,1,1,149,148,135,135,27
"2532",31,"[23]FwHoIoHcosHnJHGqKCFlbbc",280,0.996441,23,281,1,280,1,1,0,1,1,141,140,140,140,27
"2533",32,"[23]FwHoIoHcosHnJHGqKCFlbbc",284,0.996491,23,285,1,284,1,1,0,1,1,142,141,143,143,27
"2534",33,"[23]FwHoIoHcosHnJHGqKCFlbbc",290,0.996564,23,291,1,290,1,1,0,1,1,161,160,130,130,27
"2535",34,"[23]FwHoIoHcosHnJHGqKCFlbbc",280,0.996441,23,281,1,280,1,1,0,1,1,148,147,133,133,27
"2536",35,"[23]FwHoIoHcosHnJHGqKCFlbbc",281,0.996454,23,282,1,281,1,1,0,1,1,137,136,145,145,27
"2537",36,"[23]FwHoIoHcosHnJHGqKCFlbbc",279,0.996429,23,280,1,279,1,1,0,1,1,131,130,149,149,27
"2538",37,"[23]FwHoIoHcosHnJHGqKCFlbbc",279,0.996429,23,280,1,279,1,1,0,1,1,131,130,149,149,27
"2539",38,"[23]FwHoIoHcosHnJHGqKCFlbbc",281,0.996454,23,282,1,281,1,1,0,1,1,135,134,147,147,27
"2540",39,"[23]FwHoIoHcosHnJHGqKCFlbbc",277,0.996403,23,278,1,277,1,1,0,1,1,143,142,135,135,27
"2541",40,"[23]FwHoIoHcosHnJHGqKCFlbbc",281,0.996454,23,282,1,281,1,1,0,1,1,142,141,140,140,27
"2542",41,"[23]FwHoIoHcosHnJHGqKCFlbbc",284,0.996491,23,285,1,284,1,1,0,1,1,162,161,123,123,27
"2543",42,"[23]FwHoIoHcosHnJHGqKCFlbbc",277,0.996403,23,278,1,277,1,1,0,1,1,134,133,144,144,27
"2544",43,"[23]FwHoIoHcosHnJHGqKCFlbbc",285,0.996503,23,286,1,285,1,1,0,1,1,139,138,147,147,27
"2545",44,"[23]FwHoIoHcosHnJHGqKCFlbbc",280,0.996441,23,281,1,280,1,1,0,1,1,132,131,149,149,27
"2546",45,"[23]FwHoIoHcosHnJHGqKCFlbbc",276,0.99639,23,277,1,276,1,1,0,1,1,137,136,140,140,27
"2547",46,"[23]FwHoIoHcosHnJHGqKCFlbbc",279,0.996429,23,280,1,279,1,1,0,1,1,148,147,132,132,27
"2548",47,"[23]FwHoIoHcosHnJHGqKCFlbbc",276,0.99639,23,277,1,276,1,1,0,1,1,123,122,154,154,27
"2549",48,"[23]FwHoIoHcosHnJHGqKCFlbbc",284,0.996491,23,285,1,284,1,1,0,1,1,141,140,144,144,27
"2550",49,"[23]FwHoIoHcosHnJHGqKCFlbbc",273,0.99635,23,274,1,273,1,1,0,1,1,135,134,139,139,27
"2551",50,"[23]FwHoIoHcosHnJHGqKCFlbbc",286,0.996516,23,287,1,286,1,1,0,1,1,142,141,145,145,27
"2552",51,"[23]FwHoIoHcosHnJHGqKCFlbbc",277,0.996403,23,278,1,277,1,1,0,1,1,133,132,145,145,27
"2553",52,"[23]FwHoIoHcosHnJHGqKCFlbbc",286,0.996516,23,287,1,286,1,1,0,1,1,141,140,146,146,27
"2554",53,"[23]FwHoIoHcosHnJHGqKCFlbbc",280,0.996441,23,281,1,280,1,1,0,1,1,138,137,143,143,27
"2555",54,"[23]FwHoIoHcosHnJHGqKCFlbbc",278,0.996416,23,279,1,278,1,1,0,1,1,133,132,146,146,27
"2556",55,"[23]FwHoIoHcosHnJHGqKCFlbbc",277,0.996403,23,278,1,277,1,1,0,1,1,133,132,145,145,27
"2557",56,"[23]FwHoIoHcosHnJHGqKCFlbbc",287,0.996528,23,288,1,287,1,1,0,1,1,139,138,149,149,27
"2558",57,"[23]FwHoIoHcosHnJHGqKCFlbbc",278,0.996416,23,279,1,278,1,1,0,1,1,149,148,130,130,27
"2559",58,"[23]FwHoIoHcosHnJHGqKCFlbbc",283,0.996479,23,284,1,283,1,1,0,1,1,135,134,149,149,27
"2560",59,"[23]FwHoIoHcosHnJHGqKCFlbbc",277,0.996403,23,278,1,277,1,1,0,1,1,142,141,136,136,27
"2561",60,"[23]FwHoIoHcosHnJHGqKCFlbbc",280,0.996441,23,281,1,280,1,1,0,1,1,141,140,140,140,27
"2562",61,"[23]FwHoIoHcosHnJHGqKCFlbbc",283,0.996479,23,284,1,283,1,1,0,1,1,136,135,148,148,27
"2563",62,"[23]FwHoIoHcosHnJHGqKCFlbbc",283,0.996479,23,284,1,283,1,1,0,1,1,146,145,138,138,27
"2564",63,"[23]FwHoIoHcosHnJHGqKCFlbbc",282,0.996466,23,283,1,282,1,1,0,1,1,152,151,131,131,27
"2565",64,"[23]FwHoIoHcosHnJHGqKCFlbbc",283,0.996479,23,284,1,283,1,1,0,1,1,154,153,130,130,27
"2566",65,"[23]FwHoIoHcosHnJHGqKCFlbbc",276,0.99639,23,277,1,276,1,1,0,1,1,149,148,128,128,27
"2567",66,"[23]FwHoIoHcosHnJHGqKCFlbbc",286,0.996516,23,287,1,286,1,1,0,1,1,153,152,134,134,27
"2568",67,"[23]FwHoIoHcosHnJHGqKCFlbbc",282,0.996466,23,283,1,282,1,1,0,1,1,141,140,142,142,27
"2569",68,"[23]FwHoIoHcosHnJHGqKCFlbbc",276,0.99639,23,277,1,276,1,1,0,1,1,120,119,157,157,27
"2570",69,"[23]FwHoIoHcosHnJHGqKCFlbbc",274,0.996364,23,275,1,274,1,1,0,1,1,146,145,129,129,27
"2571",70,"[23]FwHoIoHcosHnJHGqKCFlbbc",276,0.99639,23,277,1,276,1,1,0,1,1,133,132,144,144,27
"2572",71,"[23]FwHoIoHcosHnJHGqKCFlbbc",272,0.996337,23,273,1,272,1,1,0,1,1,115,114,158,158,27
"2573",72,"[23]FwHoIoHcosHnJHGqKCFlbbc",277,0.996403,23,278,1,277,1,1,0,1,1,134,133,144,144,27
"2574",73,"[23]FwHoIoHcosHnJHGqKCFlbbc",275,0.996377,23,276,1,275,1,1,0,1,1,123,122,153,153,27
"2575",74,"[23]FwHoIoHcosHnJHGqKCFlbbc",281,0.996454,23,282,1,281,1,1,0,1,1,151,150,131,131,27
"2576",75,"[23]FwHoIoHcosHnJHGqKCFlbbc",284,0.996491,23,285,1,284,1,1,0,1,1,138,137,147,147,27
"2577",76,"[23]FwHoIoHcosHnJHGqKCFlbbc",280,0.996441,23,281,1,280,1,1,0,1,1,139,138,142,142,27
"2578",77,"[23]FwHoIoHcosHnJHGqKCFlbbc",278,0.996416,23,279,1,278,1,1,0,1,1,154,153,125,125,27
"2579",78,"[23]FwHoIoHcosHnJHGqKCFlbbc",284,0.996491,23,285,1,284,1,1,0,1,1,139,138,146,146,27
"2580",79,"[23]FwHoIoHcosHnJHGqKCFlbbc",285,0.996503,23,286,1,285,1,1,0,1,1,150,149,136,136,27
"2581",80,"[23]FwHoIoHcosHnJHGqKCFlbbc",284,0.996491,23,285,1,284,1,1,0,1,1,162,161,123,123,27
"2582",81,"[23]FwHoIoHcosHnJHGqKCFlbbc",283,0.996479,23,284,1,283,1,1,0,1,1,131,130,153,153,27
"2583",82,"[23]FwHoIoHcosHnJHGqKCFlbbc",279,0.996429,23,280,1,279,1,1,0,1,1,143,142,137,137,27
"2584",83,"[23]FwHoIoHcosHnJHGqKCFlbbc",282,0.996466,23,283,1,282,1,1,0,1,1,138,137,145,145,27
"2585",84,"[23]FwHoIoHcosHnJHGqKCFlbbc",284,0.996491,23,285,1,284,1,1,0,1,1,151,150,134,134,27
"2586",85,"[23]FwHoIoHcosHnJHGqKCFlbbc",273,0.99635,23,274,1,273,1,1,0,1,1,126,125,148,148,27
"2587",86,"[23]FwHoIoHcosHnJHGqKCFlbbc",281,0.996454,23,282,1,281,1,1,0,1,1,134,133,148,148,27
"2588",87,"[23]FwHoIoHcosHnJHGqKCFlbbc",287,0.996528,23,288,1,287,1,1,0,1,1,144,143,144,144,27
"2589",88,"[23]FwHoIoHcosHnJHGqKCFlbbc",282,0.996466,23,283,1,282,1,1,0,1,1,148,147,135,135,27
"2590",89,"[23]FwHoIoHcosHnJHGqKCFlbbc",278,0.996416,23,279,1,278,1,1,0,1,1,145,144,134,134,27
"2591",90,"[23]FwHoIoHcosHnJHGqKCFlbbc",278,0.996416,23,279,1,278,1,1,0,1,1,143,142,136,136,27
"2592",91,"[23]FwHoIoHcosHnJHGqKCFlbbc",284,0.996491,23,285,1,284,1,1,0,1,1,138,137,147,147,27
"2593",92,"[23]FwHoIoHcosHnJHGqKCFlbbc",283,0.996479,23,284,1,283,1,1,0,1,1,134,133,150,150,27
"2594",93,"[23]FwHoIoHcosHnJHGqKCFlbbc",283,0.996479,23,284,1,283,1,1,0,1,1,128,127,156,156,27
"2595",94,"[23]FwHoIoHcosHnJHGqKCFlbbc",281,0.996454,23,282,1,281,1,1,0,1,1,141,140,141,141,27
"2596",95,"[23]FwHoIoHcosHnJHGqKCFlbbc",287,0.996528,23,288,1,287,1,1,0,1,1,141,140,147,147,27
"2597",96,"[23]FwHoIoHcosHnJHGqKCFlbbc",276,0.99639,23,277,1,276,1,1,0,1,1,121,120,156,156,27
"2598",97,"[23]FwHoIoHcosHnJHGqKCFlbbc",275,0.996377,23,276,1,275,1,1,0,1,1,131,130,145,145,27
"2599",98,"[23]FwHoIoHcosHnJHGqKCFlbbc",279,0.996429,23,280,1,279,1,1,0,1,1,134,133,146,146,27
"2600",99,"[23]FwHoIoHcosHnJHGqKCFlbbc",280,0.996441,23,281,1,280,1,1,0,1,1,136,135,145,145,27
"2601",0,"[21]ioIoHcoxHnJHGqKCBIHHx",286,0.996516,21,287,1,286,1,1,0,1,1,148,147,139,139,28
"2602",1,"[21]ioIoHcoxHnJHGqKCBIHHx",285,0.996503,21,286,1,285,1,1,0,1,1,143,142,143,143,28
"2603",2,"[21]ioIoHcoxHnJHGqKCBIHHx",280,0.996441,21,281,1,280,1,1,0,1,1,143,142,138,138,28
"2604",3,"[21]ioIoHcoxHnJHGqKCBIHHx",277,0.996403,21,278,1,277,1,1,0,1,1,143,142,135,135,28
"2605",4,"[21]ioIoHcoxHnJHGqKCBIHHx",283,0.996479,21,284,1,283,1,1,0,1,1,138,137,146,146,28
"2606",5,"[21]ioIoHcoxHnJHGqKCBIHHx",278,0.996416,21,279,1,278,1,1,0,1,1,146,145,133,133,28
"2607",6,"[21]ioIoHcoxHnJHGqKCBIHHx",285,0.996503,21,286,1,285,1,1,0,1,1,142,141,144,144,28
"2608",7,"[21]ioIoHcoxHnJHGqKCBIHHx",278,0.996416,21,279,1,278,1,1,0,1,1,138,137,141,141,28
"2609",8,"[21]ioIoHcoxHnJHGqKCBIHHx",280,0.996441,21,281,1,280,1,1,0,1,1,133,132,148,148,28
"2610",9,"[21]ioIoHcoxHnJHGqKCBIHHx",283,0.996479,21,284,1,283,1,1,0,1,1,145,144,139,139,28
"2611",10,"[21]ioIoHcoxHnJHGqKCBIHHx",276,0.99639,21,277,1,276,1,1,0,1,1,131,130,146,146,28
"2612",11,"[21]ioIoHcoxHnJHGqKCBIHHx",282,0.996466,21,283,1,282,1,1,0,1,1,151,150,132,132,28
"2613",12,"[21]ioIoHcoxHnJHGqKCBIHHx",287,0.996528,21,288,1,287,1,1,0,1,1,151,150,137,137,28
"2614",13,"[21]ioIoHcoxHnJHGqKCBIHHx",280,0.996441,21,281,1,280,1,1,0,1,1,126,125,155,155,28
"2615",14,"[21]ioIoHcoxHnJHGqKCBIHHx",274,0.996364,21,275,1,274,1,1,0,1,1,139,138,136,136,28
"2616",15,"[21]ioIoHcoxHnJHGqKCBIHHx",274,0.996364,21,275,1,274,1,1,0,1,1,135,134,140,140,28
"2617",16,"[21]ioIoHcoxHnJHGqKCBIHHx",275,0.996377,21,276,1,275,1,1,0,1,1,120,119,156,156,28
"2618",17,"[21]ioIoHcoxHnJHGqKCBIHHx",284,0.996491,21,285,1,284,1,1,0,1,1,141,140,144,144,28
"2619",18,"[21]ioIoHcoxHnJHGqKCBIHHx",277,0.996403,21,278,1,277,1,1,0,1,1,139,138,139,139,28
"2620",19,"[21]ioIoHcoxHnJHGqKCBIHHx",284,0.996491,21,285,1,284,1,1,0,1,1,139,138,146,146,28
"2621",20,"[21]ioIoHcoxHnJHGqKCBIHHx",283,0.996479,21,284,1,283,1,1,0,1,1,158,157,126,126,28
"2622",21,"[21]ioIoHcoxHnJHGqKCBIHHx",290,0.996564,21,291,1,290,1,1,0,1,1,156,155,135,135,28
"2623",22,"[21]ioIoHcoxHnJHGqKCBIHHx",281,0.996454,21,282,1,281,1,1,0,1,1,143,142,139,139,28
"2624",23,"[21]ioIoHcoxHnJHGqKCBIHHx",275,0.996377,21,276,1,275,1,1,0,1,1,133,132,143,143,28
"2625",24,"[21]ioIoHcoxHnJHGqKCBIHHx",279,0.996429,21,280,1,279,1,1,0,1,1,131,130,149,149,28
"2626",25,"[21]ioIoHcoxHnJHGqKCBIHHx",277,0.996403,21,278,1,277,1,1,0,1,1,138,137,140,140,28
"2627",26,"[21]ioIoHcoxHnJHGqKCBIHHx",289,0.996552,21,290,1,289,1,1,0,1,1,162,161,128,128,28
"2628",27,"[21]ioIoHcoxHnJHGqKCBIHHx",281,0.996454,21,282,1,281,1,1,0,1,1,144,143,138,138,28
"2629",28,"[21]ioIoHcoxHnJHGqKCBIHHx",282,0.996466,21,283,1,282,1,1,0,1,1,133,132,150,150,28
"2630",29,"[21]ioIoHcoxHnJHGqKCBIHHx",283,0.996479,21,284,1,283,1,1,0,1,1,143,142,141,141,28
"2631",30,"[21]ioIoHcoxHnJHGqKCBIHHx",284,0.996491,21,285,1,284,1,1,0,1,1,155,154,130,130,28
"2632",31,"[21]ioIoHcoxHnJHGqKCBIHHx",276,0.99639,21,277,1,276,1,1,0,1,1,135,134,142,142,28
"2633",32,"[21]ioIoHcoxHnJHGqKCBIHHx",279,0.996429,21,280,1,279,1,1,0,1,1,139,138,141,141,28
"2634",33,"[21]ioIoHcoxHnJHGqKCBIHHx",289,0.996552,21,290,1,289,1,1,0,1,1,144,143,146,146,28
"2635",34,"[21]ioIoHcoxHnJHGqKCBIHHx",287,0.996528,21,288,1,287,1,1,0,1,1,144,143,144,144,28
"2636",35,"[21]ioIoHcoxHnJHGqKCBIHHx",270,0.99631,21,271,1,270,1,1,0,1,1,146,145,125,125,28
"2637",36,"[21]ioIoHcoxHnJHGqKCBIHHx",283,0.996479,21,284,1,283,1,1,0,1,1,140,139,144,144,28
"2638",37,"[21]ioIoHcoxHnJHGqKCBIHHx",272,0.996337,21,273,1,272,1,1,0,1,1,128,127,145,145,28
"2639",38,"[21]ioIoHcoxHnJHGqKCBIHHx",283,0.996479,21,284,1,283,1,1,0,1,1,167,166,117,117,28
"2640",39,"[21]ioIoHcoxHnJHGqKCBIHHx",277,0.996403,21,278,1,277,1,1,0,1,1,129,128,149,149,28
"2641",40,"[21]ioIoHcoxHnJHGqKCBIHHx",283,0.996479,21,284,1,283,1,1,0,1,1,147,146,137,137,28
"2642",41,"[21]ioIoHcoxHnJHGqKCBIHHx",281,0.996454,21,282,1,281,1,1,0,1,1,135,134,147,147,28
"2643",42,"[21]ioIoHcoxHnJHGqKCBIHHx",285,0.996503,21,286,1,285,1,1,0,1,1,140,139,146,146,28
"2644",43,"[21]ioIoHcoxHnJHGqKCBIHHx",294,0.99661,21,295,1,294,1,1,0,1,1,160,159,135,135,28
"2645",44,"[21]ioIoHcoxHnJHGqKCBIHHx",285,0.996503,21,286,1,285,1,1,0,1,1,134,133,152,152,28
"2646",45,"[21]ioIoHcoxHnJHGqKCBIHHx",273,0.99635,21,274,1,273,1,1,0,1,1,142,141,132,132,28
"2647",46,"[21]ioIoHcoxHnJHGqKCBIHHx",281,0.996454,21,282,1,281,1,1,0,1,1,165,164,117,117,28
"2648",47,"[21]ioIoHcoxHnJHGqKCBIHHx",282,0.996466,21,283,1,282,1,1,0,1,1,129,128,154,154,28
"2649",48,"[21]ioIoHcoxHnJHGqKCBIHHx",281,0.996454,21,282,1,281,1,1,0,1,1,139,138,143,143,28
"2650",49,"[21]ioIoHcoxHnJHGqKCBIHHx",283,0.996479,21,284,1,283,1,1,0,1,1,134,133,150,150,28
"2651",50,"[21]ioIoHcoxHnJHGqKCBIHHx",273,0.99635,21,274,1,273,1,1,0,1,1,132,131,142,142,28
"2652",51,"[21]ioIoHcoxHnJHGqKCBIHHx",288,0.99654,21,289,1,288,1,1,0,1,1,149,148,140,140,28
"2653",52,"[21]ioIoHcoxHnJHGqKCBIHHx",281,0.996454,21,282,1,281,1,1,0,1,1,148,147,134,134,28
"2654",53,"[21]ioIoHcoxHnJHGqKCBIHHx",284,0.996491,21,285,1,284,1,1,0,1,1,134,133,151,151,28
"2655",54,"[21]ioIoHcoxHnJHGqKCBIHHx",275,0.996377,21,276,1,275,1,1,0,1,1,124,123,152,152,28
"2656",55,"[21]ioIoHcoxHnJHGqKCBIHHx",273,0.99635,21,274,1,273,1,1,0,1,1,111,110,163,163,28
"2657",56,"[21]ioIoHcoxHnJHGqKCBIHHx",279,0.996429,21,280,1,279,1,1,0,1,1,145,144,135,135,28
"2658",57,"[21]ioIoHcoxHnJHGqKCBIHHx",279,0.996429,21,280,1,279,1,1,0,1,1,150,149,130,130,28
"2659",58,"[21]ioIoHcoxHnJHGqKCBIHHx",281,0.996454,21,282,1,281,1,1,0,1,1,151,150,131,131,28
"2660",59,"[21]ioIoHcoxHnJHGqKCBIHHx",277,0.996403,21,278,1,277,1,1,0,1,1,145,144,133,133,28
"2661",60,"[21]ioIoHcoxHnJHGqKCBIHHx",290,0.996564,21,291,1,290,1,1,0,1,1,146,145,145,145,28
"2662",61,"[21]ioIoHcoxHnJHGqKCBIHHx",279,0.996429,21,280,1,279,1,1,0,1,1,129,128,151,151,28
"2663",62,"[21]ioIoHcoxHnJHGqKCBIHHx",278,0.996416,21,279,1,278,1,1,0,1,1,137,136,142,142,28
"2664",63,"[21]ioIoHcoxHnJHGqKCBIHHx",276,0.99639,21,277,1,276,1,1,0,1,1,128,127,149,149,28
"2665",64,"[21]ioIoHcoxHnJHGqKCBIHHx",287,0.996528,21,288,1,287,1,1,0,1,1,156,155,132,132,28
"2666",65,"[21]ioIoHcoxHnJHGqKCBIHHx",283,0.996479,21,284,1,283,1,1,0,1,1,151,150,133,133,28
"2667",66,"[21]ioIoHcoxHnJHGqKCBIHHx",279,0.996429,21,280,1,279,1,1,0,1,1,130,129,150,150,28
"2668",67,"[21]ioIoHcoxHnJHGqKCBIHHx",281,0.996454,21,282,1,281,1,1,0,1,1,134,133,148,148,28
"2669",68,"[21]ioIoHcoxHnJHGqKCBIHHx",284,0.996491,21,285,1,284,1,1,0,1,1,151,150,134,134,28
"2670",69,"[21]ioIoHcoxHnJHGqKCBIHHx",278,0.996416,21,279,1,278,1,1,0,1,1,130,129,149,149,28
"2671",70,"[21]ioIoHcoxHnJHGqKCBIHHx",283,0.996479,21,284,1,283,1,1,0,1,1,135,134,149,149,28
"2672",71,"[21]ioIoHcoxHnJHGqKCBIHHx",280,0.996441,21,281,1,280,1,1,0,1,1,126,125,155,155,28
"2673",72,"[21]ioIoHcoxHnJHGqKCBIHHx",283,0.996479,21,284,1,283,1,1,0,1,1,147,146,137,137,28
"2674",73,"[21]ioIoHcoxHnJHGqKCBIHHx",277,0.996403,21,278,1,277,1,1,0,1,1,127,126,151,151,28
"2675",74,"[21]ioIoHcoxHnJHGqKCBIHHx",280,0.996441,21,281,1,280,1,1,0,1,1,141,140,140,140,28
"2676",75,"[21]ioIoHcoxHnJHGqKCBIHHx",287,0.996528,21,288,1,287,1,1,0,1,1,143,142,145,145,28
"2677",76,"[21]ioIoHcoxHnJHGqKCBIHHx",271,0.996324,21,272,1,271,1,1,0,1,1,118,117,154,154,28
"2678",77,"[21]ioIoHcoxHnJHGqKCBIHHx",284,0.996491,21,285,1,284,1,1,0,1,1,147,146,138,138,28
"2679",78,"[21]ioIoHcoxHnJHGqKCBIHHx",277,0.996403,21,278,1,277,1,1,0,1,1,122,121,156,156,28
"2680",79,"[21]ioIoHcoxHnJHGqKCBIHHx",284,0.996491,21,285,1,284,1,1,0,1,1,145,144,140,140,28
"2681",80,"[21]ioIoHcoxHnJHGqKCBIHHx",287,0.996528,21,288,1,287,1,1,0,1,1,157,156,131,131,28
"2682",81,"[21]ioIoHcoxHnJHGqKCBIHHx",290,0.996564,21,291,1,290,1,1,0,1,1,148,147,143,143,28
"2683",82,"[21]ioIoHcoxHnJHGqKCBIHHx",283,0.996479,21,284,1,283,1,1,0,1,1,146,145,138,138,28
"2684",83,"[21]ioIoHcoxHnJHGqKCBIHHx",280,0.996441,21,281,1,280,1,1,0,1,1,146,145,135,135,28
"2685",84,"[21]ioIoHcoxHnJHGqKCBIHHx",289,0.996552,21,290,1,289,1,1,0,1,1,140,139,150,150,28
"2686",85,"[21]ioIoHcoxHnJHGqKCBIHHx",283,0.996479,21,284,1,283,1,1,0,1,1,150,149,134,134,28
"2687",86,"[21]ioIoHcoxHnJHGqKCBIHHx",278,0.996416,21,279,1,278,1,1,0,1,1,133,132,146,146,28
"2688",87,"[21]ioIoHcoxHnJHGqKCBIHHx",284,0.996491,21,285,1,284,1,1,0,1,1,144,143,141,141,28
"2689",88,"[21]ioIoHcoxHnJHGqKCBIHHx",277,0.996403,21,278,1,277,1,1,0,1,1,125,124,153,153,28
"2690",89,"[21]ioIoHcoxHnJHGqKCBIHHx",277,0.996403,21,278,1,277,1,1,0,1,1,147,146,131,131,28
"2691",90,"[21]ioIoHcoxHnJHGqKCBIHHx",286,0.996516,21,287,1,286,1,1,0,1,1,143,142,144,144,28
"2692",91,"[21]ioIoHcoxHnJHGqKCBIHHx",284,0.996491,21,285,1,284,1,1,0,1,1,153,152,132,132,28
"2693",92,"[21]ioIoHcoxHnJHGqKCBIHHx",282,0.996466,21,283,1,282,1,1,0,1,1,138,137,145,145,28
"2694",93,"[21]ioIoHcoxHnJHGqKCBIHHx",278,0.996416,21,279,1,278,1,1,0,1,1,132,131,147,147,28
"2695",94,"[21]ioIoHcoxHnJHGqKCBIHHx",278,0.996416,21,279,1,278,1,1,0,1,1,141,140,138,138,28
"2696",95,"[21]ioIoHcoxHnJHGqKCBIHHx",285,0.996503,21,286,1,285,1,1,0,1,1,150,149,136,136,28
"2697",96,"[21]ioIoHcoxHnJHGqKCBIHHx",284,0.996491,21,285,1,284,1,1,0,1,1,153,152,132,132,28
"2698",97,"[21]ioIoHcoxHnJHGqKCBIHHx",285,0.996503,21,286,1,285,1,1,0,1,1,162,161,124,124,28
"2699",98,"[21]ioIoHcoxHnJHGqKCBIHHx",287,0.996528,21,288,1,287,1,1,0,1,1,138,137,150,150,28
"2700",99,"[21]ioIoHcoxHnJHGqKCBIHHx",281,0.996454,21,282,1,281,1,1,0,1,1,130,129,152,152,28
"2701",0,"[25]AJHoIqaxzkHBvHnJHGqKCylkm",286,0.996516,25,287,1,286,1,1,0,1,1,142,141,145,145,29
"2702",1,"[25]AJHoIqaxzkHBvHnJHGqKCylkm",278,0.996416,25,279,1,278,1,1,0,1,1,127,126,152,152,29
"2703",2,"[25]AJHoIqaxzkHBvHnJHGqKCylkm",277,0.996403,25,278,1,277,1,1,0,1,1,126,125,152,152,29
"2704",3,"[25]AJHoIqaxzkHBvHnJHGqKCylkm",286,0.996516,25,287,1,286,1,1,0,1,1,144,143,143,143,29
"2705",4,"[25]AJHoIqaxzkHBvHnJHGqKCylkm",289,0.996552,25,290,1,289,1,1,0,1,1,144,143,146,146,29
"2706",5,"[25]AJHoIqaxzkHBvHnJHGqKCylkm",281,0.996454,25,282,1,281,1,1,0,1,1,142,141,140,140,29
"2707",6,"[25]AJHoIqaxzkHBvHnJHGqKCylkm",287,0.996528,25,288,1,287,1,1,0,1,1,132,131,156,156,29
"2708",7,"[25]AJHoIqaxzkHBvHnJHGqKCylkm",285,0.996503,25,286,1,285,1,1,0,1,1,154,153,132,132,29
"2709",8,"[25]AJHoIqaxzkHBvHnJHGqKCylkm",283,0.996479,25,284,1,283,1,1,0,1,1,141,140,143,143,29
"2710",9,"[25]AJHoIqaxzkHBvHnJHGqKCylkm",278,0.996416,25,279,1,278,1,1,0,1,1,141,140,138,138,29
"2711",10,"[25]AJHoIqaxzkHBvHnJHGqKCylkm",282,0.996466,25,283,1,282,1,1,0,1,1,150,149,133,133,29
"2712",11,"[25]AJHoIqaxzkHBvHnJHGqKCylkm",286,0.996516,25,287,1,286,1,1,0,1,1,134,133,153,153,29
"2713",12,"[25]AJHoIqaxzkHBvHnJHGqKCylkm",277,0.996403,25,278,1,277,1,1,0,1,1,128,127,150,150,29
"2714",13,"[25]AJHoIqaxzkHBvHnJHGqKCylkm",285,0.996503,25,286,1,285,1,1,0,1,1,143,142,143,143,29
"2715",14,"[25]AJHoIqaxzkHBvHnJHGqKCylkm",282,0.996466,25,283,1,282,1,1,0,1,1,144,143,139,139,29
"2716",15,"[25]AJHoIqaxzkHBvHnJHGqKCylkm",285,0.996503,25,286,1,285,1,1,0,1,1,150,149,136,136,29
"2717",16,"[25]AJHoIqaxzkHBvHnJHGqKCylkm",278,0.996416,25,279,1,278,1,1,0,1,1,142,141,137,137,29
"2718",17,"[25]AJHoIqaxzkHBvHnJHGqKCylkm",283,0.996479,25,284,1,283,1,1,0,1,1,132,131,152,152,29
"2719",18,"[25]AJHoIqaxzkHBvHnJHGqKCylkm",274,0.996364,25,275,1,274,1,1,0,1,1,131,130,144,144,29
"2720",19,"[25]AJHoIqaxzkHBvHnJHGqKCylkm",275,0.996377,25,276,1,275,1,1,0,1,1,127,126,149,149,29
"2721",20,"[25]AJHoIqaxzkHBvHnJHGqKCylkm",290,0.996564,25,291,1,290,1,1,0,1,1,150,149,141,141,29
"2722",21,"[25]AJHoIqaxzkHBvHnJHGqKCylkm",281,0.996454,25,282,1,281,1,1,0,1,1,159,158,123,123,29
"2723",22,"[25]AJHoIqaxzkHBvHnJHGqKCylkm",284,0.996491,25,285,1,284,1,1,0,1,1,137,136,148,148,29
"2724",23,"[25]AJHoIqaxzkHBvHnJHGqKCylkm",280,0.996441,25,281,1,280,1,1,0,1,1,134,133,147,147,29
"2725",24,"[25]AJHoIqaxzkHBvHnJHGqKCylkm",279,0.996429,25,280,1,279,1,1,0,1,1,136,135,144,144,29
"2726",25,"[25]AJHoIqaxzkHBvHnJHGqKCylkm",287,0.996528,25,288,1,287,1,1,0,1,1,157,156,131,131,29
"2727",26,"[25]AJHoIqaxzkHBvHnJHGqKCylkm",285,0.996503,25,286,1,285,1,1,0,1,1,141,140,145,145,29
"2728",27,"[25]AJHoIqaxzkHBvHnJHGqKCylkm",282,0.996466,25,283,1,282,1,1,0,1,1,152,151,131,131,29
"2729",28,"[25]AJHoIqaxzkHBvHnJHGqKCylkm",285,0.996503,25,286,1,285,1,1,0,1,1,161,160,125,125,29
"2730",29,"[25]AJHoIqaxzkHBvHnJHGqKCylkm",284,0.996491,25,285,1,284,1,1,0,1,1,155,154,130,130,29
"2731",30,"[25]AJHoIqaxzkHBvHnJHGqKCylkm",288,0.99654,25,289,1,288,1,1,0,1,1,152,151,137,137,29
"2732",31,"[25]AJHoIqaxzkHBvHnJHGqKCylkm",279,0.996429,25,280,1,279,1,1,0,1,1,129,128,151,151,29
"2733",32,"[25]AJHoIqaxzkHBvHnJHGqKCylkm",290,0.996564,25,291,1,290,1,1,0,1,1,136,135,155,155,29
"2734",33,"[25]AJHoIqaxzkHBvHnJHGqKCylkm",283,0.996479,25,284,1,283,1,1,0,1,1,148,147,136,136,29
"2735",34,"[25]AJHoIqaxzkHBvHnJHGqKCylkm",284,0.996491,25,285,1,284,1,1,0,1,1,157,156,128,128,29
"2736",35,"[25]AJHoIqaxzkHBvHnJHGqKCylkm",286,0.996516,25,287,1,286,1,1,0,1,1,149,148,138,138,29
"2737",36,"[25]AJHoIqaxzkHBvHnJHGqKCylkm",289,0.996552,25,290,1,289,1,1,0,1,1,153,152,137,137,29
"2738",37,"[25]AJHoIqaxzkHBvHnJHGqKCylkm",282,0.996466,25,283,1,282,1,1,0,1,1,152,151,131,131,29
"2739",38,"[25]AJHoIqaxzkHBvHnJHGqKCylkm",278,0.996416,25,279,1,278,1,1,0,1,1,135,134,144,144,29
"2740",39,"[25]AJHoIqaxzkHBvHnJHGqKCylkm",290,0.996564,25,291,1,290,1,1,0,1,1,145,144,146,146,29
"2741",40,"[25]AJHoIqaxzkHBvHnJHGqKCylkm",277,0.996403,25,278,1,277,1,1,0,1,1,125,124,153,153,29
"2742",41,"[25]AJHoIqaxzkHBvHnJHGqKCylkm",283,0.996479,25,284,1,283,1,1,0,1,1,141,140,143,143,29
"2743",42,"[25]AJHoIqaxzkHBvHnJHGqKCylkm",291,0.996575,25,292,1,291,1,1,0,1,1,152,151,140,140,29
"2744",43,"[25]AJHoIqaxzkHBvHnJHGqKCylkm",286,0.996516,25,287,1,286,1,1,0,1,1,145,144,142,142,29
"2745",44,"[25]AJHoIqaxzkHBvHnJHGqKCylkm",281,0.996454,25,282,1,281,1,1,0,1,1,139,138,143,143,29
"2746",45,"[25]AJHoIqaxzkHBvHnJHGqKCylkm",282,0.996466,25,283,1,282,1,1,0,1,1,135,134,148,148,29
"2747",46,"[25]AJHoIqaxzkHBvHnJHGqKCylkm",273,0.99635,25,274,1,273,1,1,0,1,1,141,140,133,133,29
"2748",47,"[25]AJHoIqaxzkHBvHnJHGqKCylkm",287,0.996528,25,288,1,287,1,1,0,1,1,153,152,135,135,29
"2749",48,"[25]AJHoIqaxzkHBvHnJHGqKCylkm",277,0.996403,25,278,1,277,1,1,0,1,1,124,123,154,154,29
"2750",49,"[25]AJHoIqaxzkHBvHnJHGqKCylkm",280,0.996441,25,281,1,280,1,1,0,1,1,148,147,133,133,29
"2751",50,"[25]AJHoIqaxzkHBvHnJHGqKCylkm",286,0.996516,25,287,1,286,1,1,0,1,1,145,144,142,142,29
"2752",51,"[25]AJHoIqaxzkHBvHnJHGqKCylkm",279,0.996429,25,280,1,279,1,1,0,1,1,126,125,154,154,29
"2753",52,"[25]AJHoIqaxzkHBvHnJHGqKCylkm",291,0.996575,25,292,1,291,1,1,0,1,1,157,156,135,135,29
"2754",53,"[25]AJHoIqaxzkHBvHnJHGqKCylkm",289,0.996552,25,290,1,289,1,1,0,1,1,139,138,151,151,29
"2755",54,"[25]AJHoIqaxzkHBvHnJHGqKCylkm",287,0.996528,25,288,1,287,1,1,0,1,1,154,153,134,134,29
"2756",55,"[25]AJHoIqaxzkHBvHnJHGqKCylkm",292,0.996587,25,293,1,292,1,1,0,1,1,148,147,145,145,29
"2757",56,"[25]AJHoIqaxzkHBvHnJHGqKCylkm",278,0.996416,25,279,1,278,1,1,0,1,1,130,129,149,149,29
"2758",57,"[25]AJHoIqaxzkHBvHnJHGqKCylkm",280,0.996441,25,281,1,280,1,1,0,1,1,137,136,144,144,29
"2759",58,"[25]AJHoIqaxzkHBvHnJHGqKCylkm",285,0.996503,25,286,1,285,1,1,0,1,1,137,136,149,149,29
"2760",59,"[25]AJHoIqaxzkHBvHnJHGqKCylkm",277,0.996403,25,278,1,277,1,1,0,1,1,142,141,136,136,29
"2761",60,"[25]AJHoIqaxzkHBvHnJHGqKCylkm",285,0.996503,25,286,1,285,1,1,0,1,1,133,132,153,153,29
"2762",61,"[25]AJHoIqaxzkHBvHnJHGqKCylkm",284,0.996491,25,285,1,284,1,1,0,1,1,136,135,149,149,29
"2763",62,"[25]AJHoIqaxzkHBvHnJHGqKCylkm",289,0.996552,25,290,1,289,1,1,0,1,1,158,157,132,132,29
"2764",63,"[25]AJHoIqaxzkHBvHnJHGqKCylkm",292,0.996587,25,293,1,292,1,1,0,1,1,161,160,132,132,29
"2765",64,"[25]AJHoIqaxzkHBvHnJHGqKCylkm",290,0.996564,25,291,1,290,1,1,0,1,1,138,137,153,153,29
"2766",65,"[25]AJHoIqaxzkHBvHnJHGqKCylkm",281,0.996454,25,282,1,281,1,1,0,1,1,145,144,137,137,29
"2767",66,"[25]AJHoIqaxzkHBvHnJHGqKCylkm",288,0.99654,25,289,1,288,1,1,0,1,1,141,140,148,148,29
"2768",67,"[25]AJHoIqaxzkHBvHnJHGqKCylkm",282,0.996466,25,283,1,282,1,1,0,1,1,146,145,137,137,29
"2769",68,"[25]AJHoIqaxzkHBvHnJHGqKCylkm",291,0.996575,25,292,1,291,1,1,0,1,1,154,153,138,138,29
"2770",69,"[25]AJHoIqaxzkHBvHnJHGqKCylkm",279,0.996429,25,280,1,279,1,1,0,1,1,135,134,145,145,29
"2771",70,"[25]AJHoIqaxzkHBvHnJHGqKCylkm",291,0.996575,25,292,1,291,1,1,0,1,1,148,147,144,144,29
"2772",71,"[25]AJHoIqaxzkHBvHnJHGqKCylkm",274,0.996364,25,275,1,274,1,1,0,1,1,121,120,154,154,29
"2773",72,"[25]AJHoIqaxzkHBvHnJHGqKCylkm",293,0.996599,25,294,1,293,1,1,0,1,1,168,167,126,126,29
"2774",73,"[25]AJHoIqaxzkHBvHnJHGqKCylkm",276,0.99639,25,277,1,276,1,1,0,1,1,132,131,145,145,29
"2775",74,"[25]AJHoIqaxzkHBvHnJHGqKCylkm",286,0.996516,25,287,1,286,1,1,0,1,1,139,138,148,148,29
"2776",75,"[25]AJHoIqaxzkHBvHnJHGqKCylkm",286,0.996516,25,287,1,286,1,1,0,1,1,149,148,138,138,29
"2777",76,"[25]AJHoIqaxzkHBvHnJHGqKCylkm",292,0.996587,25,293,1,292,1,1,0,1,1,155,154,138,138,29
"2778",77,"[25]AJHoIqaxzkHBvHnJHGqKCylkm",288,0.99654,25,289,1,288,1,1,0,1,1,146,145,143,143,29
"2779",78,"[25]AJHoIqaxzkHBvHnJHGqKCylkm",280,0.996441,25,281,1,280,1,1,0,1,1,144,143,137,137,29
"2780",79,"[25]AJHoIqaxzkHBvHnJHGqKCylkm",292,0.996587,25,293,1,292,1,1,0,1,1,166,165,127,127,29
"2781",80,"[25]AJHoIqaxzkHBvHnJHGqKCylkm",285,0.996503,25,286,1,285,1,1,0,1,1,143,142,143,143,29
"2782",81,"[25]AJHoIqaxzkHBvHnJHGqKCylkm",276,0.99639,25,277,1,276,1,1,0,1,1,134,133,143,143,29
"2783",82,"[25]AJHoIqaxzkHBvHnJHGqKCylkm",279,0.996429,25,280,1,279,1,1,0,1,1,141,140,139,139,29
"2784",83,"[25]AJHoIqaxzkHBvHnJHGqKCylkm",281,0.996454,25,282,1,281,1,1,0,1,1,146,145,136,136,29
"2785",84,"[25]AJHoIqaxzkHBvHnJHGqKCylkm",284,0.996491,25,285,1,284,1,1,0,1,1,151,150,134,134,29
"2786",85,"[25]AJHoIqaxzkHBvHnJHGqKCylkm",288,0.99654,25,289,1,288,1,1,0,1,1,148,147,141,141,29
"2787",86,"[25]AJHoIqaxzkHBvHnJHGqKCylkm",285,0.996503,25,286,1,285,1,1,0,1,1,150,149,136,136,29
"2788",87,"[25]AJHoIqaxzkHBvHnJHGqKCylkm",285,0.996503,25,286,1,285,1,1,0,1,1,158,157,128,128,29
"2789",88,"[25]AJHoIqaxzkHBvHnJHGqKCylkm",283,0.996479,25,284,1,283,1,1,0,1,1,145,144,139,139,29
"2790",89,"[25]AJHoIqaxzkHBvHnJHGqKCylkm",280,0.996441,25,281,1,280,1,1,0,1,1,113,112,168,168,29
"2791",90,"[25]AJHoIqaxzkHBvHnJHGqKCylkm",293,0.996599,25,294,1,293,1,1,0,1,1,157,156,137,137,29
"2792",91,"[25]AJHoIqaxzkHBvHnJHGqKCylkm",290,0.996564,25,291,1,290,1,1,0,1,1,152,151,139,139,29
"2793",92,"[25]AJHoIqaxzkHBvHnJHGqKCylkm",287,0.996528,25,288,1,287,1,1,0,1,1,137,136,151,151,29
"2794",93,"[25]AJHoIqaxzkHBvHnJHGqKCylkm",277,0.996403,25,278,1,277,1,1,0,1,1,135,134,143,143,29
"2795",94,"[25]AJHoIqaxzkHBvHnJHGqKCylkm",294,0.99661,25,295,1,294,1,1,0,1,1,159,158,136,136,29
"2796",95,"[25]AJHoIqaxzkHBvHnJHGqKCylkm",279,0.996429,25,280,1,279,1,1,0,1,1,133,132,147,147,29
"2797",96,"[25]AJHoIqaxzkHBvHnJHGqKCylkm",278,0.996416,25,279,1,278,1,1,0,1,1,138,137,141,141,29
"2798",97,"[25]AJHoIqaxzkHBvHnJHGqKCylkm",273,0.99635,25,274,1,273,1,1,0,1,1,136,135,138,138,29
"2799",98,"[25]AJHoIqaxzkHBvHnJHGqKCylkm",289,0.996552,25,290,1,289,1,1,0,1,1,158,157,132,132,29
"2800",99,"[25]AJHoIqaxzkHBvHnJHGqKCylkm",289,0.996552,25,290,1,289,1,1,0,1,1,160,159,130,130,29
"2801",0,"[29]gbjaoIpoosoHcosHnJHqGKCxkawoh",293,0.996599,29,294,1,293,1,1,0,1,1,138,137,156,156,30
"2802",1,"[29]gbjaoIpoosoHcosHnJHqGKCxkawoh",288,0.99654,29,289,1,288,1,1,0,1,1,149,148,140,140,30
"2803",2,"[29]gbjaoIpoosoHcosHnJHqGKCxkawoh",293,0.996599,29,294,1,293,1,1,0,1,1,157,156,137,137,30
"2804",3,"[29]gbjaoIpoosoHcosHnJHqGKCxkawoh",293,0.996599,29,294,1,293,1,1,0,1,1,144,143,150,150,30
"2805",4,"[29]gbjaoIpoosoHcosHnJHqGKCxkawoh",298,0.996656,29,299,1,298,1,1,0,1,1,172,171,127,127,30
"2806",5,"[29]gbjaoIpoosoHcosHnJHqGKCxkawoh",295,0.996622,29,296,1,295,1,1,0,1,1,147,146,149,149,30
"2807",6,"[29]gbjaoIpoosoHcosHnJHqGKCxkawoh",285,0.996503,29,286,1,285,1,1,0,1,1,146,145,140,140,30
"2808",7,"[29]gbjaoIpoosoHcosHnJHqGKCxkawoh",285,0.996503,29,286,1,285,1,1,0,1,1,152,151,134,134,30
"2809",8,"[29]gbjaoIpoosoHcosHnJHqGKCxkawoh",283,0.996479,29,284,1,283,1,1,0,1,1,130,129,154,154,30
"2810",9,"[29]gbjaoIpoosoHcosHnJHqGKCxkawoh",299,0.996667,29,300,1,299,1,1,0,1,1,150,149,150,150,30
"2811",10,"[29]gbjaoIpoosoHcosHnJHqGKCxkawoh",303,0.996711,29,304,1,303,1,1,0,1,1,167,166,137,137,30
"2812",11,"[29]gbjaoIpoosoHcosHnJHqGKCxkawoh",291,0.996575,29,292,1,291,1,1,0,1,1,153,152,139,139,30
"2813",12,"[29]gbjaoIpoosoHcosHnJHqGKCxkawoh",291,0.996575,29,292,1,291,1,1,0,1,1,133,132,159,159,30
"2814",13,"[29]gbjaoIpoosoHcosHnJHqGKCxkawoh",287,0.996528,29,288,1,287,1,1,0,1,1,151,150,137,137,30
"2815",14,"[29]gbjaoIpoosoHcosHnJHqGKCxkawoh",302,0.9967,29,303,1,302,1,1,0,1,1,164,163,139,139,30
"2816",15,"[29]gbjaoIpoosoHcosHnJHqGKCxkawoh",291,0.996575,29,292,1,291,1,1,0,1,1,149,148,143,143,30
"2817",16,"[29]gbjaoIpoosoHcosHnJHqGKCxkawoh",287,0.996528,29,288,1,287,1,1,0,1,1,140,139,148,148,30
"2818",17,"[29]gbjaoIpoosoHcosHnJHqGKCxkawoh",296,0.996633,29,297,1,296,1,1,0,1,1,139,138,158,158,30
"2819",18,"[29]gbjaoIpoosoHcosHnJHqGKCxkawoh",291,0.996575,29,292,1,291,1,1,0,1,1,140,139,152,152,30
"2820",19,"[29]gbjaoIpoosoHcosHnJHqGKCxkawoh",294,0.99661,29,295,1,294,1,1,0,1,1,153,152,142,142,30
"2821",20,"[29]gbjaoIpoosoHcosHnJHqGKCxkawoh",292,0.996587,29,293,1,292,1,1,0,1,1,137,136,156,156,30
"2822",21,"[29]gbjaoIpoosoHcosHnJHqGKCxkawoh",293,0.996599,29,294,1,293,1,1,0,1,1,140,139,154,154,30
"2823",22,"[29]gbjaoIpoosoHcosHnJHqGKCxkawoh",296,0.996633,29,297,1,296,1,1,0,1,1,147,146,150,150,30
"2824",23,"[29]gbjaoIpoosoHcosHnJHqGKCxkawoh",299,0.996667,29,300,1,299,1,1,0,1,1,164,163,136,136,30
"2825",24,"[29]gbjaoIpoosoHcosHnJHqGKCxkawoh",289,0.996552,29,290,1,289,1,1,0,1,1,144,143,146,146,30
"2826",25,"[29]gbjaoIpoosoHcosHnJHqGKCxkawoh",295,0.996622,29,296,1,295,1,1,0,1,1,146,145,150,150,30
"2827",26,"[29]gbjaoIpoosoHcosHnJHqGKCxkawoh",286,0.996516,29,287,1,286,1,1,0,1,1,129,128,158,158,30
"2828",27,"[29]gbjaoIpoosoHcosHnJHqGKCxkawoh",295,0.996622,29,296,1,295,1,1,0,1,1,153,152,143,143,30
"2829",28,"[29]gbjaoIpoosoHcosHnJHqGKCxkawoh",291,0.996575,29,292,1,291,1,1,0,1,1,141,140,151,151,30
"2830",29,"[29]gbjaoIpoosoHcosHnJHqGKCxkawoh",297,0.996644,29,298,1,297,1,1,0,1,1,154,153,144,144,30
"2831",30,"[29]gbjaoIpoosoHcosHnJHqGKCxkawoh",297,0.996644,29,298,1,297,1,1,0,1,1,157,156,141,141,30
"2832",31,"[29]gbjaoIpoosoHcosHnJHqGKCxkawoh",295,0.996622,29,296,1,295,1,1,0,1,1,149,148,147,147,30
"2833",32,"[29]gbjaoIpoosoHcosHnJHqGKCxkawoh",291,0.996575,29,292,1,291,1,1,0,1,1,150,149,142,142,30
"2834",33,"[29]gbjaoIpoosoHcosHnJHqGKCxkawoh",293,0.996599,29,294,1,293,1,1,0,1,1,145,144,149,149,30
"2835",34,"[29]gbjaoIpoosoHcosHnJHqGKCxkawoh",289,0.996552,29,290,1,289,1,1,0,1,1,144,143,146,146,30
"2836",35,"[29]gbjaoIpoosoHcosHnJHqGKCxkawoh",293,0.996599,29,294,1,293,1,1,0,1,1,155,154,139,139,30
"2837",36,"[29]gbjaoIpoosoHcosHnJHqGKCxkawoh",295,0.996622,29,296,1,295,1,1,0,1,1,145,144,151,151,30
"2838",37,"[29]gbjaoIpoosoHcosHnJHqGKCxkawoh",294,0.99661,29,295,1,294,1,1,0,1,1,150,149,145,145,30
"2839",38,"[29]gbjaoIpoosoHcosHnJHqGKCxkawoh",296,0.996633,29,297,1,296,1,1,0,1,1,147,146,150,150,30
"2840",39,"[29]gbjaoIpoosoHcosHnJHqGKCxkawoh",296,0.996633,29,297,1,296,1,1,0,1,1,157,156,140,140,30
"2841",40,"[29]gbjaoIpoosoHcosHnJHqGKCxkawoh",294,0.99661,29,295,1,294,1,1,0,1,1,143,142,152,152,30
"2842",41,"[29]gbjaoIpoosoHcosHnJHqGKCxkawoh",283,0.996479,29,284,1,283,1,1,0,1,1,136,135,148,148,30
"2843",42,"[29]gbjaoIpoosoHcosHnJHqGKCxkawoh",303,0.996711,29,304,1,303,1,1,0,1,1,162,161,142,142,30
"2844",43,"[29]gbjaoIpoosoHcosHnJHqGKCxkawoh",301,0.996689,29,302,1,301,1,1,0,1,1,153,152,149,149,30
"2845",44,"[29]gbjaoIpoosoHcosHnJHqGKCxkawoh",292,0.996587,29,293,1,292,1,1,0,1,1,136,135,157,157,30
"2846",45,"[29]gbjaoIpoosoHcosHnJHqGKCxkawoh",288,0.99654,29,289,1,288,1,1,0,1,1,141,140,148,148,30
"2847",46,"[29]gbjaoIpoosoHcosHnJHqGKCxkawoh",294,0.99661,29,295,1,294,1,1,0,1,1,146,145,149,149,30
"2848",47,"[29]gbjaoIpoosoHcosHnJHqGKCxkawoh",299,0.996667,29,300,1,299,1,1,0,1,1,153,152,147,147,30
"2849",48,"[29]gbjaoIpoosoHcosHnJHqGKCxkawoh",295,0.996622,29,296,1,295,1,1,0,1,1,149,148,147,147,30
"2850",49,"[29]gbjaoIpoosoHcosHnJHqGKCxkawoh",294,0.99661,29,295,1,294,1,1,0,1,1,151,150,144,144,30
"2851",50,"[29]gbjaoIpoosoHcosHnJHqGKCxkawoh",293,0.996599,29,294,1,293,1,1,0,1,1,149,148,145,145,30
"2852",51,"[29]gbjaoIpoosoHcosHnJHqGKCxkawoh",294,0.99661,29,295,1,294,1,1,0,1,1,136,135,159,159,30
"2853",52,"[29]gbjaoIpoosoHcosHnJHqGKCxkawoh",300,0.996678,29,301,1,300,1,1,0,1,1,166,165,135,135,30
"2854",53,"[29]gbjaoIpoosoHcosHnJHqGKCxkawoh",284,0.996491,29,285,1,284,1,1,0,1,1,147,146,138,138,30
"2855",54,"[29]gbjaoIpoosoHcosHnJHqGKCxkawoh",291,0.996575,29,292,1,291,1,1,0,1,1,144,143,148,148,30
"2856",55,"[29]gbjaoIpoosoHcosHnJHqGKCxkawoh",293,0.996599,29,294,1,293,1,1,0,1,1,141,140,153,153,30
"2857",56,"[29]gbjaoIpoosoHcosHnJHqGKCxkawoh",290,0.996564,29,291,1,290,1,1,0,1,1,142,141,149,149,30
"2858",57,"[29]gbjaoIpoosoHcosHnJHqGKCxkawoh",293,0.996599,29,294,1,293,1,1,0,1,1,161,160,133,133,30
"2859",58,"[29]gbjaoIpoosoHcosHnJHqGKCxkawoh",292,0.996587,29,293,1,292,1,1,0,1,1,136,135,157,157,30
"2860",59,"[29]gbjaoIpoosoHcosHnJHqGKCxkawoh",289,0.996552,29,290,1,289,1,1,0,1,1,148,147,142,142,30
"2861",60,"[29]gbjaoIpoosoHcosHnJHqGKCxkawoh",291,0.996575,29,292,1,291,1,1,0,1,1,147,146,145,145,30
"2862",61,"[29]gbjaoIpoosoHcosHnJHqGKCxkawoh",294,0.99661,29,295,1,294,1,1,0,1,1,161,160,134,134,30
"2863",62,"[29]gbjaoIpoosoHcosHnJHqGKCxkawoh",292,0.996587,29,293,1,292,1,1,0,1,1,138,137,155,155,30
"2864",63,"[29]gbjaoIpoosoHcosHnJHqGKCxkawoh",297,0.996644,29,298,1,297,1,1,0,1,1,159,158,139,139,30
"2865",64,"[29]gbjaoIpoosoHcosHnJHqGKCxkawoh",284,0.996491,29,285,1,284,1,1,0,1,1,132,131,153,153,30
"2866",65,"[29]gbjaoIpoosoHcosHnJHqGKCxkawoh",293,0.996599,29,294,1,293,1,1,0,1,1,150,149,144,144,30
"2867",66,"[29]gbjaoIpoosoHcosHnJHqGKCxkawoh",291,0.996575,29,292,1,291,1,1,0,1,1,153,152,139,139,30
"2868",67,"[29]gbjaoIpoosoHcosHnJHqGKCxkawoh",290,0.996564,29,291,1,290,1,1,0,1,1,136,135,155,155,30
"2869",68,"[29]gbjaoIpoosoHcosHnJHqGKCxkawoh",290,0.996564,29,291,1,290,1,1,0,1,1,137,136,154,154,30
"2870",69,"[29]gbjaoIpoosoHcosHnJHqGKCxkawoh",293,0.996599,29,294,1,293,1,1,0,1,1,144,143,150,150,30
"2871",70,"[29]gbjaoIpoosoHcosHnJHqGKCxkawoh",297,0.996644,29,298,1,297,1,1,0,1,1,155,154,143,143,30
"2872",71,"[29]gbjaoIpoosoHcosHnJHqGKCxkawoh",296,0.996633,29,297,1,296,1,1,0,1,1,142,141,155,155,30
"2873",72,"[29]gbjaoIpoosoHcosHnJHqGKCxkawoh",297,0.996644,29,298,1,297,1,1,0,1,1,160,159,138,138,30
"2874",73,"[29]gbjaoIpoosoHcosHnJHqGKCxkawoh",294,0.99661,29,295,1,294,1,1,0,1,1,154,153,141,141,30
"2875",74,"[29]gbjaoIpoosoHcosHnJHqGKCxkawoh",279,0.996429,29,280,1,279,1,1,0,1,1,134,133,146,146,30
"2876",75,"[29]gbjaoIpoosoHcosHnJHqGKCxkawoh",280,0.996441,29,281,1,280,1,1,0,1,1,126,125,155,155,30
"2877",76,"[29]gbjaoIpoosoHcosHnJHqGKCxkawoh",294,0.99661,29,295,1,294,1,1,0,1,1,152,151,143,143,30
"2878",77,"[29]gbjaoIpoosoHcosHnJHqGKCxkawoh",295,0.996622,29,296,1,295,1,1,0,1,1,149,148,147,147,30
"2879",78,"[29]gbjaoIpoosoHcosHnJHqGKCxkawoh",297,0.996644,29,298,1,297,1,1,0,1,1,145,144,153,153,30
"2880",79,"[29]gbjaoIpoosoHcosHnJHqGKCxkawoh",300,0.996678,29,301,1,300,1,1,0,1,1,150,149,151,151,30
"2881",80,"[29]gbjaoIpoosoHcosHnJHqGKCxkawoh",300,0.996678,29,301,1,300,1,1,0,1,1,146,145,155,155,30
"2882",81,"[29]gbjaoIpoosoHcosHnJHqGKCxkawoh",284,0.996491,29,285,1,284,1,1,0,1,1,142,141,143,143,30
"2883",82,"[29]gbjaoIpoosoHcosHnJHqGKCxkawoh",305,0.996732,29,306,1,305,1,1,0,1,1,158,157,148,148,30
"2884",83,"[29]gbjaoIpoosoHcosHnJHqGKCxkawoh",293,0.996599,29,294,1,293,1,1,0,1,1,141,140,153,153,30
"2885",84,"[29]gbjaoIpoosoHcosHnJHqGKCxkawoh",283,0.996479,29,284,1,283,1,1,0,1,1,129,128,155,155,30
"2886",85,"[29]gbjaoIpoosoHcosHnJHqGKCxkawoh",300,0.996678,29,301,1,300,1,1,0,1,1,161,160,140,140,30
"2887",86,"[29]gbjaoIpoosoHcosHnJHqGKCxkawoh",293,0.996599,29,294,1,293,1,1,0,1,1,150,149,144,144,30
"2888",87,"[29]gbjaoIpoosoHcosHnJHqGKCxkawoh",290,0.996564,29,291,1,290,1,1,0,1,1,152,151,139,139,30
"2889",88,"[29]gbjaoIpoosoHcosHnJHqGKCxkawoh",292,0.996587,29,293,1,292,1,1,0,1,1,151,150,142,142,30
"2890",89,"[29]gbjaoIpoosoHcosHnJHqGKCxkawoh",284,0.996491,29,285,1,284,1,1,0,1,1,133,132,152,152,30
"2891",90,"[29]gbjaoIpoosoHcosHnJHqGKCxkawoh",286,0.996516,29,287,1,286,1,1,0,1,1,139,138,148,148,30
"2892",91,"[29]gbjaoIpoosoHcosHnJHqGKCxkawoh",292,0.996587,29,293,1,292,1,1,0,1,1,155,154,138,138,30
"2893",92,"[29]gbjaoIpoosoHcosHnJHqGKCxkawoh",295,0.996622,29,296,1,295,1,1,0,1,1,146,145,150,150,30
"2894",93,"[29]gbjaoIpoosoHcosHnJHqGKCxkawoh",285,0.996503,29,286,1,285,1,1,0,1,1,155,154,131,131,30
"2895",94,"[29]gbjaoIpoosoHcosHnJHqGKCxkawoh",292,0.996587,29,293,1,292,1,1,0,1,1,140,139,153,153,30
"2896",95,"[29]gbjaoIpoosoHcosHnJHqGKCxkawoh",290,0.996564,29,291,1,290,1,1,0,1,1,149,148,142,142,30
"2897",96,"[29]gbjaoIpoosoHcosHnJHqGKCxkawoh",300,0.996678,29,301,1,300,1,1,0,1,1,158,157,143,143,30
"2898",97,"[29]gbjaoIpoosoHcosHnJHqGKCxkawoh",289,0.996552,29,290,1,289,1,1,0,1,1,141,140,149,149,30
"2899",98,"[29]gbjaoIpoosoHcosHnJHqGKCxkawoh",293,0.996599,29,294,1,293,1,1,0,1,1,150,149,144,144,30
"2900",99,"[29]gbjaoIpoosoHcosHnJHqGKCxkawoh",290,0.996564,29,291,1,290,1,1,0,1,1,136,135,155,155,30
"2901",0,"[27]zHoIoHcotHnJHGqKChwFgiGpGth",280,0.996441,27,281,1,280,1,1,0,1,1,145,144,136,136,32
"2902",1,"[27]zHoIoHcotHnJHGqKChwFgiGpGth",277,0.996403,27,278,1,277,1,1,0,1,1,139,138,139,139,32
"2903",2,"[27]zHoIoHcotHnJHGqKChwFgiGpGth",281,0.996454,27,282,1,281,1,1,0,1,1,139,138,143,143,32
"2904",3,"[27]zHoIoHcotHnJHGqKChwFgiGpGth",284,0.996491,27,285,1,284,1,1,0,1,1,147,146,138,138,32
"2905",4,"[27]zHoIoHcotHnJHGqKChwFgiGpGth",289,0.996552,27,290,1,289,1,1,0,1,1,156,155,134,134,32
"2906",5,"[27]zHoIoHcotHnJHGqKChwFgiGpGth",279,0.996429,27,280,1,279,1,1,0,1,1,135,134,145,145,32
"2907",6,"[27]zHoIoHcotHnJHGqKChwFgiGpGth",276,0.99639,27,277,1,276,1,1,0,1,1,120,119,157,157,32
"2908",7,"[27]zHoIoHcotHnJHGqKChwFgiGpGth",281,0.996454,27,282,1,281,1,1,0,1,1,141,140,141,141,32
"2909",8,"[27]zHoIoHcotHnJHGqKChwFgiGpGth",285,0.996503,27,286,1,285,1,1,0,1,1,138,137,148,148,32
"2910",9,"[27]zHoIoHcotHnJHGqKChwFgiGpGth",284,0.996491,27,285,1,284,1,1,0,1,1,142,141,143,143,32
"2911",10,"[27]zHoIoHcotHnJHGqKChwFgiGpGth",282,0.996466,27,283,1,282,1,1,0,1,1,137,136,146,146,32
"2912",11,"[27]zHoIoHcotHnJHGqKChwFgiGpGth",274,0.996364,27,275,1,274,1,1,0,1,1,142,141,133,133,32
"2913",12,"[27]zHoIoHcotHnJHGqKChwFgiGpGth",286,0.996516,27,287,1,286,1,1,0,1,1,151,150,136,136,32
"2914",13,"[27]zHoIoHcotHnJHGqKChwFgiGpGth",284,0.996491,27,285,1,284,1,1,0,1,1,142,141,143,143,32
"2915",14,"[27]zHoIoHcotHnJHGqKChwFgiGpGth",272,0.996337,27,273,1,272,1,1,0,1,1,127,126,146,146,32
"2916",15,"[27]zHoIoHcotHnJHGqKChwFgiGpGth",282,0.996466,27,283,1,282,1,1,0,1,1,144,143,139,139,32
"2917",16,"[27]zHoIoHcotHnJHGqKChwFgiGpGth",279,0.996429,27,280,1,279,1,1,0,1,1,142,141,138,138,32
"2918",17,"[27]zHoIoHcotHnJHGqKChwFgiGpGth",273,0.99635,27,274,1,273,1,1,0,1,1,121,120,153,153,32
"2919",18,"[27]zHoIoHcotHnJHGqKChwFgiGpGth",279,0.996429,27,280,1,279,1,1,0,1,1,151,150,129,129,32
"2920",19,"[27]zHoIoHcotHnJHGqKChwFgiGpGth",279,0.996429,27,280,1,279,1,1,0,1,1,142,141,138,138,32
"2921",20,"[27]zHoIoHcotHnJHGqKChwFgiGpGth",287,0.996528,27,288,1,287,1,1,0,1,1,149,148,139,139,32
"2922",21,"[27]zHoIoHcotHnJHGqKChwFgiGpGth",284,0.996491,27,285,1,284,1,1,0,1,1,142,141,143,143,32
"2923",22,"[27]zHoIoHcotHnJHGqKChwFgiGpGth",282,0.996466,27,283,1,282,1,1,0,1,1,151,150,132,132,32
"2924",23,"[27]zHoIoHcotHnJHGqKChwFgiGpGth",282,0.996466,27,283,1,282,1,1,0,1,1,137,136,146,146,32
"2925",24,"[27]zHoIoHcotHnJHGqKChwFgiGpGth",282,0.996466,27,283,1,282,1,1,0,1,1,143,142,140,140,32
"2926",25,"[27]zHoIoHcotHnJHGqKChwFgiGpGth",282,0.996466,27,283,1,282,1,1,0,1,1,161,160,122,122,32
"2927",26,"[27]zHoIoHcotHnJHGqKChwFgiGpGth",286,0.996516,27,287,1,286,1,1,0,1,1,149,148,138,138,32
"2928",27,"[27]zHoIoHcotHnJHGqKChwFgiGpGth",288,0.99654,27,289,1,288,1,1,0,1,1,148,147,141,141,32
"2929",28,"[27]zHoIoHcotHnJHGqKChwFgiGpGth",288,0.99654,27,289,1,288,1,1,0,1,1,138,137,151,151,32
"2930",29,"[27]zHoIoHcotHnJHGqKChwFgiGpGth",288,0.99654,27,289,1,288,1,1,0,1,1,148,147,141,141,32
"2931",30,"[27]zHoIoHcotHnJHGqKChwFgiGpGth",277,0.996403,27,278,1,277,1,1,0,1,1,126,125,152,152,32
"2932",31,"[27]zHoIoHcotHnJHGqKChwFgiGpGth",281,0.996454,27,282,1,281,1,1,0,1,1,140,139,142,142,32
"2933",32,"[27]zHoIoHcotHnJHGqKChwFgiGpGth",279,0.996429,27,280,1,279,1,1,0,1,1,136,135,144,144,32
"2934",33,"[27]zHoIoHcotHnJHGqKChwFgiGpGth",276,0.99639,27,277,1,276,1,1,0,1,1,141,140,136,136,32
"2935",34,"[27]zHoIoHcotHnJHGqKChwFgiGpGth",287,0.996528,27,288,1,287,1,1,0,1,1,148,147,140,140,32
"2936",35,"[27]zHoIoHcotHnJHGqKChwFgiGpGth",280,0.996441,27,281,1,280,1,1,0,1,1,139,138,142,142,32
"2937",36,"[27]zHoIoHcotHnJHGqKChwFgiGpGth",286,0.996516,27,287,1,286,1,1,0,1,1,141,140,146,146,32
"2938",37,"[27]zHoIoHcotHnJHGqKChwFgiGpGth",274,0.996364,27,275,1,274,1,1,0,1,1,132,131,143,143,32
"2939",38,"[27]zHoIoHcotHnJHGqKChwFgiGpGth",278,0.996416,27,279,1,278,1,1,0,1,1,154,153,125,125,32
"2940",39,"[27]zHoIoHcotHnJHGqKChwFgiGpGth",276,0.99639,27,277,1,276,1,1,0,1,1,129,128,148,148,32
"2941",40,"[27]zHoIoHcotHnJHGqKChwFgiGpGth",285,0.996503,27,286,1,285,1,1,0,1,1,154,153,132,132,32
"2942",41,"[27]zHoIoHcotHnJHGqKChwFgiGpGth",282,0.996466,27,283,1,282,1,1,0,1,1,148,147,135,135,32
"2943",42,"[27]zHoIoHcotHnJHGqKChwFgiGpGth",278,0.996416,27,279,1,278,1,1,0,1,1,138,137,141,141,32
"2944",43,"[27]zHoIoHcotHnJHGqKChwFgiGpGth",292,0.996587,27,293,1,292,1,1,0,1,1,150,149,143,143,32
"2945",44,"[27]zHoIoHcotHnJHGqKChwFgiGpGth",279,0.996429,27,280,1,279,1,1,0,1,1,134,133,146,146,32
"2946",45,"[27]zHoIoHcotHnJHGqKChwFgiGpGth",280,0.996441,27,281,1,280,1,1,0,1,1,133,132,148,148,32
"2947",46,"[27]zHoIoHcotHnJHGqKChwFgiGpGth",288,0.99654,27,289,1,288,1,1,0,1,1,144,143,145,145,32
"2948",47,"[27]zHoIoHcotHnJHGqKChwFgiGpGth",281,0.996454,27,282,1,281,1,1,0,1,1,134,133,148,148,32
"2949",48,"[27]zHoIoHcotHnJHGqKChwFgiGpGth",289,0.996552,27,290,1,289,1,1,0,1,1,163,162,127,127,32
"2950",49,"[27]zHoIoHcotHnJHGqKChwFgiGpGth",273,0.99635,27,274,1,273,1,1,0,1,1,130,129,144,144,32
"2951",50,"[27]zHoIoHcotHnJHGqKChwFgiGpGth",277,0.996403,27,278,1,277,1,1,0,1,1,136,135,142,142,32
"2952",51,"[27]zHoIoHcotHnJHGqKChwFgiGpGth",281,0.996454,27,282,1,281,1,1,0,1,1,140,139,142,142,32
"2953",52,"[27]zHoIoHcotHnJHGqKChwFgiGpGth",276,0.99639,27,277,1,276,1,1,0,1,1,131,130,146,146,32
"2954",53,"[27]zHoIoHcotHnJHGqKChwFgiGpGth",286,0.996516,27,287,1,286,1,1,0,1,1,154,153,133,133,32
"2955",54,"[27]zHoIoHcotHnJHGqKChwFgiGpGth",284,0.996491,27,285,1,284,1,1,0,1,1,156,155,129,129,32
"2956",55,"[27]zHoIoHcotHnJHGqKChwFgiGpGth",283,0.996479,27,284,1,283,1,1,0,1,1,141,140,143,143,32
"2957",56,"[27]zHoIoHcotHnJHGqKChwFgiGpGth",288,0.99654,27,289,1,288,1,1,0,1,1,138,137,151,151,32
"2958",57,"[27]zHoIoHcotHnJHGqKChwFgiGpGth",278,0.996416,27,279,1,278,1,1,0,1,1,127,126,152,152,32
"2959",58,"[27]zHoIoHcotHnJHGqKChwFgiGpGth",272,0.996337,27,273,1,272,1,1,0,1,1,143,142,130,130,32
"2960",59,"[27]zHoIoHcotHnJHGqKChwFgiGpGth",282,0.996466,27,283,1,282,1,1,0,1,1,136,135,147,147,32
"2961",60,"[27]zHoIoHcotHnJHGqKChwFgiGpGth",277,0.996403,27,278,1,277,1,1,0,1,1,126,125,152,152,32
"2962",61,"[27]zHoIoHcotHnJHGqKChwFgiGpGth",277,0.996403,27,278,1,277,1,1,0,1,1,142,141,136,136,32
"2963",62,"[27]zHoIoHcotHnJHGqKChwFgiGpGth",278,0.996416,27,279,1,278,1,1,0,1,1,134,133,145,145,32
"2964",63,"[27]zHoIoHcotHnJHGqKChwFgiGpGth",284,0.996491,27,285,1,284,1,1,0,1,1,140,139,145,145,32
"2965",64,"[27]zHoIoHcotHnJHGqKChwFgiGpGth",283,0.996479,27,284,1,283,1,1,0,1,1,143,142,141,141,32
"2966",65,"[27]zHoIoHcotHnJHGqKChwFgiGpGth",275,0.996377,27,276,1,275,1,1,0,1,1,137,136,139,139,32
"2967",66,"[27]zHoIoHcotHnJHGqKChwFgiGpGth",277,0.996403,27,278,1,277,1,1,0,1,1,151,150,127,127,32
"2968",67,"[27]zHoIoHcotHnJHGqKChwFgiGpGth",285,0.996503,27,286,1,285,1,1,0,1,1,140,139,146,146,32
"2969",68,"[27]zHoIoHcotHnJHGqKChwFgiGpGth",275,0.996377,27,276,1,275,1,1,0,1,1,149,148,127,127,32
"2970",69,"[27]zHoIoHcotHnJHGqKChwFgiGpGth",281,0.996454,27,282,1,281,1,1,0,1,1,149,148,133,133,32
"2971",70,"[27]zHoIoHcotHnJHGqKChwFgiGpGth",275,0.996377,27,276,1,275,1,1,0,1,1,134,133,142,142,32
"2972",71,"[27]zHoIoHcotHnJHGqKChwFgiGpGth",274,0.996364,27,275,1,274,1,1,0,1,1,123,122,152,152,32
"2973",72,"[27]zHoIoHcotHnJHGqKChwFgiGpGth",279,0.996429,27,280,1,279,1,1,0,1,1,143,142,137,137,32
"2974",73,"[27]zHoIoHcotHnJHGqKChwFgiGpGth",281,0.996454,27,282,1,281,1,1,0,1,1,147,146,135,135,32
"2975",74,"[27]zHoIoHcotHnJHGqKChwFgiGpGth",285,0.996503,27,286,1,285,1,1,0,1,1,128,127,158,158,32
"2976",75,"[27]zHoIoHcotHnJHGqKChwFgiGpGth",274,0.996364,27,275,1,274,1,1,0,1,1,133,132,142,142,32
"2977",76,"[27]zHoIoHcotHnJHGqKChwFgiGpGth",275,0.996377,27,276,1,275,1,1,0,1,1,136,135,140,140,32
"2978",77,"[27]zHoIoHcotHnJHGqKChwFgiGpGth",282,0.996466,27,283,1,282,1,1,0,1,1,141,140,142,142,32
"2979",78,"[27]zHoIoHcotHnJHGqKChwFgiGpGth",277,0.996403,27,278,1,277,1,1,0,1,1,135,134,143,143,32
"2980",79,"[27]zHoIoHcotHnJHGqKChwFgiGpGth",272,0.996337,27,273,1,272,1,1,0,1,1,129,128,144,144,32
"2981",80,"[27]zHoIoHcotHnJHGqKChwFgiGpGth",278,0.996416,27,279,1,278,1,1,0,1,1,132,131,147,147,32
"2982",81,"[27]zHoIoHcotHnJHGqKChwFgiGpGth",283,0.996479,27,284,1,283,1,1,0,1,1,139,138,145,145,32
"2983",82,"[27]zHoIoHcotHnJHGqKChwFgiGpGth",273,0.99635,27,274,1,273,1,1,0,1,1,129,128,145,145,32
"2984",83,"[27]zHoIoHcotHnJHGqKChwFgiGpGth",281,0.996454,27,282,1,281,1,1,0,1,1,149,148,133,133,32
"2985",84,"[27]zHoIoHcotHnJHGqKChwFgiGpGth",287,0.996528,27,288,1,287,1,1,0,1,1,147,146,141,141,32
"2986",85,"[27]zHoIoHcotHnJHGqKChwFgiGpGth",280,0.996441,27,281,1,280,1,1,0,1,1,135,134,146,146,32
"2987",86,"[27]zHoIoHcotHnJHGqKChwFgiGpGth",281,0.996454,27,282,1,281,1,1,0,1,1,136,135,146,146,32
"2988",87,"[27]zHoIoHcotHnJHGqKChwFgiGpGth",284,0.996491,27,285,1,284,1,1,0,1,1,148,147,137,137,32
"2989",88,"[27]zHoIoHcotHnJHGqKChwFgiGpGth",274,0.996364,27,275,1,274,1,1,0,1,1,137,136,138,138,32
"2990",89,"[27]zHoIoHcotHnJHGqKChwFgiGpGth",273,0.99635,27,274,1,273,1,1,0,1,1,129,128,145,145,32
"2991",90,"[27]zHoIoHcotHnJHGqKChwFgiGpGth",283,0.996479,27,284,1,283,1,1,0,1,1,150,149,134,134,32
"2992",91,"[27]zHoIoHcotHnJHGqKChwFgiGpGth",288,0.99654,27,289,1,288,1,1,0,1,1,150,149,139,139,32
"2993",92,"[27]zHoIoHcotHnJHGqKChwFgiGpGth",278,0.996416,27,279,1,278,1,1,0,1,1,133,132,146,146,32
"2994",93,"[27]zHoIoHcotHnJHGqKChwFgiGpGth",284,0.996491,27,285,1,284,1,1,0,1,1,157,156,128,128,32
"2995",94,"[27]zHoIoHcotHnJHGqKChwFgiGpGth",286,0.996516,27,287,1,286,1,1,0,1,1,157,156,130,130,32
"2996",95,"[27]zHoIoHcotHnJHGqKChwFgiGpGth",279,0.996429,27,280,1,279,1,1,0,1,1,136,135,144,144,32
"2997",96,"[27]zHoIoHcotHnJHGqKChwFgiGpGth",277,0.996403,27,278,1,277,1,1,0,1,1,139,138,139,139,32
"2998",97,"[27]zHoIoHcotHnJHGqKChwFgiGpGth",283,0.996479,27,284,1,283,1,1,0,1,1,149,148,135,135,32
"2999",98,"[27]zHoIoHcotHnJHGqKChwFgiGpGth",281,0.996454,27,282,1,281,1,1,0,1,1,154,153,128,128,32
"3000",99,"[27]zHoIoHcotHnJHGqKChwFgiGpGth",280,0.996441,27,281,1,280,1,1,0,1,1,144,143,137,137,32
"3001",0,"[35]CBhsoIovoHcovHnJHGqKCetIBArnAtfHChb",284,0.996491,35,285,1,284,1,1,0,1,1,137,136,148,148,33
"3002",1,"[35]CBhsoIovoHcovHnJHGqKCetIBArnAtfHChb",266,0.996255,35,267,1,266,1,1,0,1,1,113,112,154,154,33
"3003",2,"[35]CBhsoIovoHcovHnJHGqKCetIBArnAtfHChb",278,0.996416,35,279,1,278,1,1,0,1,1,130,129,149,149,33
"3004",3,"[35]CBhsoIovoHcovHnJHGqKCetIBArnAtfHChb",278,0.996416,35,279,1,278,1,1,0,1,1,143,142,136,136,33
"3005",4,"[35]CBhsoIovoHcovHnJHGqKCetIBArnAtfHChb",275,0.996377,35,276,1,275,1,1,0,1,1,143,142,133,133,33
"3006",5,"[35]CBhsoIovoHcovHnJHGqKCetIBArnAtfHChb",283,0.996479,35,284,1,283,1,1,0,1,1,129,128,155,155,33
"3007",6,"[35]CBhsoIovoHcovHnJHGqKCetIBArnAtfHChb",281,0.996454,35,282,1,281,1,1,0,1,1,149,148,133,133,33
"3008",7,"[35]CBhsoIovoHcovHnJHGqKCetIBArnAtfHChb",283,0.996479,35,284,1,283,1,1,0,1,1,145,144,139,139,33
"3009",8,"[35]CBhsoIovoHcovHnJHGqKCetIBArnAtfHChb",278,0.996416,35,279,1,278,1,1,0,1,1,141,140,138,138,33
"3010",9,"[35]CBhsoIovoHcovHnJHGqKCetIBArnAtfHChb",275,0.996377,35,276,1,275,1,1,0,1,1,143,142,133,133,33
"3011",10,"[35]CBhsoIovoHcovHnJHGqKCetIBArnAtfHChb",286,0.996516,35,287,1,286,1,1,0,1,1,155,154,132,132,33
"3012",11,"[35]CBhsoIovoHcovHnJHGqKCetIBArnAtfHChb",275,0.996377,35,276,1,275,1,1,0,1,1,133,132,143,143,33
"3013",12,"[35]CBhsoIovoHcovHnJHGqKCetIBArnAtfHChb",274,0.996364,35,275,1,274,1,1,0,1,1,135,134,140,140,33
"3014",13,"[35]CBhsoIovoHcovHnJHGqKCetIBArnAtfHChb",270,0.99631,35,271,1,270,1,1,0,1,1,138,137,133,133,33
"3015",14,"[35]CBhsoIovoHcovHnJHGqKCetIBArnAtfHChb",283,0.996479,35,284,1,283,1,1,0,1,1,141,140,143,143,33
"3016",15,"[35]CBhsoIovoHcovHnJHGqKCetIBArnAtfHChb",275,0.996377,35,276,1,275,1,1,0,1,1,141,140,135,135,33
"3017",16,"[35]CBhsoIovoHcovHnJHGqKCetIBArnAtfHChb",284,0.996491,35,285,1,284,1,1,0,1,1,146,145,139,139,33
"3018",17,"[35]CBhsoIovoHcovHnJHGqKCetIBArnAtfHChb",285,0.996503,35,286,1,285,1,1,0,1,1,146,145,140,140,33
"3019",18,"[35]CBhsoIovoHcovHnJHGqKCetIBArnAtfHChb",282,0.996466,35,283,1,282,1,1,0,1,1,146,145,137,137,33
"3020",19,"[35]CBhsoIovoHcovHnJHGqKCetIBArnAtfHChb",287,0.996528,35,288,1,287,1,1,0,1,1,154,153,134,134,33
"3021",20,"[35]CBhsoIovoHcovHnJHGqKCetIBArnAtfHChb",280,0.996441,35,281,1,280,1,1,0,1,1,136,135,145,145,33
"3022",21,"[35]CBhsoIovoHcovHnJHGqKCetIBArnAtfHChb",283,0.996479,35,284,1,283,1,1,0,1,1,141,140,143,143,33
"3023",22,"[35]CBhsoIovoHcovHnJHGqKCetIBArnAtfHChb",273,0.99635,35,274,1,273,1,1,0,1,1,117,116,157,157,33
"3024",23,"[35]CBhsoIovoHcovHnJHGqKCetIBArnAtfHChb",281,0.996454,35,282,1,281,1,1,0,1,1,137,136,145,145,33
"3025",24,"[35]CBhsoIovoHcovHnJHGqKCetIBArnAtfHChb",275,0.996377,35,276,1,275,1,1,0,1,1,141,140,135,135,33
"3026",25,"[35]CBhsoIovoHcovHnJHGqKCetIBArnAtfHChb",282,0.996466,35,283,1,282,1,1,0,1,1,131,130,152,152,33
"3027",26,"[35]CBhsoIovoHcovHnJHGqKCetIBArnAtfHChb",280,0.996441,35,281,1,280,1,1,0,1,1,155,154,126,126,33
"3028",27,"[35]CBhsoIovoHcovHnJHGqKCetIBArnAtfHChb",280,0.996441,35,281,1,280,1,1,0,1,1,134,133,147,147,33
"3029",28,"[35]CBhsoIovoHcovHnJHGqKCetIBArnAtfHChb",275,0.996377,35,276,1,275,1,1,0,1,1,148,147,128,128,33
"3030",29,"[35]CBhsoIovoHcovHnJHGqKCetIBArnAtfHChb",283,0.996479,35,284,1,283,1,1,0,1,1,142,141,142,142,33
"3031",30,"[35]CBhsoIovoHcovHnJHGqKCetIBArnAtfHChb",270,0.99631,35,271,1,270,1,1,0,1,1,128,127,143,143,33
"3032",31,"[35]CBhsoIovoHcovHnJHGqKCetIBArnAtfHChb",279,0.996429,35,280,1,279,1,1,0,1,1,156,155,124,124,33
"3033",32,"[35]CBhsoIovoHcovHnJHGqKCetIBArnAtfHChb",274,0.996364,35,275,1,274,1,1,0,1,1,129,128,146,146,33
"3034",33,"[35]CBhsoIovoHcovHnJHGqKCetIBArnAtfHChb",279,0.996429,35,280,1,279,1,1,0,1,1,130,129,150,150,33
"3035",34,"[35]CBhsoIovoHcovHnJHGqKCetIBArnAtfHChb",276,0.99639,35,277,1,276,1,1,0,1,1,132,131,145,145,33
"3036",35,"[35]CBhsoIovoHcovHnJHGqKCetIBArnAtfHChb",287,0.996528,35,288,1,287,1,1,0,1,1,146,145,142,142,33
"3037",36,"[35]CBhsoIovoHcovHnJHGqKCetIBArnAtfHChb",280,0.996441,35,281,1,280,1,1,0,1,1,140,139,141,141,33
"3038",37,"[35]CBhsoIovoHcovHnJHGqKCetIBArnAtfHChb",281,0.996454,35,282,1,281,1,1,0,1,1,134,133,148,148,33
"3039",38,"[35]CBhsoIovoHcovHnJHGqKCetIBArnAtfHChb",285,0.996503,35,286,1,285,1,1,0,1,1,144,143,142,142,33
"3040",39,"[35]CBhsoIovoHcovHnJHGqKCetIBArnAtfHChb",281,0.996454,35,282,1,281,1,1,0,1,1,146,145,136,136,33
"3041",40,"[35]CBhsoIovoHcovHnJHGqKCetIBArnAtfHChb",279,0.996429,35,280,1,279,1,1,0,1,1,153,152,127,127,33
"3042",41,"[35]CBhsoIovoHcovHnJHGqKCetIBArnAtfHChb",276,0.99639,35,277,1,276,1,1,0,1,1,144,143,133,133,33
"3043",42,"[35]CBhsoIovoHcovHnJHGqKCetIBArnAtfHChb",273,0.99635,35,274,1,273,1,1,0,1,1,140,139,134,134,33
"3044",43,"[35]CBhsoIovoHcovHnJHGqKCetIBArnAtfHChb",277,0.996403,35,278,1,277,1,1,0,1,1,138,137,140,140,33
"3045",44,"[35]CBhsoIovoHcovHnJHGqKCetIBArnAtfHChb",277,0.996403,35,278,1,277,1,1,0,1,1,143,142,135,135,33
"3046",45,"[35]CBhsoIovoHcovHnJHGqKCetIBArnAtfHChb",272,0.996337,35,273,1,272,1,1,0,1,1,151,150,122,122,33
"3047",46,"[35]CBhsoIovoHcovHnJHGqKCetIBArnAtfHChb",273,0.99635,35,274,1,273,1,1,0,1,1,118,117,156,156,33
"3048",47,"[35]CBhsoIovoHcovHnJHGqKCetIBArnAtfHChb",280,0.996441,35,281,1,280,1,1,0,1,1,142,141,139,139,33
"3049",48,"[35]CBhsoIovoHcovHnJHGqKCetIBArnAtfHChb",279,0.996429,35,280,1,279,1,1,0,1,1,124,123,156,156,33
"3050",49,"[35]CBhsoIovoHcovHnJHGqKCetIBArnAtfHChb",284,0.996491,35,285,1,284,1,1,0,1,1,147,146,138,138,33
"3051",50,"[35]CBhsoIovoHcovHnJHGqKCetIBArnAtfHChb",288,0.99654,35,289,1,288,1,1,0,1,1,144,143,145,145,33
"3052",51,"[35]CBhsoIovoHcovHnJHGqKCetIBArnAtfHChb",283,0.996479,35,284,1,283,1,1,0,1,1,151,150,133,133,33
"3053",52,"[35]CBhsoIovoHcovHnJHGqKCetIBArnAtfHChb",282,0.996466,35,283,1,282,1,1,0,1,1,151,150,132,132,33
"3054",53,"[35]CBhsoIovoHcovHnJHGqKCetIBArnAtfHChb",277,0.996403,35,278,1,277,1,1,0,1,1,130,129,148,148,33
"3055",54,"[35]CBhsoIovoHcovHnJHGqKCetIBArnAtfHChb",282,0.996466,35,283,1,282,1,1,0,1,1,134,133,149,149,33
"3056",55,"[35]CBhsoIovoHcovHnJHGqKCetIBArnAtfHChb",279,0.996429,35,280,1,279,1,1,0,1,1,146,145,134,134,33
"3057",56,"[35]CBhsoIovoHcovHnJHGqKCetIBArnAtfHChb",289,0.996552,35,290,1,289,1,1,0,1,1,155,154,135,135,33
"3058",57,"[35]CBhsoIovoHcovHnJHGqKCetIBArnAtfHChb",286,0.996516,35,287,1,286,1,1,0,1,1,152,151,135,135,33
"3059",58,"[35]CBhsoIovoHcovHnJHGqKCetIBArnAtfHChb",284,0.996491,35,285,1,284,1,1,0,1,1,132,131,153,153,33
"3060",59,"[35]CBhsoIovoHcovHnJHGqKCetIBArnAtfHChb",274,0.996364,35,275,1,274,1,1,0,1,1,140,139,135,135,33
"3061",60,"[35]CBhsoIovoHcovHnJHGqKCetIBArnAtfHChb",281,0.996454,35,282,1,281,1,1,0,1,1,163,162,119,119,33
"3062",61,"[35]CBhsoIovoHcovHnJHGqKCetIBArnAtfHChb",279,0.996429,35,280,1,279,1,1,0,1,1,147,146,133,133,33
"3063",62,"[35]CBhsoIovoHcovHnJHGqKCetIBArnAtfHChb",286,0.996516,35,287,1,286,1,1,0,1,1,145,144,142,142,33
"3064",63,"[35]CBhsoIovoHcovHnJHGqKCetIBArnAtfHChb",272,0.996337,35,273,1,272,1,1,0,1,1,143,142,130,130,33
"3065",64,"[35]CBhsoIovoHcovHnJHGqKCetIBArnAtfHChb",285,0.996503,35,286,1,285,1,1,0,1,1,158,157,128,128,33
"3066",65,"[35]CBhsoIovoHcovHnJHGqKCetIBArnAtfHChb",285,0.996503,35,286,1,285,1,1,0,1,1,153,152,133,133,33
"3067",66,"[35]CBhsoIovoHcovHnJHGqKCetIBArnAtfHChb",278,0.996416,35,279,1,278,1,1,0,1,1,128,127,151,151,33
"3068",67,"[35]CBhsoIovoHcovHnJHGqKCetIBArnAtfHChb",280,0.996441,35,281,1,280,1,1,0,1,1,133,132,148,148,33
"3069",68,"[35]CBhsoIovoHcovHnJHGqKCetIBArnAtfHChb",280,0.996441,35,281,1,280,1,1,0,1,1,143,142,138,138,33
"3070",69,"[35]CBhsoIovoHcovHnJHGqKCetIBArnAtfHChb",283,0.996479,35,284,1,283,1,1,0,1,1,151,150,133,133,33
"3071",70,"[35]CBhsoIovoHcovHnJHGqKCetIBArnAtfHChb",277,0.996403,35,278,1,277,1,1,0,1,1,137,136,141,141,33
"3072",71,"[35]CBhsoIovoHcovHnJHGqKCetIBArnAtfHChb",282,0.996466,35,283,1,282,1,1,0,1,1,126,125,157,157,33
"3073",72,"[35]CBhsoIovoHcovHnJHGqKCetIBArnAtfHChb",278,0.996416,35,279,1,278,1,1,0,1,1,139,138,140,140,33
"3074",73,"[35]CBhsoIovoHcovHnJHGqKCetIBArnAtfHChb",281,0.996454,35,282,1,281,1,1,0,1,1,146,145,136,136,33
"3075",74,"[35]CBhsoIovoHcovHnJHGqKCetIBArnAtfHChb",276,0.99639,35,277,1,276,1,1,0,1,1,134,133,143,143,33
"3076",75,"[35]CBhsoIovoHcovHnJHGqKCetIBArnAtfHChb",278,0.996416,35,279,1,278,1,1,0,1,1,152,151,127,127,33
"3077",76,"[35]CBhsoIovoHcovHnJHGqKCetIBArnAtfHChb",283,0.996479,35,284,1,283,1,1,0,1,1,140,139,144,144,33
"3078",77,"[35]CBhsoIovoHcovHnJHGqKCetIBArnAtfHChb",283,0.996479,35,284,1,283,1,1,0,1,1,159,158,125,125,33
"3079",78,"[35]CBhsoIovoHcovHnJHGqKCetIBArnAtfHChb",280,0.996441,35,281,1,280,1,1,0,1,1,139,138,142,142,33
"3080",79,"[35]CBhsoIovoHcovHnJHGqKCetIBArnAtfHChb",270,0.99631,35,271,1,270,1,1,0,1,1,124,123,147,147,33
"3081",80,"[35]CBhsoIovoHcovHnJHGqKCetIBArnAtfHChb",278,0.996416,35,279,1,278,1,1,0,1,1,164,163,115,115,33
"3082",81,"[35]CBhsoIovoHcovHnJHGqKCetIBArnAtfHChb",282,0.996466,35,283,1,282,1,1,0,1,1,152,151,131,131,33
"3083",82,"[35]CBhsoIovoHcovHnJHGqKCetIBArnAtfHChb",280,0.996441,35,281,1,280,1,1,0,1,1,157,156,124,124,33
"3084",83,"[35]CBhsoIovoHcovHnJHGqKCetIBArnAtfHChb",281,0.996454,35,282,1,281,1,1,0,1,1,138,137,144,144,33
"3085",84,"[35]CBhsoIovoHcovHnJHGqKCetIBArnAtfHChb",279,0.996429,35,280,1,279,1,1,0,1,1,140,139,140,140,33
"3086",85,"[35]CBhsoIovoHcovHnJHGqKCetIBArnAtfHChb",279,0.996429,35,280,1,279,1,1,0,1,1,153,152,127,127,33
"3087",86,"[35]CBhsoIovoHcovHnJHGqKCetIBArnAtfHChb",284,0.996491,35,285,1,284,1,1,0,1,1,135,134,150,150,33
"3088",87,"[35]CBhsoIovoHcovHnJHGqKCetIBArnAtfHChb",279,0.996429,35,280,1,279,1,1,0,1,1,138,137,142,142,33
"3089",88,"[35]CBhsoIovoHcovHnJHGqKCetIBArnAtfHChb",284,0.996491,35,285,1,284,1,1,0,1,1,142,141,143,143,33
"3090",89,"[35]CBhsoIovoHcovHnJHGqKCetIBArnAtfHChb",278,0.996416,35,279,1,278,1,1,0,1,1,146,145,133,133,33
"3091",90,"[35]CBhsoIovoHcovHnJHGqKCetIBArnAtfHChb",277,0.996403,35,278,1,277,1,1,0,1,1,142,141,136,136,33
"3092",91,"[35]CBhsoIovoHcovHnJHGqKCetIBArnAtfHChb",280,0.996441,35,281,1,280,1,1,0,1,1,148,147,133,133,33
"3093",92,"[35]CBhsoIovoHcovHnJHGqKCetIBArnAtfHChb",278,0.996416,35,279,1,278,1,1,0,1,1,145,144,134,134,33
"3094",93,"[35]CBhsoIovoHcovHnJHGqKCetIBArnAtfHChb",285,0.996503,35,286,1,285,1,1,0,1,1,147,146,139,139,33
"3095",94,"[35]CBhsoIovoHcovHnJHGqKCetIBArnAtfHChb",279,0.996429,35,280,1,279,1,1,0,1,1,150,149,130,130,33
"3096",95,"[35]CBhsoIovoHcovHnJHGqKCetIBArnAtfHChb",277,0.996403,35,278,1,277,1,1,0,1,1,152,151,126,126,33
"3097",96,"[35]CBhsoIovoHcovHnJHGqKCetIBArnAtfHChb",284,0.996491,35,285,1,284,1,1,0,1,1,131,130,154,154,33
"3098",97,"[35]CBhsoIovoHcovHnJHGqKCetIBArnAtfHChb",284,0.996491,35,285,1,284,1,1,0,1,1,141,140,144,144,33
"3099",98,"[35]CBhsoIovoHcovHnJHGqKCetIBArnAtfHChb",280,0.996441,35,281,1,280,1,1,0,1,1,148,147,133,133,33
"3100",99,"[35]CBhsoIovoHcovHnJHGqKCetIBArnAtfHChb",277,0.996403,35,278,1,277,1,1,0,1,1,123,122,155,155,33
"3101",0,"[26]yHoIoHcosHnJqGKCuqpodlhKuj",296,0.996633,26,297,1,296,1,1,0,1,1,152,151,145,145,34
"3102",1,"[26]yHoIoHcosHnJqGKCuqpodlhKuj",293,0.996599,26,294,1,293,1,1,0,1,1,140,139,154,154,34
"3103",2,"[26]yHoIoHcosHnJqGKCuqpodlhKuj",299,0.996667,26,300,1,299,1,1,0,1,1,154,153,146,146,34
"3104",3,"[26]yHoIoHcosHnJqGKCuqpodlhKuj",299,0.996667,26,300,1,299,1,1,0,1,1,154,153,146,146,34
"3105",4,"[26]yHoIoHcosHnJqGKCuqpodlhKuj",295,0.996622,26,296,1,295,1,1,0,1,1,146,145,150,150,34
"3106",5,"[26]yHoIoHcosHnJqGKCuqpodlhKuj",296,0.996633,26,297,1,296,1,1,0,1,1,147,146,150,150,34
"3107",6,"[26]yHoIoHcosHnJqGKCuqpodlhKuj",291,0.996575,26,292,1,291,1,1,0,1,1,135,134,157,157,34
"3108",7,"[26]yHoIoHcosHnJqGKCuqpodlhKuj",294,0.99661,26,295,1,294,1,1,0,1,1,144,143,151,151,34
"3109",8,"[26]yHoIoHcosHnJqGKCuqpodlhKuj",292,0.996587,26,293,1,292,1,1,0,1,1,144,143,149,149,34
"3110",9,"[26]yHoIoHcosHnJqGKCuqpodlhKuj",295,0.996622,26,296,1,295,1,1,0,1,1,152,151,144,144,34
"3111",10,"[26]yHoIoHcosHnJqGKCuqpodlhKuj",293,0.996599,26,294,1,293,1,1,0,1,1,140,139,154,154,34
"3112",11,"[26]yHoIoHcosHnJqGKCuqpodlhKuj",294,0.99661,26,295,1,294,1,1,0,1,1,143,142,152,152,34
"3113",12,"[26]yHoIoHcosHnJqGKCuqpodlhKuj",293,0.996599,26,294,1,293,1,1,0,1,1,142,141,152,152,34
"3114",13,"[26]yHoIoHcosHnJqGKCuqpodlhKuj",295,0.996622,26,296,1,295,1,1,0,1,1,146,145,150,150,34
"3115",14,"[26]yHoIoHcosHnJqGKCuqpodlhKuj",306,0.996743,26,307,1,306,1,1,0,1,1,175,174,132,132,34
"3116",15,"[26]yHoIoHcosHnJqGKCuqpodlhKuj",300,0.996678,26,301,1,300,1,1,0,1,1,163,162,138,138,34
"3117",16,"[26]yHoIoHcosHnJqGKCuqpodlhKuj",291,0.996575,26,292,1,291,1,1,0,1,1,132,131,160,160,34
"3118",17,"[26]yHoIoHcosHnJqGKCuqpodlhKuj",300,0.996678,26,301,1,300,1,1,0,1,1,157,156,144,144,34
"3119",18,"[26]yHoIoHcosHnJqGKCuqpodlhKuj",295,0.996622,26,296,1,295,1,1,0,1,1,144,143,152,152,34
"3120",19,"[26]yHoIoHcosHnJqGKCuqpodlhKuj",299,0.996667,26,300,1,299,1,1,0,1,1,155,154,145,145,34
"3121",20,"[26]yHoIoHcosHnJqGKCuqpodlhKuj",294,0.99661,26,295,1,294,1,1,0,1,1,141,140,154,154,34
"3122",21,"[26]yHoIoHcosHnJqGKCuqpodlhKuj",296,0.996633,26,297,1,296,1,1,0,1,1,148,147,149,149,34
"3123",22,"[26]yHoIoHcosHnJqGKCuqpodlhKuj",299,0.996667,26,300,1,299,1,1,0,1,1,156,155,144,144,34
"3124",23,"[26]yHoIoHcosHnJqGKCuqpodlhKuj",298,0.996656,26,299,1,298,1,1,0,1,1,155,154,144,144,34
"3125",24,"[26]yHoIoHcosHnJqGKCuqpodlhKuj",298,0.996656,26,299,1,298,1,1,0,1,1,150,149,149,149,34
"3126",25,"[26]yHoIoHcosHnJqGKCuqpodlhKuj",294,0.99661,26,295,1,294,1,1,0,1,1,146,145,149,149,34
"3127",26,"[26]yHoIoHcosHnJqGKCuqpodlhKuj",294,0.99661,26,295,1,294,1,1,0,1,1,142,141,153,153,34
"3128",27,"[26]yHoIoHcosHnJqGKCuqpodlhKuj",296,0.996633,26,297,1,296,1,1,0,1,1,151,150,146,146,34
"3129",28,"[26]yHoIoHcosHnJqGKCuqpodlhKuj",303,0.996711,26,304,1,303,1,1,0,1,1,164,163,140,140,34
"3130",29,"[26]yHoIoHcosHnJqGKCuqpodlhKuj",291,0.996575,26,292,1,291,1,1,0,1,1,139,138,153,153,34
"3131",30,"[26]yHoIoHcosHnJqGKCuqpodlhKuj",295,0.996622,26,296,1,295,1,1,0,1,1,147,146,149,149,34
"3132",31,"[26]yHoIoHcosHnJqGKCuqpodlhKuj",297,0.996644,26,298,1,297,1,1,0,1,1,148,147,150,150,34
"3133",32,"[26]yHoIoHcosHnJqGKCuqpodlhKuj",299,0.996667,26,300,1,299,1,1,0,1,1,152,151,148,148,34
"3134",33,"[26]yHoIoHcosHnJqGKCuqpodlhKuj",295,0.996622,26,296,1,295,1,1,0,1,1,144,143,152,152,34
"3135",34,"[26]yHoIoHcosHnJqGKCuqpodlhKuj",296,0.996633,26,297,1,296,1,1,0,1,1,147,146,150,150,34
"3136",35,"[26]yHoIoHcosHnJqGKCuqpodlhKuj",298,0.996656,26,299,1,298,1,1,0,1,1,153,152,146,146,34
"3137",36,"[26]yHoIoHcosHnJqGKCuqpodlhKuj",298,0.996656,26,299,1,298,1,1,0,1,1,157,156,142,142,34
"3138",37,"[26]yHoIoHcosHnJqGKCuqpodlhKuj",293,0.996599,26,294,1,293,1,1,0,1,1,140,139,154,154,34
"3139",38,"[26]yHoIoHcosHnJqGKCuqpodlhKuj",296,0.996633,26,297,1,296,1,1,0,1,1,148,147,149,149,34
"3140",39,"[26]yHoIoHcosHnJqGKCuqpodlhKuj",304,0.996721,26,305,1,304,1,1,0,1,1,171,170,134,134,34
"3141",40,"[26]yHoIoHcosHnJqGKCuqpodlhKuj",299,0.996667,26,300,1,299,1,1,0,1,1,153,152,147,147,34
"3142",41,"[26]yHoIoHcosHnJqGKCuqpodlhKuj",295,0.996622,26,296,1,295,1,1,0,1,1,146,145,150,150,34
"3143",42,"[26]yHoIoHcosHnJqGKCuqpodlhKuj",303,0.996711,26,304,1,303,1,1,0,1,1,173,172,131,131,34
"3144",43,"[26]yHoIoHcosHnJqGKCuqpodlhKuj",296,0.996633,26,297,1,296,1,1,0,1,1,149,148,148,148,34
"3145",44,"[26]yHoIoHcosHnJqGKCuqpodlhKuj",295,0.996622,26,296,1,295,1,1,0,1,1,150,149,146,146,34
"3146",45,"[26]yHoIoHcosHnJqGKCuqpodlhKuj",292,0.996587,26,293,1,292,1,1,0,1,1,140,139,153,153,34
"3147",46,"[26]yHoIoHcosHnJqGKCuqpodlhKuj",305,0.996732,26,306,1,305,1,1,0,1,1,172,171,134,134,34
"3148",47,"[26]yHoIoHcosHnJqGKCuqpodlhKuj",302,0.9967,26,303,1,302,1,1,0,1,1,161,160,142,142,34
"3149",48,"[26]yHoIoHcosHnJqGKCuqpodlhKuj",289,0.996552,26,290,1,289,1,1,0,1,1,139,138,151,151,34
"3150",49,"[26]yHoIoHcosHnJqGKCuqpodlhKuj",295,0.996622,26,296,1,295,1,1,0,1,1,145,144,151,151,34
"3151",50,"[26]yHoIoHcosHnJqGKCuqpodlhKuj",295,0.996622,26,296,1,295,1,1,0,1,1,145,144,151,151,34
"3152",51,"[26]yHoIoHcosHnJqGKCuqpodlhKuj",309,0.996774,26,310,1,309,1,1,0,1,1,185,184,125,125,34
"3153",52,"[26]yHoIoHcosHnJqGKCuqpodlhKuj",302,0.9967,26,303,1,302,1,1,0,1,1,166,165,137,137,34
"3154",53,"[26]yHoIoHcosHnJqGKCuqpodlhKuj",296,0.996633,26,297,1,296,1,1,0,1,1,150,149,147,147,34
"3155",54,"[26]yHoIoHcosHnJqGKCuqpodlhKuj",294,0.99661,26,295,1,294,1,1,0,1,1,138,137,157,157,34
"3156",55,"[26]yHoIoHcosHnJqGKCuqpodlhKuj",287,0.996528,26,288,1,287,1,1,0,1,1,128,127,160,160,34
"3157",56,"[26]yHoIoHcosHnJqGKCuqpodlhKuj",295,0.996622,26,296,1,295,1,1,0,1,1,136,135,160,160,34
"3158",57,"[26]yHoIoHcosHnJqGKCuqpodlhKuj",297,0.996644,26,298,1,297,1,1,0,1,1,148,147,150,150,34
"3159",58,"[26]yHoIoHcosHnJqGKCuqpodlhKuj",297,0.996644,26,298,1,297,1,1,0,1,1,152,151,146,146,34
"3160",59,"[26]yHoIoHcosHnJqGKCuqpodlhKuj",297,0.996644,26,298,1,297,1,1,0,1,1,158,157,140,140,34
"3161",60,"[26]yHoIoHcosHnJqGKCuqpodlhKuj",293,0.996599,26,294,1,293,1,1,0,1,1,145,144,149,149,34
"3162",61,"[26]yHoIoHcosHnJqGKCuqpodlhKuj",293,0.996599,26,294,1,293,1,1,0,1,1,137,136,157,157,34
"3163",62,"[26]yHoIoHcosHnJqGKCuqpodlhKuj",292,0.996587,26,293,1,292,1,1,0,1,1,147,146,146,146,34
"3164",63,"[26]yHoIoHcosHnJqGKCuqpodlhKuj",293,0.996599,26,294,1,293,1,1,0,1,1,140,139,154,154,34
"3165",64,"[26]yHoIoHcosHnJqGKCuqpodlhKuj",296,0.996633,26,297,1,296,1,1,0,1,1,153,152,144,144,34
"3166",65,"[26]yHoIoHcosHnJqGKCuqpodlhKuj",296,0.996633,26,297,1,296,1,1,0,1,1,138,137,159,159,34
"3167",66,"[26]yHoIoHcosHnJqGKCuqpodlhKuj",299,0.996667,26,300,1,299,1,1,0,1,1,156,155,144,144,34
"3168",67,"[26]yHoIoHcosHnJqGKCuqpodlhKuj",295,0.996622,26,296,1,295,1,1,0,1,1,146,145,150,150,34
"3169",68,"[26]yHoIoHcosHnJqGKCuqpodlhKuj",305,0.996732,26,306,1,305,1,1,0,1,1,180,179,126,126,34
"3170",69,"[26]yHoIoHcosHnJqGKCuqpodlhKuj",301,0.996689,26,302,1,301,1,1,0,1,1,158,157,144,144,34
"3171",70,"[26]yHoIoHcosHnJqGKCuqpodlhKuj",287,0.996528,26,288,1,287,1,1,0,1,1,120,119,168,168,34
"3172",71,"[26]yHoIoHcosHnJqGKCuqpodlhKuj",300,0.996678,26,301,1,300,1,1,0,1,1,158,157,143,143,34
"3173",72,"[26]yHoIoHcosHnJqGKCuqpodlhKuj",309,0.996774,26,310,1,309,1,1,0,1,1,170,169,140,140,34
"3174",73,"[26]yHoIoHcosHnJqGKCuqpodlhKuj",292,0.996587,26,293,1,292,1,1,0,1,1,138,137,155,155,34
"3175",74,"[26]yHoIoHcosHnJqGKCuqpodlhKuj",297,0.996644,26,298,1,297,1,1,0,1,1,146,145,152,152,34
"3176",75,"[26]yHoIoHcosHnJqGKCuqpodlhKuj",296,0.996633,26,297,1,296,1,1,0,1,1,149,148,148,148,34
"3177",76,"[26]yHoIoHcosHnJqGKCuqpodlhKuj",291,0.996575,26,292,1,291,1,1,0,1,1,142,141,150,150,34
"3178",77,"[26]yHoIoHcosHnJqGKCuqpodlhKuj",301,0.996689,26,302,1,301,1,1,0,1,1,164,163,138,138,34
"3179",78,"[26]yHoIoHcosHnJqGKCuqpodlhKuj",295,0.996622,26,296,1,295,1,1,0,1,1,142,141,154,154,34
"3180",79,"[26]yHoIoHcosHnJqGKCuqpodlhKuj",294,0.99661,26,295,1,294,1,1,0,1,1,143,142,152,152,34
"3181",80,"[26]yHoIoHcosHnJqGKCuqpodlhKuj",299,0.996667,26,300,1,299,1,1,0,1,1,156,155,144,144,34
"3182",81,"[26]yHoIoHcosHnJqGKCuqpodlhKuj",292,0.996587,26,293,1,292,1,1,0,1,1,145,144,148,148,34
"3183",82,"[26]yHoIoHcosHnJqGKCuqpodlhKuj",293,0.996599,26,294,1,293,1,1,0,1,1,144,143,150,150,34
"3184",83,"[26]yHoIoHcosHnJqGKCuqpodlhKuj",297,0.996644,26,298,1,297,1,1,0,1,1,152,151,146,146,34
"3185",84,"[26]yHoIoHcosHnJqGKCuqpodlhKuj",293,0.996599,26,294,1,293,1,1,0,1,1,138,137,156,156,34
"3186",85,"[26]yHoIoHcosHnJqGKCuqpodlhKuj",296,0.996633,26,297,1,296,1,1,0,1,1,149,148,148,148,34
"3187",86,"[26]yHoIoHcosHnJqGKCuqpodlhKuj",293,0.996599,26,294,1,293,1,1,0,1,1,140,139,154,154,34
"3188",87,"[26]yHoIoHcosHnJqGKCuqpodlhKuj",297,0.996644,26,298,1,297,1,1,0,1,1,154,153,144,144,34
"3189",88,"[26]yHoIoHcosHnJqGKCuqpodlhKuj",301,0.996689,26,302,1,301,1,1,0,1,1,161,160,141,141,34
"3190",89,"[26]yHoIoHcosHnJqGKCuqpodlhKuj",296,0.996633,26,297,1,296,1,1,0,1,1,148,147,149,149,34
"3191",90,"[26]yHoIoHcosHnJqGKCuqpodlhKuj",298,0.996656,26,299,1,298,1,1,0,1,1,154,153,145,145,34
"3192",91,"[26]yHoIoHcosHnJqGKCuqpodlhKuj",295,0.996622,26,296,1,295,1,1,0,1,1,148,147,148,148,34
"3193",92,"[26]yHoIoHcosHnJqGKCuqpodlhKuj",289,0.996552,26,290,1,289,1,1,0,1,1,140,139,150,150,34
"3194",93,"[26]yHoIoHcosHnJqGKCuqpodlhKuj",293,0.996599,26,294,1,293,1,1,0,1,1,143,142,151,151,34
"3195",94,"[26]yHoIoHcosHnJqGKCuqpodlhKuj",294,0.99661,26,295,1,294,1,1,0,1,1,139,138,156,156,34
"3196",95,"[26]yHoIoHcosHnJqGKCuqpodlhKuj",297,0.996644,26,298,1,297,1,1,0,1,1,153,152,145,145,34
"3197",96,"[26]yHoIoHcosHnJqGKCuqpodlhKuj",297,0.996644,26,298,1,297,1,1,0,1,1,145,144,153,153,34
"3198",97,"[26]yHoIoHcosHnJqGKCuqpodlhKuj",300,0.996678,26,301,1,300,1,1,0,1,1,158,157,143,143,34
"3199",98,"[26]yHoIoHcosHnJqGKCuqpodlhKuj",301,0.996689,26,302,1,301,1,1,0,1,1,160,159,142,142,34
"3200",99,"[26]yHoIoHcosHnJqGKCuqpodlhKuj",299,0.996667,26,300,1,299,1,1,0,1,1,160,159,140,140,34
"3201",0,"[25]loIoHcowHnJHGqKCkosdgdwec",275,0.996377,25,276,1,275,1,1,0,1,1,128,127,148,148,35
"3202",1,"[25]loIoHcowHnJHGqKCkosdgdwec",281,0.996454,25,282,1,281,1,1,0,1,1,142,141,140,140,35
"3203",2,"[25]loIoHcowHnJHGqKCkosdgdwec",274,0.996364,25,275,1,274,1,1,0,1,1,129,128,146,146,35
"3204",3,"[25]loIoHcowHnJHGqKCkosdgdwec",288,0.99654,25,289,1,288,1,1,0,1,1,142,141,147,147,35
"3205",4,"[25]loIoHcowHnJHGqKCkosdgdwec",282,0.996466,25,283,1,282,1,1,0,1,1,131,130,152,152,35
"3206",5,"[25]loIoHcowHnJHGqKCkosdgdwec",281,0.996454,25,282,1,281,1,1,0,1,1,143,142,139,139,35
"3207",6,"[25]loIoHcowHnJHGqKCkosdgdwec",291,0.996575,25,292,1,291,1,1,0,1,1,149,148,143,143,35
"3208",7,"[25]loIoHcowHnJHGqKCkosdgdwec",280,0.996441,25,281,1,280,1,1,0,1,1,146,145,135,135,35
"3209",8,"[25]loIoHcowHnJHGqKCkosdgdwec",292,0.996587,25,293,1,292,1,1,0,1,1,158,157,135,135,35
"3210",9,"[25]loIoHcowHnJHGqKCkosdgdwec",284,0.996491,25,285,1,284,1,1,0,1,1,138,137,147,147,35
"3211",10,"[25]loIoHcowHnJHGqKCkosdgdwec",284,0.996491,25,285,1,284,1,1,0,1,1,141,140,144,144,35
"3212",11,"[25]loIoHcowHnJHGqKCkosdgdwec",279,0.996429,25,280,1,279,1,1,0,1,1,136,135,144,144,35
"3213",12,"[25]loIoHcowHnJHGqKCkosdgdwec",284,0.996491,25,285,1,284,1,1,0,1,1,148,147,137,137,35
"3214",13,"[25]loIoHcowHnJHGqKCkosdgdwec",282,0.996466,25,283,1,282,1,1,0,1,1,148,147,135,135,35
"3215",14,"[25]loIoHcowHnJHGqKCkosdgdwec",284,0.996491,25,285,1,284,1,1,0,1,1,149,148,136,136,35
"3216",15,"[25]loIoHcowHnJHGqKCkosdgdwec",283,0.996479,25,284,1,283,1,1,0,1,1,145,144,139,139,35
"3217",16,"[25]loIoHcowHnJHGqKCkosdgdwec",281,0.996454,25,282,1,281,1,1,0,1,1,154,153,128,128,35
"3218",17,"[25]loIoHcowHnJHGqKCkosdgdwec",282,0.996466,25,283,1,282,1,1,0,1,1,136,135,147,147,35
"3219",18,"[25]loIoHcowHnJHGqKCkosdgdwec",286,0.996516,25,287,1,286,1,1,0,1,1,142,141,145,145,35
"3220",19,"[25]loIoHcowHnJHGqKCkosdgdwec",280,0.996441,25,281,1,280,1,1,0,1,1,148,147,133,133,35
"3221",20,"[25]loIoHcowHnJHGqKCkosdgdwec",277,0.996403,25,278,1,277,1,1,0,1,1,141,140,137,137,35
"3222",21,"[25]loIoHcowHnJHGqKCkosdgdwec",287,0.996528,25,288,1,287,1,1,0,1,1,139,138,149,149,35
"3223",22,"[25]loIoHcowHnJHGqKCkosdgdwec",289,0.996552,25,290,1,289,1,1,0,1,1,165,164,125,125,35
"3224",23,"[25]loIoHcowHnJHGqKCkosdgdwec",291,0.996575,25,292,1,291,1,1,0,1,1,143,142,149,149,35
"3225",24,"[25]loIoHcowHnJHGqKCkosdgdwec",278,0.996416,25,279,1,278,1,1,0,1,1,142,141,137,137,35
"3226",25,"[25]loIoHcowHnJHGqKCkosdgdwec",286,0.996516,25,287,1,286,1,1,0,1,1,145,144,142,142,35
"3227",26,"[25]loIoHcowHnJHGqKCkosdgdwec",288,0.99654,25,289,1,288,1,1,0,1,1,162,161,127,127,35
"3228",27,"[25]loIoHcowHnJHGqKCkosdgdwec",276,0.99639,25,277,1,276,1,1,0,1,1,139,138,138,138,35
"3229",28,"[25]loIoHcowHnJHGqKCkosdgdwec",274,0.996364,25,275,1,274,1,1,0,1,1,136,135,139,139,35
"3230",29,"[25]loIoHcowHnJHGqKCkosdgdwec",290,0.996564,25,291,1,290,1,1,0,1,1,147,146,144,144,35
"3231",30,"[25]loIoHcowHnJHGqKCkosdgdwec",281,0.996454,25,282,1,281,1,1,0,1,1,129,128,153,153,35
"3232",31,"[25]loIoHcowHnJHGqKCkosdgdwec",276,0.99639,25,277,1,276,1,1,0,1,1,148,147,129,129,35
"3233",32,"[25]loIoHcowHnJHGqKCkosdgdwec",283,0.996479,25,284,1,283,1,1,0,1,1,138,137,146,146,35
"3234",33,"[25]loIoHcowHnJHGqKCkosdgdwec",279,0.996429,25,280,1,279,1,1,0,1,1,135,134,145,145,35
"3235",34,"[25]loIoHcowHnJHGqKCkosdgdwec",280,0.996441,25,281,1,280,1,1,0,1,1,141,140,140,140,35
"3236",35,"[25]loIoHcowHnJHGqKCkosdgdwec",276,0.99639,25,277,1,276,1,1,0,1,1,132,131,145,145,35
"3237",36,"[25]loIoHcowHnJHGqKCkosdgdwec",286,0.996516,25,287,1,286,1,1,0,1,1,153,152,134,134,35
"3238",37,"[25]loIoHcowHnJHGqKCkosdgdwec",279,0.996429,25,280,1,279,1,1,0,1,1,118,117,162,162,35
"3239",38,"[25]loIoHcowHnJHGqKCkosdgdwec",286,0.996516,25,287,1,286,1,1,0,1,1,160,159,127,127,35
"3240",39,"[25]loIoHcowHnJHGqKCkosdgdwec",285,0.996503,25,286,1,285,1,1,0,1,1,143,142,143,143,35
"3241",40,"[25]loIoHcowHnJHGqKCkosdgdwec",286,0.996516,25,287,1,286,1,1,0,1,1,147,146,140,140,35
"3242",41,"[25]loIoHcowHnJHGqKCkosdgdwec",287,0.996528,25,288,1,287,1,1,0,1,1,134,133,154,154,35
"3243",42,"[25]loIoHcowHnJHGqKCkosdgdwec",283,0.996479,25,284,1,283,1,1,0,1,1,150,149,134,134,35
"3244",43,"[25]loIoHcowHnJHGqKCkosdgdwec",279,0.996429,25,280,1,279,1,1,0,1,1,136,135,144,144,35
"3245",44,"[25]loIoHcowHnJHGqKCkosdgdwec",284,0.996491,25,285,1,284,1,1,0,1,1,148,147,137,137,35
"3246",45,"[25]loIoHcowHnJHGqKCkosdgdwec",284,0.996491,25,285,1,284,1,1,0,1,1,144,143,141,141,35
"3247",46,"[25]loIoHcowHnJHGqKCkosdgdwec",280,0.996441,25,281,1,280,1,1,0,1,1,138,137,143,143,35
"3248",47,"[25]loIoHcowHnJHGqKCkosdgdwec",284,0.996491,25,285,1,284,1,1,0,1,1,142,141,143,143,35
"3249",48,"[25]loIoHcowHnJHGqKCkosdgdwec",284,0.996491,25,285,1,284,1,1,0,1,1,136,135,149,149,35
"3250",49,"[25]loIoHcowHnJHGqKCkosdgdwec",281,0.996454,25,282,1,281,1,1,0,1,1,149,148,133,133,35
"3251",50,"[25]loIoHcowHnJHGqKCkosdgdwec",281,0.996454,25,282,1,281,1,1,0,1,1,142,141,140,140,35
"3252",51,"[25]loIoHcowHnJHGqKCkosdgdwec",288,0.99654,25,289,1,288,1,1,0,1,1,145,144,144,144,35
"3253",52,"[25]loIoHcowHnJHGqKCkosdgdwec",284,0.996491,25,285,1,284,1,1,0,1,1,136,135,149,149,35
"3254",53,"[25]loIoHcowHnJHGqKCkosdgdwec",285,0.996503,25,286,1,285,1,1,0,1,1,142,141,144,144,35
"3255",54,"[25]loIoHcowHnJHGqKCkosdgdwec",283,0.996479,25,284,1,283,1,1,0,1,1,136,135,148,148,35
"3256",55,"[25]loIoHcowHnJHGqKCkosdgdwec",281,0.996454,25,282,1,281,1,1,0,1,1,134,133,148,148,35
"3257",56,"[25]loIoHcowHnJHGqKCkosdgdwec",278,0.996416,25,279,1,278,1,1,0,1,1,141,140,138,138,35
"3258",57,"[25]loIoHcowHnJHGqKCkosdgdwec",282,0.996466,25,283,1,282,1,1,0,1,1,136,135,147,147,35
"3259",58,"[25]loIoHcowHnJHGqKCkosdgdwec",282,0.996466,25,283,1,282,1,1,0,1,1,139,138,144,144,35
"3260",59,"[25]loIoHcowHnJHGqKCkosdgdwec",280,0.996441,25,281,1,280,1,1,0,1,1,144,143,137,137,35
"3261",60,"[25]loIoHcowHnJHGqKCkosdgdwec",279,0.996429,25,280,1,279,1,1,0,1,1,152,151,128,128,35
"3262",61,"[25]loIoHcowHnJHGqKCkosdgdwec",277,0.996403,25,278,1,277,1,1,0,1,1,131,130,147,147,35
"3263",62,"[25]loIoHcowHnJHGqKCkosdgdwec",287,0.996528,25,288,1,287,1,1,0,1,1,160,159,128,128,35
"3264",63,"[25]loIoHcowHnJHGqKCkosdgdwec",284,0.996491,25,285,1,284,1,1,0,1,1,157,156,128,128,35
"3265",64,"[25]loIoHcowHnJHGqKCkosdgdwec",276,0.99639,25,277,1,276,1,1,0,1,1,134,133,143,143,35
"3266",65,"[25]loIoHcowHnJHGqKCkosdgdwec",284,0.996491,25,285,1,284,1,1,0,1,1,140,139,145,145,35
"3267",66,"[25]loIoHcowHnJHGqKCkosdgdwec",282,0.996466,25,283,1,282,1,1,0,1,1,140,139,143,143,35
"3268",67,"[25]loIoHcowHnJHGqKCkosdgdwec",280,0.996441,25,281,1,280,1,1,0,1,1,138,137,143,143,35
"3269",68,"[25]loIoHcowHnJHGqKCkosdgdwec",282,0.996466,25,283,1,282,1,1,0,1,1,134,133,149,149,35
"3270",69,"[25]loIoHcowHnJHGqKCkosdgdwec",276,0.99639,25,277,1,276,1,1,0,1,1,126,125,151,151,35
"3271",70,"[25]loIoHcowHnJHGqKCkosdgdwec",277,0.996403,25,278,1,277,1,1,0,1,1,144,143,134,134,35
"3272",71,"[25]loIoHcowHnJHGqKCkosdgdwec",277,0.996403,25,278,1,277,1,1,0,1,1,131,130,147,147,35
"3273",72,"[25]loIoHcowHnJHGqKCkosdgdwec",274,0.996364,25,275,1,274,1,1,0,1,1,132,131,143,143,35
"3274",73,"[25]loIoHcowHnJHGqKCkosdgdwec",283,0.996479,25,284,1,283,1,1,0,1,1,139,138,145,145,35
"3275",74,"[25]loIoHcowHnJHGqKCkosdgdwec",279,0.996429,25,280,1,279,1,1,0,1,1,137,136,143,143,35
"3276",75,"[25]loIoHcowHnJHGqKCkosdgdwec",285,0.996503,25,286,1,285,1,1,0,1,1,146,145,140,140,35
"3277",76,"[25]loIoHcowHnJHGqKCkosdgdwec",279,0.996429,25,280,1,279,1,1,0,1,1,137,136,143,143,35
"3278",77,"[25]loIoHcowHnJHGqKCkosdgdwec",284,0.996491,25,285,1,284,1,1,0,1,1,129,128,156,156,35
"3279",78,"[25]loIoHcowHnJHGqKCkosdgdwec",281,0.996454,25,282,1,281,1,1,0,1,1,128,127,154,154,35
"3280",79,"[25]loIoHcowHnJHGqKCkosdgdwec",282,0.996466,25,283,1,282,1,1,0,1,1,129,128,154,154,35
"3281",80,"[25]loIoHcowHnJHGqKCkosdgdwec",274,0.996364,25,275,1,274,1,1,0,1,1,138,137,137,137,35
"3282",81,"[25]loIoHcowHnJHGqKCkosdgdwec",281,0.996454,25,282,1,281,1,1,0,1,1,132,131,150,150,35
"3283",82,"[25]loIoHcowHnJHGqKCkosdgdwec",281,0.996454,25,282,1,281,1,1,0,1,1,147,146,135,135,35
"3284",83,"[25]loIoHcowHnJHGqKCkosdgdwec",290,0.996564,25,291,1,290,1,1,0,1,1,162,161,129,129,35
"3285",84,"[25]loIoHcowHnJHGqKCkosdgdwec",276,0.99639,25,277,1,276,1,1,0,1,1,131,130,146,146,35
"3286",85,"[25]loIoHcowHnJHGqKCkosdgdwec",286,0.996516,25,287,1,286,1,1,0,1,1,149,148,138,138,35
"3287",86,"[25]loIoHcowHnJHGqKCkosdgdwec",284,0.996491,25,285,1,284,1,1,0,1,1,142,141,143,143,35
"3288",87,"[25]loIoHcowHnJHGqKCkosdgdwec",282,0.996466,25,283,1,282,1,1,0,1,1,134,133,149,149,35
"3289",88,"[25]loIoHcowHnJHGqKCkosdgdwec",270,0.99631,25,271,1,270,1,1,0,1,1,141,140,130,130,35
"3290",89,"[25]loIoHcowHnJHGqKCkosdgdwec",283,0.996479,25,284,1,283,1,1,0,1,1,156,155,128,128,35
"3291",90,"[25]loIoHcowHnJHGqKCkosdgdwec",283,0.996479,25,284,1,283,1,1,0,1,1,157,156,127,127,35
"3292",91,"[25]loIoHcowHnJHGqKCkosdgdwec",275,0.996377,25,276,1,275,1,1,0,1,1,128,127,148,148,35
"3293",92,"[25]loIoHcowHnJHGqKCkosdgdwec",279,0.996429,25,280,1,279,1,1,0,1,1,120,119,160,160,35
"3294",93,"[25]loIoHcowHnJHGqKCkosdgdwec",283,0.996479,25,284,1,283,1,1,0,1,1,151,150,133,133,35
"3295",94,"[25]loIoHcowHnJHGqKCkosdgdwec",276,0.99639,25,277,1,276,1,1,0,1,1,149,148,128,128,35
"3296",95,"[25]loIoHcowHnJHGqKCkosdgdwec",276,0.99639,25,277,1,276,1,1,0,1,1,136,135,141,141,35
"3297",96,"[25]loIoHcowHnJHGqKCkosdgdwec",286,0.996516,25,287,1,286,1,1,0,1,1,151,150,136,136,35
"3298",97,"[25]loIoHcowHnJHGqKCkosdgdwec",284,0.996491,25,285,1,284,1,1,0,1,1,147,146,138,138,35
"3299",98,"[25]loIoHcowHnJHGqKCkosdgdwec",287,0.996528,25,288,1,287,1,1,0,1,1,176,175,112,112,35
"3300",99,"[25]loIoHcowHnJHGqKCkosdgdwec",282,0.996466,25,283,1,282,1,1,0,1,1,147,146,136,136,35
"3301",0,"[24]gyoIoHcouHnJHGqKCvJpBjvv",273,0.99635,24,274,1,273,1,1,0,1,1,130,129,144,144,36
"3302",1,"[24]gyoIoHcouHnJHGqKCvJpBjvv",282,0.996466,24,283,1,282,1,1,0,1,1,140,139,143,143,36
"3303",2,"[24]gyoIoHcouHnJHGqKCvJpBjvv",284,0.996491,24,285,1,284,1,1,0,1,1,147,146,138,138,36
"3304",3,"[24]gyoIoHcouHnJHGqKCvJpBjvv",280,0.996441,24,281,1,280,1,1,0,1,1,147,146,134,134,36
"3305",4,"[24]gyoIoHcouHnJHGqKCvJpBjvv",271,0.996324,24,272,1,271,1,1,0,1,1,118,117,154,154,36
"3306",5,"[24]gyoIoHcouHnJHGqKCvJpBjvv",279,0.996429,24,280,1,279,1,1,0,1,1,131,130,149,149,36
"3307",6,"[24]gyoIoHcouHnJHGqKCvJpBjvv",284,0.996491,24,285,1,284,1,1,0,1,1,138,137,147,147,36
"3308",7,"[24]gyoIoHcouHnJHGqKCvJpBjvv",283,0.996479,24,284,1,283,1,1,0,1,1,137,136,147,147,36
"3309",8,"[24]gyoIoHcouHnJHGqKCvJpBjvv",279,0.996429,24,280,1,279,1,1,0,1,1,135,134,145,145,36
"3310",9,"[24]gyoIoHcouHnJHGqKCvJpBjvv",277,0.996403,24,278,1,277,1,1,0,1,1,146,145,132,132,36
"3311",10,"[24]gyoIoHcouHnJHGqKCvJpBjvv",277,0.996403,24,278,1,277,1,1,0,1,1,132,131,146,146,36
"3312",11,"[24]gyoIoHcouHnJHGqKCvJpBjvv",275,0.996377,24,276,1,275,1,1,0,1,1,147,146,129,129,36
"3313",12,"[24]gyoIoHcouHnJHGqKCvJpBjvv",282,0.996466,24,283,1,282,1,1,0,1,1,151,150,132,132,36
"3314",13,"[24]gyoIoHcouHnJHGqKCvJpBjvv",282,0.996466,24,283,1,282,1,1,0,1,1,140,139,143,143,36
"3315",14,"[24]gyoIoHcouHnJHGqKCvJpBjvv",283,0.996479,24,284,1,283,1,1,0,1,1,141,140,143,143,36
"3316",15,"[24]gyoIoHcouHnJHGqKCvJpBjvv",279,0.996429,24,280,1,279,1,1,0,1,1,139,138,141,141,36
"3317",16,"[24]gyoIoHcouHnJHGqKCvJpBjvv",286,0.996516,24,287,1,286,1,1,0,1,1,155,154,132,132,36
"3318",17,"[24]gyoIoHcouHnJHGqKCvJpBjvv",279,0.996429,24,280,1,279,1,1,0,1,1,132,131,148,148,36
"3319",18,"[24]gyoIoHcouHnJHGqKCvJpBjvv",280,0.996441,24,281,1,280,1,1,0,1,1,139,138,142,142,36
"3320",19,"[24]gyoIoHcouHnJHGqKCvJpBjvv",288,0.99654,24,289,1,288,1,1,0,1,1,143,142,146,146,36
"3321",20,"[24]gyoIoHcouHnJHGqKCvJpBjvv",282,0.996466,24,283,1,282,1,1,0,1,1,141,140,142,142,36
"3322",21,"[24]gyoIoHcouHnJHGqKCvJpBjvv",275,0.996377,24,276,1,275,1,1,0,1,1,134,133,142,142,36
"3323",22,"[24]gyoIoHcouHnJHGqKCvJpBjvv",280,0.996441,24,281,1,280,1,1,0,1,1,125,124,156,156,36
"3324",23,"[24]gyoIoHcouHnJHGqKCvJpBjvv",275,0.996377,24,276,1,275,1,1,0,1,1,142,141,134,134,36
"3325",24,"[24]gyoIoHcouHnJHGqKCvJpBjvv",280,0.996441,24,281,1,280,1,1,0,1,1,142,141,139,139,36
"3326",25,"[24]gyoIoHcouHnJHGqKCvJpBjvv",282,0.996466,24,283,1,282,1,1,0,1,1,141,140,142,142,36
"3327",26,"[24]gyoIoHcouHnJHGqKCvJpBjvv",288,0.99654,24,289,1,288,1,1,0,1,1,141,140,148,148,36
"3328",27,"[24]gyoIoHcouHnJHGqKCvJpBjvv",276,0.99639,24,277,1,276,1,1,0,1,1,124,123,153,153,36
"3329",28,"[24]gyoIoHcouHnJHGqKCvJpBjvv",284,0.996491,24,285,1,284,1,1,0,1,1,137,136,148,148,36
"3330",29,"[24]gyoIoHcouHnJHGqKCvJpBjvv",274,0.996364,24,275,1,274,1,1,0,1,1,126,125,149,149,36
"3331",30,"[24]gyoIoHcouHnJHGqKCvJpBjvv",277,0.996403,24,278,1,277,1,1,0,1,1,132,131,146,146,36
"3332",31,"[24]gyoIoHcouHnJHGqKCvJpBjvv",282,0.996466,24,283,1,282,1,1,0,1,1,151,150,132,132,36
"3333",32,"[24]gyoIoHcouHnJHGqKCvJpBjvv",283,0.996479,24,284,1,283,1,1,0,1,1,144,143,140,140,36
"3334",33,"[24]gyoIoHcouHnJHGqKCvJpBjvv",286,0.996516,24,287,1,286,1,1,0,1,1,140,139,147,147,36
"3335",34,"[24]gyoIoHcouHnJHGqKCvJpBjvv",276,0.99639,24,277,1,276,1,1,0,1,1,134,133,143,143,36
"3336",35,"[24]gyoIoHcouHnJHGqKCvJpBjvv",288,0.99654,24,289,1,288,1,1,0,1,1,148,147,141,141,36
"3337",36,"[24]gyoIoHcouHnJHGqKCvJpBjvv",281,0.996454,24,282,1,281,1,1,0,1,1,146,145,136,136,36
"3338",37,"[24]gyoIoHcouHnJHGqKCvJpBjvv",275,0.996377,24,276,1,275,1,1,0,1,1,149,148,127,127,36
"3339",38,"[24]gyoIoHcouHnJHGqKCvJpBjvv",281,0.996454,24,282,1,281,1,1,0,1,1,131,130,151,151,36
"3340",39,"[24]gyoIoHcouHnJHGqKCvJpBjvv",278,0.996416,24,279,1,278,1,1,0,1,1,139,138,140,140,36
"3341",40,"[24]gyoIoHcouHnJHGqKCvJpBjvv",278,0.996416,24,279,1,278,1,1,0,1,1,145,144,134,134,36
"3342",41,"[24]gyoIoHcouHnJHGqKCvJpBjvv",287,0.996528,24,288,1,287,1,1,0,1,1,150,149,138,138,36
"3343",42,"[24]gyoIoHcouHnJHGqKCvJpBjvv",281,0.996454,24,282,1,281,1,1,0,1,1,140,139,142,142,36
"3344",43,"[24]gyoIoHcouHnJHGqKCvJpBjvv",275,0.996377,24,276,1,275,1,1,0,1,1,139,138,137,137,36
"3345",44,"[24]gyoIoHcouHnJHGqKCvJpBjvv",276,0.99639,24,277,1,276,1,1,0,1,1,145,144,132,132,36
"3346",45,"[24]gyoIoHcouHnJHGqKCvJpBjvv",276,0.99639,24,277,1,276,1,1,0,1,1,126,125,151,151,36
"3347",46,"[24]gyoIoHcouHnJHGqKCvJpBjvv",283,0.996479,24,284,1,283,1,1,0,1,1,143,142,141,141,36
"3348",47,"[24]gyoIoHcouHnJHGqKCvJpBjvv",285,0.996503,24,286,1,285,1,1,0,1,1,147,146,139,139,36
"3349",48,"[24]gyoIoHcouHnJHGqKCvJpBjvv",286,0.996516,24,287,1,286,1,1,0,1,1,156,155,131,131,36
"3350",49,"[24]gyoIoHcouHnJHGqKCvJpBjvv",276,0.99639,24,277,1,276,1,1,0,1,1,131,130,146,146,36
"3351",50,"[24]gyoIoHcouHnJHGqKCvJpBjvv",275,0.996377,24,276,1,275,1,1,0,1,1,143,142,133,133,36
"3352",51,"[24]gyoIoHcouHnJHGqKCvJpBjvv",279,0.996429,24,280,1,279,1,1,0,1,1,145,144,135,135,36
"3353",52,"[24]gyoIoHcouHnJHGqKCvJpBjvv",292,0.996587,24,293,1,292,1,1,0,1,1,146,145,147,147,36
"3354",53,"[24]gyoIoHcouHnJHGqKCvJpBjvv",277,0.996403,24,278,1,277,1,1,0,1,1,138,137,140,140,36
"3355",54,"[24]gyoIoHcouHnJHGqKCvJpBjvv",290,0.996564,24,291,1,290,1,1,0,1,1,154,153,137,137,36
"3356",55,"[24]gyoIoHcouHnJHGqKCvJpBjvv",284,0.996491,24,285,1,284,1,1,0,1,1,145,144,140,140,36
"3357",56,"[24]gyoIoHcouHnJHGqKCvJpBjvv",274,0.996364,24,275,1,274,1,1,0,1,1,139,138,136,136,36
"3358",57,"[24]gyoIoHcouHnJHGqKCvJpBjvv",284,0.996491,24,285,1,284,1,1,0,1,1,148,147,137,137,36
"3359",58,"[24]gyoIoHcouHnJHGqKCvJpBjvv",284,0.996491,24,285,1,284,1,1,0,1,1,157,156,128,128,36
"3360",59,"[24]gyoIoHcouHnJHGqKCvJpBjvv",281,0.996454,24,282,1,281,1,1,0,1,1,141,140,141,141,36
"3361",60,"[24]gyoIoHcouHnJHGqKCvJpBjvv",279,0.996429,24,280,1,279,1,1,0,1,1,139,138,141,141,36
"3362",61,"[24]gyoIoHcouHnJHGqKCvJpBjvv",282,0.996466,24,283,1,282,1,1,0,1,1,128,127,155,155,36
"3363",62,"[24]gyoIoHcouHnJHGqKCvJpBjvv",286,0.996516,24,287,1,286,1,1,0,1,1,151,150,136,136,36
"3364",63,"[24]gyoIoHcouHnJHGqKCvJpBjvv",279,0.996429,24,280,1,279,1,1,0,1,1,142,141,138,138,36
"3365",64,"[24]gyoIoHcouHnJHGqKCvJpBjvv",277,0.996403,24,278,1,277,1,1,0,1,1,147,146,131,131,36
"3366",65,"[24]gyoIoHcouHnJHGqKCvJpBjvv",277,0.996403,24,278,1,277,1,1,0,1,1,144,143,134,134,36
"3367",66,"[24]gyoIoHcouHnJHGqKCvJpBjvv",282,0.996466,24,283,1,282,1,1,0,1,1,151,150,132,132,36
"3368",67,"[24]gyoIoHcouHnJHGqKCvJpBjvv",281,0.996454,24,282,1,281,1,1,0,1,1,154,153,128,128,36
"3369",68,"[24]gyoIoHcouHnJHGqKCvJpBjvv",284,0.996491,24,285,1,284,1,1,0,1,1,138,137,147,147,36
"3370",69,"[24]gyoIoHcouHnJHGqKCvJpBjvv",276,0.99639,24,277,1,276,1,1,0,1,1,125,124,152,152,36
"3371",70,"[24]gyoIoHcouHnJHGqKCvJpBjvv",282,0.996466,24,283,1,282,1,1,0,1,1,149,148,134,134,36
"3372",71,"[24]gyoIoHcouHnJHGqKCvJpBjvv",288,0.99654,24,289,1,288,1,1,0,1,1,145,144,144,144,36
"3373",72,"[24]gyoIoHcouHnJHGqKCvJpBjvv",277,0.996403,24,278,1,277,1,1,0,1,1,137,136,141,141,36
"3374",73,"[24]gyoIoHcouHnJHGqKCvJpBjvv",280,0.996441,24,281,1,280,1,1,0,1,1,139,138,142,142,36
"3375",74,"[24]gyoIoHcouHnJHGqKCvJpBjvv",268,0.996283,24,269,1,268,1,1,0,1,1,135,134,134,134,36
"3376",75,"[24]gyoIoHcouHnJHGqKCvJpBjvv",278,0.996416,24,279,1,278,1,1,0,1,1,129,128,150,150,36
"3377",76,"[24]gyoIoHcouHnJHGqKCvJpBjvv",274,0.996364,24,275,1,274,1,1,0,1,1,132,131,143,143,36
"3378",77,"[24]gyoIoHcouHnJHGqKCvJpBjvv",280,0.996441,24,281,1,280,1,1,0,1,1,145,144,136,136,36
"3379",78,"[24]gyoIoHcouHnJHGqKCvJpBjvv",289,0.996552,24,290,1,289,1,1,0,1,1,145,144,145,145,36
"3380",79,"[24]gyoIoHcouHnJHGqKCvJpBjvv",278,0.996416,24,279,1,278,1,1,0,1,1,139,138,140,140,36
"3381",80,"[24]gyoIoHcouHnJHGqKCvJpBjvv",278,0.996416,24,279,1,278,1,1,0,1,1,130,129,149,149,36
"3382",81,"[24]gyoIoHcouHnJHGqKCvJpBjvv",273,0.99635,24,274,1,273,1,1,0,1,1,140,139,134,134,36
"3383",82,"[24]gyoIoHcouHnJHGqKCvJpBjvv",275,0.996377,24,276,1,275,1,1,0,1,1,139,138,137,137,36
"3384",83,"[24]gyoIoHcouHnJHGqKCvJpBjvv",285,0.996503,24,286,1,285,1,1,0,1,1,147,146,139,139,36
"3385",84,"[24]gyoIoHcouHnJHGqKCvJpBjvv",286,0.996516,24,287,1,286,1,1,0,1,1,145,144,142,142,36
"3386",85,"[24]gyoIoHcouHnJHGqKCvJpBjvv",282,0.996466,24,283,1,282,1,1,0,1,1,138,137,145,145,36
"3387",86,"[24]gyoIoHcouHnJHGqKCvJpBjvv",274,0.996364,24,275,1,274,1,1,0,1,1,149,148,126,126,36
"3388",87,"[24]gyoIoHcouHnJHGqKCvJpBjvv",274,0.996364,24,275,1,274,1,1,0,1,1,137,136,138,138,36
"3389",88,"[24]gyoIoHcouHnJHGqKCvJpBjvv",277,0.996403,24,278,1,277,1,1,0,1,1,132,131,146,146,36
"3390",89,"[24]gyoIoHcouHnJHGqKCvJpBjvv",273,0.99635,24,274,1,273,1,1,0,1,1,142,141,132,132,36
"3391",90,"[24]gyoIoHcouHnJHGqKCvJpBjvv",284,0.996491,24,285,1,284,1,1,0,1,1,131,130,154,154,36
"3392",91,"[24]gyoIoHcouHnJHGqKCvJpBjvv",285,0.996503,24,286,1,285,1,1,0,1,1,148,147,138,138,36
"3393",92,"[24]gyoIoHcouHnJHGqKCvJpBjvv",278,0.996416,24,279,1,278,1,1,0,1,1,150,149,129,129,36
"3394",93,"[24]gyoIoHcouHnJHGqKCvJpBjvv",277,0.996403,24,278,1,277,1,1,0,1,1,137,136,141,141,36
"3395",94,"[24]gyoIoHcouHnJHGqKCvJpBjvv",282,0.996466,24,283,1,282,1,1,0,1,1,142,141,141,141,36
"3396",95,"[24]gyoIoHcouHnJHGqKCvJpBjvv",289,0.996552,24,290,1,289,1,1,0,1,1,150,149,140,140,36
"3397",96,"[24]gyoIoHcouHnJHGqKCvJpBjvv",284,0.996491,24,285,1,284,1,1,0,1,1,147,146,138,138,36
"3398",97,"[24]gyoIoHcouHnJHGqKCvJpBjvv",285,0.996503,24,286,1,285,1,1,0,1,1,153,152,133,133,36
"3399",98,"[24]gyoIoHcouHnJHGqKCvJpBjvv",280,0.996441,24,281,1,280,1,1,0,1,1,136,135,145,145,36
"3400",99,"[24]gyoIoHcouHnJHGqKCvJpBjvv",278,0.996416,24,279,1,278,1,1,0,1,1,139,138,140,140,36
"3401",0,"[27]bHoIeAloHcoxHnJqGKCwJHmHfdi",293,0.996599,27,294,1,293,1,1,0,1,1,154,153,140,140,37
"3402",1,"[27]bHoIeAloHcoxHnJqGKCwJHmHfdi",294,0.99661,27,295,1,294,1,1,0,1,1,140,139,155,155,37
"3403",2,"[27]bHoIeAloHcoxHnJqGKCwJHmHfdi",293,0.996599,27,294,1,293,1,1,0,1,1,138,137,156,156,37
"3404",3,"[27]bHoIeAloHcoxHnJqGKCwJHmHfdi",300,0.996678,27,301,1,300,1,1,0,1,1,164,163,137,137,37
"3405",4,"[27]bHoIeAloHcoxHnJqGKCwJHmHfdi",299,0.996667,27,300,1,299,1,1,0,1,1,166,165,134,134,37
"3406",5,"[27]bHoIeAloHcoxHnJqGKCwJHmHfdi",291,0.996575,27,292,1,291,1,1,0,1,1,144,143,148,148,37
"3407",6,"[27]bHoIeAloHcoxHnJqGKCwJHmHfdi",295,0.996622,27,296,1,295,1,1,0,1,1,147,146,149,149,37
"3408",7,"[27]bHoIeAloHcoxHnJqGKCwJHmHfdi",296,0.996633,27,297,1,296,1,1,0,1,1,148,147,149,149,37
"3409",8,"[27]bHoIeAloHcoxHnJqGKCwJHmHfdi",295,0.996622,27,296,1,295,1,1,0,1,1,147,146,149,149,37
"3410",9,"[27]bHoIeAloHcoxHnJqGKCwJHmHfdi",298,0.996656,27,299,1,298,1,1,0,1,1,156,155,143,143,37
"3411",10,"[27]bHoIeAloHcoxHnJqGKCwJHmHfdi",302,0.9967,27,303,1,302,1,1,0,1,1,167,166,136,136,37
"3412",11,"[27]bHoIeAloHcoxHnJqGKCwJHmHfdi",295,0.996622,27,296,1,295,1,1,0,1,1,152,151,144,144,37
"3413",12,"[27]bHoIeAloHcoxHnJqGKCwJHmHfdi",291,0.996575,27,292,1,291,1,1,0,1,1,142,141,150,150,37
"3414",13,"[27]bHoIeAloHcoxHnJqGKCwJHmHfdi",295,0.996622,27,296,1,295,1,1,0,1,1,146,145,150,150,37
"3415",14,"[27]bHoIeAloHcoxHnJqGKCwJHmHfdi",292,0.996587,27,293,1,292,1,1,0,1,1,137,136,156,156,37
"3416",15,"[27]bHoIeAloHcoxHnJqGKCwJHmHfdi",294,0.99661,27,295,1,294,1,1,0,1,1,150,149,145,145,37
"3417",16,"[27]bHoIeAloHcoxHnJqGKCwJHmHfdi",296,0.996633,27,297,1,296,1,1,0,1,1,146,145,151,151,37
"3418",17,"[27]bHoIeAloHcoxHnJqGKCwJHmHfdi",290,0.996564,27,291,1,290,1,1,0,1,1,146,145,145,145,37
"3419",18,"[27]bHoIeAloHcoxHnJqGKCwJHmHfdi",291,0.996575,27,292,1,291,1,1,0,1,1,140,139,152,152,37
"3420",19,"[27]bHoIeAloHcoxHnJqGKCwJHmHfdi",301,0.996689,27,302,1,301,1,1,0,1,1,158,157,144,144,37
"3421",20,"[27]bHoIeAloHcoxHnJqGKCwJHmHfdi",294,0.99661,27,295,1,294,1,1,0,1,1,143,142,152,152,37
"3422",21,"[27]bHoIeAloHcoxHnJqGKCwJHmHfdi",294,0.99661,27,295,1,294,1,1,0,1,1,143,142,152,152,37
"3423",22,"[27]bHoIeAloHcoxHnJqGKCwJHmHfdi",293,0.996599,27,294,1,293,1,1,0,1,1,145,144,149,149,37
"3424",23,"[27]bHoIeAloHcoxHnJqGKCwJHmHfdi",301,0.996689,27,302,1,301,1,1,0,1,1,163,162,139,139,37
"3425",24,"[27]bHoIeAloHcoxHnJqGKCwJHmHfdi",293,0.996599,27,294,1,293,1,1,0,1,1,142,141,152,152,37
"3426",25,"[27]bHoIeAloHcoxHnJqGKCwJHmHfdi",293,0.996599,27,294,1,293,1,1,0,1,1,151,150,143,143,37
"3427",26,"[27]bHoIeAloHcoxHnJqGKCwJHmHfdi",295,0.996622,27,296,1,295,1,1,0,1,1,152,151,144,144,37
"3428",27,"[27]bHoIeAloHcoxHnJqGKCwJHmHfdi",291,0.996575,27,292,1,291,1,1,0,1,1,138,137,154,154,37
"3429",28,"[27]bHoIeAloHcoxHnJqGKCwJHmHfdi",293,0.996599,27,294,1,293,1,1,0,1,1,149,148,145,145,37
"3430",29,"[27]bHoIeAloHcoxHnJqGKCwJHmHfdi",296,0.996633,27,297,1,296,1,1,0,1,1,150,149,147,147,37
"3431",30,"[27]bHoIeAloHcoxHnJqGKCwJHmHfdi",301,0.996689,27,302,1,301,1,1,0,1,1,164,163,138,138,37
"3432",31,"[27]bHoIeAloHcoxHnJqGKCwJHmHfdi",294,0.99661,27,295,1,294,1,1,0,1,1,144,143,151,151,37
"3433",32,"[27]bHoIeAloHcoxHnJqGKCwJHmHfdi",296,0.996633,27,297,1,296,1,1,0,1,1,151,150,146,146,37
"3434",33,"[27]bHoIeAloHcoxHnJqGKCwJHmHfdi",291,0.996575,27,292,1,291,1,1,0,1,1,140,139,152,152,37
"3435",34,"[27]bHoIeAloHcoxHnJqGKCwJHmHfdi",301,0.996689,27,302,1,301,1,1,0,1,1,163,162,139,139,37
"3436",35,"[27]bHoIeAloHcoxHnJqGKCwJHmHfdi",298,0.996656,27,299,1,298,1,1,0,1,1,153,152,146,146,37
"3437",36,"[27]bHoIeAloHcoxHnJqGKCwJHmHfdi",291,0.996575,27,292,1,291,1,1,0,1,1,137,136,155,155,37
"3438",37,"[27]bHoIeAloHcoxHnJqGKCwJHmHfdi",295,0.996622,27,296,1,295,1,1,0,1,1,146,145,150,150,37
"3439",38,"[27]bHoIeAloHcoxHnJqGKCwJHmHfdi",295,0.996622,27,296,1,295,1,1,0,1,1,137,136,159,159,37
"3440",39,"[27]bHoIeAloHcoxHnJqGKCwJHmHfdi",297,0.996644,27,298,1,297,1,1,0,1,1,156,155,142,142,37
"3441",40,"[27]bHoIeAloHcoxHnJqGKCwJHmHfdi",295,0.996622,27,296,1,295,1,1,0,1,1,150,149,146,146,37
"3442",41,"[27]bHoIeAloHcoxHnJqGKCwJHmHfdi",303,0.996711,27,304,1,303,1,1,0,1,1,168,167,136,136,37
"3443",42,"[27]bHoIeAloHcoxHnJqGKCwJHmHfdi",295,0.996622,27,296,1,295,1,1,0,1,1,149,148,147,147,37
"3444",43,"[27]bHoIeAloHcoxHnJqGKCwJHmHfdi",289,0.996552,27,290,1,289,1,1,0,1,1,138,137,152,152,37
"3445",44,"[27]bHoIeAloHcoxHnJqGKCwJHmHfdi",299,0.996667,27,300,1,299,1,1,0,1,1,159,158,141,141,37
"3446",45,"[27]bHoIeAloHcoxHnJqGKCwJHmHfdi",290,0.996564,27,291,1,290,1,1,0,1,1,145,144,146,146,37
"3447",46,"[27]bHoIeAloHcoxHnJqGKCwJHmHfdi",295,0.996622,27,296,1,295,1,1,0,1,1,152,151,144,144,37
"3448",47,"[27]bHoIeAloHcoxHnJqGKCwJHmHfdi",295,0.996622,27,296,1,295,1,1,0,1,1,147,146,149,149,37
"3449",48,"[27]bHoIeAloHcoxHnJqGKCwJHmHfdi",296,0.996633,27,297,1,296,1,1,0,1,1,152,151,145,145,37
"3450",49,"[27]bHoIeAloHcoxHnJqGKCwJHmHfdi",294,0.99661,27,295,1,294,1,1,0,1,1,148,147,147,147,37
"3451",50,"[27]bHoIeAloHcoxHnJqGKCwJHmHfdi",291,0.996575,27,292,1,291,1,1,0,1,1,145,144,147,147,37
"3452",51,"[27]bHoIeAloHcoxHnJqGKCwJHmHfdi",295,0.996622,27,296,1,295,1,1,0,1,1,148,147,148,148,37
"3453",52,"[27]bHoIeAloHcoxHnJqGKCwJHmHfdi",294,0.99661,27,295,1,294,1,1,0,1,1,151,150,144,144,37
"3454",53,"[27]bHoIeAloHcoxHnJqGKCwJHmHfdi",295,0.996622,27,296,1,295,1,1,0,1,1,142,141,154,154,37
"3455",54,"[27]bHoIeAloHcoxHnJqGKCwJHmHfdi",296,0.996633,27,297,1,296,1,1,0,1,1,158,157,139,139,37
"3456",55,"[27]bHoIeAloHcoxHnJqGKCwJHmHfdi",299,0.996667,27,300,1,299,1,1,0,1,1,157,156,143,143,37
"3457",56,"[27]bHoIeAloHcoxHnJqGKCwJHmHfdi",303,0.996711,27,304,1,303,1,1,0,1,1,161,160,143,143,37
"3458",57,"[27]bHoIeAloHcoxHnJqGKCwJHmHfdi",295,0.996622,27,296,1,295,1,1,0,1,1,146,145,150,150,37
"3459",58,"[27]bHoIeAloHcoxHnJqGKCwJHmHfdi",295,0.996622,27,296,1,295,1,1,0,1,1,148,147,148,148,37
"3460",59,"[27]bHoIeAloHcoxHnJqGKCwJHmHfdi",288,0.99654,27,289,1,288,1,1,0,1,1,133,132,156,156,37
"3461",60,"[27]bHoIeAloHcoxHnJqGKCwJHmHfdi",289,0.996552,27,290,1,289,1,1,0,1,1,132,131,158,158,37
"3462",61,"[27]bHoIeAloHcoxHnJqGKCwJHmHfdi",300,0.996678,27,301,1,300,1,1,0,1,1,164,163,137,137,37
"3463",62,"[27]bHoIeAloHcoxHnJqGKCwJHmHfdi",296,0.996633,27,297,1,296,1,1,0,1,1,160,159,137,137,37
"3464",63,"[27]bHoIeAloHcoxHnJqGKCwJHmHfdi",293,0.996599,27,294,1,293,1,1,0,1,1,147,146,147,147,37
"3465",64,"[27]bHoIeAloHcoxHnJqGKCwJHmHfdi",290,0.996564,27,291,1,290,1,1,0,1,1,132,131,159,159,37
"3466",65,"[27]bHoIeAloHcoxHnJqGKCwJHmHfdi",296,0.996633,27,297,1,296,1,1,0,1,1,156,155,141,141,37
"3467",66,"[27]bHoIeAloHcoxHnJqGKCwJHmHfdi",303,0.996711,27,304,1,303,1,1,0,1,1,168,167,136,136,37
"3468",67,"[27]bHoIeAloHcoxHnJqGKCwJHmHfdi",294,0.99661,27,295,1,294,1,1,0,1,1,141,140,154,154,37
"3469",68,"[27]bHoIeAloHcoxHnJqGKCwJHmHfdi",303,0.996711,27,304,1,303,1,1,0,1,1,168,167,136,136,37
"3470",69,"[27]bHoIeAloHcoxHnJqGKCwJHmHfdi",301,0.996689,27,302,1,301,1,1,0,1,1,163,162,139,139,37
"3471",70,"[27]bHoIeAloHcoxHnJqGKCwJHmHfdi",291,0.996575,27,292,1,291,1,1,0,1,1,145,144,147,147,37
"3472",71,"[27]bHoIeAloHcoxHnJqGKCwJHmHfdi",297,0.996644,27,298,1,297,1,1,0,1,1,152,151,146,146,37
"3473",72,"[27]bHoIeAloHcoxHnJqGKCwJHmHfdi",297,0.996644,27,298,1,297,1,1,0,1,1,151,150,147,147,37
"3474",73,"[27]bHoIeAloHcoxHnJqGKCwJHmHfdi",289,0.996552,27,290,1,289,1,1,0,1,1,142,141,148,148,37
"3475",74,"[27]bHoIeAloHcoxHnJqGKCwJHmHfdi",294,0.99661,27,295,1,294,1,1,0,1,1,142,141,153,153,37
"3476",75,"[27]bHoIeAloHcoxHnJqGKCwJHmHfdi",296,0.996633,27,297,1,296,1,1,0,1,1,154,153,143,143,37
"3477",76,"[27]bHoIeAloHcoxHnJqGKCwJHmHfdi",288,0.99654,27,289,1,288,1,1,0,1,1,132,131,157,157,37
"3478",77,"[27]bHoIeAloHcoxHnJqGKCwJHmHfdi",291,0.996575,27,292,1,291,1,1,0,1,1,134,133,158,158,37
"3479",78,"[27]bHoIeAloHcoxHnJqGKCwJHmHfdi",301,0.996689,27,302,1,301,1,1,0,1,1,165,164,137,137,37
"3480",79,"[27]bHoIeAloHcoxHnJqGKCwJHmHfdi",294,0.99661,27,295,1,294,1,1,0,1,1,146,145,149,149,37
"3481",80,"[27]bHoIeAloHcoxHnJqGKCwJHmHfdi",291,0.996575,27,292,1,291,1,1,0,1,1,139,138,153,153,37
"3482",81,"[27]bHoIeAloHcoxHnJqGKCwJHmHfdi",297,0.996644,27,298,1,297,1,1,0,1,1,155,154,143,143,37
"3483",82,"[27]bHoIeAloHcoxHnJqGKCwJHmHfdi",295,0.996622,27,296,1,295,1,1,0,1,1,152,151,144,144,37
"3484",83,"[27]bHoIeAloHcoxHnJqGKCwJHmHfdi",295,0.996622,27,296,1,295,1,1,0,1,1,148,147,148,148,37
"3485",84,"[27]bHoIeAloHcoxHnJqGKCwJHmHfdi",297,0.996644,27,298,1,297,1,1,0,1,1,163,162,135,135,37
"3486",85,"[27]bHoIeAloHcoxHnJqGKCwJHmHfdi",298,0.996656,27,299,1,298,1,1,0,1,1,158,157,141,141,37
"3487",86,"[27]bHoIeAloHcoxHnJqGKCwJHmHfdi",286,0.996516,27,287,1,286,1,1,0,1,1,134,133,153,153,37
"3488",87,"[27]bHoIeAloHcoxHnJqGKCwJHmHfdi",295,0.996622,27,296,1,295,1,1,0,1,1,153,152,143,143,37
"3489",88,"[27]bHoIeAloHcoxHnJqGKCwJHmHfdi",290,0.996564,27,291,1,290,1,1,0,1,1,136,135,155,155,37
"3490",89,"[27]bHoIeAloHcoxHnJqGKCwJHmHfdi",293,0.996599,27,294,1,293,1,1,0,1,1,141,140,153,153,37
"3491",90,"[27]bHoIeAloHcoxHnJqGKCwJHmHfdi",297,0.996644,27,298,1,297,1,1,0,1,1,151,150,147,147,37
"3492",91,"[27]bHoIeAloHcoxHnJqGKCwJHmHfdi",295,0.996622,27,296,1,295,1,1,0,1,1,152,151,144,144,37
"3493",92,"[27]bHoIeAloHcoxHnJqGKCwJHmHfdi",295,0.996622,27,296,1,295,1,1,0,1,1,149,148,147,147,37
"3494",93,"[27]bHoIeAloHcoxHnJqGKCwJHmHfdi",291,0.996575,27,292,1,291,1,1,0,1,1,137,136,155,155,37
"3495",94,"[27]bHoIeAloHcoxHnJqGKCwJHmHfdi",296,0.996633,27,297,1,296,1,1,0,1,1,151,150,146,146,37
"3496",95,"[27]bHoIeAloHcoxHnJqGKCwJHmHfdi",293,0.996599,27,294,1,293,1,1,0,1,1,149,148,145,145,37
"3497",96,"[27]bHoIeAloHcoxHnJqGKCwJHmHfdi",291,0.996575,27,292,1,291,1,1,0,1,1,135,134,157,157,37
"3498",97,"[27]bHoIeAloHcoxHnJqGKCwJHmHfdi",291,0.996575,27,292,1,291,1,1,0,1,1,136,135,156,156,37
"3499",98,"[27]bHoIeAloHcoxHnJqGKCwJHmHfdi",299,0.996667,27,300,1,299,1,1,0,1,1,153,152,147,147,37
"3500",99,"[27]bHoIeAloHcoxHnJqGKCwJHmHfdi",291,0.996575,27,292,1,291,1,1,0,1,1,135,134,157,157,37
"3501",0,"[26]JuHoIoHcovHnJqGKCwahmcukrk",300,0.996678,26,301,1,300,1,1,0,1,1,157,156,144,144,38
"3502",1,"[26]JuHoIoHcovHnJqGKCwahmcukrk",297,0.996644,26,298,1,297,1,1,0,1,1,150,149,148,148,38
"3503",2,"[26]JuHoIoHcovHnJqGKCwahmcukrk",303,0.996711,26,304,1,303,1,1,0,1,1,156,155,148,148,38
"3504",3,"[26]JuHoIoHcovHnJqGKCwahmcukrk",303,0.996711,26,304,1,303,1,1,0,1,1,165,164,139,139,38
"3505",4,"[26]JuHoIoHcovHnJqGKCwahmcukrk",298,0.996656,26,299,1,298,1,1,0,1,1,157,156,142,142,38
"3506",5,"[26]JuHoIoHcovHnJqGKCwahmcukrk",296,0.996633,26,297,1,296,1,1,0,1,1,147,146,150,150,38
"3507",6,"[26]JuHoIoHcovHnJqGKCwahmcukrk",294,0.99661,26,295,1,294,1,1,0,1,1,139,138,156,156,38
"3508",7,"[26]JuHoIoHcovHnJqGKCwahmcukrk",302,0.9967,26,303,1,302,1,1,0,1,1,162,161,141,141,38
"3509",8,"[26]JuHoIoHcovHnJqGKCwahmcukrk",297,0.996644,26,298,1,297,1,1,0,1,1,148,147,150,150,38
"3510",9,"[26]JuHoIoHcovHnJqGKCwahmcukrk",302,0.9967,26,303,1,302,1,1,0,1,1,163,162,140,140,38
"3511",10,"[26]JuHoIoHcovHnJqGKCwahmcukrk",298,0.996656,26,299,1,298,1,1,0,1,1,151,150,148,148,38
"3512",11,"[26]JuHoIoHcovHnJqGKCwahmcukrk",293,0.996599,26,294,1,293,1,1,0,1,1,136,135,158,158,38
"3513",12,"[26]JuHoIoHcovHnJqGKCwahmcukrk",294,0.99661,26,295,1,294,1,1,0,1,1,142,141,153,153,38
"3514",13,"[26]JuHoIoHcovHnJqGKCwahmcukrk",297,0.996644,26,298,1,297,1,1,0,1,1,143,142,155,155,38
"3515",14,"[26]JuHoIoHcovHnJqGKCwahmcukrk",305,0.996732,26,306,1,305,1,1,0,1,1,163,162,143,143,38
"3516",15,"[26]JuHoIoHcovHnJqGKCwahmcukrk",300,0.996678,26,301,1,300,1,1,0,1,1,156,155,145,145,38
"3517",16,"[26]JuHoIoHcovHnJqGKCwahmcukrk",296,0.996633,26,297,1,296,1,1,0,1,1,144,143,153,153,38
"3518",17,"[26]JuHoIoHcovHnJqGKCwahmcukrk",303,0.996711,26,304,1,303,1,1,0,1,1,165,164,139,139,38
"3519",18,"[26]JuHoIoHcovHnJqGKCwahmcukrk",301,0.996689,26,302,1,301,1,1,0,1,1,158,157,144,144,38
"3520",19,"[26]JuHoIoHcovHnJqGKCwahmcukrk",299,0.996667,26,300,1,299,1,1,0,1,1,158,157,142,142,38
"3521",20,"[26]JuHoIoHcovHnJqGKCwahmcukrk",303,0.996711,26,304,1,303,1,1,0,1,1,159,158,145,145,38
"3522",21,"[26]JuHoIoHcovHnJqGKCwahmcukrk",292,0.996587,26,293,1,292,1,1,0,1,1,134,133,159,159,38
"3523",22,"[26]JuHoIoHcovHnJqGKCwahmcukrk",291,0.996575,26,292,1,291,1,1,0,1,1,133,132,159,159,38
"3524",23,"[26]JuHoIoHcovHnJqGKCwahmcukrk",301,0.996689,26,302,1,301,1,1,0,1,1,160,159,142,142,38
"3525",24,"[26]JuHoIoHcovHnJqGKCwahmcukrk",295,0.996622,26,296,1,295,1,1,0,1,1,147,146,149,149,38
"3526",25,"[26]JuHoIoHcovHnJqGKCwahmcukrk",294,0.99661,26,295,1,294,1,1,0,1,1,137,136,158,158,38
"3527",26,"[26]JuHoIoHcovHnJqGKCwahmcukrk",298,0.996656,26,299,1,298,1,1,0,1,1,153,152,146,146,38
"3528",27,"[26]JuHoIoHcovHnJqGKCwahmcukrk",294,0.99661,26,295,1,294,1,1,0,1,1,139,138,156,156,38
"3529",28,"[26]JuHoIoHcovHnJqGKCwahmcukrk",299,0.996667,26,300,1,299,1,1,0,1,1,148,147,152,152,38
"3530",29,"[26]JuHoIoHcovHnJqGKCwahmcukrk",294,0.99661,26,295,1,294,1,1,0,1,1,141,140,154,154,38
"3531",30,"[26]JuHoIoHcovHnJqGKCwahmcukrk",302,0.9967,26,303,1,302,1,1,0,1,1,160,159,143,143,38
"3532",31,"[26]JuHoIoHcovHnJqGKCwahmcukrk",296,0.996633,26,297,1,296,1,1,0,1,1,141,140,156,156,38
"3533",32,"[26]JuHoIoHcovHnJqGKCwahmcukrk",297,0.996644,26,298,1,297,1,1,0,1,1,153,152,145,145,38
"3534",33,"[26]JuHoIoHcovHnJqGKCwahmcukrk",298,0.996656,26,299,1,298,1,1,0,1,1,144,143,155,155,38
"3535",34,"[26]JuHoIoHcovHnJqGKCwahmcukrk",296,0.996633,26,297,1,296,1,1,0,1,1,144,143,153,153,38
"3536",35,"[26]JuHoIoHcovHnJqGKCwahmcukrk",305,0.996732,26,306,1,305,1,1,0,1,1,172,171,134,134,38
"3537",36,"[26]JuHoIoHcovHnJqGKCwahmcukrk",300,0.996678,26,301,1,300,1,1,0,1,1,160,159,141,141,38
"3538",37,"[26]JuHoIoHcovHnJqGKCwahmcukrk",303,0.996711,26,304,1,303,1,1,0,1,1,156,155,148,148,38
"3539",38,"[26]JuHoIoHcovHnJqGKCwahmcukrk",294,0.99661,26,295,1,294,1,1,0,1,1,140,139,155,155,38
"3540",39,"[26]JuHoIoHcovHnJqGKCwahmcukrk",294,0.99661,26,295,1,294,1,1,0,1,1,148,147,147,147,38
"3541",40,"[26]JuHoIoHcovHnJqGKCwahmcukrk",294,0.99661,26,295,1,294,1,1,0,1,1,148,147,147,147,38
"3542",41,"[26]JuHoIoHcovHnJqGKCwahmcukrk",301,0.996689,26,302,1,301,1,1,0,1,1,157,156,145,145,38
"3543",42,"[26]JuHoIoHcovHnJqGKCwahmcukrk",298,0.996656,26,299,1,298,1,1,0,1,1,148,147,151,151,38
"3544",43,"[26]JuHoIoHcovHnJqGKCwahmcukrk",294,0.99661,26,295,1,294,1,1,0,1,1,142,141,153,153,38
"3545",44,"[26]JuHoIoHcovHnJqGKCwahmcukrk",296,0.996633,26,297,1,296,1,1,0,1,1,148,147,149,149,38
"3546",45,"[26]JuHoIoHcovHnJqGKCwahmcukrk",298,0.996656,26,299,1,298,1,1,0,1,1,151,150,148,148,38
"3547",46,"[26]JuHoIoHcovHnJqGKCwahmcukrk",301,0.996689,26,302,1,301,1,1,0,1,1,161,160,141,141,38
"3548",47,"[26]JuHoIoHcovHnJqGKCwahmcukrk",303,0.996711,26,304,1,303,1,1,0,1,1,166,165,138,138,38
"3549",48,"[26]JuHoIoHcovHnJqGKCwahmcukrk",296,0.996633,26,297,1,296,1,1,0,1,1,145,144,152,152,38
"3550",49,"[26]JuHoIoHcovHnJqGKCwahmcukrk",296,0.996633,26,297,1,296,1,1,0,1,1,145,144,152,152,38
"3551",50,"[26]JuHoIoHcovHnJqGKCwahmcukrk",294,0.99661,26,295,1,294,1,1,0,1,1,140,139,155,155,38
"3552",51,"[26]JuHoIoHcovHnJqGKCwahmcukrk",301,0.996689,26,302,1,301,1,1,0,1,1,160,159,142,142,38
"3553",52,"[26]JuHoIoHcovHnJqGKCwahmcukrk",305,0.996732,26,306,1,305,1,1,0,1,1,171,170,135,135,38
"3554",53,"[26]JuHoIoHcovHnJqGKCwahmcukrk",295,0.996622,26,296,1,295,1,1,0,1,1,144,143,152,152,38
"3555",54,"[26]JuHoIoHcovHnJqGKCwahmcukrk",300,0.996678,26,301,1,300,1,1,0,1,1,155,154,146,146,38
"3556",55,"[26]JuHoIoHcovHnJqGKCwahmcukrk",293,0.996599,26,294,1,293,1,1,0,1,1,135,134,159,159,38
"3557",56,"[26]JuHoIoHcovHnJqGKCwahmcukrk",302,0.9967,26,303,1,302,1,1,0,1,1,161,160,142,142,38
"3558",57,"[26]JuHoIoHcovHnJqGKCwahmcukrk",295,0.996622,26,296,1,295,1,1,0,1,1,146,145,150,150,38
"3559",58,"[26]JuHoIoHcovHnJqGKCwahmcukrk",300,0.996678,26,301,1,300,1,1,0,1,1,154,153,147,147,38
"3560",59,"[26]JuHoIoHcovHnJqGKCwahmcukrk",296,0.996633,26,297,1,296,1,1,0,1,1,145,144,152,152,38
"3561",60,"[26]JuHoIoHcovHnJqGKCwahmcukrk",300,0.996678,26,301,1,300,1,1,0,1,1,156,155,145,145,38
"3562",61,"[26]JuHoIoHcovHnJqGKCwahmcukrk",292,0.996587,26,293,1,292,1,1,0,1,1,140,139,153,153,38
"3563",62,"[26]JuHoIoHcovHnJqGKCwahmcukrk",296,0.996633,26,297,1,296,1,1,0,1,1,145,144,152,152,38
"3564",63,"[26]JuHoIoHcovHnJqGKCwahmcukrk",300,0.996678,26,301,1,300,1,1,0,1,1,153,152,148,148,38
"3565",64,"[26]JuHoIoHcovHnJqGKCwahmcukrk",298,0.996656,26,299,1,298,1,1,0,1,1,147,146,152,152,38
"3566",65,"[26]JuHoIoHcovHnJqGKCwahmcukrk",298,0.996656,26,299,1,298,1,1,0,1,1,143,142,156,156,38
"3567",66,"[26]JuHoIoHcovHnJqGKCwahmcukrk",299,0.996667,26,300,1,299,1,1,0,1,1,152,151,148,148,38
"3568",67,"[26]JuHoIoHcovHnJqGKCwahmcukrk",292,0.996587,26,293,1,292,1,1,0,1,1,146,145,147,147,38
"3569",68,"[26]JuHoIoHcovHnJqGKCwahmcukrk",300,0.996678,26,301,1,300,1,1,0,1,1,156,155,145,145,38
"3570",69,"[26]JuHoIoHcovHnJqGKCwahmcukrk",293,0.996599,26,294,1,293,1,1,0,1,1,140,139,154,154,38
"3571",70,"[26]JuHoIoHcovHnJqGKCwahmcukrk",298,0.996656,26,299,1,298,1,1,0,1,1,153,152,146,146,38
"3572",71,"[26]JuHoIoHcovHnJqGKCwahmcukrk",300,0.996678,26,301,1,300,1,1,0,1,1,143,142,158,158,38
"3573",72,"[26]JuHoIoHcovHnJqGKCwahmcukrk",292,0.996587,26,293,1,292,1,1,0,1,1,131,130,162,162,38
"3574",73,"[26]JuHoIoHcovHnJqGKCwahmcukrk",296,0.996633,26,297,1,296,1,1,0,1,1,147,146,150,150,38
"3575",74,"[26]JuHoIoHcovHnJqGKCwahmcukrk",291,0.996575,26,292,1,291,1,1,0,1,1,133,132,159,159,38
"3576",75,"[26]JuHoIoHcovHnJqGKCwahmcukrk",303,0.996711,26,304,1,303,1,1,0,1,1,167,166,137,137,38
"3577",76,"[26]JuHoIoHcovHnJqGKCwahmcukrk",296,0.996633,26,297,1,296,1,1,0,1,1,145,144,152,152,38
"3578",77,"[26]JuHoIoHcovHnJqGKCwahmcukrk",296,0.996633,26,297,1,296,1,1,0,1,1,148,147,149,149,38
"3579",78,"[26]JuHoIoHcovHnJqGKCwahmcukrk",304,0.996721,26,305,1,304,1,1,0,1,1,163,162,142,142,38
"3580",79,"[26]JuHoIoHcovHnJqGKCwahmcukrk",299,0.996667,26,300,1,299,1,1,0,1,1,151,150,149,149,38
"3581",80,"[26]JuHoIoHcovHnJqGKCwahmcukrk",301,0.996689,26,302,1,301,1,1,0,1,1,159,158,143,143,38
"3582",81,"[26]JuHoIoHcovHnJqGKCwahmcukrk",299,0.996667,26,300,1,299,1,1,0,1,1,152,151,148,148,38
"3583",82,"[26]JuHoIoHcovHnJqGKCwahmcukrk",294,0.99661,26,295,1,294,1,1,0,1,1,147,146,148,148,38
"3584",83,"[26]JuHoIoHcovHnJqGKCwahmcukrk",305,0.996732,26,306,1,305,1,1,0,1,1,171,170,135,135,38
"3585",84,"[26]JuHoIoHcovHnJqGKCwahmcukrk",301,0.996689,26,302,1,301,1,1,0,1,1,154,153,148,148,38
"3586",85,"[26]JuHoIoHcovHnJqGKCwahmcukrk",301,0.996689,26,302,1,301,1,1,0,1,1,160,159,142,142,38
"3587",86,"[26]JuHoIoHcovHnJqGKCwahmcukrk",289,0.996552,26,290,1,289,1,1,0,1,1,124,123,166,166,38
"3588",87,"[26]JuHoIoHcovHnJqGKCwahmcukrk",291,0.996575,26,292,1,291,1,1,0,1,1,130,129,162,162,38
"3589",88,"[26]JuHoIoHcovHnJqGKCwahmcukrk",298,0.996656,26,299,1,298,1,1,0,1,1,151,150,148,148,38
"3590",89,"[26]JuHoIoHcovHnJqGKCwahmcukrk",298,0.996656,26,299,1,298,1,1,0,1,1,151,150,148,148,38
"3591",90,"[26]JuHoIoHcovHnJqGKCwahmcukrk",302,0.9967,26,303,1,302,1,1,0,1,1,160,159,143,143,38
"3592",91,"[26]JuHoIoHcovHnJqGKCwahmcukrk",300,0.996678,26,301,1,300,1,1,0,1,1,155,154,146,146,38
"3593",92,"[26]JuHoIoHcovHnJqGKCwahmcukrk",293,0.996599,26,294,1,293,1,1,0,1,1,134,133,160,160,38
"3594",93,"[26]JuHoIoHcovHnJqGKCwahmcukrk",294,0.99661,26,295,1,294,1,1,0,1,1,142,141,153,153,38
"3595",94,"[26]JuHoIoHcovHnJqGKCwahmcukrk",300,0.996678,26,301,1,300,1,1,0,1,1,156,155,145,145,38
"3596",95,"[26]JuHoIoHcovHnJqGKCwahmcukrk",296,0.996633,26,297,1,296,1,1,0,1,1,143,142,154,154,38
"3597",96,"[26]JuHoIoHcovHnJqGKCwahmcukrk",292,0.996587,26,293,1,292,1,1,0,1,1,131,130,162,162,38
"3598",97,"[26]JuHoIoHcovHnJqGKCwahmcukrk",303,0.996711,26,304,1,303,1,1,0,1,1,165,164,139,139,38
"3599",98,"[26]JuHoIoHcovHnJqGKCwahmcukrk",293,0.996599,26,294,1,293,1,1,0,1,1,135,134,159,159,38
"3600",99,"[26]JuHoIoHcovHnJqGKCwahmcukrk",299,0.996667,26,300,1,299,1,1,0,1,1,152,151,148,148,38
"3601",0,"[25]ioIpGoHcotHnJHGqKCIbqtsju",282,0.996466,25,283,1,282,1,1,0,1,1,144,143,139,139,39
"3602",1,"[25]ioIpGoHcotHnJHGqKCIbqtsju",286,0.996516,25,287,1,286,1,1,0,1,1,149,148,138,138,39
"3603",2,"[25]ioIpGoHcotHnJHGqKCIbqtsju",283,0.996479,25,284,1,283,1,1,0,1,1,153,152,131,131,39
"3604",3,"[25]ioIpGoHcotHnJHGqKCIbqtsju",283,0.996479,25,284,1,283,1,1,0,1,1,140,139,144,144,39
"3605",4,"[25]ioIpGoHcotHnJHGqKCIbqtsju",280,0.996441,25,281,1,280,1,1,0,1,1,130,129,151,151,39
"3606",5,"[25]ioIpGoHcotHnJHGqKCIbqtsju",282,0.996466,25,283,1,282,1,1,0,1,1,142,141,141,141,39
"3607",6,"[25]ioIpGoHcotHnJHGqKCIbqtsju",282,0.996466,25,283,1,282,1,1,0,1,1,141,140,142,142,39
"3608",7,"[25]ioIpGoHcotHnJHGqKCIbqtsju",280,0.996441,25,281,1,280,1,1,0,1,1,143,142,138,138,39
"3609",8,"[25]ioIpGoHcotHnJHGqKCIbqtsju",286,0.996516,25,287,1,286,1,1,0,1,1,154,153,133,133,39
"3610",9,"[25]ioIpGoHcotHnJHGqKCIbqtsju",280,0.996441,25,281,1,280,1,1,0,1,1,149,148,132,132,39
"3611",10,"[25]ioIpGoHcotHnJHGqKCIbqtsju",279,0.996429,25,280,1,279,1,1,0,1,1,136,135,144,144,39
"3612",11,"[25]ioIpGoHcotHnJHGqKCIbqtsju",280,0.996441,25,281,1,280,1,1,0,1,1,127,126,154,154,39
"3613",12,"[25]ioIpGoHcotHnJHGqKCIbqtsju",272,0.996337,25,273,1,272,1,1,0,1,1,133,132,140,140,39
"3614",13,"[25]ioIpGoHcotHnJHGqKCIbqtsju",274,0.996364,25,275,1,274,1,1,0,1,1,133,132,142,142,39
"3615",14,"[25]ioIpGoHcotHnJHGqKCIbqtsju",283,0.996479,25,284,1,283,1,1,0,1,1,134,133,150,150,39
"3616",15,"[25]ioIpGoHcotHnJHGqKCIbqtsju",282,0.996466,25,283,1,282,1,1,0,1,1,148,147,135,135,39
"3617",16,"[25]ioIpGoHcotHnJHGqKCIbqtsju",279,0.996429,25,280,1,279,1,1,0,1,1,137,136,143,143,39
"3618",17,"[25]ioIpGoHcotHnJHGqKCIbqtsju",283,0.996479,25,284,1,283,1,1,0,1,1,149,148,135,135,39
"3619",18,"[25]ioIpGoHcotHnJHGqKCIbqtsju",282,0.996466,25,283,1,282,1,1,0,1,1,137,136,146,146,39
"3620",19,"[25]ioIpGoHcotHnJHGqKCIbqtsju",276,0.99639,25,277,1,276,1,1,0,1,1,143,142,134,134,39
"3621",20,"[25]ioIpGoHcotHnJHGqKCIbqtsju",282,0.996466,25,283,1,282,1,1,0,1,1,150,149,133,133,39
"3622",21,"[25]ioIpGoHcotHnJHGqKCIbqtsju",287,0.996528,25,288,1,287,1,1,0,1,1,147,146,141,141,39
"3623",22,"[25]ioIpGoHcotHnJHGqKCIbqtsju",284,0.996491,25,285,1,284,1,1,0,1,1,133,132,152,152,39
"3624",23,"[25]ioIpGoHcotHnJHGqKCIbqtsju",283,0.996479,25,284,1,283,1,1,0,1,1,156,155,128,128,39
"3625",24,"[25]ioIpGoHcotHnJHGqKCIbqtsju",282,0.996466,25,283,1,282,1,1,0,1,1,137,136,146,146,39
"3626",25,"[25]ioIpGoHcotHnJHGqKCIbqtsju",285,0.996503,25,286,1,285,1,1,0,1,1,139,138,147,147,39
"3627",26,"[25]ioIpGoHcotHnJHGqKCIbqtsju",282,0.996466,25,283,1,282,1,1,0,1,1,155,154,128,128,39
"3628",27,"[25]ioIpGoHcotHnJHGqKCIbqtsju",274,0.996364,25,275,1,274,1,1,0,1,1,135,134,140,140,39
"3629",28,"[25]ioIpGoHcotHnJHGqKCIbqtsju",290,0.996564,25,291,1,290,1,1,0,1,1,160,159,131,131,39
"3630",29,"[25]ioIpGoHcotHnJHGqKCIbqtsju",281,0.996454,25,282,1,281,1,1,0,1,1,152,151,130,130,39
"3631",30,"[25]ioIpGoHcotHnJHGqKCIbqtsju",284,0.996491,25,285,1,284,1,1,0,1,1,152,151,133,133,39
"3632",31,"[25]ioIpGoHcotHnJHGqKCIbqtsju",287,0.996528,25,288,1,287,1,1,0,1,1,142,141,146,146,39
"3633",32,"[25]ioIpGoHcotHnJHGqKCIbqtsju",283,0.996479,25,284,1,283,1,1,0,1,1,141,140,143,143,39
"3634",33,"[25]ioIpGoHcotHnJHGqKCIbqtsju",276,0.99639,25,277,1,276,1,1,0,1,1,142,141,135,135,39
"3635",34,"[25]ioIpGoHcotHnJHGqKCIbqtsju",276,0.99639,25,277,1,276,1,1,0,1,1,136,135,141,141,39
"3636",35,"[25]ioIpGoHcotHnJHGqKCIbqtsju",280,0.996441,25,281,1,280,1,1,0,1,1,149,148,132,132,39
"3637",36,"[25]ioIpGoHcotHnJHGqKCIbqtsju",274,0.996364,25,275,1,274,1,1,0,1,1,132,131,143,143,39
"3638",37,"[25]ioIpGoHcotHnJHGqKCIbqtsju",287,0.996528,25,288,1,287,1,1,0,1,1,139,138,149,149,39
"3639",38,"[25]ioIpGoHcotHnJHGqKCIbqtsju",294,0.99661,25,295,1,294,1,1,0,1,1,169,168,126,126,39
"3640",39,"[25]ioIpGoHcotHnJHGqKCIbqtsju",281,0.996454,25,282,1,281,1,1,0,1,1,141,140,141,141,39
"3641",40,"[25]ioIpGoHcotHnJHGqKCIbqtsju",275,0.996377,25,276,1,275,1,1,0,1,1,139,138,137,137,39
"3642",41,"[25]ioIpGoHcotHnJHGqKCIbqtsju",282,0.996466,25,283,1,282,1,1,0,1,1,140,139,143,143,39
"3643",42,"[25]ioIpGoHcotHnJHGqKCIbqtsju",290,0.996564,25,291,1,290,1,1,0,1,1,145,144,146,146,39
"3644",43,"[25]ioIpGoHcotHnJHGqKCIbqtsju",276,0.99639,25,277,1,276,1,1,0,1,1,140,139,137,137,39
"3645",44,"[25]ioIpGoHcotHnJHGqKCIbqtsju",278,0.996416,25,279,1,278,1,1,0,1,1,124,123,155,155,39
"3646",45,"[25]ioIpGoHcotHnJHGqKCIbqtsju",283,0.996479,25,284,1,283,1,1,0,1,1,149,148,135,135,39
"3647",46,"[25]ioIpGoHcotHnJHGqKCIbqtsju",274,0.996364,25,275,1,274,1,1,0,1,1,151,150,124,124,39
"3648",47,"[25]ioIpGoHcotHnJHGqKCIbqtsju",275,0.996377,25,276,1,275,1,1,0,1,1,137,136,139,139,39
"3649",48,"[25]ioIpGoHcotHnJHGqKCIbqtsju",286,0.996516,25,287,1,286,1,1,0,1,1,137,136,150,150,39
"3650",49,"[25]ioIpGoHcotHnJHGqKCIbqtsju",280,0.996441,25,281,1,280,1,1,0,1,1,143,142,138,138,39
"3651",50,"[25]ioIpGoHcotHnJHGqKCIbqtsju",278,0.996416,25,279,1,278,1,1,0,1,1,149,148,130,130,39
"3652",51,"[25]ioIpGoHcotHnJHGqKCIbqtsju",279,0.996429,25,280,1,279,1,1,0,1,1,150,149,130,130,39
"3653",52,"[25]ioIpGoHcotHnJHGqKCIbqtsju",275,0.996377,25,276,1,275,1,1,0,1,1,131,130,145,145,39
"3654",53,"[25]ioIpGoHcotHnJHGqKCIbqtsju",281,0.996454,25,282,1,281,1,1,0,1,1,146,145,136,136,39
"3655",54,"[25]ioIpGoHcotHnJHGqKCIbqtsju",281,0.996454,25,282,1,281,1,1,0,1,1,139,138,143,143,39
"3656",55,"[25]ioIpGoHcotHnJHGqKCIbqtsju",278,0.996416,25,279,1,278,1,1,0,1,1,145,144,134,134,39
"3657",56,"[25]ioIpGoHcotHnJHGqKCIbqtsju",286,0.996516,25,287,1,286,1,1,0,1,1,146,145,141,141,39
"3658",57,"[25]ioIpGoHcotHnJHGqKCIbqtsju",283,0.996479,25,284,1,283,1,1,0,1,1,149,148,135,135,39
"3659",58,"[25]ioIpGoHcotHnJHGqKCIbqtsju",283,0.996479,25,284,1,283,1,1,0,1,1,144,143,140,140,39
"3660",59,"[25]ioIpGoHcotHnJHGqKCIbqtsju",279,0.996429,25,280,1,279,1,1,0,1,1,159,158,121,121,39
"3661",60,"[25]ioIpGoHcotHnJHGqKCIbqtsju",284,0.996491,25,285,1,284,1,1,0,1,1,158,157,127,127,39
"3662",61,"[25]ioIpGoHcotHnJHGqKCIbqtsju",279,0.996429,25,280,1,279,1,1,0,1,1,136,135,144,144,39
"3663",62,"[25]ioIpGoHcotHnJHGqKCIbqtsju",275,0.996377,25,276,1,275,1,1,0,1,1,123,122,153,153,39
"3664",63,"[25]ioIpGoHcotHnJHGqKCIbqtsju",283,0.996479,25,284,1,283,1,1,0,1,1,152,151,132,132,39
"3665",64,"[25]ioIpGoHcotHnJHGqKCIbqtsju",286,0.996516,25,287,1,286,1,1,0,1,1,146,145,141,141,39
"3666",65,"[25]ioIpGoHcotHnJHGqKCIbqtsju",276,0.99639,25,277,1,276,1,1,0,1,1,127,126,150,150,39
"3667",66,"[25]ioIpGoHcotHnJHGqKCIbqtsju",283,0.996479,25,284,1,283,1,1,0,1,1,138,137,146,146,39
"3668",67,"[25]ioIpGoHcotHnJHGqKCIbqtsju",287,0.996528,25,288,1,287,1,1,0,1,1,150,149,138,138,39
"3669",68,"[25]ioIpGoHcotHnJHGqKCIbqtsju",279,0.996429,25,280,1,279,1,1,0,1,1,140,139,140,140,39
"3670",69,"[25]ioIpGoHcotHnJHGqKCIbqtsju",286,0.996516,25,287,1,286,1,1,0,1,1,143,142,144,144,39
"3671",70,"[25]ioIpGoHcotHnJHGqKCIbqtsju",279,0.996429,25,280,1,279,1,1,0,1,1,146,145,134,134,39
"3672",71,"[25]ioIpGoHcotHnJHGqKCIbqtsju",282,0.996466,25,283,1,282,1,1,0,1,1,143,142,140,140,39
"3673",72,"[25]ioIpGoHcotHnJHGqKCIbqtsju",282,0.996466,25,283,1,282,1,1,0,1,1,147,146,136,136,39
"3674",73,"[25]ioIpGoHcotHnJHGqKCIbqtsju",275,0.996377,25,276,1,275,1,1,0,1,1,154,153,122,122,39
"3675",74,"[25]ioIpGoHcotHnJHGqKCIbqtsju",289,0.996552,25,290,1,289,1,1,0,1,1,147,146,143,143,39
"3676",75,"[25]ioIpGoHcotHnJHGqKCIbqtsju",276,0.99639,25,277,1,276,1,1,0,1,1,142,141,135,135,39
"3677",76,"[25]ioIpGoHcotHnJHGqKCIbqtsju",283,0.996479,25,284,1,283,1,1,0,1,1,150,149,134,134,39
"3678",77,"[25]ioIpGoHcotHnJHGqKCIbqtsju",272,0.996337,25,273,1,272,1,1,0,1,1,116,115,157,157,39
"3679",78,"[25]ioIpGoHcotHnJHGqKCIbqtsju",280,0.996441,25,281,1,280,1,1,0,1,1,142,141,139,139,39
"3680",79,"[25]ioIpGoHcotHnJHGqKCIbqtsju",278,0.996416,25,279,1,278,1,1,0,1,1,128,127,151,151,39
"3681",80,"[25]ioIpGoHcotHnJHGqKCIbqtsju",281,0.996454,25,282,1,281,1,1,0,1,1,146,145,136,136,39
"3682",81,"[25]ioIpGoHcotHnJHGqKCIbqtsju",281,0.996454,25,282,1,281,1,1,0,1,1,146,145,136,136,39
"3683",82,"[25]ioIpGoHcotHnJHGqKCIbqtsju",277,0.996403,25,278,1,277,1,1,0,1,1,149,148,129,129,39
"3684",83,"[25]ioIpGoHcotHnJHGqKCIbqtsju",280,0.996441,25,281,1,280,1,1,0,1,1,152,151,129,129,39
"3685",84,"[25]ioIpGoHcotHnJHGqKCIbqtsju",294,0.99661,25,295,1,294,1,1,0,1,1,150,149,145,145,39
"3686",85,"[25]ioIpGoHcotHnJHGqKCIbqtsju",277,0.996403,25,278,1,277,1,1,0,1,1,153,152,125,125,39
"3687",86,"[25]ioIpGoHcotHnJHGqKCIbqtsju",278,0.996416,25,279,1,278,1,1,0,1,1,152,151,127,127,39
"3688",87,"[25]ioIpGoHcotHnJHGqKCIbqtsju",283,0.996479,25,284,1,283,1,1,0,1,1,141,140,143,143,39
"3689",88,"[25]ioIpGoHcotHnJHGqKCIbqtsju",277,0.996403,25,278,1,277,1,1,0,1,1,138,137,140,140,39
"3690",89,"[25]ioIpGoHcotHnJHGqKCIbqtsju",280,0.996441,25,281,1,280,1,1,0,1,1,139,138,142,142,39
"3691",90,"[25]ioIpGoHcotHnJHGqKCIbqtsju",281,0.996454,25,282,1,281,1,1,0,1,1,141,140,141,141,39
"3692",91,"[25]ioIpGoHcotHnJHGqKCIbqtsju",283,0.996479,25,284,1,283,1,1,0,1,1,153,152,131,131,39
"3693",92,"[25]ioIpGoHcotHnJHGqKCIbqtsju",281,0.996454,25,282,1,281,1,1,0,1,1,136,135,146,146,39
"3694",93,"[25]ioIpGoHcotHnJHGqKCIbqtsju",278,0.996416,25,279,1,278,1,1,0,1,1,129,128,150,150,39
"3695",94,"[25]ioIpGoHcotHnJHGqKCIbqtsju",278,0.996416,25,279,1,278,1,1,0,1,1,138,137,141,141,39
"3696",95,"[25]ioIpGoHcotHnJHGqKCIbqtsju",274,0.996364,25,275,1,274,1,1,0,1,1,121,120,154,154,39
"3697",96,"[25]ioIpGoHcotHnJHGqKCIbqtsju",274,0.996364,25,275,1,274,1,1,0,1,1,142,141,133,133,39
"3698",97,"[25]ioIpGoHcotHnJHGqKCIbqtsju",288,0.99654,25,289,1,288,1,1,0,1,1,149,148,140,140,39
"3699",98,"[25]ioIpGoHcotHnJHGqKCIbqtsju",281,0.996454,25,282,1,281,1,1,0,1,1,131,130,151,151,39
"3700",99,"[25]ioIpGoHcotHnJHGqKCIbqtsju",277,0.996403,25,278,1,277,1,1,0,1,1,136,135,142,142,39
"3701",0,"[20]koIoHcouHnJHGqKCrmEr",287,0.996528,20,288,1,287,1,1,0,1,1,167,166,121,121,40
"3702",1,"[20]koIoHcouHnJHGqKCrmEr",289,0.996552,20,290,1,289,1,1,0,1,1,149,148,141,141,40
"3703",2,"[20]koIoHcouHnJHGqKCrmEr",276,0.99639,20,277,1,276,1,1,0,1,1,144,143,133,133,40
"3704",3,"[20]koIoHcouHnJHGqKCrmEr",285,0.996503,20,286,1,285,1,1,0,1,1,142,141,144,144,40
"3705",4,"[20]koIoHcouHnJHGqKCrmEr",284,0.996491,20,285,1,284,1,1,0,1,1,150,149,135,135,40
"3706",5,"[20]koIoHcouHnJHGqKCrmEr",289,0.996552,20,290,1,289,1,1,0,1,1,143,142,147,147,40
"3707",6,"[20]koIoHcouHnJHGqKCrmEr",277,0.996403,20,278,1,277,1,1,0,1,1,144,143,134,134,40
"3708",7,"[20]koIoHcouHnJHGqKCrmEr",278,0.996416,20,279,1,278,1,1,0,1,1,159,158,120,120,40
"3709",8,"[20]koIoHcouHnJHGqKCrmEr",277,0.996403,20,278,1,277,1,1,0,1,1,126,125,152,152,40
"3710",9,"[20]koIoHcouHnJHGqKCrmEr",280,0.996441,20,281,1,280,1,1,0,1,1,133,132,148,148,40
"3711",10,"[20]koIoHcouHnJHGqKCrmEr",283,0.996479,20,284,1,283,1,1,0,1,1,152,151,132,132,40
"3712",11,"[20]koIoHcouHnJHGqKCrmEr",284,0.996491,20,285,1,284,1,1,0,1,1,138,137,147,147,40
"3713",12,"[20]koIoHcouHnJHGqKCrmEr",282,0.996466,20,283,1,282,1,1,0,1,1,136,135,147,147,40
"3714",13,"[20]koIoHcouHnJHGqKCrmEr",273,0.99635,20,274,1,273,1,1,0,1,1,117,116,157,157,40
"3715",14,"[20]koIoHcouHnJHGqKCrmEr",283,0.996479,20,284,1,283,1,1,0,1,1,134,133,150,150,40
"3716",15,"[20]koIoHcouHnJHGqKCrmEr",275,0.996377,20,276,1,275,1,1,0,1,1,129,128,147,147,40
"3717",16,"[20]koIoHcouHnJHGqKCrmEr",272,0.996337,20,273,1,272,1,1,0,1,1,145,144,128,128,40
"3718",17,"[20]koIoHcouHnJHGqKCrmEr",277,0.996403,20,278,1,277,1,1,0,1,1,135,134,143,143,40
"3719",18,"[20]koIoHcouHnJHGqKCrmEr",279,0.996429,20,280,1,279,1,1,0,1,1,137,136,143,143,40
"3720",19,"[20]koIoHcouHnJHGqKCrmEr",279,0.996429,20,280,1,279,1,1,0,1,1,146,145,134,134,40
"3721",20,"[20]koIoHcouHnJHGqKCrmEr",283,0.996479,20,284,1,283,1,1,0,1,1,147,146,137,137,40
"3722",21,"[20]koIoHcouHnJHGqKCrmEr",280,0.996441,20,281,1,280,1,1,0,1,1,134,133,147,147,40
"3723",22,"[20]koIoHcouHnJHGqKCrmEr",279,0.996429,20,280,1,279,1,1,0,1,1,144,143,136,136,40
"3724",23,"[20]koIoHcouHnJHGqKCrmEr",277,0.996403,20,278,1,277,1,1,0,1,1,143,142,135,135,40
"3725",24,"[20]koIoHcouHnJHGqKCrmEr",280,0.996441,20,281,1,280,1,1,0,1,1,129,128,152,152,40
"3726",25,"[20]koIoHcouHnJHGqKCrmEr",281,0.996454,20,282,1,281,1,1,0,1,1,133,132,149,149,40
"3727",26,"[20]koIoHcouHnJHGqKCrmEr",283,0.996479,20,284,1,283,1,1,0,1,1,137,136,147,147,40
"3728",27,"[20]koIoHcouHnJHGqKCrmEr",279,0.996429,20,280,1,279,1,1,0,1,1,145,144,135,135,40
"3729",28,"[20]koIoHcouHnJHGqKCrmEr",287,0.996528,20,288,1,287,1,1,0,1,1,146,145,142,142,40
"3730",29,"[20]koIoHcouHnJHGqKCrmEr",290,0.996564,20,291,1,290,1,1,0,1,1,135,134,156,156,40
"3731",30,"[20]koIoHcouHnJHGqKCrmEr",276,0.99639,20,277,1,276,1,1,0,1,1,141,140,136,136,40
"3732",31,"[20]koIoHcouHnJHGqKCrmEr",286,0.996516,20,287,1,286,1,1,0,1,1,146,145,141,141,40
"3733",32,"[20]koIoHcouHnJHGqKCrmEr",281,0.996454,20,282,1,281,1,1,0,1,1,133,132,149,149,40
"3734",33,"[20]koIoHcouHnJHGqKCrmEr",285,0.996503,20,286,1,285,1,1,0,1,1,144,143,142,142,40
"3735",34,"[20]koIoHcouHnJHGqKCrmEr",284,0.996491,20,285,1,284,1,1,0,1,1,148,147,137,137,40
"3736",35,"[20]koIoHcouHnJHGqKCrmEr",289,0.996552,20,290,1,289,1,1,0,1,1,135,134,155,155,40
"3737",36,"[20]koIoHcouHnJHGqKCrmEr",281,0.996454,20,282,1,281,1,1,0,1,1,140,139,142,142,40
"3738",37,"[20]koIoHcouHnJHGqKCrmEr",285,0.996503,20,286,1,285,1,1,0,1,1,143,142,143,143,40
"3739",38,"[20]koIoHcouHnJHGqKCrmEr",278,0.996416,20,279,1,278,1,1,0,1,1,128,127,151,151,40
"3740",39,"[20]koIoHcouHnJHGqKCrmEr",279,0.996429,20,280,1,279,1,1,0,1,1,129,128,151,151,40
"3741",40,"[20]koIoHcouHnJHGqKCrmEr",283,0.996479,20,284,1,283,1,1,0,1,1,131,130,153,153,40
"3742",41,"[20]koIoHcouHnJHGqKCrmEr",282,0.996466,20,283,1,282,1,1,0,1,1,145,144,138,138,40
"3743",42,"[20]koIoHcouHnJHGqKCrmEr",284,0.996491,20,285,1,284,1,1,0,1,1,143,142,142,142,40
"3744",43,"[20]koIoHcouHnJHGqKCrmEr",283,0.996479,20,284,1,283,1,1,0,1,1,137,136,147,147,40
"3745",44,"[20]koIoHcouHnJHGqKCrmEr",276,0.99639,20,277,1,276,1,1,0,1,1,130,129,147,147,40
"3746",45,"[20]koIoHcouHnJHGqKCrmEr",286,0.996516,20,287,1,286,1,1,0,1,1,154,153,133,133,40
"3747",46,"[20]koIoHcouHnJHGqKCrmEr",280,0.996441,20,281,1,280,1,1,0,1,1,141,140,140,140,40
"3748",47,"[20]koIoHcouHnJHGqKCrmEr",274,0.996364,20,275,1,274,1,1,0,1,1,131,130,144,144,40
"3749",48,"[20]koIoHcouHnJHGqKCrmEr",275,0.996377,20,276,1,275,1,1,0,1,1,128,127,148,148,40
"3750",49,"[20]koIoHcouHnJHGqKCrmEr",287,0.996528,20,288,1,287,1,1,0,1,1,152,151,136,136,40
"3751",50,"[20]koIoHcouHnJHGqKCrmEr",280,0.996441,20,281,1,280,1,1,0,1,1,122,121,159,159,40
"3752",51,"[20]koIoHcouHnJHGqKCrmEr",284,0.996491,20,285,1,284,1,1,0,1,1,142,141,143,143,40
"3753",52,"[20]koIoHcouHnJHGqKCrmEr",279,0.996429,20,280,1,279,1,1,0,1,1,135,134,145,145,40
"3754",53,"[20]koIoHcouHnJHGqKCrmEr",290,0.996564,20,291,1,290,1,1,0,1,1,152,151,139,139,40
"3755",54,"[20]koIoHcouHnJHGqKCrmEr",280,0.996441,20,281,1,280,1,1,0,1,1,144,143,137,137,40
"3756",55,"[20]koIoHcouHnJHGqKCrmEr",287,0.996528,20,288,1,287,1,1,0,1,1,171,170,117,117,40
"3757",56,"[20]koIoHcouHnJHGqKCrmEr",286,0.996516,20,287,1,286,1,1,0,1,1,151,150,136,136,40
"3758",57,"[20]koIoHcouHnJHGqKCrmEr",285,0.996503,20,286,1,285,1,1,0,1,1,137,136,149,149,40
"3759",58,"[20]koIoHcouHnJHGqKCrmEr",277,0.996403,20,278,1,277,1,1,0,1,1,143,142,135,135,40
"3760",59,"[20]koIoHcouHnJHGqKCrmEr",280,0.996441,20,281,1,280,1,1,0,1,1,137,136,144,144,40
"3761",60,"[20]koIoHcouHnJHGqKCrmEr",281,0.996454,20,282,1,281,1,1,0,1,1,154,153,128,128,40
"3762",61,"[20]koIoHcouHnJHGqKCrmEr",284,0.996491,20,285,1,284,1,1,0,1,1,139,138,146,146,40
"3763",62,"[20]koIoHcouHnJHGqKCrmEr",274,0.996364,20,275,1,274,1,1,0,1,1,147,146,128,128,40
"3764",63,"[20]koIoHcouHnJHGqKCrmEr",282,0.996466,20,283,1,282,1,1,0,1,1,136,135,147,147,40
"3765",64,"[20]koIoHcouHnJHGqKCrmEr",282,0.996466,20,283,1,282,1,1,0,1,1,157,156,126,126,40
"3766",65,"[20]koIoHcouHnJHGqKCrmEr",276,0.99639,20,277,1,276,1,1,0,1,1,128,127,149,149,40
"3767",66,"[20]koIoHcouHnJHGqKCrmEr",286,0.996516,20,287,1,286,1,1,0,1,1,156,155,131,131,40
"3768",67,"[20]koIoHcouHnJHGqKCrmEr",276,0.99639,20,277,1,276,1,1,0,1,1,136,135,141,141,40
"3769",68,"[20]koIoHcouHnJHGqKCrmEr",278,0.996416,20,279,1,278,1,1,0,1,1,151,150,128,128,40
"3770",69,"[20]koIoHcouHnJHGqKCrmEr",281,0.996454,20,282,1,281,1,1,0,1,1,124,123,158,158,40
"3771",70,"[20]koIoHcouHnJHGqKCrmEr",286,0.996516,20,287,1,286,1,1,0,1,1,148,147,139,139,40
"3772",71,"[20]koIoHcouHnJHGqKCrmEr",282,0.996466,20,283,1,282,1,1,0,1,1,144,143,139,139,40
"3773",72,"[20]koIoHcouHnJHGqKCrmEr",284,0.996491,20,285,1,284,1,1,0,1,1,143,142,142,142,40
"3774",73,"[20]koIoHcouHnJHGqKCrmEr",284,0.996491,20,285,1,284,1,1,0,1,1,146,145,139,139,40
"3775",74,"[20]koIoHcouHnJHGqKCrmEr",285,0.996503,20,286,1,285,1,1,0,1,1,156,155,130,130,40
"3776",75,"[20]koIoHcouHnJHGqKCrmEr",276,0.99639,20,277,1,276,1,1,0,1,1,133,132,144,144,40
"3777",76,"[20]koIoHcouHnJHGqKCrmEr",279,0.996429,20,280,1,279,1,1,0,1,1,150,149,130,130,40
"3778",77,"[20]koIoHcouHnJHGqKCrmEr",277,0.996403,20,278,1,277,1,1,0,1,1,138,137,140,140,40
"3779",78,"[20]koIoHcouHnJHGqKCrmEr",280,0.996441,20,281,1,280,1,1,0,1,1,130,129,151,151,40
"3780",79,"[20]koIoHcouHnJHGqKCrmEr",289,0.996552,20,290,1,289,1,1,0,1,1,148,147,142,142,40
"3781",80,"[20]koIoHcouHnJHGqKCrmEr",283,0.996479,20,284,1,283,1,1,0,1,1,147,146,137,137,40
"3782",81,"[20]koIoHcouHnJHGqKCrmEr",287,0.996528,20,288,1,287,1,1,0,1,1,156,155,132,132,40
"3783",82,"[20]koIoHcouHnJHGqKCrmEr",278,0.996416,20,279,1,278,1,1,0,1,1,141,140,138,138,40
"3784",83,"[20]koIoHcouHnJHGqKCrmEr",282,0.996466,20,283,1,282,1,1,0,1,1,146,145,137,137,40
"3785",84,"[20]koIoHcouHnJHGqKCrmEr",282,0.996466,20,283,1,282,1,1,0,1,1,149,148,134,134,40
"3786",85,"[20]koIoHcouHnJHGqKCrmEr",275,0.996377,20,276,1,275,1,1,0,1,1,134,133,142,142,40
"3787",86,"[20]koIoHcouHnJHGqKCrmEr",278,0.996416,20,279,1,278,1,1,0,1,1,126,125,153,153,40
"3788",87,"[20]koIoHcouHnJHGqKCrmEr",282,0.996466,20,283,1,282,1,1,0,1,1,136,135,147,147,40
"3789",88,"[20]koIoHcouHnJHGqKCrmEr",276,0.99639,20,277,1,276,1,1,0,1,1,132,131,145,145,40
"3790",89,"[20]koIoHcouHnJHGqKCrmEr",281,0.996454,20,282,1,281,1,1,0,1,1,132,131,150,150,40
"3791",90,"[20]koIoHcouHnJHGqKCrmEr",278,0.996416,20,279,1,278,1,1,0,1,1,141,140,138,138,40
"3792",91,"[20]koIoHcouHnJHGqKCrmEr",288,0.99654,20,289,1,288,1,1,0,1,1,156,155,133,133,40
"3793",92,"[20]koIoHcouHnJHGqKCrmEr",282,0.996466,20,283,1,282,1,1,0,1,1,140,139,143,143,40
"3794",93,"[20]koIoHcouHnJHGqKCrmEr",285,0.996503,20,286,1,285,1,1,0,1,1,145,144,141,141,40
"3795",94,"[20]koIoHcouHnJHGqKCrmEr",284,0.996491,20,285,1,284,1,1,0,1,1,140,139,145,145,40
"3796",95,"[20]koIoHcouHnJHGqKCrmEr",276,0.99639,20,277,1,276,1,1,0,1,1,131,130,146,146,40
"3797",96,"[20]koIoHcouHnJHGqKCrmEr",279,0.996429,20,280,1,279,1,1,0,1,1,137,136,143,143,40
"3798",97,"[20]koIoHcouHnJHGqKCrmEr",280,0.996441,20,281,1,280,1,1,0,1,1,136,135,145,145,40
"3799",98,"[20]koIoHcouHnJHGqKCrmEr",283,0.996479,20,284,1,283,1,1,0,1,1,151,150,133,133,40
"3800",99,"[20]koIoHcouHnJHGqKCrmEr",281,0.996454,20,282,1,281,1,1,0,1,1,139,138,143,143,40
"3801",0,"[23]FwHoInFoHcotHnJHGqKCHvt",278,0.996416,23,279,1,278,1,1,0,1,1,145,144,134,134,41
"3802",1,"[23]FwHoInFoHcotHnJHGqKCHvt",282,0.996466,23,283,1,282,1,1,0,1,1,155,154,128,128,41
"3803",2,"[23]FwHoInFoHcotHnJHGqKCHvt",283,0.996479,23,284,1,283,1,1,0,1,1,141,140,143,143,41
"3804",3,"[23]FwHoInFoHcotHnJHGqKCHvt",285,0.996503,23,286,1,285,1,1,0,1,1,152,151,134,134,41
"3805",4,"[23]FwHoInFoHcotHnJHGqKCHvt",281,0.996454,23,282,1,281,1,1,0,1,1,134,133,148,148,41
"3806",5,"[23]FwHoInFoHcotHnJHGqKCHvt",282,0.996466,23,283,1,282,1,1,0,1,1,150,149,133,133,41
"3807",6,"[23]FwHoInFoHcotHnJHGqKCHvt",285,0.996503,23,286,1,285,1,1,0,1,1,143,142,143,143,41
"3808",7,"[23]FwHoInFoHcotHnJHGqKCHvt",280,0.996441,23,281,1,280,1,1,0,1,1,133,132,148,148,41
"3809",8,"[23]FwHoInFoHcotHnJHGqKCHvt",286,0.996516,23,287,1,286,1,1,0,1,1,145,144,142,142,41
"3810",9,"[23]FwHoInFoHcotHnJHGqKCHvt",277,0.996403,23,278,1,277,1,1,0,1,1,138,137,140,140,41
"3811",10,"[23]FwHoInFoHcotHnJHGqKCHvt",288,0.99654,23,289,1,288,1,1,0,1,1,155,154,134,134,41
"3812",11,"[23]FwHoInFoHcotHnJHGqKCHvt",276,0.99639,23,277,1,276,1,1,0,1,1,135,134,142,142,41
"3813",12,"[23]FwHoInFoHcotHnJHGqKCHvt",280,0.996441,23,281,1,280,1,1,0,1,1,139,138,142,142,41
"3814",13,"[23]FwHoInFoHcotHnJHGqKCHvt",268,0.996283,23,269,1,268,1,1,0,1,1,108,107,161,161,41
"3815",14,"[23]FwHoInFoHcotHnJHGqKCHvt",285,0.996503,23,286,1,285,1,1,0,1,1,147,146,139,139,41
"3816",15,"[23]FwHoInFoHcotHnJHGqKCHvt",286,0.996516,23,287,1,286,1,1,0,1,1,150,149,137,137,41
"3817",16,"[23]FwHoInFoHcotHnJHGqKCHvt",279,0.996429,23,280,1,279,1,1,0,1,1,130,129,150,150,41
"3818",17,"[23]FwHoInFoHcotHnJHGqKCHvt",284,0.996491,23,285,1,284,1,1,0,1,1,134,133,151,151,41
"3819",18,"[23]FwHoInFoHcotHnJHGqKCHvt",278,0.996416,23,279,1,278,1,1,0,1,1,151,150,128,128,41
"3820",19,"[23]FwHoInFoHcotHnJHGqKCHvt",280,0.996441,23,281,1,280,1,1,0,1,1,143,142,138,138,41
"3821",20,"[23]FwHoInFoHcotHnJHGqKCHvt",282,0.996466,23,283,1,282,1,1,0,1,1,151,150,132,132,41
"3822",21,"[23]FwHoInFoHcotHnJHGqKCHvt",273,0.99635,23,274,1,273,1,1,0,1,1,132,131,142,142,41
"3823",22,"[23]FwHoInFoHcotHnJHGqKCHvt",278,0.996416,23,279,1,278,1,1,0,1,1,134,133,145,145,41
"3824",23,"[23]FwHoInFoHcotHnJHGqKCHvt",283,0.996479,23,284,1,283,1,1,0,1,1,145,144,139,139,41
"3825",24,"[23]FwHoInFoHcotHnJHGqKCHvt",275,0.996377,23,276,1,275,1,1,0,1,1,137,136,139,139,41
"3826",25,"[23]FwHoInFoHcotHnJHGqKCHvt",283,0.996479,23,284,1,283,1,1,0,1,1,148,147,136,136,41
"3827",26,"[23]FwHoInFoHcotHnJHGqKCHvt",289,0.996552,23,290,1,289,1,1,0,1,1,149,148,141,141,41
"3828",27,"[23]FwHoInFoHcotHnJHGqKCHvt",276,0.99639,23,277,1,276,1,1,0,1,1,136,135,141,141,41
"3829",28,"[23]FwHoInFoHcotHnJHGqKCHvt",272,0.996337,23,273,1,272,1,1,0,1,1,144,143,129,129,41
"3830",29,"[23]FwHoInFoHcotHnJHGqKCHvt",284,0.996491,23,285,1,284,1,1,0,1,1,151,150,134,134,41
"3831",30,"[23]FwHoInFoHcotHnJHGqKCHvt",285,0.996503,23,286,1,285,1,1,0,1,1,147,146,139,139,41
"3832",31,"[23]FwHoInFoHcotHnJHGqKCHvt",283,0.996479,23,284,1,283,1,1,0,1,1,135,134,149,149,41
"3833",32,"[23]FwHoInFoHcotHnJHGqKCHvt",285,0.996503,23,286,1,285,1,1,0,1,1,150,149,136,136,41
"3834",33,"[23]FwHoInFoHcotHnJHGqKCHvt",282,0.996466,23,283,1,282,1,1,0,1,1,141,140,142,142,41
"3835",34,"[23]FwHoInFoHcotHnJHGqKCHvt",284,0.996491,23,285,1,284,1,1,0,1,1,156,155,129,129,41
"3836",35,"[23]FwHoInFoHcotHnJHGqKCHvt",277,0.996403,23,278,1,277,1,1,0,1,1,148,147,130,130,41
"3837",36,"[23]FwHoInFoHcotHnJHGqKCHvt",276,0.99639,23,277,1,276,1,1,0,1,1,118,117,159,159,41
"3838",37,"[23]FwHoInFoHcotHnJHGqKCHvt",275,0.996377,23,276,1,275,1,1,0,1,1,130,129,146,146,41
"3839",38,"[23]FwHoInFoHcotHnJHGqKCHvt",282,0.996466,23,283,1,282,1,1,0,1,1,147,146,136,136,41
"3840",39,"[23]FwHoInFoHcotHnJHGqKCHvt",280,0.996441,23,281,1,280,1,1,0,1,1,129,128,152,152,41
"3841",40,"[23]FwHoInFoHcotHnJHGqKCHvt",296,0.996633,23,297,1,296,1,1,0,1,1,162,161,135,135,41
"3842",41,"[23]FwHoInFoHcotHnJHGqKCHvt",289,0.996552,23,290,1,289,1,1,0,1,1,148,147,142,142,41
"3843",42,"[23]FwHoInFoHcotHnJHGqKCHvt",280,0.996441,23,281,1,280,1,1,0,1,1,147,146,134,134,41
"3844",43,"[23]FwHoInFoHcotHnJHGqKCHvt",280,0.996441,23,281,1,280,1,1,0,1,1,137,136,144,144,41
"3845",44,"[23]FwHoInFoHcotHnJHGqKCHvt",275,0.996377,23,276,1,275,1,1,0,1,1,137,136,139,139,41
"3846",45,"[23]FwHoInFoHcotHnJHGqKCHvt",276,0.99639,23,277,1,276,1,1,0,1,1,137,136,140,140,41
"3847",46,"[23]FwHoInFoHcotHnJHGqKCHvt",277,0.996403,23,278,1,277,1,1,0,1,1,138,137,140,140,41
"3848",47,"[23]FwHoInFoHcotHnJHGqKCHvt",284,0.996491,23,285,1,284,1,1,0,1,1,133,132,152,152,41
"3849",48,"[23]FwHoInFoHcotHnJHGqKCHvt",282,0.996466,23,283,1,282,1,1,0,1,1,140,139,143,143,41
"3850",49,"[23]FwHoInFoHcotHnJHGqKCHvt",270,0.99631,23,271,1,270,1,1,0,1,1,119,118,152,152,41
"3851",50,"[23]FwHoInFoHcotHnJHGqKCHvt",281,0.996454,23,282,1,281,1,1,0,1,1,133,132,149,149,41
"3852",51,"[23]FwHoInFoHcotHnJHGqKCHvt",282,0.996466,23,283,1,282,1,1,0,1,1,153,152,130,130,41
"3853",52,"[23]FwHoInFoHcotHnJHGqKCHvt",269,0.996296,23,270,1,269,1,1,0,1,1,118,117,152,152,41
"3854",53,"[23]FwHoInFoHcotHnJHGqKCHvt",274,0.996364,23,275,1,274,1,1,0,1,1,122,121,153,153,41
"3855",54,"[23]FwHoInFoHcotHnJHGqKCHvt",281,0.996454,23,282,1,281,1,1,0,1,1,142,141,140,140,41
"3856",55,"[23]FwHoInFoHcotHnJHGqKCHvt",284,0.996491,23,285,1,284,1,1,0,1,1,141,140,144,144,41
"3857",56,"[23]FwHoInFoHcotHnJHGqKCHvt",287,0.996528,23,288,1,287,1,1,0,1,1,146,145,142,142,41
"3858",57,"[23]FwHoInFoHcotHnJHGqKCHvt",277,0.996403,23,278,1,277,1,1,0,1,1,136,135,142,142,41
"3859",58,"[23]FwHoInFoHcotHnJHGqKCHvt",285,0.996503,23,286,1,285,1,1,0,1,1,144,143,142,142,41
"3860",59,"[23]FwHoInFoHcotHnJHGqKCHvt",284,0.996491,23,285,1,284,1,1,0,1,1,146,145,139,139,41
"3861",60,"[23]FwHoInFoHcotHnJHGqKCHvt",275,0.996377,23,276,1,275,1,1,0,1,1,143,142,133,133,41
"3862",61,"[23]FwHoInFoHcotHnJHGqKCHvt",284,0.996491,23,285,1,284,1,1,0,1,1,138,137,147,147,41
"3863",62,"[23]FwHoInFoHcotHnJHGqKCHvt",282,0.996466,23,283,1,282,1,1,0,1,1,147,146,136,136,41
"3864",63,"[23]FwHoInFoHcotHnJHGqKCHvt",285,0.996503,23,286,1,285,1,1,0,1,1,147,146,139,139,41
"3865",64,"[23]FwHoInFoHcotHnJHGqKCHvt",279,0.996429,23,280,1,279,1,1,0,1,1,145,144,135,135,41
"3866",65,"[23]FwHoInFoHcotHnJHGqKCHvt",287,0.996528,23,288,1,287,1,1,0,1,1,133,132,155,155,41
"3867",66,"[23]FwHoInFoHcotHnJHGqKCHvt",278,0.996416,23,279,1,278,1,1,0,1,1,147,146,132,132,41
"3868",67,"[23]FwHoInFoHcotHnJHGqKCHvt",286,0.996516,23,287,1,286,1,1,0,1,1,149,148,138,138,41
"3869",68,"[23]FwHoInFoHcotHnJHGqKCHvt",277,0.996403,23,278,1,277,1,1,0,1,1,139,138,139,139,41
"3870",69,"[23]FwHoInFoHcotHnJHGqKCHvt",284,0.996491,23,285,1,284,1,1,0,1,1,153,152,132,132,41
"3871",70,"[23]FwHoInFoHcotHnJHGqKCHvt",285,0.996503,23,286,1,285,1,1,0,1,1,136,135,150,150,41
"3872",71,"[23]FwHoInFoHcotHnJHGqKCHvt",284,0.996491,23,285,1,284,1,1,0,1,1,152,151,133,133,41
"3873",72,"[23]FwHoInFoHcotHnJHGqKCHvt",287,0.996528,23,288,1,287,1,1,0,1,1,135,134,153,153,41
"3874",73,"[23]FwHoInFoHcotHnJHGqKCHvt",283,0.996479,23,284,1,283,1,1,0,1,1,135,134,149,149,41
"3875",74,"[23]FwHoInFoHcotHnJHGqKCHvt",279,0.996429,23,280,1,279,1,1,0,1,1,125,124,155,155,41
"3876",75,"[23]FwHoInFoHcotHnJHGqKCHvt",280,0.996441,23,281,1,280,1,1,0,1,1,130,129,151,151,41
"3877",76,"[23]FwHoInFoHcotHnJHGqKCHvt",279,0.996429,23,280,1,279,1,1,0,1,1,123,122,157,157,41
"3878",77,"[23]FwHoInFoHcotHnJHGqKCHvt",276,0.99639,23,277,1,276,1,1,0,1,1,146,145,131,131,41
"3879",78,"[23]FwHoInFoHcotHnJHGqKCHvt",278,0.996416,23,279,1,278,1,1,0,1,1,141,140,138,138,41
"3880",79,"[23]FwHoInFoHcotHnJHGqKCHvt",277,0.996403,23,278,1,277,1,1,0,1,1,146,145,132,132,41
"3881",80,"[23]FwHoInFoHcotHnJHGqKCHvt",281,0.996454,23,282,1,281,1,1,0,1,1,157,156,125,125,41
"3882",81,"[23]FwHoInFoHcotHnJHGqKCHvt",282,0.996466,23,283,1,282,1,1,0,1,1,139,138,144,144,41
"3883",82,"[23]FwHoInFoHcotHnJHGqKCHvt",279,0.996429,23,280,1,279,1,1,0,1,1,139,138,141,141,41
"3884",83,"[23]FwHoInFoHcotHnJHGqKCHvt",269,0.996296,23,270,1,269,1,1,0,1,1,130,129,140,140,41
"3885",84,"[23]FwHoInFoHcotHnJHGqKCHvt",279,0.996429,23,280,1,279,1,1,0,1,1,143,142,137,137,41
"3886",85,"[23]FwHoInFoHcotHnJHGqKCHvt",284,0.996491,23,285,1,284,1,1,0,1,1,139,138,146,146,41
"3887",86,"[23]FwHoInFoHcotHnJHGqKCHvt",273,0.99635,23,274,1,273,1,1,0,1,1,141,140,133,133,41
"3888",87,"[23]FwHoInFoHcotHnJHGqKCHvt",281,0.996454,23,282,1,281,1,1,0,1,1,137,136,145,145,41
"3889",88,"[23]FwHoInFoHcotHnJHGqKCHvt",275,0.996377,23,276,1,275,1,1,0,1,1,146,145,130,130,41
"3890",89,"[23]FwHoInFoHcotHnJHGqKCHvt",274,0.996364,23,275,1,274,1,1,0,1,1,143,142,132,132,41
"3891",90,"[23]FwHoInFoHcotHnJHGqKCHvt",287,0.996528,23,288,1,287,1,1,0,1,1,139,138,149,149,41
"3892",91,"[23]FwHoInFoHcotHnJHGqKCHvt",278,0.996416,23,279,1,278,1,1,0,1,1,139,138,140,140,41
"3893",92,"[23]FwHoInFoHcotHnJHGqKCHvt",282,0.996466,23,283,1,282,1,1,0,1,1,149,148,134,134,41
"3894",93,"[23]FwHoInFoHcotHnJHGqKCHvt",284,0.996491,23,285,1,284,1,1,0,1,1,139,138,146,146,41
"3895",94,"[23]FwHoInFoHcotHnJHGqKCHvt",278,0.996416,23,279,1,278,1,1,0,1,1,129,128,150,150,41
"3896",95,"[23]FwHoInFoHcotHnJHGqKCHvt",273,0.99635,23,274,1,273,1,1,0,1,1,131,130,143,143,41
"3897",96,"[23]FwHoInFoHcotHnJHGqKCHvt",289,0.996552,23,290,1,289,1,1,0,1,1,148,147,142,142,41
"3898",97,"[23]FwHoInFoHcotHnJHGqKCHvt",268,0.996283,23,269,1,268,1,1,0,1,1,131,130,138,138,41
"3899",98,"[23]FwHoInFoHcotHnJHGqKCHvt",278,0.996416,23,279,1,278,1,1,0,1,1,145,144,134,134,41
"3900",99,"[23]FwHoInFoHcotHnJHGqKCHvt",281,0.996454,23,282,1,281,1,1,0,1,1,160,159,122,122,41
"3901",0,"[22]bsHoIoHcowHnJqGKCECDyd",298,0.996656,22,299,1,298,1,1,0,1,1,154,153,145,145,42
"3902",1,"[22]bsHoIoHcowHnJqGKCECDyd",303,0.996711,22,304,1,303,1,1,0,1,1,161,160,143,143,42
"3903",2,"[22]bsHoIoHcowHnJqGKCECDyd",300,0.996678,22,301,1,300,1,1,0,1,1,162,161,139,139,42
"3904",3,"[22]bsHoIoHcowHnJqGKCECDyd",298,0.996656,22,299,1,298,1,1,0,1,1,159,158,140,140,42
"3905",4,"[22]bsHoIoHcowHnJqGKCECDyd",299,0.996667,22,300,1,299,1,1,0,1,1,156,155,144,144,42
"3906",5,"[22]bsHoIoHcowHnJqGKCECDyd",292,0.996587,22,293,1,292,1,1,0,1,1,136,135,157,157,42
"3907",6,"[22]bsHoIoHcowHnJqGKCECDyd",293,0.996599,22,294,1,293,1,1,0,1,1,139,138,155,155,42
"3908",7,"[22]bsHoIoHcowHnJqGKCECDyd",291,0.996575,22,292,1,291,1,1,0,1,1,133,132,159,159,42
"3909",8,"[22]bsHoIoHcowHnJqGKCECDyd",298,0.996656,22,299,1,298,1,1,0,1,1,155,154,144,144,42
"3910",9,"[22]bsHoIoHcowHnJqGKCECDyd",305,0.996732,22,306,1,305,1,1,0,1,1,173,172,133,133,42
"3911",10,"[22]bsHoIoHcowHnJqGKCECDyd",302,0.9967,22,303,1,302,1,1,0,1,1,175,174,128,128,42
"3912",11,"[22]bsHoIoHcowHnJqGKCECDyd",292,0.996587,22,293,1,292,1,1,0,1,1,141,140,152,152,42
"3913",12,"[22]bsHoIoHcowHnJqGKCECDyd",297,0.996644,22,298,1,297,1,1,0,1,1,153,152,145,145,42
"3914",13,"[22]bsHoIoHcowHnJqGKCECDyd",295,0.996622,22,296,1,295,1,1,0,1,1,147,146,149,149,42
"3915",14,"[22]bsHoIoHcowHnJqGKCECDyd",302,0.9967,22,303,1,302,1,1,0,1,1,166,165,137,137,42
"3916",15,"[22]bsHoIoHcowHnJqGKCECDyd",296,0.996633,22,297,1,296,1,1,0,1,1,148,147,149,149,42
"3917",16,"[22]bsHoIoHcowHnJqGKCECDyd",292,0.996587,22,293,1,292,1,1,0,1,1,143,142,150,150,42
"3918",17,"[22]bsHoIoHcowHnJqGKCECDyd",298,0.996656,22,299,1,298,1,1,0,1,1,154,153,145,145,42
"3919",18,"[22]bsHoIoHcowHnJqGKCECDyd",296,0.996633,22,297,1,296,1,1,0,1,1,145,144,152,152,42
"3920",19,"[22]bsHoIoHcowHnJqGKCECDyd",299,0.996667,22,300,1,299,1,1,0,1,1,155,154,145,145,42
"3921",20,"[22]bsHoIoHcowHnJqGKCECDyd",296,0.996633,22,297,1,296,1,1,0,1,1,149,148,148,148,42
"3922",21,"[22]bsHoIoHcowHnJqGKCECDyd",296,0.996633,22,297,1,296,1,1,0,1,1,150,149,147,147,42
"3923",22,"[22]bsHoIoHcowHnJqGKCECDyd",296,0.996633,22,297,1,296,1,1,0,1,1,154,153,143,143,42
"3924",23,"[22]bsHoIoHcowHnJqGKCECDyd",295,0.996622,22,296,1,295,1,1,0,1,1,146,145,150,150,42
"3925",24,"[22]bsHoIoHcowHnJqGKCECDyd",295,0.996622,22,296,1,295,1,1,0,1,1,163,162,133,133,42
"3926",25,"[22]bsHoIoHcowHnJqGKCECDyd",293,0.996599,22,294,1,293,1,1,0,1,1,149,148,145,145,42
"3927",26,"[22]bsHoIoHcowHnJqGKCECDyd",297,0.996644,22,298,1,297,1,1,0,1,1,153,152,145,145,42
"3928",27,"[22]bsHoIoHcowHnJqGKCECDyd",300,0.996678,22,301,1,300,1,1,0,1,1,162,161,139,139,42
"3929",28,"[22]bsHoIoHcowHnJqGKCECDyd",295,0.996622,22,296,1,295,1,1,0,1,1,147,146,149,149,42
"3930",29,"[22]bsHoIoHcowHnJqGKCECDyd",293,0.996599,22,294,1,293,1,1,0,1,1,142,141,152,152,42
"3931",30,"[22]bsHoIoHcowHnJqGKCECDyd",300,0.996678,22,301,1,300,1,1,0,1,1,162,161,139,139,42
"3932",31,"[22]bsHoIoHcowHnJqGKCECDyd",303,0.996711,22,304,1,303,1,1,0,1,1,161,160,143,143,42
"3933",32,"[22]bsHoIoHcowHnJqGKCECDyd",298,0.996656,22,299,1,298,1,1,0,1,1,155,154,144,144,42
"3934",33,"[22]bsHoIoHcowHnJqGKCECDyd",296,0.996633,22,297,1,296,1,1,0,1,1,149,148,148,148,42
"3935",34,"[22]bsHoIoHcowHnJqGKCECDyd",288,0.99654,22,289,1,288,1,1,0,1,1,128,127,161,161,42
"3936",35,"[22]bsHoIoHcowHnJqGKCECDyd",294,0.99661,22,295,1,294,1,1,0,1,1,147,146,148,148,42
"3937",36,"[22]bsHoIoHcowHnJqGKCECDyd",296,0.996633,22,297,1,296,1,1,0,1,1,153,152,144,144,42
"3938",37,"[22]bsHoIoHcowHnJqGKCECDyd",298,0.996656,22,299,1,298,1,1,0,1,1,155,154,144,144,42
"3939",38,"[22]bsHoIoHcowHnJqGKCECDyd",296,0.996633,22,297,1,296,1,1,0,1,1,142,141,155,155,42
"3940",39,"[22]bsHoIoHcowHnJqGKCECDyd",293,0.996599,22,294,1,293,1,1,0,1,1,140,139,154,154,42
"3941",40,"[22]bsHoIoHcowHnJqGKCECDyd",292,0.996587,22,293,1,292,1,1,0,1,1,135,134,158,158,42
"3942",41,"[22]bsHoIoHcowHnJqGKCECDyd",294,0.99661,22,295,1,294,1,1,0,1,1,145,144,150,150,42
"3943",42,"[22]bsHoIoHcowHnJqGKCECDyd",300,0.996678,22,301,1,300,1,1,0,1,1,161,160,140,140,42
"3944",43,"[22]bsHoIoHcowHnJqGKCECDyd",295,0.996622,22,296,1,295,1,1,0,1,1,142,141,154,154,42
"3945",44,"[22]bsHoIoHcowHnJqGKCECDyd",301,0.996689,22,302,1,301,1,1,0,1,1,163,162,139,139,42
"3946",45,"[22]bsHoIoHcowHnJqGKCECDyd",298,0.996656,22,299,1,298,1,1,0,1,1,154,153,145,145,42
"3947",46,"[22]bsHoIoHcowHnJqGKCECDyd",298,0.996656,22,299,1,298,1,1,0,1,1,155,154,144,144,42
"3948",47,"[22]bsHoIoHcowHnJqGKCECDyd",300,0.996678,22,301,1,300,1,1,0,1,1,160,159,141,141,42
"3949",48,"[22]bsHoIoHcowHnJqGKCECDyd",299,0.996667,22,300,1,299,1,1,0,1,1,156,155,144,144,42
"3950",49,"[22]bsHoIoHcowHnJqGKCECDyd",297,0.996644,22,298,1,297,1,1,0,1,1,151,150,147,147,42
"3951",50,"[22]bsHoIoHcowHnJqGKCECDyd",298,0.996656,22,299,1,298,1,1,0,1,1,152,151,147,147,42
"3952",51,"[22]bsHoIoHcowHnJqGKCECDyd",298,0.996656,22,299,1,298,1,1,0,1,1,154,153,145,145,42
"3953",52,"[22]bsHoIoHcowHnJqGKCECDyd",295,0.996622,22,296,1,295,1,1,0,1,1,143,142,153,153,42
"3954",53,"[22]bsHoIoHcowHnJqGKCECDyd",291,0.996575,22,292,1,291,1,1,0,1,1,135,134,157,157,42
"3955",54,"[22]bsHoIoHcowHnJqGKCECDyd",292,0.996587,22,293,1,292,1,1,0,1,1,134,133,159,159,42
"3956",55,"[22]bsHoIoHcowHnJqGKCECDyd",294,0.99661,22,295,1,294,1,1,0,1,1,139,138,156,156,42
"3957",56,"[22]bsHoIoHcowHnJqGKCECDyd",295,0.996622,22,296,1,295,1,1,0,1,1,140,139,156,156,42
"3958",57,"[22]bsHoIoHcowHnJqGKCECDyd",294,0.99661,22,295,1,294,1,1,0,1,1,145,144,150,150,42
"3959",58,"[22]bsHoIoHcowHnJqGKCECDyd",302,0.9967,22,303,1,302,1,1,0,1,1,160,159,143,143,42
"3960",59,"[22]bsHoIoHcowHnJqGKCECDyd",294,0.99661,22,295,1,294,1,1,0,1,1,142,141,153,153,42
"3961",60,"[22]bsHoIoHcowHnJqGKCECDyd",297,0.996644,22,298,1,297,1,1,0,1,1,156,155,142,142,42
"3962",61,"[22]bsHoIoHcowHnJqGKCECDyd",296,0.996633,22,297,1,296,1,1,0,1,1,149,148,148,148,42
"3963",62,"[22]bsHoIoHcowHnJqGKCECDyd",296,0.996633,22,297,1,296,1,1,0,1,1,151,150,146,146,42
"3964",63,"[22]bsHoIoHcowHnJqGKCECDyd",289,0.996552,22,290,1,289,1,1,0,1,1,140,139,150,150,42
"3965",64,"[22]bsHoIoHcowHnJqGKCECDyd",302,0.9967,22,303,1,302,1,1,0,1,1,163,162,140,140,42
"3966",65,"[22]bsHoIoHcowHnJqGKCECDyd",301,0.996689,22,302,1,301,1,1,0,1,1,154,153,148,148,42
"3967",66,"[22]bsHoIoHcowHnJqGKCECDyd",295,0.996622,22,296,1,295,1,1,0,1,1,146,145,150,150,42
"3968",67,"[22]bsHoIoHcowHnJqGKCECDyd",293,0.996599,22,294,1,293,1,1,0,1,1,140,139,154,154,42
"3969",68,"[22]bsHoIoHcowHnJqGKCECDyd",289,0.996552,22,290,1,289,1,1,0,1,1,136,135,154,154,42
"3970",69,"[22]bsHoIoHcowHnJqGKCECDyd",292,0.996587,22,293,1,292,1,1,0,1,1,137,136,156,156,42
"3971",70,"[22]bsHoIoHcowHnJqGKCECDyd",293,0.996599,22,294,1,293,1,1,0,1,1,146,145,148,148,42
"3972",71,"[22]bsHoIoHcowHnJqGKCECDyd",305,0.996732,22,306,1,305,1,1,0,1,1,155,154,151,151,42
"3973",72,"[22]bsHoIoHcowHnJqGKCECDyd",302,0.9967,22,303,1,302,1,1,0,1,1,160,159,143,143,42
"3974",73,"[22]bsHoIoHcowHnJqGKCECDyd",294,0.99661,22,295,1,294,1,1,0,1,1,143,142,152,152,42
"3975",74,"[22]bsHoIoHcowHnJqGKCECDyd",293,0.996599,22,294,1,293,1,1,0,1,1,137,136,157,157,42
"3976",75,"[22]bsHoIoHcowHnJqGKCECDyd",296,0.996633,22,297,1,296,1,1,0,1,1,147,146,150,150,42
"3977",76,"[22]bsHoIoHcowHnJqGKCECDyd",299,0.996667,22,300,1,299,1,1,0,1,1,161,160,139,139,42
"3978",77,"[22]bsHoIoHcowHnJqGKCECDyd",294,0.99661,22,295,1,294,1,1,0,1,1,145,144,150,150,42
"3979",78,"[22]bsHoIoHcowHnJqGKCECDyd",293,0.996599,22,294,1,293,1,1,0,1,1,137,136,157,157,42
"3980",79,"[22]bsHoIoHcowHnJqGKCECDyd",302,0.9967,22,303,1,302,1,1,0,1,1,167,166,136,136,42
"3981",80,"[22]bsHoIoHcowHnJqGKCECDyd",296,0.996633,22,297,1,296,1,1,0,1,1,150,149,147,147,42
"3982",81,"[22]bsHoIoHcowHnJqGKCECDyd",304,0.996721,22,305,1,304,1,1,0,1,1,163,162,142,142,42
"3983",82,"[22]bsHoIoHcowHnJqGKCECDyd",298,0.996656,22,299,1,298,1,1,0,1,1,155,154,144,144,42
"3984",83,"[22]bsHoIoHcowHnJqGKCECDyd",293,0.996599,22,294,1,293,1,1,0,1,1,143,142,151,151,42
"3985",84,"[22]bsHoIoHcowHnJqGKCECDyd",302,0.9967,22,303,1,302,1,1,0,1,1,174,173,129,129,42
"3986",85,"[22]bsHoIoHcowHnJqGKCECDyd",292,0.996587,22,293,1,292,1,1,0,1,1,136,135,157,157,42
"3987",86,"[22]bsHoIoHcowHnJqGKCECDyd",290,0.996564,22,291,1,290,1,1,0,1,1,131,130,160,160,42
"3988",87,"[22]bsHoIoHcowHnJqGKCECDyd",297,0.996644,22,298,1,297,1,1,0,1,1,147,146,151,151,42
"3989",88,"[22]bsHoIoHcowHnJqGKCECDyd",295,0.996622,22,296,1,295,1,1,0,1,1,150,149,146,146,42
"3990",89,"[22]bsHoIoHcowHnJqGKCECDyd",295,0.996622,22,296,1,295,1,1,0,1,1,150,149,146,146,42
"3991",90,"[22]bsHoIoHcowHnJqGKCECDyd",296,0.996633,22,297,1,296,1,1,0,1,1,148,147,149,149,42
"3992",91,"[22]bsHoIoHcowHnJqGKCECDyd",292,0.996587,22,293,1,292,1,1,0,1,1,137,136,156,156,42
"3993",92,"[22]bsHoIoHcowHnJqGKCECDyd",293,0.996599,22,294,1,293,1,1,0,1,1,139,138,155,155,42
"3994",93,"[22]bsHoIoHcowHnJqGKCECDyd",301,0.996689,22,302,1,301,1,1,0,1,1,166,165,136,136,42
"3995",94,"[22]bsHoIoHcowHnJqGKCECDyd",295,0.996622,22,296,1,295,1,1,0,1,1,142,141,154,154,42
"3996",95,"[22]bsHoIoHcowHnJqGKCECDyd",295,0.996622,22,296,1,295,1,1,0,1,1,146,145,150,150,42
"3997",96,"[22]bsHoIoHcowHnJqGKCECDyd",302,0.9967,22,303,1,302,1,1,0,1,1,166,165,137,137,42
"3998",97,"[22]bsHoIoHcowHnJqGKCECDyd",294,0.99661,22,295,1,294,1,1,0,1,1,149,148,146,146,42
"3999",98,"[22]bsHoIoHcowHnJqGKCECDyd",294,0.99661,22,295,1,294,1,1,0,1,1,143,142,152,152,42
"4000",99,"[22]bsHoIoHcowHnJqGKCECDyd",299,0.996667,22,300,1,299,1,1,0,1,1,159,158,141,141,42
"4001",0,"[18]hHoIoHcosHnJHGqKCI",282,0.996466,18,283,1,282,1,1,0,1,1,140,139,143,143,43
"4002",1,"[18]hHoIoHcosHnJHGqKCI",283,0.996479,18,284,1,283,1,1,0,1,1,150,149,134,134,43
"4003",2,"[18]hHoIoHcosHnJHGqKCI",272,0.996337,18,273,1,272,1,1,0,1,1,132,131,141,141,43
"4004",3,"[18]hHoIoHcosHnJHGqKCI",281,0.996454,18,282,1,281,1,1,0,1,1,138,137,144,144,43
"4005",4,"[18]hHoIoHcosHnJHGqKCI",283,0.996479,18,284,1,283,1,1,0,1,1,150,149,134,134,43
"4006",5,"[18]hHoIoHcosHnJHGqKCI",278,0.996416,18,279,1,278,1,1,0,1,1,135,134,144,144,43
"4007",6,"[18]hHoIoHcosHnJHGqKCI",283,0.996479,18,284,1,283,1,1,0,1,1,149,148,135,135,43
"4008",7,"[18]hHoIoHcosHnJHGqKCI",281,0.996454,18,282,1,281,1,1,0,1,1,130,129,152,152,43
"4009",8,"[18]hHoIoHcosHnJHGqKCI",286,0.996516,18,287,1,286,1,1,0,1,1,157,156,130,130,43
"4010",9,"[18]hHoIoHcosHnJHGqKCI",282,0.996466,18,283,1,282,1,1,0,1,1,132,131,151,151,43
"4011",10,"[18]hHoIoHcosHnJHGqKCI",286,0.996516,18,287,1,286,1,1,0,1,1,152,151,135,135,43
"4012",11,"[18]hHoIoHcosHnJHGqKCI",280,0.996441,18,281,1,280,1,1,0,1,1,149,148,132,132,43
"4013",12,"[18]hHoIoHcosHnJHGqKCI",280,0.996441,18,281,1,280,1,1,0,1,1,157,156,124,124,43
"4014",13,"[18]hHoIoHcosHnJHGqKCI",286,0.996516,18,287,1,286,1,1,0,1,1,156,155,131,131,43
"4015",14,"[18]hHoIoHcosHnJHGqKCI",279,0.996429,18,280,1,279,1,1,0,1,1,143,142,137,137,43
"4016",15,"[18]hHoIoHcosHnJHGqKCI",280,0.996441,18,281,1,280,1,1,0,1,1,139,138,142,142,43
"4017",16,"[18]hHoIoHcosHnJHGqKCI",275,0.996377,18,276,1,275,1,1,0,1,1,139,138,137,137,43
"4018",17,"[18]hHoIoHcosHnJHGqKCI",282,0.996466,18,283,1,282,1,1,0,1,1,158,157,125,125,43
"4019",18,"[18]hHoIoHcosHnJHGqKCI",281,0.996454,18,282,1,281,1,1,0,1,1,148,147,134,134,43
"4020",19,"[18]hHoIoHcosHnJHGqKCI",285,0.996503,18,286,1,285,1,1,0,1,1,139,138,147,147,43
"4021",20,"[18]hHoIoHcosHnJHGqKCI",285,0.996503,18,286,1,285,1,1,0,1,1,138,137,148,148,43
"4022",21,"[18]hHoIoHcosHnJHGqKCI",281,0.996454,18,282,1,281,1,1,0,1,1,146,145,136,136,43
"4023",22,"[18]hHoIoHcosHnJHGqKCI",282,0.996466,18,283,1,282,1,1,0,1,1,136,135,147,147,43
"4024",23,"[18]hHoIoHcosHnJHGqKCI",278,0.996416,18,279,1,278,1,1,0,1,1,133,132,146,146,43
"4025",24,"[18]hHoIoHcosHnJHGqKCI",286,0.996516,18,287,1,286,1,1,0,1,1,138,137,149,149,43
"4026",25,"[18]hHoIoHcosHnJHGqKCI",292,0.996587,18,293,1,292,1,1,0,1,1,150,149,143,143,43
"4027",26,"[18]hHoIoHcosHnJHGqKCI",290,0.996564,18,291,1,290,1,1,0,1,1,153,152,138,138,43
"4028",27,"[18]hHoIoHcosHnJHGqKCI",288,0.99654,18,289,1,288,1,1,0,1,1,143,142,146,146,43
"4029",28,"[18]hHoIoHcosHnJHGqKCI",273,0.99635,18,274,1,273,1,1,0,1,1,161,160,113,113,43
"4030",29,"[18]hHoIoHcosHnJHGqKCI",282,0.996466,18,283,1,282,1,1,0,1,1,144,143,139,139,43
"4031",30,"[18]hHoIoHcosHnJHGqKCI",283,0.996479,18,284,1,283,1,1,0,1,1,140,139,144,144,43
"4032",31,"[18]hHoIoHcosHnJHGqKCI",281,0.996454,18,282,1,281,1,1,0,1,1,148,147,134,134,43
"4033",32,"[18]hHoIoHcosHnJHGqKCI",275,0.996377,18,276,1,275,1,1,0,1,1,150,149,126,126,43
"4034",33,"[18]hHoIoHcosHnJHGqKCI",275,0.996377,18,276,1,275,1,1,0,1,1,134,133,142,142,43
"4035",34,"[18]hHoIoHcosHnJHGqKCI",282,0.996466,18,283,1,282,1,1,0,1,1,147,146,136,136,43
"4036",35,"[18]hHoIoHcosHnJHGqKCI",278,0.996416,18,279,1,278,1,1,0,1,1,147,146,132,132,43
"4037",36,"[18]hHoIoHcosHnJHGqKCI",272,0.996337,18,273,1,272,1,1,0,1,1,127,126,146,146,43
"4038",37,"[18]hHoIoHcosHnJHGqKCI",280,0.996441,18,281,1,280,1,1,0,1,1,148,147,133,133,43
"4039",38,"[18]hHoIoHcosHnJHGqKCI",281,0.996454,18,282,1,281,1,1,0,1,1,150,149,132,132,43
"4040",39,"[18]hHoIoHcosHnJHGqKCI",287,0.996528,18,288,1,287,1,1,0,1,1,142,141,146,146,43
"4041",40,"[18]hHoIoHcosHnJHGqKCI",285,0.996503,18,286,1,285,1,1,0,1,1,152,151,134,134,43
"4042",41,"[18]hHoIoHcosHnJHGqKCI",284,0.996491,18,285,1,284,1,1,0,1,1,150,149,135,135,43
"4043",42,"[18]hHoIoHcosHnJHGqKCI",285,0.996503,18,286,1,285,1,1,0,1,1,137,136,149,149,43
"4044",43,"[18]hHoIoHcosHnJHGqKCI",259,0.996154,18,260,1,259,1,1,0,1,1,129,128,131,131,43
"4045",44,"[18]hHoIoHcosHnJHGqKCI",290,0.996564,18,291,1,290,1,1,0,1,1,146,145,145,145,43
"4046",45,"[18]hHoIoHcosHnJHGqKCI",288,0.99654,18,289,1,288,1,1,0,1,1,178,177,111,111,43
"4047",46,"[18]hHoIoHcosHnJHGqKCI",280,0.996441,18,281,1,280,1,1,0,1,1,139,138,142,142,43
"4048",47,"[18]hHoIoHcosHnJHGqKCI",283,0.996479,18,284,1,283,1,1,0,1,1,142,141,142,142,43
"4049",48,"[18]hHoIoHcosHnJHGqKCI",272,0.996337,18,273,1,272,1,1,0,1,1,137,136,136,136,43
"4050",49,"[18]hHoIoHcosHnJHGqKCI",271,0.996324,18,272,1,271,1,1,0,1,1,127,126,145,145,43
"4051",50,"[18]hHoIoHcosHnJHGqKCI",280,0.996441,18,281,1,280,1,1,0,1,1,145,144,136,136,43
"4052",51,"[18]hHoIoHcosHnJHGqKCI",276,0.99639,18,277,1,276,1,1,0,1,1,134,133,143,143,43
"4053",52,"[18]hHoIoHcosHnJHGqKCI",271,0.996324,18,272,1,271,1,1,0,1,1,128,127,144,144,43
"4054",53,"[18]hHoIoHcosHnJHGqKCI",281,0.996454,18,282,1,281,1,1,0,1,1,149,148,133,133,43
"4055",54,"[18]hHoIoHcosHnJHGqKCI",279,0.996429,18,280,1,279,1,1,0,1,1,133,132,147,147,43
"4056",55,"[18]hHoIoHcosHnJHGqKCI",282,0.996466,18,283,1,282,1,1,0,1,1,137,136,146,146,43
"4057",56,"[18]hHoIoHcosHnJHGqKCI",283,0.996479,18,284,1,283,1,1,0,1,1,149,148,135,135,43
"4058",57,"[18]hHoIoHcosHnJHGqKCI",273,0.99635,18,274,1,273,1,1,0,1,1,135,134,139,139,43
"4059",58,"[18]hHoIoHcosHnJHGqKCI",286,0.996516,18,287,1,286,1,1,0,1,1,152,151,135,135,43
"4060",59,"[18]hHoIoHcosHnJHGqKCI",285,0.996503,18,286,1,285,1,1,0,1,1,148,147,138,138,43
"4061",60,"[18]hHoIoHcosHnJHGqKCI",286,0.996516,18,287,1,286,1,1,0,1,1,152,151,135,135,43
"4062",61,"[18]hHoIoHcosHnJHGqKCI",277,0.996403,18,278,1,277,1,1,0,1,1,133,132,145,145,43
"4063",62,"[18]hHoIoHcosHnJHGqKCI",282,0.996466,18,283,1,282,1,1,0,1,1,147,146,136,136,43
"4064",63,"[18]hHoIoHcosHnJHGqKCI",290,0.996564,18,291,1,290,1,1,0,1,1,135,134,156,156,43
"4065",64,"[18]hHoIoHcosHnJHGqKCI",276,0.99639,18,277,1,276,1,1,0,1,1,139,138,138,138,43
"4066",65,"[18]hHoIoHcosHnJHGqKCI",287,0.996528,18,288,1,287,1,1,0,1,1,149,148,139,139,43
"4067",66,"[18]hHoIoHcosHnJHGqKCI",278,0.996416,18,279,1,278,1,1,0,1,1,141,140,138,138,43
"4068",67,"[18]hHoIoHcosHnJHGqKCI",286,0.996516,18,287,1,286,1,1,0,1,1,154,153,133,133,43
"4069",68,"[18]hHoIoHcosHnJHGqKCI",282,0.996466,18,283,1,282,1,1,0,1,1,129,128,154,154,43
"4070",69,"[18]hHoIoHcosHnJHGqKCI",288,0.99654,18,289,1,288,1,1,0,1,1,149,148,140,140,43
"4071",70,"[18]hHoIoHcosHnJHGqKCI",278,0.996416,18,279,1,278,1,1,0,1,1,129,128,150,150,43
"4072",71,"[18]hHoIoHcosHnJHGqKCI",281,0.996454,18,282,1,281,1,1,0,1,1,138,137,144,144,43
"4073",72,"[18]hHoIoHcosHnJHGqKCI",278,0.996416,18,279,1,278,1,1,0,1,1,136,135,143,143,43
"4074",73,"[18]hHoIoHcosHnJHGqKCI",277,0.996403,18,278,1,277,1,1,0,1,1,146,145,132,132,43
"4075",74,"[18]hHoIoHcosHnJHGqKCI",285,0.996503,18,286,1,285,1,1,0,1,1,134,133,152,152,43
"4076",75,"[18]hHoIoHcosHnJHGqKCI",285,0.996503,18,286,1,285,1,1,0,1,1,150,149,136,136,43
"4077",76,"[18]hHoIoHcosHnJHGqKCI",282,0.996466,18,283,1,282,1,1,0,1,1,132,131,151,151,43
"4078",77,"[18]hHoIoHcosHnJHGqKCI",282,0.996466,18,283,1,282,1,1,0,1,1,141,140,142,142,43
"4079",78,"[18]hHoIoHcosHnJHGqKCI",282,0.996466,18,283,1,282,1,1,0,1,1,146,145,137,137,43
"4080",79,"[18]hHoIoHcosHnJHGqKCI",278,0.996416,18,279,1,278,1,1,0,1,1,137,136,142,142,43
"4081",80,"[18]hHoIoHcosHnJHGqKCI",284,0.996491,18,285,1,284,1,1,0,1,1,144,143,141,141,43
"4082",81,"[18]hHoIoHcosHnJHGqKCI",278,0.996416,18,279,1,278,1,1,0,1,1,141,140,138,138,43
"4083",82,"[18]hHoIoHcosHnJHGqKCI",288,0.99654,18,289,1,288,1,1,0,1,1,137,136,152,152,43
"4084",83,"[18]hHoIoHcosHnJHGqKCI",282,0.996466,18,283,1,282,1,1,0,1,1,152,151,131,131,43
"4085",84,"[18]hHoIoHcosHnJHGqKCI",279,0.996429,18,280,1,279,1,1,0,1,1,137,136,143,143,43
"4086",85,"[18]hHoIoHcosHnJHGqKCI",281,0.996454,18,282,1,281,1,1,0,1,1,144,143,138,138,43
"4087",86,"[18]hHoIoHcosHnJHGqKCI",280,0.996441,18,281,1,280,1,1,0,1,1,140,139,141,141,43
"4088",87,"[18]hHoIoHcosHnJHGqKCI",291,0.996575,18,292,1,291,1,1,0,1,1,145,144,147,147,43
"4089",88,"[18]hHoIoHcosHnJHGqKCI",279,0.996429,18,280,1,279,1,1,0,1,1,154,153,126,126,43
"4090",89,"[18]hHoIoHcosHnJHGqKCI",279,0.996429,18,280,1,279,1,1,0,1,1,143,142,137,137,43
"4091",90,"[18]hHoIoHcosHnJHGqKCI",282,0.996466,18,283,1,282,1,1,0,1,1,153,152,130,130,43
"4092",91,"[18]hHoIoHcosHnJHGqKCI",278,0.996416,18,279,1,278,1,1,0,1,1,148,147,131,131,43
"4093",92,"[18]hHoIoHcosHnJHGqKCI",278,0.996416,18,279,1,278,1,1,0,1,1,149,148,130,130,43
"4094",93,"[18]hHoIoHcosHnJHGqKCI",286,0.996516,18,287,1,286,1,1,0,1,1,144,143,143,143,43
"4095",94,"[18]hHoIoHcosHnJHGqKCI",283,0.996479,18,284,1,283,1,1,0,1,1,150,149,134,134,43
"4096",95,"[18]hHoIoHcosHnJHGqKCI",280,0.996441,18,281,1,280,1,1,0,1,1,154,153,127,127,43
"4097",96,"[18]hHoIoHcosHnJHGqKCI",283,0.996479,18,284,1,283,1,1,0,1,1,138,137,146,146,43
"4098",97,"[18]hHoIoHcosHnJHGqKCI",285,0.996503,18,286,1,285,1,1,0,1,1,143,142,143,143,43
"4099",98,"[18]hHoIoHcosHnJHGqKCI",283,0.996479,18,284,1,283,1,1,0,1,1,152,151,132,132,43
"4100",99,"[18]hHoIoHcosHnJHGqKCI",281,0.996454,18,282,1,281,1,1,0,1,1,143,142,139,139,43
"4101",0,"[28]gtHuoIFoHcouHnJHGqKCAtDpHcsG",290,0.996564,28,291,1,290,1,1,0,1,1,134,133,157,157,44
"4102",1,"[28]gtHuoIFoHcouHnJHGqKCAtDpHcsG",279,0.996429,28,280,1,279,1,1,0,1,1,142,141,138,138,44
"4103",2,"[28]gtHuoIFoHcouHnJHGqKCAtDpHcsG",273,0.99635,28,274,1,273,1,1,0,1,1,132,131,142,142,44
"4104",3,"[28]gtHuoIFoHcouHnJHGqKCAtDpHcsG",285,0.996503,28,286,1,285,1,1,0,1,1,154,153,132,132,44
"4105",4,"[28]gtHuoIFoHcouHnJHGqKCAtDpHcsG",286,0.996516,28,287,1,286,1,1,0,1,1,134,133,153,153,44
"4106",5,"[28]gtHuoIFoHcouHnJHGqKCAtDpHcsG",282,0.996466,28,283,1,282,1,1,0,1,1,157,156,126,126,44
"4107",6,"[28]gtHuoIFoHcouHnJHGqKCAtDpHcsG",281,0.996454,28,282,1,281,1,1,0,1,1,148,147,134,134,44
"4108",7,"[28]gtHuoIFoHcouHnJHGqKCAtDpHcsG",280,0.996441,28,281,1,280,1,1,0,1,1,137,136,144,144,44
"4109",8,"[28]gtHuoIFoHcouHnJHGqKCAtDpHcsG",278,0.996416,28,279,1,278,1,1,0,1,1,139,138,140,140,44
"4110",9,"[28]gtHuoIFoHcouHnJHGqKCAtDpHcsG",277,0.996403,28,278,1,277,1,1,0,1,1,144,143,134,134,44
"4111",10,"[28]gtHuoIFoHcouHnJHGqKCAtDpHcsG",283,0.996479,28,284,1,283,1,1,0,1,1,148,147,136,136,44
"4112",11,"[28]gtHuoIFoHcouHnJHGqKCAtDpHcsG",278,0.996416,28,279,1,278,1,1,0,1,1,128,127,151,151,44
"4113",12,"[28]gtHuoIFoHcouHnJHGqKCAtDpHcsG",278,0.996416,28,279,1,278,1,1,0,1,1,138,137,141,141,44
"4114",13,"[28]gtHuoIFoHcouHnJHGqKCAtDpHcsG",285,0.996503,28,286,1,285,1,1,0,1,1,158,157,128,128,44
"4115",14,"[28]gtHuoIFoHcouHnJHGqKCAtDpHcsG",283,0.996479,28,284,1,283,1,1,0,1,1,131,130,153,153,44
"4116",15,"[28]gtHuoIFoHcouHnJHGqKCAtDpHcsG",273,0.99635,28,274,1,273,1,1,0,1,1,128,127,146,146,44
"4117",16,"[28]gtHuoIFoHcouHnJHGqKCAtDpHcsG",283,0.996479,28,284,1,283,1,1,0,1,1,148,147,136,136,44
"4118",17,"[28]gtHuoIFoHcouHnJHGqKCAtDpHcsG",278,0.996416,28,279,1,278,1,1,0,1,1,144,143,135,135,44
"4119",18,"[28]gtHuoIFoHcouHnJHGqKCAtDpHcsG",285,0.996503,28,286,1,285,1,1,0,1,1,151,150,135,135,44
"4120",19,"[28]gtHuoIFoHcouHnJHGqKCAtDpHcsG",269,0.996296,28,270,1,269,1,1,0,1,1,130,129,140,140,44
"4121",20,"[28]gtHuoIFoHcouHnJHGqKCAtDpHcsG",278,0.996416,28,279,1,278,1,1,0,1,1,138,137,141,141,44
"4122",21,"[28]gtHuoIFoHcouHnJHGqKCAtDpHcsG",288,0.99654,28,289,1,288,1,1,0,1,1,151,150,138,138,44
"4123",22,"[28]gtHuoIFoHcouHnJHGqKCAtDpHcsG",282,0.996466,28,283,1,282,1,1,0,1,1,131,130,152,152,44
"4124",23,"[28]gtHuoIFoHcouHnJHGqKCAtDpHcsG",280,0.996441,28,281,1,280,1,1,0,1,1,139,138,142,142,44
"4125",24,"[28]gtHuoIFoHcouHnJHGqKCAtDpHcsG",279,0.996429,28,280,1,279,1,1,0,1,1,131,130,149,149,44
"4126",25,"[28]gtHuoIFoHcouHnJHGqKCAtDpHcsG",275,0.996377,28,276,1,275,1,1,0,1,1,130,129,146,146,44
"4127",26,"[28]gtHuoIFoHcouHnJHGqKCAtDpHcsG",282,0.996466,28,283,1,282,1,1,0,1,1,143,142,140,140,44
"4128",27,"[28]gtHuoIFoHcouHnJHGqKCAtDpHcsG",273,0.99635,28,274,1,273,1,1,0,1,1,136,135,138,138,44
"4129",28,"[28]gtHuoIFoHcouHnJHGqKCAtDpHcsG",275,0.996377,28,276,1,275,1,1,0,1,1,128,127,148,148,44
"4130",29,"[28]gtHuoIFoHcouHnJHGqKCAtDpHcsG",277,0.996403,28,278,1,277,1,1,0,1,1,159,158,119,119,44
"4131",30,"[28]gtHuoIFoHcouHnJHGqKCAtDpHcsG",289,0.996552,28,290,1,289,1,1,0,1,1,155,154,135,135,44
"4132",31,"[28]gtHuoIFoHcouHnJHGqKCAtDpHcsG",275,0.996377,28,276,1,275,1,1,0,1,1,137,136,139,139,44
"4133",32,"[28]gtHuoIFoHcouHnJHGqKCAtDpHcsG",284,0.996491,28,285,1,284,1,1,0,1,1,141,140,144,144,44
"4134",33,"[28]gtHuoIFoHcouHnJHGqKCAtDpHcsG",278,0.996416,28,279,1,278,1,1,0,1,1,137,136,142,142,44
"4135",34,"[28]gtHuoIFoHcouHnJHGqKCAtDpHcsG",279,0.996429,28,280,1,279,1,1,0,1,1,136,135,144,144,44
"4136",35,"[28]gtHuoIFoHcouHnJHGqKCAtDpHcsG",282,0.996466,28,283,1,282,1,1,0,1,1,154,153,129,129,44
"4137",36,"[28]gtHuoIFoHcouHnJHGqKCAtDpHcsG",283,0.996479,28,284,1,283,1,1,0,1,1,131,130,153,153,44
"4138",37,"[28]gtHuoIFoHcouHnJHGqKCAtDpHcsG",274,0.996364,28,275,1,274,1,1,0,1,1,126,125,149,149,44
"4139",38,"[28]gtHuoIFoHcouHnJHGqKCAtDpHcsG",276,0.99639,28,277,1,276,1,1,0,1,1,130,129,147,147,44
"4140",39,"[28]gtHuoIFoHcouHnJHGqKCAtDpHcsG",289,0.996552,28,290,1,289,1,1,0,1,1,153,152,137,137,44
"4141",40,"[28]gtHuoIFoHcouHnJHGqKCAtDpHcsG",280,0.996441,28,281,1,280,1,1,0,1,1,136,135,145,145,44
"4142",41,"[28]gtHuoIFoHcouHnJHGqKCAtDpHcsG",281,0.996454,28,282,1,281,1,1,0,1,1,137,136,145,145,44
"4143",42,"[28]gtHuoIFoHcouHnJHGqKCAtDpHcsG",283,0.996479,28,284,1,283,1,1,0,1,1,136,135,148,148,44
"4144",43,"[28]gtHuoIFoHcouHnJHGqKCAtDpHcsG",274,0.996364,28,275,1,274,1,1,0,1,1,136,135,139,139,44
"4145",44,"[28]gtHuoIFoHcouHnJHGqKCAtDpHcsG",278,0.996416,28,279,1,278,1,1,0,1,1,128,127,151,151,44
"4146",45,"[28]gtHuoIFoHcouHnJHGqKCAtDpHcsG",286,0.996516,28,287,1,286,1,1,0,1,1,128,127,159,159,44
"4147",46,"[28]gtHuoIFoHcouHnJHGqKCAtDpHcsG",275,0.996377,28,276,1,275,1,1,0,1,1,126,125,150,150,44
"4148",47,"[28]gtHuoIFoHcouHnJHGqKCAtDpHcsG",275,0.996377,28,276,1,275,1,1,0,1,1,137,136,139,139,44
"4149",48,"[28]gtHuoIFoHcouHnJHGqKCAtDpHcsG",289,0.996552,28,290,1,289,1,1,0,1,1,147,146,143,143,44
"4150",49,"[28]gtHuoIFoHcouHnJHGqKCAtDpHcsG",281,0.996454,28,282,1,281,1,1,0,1,1,142,141,140,140,44
"4151",50,"[28]gtHuoIFoHcouHnJHGqKCAtDpHcsG",281,0.996454,28,282,1,281,1,1,0,1,1,135,134,147,147,44
"4152",51,"[28]gtHuoIFoHcouHnJHGqKCAtDpHcsG",272,0.996337,28,273,1,272,1,1,0,1,1,123,122,150,150,44
"4153",52,"[28]gtHuoIFoHcouHnJHGqKCAtDpHcsG",284,0.996491,28,285,1,284,1,1,0,1,1,144,143,141,141,44
"4154",53,"[28]gtHuoIFoHcouHnJHGqKCAtDpHcsG",285,0.996503,28,286,1,285,1,1,0,1,1,152,151,134,134,44
"4155",54,"[28]gtHuoIFoHcouHnJHGqKCAtDpHcsG",280,0.996441,28,281,1,280,1,1,0,1,1,138,137,143,143,44
"4156",55,"[28]gtHuoIFoHcouHnJHGqKCAtDpHcsG",279,0.996429,28,280,1,279,1,1,0,1,1,157,156,123,123,44
"4157",56,"[28]gtHuoIFoHcouHnJHGqKCAtDpHcsG",280,0.996441,28,281,1,280,1,1,0,1,1,143,142,138,138,44
"4158",57,"[28]gtHuoIFoHcouHnJHGqKCAtDpHcsG",273,0.99635,28,274,1,273,1,1,0,1,1,135,134,139,139,44
"4159",58,"[28]gtHuoIFoHcouHnJHGqKCAtDpHcsG",279,0.996429,28,280,1,279,1,1,0,1,1,145,144,135,135,44
"4160",59,"[28]gtHuoIFoHcouHnJHGqKCAtDpHcsG",280,0.996441,28,281,1,280,1,1,0,1,1,147,146,134,134,44
"4161",60,"[28]gtHuoIFoHcouHnJHGqKCAtDpHcsG",279,0.996429,28,280,1,279,1,1,0,1,1,131,130,149,149,44
"4162",61,"[28]gtHuoIFoHcouHnJHGqKCAtDpHcsG",285,0.996503,28,286,1,285,1,1,0,1,1,147,146,139,139,44
"4163",62,"[28]gtHuoIFoHcouHnJHGqKCAtDpHcsG",276,0.99639,28,277,1,276,1,1,0,1,1,133,132,144,144,44
"4164",63,"[28]gtHuoIFoHcouHnJHGqKCAtDpHcsG",285,0.996503,28,286,1,285,1,1,0,1,1,150,149,136,136,44
"4165",64,"[28]gtHuoIFoHcouHnJHGqKCAtDpHcsG",282,0.996466,28,283,1,282,1,1,0,1,1,137,136,146,146,44
"4166",65,"[28]gtHuoIFoHcouHnJHGqKCAtDpHcsG",282,0.996466,28,283,1,282,1,1,0,1,1,148,147,135,135,44
"4167",66,"[28]gtHuoIFoHcouHnJHGqKCAtDpHcsG",283,0.996479,28,284,1,283,1,1,0,1,1,139,138,145,145,44
"4168",67,"[28]gtHuoIFoHcouHnJHGqKCAtDpHcsG",277,0.996403,28,278,1,277,1,1,0,1,1,139,138,139,139,44
"4169",68,"[28]gtHuoIFoHcouHnJHGqKCAtDpHcsG",284,0.996491,28,285,1,284,1,1,0,1,1,144,143,141,141,44
"4170",69,"[28]gtHuoIFoHcouHnJHGqKCAtDpHcsG",282,0.996466,28,283,1,282,1,1,0,1,1,124,123,159,159,44
"4171",70,"[28]gtHuoIFoHcouHnJHGqKCAtDpHcsG",286,0.996516,28,287,1,286,1,1,0,1,1,163,162,124,124,44
"4172",71,"[28]gtHuoIFoHcouHnJHGqKCAtDpHcsG",276,0.99639,28,277,1,276,1,1,0,1,1,140,139,137,137,44
"4173",72,"[28]gtHuoIFoHcouHnJHGqKCAtDpHcsG",279,0.996429,28,280,1,279,1,1,0,1,1,129,128,151,151,44
"4174",73,"[28]gtHuoIFoHcouHnJHGqKCAtDpHcsG",284,0.996491,28,285,1,284,1,1,0,1,1,148,147,137,137,44
"4175",74,"[28]gtHuoIFoHcouHnJHGqKCAtDpHcsG",286,0.996516,28,287,1,286,1,1,0,1,1,140,139,147,147,44
"4176",75,"[28]gtHuoIFoHcouHnJHGqKCAtDpHcsG",281,0.996454,28,282,1,281,1,1,0,1,1,142,141,140,140,44
"4177",76,"[28]gtHuoIFoHcouHnJHGqKCAtDpHcsG",282,0.996466,28,283,1,282,1,1,0,1,1,130,129,153,153,44
"4178",77,"[28]gtHuoIFoHcouHnJHGqKCAtDpHcsG",284,0.996491,28,285,1,284,1,1,0,1,1,150,149,135,135,44
"4179",78,"[28]gtHuoIFoHcouHnJHGqKCAtDpHcsG",280,0.996441,28,281,1,280,1,1,0,1,1,139,138,142,142,44
"4180",79,"[28]gtHuoIFoHcouHnJHGqKCAtDpHcsG",289,0.996552,28,290,1,289,1,1,0,1,1,144,143,146,146,44
"4181",80,"[28]gtHuoIFoHcouHnJHGqKCAtDpHcsG",283,0.996479,28,284,1,283,1,1,0,1,1,152,151,132,132,44
"4182",81,"[28]gtHuoIFoHcouHnJHGqKCAtDpHcsG",277,0.996403,28,278,1,277,1,1,0,1,1,135,134,143,143,44
"4183",82,"[28]gtHuoIFoHcouHnJHGqKCAtDpHcsG",283,0.996479,28,284,1,283,1,1,0,1,1,129,128,155,155,44
"4184",83,"[28]gtHuoIFoHcouHnJHGqKCAtDpHcsG",272,0.996337,28,273,1,272,1,1,0,1,1,138,137,135,135,44
"4185",84,"[28]gtHuoIFoHcouHnJHGqKCAtDpHcsG",277,0.996403,28,278,1,277,1,1,0,1,1,121,120,157,157,44
"4186",85,"[28]gtHuoIFoHcouHnJHGqKCAtDpHcsG",277,0.996403,28,278,1,277,1,1,0,1,1,136,135,142,142,44
"4187",86,"[28]gtHuoIFoHcouHnJHGqKCAtDpHcsG",283,0.996479,28,284,1,283,1,1,0,1,1,141,140,143,143,44
"4188",87,"[28]gtHuoIFoHcouHnJHGqKCAtDpHcsG",283,0.996479,28,284,1,283,1,1,0,1,1,129,128,155,155,44
"4189",88,"[28]gtHuoIFoHcouHnJHGqKCAtDpHcsG",283,0.996479,28,284,1,283,1,1,0,1,1,146,145,138,138,44
"4190",89,"[28]gtHuoIFoHcouHnJHGqKCAtDpHcsG",280,0.996441,28,281,1,280,1,1,0,1,1,143,142,138,138,44
"4191",90,"[28]gtHuoIFoHcouHnJHGqKCAtDpHcsG",283,0.996479,28,284,1,283,1,1,0,1,1,143,142,141,141,44
"4192",91,"[28]gtHuoIFoHcouHnJHGqKCAtDpHcsG",277,0.996403,28,278,1,277,1,1,0,1,1,134,133,144,144,44
"4193",92,"[28]gtHuoIFoHcouHnJHGqKCAtDpHcsG",279,0.996429,28,280,1,279,1,1,0,1,1,147,146,133,133,44
"4194",93,"[28]gtHuoIFoHcouHnJHGqKCAtDpHcsG",285,0.996503,28,286,1,285,1,1,0,1,1,175,174,111,111,44
"4195",94,"[28]gtHuoIFoHcouHnJHGqKCAtDpHcsG",282,0.996466,28,283,1,282,1,1,0,1,1,147,146,136,136,44
"4196",95,"[28]gtHuoIFoHcouHnJHGqKCAtDpHcsG",283,0.996479,28,284,1,283,1,1,0,1,1,146,145,138,138,44
"4197",96,"[28]gtHuoIFoHcouHnJHGqKCAtDpHcsG",281,0.996454,28,282,1,281,1,1,0,1,1,147,146,135,135,44
"4198",97,"[28]gtHuoIFoHcouHnJHGqKCAtDpHcsG",275,0.996377,28,276,1,275,1,1,0,1,1,133,132,143,143,44
"4199",98,"[28]gtHuoIFoHcouHnJHGqKCAtDpHcsG",275,0.996377,28,276,1,275,1,1,0,1,1,156,155,120,120,44
"4200",99,"[28]gtHuoIFoHcouHnJHGqKCAtDpHcsG",279,0.996429,28,280,1,279,1,1,0,1,1,145,144,135,135,44
"4201",0,"[29]HoIbaoHcosHnJHGqKCuIBCHjmKjqt",277,0.996403,29,278,1,277,1,1,0,1,1,115,114,163,163,45
"4202",1,"[29]HoIbaoHcosHnJHGqKCuIBCHjmKjqt",283,0.996479,29,284,1,283,1,1,0,1,1,149,148,135,135,45
"4203",2,"[29]HoIbaoHcosHnJHGqKCuIBCHjmKjqt",271,0.996324,29,272,1,271,1,1,0,1,1,139,138,133,133,45
"4204",3,"[29]HoIbaoHcosHnJHGqKCuIBCHjmKjqt",277,0.996403,29,278,1,277,1,1,0,1,1,140,139,138,138,45
"4205",4,"[29]HoIbaoHcosHnJHGqKCuIBCHjmKjqt",280,0.996441,29,281,1,280,1,1,0,1,1,134,133,147,147,45
"4206",5,"[29]HoIbaoHcosHnJHGqKCuIBCHjmKjqt",283,0.996479,29,284,1,283,1,1,0,1,1,137,136,147,147,45
"4207",6,"[29]HoIbaoHcosHnJHGqKCuIBCHjmKjqt",281,0.996454,29,282,1,281,1,1,0,1,1,138,137,144,144,45
"4208",7,"[29]HoIbaoHcosHnJHGqKCuIBCHjmKjqt",286,0.996516,29,287,1,286,1,1,0,1,1,136,135,151,151,45
"4209",8,"[29]HoIbaoHcosHnJHGqKCuIBCHjmKjqt",282,0.996466,29,283,1,282,1,1,0,1,1,139,138,144,144,45
"4210",9,"[29]HoIbaoHcosHnJHGqKCuIBCHjmKjqt",282,0.996466,29,283,1,282,1,1,0,1,1,141,140,142,142,45
"4211",10,"[29]HoIbaoHcosHnJHGqKCuIBCHjmKjqt",276,0.99639,29,277,1,276,1,1,0,1,1,136,135,141,141,45
"4212",11,"[29]HoIbaoHcosHnJHGqKCuIBCHjmKjqt",275,0.996377,29,276,1,275,1,1,0,1,1,154,153,122,122,45
"4213",12,"[29]HoIbaoHcosHnJHGqKCuIBCHjmKjqt",279,0.996429,29,280,1,279,1,1,0,1,1,142,141,138,138,45
"4214",13,"[29]HoIbaoHcosHnJHGqKCuIBCHjmKjqt",280,0.996441,29,281,1,280,1,1,0,1,1,129,128,152,152,45
"4215",14,"[29]HoIbaoHcosHnJHGqKCuIBCHjmKjqt",282,0.996466,29,283,1,282,1,1,0,1,1,166,165,117,117,45
"4216",15,"[29]HoIbaoHcosHnJHGqKCuIBCHjmKjqt",275,0.996377,29,276,1,275,1,1,0,1,1,135,134,141,141,45
"4217",16,"[29]HoIbaoHcosHnJHGqKCuIBCHjmKjqt",284,0.996491,29,285,1,284,1,1,0,1,1,151,150,134,134,45
"4218",17,"[29]HoIbaoHcosHnJHGqKCuIBCHjmKjqt",274,0.996364,29,275,1,274,1,1,0,1,1,128,127,147,147,45
"4219",18,"[29]HoIbaoHcosHnJHGqKCuIBCHjmKjqt",273,0.99635,29,274,1,273,1,1,0,1,1,133,132,141,141,45
"4220",19,"[29]HoIbaoHcosHnJHGqKCuIBCHjmKjqt",286,0.996516,29,287,1,286,1,1,0,1,1,149,148,138,138,45
"4221",20,"[29]HoIbaoHcosHnJHGqKCuIBCHjmKjqt",281,0.996454,29,282,1,281,1,1,0,1,1,137,136,145,145,45
"4222",21,"[29]HoIbaoHcosHnJHGqKCuIBCHjmKjqt",285,0.996503,29,286,1,285,1,1,0,1,1,146,145,140,140,45
"4223",22,"[29]HoIbaoHcosHnJHGqKCuIBCHjmKjqt",284,0.996491,29,285,1,284,1,1,0,1,1,140,139,145,145,45
"4224",23,"[29]HoIbaoHcosHnJHGqKCuIBCHjmKjqt",288,0.99654,29,289,1,288,1,1,0,1,1,145,144,144,144,45
"4225",24,"[29]HoIbaoHcosHnJHGqKCuIBCHjmKjqt",276,0.99639,29,277,1,276,1,1,0,1,1,145,144,132,132,45
"4226",25,"[29]HoIbaoHcosHnJHGqKCuIBCHjmKjqt",282,0.996466,29,283,1,282,1,1,0,1,1,142,141,141,141,45
"4227",26,"[29]HoIbaoHcosHnJHGqKCuIBCHjmKjqt",286,0.996516,29,287,1,286,1,1,0,1,1,157,156,130,130,45
"4228",27,"[29]HoIbaoHcosHnJHGqKCuIBCHjmKjqt",281,0.996454,29,282,1,281,1,1,0,1,1,136,135,146,146,45
"4229",28,"[29]HoIbaoHcosHnJHGqKCuIBCHjmKjqt",277,0.996403,29,278,1,277,1,1,0,1,1,130,129,148,148,45
"4230",29,"[29]HoIbaoHcosHnJHGqKCuIBCHjmKjqt",279,0.996429,29,280,1,279,1,1,0,1,1,134,133,146,146,45
"4231",30,"[29]HoIbaoHcosHnJHGqKCuIBCHjmKjqt",289,0.996552,29,290,1,289,1,1,0,1,1,141,140,149,149,45
"4232",31,"[29]HoIbaoHcosHnJHGqKCuIBCHjmKjqt",289,0.996552,29,290,1,289,1,1,0,1,1,152,151,138,138,45
"4233",32,"[29]HoIbaoHcosHnJHGqKCuIBCHjmKjqt",279,0.996429,29,280,1,279,1,1,0,1,1,138,137,142,142,45
"4234",33,"[29]HoIbaoHcosHnJHGqKCuIBCHjmKjqt",281,0.996454,29,282,1,281,1,1,0,1,1,143,142,139,139,45
"4235",34,"[29]HoIbaoHcosHnJHGqKCuIBCHjmKjqt",277,0.996403,29,278,1,277,1,1,0,1,1,135,134,143,143,45
"4236",35,"[29]HoIbaoHcosHnJHGqKCuIBCHjmKjqt",284,0.996491,29,285,1,284,1,1,0,1,1,143,142,142,142,45
"4237",36,"[29]HoIbaoHcosHnJHGqKCuIBCHjmKjqt",275,0.996377,29,276,1,275,1,1,0,1,1,132,131,144,144,45
"4238",37,"[29]HoIbaoHcosHnJHGqKCuIBCHjmKjqt",276,0.99639,29,277,1,276,1,1,0,1,1,136,135,141,141,45
"4239",38,"[29]HoIbaoHcosHnJHGqKCuIBCHjmKjqt",276,0.99639,29,277,1,276,1,1,0,1,1,143,142,134,134,45
"4240",39,"[29]HoIbaoHcosHnJHGqKCuIBCHjmKjqt",279,0.996429,29,280,1,279,1,1,0,1,1,124,123,156,156,45
"4241",40,"[29]HoIbaoHcosHnJHGqKCuIBCHjmKjqt",286,0.996516,29,287,1,286,1,1,0,1,1,144,143,143,143,45
"4242",41,"[29]HoIbaoHcosHnJHGqKCuIBCHjmKjqt",274,0.996364,29,275,1,274,1,1,0,1,1,132,131,143,143,45
"4243",42,"[29]HoIbaoHcosHnJHGqKCuIBCHjmKjqt",275,0.996377,29,276,1,275,1,1,0,1,1,129,128,147,147,45
"4244",43,"[29]HoIbaoHcosHnJHGqKCuIBCHjmKjqt",278,0.996416,29,279,1,278,1,1,0,1,1,134,133,145,145,45
"4245",44,"[29]HoIbaoHcosHnJHGqKCuIBCHjmKjqt",278,0.996416,29,279,1,278,1,1,0,1,1,137,136,142,142,45
"4246",45,"[29]HoIbaoHcosHnJHGqKCuIBCHjmKjqt",282,0.996466,29,283,1,282,1,1,0,1,1,146,145,137,137,45
"4247",46,"[29]HoIbaoHcosHnJHGqKCuIBCHjmKjqt",279,0.996429,29,280,1,279,1,1,0,1,1,155,154,125,125,45
"4248",47,"[29]HoIbaoHcosHnJHGqKCuIBCHjmKjqt",271,0.996324,29,272,1,271,1,1,0,1,1,128,127,144,144,45
"4249",48,"[29]HoIbaoHcosHnJHGqKCuIBCHjmKjqt",290,0.996564,29,291,1,290,1,1,0,1,1,150,149,141,141,45
"4250",49,"[29]HoIbaoHcosHnJHGqKCuIBCHjmKjqt",280,0.996441,29,281,1,280,1,1,0,1,1,148,147,133,133,45
"4251",50,"[29]HoIbaoHcosHnJHGqKCuIBCHjmKjqt",278,0.996416,29,279,1,278,1,1,0,1,1,149,148,130,130,45
"4252",51,"[29]HoIbaoHcosHnJHGqKCuIBCHjmKjqt",287,0.996528,29,288,1,287,1,1,0,1,1,154,153,134,134,45
"4253",52,"[29]HoIbaoHcosHnJHGqKCuIBCHjmKjqt",276,0.99639,29,277,1,276,1,1,0,1,1,136,135,141,141,45
"4254",53,"[29]HoIbaoHcosHnJHGqKCuIBCHjmKjqt",279,0.996429,29,280,1,279,1,1,0,1,1,145,144,135,135,45
"4255",54,"[29]HoIbaoHcosHnJHGqKCuIBCHjmKjqt",283,0.996479,29,284,1,283,1,1,0,1,1,137,136,147,147,45
"4256",55,"[29]HoIbaoHcosHnJHGqKCuIBCHjmKjqt",273,0.99635,29,274,1,273,1,1,0,1,1,137,136,137,137,45
"4257",56,"[29]HoIbaoHcosHnJHGqKCuIBCHjmKjqt",281,0.996454,29,282,1,281,1,1,0,1,1,140,139,142,142,45
"4258",57,"[29]HoIbaoHcosHnJHGqKCuIBCHjmKjqt",285,0.996503,29,286,1,285,1,1,0,1,1,142,141,144,144,45
"4259",58,"[29]HoIbaoHcosHnJHGqKCuIBCHjmKjqt",277,0.996403,29,278,1,277,1,1,0,1,1,121,120,157,157,45
"4260",59,"[29]HoIbaoHcosHnJHGqKCuIBCHjmKjqt",282,0.996466,29,283,1,282,1,1,0,1,1,134,133,149,149,45
"4261",60,"[29]HoIbaoHcosHnJHGqKCuIBCHjmKjqt",276,0.99639,29,277,1,276,1,1,0,1,1,139,138,138,138,45
"4262",61,"[29]HoIbaoHcosHnJHGqKCuIBCHjmKjqt",279,0.996429,29,280,1,279,1,1,0,1,1,130,129,150,150,45
"4263",62,"[29]HoIbaoHcosHnJHGqKCuIBCHjmKjqt",277,0.996403,29,278,1,277,1,1,0,1,1,131,130,147,147,45
"4264",63,"[29]HoIbaoHcosHnJHGqKCuIBCHjmKjqt",275,0.996377,29,276,1,275,1,1,0,1,1,129,128,147,147,45
"4265",64,"[29]HoIbaoHcosHnJHGqKCuIBCHjmKjqt",268,0.996283,29,269,1,268,1,1,0,1,1,119,118,150,150,45
"4266",65,"[29]HoIbaoHcosHnJHGqKCuIBCHjmKjqt",282,0.996466,29,283,1,282,1,1,0,1,1,138,137,145,145,45
"4267",66,"[29]HoIbaoHcosHnJHGqKCuIBCHjmKjqt",282,0.996466,29,283,1,282,1,1,0,1,1,157,156,126,126,45
"4268",67,"[29]HoIbaoHcosHnJHGqKCuIBCHjmKjqt",277,0.996403,29,278,1,277,1,1,0,1,1,135,134,143,143,45
"4269",68,"[29]HoIbaoHcosHnJHGqKCuIBCHjmKjqt",288,0.99654,29,289,1,288,1,1,0,1,1,147,146,142,142,45
"4270",69,"[29]HoIbaoHcosHnJHGqKCuIBCHjmKjqt",275,0.996377,29,276,1,275,1,1,0,1,1,137,136,139,139,45
"4271",70,"[29]HoIbaoHcosHnJHGqKCuIBCHjmKjqt",286,0.996516,29,287,1,286,1,1,0,1,1,156,155,131,131,45
"4272",71,"[29]HoIbaoHcosHnJHGqKCuIBCHjmKjqt",286,0.996516,29,287,1,286,1,1,0,1,1,138,137,149,149,45
"4273",72,"[29]HoIbaoHcosHnJHGqKCuIBCHjmKjqt",285,0.996503,29,286,1,285,1,1,0,1,1,160,159,126,126,45
"4274",73,"[29]HoIbaoHcosHnJHGqKCuIBCHjmKjqt",279,0.996429,29,280,1,279,1,1,0,1,1,149,148,131,131,45
"4275",74,"[29]HoIbaoHcosHnJHGqKCuIBCHjmKjqt",285,0.996503,29,286,1,285,1,1,0,1,1,136,135,150,150,45
"4276",75,"[29]HoIbaoHcosHnJHGqKCuIBCHjmKjqt",278,0.996416,29,279,1,278,1,1,0,1,1,155,154,124,124,45
"4277",76,"[29]HoIbaoHcosHnJHGqKCuIBCHjmKjqt",278,0.996416,29,279,1,278,1,1,0,1,1,136,135,143,143,45
"4278",77,"[29]HoIbaoHcosHnJHGqKCuIBCHjmKjqt",279,0.996429,29,280,1,279,1,1,0,1,1,129,128,151,151,45
"4279",78,"[29]HoIbaoHcosHnJHGqKCuIBCHjmKjqt",286,0.996516,29,287,1,286,1,1,0,1,1,150,149,137,137,45
"4280",79,"[29]HoIbaoHcosHnJHGqKCuIBCHjmKjqt",281,0.996454,29,282,1,281,1,1,0,1,1,152,151,130,130,45
"4281",80,"[29]HoIbaoHcosHnJHGqKCuIBCHjmKjqt",288,0.99654,29,289,1,288,1,1,0,1,1,177,176,112,112,45
"4282",81,"[29]HoIbaoHcosHnJHGqKCuIBCHjmKjqt",280,0.996441,29,281,1,280,1,1,0,1,1,151,150,130,130,45
"4283",82,"[29]HoIbaoHcosHnJHGqKCuIBCHjmKjqt",280,0.996441,29,281,1,280,1,1,0,1,1,150,149,131,131,45
"4284",83,"[29]HoIbaoHcosHnJHGqKCuIBCHjmKjqt",279,0.996429,29,280,1,279,1,1,0,1,1,134,133,146,146,45
"4285",84,"[29]HoIbaoHcosHnJHGqKCuIBCHjmKjqt",282,0.996466,29,283,1,282,1,1,0,1,1,150,149,133,133,45
"4286",85,"[29]HoIbaoHcosHnJHGqKCuIBCHjmKjqt",286,0.996516,29,287,1,286,1,1,0,1,1,138,137,149,149,45
"4287",86,"[29]HoIbaoHcosHnJHGqKCuIBCHjmKjqt",268,0.996283,29,269,1,268,1,1,0,1,1,123,122,146,146,45
"4288",87,"[29]HoIbaoHcosHnJHGqKCuIBCHjmKjqt",289,0.996552,29,290,1,289,1,1,0,1,1,151,150,139,139,45
"4289",88,"[29]HoIbaoHcosHnJHGqKCuIBCHjmKjqt",283,0.996479,29,284,1,283,1,1,0,1,1,143,142,141,141,45
"4290",89,"[29]HoIbaoHcosHnJHGqKCuIBCHjmKjqt",277,0.996403,29,278,1,277,1,1,0,1,1,129,128,149,149,45
"4291",90,"[29]HoIbaoHcosHnJHGqKCuIBCHjmKjqt",283,0.996479,29,284,1,283,1,1,0,1,1,142,141,142,142,45
"4292",91,"[29]HoIbaoHcosHnJHGqKCuIBCHjmKjqt",284,0.996491,29,285,1,284,1,1,0,1,1,146,145,139,139,45
"4293",92,"[29]HoIbaoHcosHnJHGqKCuIBCHjmKjqt",280,0.996441,29,281,1,280,1,1,0,1,1,142,141,139,139,45
"4294",93,"[29]HoIbaoHcosHnJHGqKCuIBCHjmKjqt",286,0.996516,29,287,1,286,1,1,0,1,1,144,143,143,143,45
"4295",94,"[29]HoIbaoHcosHnJHGqKCuIBCHjmKjqt",282,0.996466,29,283,1,282,1,1,0,1,1,156,155,127,127,45
"4296",95,"[29]HoIbaoHcosHnJHGqKCuIBCHjmKjqt",284,0.996491,29,285,1,284,1,1,0,1,1,147,146,138,138,45
"4297",96,"[29]HoIbaoHcosHnJHGqKCuIBCHjmKjqt",287,0.996528,29,288,1,287,1,1,0,1,1,142,141,146,146,45
"4298",97,"[29]HoIbaoHcosHnJHGqKCuIBCHjmKjqt",278,0.996416,29,279,1,278,1,1,0,1,1,133,132,146,146,45
"4299",98,"[29]HoIbaoHcosHnJHGqKCuIBCHjmKjqt",289,0.996552,29,290,1,289,1,1,0,1,1,144,143,146,146,45
"4300",99,"[29]HoIbaoHcosHnJHGqKCuIBCHjmKjqt",280,0.996441,29,281,1,280,1,1,0,1,1,134,133,147,147,45
"4301",0,"[22]qHoIoHcoxHnJHGqKCxtBAD",285,0.996503,22,286,1,285,1,1,0,1,1,150,149,136,136,46
"4302",1,"[22]qHoIoHcoxHnJHGqKCxtBAD",286,0.996516,22,287,1,286,1,1,0,1,1,145,144,142,142,46
"4303",2,"[22]qHoIoHcoxHnJHGqKCxtBAD",274,0.996364,22,275,1,274,1,1,0,1,1,152,151,123,123,46
"4304",3,"[22]qHoIoHcoxHnJHGqKCxtBAD",285,0.996503,22,286,1,285,1,1,0,1,1,151,150,135,135,46
"4305",4,"[22]qHoIoHcoxHnJHGqKCxtBAD",279,0.996429,22,280,1,279,1,1,0,1,1,127,126,153,153,46
"4306",5,"[22]qHoIoHcoxHnJHGqKCxtBAD",279,0.996429,22,280,1,279,1,1,0,1,1,149,148,131,131,46
"4307",6,"[22]qHoIoHcoxHnJHGqKCxtBAD",276,0.99639,22,277,1,276,1,1,0,1,1,135,134,142,142,46
"4308",7,"[22]qHoIoHcoxHnJHGqKCxtBAD",280,0.996441,22,281,1,280,1,1,0,1,1,149,148,132,132,46
"4309",8,"[22]qHoIoHcoxHnJHGqKCxtBAD",277,0.996403,22,278,1,277,1,1,0,1,1,148,147,130,130,46
"4310",9,"[22]qHoIoHcoxHnJHGqKCxtBAD",281,0.996454,22,282,1,281,1,1,0,1,1,143,142,139,139,46
"4311",10,"[22]qHoIoHcoxHnJHGqKCxtBAD",278,0.996416,22,279,1,278,1,1,0,1,1,148,147,131,131,46
"4312",11,"[22]qHoIoHcoxHnJHGqKCxtBAD",281,0.996454,22,282,1,281,1,1,0,1,1,145,144,137,137,46
"4313",12,"[22]qHoIoHcoxHnJHGqKCxtBAD",280,0.996441,22,281,1,280,1,1,0,1,1,154,153,127,127,46
"4314",13,"[22]qHoIoHcoxHnJHGqKCxtBAD",291,0.996575,22,292,1,291,1,1,0,1,1,150,149,142,142,46
"4315",14,"[22]qHoIoHcoxHnJHGqKCxtBAD",279,0.996429,22,280,1,279,1,1,0,1,1,145,144,135,135,46
"4316",15,"[22]qHoIoHcoxHnJHGqKCxtBAD",271,0.996324,22,272,1,271,1,1,0,1,1,129,128,143,143,46
"4317",16,"[22]qHoIoHcoxHnJHGqKCxtBAD",286,0.996516,22,287,1,286,1,1,0,1,1,149,148,138,138,46
"4318",17,"[22]qHoIoHcoxHnJHGqKCxtBAD",281,0.996454,22,282,1,281,1,1,0,1,1,139,138,143,143,46
"4319",18,"[22]qHoIoHcoxHnJHGqKCxtBAD",280,0.996441,22,281,1,280,1,1,0,1,1,138,137,143,143,46
"4320",19,"[22]qHoIoHcoxHnJHGqKCxtBAD",275,0.996377,22,276,1,275,1,1,0,1,1,140,139,136,136,46
"4321",20,"[22]qHoIoHcoxHnJHGqKCxtBAD",283,0.996479,22,284,1,283,1,1,0,1,1,154,153,130,130,46
"4322",21,"[22]qHoIoHcoxHnJHGqKCxtBAD",282,0.996466,22,283,1,282,1,1,0,1,1,133,132,150,150,46
"4323",22,"[22]qHoIoHcoxHnJHGqKCxtBAD",276,0.99639,22,277,1,276,1,1,0,1,1,120,119,157,157,46
"4324",23,"[22]qHoIoHcoxHnJHGqKCxtBAD",283,0.996479,22,284,1,283,1,1,0,1,1,145,144,139,139,46
"4325",24,"[22]qHoIoHcoxHnJHGqKCxtBAD",286,0.996516,22,287,1,286,1,1,0,1,1,141,140,146,146,46
"4326",25,"[22]qHoIoHcoxHnJHGqKCxtBAD",292,0.996587,22,293,1,292,1,1,0,1,1,156,155,137,137,46
"4327",26,"[22]qHoIoHcoxHnJHGqKCxtBAD",279,0.996429,22,280,1,279,1,1,0,1,1,127,126,153,153,46
"4328",27,"[22]qHoIoHcoxHnJHGqKCxtBAD",280,0.996441,22,281,1,280,1,1,0,1,1,138,137,143,143,46
"4329",28,"[22]qHoIoHcoxHnJHGqKCxtBAD",283,0.996479,22,284,1,283,1,1,0,1,1,135,134,149,149,46
"4330",29,"[22]qHoIoHcoxHnJHGqKCxtBAD",274,0.996364,22,275,1,274,1,1,0,1,1,130,129,145,145,46
"4331",30,"[22]qHoIoHcoxHnJHGqKCxtBAD",286,0.996516,22,287,1,286,1,1,0,1,1,143,142,144,144,46
"4332",31,"[22]qHoIoHcoxHnJHGqKCxtBAD",279,0.996429,22,280,1,279,1,1,0,1,1,129,128,151,151,46
"4333",32,"[22]qHoIoHcoxHnJHGqKCxtBAD",278,0.996416,22,279,1,278,1,1,0,1,1,149,148,130,130,46
"4334",33,"[22]qHoIoHcoxHnJHGqKCxtBAD",282,0.996466,22,283,1,282,1,1,0,1,1,144,143,139,139,46
"4335",34,"[22]qHoIoHcoxHnJHGqKCxtBAD",277,0.996403,22,278,1,277,1,1,0,1,1,137,136,141,141,46
"4336",35,"[22]qHoIoHcoxHnJHGqKCxtBAD",276,0.99639,22,277,1,276,1,1,0,1,1,147,146,130,130,46
"4337",36,"[22]qHoIoHcoxHnJHGqKCxtBAD",288,0.99654,22,289,1,288,1,1,0,1,1,135,134,154,154,46
"4338",37,"[22]qHoIoHcoxHnJHGqKCxtBAD",281,0.996454,22,282,1,281,1,1,0,1,1,136,135,146,146,46
"4339",38,"[22]qHoIoHcoxHnJHGqKCxtBAD",288,0.99654,22,289,1,288,1,1,0,1,1,153,152,136,136,46
"4340",39,"[22]qHoIoHcoxHnJHGqKCxtBAD",282,0.996466,22,283,1,282,1,1,0,1,1,138,137,145,145,46
"4341",40,"[22]qHoIoHcoxHnJHGqKCxtBAD",278,0.996416,22,279,1,278,1,1,0,1,1,139,138,140,140,46
"4342",41,"[22]qHoIoHcoxHnJHGqKCxtBAD",278,0.996416,22,279,1,278,1,1,0,1,1,147,146,132,132,46
"4343",42,"[22]qHoIoHcoxHnJHGqKCxtBAD",278,0.996416,22,279,1,278,1,1,0,1,1,146,145,133,133,46
"4344",43,"[22]qHoIoHcoxHnJHGqKCxtBAD",286,0.996516,22,287,1,286,1,1,0,1,1,143,142,144,144,46
"4345",44,"[22]qHoIoHcoxHnJHGqKCxtBAD",279,0.996429,22,280,1,279,1,1,0,1,1,135,134,145,145,46
"4346",45,"[22]qHoIoHcoxHnJHGqKCxtBAD",280,0.996441,22,281,1,280,1,1,0,1,1,148,147,133,133,46
"4347",46,"[22]qHoIoHcoxHnJHGqKCxtBAD",269,0.996296,22,270,1,269,1,1,0,1,1,113,112,157,157,46
"4348",47,"[22]qHoIoHcoxHnJHGqKCxtBAD",276,0.99639,22,277,1,276,1,1,0,1,1,135,134,142,142,46
"4349",48,"[22]qHoIoHcoxHnJHGqKCxtBAD",276,0.99639,22,277,1,276,1,1,0,1,1,141,140,136,136,46
"4350",49,"[22]qHoIoHcoxHnJHGqKCxtBAD",285,0.996503,22,286,1,285,1,1,0,1,1,142,141,144,144,46
"4351",50,"[22]qHoIoHcoxHnJHGqKCxtBAD",282,0.996466,22,283,1,282,1,1,0,1,1,148,147,135,135,46
"4352",51,"[22]qHoIoHcoxHnJHGqKCxtBAD",291,0.996575,22,292,1,291,1,1,0,1,1,153,152,139,139,46
"4353",52,"[22]qHoIoHcoxHnJHGqKCxtBAD",271,0.996324,22,272,1,271,1,1,0,1,1,119,118,153,153,46
"4354",53,"[22]qHoIoHcoxHnJHGqKCxtBAD",282,0.996466,22,283,1,282,1,1,0,1,1,141,140,142,142,46
"4355",54,"[22]qHoIoHcoxHnJHGqKCxtBAD",280,0.996441,22,281,1,280,1,1,0,1,1,143,142,138,138,46
"4356",55,"[22]qHoIoHcoxHnJHGqKCxtBAD",284,0.996491,22,285,1,284,1,1,0,1,1,157,156,128,128,46
"4357",56,"[22]qHoIoHcoxHnJHGqKCxtBAD",275,0.996377,22,276,1,275,1,1,0,1,1,124,123,152,152,46
"4358",57,"[22]qHoIoHcoxHnJHGqKCxtBAD",279,0.996429,22,280,1,279,1,1,0,1,1,139,138,141,141,46
"4359",58,"[22]qHoIoHcoxHnJHGqKCxtBAD",277,0.996403,22,278,1,277,1,1,0,1,1,147,146,131,131,46
"4360",59,"[22]qHoIoHcoxHnJHGqKCxtBAD",273,0.99635,22,274,1,273,1,1,0,1,1,119,118,155,155,46
"4361",60,"[22]qHoIoHcoxHnJHGqKCxtBAD",278,0.996416,22,279,1,278,1,1,0,1,1,130,129,149,149,46
"4362",61,"[22]qHoIoHcoxHnJHGqKCxtBAD",280,0.996441,22,281,1,280,1,1,0,1,1,144,143,137,137,46
"4363",62,"[22]qHoIoHcoxHnJHGqKCxtBAD",281,0.996454,22,282,1,281,1,1,0,1,1,140,139,142,142,46
"4364",63,"[22]qHoIoHcoxHnJHGqKCxtBAD",283,0.996479,22,284,1,283,1,1,0,1,1,138,137,146,146,46
"4365",64,"[22]qHoIoHcoxHnJHGqKCxtBAD",283,0.996479,22,284,1,283,1,1,0,1,1,129,128,155,155,46
"4366",65,"[22]qHoIoHcoxHnJHGqKCxtBAD",282,0.996466,22,283,1,282,1,1,0,1,1,149,148,134,134,46
"4367",66,"[22]qHoIoHcoxHnJHGqKCxtBAD",279,0.996429,22,280,1,279,1,1,0,1,1,137,136,143,143,46
"4368",67,"[22]qHoIoHcoxHnJHGqKCxtBAD",281,0.996454,22,282,1,281,1,1,0,1,1,146,145,136,136,46
"4369",68,"[22]qHoIoHcoxHnJHGqKCxtBAD",282,0.996466,22,283,1,282,1,1,0,1,1,132,131,151,151,46
"4370",69,"[22]qHoIoHcoxHnJHGqKCxtBAD",294,0.99661,22,295,1,294,1,1,0,1,1,169,168,126,126,46
"4371",70,"[22]qHoIoHcoxHnJHGqKCxtBAD",286,0.996516,22,287,1,286,1,1,0,1,1,166,165,121,121,46
"4372",71,"[22]qHoIoHcoxHnJHGqKCxtBAD",284,0.996491,22,285,1,284,1,1,0,1,1,147,146,138,138,46
"4373",72,"[22]qHoIoHcoxHnJHGqKCxtBAD",277,0.996403,22,278,1,277,1,1,0,1,1,144,143,134,134,46
"4374",73,"[22]qHoIoHcoxHnJHGqKCxtBAD",277,0.996403,22,278,1,277,1,1,0,1,1,140,139,138,138,46
"4375",74,"[22]qHoIoHcoxHnJHGqKCxtBAD",281,0.996454,22,282,1,281,1,1,0,1,1,137,136,145,145,46
"4376",75,"[22]qHoIoHcoxHnJHGqKCxtBAD",280,0.996441,22,281,1,280,1,1,0,1,1,133,132,148,148,46
"4377",76,"[22]qHoIoHcoxHnJHGqKCxtBAD",281,0.996454,22,282,1,281,1,1,0,1,1,146,145,136,136,46
"4378",77,"[22]qHoIoHcoxHnJHGqKCxtBAD",283,0.996479,22,284,1,283,1,1,0,1,1,176,175,108,108,46
"4379",78,"[22]qHoIoHcoxHnJHGqKCxtBAD",280,0.996441,22,281,1,280,1,1,0,1,1,141,140,140,140,46
"4380",79,"[22]qHoIoHcoxHnJHGqKCxtBAD",284,0.996491,22,285,1,284,1,1,0,1,1,147,146,138,138,46
"4381",80,"[22]qHoIoHcoxHnJHGqKCxtBAD",279,0.996429,22,280,1,279,1,1,0,1,1,146,145,134,134,46
"4382",81,"[22]qHoIoHcoxHnJHGqKCxtBAD",284,0.996491,22,285,1,284,1,1,0,1,1,138,137,147,147,46
"4383",82,"[22]qHoIoHcoxHnJHGqKCxtBAD",274,0.996364,22,275,1,274,1,1,0,1,1,137,136,138,138,46
"4384",83,"[22]qHoIoHcoxHnJHGqKCxtBAD",285,0.996503,22,286,1,285,1,1,0,1,1,149,148,137,137,46
"4385",84,"[22]qHoIoHcoxHnJHGqKCxtBAD",286,0.996516,22,287,1,286,1,1,0,1,1,139,138,148,148,46
"4386",85,"[22]qHoIoHcoxHnJHGqKCxtBAD",283,0.996479,22,284,1,283,1,1,0,1,1,134,133,150,150,46
"4387",86,"[22]qHoIoHcoxHnJHGqKCxtBAD",282,0.996466,22,283,1,282,1,1,0,1,1,150,149,133,133,46
"4388",87,"[22]qHoIoHcoxHnJHGqKCxtBAD",289,0.996552,22,290,1,289,1,1,0,1,1,144,143,146,146,46
"4389",88,"[22]qHoIoHcoxHnJHGqKCxtBAD",274,0.996364,22,275,1,274,1,1,0,1,1,115,114,160,160,46
"4390",89,"[22]qHoIoHcoxHnJHGqKCxtBAD",292,0.996587,22,293,1,292,1,1,0,1,1,158,157,135,135,46
"4391",90,"[22]qHoIoHcoxHnJHGqKCxtBAD",285,0.996503,22,286,1,285,1,1,0,1,1,153,152,133,133,46
"4392",91,"[22]qHoIoHcoxHnJHGqKCxtBAD",290,0.996564,22,291,1,290,1,1,0,1,1,150,149,141,141,46
"4393",92,"[22]qHoIoHcoxHnJHGqKCxtBAD",281,0.996454,22,282,1,281,1,1,0,1,1,146,145,136,136,46
"4394",93,"[22]qHoIoHcoxHnJHGqKCxtBAD",285,0.996503,22,286,1,285,1,1,0,1,1,148,147,138,138,46
"4395",94,"[22]qHoIoHcoxHnJHGqKCxtBAD",282,0.996466,22,283,1,282,1,1,0,1,1,152,151,131,131,46
"4396",95,"[22]qHoIoHcoxHnJHGqKCxtBAD",281,0.996454,22,282,1,281,1,1,0,1,1,142,141,140,140,46
"4397",96,"[22]qHoIoHcoxHnJHGqKCxtBAD",276,0.99639,22,277,1,276,1,1,0,1,1,138,137,139,139,46
"4398",97,"[22]qHoIoHcoxHnJHGqKCxtBAD",282,0.996466,22,283,1,282,1,1,0,1,1,146,145,137,137,46
"4399",98,"[22]qHoIoHcoxHnJHGqKCxtBAD",279,0.996429,22,280,1,279,1,1,0,1,1,145,144,135,135,46
"4400",99,"[22]qHoIoHcoxHnJHGqKCxtBAD",272,0.996337,22,273,1,272,1,1,0,1,1,138,137,135,135,46
"4401",0,"[24]JAHoIFoHcowHnJHGqKCxmjfI",284,0.996491,24,285,1,284,1,1,0,1,1,148,147,137,137,47
"4402",1,"[24]JAHoIFoHcowHnJHGqKCxmjfI",285,0.996503,24,286,1,285,1,1,0,1,1,140,139,146,146,47
"4403",2,"[24]JAHoIFoHcowHnJHGqKCxmjfI",278,0.996416,24,279,1,278,1,1,0,1,1,131,130,148,148,47
"4404",3,"[24]JAHoIFoHcowHnJHGqKCxmjfI",282,0.996466,24,283,1,282,1,1,0,1,1,147,146,136,136,47
"4405",4,"[24]JAHoIFoHcowHnJHGqKCxmjfI",285,0.996503,24,286,1,285,1,1,0,1,1,150,149,136,136,47
"4406",5,"[24]JAHoIFoHcowHnJHGqKCxmjfI",288,0.99654,24,289,1,288,1,1,0,1,1,165,164,124,124,47
"4407",6,"[24]JAHoIFoHcowHnJHGqKCxmjfI",278,0.996416,24,279,1,278,1,1,0,1,1,139,138,140,140,47
"4408",7,"[24]JAHoIFoHcowHnJHGqKCxmjfI",280,0.996441,24,281,1,280,1,1,0,1,1,133,132,148,148,47
"4409",8,"[24]JAHoIFoHcowHnJHGqKCxmjfI",280,0.996441,24,281,1,280,1,1,0,1,1,141,140,140,140,47
"4410",9,"[24]JAHoIFoHcowHnJHGqKCxmjfI",286,0.996516,24,287,1,286,1,1,0,1,1,146,145,141,141,47
"4411",10,"[24]JAHoIFoHcowHnJHGqKCxmjfI",281,0.996454,24,282,1,281,1,1,0,1,1,125,124,157,157,47
"4412",11,"[24]JAHoIFoHcowHnJHGqKCxmjfI",282,0.996466,24,283,1,282,1,1,0,1,1,142,141,141,141,47
"4413",12,"[24]JAHoIFoHcowHnJHGqKCxmjfI",284,0.996491,24,285,1,284,1,1,0,1,1,152,151,133,133,47
"4414",13,"[24]JAHoIFoHcowHnJHGqKCxmjfI",281,0.996454,24,282,1,281,1,1,0,1,1,151,150,131,131,47
"4415",14,"[24]JAHoIFoHcowHnJHGqKCxmjfI",285,0.996503,24,286,1,285,1,1,0,1,1,134,133,152,152,47
"4416",15,"[24]JAHoIFoHcowHnJHGqKCxmjfI",279,0.996429,24,280,1,279,1,1,0,1,1,141,140,139,139,47
"4417",16,"[24]JAHoIFoHcowHnJHGqKCxmjfI",281,0.996454,24,282,1,281,1,1,0,1,1,140,139,142,142,47
"4418",17,"[24]JAHoIFoHcowHnJHGqKCxmjfI",283,0.996479,24,284,1,283,1,1,0,1,1,150,149,134,134,47
"4419",18,"[24]JAHoIFoHcowHnJHGqKCxmjfI",287,0.996528,24,288,1,287,1,1,0,1,1,157,156,131,131,47
"4420",19,"[24]JAHoIFoHcowHnJHGqKCxmjfI",290,0.996564,24,291,1,290,1,1,0,1,1,146,145,145,145,47
"4421",20,"[24]JAHoIFoHcowHnJHGqKCxmjfI",276,0.99639,24,277,1,276,1,1,0,1,1,135,134,142,142,47
"4422",21,"[24]JAHoIFoHcowHnJHGqKCxmjfI",288,0.99654,24,289,1,288,1,1,0,1,1,149,148,140,140,47
"4423",22,"[24]JAHoIFoHcowHnJHGqKCxmjfI",286,0.996516,24,287,1,286,1,1,0,1,1,146,145,141,141,47
"4424",23,"[24]JAHoIFoHcowHnJHGqKCxmjfI",290,0.996564,24,291,1,290,1,1,0,1,1,145,144,146,146,47
"4425",24,"[24]JAHoIFoHcowHnJHGqKCxmjfI",279,0.996429,24,280,1,279,1,1,0,1,1,127,126,153,153,47
"4426",25,"[24]JAHoIFoHcowHnJHGqKCxmjfI",286,0.996516,24,287,1,286,1,1,0,1,1,154,153,133,133,47
"4427",26,"[24]JAHoIFoHcowHnJHGqKCxmjfI",276,0.99639,24,277,1,276,1,1,0,1,1,130,129,147,147,47
"4428",27,"[24]JAHoIFoHcowHnJHGqKCxmjfI",286,0.996516,24,287,1,286,1,1,0,1,1,149,148,138,138,47
"4429",28,"[24]JAHoIFoHcowHnJHGqKCxmjfI",280,0.996441,24,281,1,280,1,1,0,1,1,136,135,145,145,47
"4430",29,"[24]JAHoIFoHcowHnJHGqKCxmjfI",284,0.996491,24,285,1,284,1,1,0,1,1,127,126,158,158,47
"4431",30,"[24]JAHoIFoHcowHnJHGqKCxmjfI",281,0.996454,24,282,1,281,1,1,0,1,1,133,132,149,149,47
"4432",31,"[24]JAHoIFoHcowHnJHGqKCxmjfI",283,0.996479,24,284,1,283,1,1,0,1,1,140,139,144,144,47
"4433",32,"[24]JAHoIFoHcowHnJHGqKCxmjfI",285,0.996503,24,286,1,285,1,1,0,1,1,148,147,138,138,47
"4434",33,"[24]JAHoIFoHcowHnJHGqKCxmjfI",277,0.996403,24,278,1,277,1,1,0,1,1,149,148,129,129,47
"4435",34,"[24]JAHoIFoHcowHnJHGqKCxmjfI",279,0.996429,24,280,1,279,1,1,0,1,1,138,137,142,142,47
"4436",35,"[24]JAHoIFoHcowHnJHGqKCxmjfI",284,0.996491,24,285,1,284,1,1,0,1,1,140,139,145,145,47
"4437",36,"[24]JAHoIFoHcowHnJHGqKCxmjfI",280,0.996441,24,281,1,280,1,1,0,1,1,128,127,153,153,47
"4438",37,"[24]JAHoIFoHcowHnJHGqKCxmjfI",287,0.996528,24,288,1,287,1,1,0,1,1,156,155,132,132,47
"4439",38,"[24]JAHoIFoHcowHnJHGqKCxmjfI",286,0.996516,24,287,1,286,1,1,0,1,1,138,137,149,149,47
"4440",39,"[24]JAHoIFoHcowHnJHGqKCxmjfI",277,0.996403,24,278,1,277,1,1,0,1,1,128,127,150,150,47
"4441",40,"[24]JAHoIFoHcowHnJHGqKCxmjfI",287,0.996528,24,288,1,287,1,1,0,1,1,142,141,146,146,47
"4442",41,"[24]JAHoIFoHcowHnJHGqKCxmjfI",292,0.996587,24,293,1,292,1,1,0,1,1,163,162,130,130,47
"4443",42,"[24]JAHoIFoHcowHnJHGqKCxmjfI",279,0.996429,24,280,1,279,1,1,0,1,1,135,134,145,145,47
"4444",43,"[24]JAHoIFoHcowHnJHGqKCxmjfI",287,0.996528,24,288,1,287,1,1,0,1,1,139,138,149,149,47
"4445",44,"[24]JAHoIFoHcowHnJHGqKCxmjfI",279,0.996429,24,280,1,279,1,1,0,1,1,148,147,132,132,47
"4446",45,"[24]JAHoIFoHcowHnJHGqKCxmjfI",281,0.996454,24,282,1,281,1,1,0,1,1,149,148,133,133,47
"4447",46,"[24]JAHoIFoHcowHnJHGqKCxmjfI",282,0.996466,24,283,1,282,1,1,0,1,1,144,143,139,139,47
"4448",47,"[24]JAHoIFoHcowHnJHGqKCxmjfI",283,0.996479,24,284,1,283,1,1,0,1,1,136,135,148,148,47
"4449",48,"[24]JAHoIFoHcowHnJHGqKCxmjfI",280,0.996441,24,281,1,280,1,1,0,1,1,138,137,143,143,47
"4450",49,"[24]JAHoIFoHcowHnJHGqKCxmjfI",280,0.996441,24,281,1,280,1,1,0,1,1,137,136,144,144,47
"4451",50,"[24]JAHoIFoHcowHnJHGqKCxmjfI",289,0.996552,24,290,1,289,1,1,0,1,1,145,144,145,145,47
"4452",51,"[24]JAHoIFoHcowHnJHGqKCxmjfI",283,0.996479,24,284,1,283,1,1,0,1,1,135,134,149,149,47
"4453",52,"[24]JAHoIFoHcowHnJHGqKCxmjfI",285,0.996503,24,286,1,285,1,1,0,1,1,159,158,127,127,47
"4454",53,"[24]JAHoIFoHcowHnJHGqKCxmjfI",286,0.996516,24,287,1,286,1,1,0,1,1,141,140,146,146,47
"4455",54,"[24]JAHoIFoHcowHnJHGqKCxmjfI",282,0.996466,24,283,1,282,1,1,0,1,1,133,132,150,150,47
"4456",55,"[24]JAHoIFoHcowHnJHGqKCxmjfI",280,0.996441,24,281,1,280,1,1,0,1,1,149,148,132,132,47
"4457",56,"[24]JAHoIFoHcowHnJHGqKCxmjfI",285,0.996503,24,286,1,285,1,1,0,1,1,145,144,141,141,47
"4458",57,"[24]JAHoIFoHcowHnJHGqKCxmjfI",276,0.99639,24,277,1,276,1,1,0,1,1,146,145,131,131,47
"4459",58,"[24]JAHoIFoHcowHnJHGqKCxmjfI",281,0.996454,24,282,1,281,1,1,0,1,1,136,135,146,146,47
"4460",59,"[24]JAHoIFoHcowHnJHGqKCxmjfI",277,0.996403,24,278,1,277,1,1,0,1,1,129,128,149,149,47
"4461",60,"[24]JAHoIFoHcowHnJHGqKCxmjfI",281,0.996454,24,282,1,281,1,1,0,1,1,153,152,129,129,47
"4462",61,"[24]JAHoIFoHcowHnJHGqKCxmjfI",287,0.996528,24,288,1,287,1,1,0,1,1,149,148,139,139,47
"4463",62,"[24]JAHoIFoHcowHnJHGqKCxmjfI",286,0.996516,24,287,1,286,1,1,0,1,1,150,149,137,137,47
"4464",63,"[24]JAHoIFoHcowHnJHGqKCxmjfI",284,0.996491,24,285,1,284,1,1,0,1,1,134,133,151,151,47
"4465",64,"[24]JAHoIFoHcowHnJHGqKCxmjfI",273,0.99635,24,274,1,273,1,1,0,1,1,130,129,144,144,47
"4466",65,"[24]JAHoIFoHcowHnJHGqKCxmjfI",275,0.996377,24,276,1,275,1,1,0,1,1,133,132,143,143,47
"4467",66,"[24]JAHoIFoHcowHnJHGqKCxmjfI",279,0.996429,24,280,1,279,1,1,0,1,1,152,151,128,128,47
"4468",67,"[24]JAHoIFoHcowHnJHGqKCxmjfI",278,0.996416,24,279,1,278,1,1,0,1,1,141,140,138,138,47
"4469",68,"[24]JAHoIFoHcowHnJHGqKCxmjfI",281,0.996454,24,282,1,281,1,1,0,1,1,141,140,141,141,47
"4470",69,"[24]JAHoIFoHcowHnJHGqKCxmjfI",286,0.996516,24,287,1,286,1,1,0,1,1,135,134,152,152,47
"4471",70,"[24]JAHoIFoHcowHnJHGqKCxmjfI",281,0.996454,24,282,1,281,1,1,0,1,1,136,135,146,146,47
"4472",71,"[24]JAHoIFoHcowHnJHGqKCxmjfI",285,0.996503,24,286,1,285,1,1,0,1,1,140,139,146,146,47
"4473",72,"[24]JAHoIFoHcowHnJHGqKCxmjfI",277,0.996403,24,278,1,277,1,1,0,1,1,154,153,124,124,47
"4474",73,"[24]JAHoIFoHcowHnJHGqKCxmjfI",285,0.996503,24,286,1,285,1,1,0,1,1,150,149,136,136,47
"4475",74,"[24]JAHoIFoHcowHnJHGqKCxmjfI",283,0.996479,24,284,1,283,1,1,0,1,1,151,150,133,133,47
"4476",75,"[24]JAHoIFoHcowHnJHGqKCxmjfI",279,0.996429,24,280,1,279,1,1,0,1,1,122,121,158,158,47
"4477",76,"[24]JAHoIFoHcowHnJHGqKCxmjfI",280,0.996441,24,281,1,280,1,1,0,1,1,140,139,141,141,47
"4478",77,"[24]JAHoIFoHcowHnJHGqKCxmjfI",287,0.996528,24,288,1,287,1,1,0,1,1,153,152,135,135,47
"4479",78,"[24]JAHoIFoHcowHnJHGqKCxmjfI",291,0.996575,24,292,1,291,1,1,0,1,1,153,152,139,139,47
"4480",79,"[24]JAHoIFoHcowHnJHGqKCxmjfI",288,0.99654,24,289,1,288,1,1,0,1,1,152,151,137,137,47
"4481",80,"[24]JAHoIFoHcowHnJHGqKCxmjfI",278,0.996416,24,279,1,278,1,1,0,1,1,148,147,131,131,47
"4482",81,"[24]JAHoIFoHcowHnJHGqKCxmjfI",283,0.996479,24,284,1,283,1,1,0,1,1,146,145,138,138,47
"4483",82,"[24]JAHoIFoHcowHnJHGqKCxmjfI",285,0.996503,24,286,1,285,1,1,0,1,1,140,139,146,146,47
"4484",83,"[24]JAHoIFoHcowHnJHGqKCxmjfI",280,0.996441,24,281,1,280,1,1,0,1,1,142,141,139,139,47
"4485",84,"[24]JAHoIFoHcowHnJHGqKCxmjfI",282,0.996466,24,283,1,282,1,1,0,1,1,135,134,148,148,47
"4486",85,"[24]JAHoIFoHcowHnJHGqKCxmjfI",282,0.996466,24,283,1,282,1,1,0,1,1,137,136,146,146,47
"4487",86,"[24]JAHoIFoHcowHnJHGqKCxmjfI",277,0.996403,24,278,1,277,1,1,0,1,1,137,136,141,141,47
"4488",87,"[24]JAHoIFoHcowHnJHGqKCxmjfI",284,0.996491,24,285,1,284,1,1,0,1,1,135,134,150,150,47
"4489",88,"[24]JAHoIFoHcowHnJHGqKCxmjfI",286,0.996516,24,287,1,286,1,1,0,1,1,140,139,147,147,47
"4490",89,"[24]JAHoIFoHcowHnJHGqKCxmjfI",282,0.996466,24,283,1,282,1,1,0,1,1,139,138,144,144,47
"4491",90,"[24]JAHoIFoHcowHnJHGqKCxmjfI",284,0.996491,24,285,1,284,1,1,0,1,1,143,142,142,142,47
"4492",91,"[24]JAHoIFoHcowHnJHGqKCxmjfI",281,0.996454,24,282,1,281,1,1,0,1,1,134,133,148,148,47
"4493",92,"[24]JAHoIFoHcowHnJHGqKCxmjfI",282,0.996466,24,283,1,282,1,1,0,1,1,122,121,161,161,47
"4494",93,"[24]JAHoIFoHcowHnJHGqKCxmjfI",283,0.996479,24,284,1,283,1,1,0,1,1,139,138,145,145,47
"4495",94,"[24]JAHoIFoHcowHnJHGqKCxmjfI",286,0.996516,24,287,1,286,1,1,0,1,1,153,152,134,134,47
"4496",95,"[24]JAHoIFoHcowHnJHGqKCxmjfI",282,0.996466,24,283,1,282,1,1,0,1,1,149,148,134,134,47
"4497",96,"[24]JAHoIFoHcowHnJHGqKCxmjfI",277,0.996403,24,278,1,277,1,1,0,1,1,123,122,155,155,47
"4498",97,"[24]JAHoIFoHcowHnJHGqKCxmjfI",289,0.996552,24,290,1,289,1,1,0,1,1,157,156,133,133,47
"4499",98,"[24]JAHoIFoHcowHnJHGqKCxmjfI",282,0.996466,24,283,1,282,1,1,0,1,1,138,137,145,145,47
"4500",99,"[24]JAHoIFoHcowHnJHGqKCxmjfI",290,0.996564,24,291,1,290,1,1,0,1,1,148,147,143,143,47
"4501",0,"[25]iGoIboHcotHnJHGqKCyHgfGDt",283,0.996479,25,284,1,283,1,1,0,1,1,137,136,147,147,48
"4502",1,"[25]iGoIboHcotHnJHGqKCyHgfGDt",289,0.996552,25,290,1,289,1,1,0,1,1,134,133,156,156,48
"4503",2,"[25]iGoIboHcotHnJHGqKCyHgfGDt",283,0.996479,25,284,1,283,1,1,0,1,1,139,138,145,145,48
"4504",3,"[25]iGoIboHcotHnJHGqKCyHgfGDt",285,0.996503,25,286,1,285,1,1,0,1,1,150,149,136,136,48
"4505",4,"[25]iGoIboHcotHnJHGqKCyHgfGDt",278,0.996416,25,279,1,278,1,1,0,1,1,122,121,157,157,48
"4506",5,"[25]iGoIboHcotHnJHGqKCyHgfGDt",284,0.996491,25,285,1,284,1,1,0,1,1,149,148,136,136,48
"4507",6,"[25]iGoIboHcotHnJHGqKCyHgfGDt",287,0.996528,25,288,1,287,1,1,0,1,1,146,145,142,142,48
"4508",7,"[25]iGoIboHcotHnJHGqKCyHgfGDt",281,0.996454,25,282,1,281,1,1,0,1,1,142,141,140,140,48
"4509",8,"[25]iGoIboHcotHnJHGqKCyHgfGDt",283,0.996479,25,284,1,283,1,1,0,1,1,149,148,135,135,48
"4510",9,"[25]iGoIboHcotHnJHGqKCyHgfGDt",279,0.996429,25,280,1,279,1,1,0,1,1,137,136,143,143,48
"4511",10,"[25]iGoIboHcotHnJHGqKCyHgfGDt",279,0.996429,25,280,1,279,1,1,0,1,1,157,156,123,123,48
"4512",11,"[25]iGoIboHcotHnJHGqKCyHgfGDt",281,0.996454,25,282,1,281,1,1,0,1,1,139,138,143,143,48
"4513",12,"[25]iGoIboHcotHnJHGqKCyHgfGDt",278,0.996416,25,279,1,278,1,1,0,1,1,145,144,134,134,48
"4514",13,"[25]iGoIboHcotHnJHGqKCyHgfGDt",280,0.996441,25,281,1,280,1,1,0,1,1,151,150,130,130,48
"4515",14,"[25]iGoIboHcotHnJHGqKCyHgfGDt",271,0.996324,25,272,1,271,1,1,0,1,1,139,138,133,133,48
"4516",15,"[25]iGoIboHcotHnJHGqKCyHgfGDt",279,0.996429,25,280,1,279,1,1,0,1,1,147,146,133,133,48
"4517",16,"[25]iGoIboHcotHnJHGqKCyHgfGDt",292,0.996587,25,293,1,292,1,1,0,1,1,145,144,148,148,48
"4518",17,"[25]iGoIboHcotHnJHGqKCyHgfGDt",286,0.996516,25,287,1,286,1,1,0,1,1,146,145,141,141,48
"4519",18,"[25]iGoIboHcotHnJHGqKCyHgfGDt",286,0.996516,25,287,1,286,1,1,0,1,1,145,144,142,142,48
"4520",19,"[25]iGoIboHcotHnJHGqKCyHgfGDt",276,0.99639,25,277,1,276,1,1,0,1,1,144,143,133,133,48
"4521",20,"[25]iGoIboHcotHnJHGqKCyHgfGDt",281,0.996454,25,282,1,281,1,1,0,1,1,142,141,140,140,48
"4522",21,"[25]iGoIboHcotHnJHGqKCyHgfGDt",274,0.996364,25,275,1,274,1,1,0,1,1,133,132,142,142,48
"4523",22,"[25]iGoIboHcotHnJHGqKCyHgfGDt",280,0.996441,25,281,1,280,1,1,0,1,1,147,146,134,134,48
"4524",23,"[25]iGoIboHcotHnJHGqKCyHgfGDt",288,0.99654,25,289,1,288,1,1,0,1,1,149,148,140,140,48
"4525",24,"[25]iGoIboHcotHnJHGqKCyHgfGDt",283,0.996479,25,284,1,283,1,1,0,1,1,145,144,139,139,48
"4526",25,"[25]iGoIboHcotHnJHGqKCyHgfGDt",283,0.996479,25,284,1,283,1,1,0,1,1,136,135,148,148,48
"4527",26,"[25]iGoIboHcotHnJHGqKCyHgfGDt",272,0.996337,25,273,1,272,1,1,0,1,1,121,120,152,152,48
"4528",27,"[25]iGoIboHcotHnJHGqKCyHgfGDt",281,0.996454,25,282,1,281,1,1,0,1,1,147,146,135,135,48
"4529",28,"[25]iGoIboHcotHnJHGqKCyHgfGDt",286,0.996516,25,287,1,286,1,1,0,1,1,147,146,140,140,48
"4530",29,"[25]iGoIboHcotHnJHGqKCyHgfGDt",278,0.996416,25,279,1,278,1,1,0,1,1,141,140,138,138,48
"4531",30,"[25]iGoIboHcotHnJHGqKCyHgfGDt",275,0.996377,25,276,1,275,1,1,0,1,1,143,142,133,133,48
"4532",31,"[25]iGoIboHcotHnJHGqKCyHgfGDt",286,0.996516,25,287,1,286,1,1,0,1,1,157,156,130,130,48
"4533",32,"[25]iGoIboHcotHnJHGqKCyHgfGDt",276,0.99639,25,277,1,276,1,1,0,1,1,125,124,152,152,48
"4534",33,"[25]iGoIboHcotHnJHGqKCyHgfGDt",283,0.996479,25,284,1,283,1,1,0,1,1,135,134,149,149,48
"4535",34,"[25]iGoIboHcotHnJHGqKCyHgfGDt",292,0.996587,25,293,1,292,1,1,0,1,1,148,147,145,145,48
"4536",35,"[25]iGoIboHcotHnJHGqKCyHgfGDt",272,0.996337,25,273,1,272,1,1,0,1,1,135,134,138,138,48
"4537",36,"[25]iGoIboHcotHnJHGqKCyHgfGDt",282,0.996466,25,283,1,282,1,1,0,1,1,160,159,123,123,48
"4538",37,"[25]iGoIboHcotHnJHGqKCyHgfGDt",281,0.996454,25,282,1,281,1,1,0,1,1,146,145,136,136,48
"4539",38,"[25]iGoIboHcotHnJHGqKCyHgfGDt",278,0.996416,25,279,1,278,1,1,0,1,1,144,143,135,135,48
"4540",39,"[25]iGoIboHcotHnJHGqKCyHgfGDt",274,0.996364,25,275,1,274,1,1,0,1,1,139,138,136,136,48
"4541",40,"[25]iGoIboHcotHnJHGqKCyHgfGDt",280,0.996441,25,281,1,280,1,1,0,1,1,160,159,121,121,48
"4542",41,"[25]iGoIboHcotHnJHGqKCyHgfGDt",284,0.996491,25,285,1,284,1,1,0,1,1,150,149,135,135,48
"4543",42,"[25]iGoIboHcotHnJHGqKCyHgfGDt",281,0.996454,25,282,1,281,1,1,0,1,1,133,132,149,149,48
"4544",43,"[25]iGoIboHcotHnJHGqKCyHgfGDt",270,0.99631,25,271,1,270,1,1,0,1,1,130,129,141,141,48
"4545",44,"[25]iGoIboHcotHnJHGqKCyHgfGDt",287,0.996528,25,288,1,287,1,1,0,1,1,139,138,149,149,48
"4546",45,"[25]iGoIboHcotHnJHGqKCyHgfGDt",283,0.996479,25,284,1,283,1,1,0,1,1,155,154,129,129,48
"4547",46,"[25]iGoIboHcotHnJHGqKCyHgfGDt",280,0.996441,25,281,1,280,1,1,0,1,1,134,133,147,147,48
"4548",47,"[25]iGoIboHcotHnJHGqKCyHgfGDt",288,0.99654,25,289,1,288,1,1,0,1,1,142,141,147,147,48
"4549",48,"[25]iGoIboHcotHnJHGqKCyHgfGDt",275,0.996377,25,276,1,275,1,1,0,1,1,126,125,150,150,48
"4550",49,"[25]iGoIboHcotHnJHGqKCyHgfGDt",287,0.996528,25,288,1,287,1,1,0,1,1,150,149,138,138,48
"4551",50,"[25]iGoIboHcotHnJHGqKCyHgfGDt",281,0.996454,25,282,1,281,1,1,0,1,1,138,137,144,144,48
"4552",51,"[25]iGoIboHcotHnJHGqKCyHgfGDt",279,0.996429,25,280,1,279,1,1,0,1,1,150,149,130,130,48
"4553",52,"[25]iGoIboHcotHnJHGqKCyHgfGDt",275,0.996377,25,276,1,275,1,1,0,1,1,130,129,146,146,48
"4554",53,"[25]iGoIboHcotHnJHGqKCyHgfGDt",280,0.996441,25,281,1,280,1,1,0,1,1,156,155,125,125,48
"4555",54,"[25]iGoIboHcotHnJHGqKCyHgfGDt",278,0.996416,25,279,1,278,1,1,0,1,1,148,147,131,131,48
"4556",55,"[25]iGoIboHcotHnJHGqKCyHgfGDt",281,0.996454,25,282,1,281,1,1,0,1,1,140,139,142,142,48
"4557",56,"[25]iGoIboHcotHnJHGqKCyHgfGDt",283,0.996479,25,284,1,283,1,1,0,1,1,144,143,140,140,48
"4558",57,"[25]iGoIboHcotHnJHGqKCyHgfGDt",282,0.996466,25,283,1,282,1,1,0,1,1,149,148,134,134,48
"4559",58,"[25]iGoIboHcotHnJHGqKCyHgfGDt",272,0.996337,25,273,1,272,1,1,0,1,1,120,119,153,153,48
"4560",59,"[25]iGoIboHcotHnJHGqKCyHgfGDt",278,0.996416,25,279,1,278,1,1,0,1,1,139,138,140,140,48
"4561",60,"[25]iGoIboHcotHnJHGqKCyHgfGDt",278,0.996416,25,279,1,278,1,1,0,1,1,139,138,140,140,48
"4562",61,"[25]iGoIboHcotHnJHGqKCyHgfGDt",289,0.996552,25,290,1,289,1,1,0,1,1,159,158,131,131,48
"4563",62,"[25]iGoIboHcotHnJHGqKCyHgfGDt",283,0.996479,25,284,1,283,1,1,0,1,1,150,149,134,134,48
"4564",63,"[25]iGoIboHcotHnJHGqKCyHgfGDt",283,0.996479,25,284,1,283,1,1,0,1,1,138,137,146,146,48
"4565",64,"[25]iGoIboHcotHnJHGqKCyHgfGDt",270,0.99631,25,271,1,270,1,1,0,1,1,132,131,139,139,48
"4566",65,"[25]iGoIboHcotHnJHGqKCyHgfGDt",278,0.996416,25,279,1,278,1,1,0,1,1,134,133,145,145,48
"4567",66,"[25]iGoIboHcotHnJHGqKCyHgfGDt",275,0.996377,25,276,1,275,1,1,0,1,1,129,128,147,147,48
"4568",67,"[25]iGoIboHcotHnJHGqKCyHgfGDt",279,0.996429,25,280,1,279,1,1,0,1,1,149,148,131,131,48
"4569",68,"[25]iGoIboHcotHnJHGqKCyHgfGDt",283,0.996479,25,284,1,283,1,1,0,1,1,143,142,141,141,48
"4570",69,"[25]iGoIboHcotHnJHGqKCyHgfGDt",285,0.996503,25,286,1,285,1,1,0,1,1,151,150,135,135,48
"4571",70,"[25]iGoIboHcotHnJHGqKCyHgfGDt",285,0.996503,25,286,1,285,1,1,0,1,1,142,141,144,144,48
"4572",71,"[25]iGoIboHcotHnJHGqKCyHgfGDt",281,0.996454,25,282,1,281,1,1,0,1,1,143,142,139,139,48
"4573",72,"[25]iGoIboHcotHnJHGqKCyHgfGDt",275,0.996377,25,276,1,275,1,1,0,1,1,138,137,138,138,48
"4574",73,"[25]iGoIboHcotHnJHGqKCyHgfGDt",280,0.996441,25,281,1,280,1,1,0,1,1,145,144,136,136,48
"4575",74,"[25]iGoIboHcotHnJHGqKCyHgfGDt",282,0.996466,25,283,1,282,1,1,0,1,1,149,148,134,134,48
"4576",75,"[25]iGoIboHcotHnJHGqKCyHgfGDt",284,0.996491,25,285,1,284,1,1,0,1,1,142,141,143,143,48
"4577",76,"[25]iGoIboHcotHnJHGqKCyHgfGDt",289,0.996552,25,290,1,289,1,1,0,1,1,148,147,142,142,48
"4578",77,"[25]iGoIboHcotHnJHGqKCyHgfGDt",278,0.996416,25,279,1,278,1,1,0,1,1,139,138,140,140,48
"4579",78,"[25]iGoIboHcotHnJHGqKCyHgfGDt",278,0.996416,25,279,1,278,1,1,0,1,1,132,131,147,147,48
"4580",79,"[25]iGoIboHcotHnJHGqKCyHgfGDt",290,0.996564,25,291,1,290,1,1,0,1,1,151,150,140,140,48
"4581",80,"[25]iGoIboHcotHnJHGqKCyHgfGDt",279,0.996429,25,280,1,279,1,1,0,1,1,134,133,146,146,48
"4582",81,"[25]iGoIboHcotHnJHGqKCyHgfGDt",280,0.996441,25,281,1,280,1,1,0,1,1,137,136,144,144,48
"4583",82,"[25]iGoIboHcotHnJHGqKCyHgfGDt",284,0.996491,25,285,1,284,1,1,0,1,1,144,143,141,141,48
"4584",83,"[25]iGoIboHcotHnJHGqKCyHgfGDt",281,0.996454,25,282,1,281,1,1,0,1,1,137,136,145,145,48
"4585",84,"[25]iGoIboHcotHnJHGqKCyHgfGDt",281,0.996454,25,282,1,281,1,1,0,1,1,145,144,137,137,48
"4586",85,"[25]iGoIboHcotHnJHGqKCyHgfGDt",280,0.996441,25,281,1,280,1,1,0,1,1,150,149,131,131,48
"4587",86,"[25]iGoIboHcotHnJHGqKCyHgfGDt",284,0.996491,25,285,1,284,1,1,0,1,1,137,136,148,148,48
"4588",87,"[25]iGoIboHcotHnJHGqKCyHgfGDt",282,0.996466,25,283,1,282,1,1,0,1,1,140,139,143,143,48
"4589",88,"[25]iGoIboHcotHnJHGqKCyHgfGDt",276,0.99639,25,277,1,276,1,1,0,1,1,130,129,147,147,48
"4590",89,"[25]iGoIboHcotHnJHGqKCyHgfGDt",284,0.996491,25,285,1,284,1,1,0,1,1,156,155,129,129,48
"4591",90,"[25]iGoIboHcotHnJHGqKCyHgfGDt",290,0.996564,25,291,1,290,1,1,0,1,1,138,137,153,153,48
"4592",91,"[25]iGoIboHcotHnJHGqKCyHgfGDt",282,0.996466,25,283,1,282,1,1,0,1,1,142,141,141,141,48
"4593",92,"[25]iGoIboHcotHnJHGqKCyHgfGDt",285,0.996503,25,286,1,285,1,1,0,1,1,134,133,152,152,48
"4594",93,"[25]iGoIboHcotHnJHGqKCyHgfGDt",279,0.996429,25,280,1,279,1,1,0,1,1,130,129,150,150,48
"4595",94,"[25]iGoIboHcotHnJHGqKCyHgfGDt",282,0.996466,25,283,1,282,1,1,0,1,1,157,156,126,126,48
"4596",95,"[25]iGoIboHcotHnJHGqKCyHgfGDt",275,0.996377,25,276,1,275,1,1,0,1,1,140,139,136,136,48
"4597",96,"[25]iGoIboHcotHnJHGqKCyHgfGDt",286,0.996516,25,287,1,286,1,1,0,1,1,152,151,135,135,48
"4598",97,"[25]iGoIboHcotHnJHGqKCyHgfGDt",283,0.996479,25,284,1,283,1,1,0,1,1,138,137,146,146,48
"4599",98,"[25]iGoIboHcotHnJHGqKCyHgfGDt",284,0.996491,25,285,1,284,1,1,0,1,1,149,148,136,136,48
"4600",99,"[25]iGoIboHcotHnJHGqKCyHgfGDt",280,0.996441,25,281,1,280,1,1,0,1,1,133,132,148,148,48
"4601",0,"[27]JnHoIoHcotHnJqGKCrsJiEHlunI",299,0.996667,27,300,1,299,1,1,0,1,1,148,147,152,152,49
"4602",1,"[27]JnHoIoHcotHnJqGKCrsJiEHlunI",296,0.996633,27,297,1,296,1,1,0,1,1,143,142,154,154,49
"4603",2,"[27]JnHoIoHcotHnJqGKCrsJiEHlunI",294,0.99661,27,295,1,294,1,1,0,1,1,142,141,153,153,49
"4604",3,"[27]JnHoIoHcotHnJqGKCrsJiEHlunI",298,0.996656,27,299,1,298,1,1,0,1,1,152,151,147,147,49
"4605",4,"[27]JnHoIoHcotHnJqGKCrsJiEHlunI",295,0.996622,27,296,1,295,1,1,0,1,1,140,139,156,156,49
"4606",5,"[27]JnHoIoHcotHnJqGKCrsJiEHlunI",295,0.996622,27,296,1,295,1,1,0,1,1,144,143,152,152,49
"4607",6,"[27]JnHoIoHcotHnJqGKCrsJiEHlunI",298,0.996656,27,299,1,298,1,1,0,1,1,147,146,152,152,49
"4608",7,"[27]JnHoIoHcotHnJqGKCrsJiEHlunI",301,0.996689,27,302,1,301,1,1,0,1,1,160,159,142,142,49
"4609",8,"[27]JnHoIoHcotHnJqGKCrsJiEHlunI",299,0.996667,27,300,1,299,1,1,0,1,1,154,153,146,146,49
"4610",9,"[27]JnHoIoHcotHnJqGKCrsJiEHlunI",300,0.996678,27,301,1,300,1,1,0,1,1,151,150,150,150,49
"4611",10,"[27]JnHoIoHcotHnJqGKCrsJiEHlunI",294,0.99661,27,295,1,294,1,1,0,1,1,141,140,154,154,49
"4612",11,"[27]JnHoIoHcotHnJqGKCrsJiEHlunI",296,0.996633,27,297,1,296,1,1,0,1,1,148,147,149,149,49
"4613",12,"[27]JnHoIoHcotHnJqGKCrsJiEHlunI",299,0.996667,27,300,1,299,1,1,0,1,1,148,147,152,152,49
"4614",13,"[27]JnHoIoHcotHnJqGKCrsJiEHlunI",293,0.996599,27,294,1,293,1,1,0,1,1,136,135,158,158,49
"4615",14,"[27]JnHoIoHcotHnJqGKCrsJiEHlunI",291,0.996575,27,292,1,291,1,1,0,1,1,129,128,163,163,49
"4616",15,"[27]JnHoIoHcotHnJqGKCrsJiEHlunI",299,0.996667,27,300,1,299,1,1,0,1,1,153,152,147,147,49
"4617",16,"[27]JnHoIoHcotHnJqGKCrsJiEHlunI",301,0.996689,27,302,1,301,1,1,0,1,1,160,159,142,142,49
"4618",17,"[27]JnHoIoHcotHnJqGKCrsJiEHlunI",301,0.996689,27,302,1,301,1,1,0,1,1,160,159,142,142,49
"4619",18,"[27]JnHoIoHcotHnJqGKCrsJiEHlunI",298,0.996656,27,299,1,298,1,1,0,1,1,146,145,153,153,49
"4620",19,"[27]JnHoIoHcotHnJqGKCrsJiEHlunI",294,0.99661,27,295,1,294,1,1,0,1,1,139,138,156,156,49
"4621",20,"[27]JnHoIoHcotHnJqGKCrsJiEHlunI",298,0.996656,27,299,1,298,1,1,0,1,1,152,151,147,147,49
"4622",21,"[27]JnHoIoHcotHnJqGKCrsJiEHlunI",300,0.996678,27,301,1,300,1,1,0,1,1,164,163,137,137,49
"4623",22,"[27]JnHoIoHcotHnJqGKCrsJiEHlunI",301,0.996689,27,302,1,301,1,1,0,1,1,156,155,146,146,49
"4624",23,"[27]JnHoIoHcotHnJqGKCrsJiEHlunI",299,0.996667,27,300,1,299,1,1,0,1,1,157,156,143,143,49
"4625",24,"[27]JnHoIoHcotHnJqGKCrsJiEHlunI",293,0.996599,27,294,1,293,1,1,0,1,1,138,137,156,156,49
"4626",25,"[27]JnHoIoHcotHnJqGKCrsJiEHlunI",292,0.996587,27,293,1,292,1,1,0,1,1,146,145,147,147,49
"4627",26,"[27]JnHoIoHcotHnJqGKCrsJiEHlunI",298,0.996656,27,299,1,298,1,1,0,1,1,154,153,145,145,49
"4628",27,"[27]JnHoIoHcotHnJqGKCrsJiEHlunI",304,0.996721,27,305,1,304,1,1,0,1,1,166,165,139,139,49
"4629",28,"[27]JnHoIoHcotHnJqGKCrsJiEHlunI",299,0.996667,27,300,1,299,1,1,0,1,1,142,141,158,158,49
"4630",29,"[27]JnHoIoHcotHnJqGKCrsJiEHlunI",296,0.996633,27,297,1,296,1,1,0,1,1,154,153,143,143,49
"4631",30,"[27]JnHoIoHcotHnJqGKCrsJiEHlunI",294,0.99661,27,295,1,294,1,1,0,1,1,144,143,151,151,49
"4632",31,"[27]JnHoIoHcotHnJqGKCrsJiEHlunI",290,0.996564,27,291,1,290,1,1,0,1,1,126,125,165,165,49
"4633",32,"[27]JnHoIoHcotHnJqGKCrsJiEHlunI",297,0.996644,27,298,1,297,1,1,0,1,1,147,146,151,151,49
"4634",33,"[27]JnHoIoHcotHnJqGKCrsJiEHlunI",297,0.996644,27,298,1,297,1,1,0,1,1,146,145,152,152,49
"4635",34,"[27]JnHoIoHcotHnJqGKCrsJiEHlunI",305,0.996732,27,306,1,305,1,1,0,1,1,165,164,141,141,49
"4636",35,"[27]JnHoIoHcotHnJqGKCrsJiEHlunI",296,0.996633,27,297,1,296,1,1,0,1,1,144,143,153,153,49
"4637",36,"[27]JnHoIoHcotHnJqGKCrsJiEHlunI",301,0.996689,27,302,1,301,1,1,0,1,1,156,155,146,146,49
"4638",37,"[27]JnHoIoHcotHnJqGKCrsJiEHlunI",293,0.996599,27,294,1,293,1,1,0,1,1,134,133,160,160,49
"4639",38,"[27]JnHoIoHcotHnJqGKCrsJiEHlunI",300,0.996678,27,301,1,300,1,1,0,1,1,160,159,141,141,49
"4640",39,"[27]JnHoIoHcotHnJqGKCrsJiEHlunI",296,0.996633,27,297,1,296,1,1,0,1,1,145,144,152,152,49
"4641",40,"[27]JnHoIoHcotHnJqGKCrsJiEHlunI",301,0.996689,27,302,1,301,1,1,0,1,1,150,149,152,152,49
"4642",41,"[27]JnHoIoHcotHnJqGKCrsJiEHlunI",298,0.996656,27,299,1,298,1,1,0,1,1,152,151,147,147,49
"4643",42,"[27]JnHoIoHcotHnJqGKCrsJiEHlunI",293,0.996599,27,294,1,293,1,1,0,1,1,140,139,154,154,49
"4644",43,"[27]JnHoIoHcotHnJqGKCrsJiEHlunI",299,0.996667,27,300,1,299,1,1,0,1,1,152,151,148,148,49
"4645",44,"[27]JnHoIoHcotHnJqGKCrsJiEHlunI",300,0.996678,27,301,1,300,1,1,0,1,1,160,159,141,141,49
"4646",45,"[27]JnHoIoHcotHnJqGKCrsJiEHlunI",300,0.996678,27,301,1,300,1,1,0,1,1,160,159,141,141,49
"4647",46,"[27]JnHoIoHcotHnJqGKCrsJiEHlunI",299,0.996667,27,300,1,299,1,1,0,1,1,156,155,144,144,49
"4648",47,"[27]JnHoIoHcotHnJqGKCrsJiEHlunI",296,0.996633,27,297,1,296,1,1,0,1,1,148,147,149,149,49
"4649",48,"[27]JnHoIoHcotHnJqGKCrsJiEHlunI",294,0.99661,27,295,1,294,1,1,0,1,1,148,147,147,147,49
"4650",49,"[27]JnHoIoHcotHnJqGKCrsJiEHlunI",290,0.996564,27,291,1,290,1,1,0,1,1,134,133,157,157,49
"4651",50,"[27]JnHoIoHcotHnJqGKCrsJiEHlunI",299,0.996667,27,300,1,299,1,1,0,1,1,147,146,153,153,49
"4652",51,"[27]JnHoIoHcotHnJqGKCrsJiEHlunI",296,0.996633,27,297,1,296,1,1,0,1,1,139,138,158,158,49
"4653",52,"[27]JnHoIoHcotHnJqGKCrsJiEHlunI",300,0.996678,27,301,1,300,1,1,0,1,1,157,156,144,144,49
"4654",53,"[27]JnHoIoHcotHnJqGKCrsJiEHlunI",303,0.996711,27,304,1,303,1,1,0,1,1,158,157,146,146,49
"4655",54,"[27]JnHoIoHcotHnJqGKCrsJiEHlunI",309,0.996774,27,310,1,309,1,1,0,1,1,178,177,132,132,49
"4656",55,"[27]JnHoIoHcotHnJqGKCrsJiEHlunI",293,0.996599,27,294,1,293,1,1,0,1,1,136,135,158,158,49
"4657",56,"[27]JnHoIoHcotHnJqGKCrsJiEHlunI",297,0.996644,27,298,1,297,1,1,0,1,1,150,149,148,148,49
"4658",57,"[27]JnHoIoHcotHnJqGKCrsJiEHlunI",295,0.996622,27,296,1,295,1,1,0,1,1,144,143,152,152,49
"4659",58,"[27]JnHoIoHcotHnJqGKCrsJiEHlunI",294,0.99661,27,295,1,294,1,1,0,1,1,142,141,153,153,49
"4660",59,"[27]JnHoIoHcotHnJqGKCrsJiEHlunI",299,0.996667,27,300,1,299,1,1,0,1,1,153,152,147,147,49
"4661",60,"[27]JnHoIoHcotHnJqGKCrsJiEHlunI",299,0.996667,27,300,1,299,1,1,0,1,1,151,150,149,149,49
"4662",61,"[27]JnHoIoHcotHnJqGKCrsJiEHlunI",297,0.996644,27,298,1,297,1,1,0,1,1,157,156,141,141,49
"4663",62,"[27]JnHoIoHcotHnJqGKCrsJiEHlunI",295,0.996622,27,296,1,295,1,1,0,1,1,147,146,149,149,49
"4664",63,"[27]JnHoIoHcotHnJqGKCrsJiEHlunI",300,0.996678,27,301,1,300,1,1,0,1,1,157,156,144,144,49
"4665",64,"[27]JnHoIoHcotHnJqGKCrsJiEHlunI",299,0.996667,27,300,1,299,1,1,0,1,1,154,153,146,146,49
"4666",65,"[27]JnHoIoHcotHnJqGKCrsJiEHlunI",299,0.996667,27,300,1,299,1,1,0,1,1,155,154,145,145,49
"4667",66,"[27]JnHoIoHcotHnJqGKCrsJiEHlunI",299,0.996667,27,300,1,299,1,1,0,1,1,152,151,148,148,49
"4668",67,"[27]JnHoIoHcotHnJqGKCrsJiEHlunI",299,0.996667,27,300,1,299,1,1,0,1,1,152,151,148,148,49
"4669",68,"[27]JnHoIoHcotHnJqGKCrsJiEHlunI",295,0.996622,27,296,1,295,1,1,0,1,1,144,143,152,152,49
"4670",69,"[27]JnHoIoHcotHnJqGKCrsJiEHlunI",299,0.996667,27,300,1,299,1,1,0,1,1,157,156,143,143,49
"4671",70,"[27]JnHoIoHcotHnJqGKCrsJiEHlunI",298,0.996656,27,299,1,298,1,1,0,1,1,146,145,153,153,49
"4672",71,"[27]JnHoIoHcotHnJqGKCrsJiEHlunI",296,0.996633,27,297,1,296,1,1,0,1,1,145,144,152,152,49
"4673",72,"[27]JnHoIoHcotHnJqGKCrsJiEHlunI",300,0.996678,27,301,1,300,1,1,0,1,1,156,155,145,145,49
"4674",73,"[27]JnHoIoHcotHnJqGKCrsJiEHlunI",297,0.996644,27,298,1,297,1,1,0,1,1,144,143,154,154,49
"4675",74,"[27]JnHoIoHcotHnJqGKCrsJiEHlunI",297,0.996644,27,298,1,297,1,1,0,1,1,143,142,155,155,49
"4676",75,"[27]JnHoIoHcotHnJqGKCrsJiEHlunI",289,0.996552,27,290,1,289,1,1,0,1,1,129,128,161,161,49
"4677",76,"[27]JnHoIoHcotHnJqGKCrsJiEHlunI",296,0.996633,27,297,1,296,1,1,0,1,1,148,147,149,149,49
"4678",77,"[27]JnHoIoHcotHnJqGKCrsJiEHlunI",294,0.99661,27,295,1,294,1,1,0,1,1,145,144,150,150,49
"4679",78,"[27]JnHoIoHcotHnJqGKCrsJiEHlunI",302,0.9967,27,303,1,302,1,1,0,1,1,157,156,146,146,49
"4680",79,"[27]JnHoIoHcotHnJqGKCrsJiEHlunI",297,0.996644,27,298,1,297,1,1,0,1,1,147,146,151,151,49
"4681",80,"[27]JnHoIoHcotHnJqGKCrsJiEHlunI",297,0.996644,27,298,1,297,1,1,0,1,1,146,145,152,152,49
"4682",81,"[27]JnHoIoHcotHnJqGKCrsJiEHlunI",295,0.996622,27,296,1,295,1,1,0,1,1,159,158,137,137,49
"4683",82,"[27]JnHoIoHcotHnJqGKCrsJiEHlunI",302,0.9967,27,303,1,302,1,1,0,1,1,160,159,143,143,49
"4684",83,"[27]JnHoIoHcotHnJqGKCrsJiEHlunI",299,0.996667,27,300,1,299,1,1,0,1,1,152,151,148,148,49
"4685",84,"[27]JnHoIoHcotHnJqGKCrsJiEHlunI",300,0.996678,27,301,1,300,1,1,0,1,1,154,153,147,147,49
"4686",85,"[27]JnHoIoHcotHnJqGKCrsJiEHlunI",299,0.996667,27,300,1,299,1,1,0,1,1,154,153,146,146,49
"4687",86,"[27]JnHoIoHcotHnJqGKCrsJiEHlunI",297,0.996644,27,298,1,297,1,1,0,1,1,147,146,151,151,49
"4688",87,"[27]JnHoIoHcotHnJqGKCrsJiEHlunI",295,0.996622,27,296,1,295,1,1,0,1,1,146,145,150,150,49
"4689",88,"[27]JnHoIoHcotHnJqGKCrsJiEHlunI",295,0.996622,27,296,1,295,1,1,0,1,1,141,140,155,155,49
"4690",89,"[27]JnHoIoHcotHnJqGKCrsJiEHlunI",292,0.996587,27,293,1,292,1,1,0,1,1,142,141,151,151,49
"4691",90,"[27]JnHoIoHcotHnJqGKCrsJiEHlunI",295,0.996622,27,296,1,295,1,1,0,1,1,144,143,152,152,49
"4692",91,"[27]JnHoIoHcotHnJqGKCrsJiEHlunI",296,0.996633,27,297,1,296,1,1,0,1,1,144,143,153,153,49
"4693",92,"[27]JnHoIoHcotHnJqGKCrsJiEHlunI",292,0.996587,27,293,1,292,1,1,0,1,1,139,138,154,154,49
"4694",93,"[27]JnHoIoHcotHnJqGKCrsJiEHlunI",291,0.996575,27,292,1,291,1,1,0,1,1,130,129,162,162,49
"4695",94,"[27]JnHoIoHcotHnJqGKCrsJiEHlunI",297,0.996644,27,298,1,297,1,1,0,1,1,154,153,144,144,49
"4696",95,"[27]JnHoIoHcotHnJqGKCrsJiEHlunI",296,0.996633,27,297,1,296,1,1,0,1,1,150,149,147,147,49
"4697",96,"[27]JnHoIoHcotHnJqGKCrsJiEHlunI",298,0.996656,27,299,1,298,1,1,0,1,1,149,148,150,150,49
"4698",97,"[27]JnHoIoHcotHnJqGKCrsJiEHlunI",291,0.996575,27,292,1,291,1,1,0,1,1,137,136,155,155,49
"4699",98,"[27]JnHoIoHcotHnJqGKCrsJiEHlunI",298,0.996656,27,299,1,298,1,1,0,1,1,156,155,143,143,49
"4700",99,"[27]JnHoIoHcotHnJqGKCrsJiEHlunI",292,0.996587,27,293,1,292,1,1,0,1,1,136,135,157,157,49
"4701",0,"[25]sHoIoHcowHnJHqKGCuqqkyHyB",291,0.996575,25,292,1,291,1,1,0,1,1,143,142,149,149,52
"4702",1,"[25]sHoIoHcowHnJHqKGCuqqkyHyB",300,0.996678,25,301,1,300,1,1,0,1,1,156,155,145,145,52
"4703",2,"[25]sHoIoHcowHnJHqKGCuqqkyHyB",300,0.996678,25,301,1,300,1,1,0,1,1,150,149,151,151,52
"4704",3,"[25]sHoIoHcowHnJHqKGCuqqkyHyB",302,0.9967,25,303,1,302,1,1,0,1,1,160,159,143,143,52
"4705",4,"[25]sHoIoHcowHnJHqKGCuqqkyHyB",303,0.996711,25,304,1,303,1,1,0,1,1,162,161,142,142,52
"4706",5,"[25]sHoIoHcowHnJHqKGCuqqkyHyB",308,0.996764,25,309,1,308,1,1,0,1,1,179,178,130,130,52
"4707",6,"[25]sHoIoHcowHnJHqKGCuqqkyHyB",297,0.996644,25,298,1,297,1,1,0,1,1,142,141,156,156,52
"4708",7,"[25]sHoIoHcowHnJHqKGCuqqkyHyB",304,0.996721,25,305,1,304,1,1,0,1,1,162,161,143,143,52
"4709",8,"[25]sHoIoHcowHnJHqKGCuqqkyHyB",294,0.99661,25,295,1,294,1,1,0,1,1,152,151,143,143,52
"4710",9,"[25]sHoIoHcowHnJHqKGCuqqkyHyB",294,0.99661,25,295,1,294,1,1,0,1,1,159,158,136,136,52
"4711",10,"[25]sHoIoHcowHnJHqKGCuqqkyHyB",300,0.996678,25,301,1,300,1,1,0,1,1,152,151,149,149,52
"4712",11,"[25]sHoIoHcowHnJHqKGCuqqkyHyB",300,0.996678,25,301,1,300,1,1,0,1,1,147,146,154,154,52
"4713",12,"[25]sHoIoHcowHnJHqKGCuqqkyHyB",293,0.996599,25,294,1,293,1,1,0,1,1,128,127,166,166,52
"4714",13,"[25]sHoIoHcowHnJHqKGCuqqkyHyB",301,0.996689,25,302,1,301,1,1,0,1,1,155,154,147,147,52
"4715",14,"[25]sHoIoHcowHnJHqKGCuqqkyHyB",295,0.996622,25,296,1,295,1,1,0,1,1,149,148,147,147,52
"4716",15,"[25]sHoIoHcowHnJHqKGCuqqkyHyB",295,0.996622,25,296,1,295,1,1,0,1,1,142,141,154,154,52
"4717",16,"[25]sHoIoHcowHnJHqKGCuqqkyHyB",293,0.996599,25,294,1,293,1,1,0,1,1,136,135,158,158,52
"4718",17,"[25]sHoIoHcowHnJHqKGCuqqkyHyB",319,0.996875,25,320,1,319,1,1,0,1,1,183,182,137,137,52
"4719",18,"[25]sHoIoHcowHnJHqKGCuqqkyHyB",292,0.996587,25,293,1,292,1,1,0,1,1,138,137,155,155,52
"4720",19,"[25]sHoIoHcowHnJHqKGCuqqkyHyB",304,0.996721,25,305,1,304,1,1,0,1,1,165,164,140,140,52
"4721",20,"[25]sHoIoHcowHnJHqKGCuqqkyHyB",301,0.996689,25,302,1,301,1,1,0,1,1,166,165,136,136,52
"4722",21,"[25]sHoIoHcowHnJHqKGCuqqkyHyB",290,0.996564,25,291,1,290,1,1,0,1,1,141,140,150,150,52
"4723",22,"[25]sHoIoHcowHnJHqKGCuqqkyHyB",303,0.996711,25,304,1,303,1,1,0,1,1,141,140,163,163,52
"4724",23,"[25]sHoIoHcowHnJHqKGCuqqkyHyB",300,0.996678,25,301,1,300,1,1,0,1,1,157,156,144,144,52
"4725",24,"[25]sHoIoHcowHnJHqKGCuqqkyHyB",298,0.996656,25,299,1,298,1,1,0,1,1,165,164,134,134,52
"4726",25,"[25]sHoIoHcowHnJHqKGCuqqkyHyB",304,0.996721,25,305,1,304,1,1,0,1,1,148,147,157,157,52
"4727",26,"[25]sHoIoHcowHnJHqKGCuqqkyHyB",305,0.996732,25,306,1,305,1,1,0,1,1,159,158,147,147,52
"4728",27,"[25]sHoIoHcowHnJHqKGCuqqkyHyB",291,0.996575,25,292,1,291,1,1,0,1,1,143,142,149,149,52
"4729",28,"[25]sHoIoHcowHnJHqKGCuqqkyHyB",297,0.996644,25,298,1,297,1,1,0,1,1,153,152,145,145,52
"4730",29,"[25]sHoIoHcowHnJHqKGCuqqkyHyB",306,0.996743,25,307,1,306,1,1,0,1,1,174,173,133,133,52
"4731",30,"[25]sHoIoHcowHnJHqKGCuqqkyHyB",294,0.99661,25,295,1,294,1,1,0,1,1,152,151,143,143,52
"4732",31,"[25]sHoIoHcowHnJHqKGCuqqkyHyB",299,0.996667,25,300,1,299,1,1,0,1,1,146,145,154,154,52
"4733",32,"[25]sHoIoHcowHnJHqKGCuqqkyHyB",296,0.996633,25,297,1,296,1,1,0,1,1,146,145,151,151,52
"4734",33,"[25]sHoIoHcowHnJHqKGCuqqkyHyB",302,0.9967,25,303,1,302,1,1,0,1,1,150,149,153,153,52
"4735",34,"[25]sHoIoHcowHnJHqKGCuqqkyHyB",293,0.996599,25,294,1,293,1,1,0,1,1,148,147,146,146,52
"4736",35,"[25]sHoIoHcowHnJHqKGCuqqkyHyB",300,0.996678,25,301,1,300,1,1,0,1,1,159,158,142,142,52
"4737",36,"[25]sHoIoHcowHnJHqKGCuqqkyHyB",294,0.99661,25,295,1,294,1,1,0,1,1,155,154,140,140,52
"4738",37,"[25]sHoIoHcowHnJHqKGCuqqkyHyB",299,0.996667,25,300,1,299,1,1,0,1,1,168,167,132,132,52
"4739",38,"[25]sHoIoHcowHnJHqKGCuqqkyHyB",296,0.996633,25,297,1,296,1,1,0,1,1,148,147,149,149,52
"4740",39,"[25]sHoIoHcowHnJHqKGCuqqkyHyB",295,0.996622,25,296,1,295,1,1,0,1,1,142,141,154,154,52
"4741",40,"[25]sHoIoHcowHnJHqKGCuqqkyHyB",298,0.996656,25,299,1,298,1,1,0,1,1,150,149,149,149,52
"4742",41,"[25]sHoIoHcowHnJHqKGCuqqkyHyB",301,0.996689,25,302,1,301,1,1,0,1,1,153,152,149,149,52
"4743",42,"[25]sHoIoHcowHnJHqKGCuqqkyHyB",313,0.996815,25,314,1,313,1,1,0,1,1,180,179,134,134,52
"4744",43,"[25]sHoIoHcowHnJHqKGCuqqkyHyB",303,0.996711,25,304,1,303,1,1,0,1,1,169,168,135,135,52
"4745",44,"[25]sHoIoHcowHnJHqKGCuqqkyHyB",295,0.996622,25,296,1,295,1,1,0,1,1,144,143,152,152,52
"4746",45,"[25]sHoIoHcowHnJHqKGCuqqkyHyB",300,0.996678,25,301,1,300,1,1,0,1,1,158,157,143,143,52
"4747",46,"[25]sHoIoHcowHnJHqKGCuqqkyHyB",296,0.996633,25,297,1,296,1,1,0,1,1,141,140,156,156,52
"4748",47,"[25]sHoIoHcowHnJHqKGCuqqkyHyB",295,0.996622,25,296,1,295,1,1,0,1,1,144,143,152,152,52
"4749",48,"[25]sHoIoHcowHnJHqKGCuqqkyHyB",295,0.996622,25,296,1,295,1,1,0,1,1,147,146,149,149,52
"4750",49,"[25]sHoIoHcowHnJHqKGCuqqkyHyB",295,0.996622,25,296,1,295,1,1,0,1,1,146,145,150,150,52
"4751",50,"[25]sHoIoHcowHnJHqKGCuqqkyHyB",304,0.996721,25,305,1,304,1,1,0,1,1,171,170,134,134,52
"4752",51,"[25]sHoIoHcowHnJHqKGCuqqkyHyB",294,0.99661,25,295,1,294,1,1,0,1,1,151,150,144,144,52
"4753",52,"[25]sHoIoHcowHnJHqKGCuqqkyHyB",307,0.996753,25,308,1,307,1,1,0,1,1,170,169,138,138,52
"4754",53,"[25]sHoIoHcowHnJHqKGCuqqkyHyB",292,0.996587,25,293,1,292,1,1,0,1,1,142,141,151,151,52
"4755",54,"[25]sHoIoHcowHnJHqKGCuqqkyHyB",296,0.996633,25,297,1,296,1,1,0,1,1,146,145,151,151,52
"4756",55,"[25]sHoIoHcowHnJHqKGCuqqkyHyB",295,0.996622,25,296,1,295,1,1,0,1,1,149,148,147,147,52
"4757",56,"[25]sHoIoHcowHnJHqKGCuqqkyHyB",296,0.996633,25,297,1,296,1,1,0,1,1,159,158,138,138,52
"4758",57,"[25]sHoIoHcowHnJHqKGCuqqkyHyB",300,0.996678,25,301,1,300,1,1,0,1,1,151,150,150,150,52
"4759",58,"[25]sHoIoHcowHnJHqKGCuqqkyHyB",298,0.996656,25,299,1,298,1,1,0,1,1,159,158,140,140,52
"4760",59,"[25]sHoIoHcowHnJHqKGCuqqkyHyB",297,0.996644,25,298,1,297,1,1,0,1,1,153,152,145,145,52
"4761",60,"[25]sHoIoHcowHnJHqKGCuqqkyHyB",290,0.996564,25,291,1,290,1,1,0,1,1,149,148,142,142,52
"4762",61,"[25]sHoIoHcowHnJHqKGCuqqkyHyB",287,0.996528,25,288,1,287,1,1,0,1,1,143,142,145,145,52
"4763",62,"[25]sHoIoHcowHnJHqKGCuqqkyHyB",297,0.996644,25,298,1,297,1,1,0,1,1,150,149,148,148,52
"4764",63,"[25]sHoIoHcowHnJHqKGCuqqkyHyB",295,0.996622,25,296,1,295,1,1,0,1,1,148,147,148,148,52
"4765",64,"[25]sHoIoHcowHnJHqKGCuqqkyHyB",300,0.996678,25,301,1,300,1,1,0,1,1,168,167,133,133,52
"4766",65,"[25]sHoIoHcowHnJHqKGCuqqkyHyB",290,0.996564,25,291,1,290,1,1,0,1,1,137,136,154,154,52
"4767",66,"[25]sHoIoHcowHnJHqKGCuqqkyHyB",296,0.996633,25,297,1,296,1,1,0,1,1,152,151,145,145,52
"4768",67,"[25]sHoIoHcowHnJHqKGCuqqkyHyB",299,0.996667,25,300,1,299,1,1,0,1,1,155,154,145,145,52
"4769",68,"[25]sHoIoHcowHnJHqKGCuqqkyHyB",298,0.996656,25,299,1,298,1,1,0,1,1,160,159,139,139,52
"4770",69,"[25]sHoIoHcowHnJHqKGCuqqkyHyB",292,0.996587,25,293,1,292,1,1,0,1,1,142,141,151,151,52
"4771",70,"[25]sHoIoHcowHnJHqKGCuqqkyHyB",292,0.996587,25,293,1,292,1,1,0,1,1,142,141,151,151,52
"4772",71,"[25]sHoIoHcowHnJHqKGCuqqkyHyB",303,0.996711,25,304,1,303,1,1,0,1,1,158,157,146,146,52
"4773",72,"[25]sHoIoHcowHnJHqKGCuqqkyHyB",291,0.996575,25,292,1,291,1,1,0,1,1,132,131,160,160,52
"4774",73,"[25]sHoIoHcowHnJHqKGCuqqkyHyB",298,0.996656,25,299,1,298,1,1,0,1,1,145,144,154,154,52
"4775",74,"[25]sHoIoHcowHnJHqKGCuqqkyHyB",297,0.996644,25,298,1,297,1,1,0,1,1,148,147,150,150,52
"4776",75,"[25]sHoIoHcowHnJHqKGCuqqkyHyB",305,0.996732,25,306,1,305,1,1,0,1,1,167,166,139,139,52
"4777",76,"[25]sHoIoHcowHnJHqKGCuqqkyHyB",302,0.9967,25,303,1,302,1,1,0,1,1,148,147,155,155,52
"4778",77,"[25]sHoIoHcowHnJHqKGCuqqkyHyB",299,0.996667,25,300,1,299,1,1,0,1,1,148,147,152,152,52
"4779",78,"[25]sHoIoHcowHnJHqKGCuqqkyHyB",298,0.996656,25,299,1,298,1,1,0,1,1,159,158,140,140,52
"4780",79,"[25]sHoIoHcowHnJHqKGCuqqkyHyB",289,0.996552,25,290,1,289,1,1,0,1,1,137,136,153,153,52
"4781",80,"[25]sHoIoHcowHnJHqKGCuqqkyHyB",291,0.996575,25,292,1,291,1,1,0,1,1,136,135,156,156,52
"4782",81,"[25]sHoIoHcowHnJHqKGCuqqkyHyB",286,0.996516,25,287,1,286,1,1,0,1,1,140,139,147,147,52
"4783",82,"[25]sHoIoHcowHnJHqKGCuqqkyHyB",303,0.996711,25,304,1,303,1,1,0,1,1,156,155,148,148,52
"4784",83,"[25]sHoIoHcowHnJHqKGCuqqkyHyB",299,0.996667,25,300,1,299,1,1,0,1,1,146,145,154,154,52
"4785",84,"[25]sHoIoHcowHnJHqKGCuqqkyHyB",313,0.996815,25,314,1,313,1,1,0,1,1,164,163,150,150,52
"4786",85,"[25]sHoIoHcowHnJHqKGCuqqkyHyB",285,0.996503,25,286,1,285,1,1,0,1,1,125,124,161,161,52
"4787",86,"[25]sHoIoHcowHnJHqKGCuqqkyHyB",294,0.99661,25,295,1,294,1,1,0,1,1,141,140,154,154,52
"4788",87,"[25]sHoIoHcowHnJHqKGCuqqkyHyB",292,0.996587,25,293,1,292,1,1,0,1,1,148,147,145,145,52
"4789",88,"[25]sHoIoHcowHnJHqKGCuqqkyHyB",301,0.996689,25,302,1,301,1,1,0,1,1,156,155,146,146,52
"4790",89,"[25]sHoIoHcowHnJHqKGCuqqkyHyB",290,0.996564,25,291,1,290,1,1,0,1,1,145,144,146,146,52
"4791",90,"[25]sHoIoHcowHnJHqKGCuqqkyHyB",297,0.996644,25,298,1,297,1,1,0,1,1,143,142,155,155,52
"4792",91,"[25]sHoIoHcowHnJHqKGCuqqkyHyB",302,0.9967,25,303,1,302,1,1,0,1,1,156,155,147,147,52
"4793",92,"[25]sHoIoHcowHnJHqKGCuqqkyHyB",306,0.996743,25,307,1,306,1,1,0,1,1,166,165,141,141,52
"4794",93,"[25]sHoIoHcowHnJHqKGCuqqkyHyB",307,0.996753,25,308,1,307,1,1,0,1,1,175,174,133,133,52
"4795",94,"[25]sHoIoHcowHnJHqKGCuqqkyHyB",302,0.9967,25,303,1,302,1,1,0,1,1,164,163,139,139,52
"4796",95,"[25]sHoIoHcowHnJHqKGCuqqkyHyB",301,0.996689,25,302,1,301,1,1,0,1,1,177,176,125,125,52
"4797",96,"[25]sHoIoHcowHnJHqKGCuqqkyHyB",295,0.996622,25,296,1,295,1,1,0,1,1,138,137,158,158,52
"4798",97,"[25]sHoIoHcowHnJHqKGCuqqkyHyB",296,0.996633,25,297,1,296,1,1,0,1,1,144,143,153,153,52
"4799",98,"[25]sHoIoHcowHnJHqKGCuqqkyHyB",307,0.996753,25,308,1,307,1,1,0,1,1,166,165,142,142,52
"4800",99,"[25]sHoIoHcowHnJHqKGCuqqkyHyB",297,0.996644,25,298,1,297,1,1,0,1,1,136,135,162,162,52
"4801",0,"[25]hirvoIFoHcowHnJHGqKCHcHHk",283,0.996479,25,284,1,283,1,1,0,1,1,147,146,137,137,53
"4802",1,"[25]hirvoIFoHcowHnJHGqKCHcHHk",280,0.996441,25,281,1,280,1,1,0,1,1,157,156,124,124,53
"4803",2,"[25]hirvoIFoHcowHnJHGqKCHcHHk",282,0.996466,25,283,1,282,1,1,0,1,1,147,146,136,136,53
"4804",3,"[25]hirvoIFoHcowHnJHGqKCHcHHk",279,0.996429,25,280,1,279,1,1,0,1,1,133,132,147,147,53
"4805",4,"[25]hirvoIFoHcowHnJHGqKCHcHHk",282,0.996466,25,283,1,282,1,1,0,1,1,146,145,137,137,53
"4806",5,"[25]hirvoIFoHcowHnJHGqKCHcHHk",279,0.996429,25,280,1,279,1,1,0,1,1,148,147,132,132,53
"4807",6,"[25]hirvoIFoHcowHnJHGqKCHcHHk",283,0.996479,25,284,1,283,1,1,0,1,1,153,152,131,131,53
"4808",7,"[25]hirvoIFoHcowHnJHGqKCHcHHk",277,0.996403,25,278,1,277,1,1,0,1,1,136,135,142,142,53
"4809",8,"[25]hirvoIFoHcowHnJHGqKCHcHHk",278,0.996416,25,279,1,278,1,1,0,1,1,128,127,151,151,53
"4810",9,"[25]hirvoIFoHcowHnJHGqKCHcHHk",277,0.996403,25,278,1,277,1,1,0,1,1,143,142,135,135,53
"4811",10,"[25]hirvoIFoHcowHnJHGqKCHcHHk",275,0.996377,25,276,1,275,1,1,0,1,1,141,140,135,135,53
"4812",11,"[25]hirvoIFoHcowHnJHGqKCHcHHk",281,0.996454,25,282,1,281,1,1,0,1,1,130,129,152,152,53
"4813",12,"[25]hirvoIFoHcowHnJHGqKCHcHHk",283,0.996479,25,284,1,283,1,1,0,1,1,156,155,128,128,53
"4814",13,"[25]hirvoIFoHcowHnJHGqKCHcHHk",292,0.996587,25,293,1,292,1,1,0,1,1,157,156,136,136,53
"4815",14,"[25]hirvoIFoHcowHnJHGqKCHcHHk",281,0.996454,25,282,1,281,1,1,0,1,1,135,134,147,147,53
"4816",15,"[25]hirvoIFoHcowHnJHGqKCHcHHk",277,0.996403,25,278,1,277,1,1,0,1,1,138,137,140,140,53
"4817",16,"[25]hirvoIFoHcowHnJHGqKCHcHHk",280,0.996441,25,281,1,280,1,1,0,1,1,136,135,145,145,53
"4818",17,"[25]hirvoIFoHcowHnJHGqKCHcHHk",283,0.996479,25,284,1,283,1,1,0,1,1,134,133,150,150,53
"4819",18,"[25]hirvoIFoHcowHnJHGqKCHcHHk",278,0.996416,25,279,1,278,1,1,0,1,1,130,129,149,149,53
"4820",19,"[25]hirvoIFoHcowHnJHGqKCHcHHk",281,0.996454,25,282,1,281,1,1,0,1,1,149,148,133,133,53
"4821",20,"[25]hirvoIFoHcowHnJHGqKCHcHHk",284,0.996491,25,285,1,284,1,1,0,1,1,151,150,134,134,53
"4822",21,"[25]hirvoIFoHcowHnJHGqKCHcHHk",283,0.996479,25,284,1,283,1,1,0,1,1,142,141,142,142,53
"4823",22,"[25]hirvoIFoHcowHnJHGqKCHcHHk",287,0.996528,25,288,1,287,1,1,0,1,1,150,149,138,138,53
"4824",23,"[25]hirvoIFoHcowHnJHGqKCHcHHk",286,0.996516,25,287,1,286,1,1,0,1,1,150,149,137,137,53
"4825",24,"[25]hirvoIFoHcowHnJHGqKCHcHHk",272,0.996337,25,273,1,272,1,1,0,1,1,143,142,130,130,53
"4826",25,"[25]hirvoIFoHcowHnJHGqKCHcHHk",279,0.996429,25,280,1,279,1,1,0,1,1,130,129,150,150,53
"4827",26,"[25]hirvoIFoHcowHnJHGqKCHcHHk",270,0.99631,25,271,1,270,1,1,0,1,1,139,138,132,132,53
"4828",27,"[25]hirvoIFoHcowHnJHGqKCHcHHk",281,0.996454,25,282,1,281,1,1,0,1,1,136,135,146,146,53
"4829",28,"[25]hirvoIFoHcowHnJHGqKCHcHHk",279,0.996429,25,280,1,279,1,1,0,1,1,144,143,136,136,53
"4830",29,"[25]hirvoIFoHcowHnJHGqKCHcHHk",280,0.996441,25,281,1,280,1,1,0,1,1,140,139,141,141,53
"4831",30,"[25]hirvoIFoHcowHnJHGqKCHcHHk",276,0.99639,25,277,1,276,1,1,0,1,1,136,135,141,141,53
"4832",31,"[25]hirvoIFoHcowHnJHGqKCHcHHk",283,0.996479,25,284,1,283,1,1,0,1,1,165,164,119,119,53
"4833",32,"[25]hirvoIFoHcowHnJHGqKCHcHHk",280,0.996441,25,281,1,280,1,1,0,1,1,149,148,132,132,53
"4834",33,"[25]hirvoIFoHcowHnJHGqKCHcHHk",276,0.99639,25,277,1,276,1,1,0,1,1,157,156,120,120,53
"4835",34,"[25]hirvoIFoHcowHnJHGqKCHcHHk",283,0.996479,25,284,1,283,1,1,0,1,1,129,128,155,155,53
"4836",35,"[25]hirvoIFoHcowHnJHGqKCHcHHk",284,0.996491,25,285,1,284,1,1,0,1,1,151,150,134,134,53
"4837",36,"[25]hirvoIFoHcowHnJHGqKCHcHHk",284,0.996491,25,285,1,284,1,1,0,1,1,151,150,134,134,53
"4838",37,"[25]hirvoIFoHcowHnJHGqKCHcHHk",283,0.996479,25,284,1,283,1,1,0,1,1,136,135,148,148,53
"4839",38,"[25]hirvoIFoHcowHnJHGqKCHcHHk",279,0.996429,25,280,1,279,1,1,0,1,1,140,139,140,140,53
"4840",39,"[25]hirvoIFoHcowHnJHGqKCHcHHk",280,0.996441,25,281,1,280,1,1,0,1,1,133,132,148,148,53
"4841",40,"[25]hirvoIFoHcowHnJHGqKCHcHHk",278,0.996416,25,279,1,278,1,1,0,1,1,128,127,151,151,53
"4842",41,"[25]hirvoIFoHcowHnJHGqKCHcHHk",285,0.996503,25,286,1,285,1,1,0,1,1,144,143,142,142,53
"4843",42,"[25]hirvoIFoHcowHnJHGqKCHcHHk",275,0.996377,25,276,1,275,1,1,0,1,1,131,130,145,145,53
"4844",43,"[25]hirvoIFoHcowHnJHGqKCHcHHk",277,0.996403,25,278,1,277,1,1,0,1,1,144,143,134,134,53
"4845",44,"[25]hirvoIFoHcowHnJHGqKCHcHHk",274,0.996364,25,275,1,274,1,1,0,1,1,140,139,135,135,53
"4846",45,"[25]hirvoIFoHcowHnJHGqKCHcHHk",279,0.996429,25,280,1,279,1,1,0,1,1,124,123,156,156,53
"4847",46,"[25]hirvoIFoHcowHnJHGqKCHcHHk",280,0.996441,25,281,1,280,1,1,0,1,1,142,141,139,139,53
"4848",47,"[25]hirvoIFoHcowHnJHGqKCHcHHk",279,0.996429,25,280,1,279,1,1,0,1,1,133,132,147,147,53
"4849",48,"[25]hirvoIFoHcowHnJHGqKCHcHHk",282,0.996466,25,283,1,282,1,1,0,1,1,148,147,135,135,53
"4850",49,"[25]hirvoIFoHcowHnJHGqKCHcHHk",277,0.996403,25,278,1,277,1,1,0,1,1,147,146,131,131,53
"4851",50,"[25]hirvoIFoHcowHnJHGqKCHcHHk",271,0.996324,25,272,1,271,1,1,0,1,1,142,141,130,130,53
"4852",51,"[25]hirvoIFoHcowHnJHGqKCHcHHk",285,0.996503,25,286,1,285,1,1,0,1,1,140,139,146,146,53
"4853",52,"[25]hirvoIFoHcowHnJHGqKCHcHHk",280,0.996441,25,281,1,280,1,1,0,1,1,139,138,142,142,53
"4854",53,"[25]hirvoIFoHcowHnJHGqKCHcHHk",272,0.996337,25,273,1,272,1,1,0,1,1,138,137,135,135,53
"4855",54,"[25]hirvoIFoHcowHnJHGqKCHcHHk",283,0.996479,25,284,1,283,1,1,0,1,1,140,139,144,144,53
"4856",55,"[25]hirvoIFoHcowHnJHGqKCHcHHk",278,0.996416,25,279,1,278,1,1,0,1,1,151,150,128,128,53
"4857",56,"[25]hirvoIFoHcowHnJHGqKCHcHHk",280,0.996441,25,281,1,280,1,1,0,1,1,140,139,141,141,53
"4858",57,"[25]hirvoIFoHcowHnJHGqKCHcHHk",275,0.996377,25,276,1,275,1,1,0,1,1,131,130,145,145,53
"4859",58,"[25]hirvoIFoHcowHnJHGqKCHcHHk",278,0.996416,25,279,1,278,1,1,0,1,1,118,117,161,161,53
"4860",59,"[25]hirvoIFoHcowHnJHGqKCHcHHk",270,0.99631,25,271,1,270,1,1,0,1,1,120,119,151,151,53
"4861",60,"[25]hirvoIFoHcowHnJHGqKCHcHHk",277,0.996403,25,278,1,277,1,1,0,1,1,133,132,145,145,53
"4862",61,"[25]hirvoIFoHcowHnJHGqKCHcHHk",278,0.996416,25,279,1,278,1,1,0,1,1,138,137,141,141,53
"4863",62,"[25]hirvoIFoHcowHnJHGqKCHcHHk",275,0.996377,25,276,1,275,1,1,0,1,1,130,129,146,146,53
"4864",63,"[25]hirvoIFoHcowHnJHGqKCHcHHk",273,0.99635,25,274,1,273,1,1,0,1,1,132,131,142,142,53
"4865",64,"[25]hirvoIFoHcowHnJHGqKCHcHHk",271,0.996324,25,272,1,271,1,1,0,1,1,129,128,143,143,53
"4866",65,"[25]hirvoIFoHcowHnJHGqKCHcHHk",276,0.99639,25,277,1,276,1,1,0,1,1,134,133,143,143,53
"4867",66,"[25]hirvoIFoHcowHnJHGqKCHcHHk",280,0.996441,25,281,1,280,1,1,0,1,1,146,145,135,135,53
"4868",67,"[25]hirvoIFoHcowHnJHGqKCHcHHk",279,0.996429,25,280,1,279,1,1,0,1,1,136,135,144,144,53
"4869",68,"[25]hirvoIFoHcowHnJHGqKCHcHHk",282,0.996466,25,283,1,282,1,1,0,1,1,148,147,135,135,53
"4870",69,"[25]hirvoIFoHcowHnJHGqKCHcHHk",278,0.996416,25,279,1,278,1,1,0,1,1,125,124,154,154,53
"4871",70,"[25]hirvoIFoHcowHnJHGqKCHcHHk",282,0.996466,25,283,1,282,1,1,0,1,1,146,145,137,137,53
"4872",71,"[25]hirvoIFoHcowHnJHGqKCHcHHk",280,0.996441,25,281,1,280,1,1,0,1,1,139,138,142,142,53
"4873",72,"[25]hirvoIFoHcowHnJHGqKCHcHHk",284,0.996491,25,285,1,284,1,1,0,1,1,148,147,137,137,53
"4874",73,"[25]hirvoIFoHcowHnJHGqKCHcHHk",280,0.996441,25,281,1,280,1,1,0,1,1,147,146,134,134,53
"4875",74,"[25]hirvoIFoHcowHnJHGqKCHcHHk",283,0.996479,25,284,1,283,1,1,0,1,1,154,153,130,130,53
"4876",75,"[25]hirvoIFoHcowHnJHGqKCHcHHk",282,0.996466,25,283,1,282,1,1,0,1,1,128,127,155,155,53
"4877",76,"[25]hirvoIFoHcowHnJHGqKCHcHHk",284,0.996491,25,285,1,284,1,1,0,1,1,144,143,141,141,53
"4878",77,"[25]hirvoIFoHcowHnJHGqKCHcHHk",288,0.99654,25,289,1,288,1,1,0,1,1,153,152,136,136,53
"4879",78,"[25]hirvoIFoHcowHnJHGqKCHcHHk",282,0.996466,25,283,1,282,1,1,0,1,1,131,130,152,152,53
"4880",79,"[25]hirvoIFoHcowHnJHGqKCHcHHk",283,0.996479,25,284,1,283,1,1,0,1,1,129,128,155,155,53
"4881",80,"[25]hirvoIFoHcowHnJHGqKCHcHHk",283,0.996479,25,284,1,283,1,1,0,1,1,146,145,138,138,53
"4882",81,"[25]hirvoIFoHcowHnJHGqKCHcHHk",281,0.996454,25,282,1,281,1,1,0,1,1,137,136,145,145,53
"4883",82,"[25]hirvoIFoHcowHnJHGqKCHcHHk",283,0.996479,25,284,1,283,1,1,0,1,1,141,140,143,143,53
"4884",83,"[25]hirvoIFoHcowHnJHGqKCHcHHk",280,0.996441,25,281,1,280,1,1,0,1,1,147,146,134,134,53
"4885",84,"[25]hirvoIFoHcowHnJHGqKCHcHHk",271,0.996324,25,272,1,271,1,1,0,1,1,134,133,138,138,53
"4886",85,"[25]hirvoIFoHcowHnJHGqKCHcHHk",284,0.996491,25,285,1,284,1,1,0,1,1,156,155,129,129,53
"4887",86,"[25]hirvoIFoHcowHnJHGqKCHcHHk",271,0.996324,25,272,1,271,1,1,0,1,1,126,125,146,146,53
"4888",87,"[25]hirvoIFoHcowHnJHGqKCHcHHk",284,0.996491,25,285,1,284,1,1,0,1,1,161,160,124,124,53
"4889",88,"[25]hirvoIFoHcowHnJHGqKCHcHHk",276,0.99639,25,277,1,276,1,1,0,1,1,142,141,135,135,53
"4890",89,"[25]hirvoIFoHcowHnJHGqKCHcHHk",288,0.99654,25,289,1,288,1,1,0,1,1,151,150,138,138,53
"4891",90,"[25]hirvoIFoHcowHnJHGqKCHcHHk",282,0.996466,25,283,1,282,1,1,0,1,1,142,141,141,141,53
"4892",91,"[25]hirvoIFoHcowHnJHGqKCHcHHk",276,0.99639,25,277,1,276,1,1,0,1,1,154,153,123,123,53
"4893",92,"[25]hirvoIFoHcowHnJHGqKCHcHHk",278,0.996416,25,279,1,278,1,1,0,1,1,143,142,136,136,53
"4894",93,"[25]hirvoIFoHcowHnJHGqKCHcHHk",275,0.996377,25,276,1,275,1,1,0,1,1,142,141,134,134,53
"4895",94,"[25]hirvoIFoHcowHnJHGqKCHcHHk",275,0.996377,25,276,1,275,1,1,0,1,1,135,134,141,141,53
"4896",95,"[25]hirvoIFoHcowHnJHGqKCHcHHk",276,0.99639,25,277,1,276,1,1,0,1,1,137,136,140,140,53
"4897",96,"[25]hirvoIFoHcowHnJHGqKCHcHHk",278,0.996416,25,279,1,278,1,1,0,1,1,138,137,141,141,53
"4898",97,"[25]hirvoIFoHcowHnJHGqKCHcHHk",290,0.996564,25,291,1,290,1,1,0,1,1,145,144,146,146,53
"4899",98,"[25]hirvoIFoHcowHnJHGqKCHcHHk",283,0.996479,25,284,1,283,1,1,0,1,1,139,138,145,145,53
"4900",99,"[25]hirvoIFoHcowHnJHGqKCHcHHk",274,0.996364,25,275,1,274,1,1,0,1,1,115,114,160,160,53
"4901",0,"[20]dHoIoHcoxHnJqGKCijkE",297,0.996644,20,298,1,297,1,1,0,1,1,151,150,147,147,54
"4902",1,"[20]dHoIoHcoxHnJqGKCijkE",299,0.996667,20,300,1,299,1,1,0,1,1,163,162,137,137,54
"4903",2,"[20]dHoIoHcoxHnJqGKCijkE",299,0.996667,20,300,1,299,1,1,0,1,1,159,158,141,141,54
"4904",3,"[20]dHoIoHcoxHnJqGKCijkE",292,0.996587,20,293,1,292,1,1,0,1,1,141,140,152,152,54
"4905",4,"[20]dHoIoHcoxHnJqGKCijkE",298,0.996656,20,299,1,298,1,1,0,1,1,159,158,140,140,54
"4906",5,"[20]dHoIoHcoxHnJqGKCijkE",293,0.996599,20,294,1,293,1,1,0,1,1,138,137,156,156,54
"4907",6,"[20]dHoIoHcoxHnJqGKCijkE",300,0.996678,20,301,1,300,1,1,0,1,1,155,154,146,146,54
"4908",7,"[20]dHoIoHcoxHnJqGKCijkE",295,0.996622,20,296,1,295,1,1,0,1,1,148,147,148,148,54
"4909",8,"[20]dHoIoHcoxHnJqGKCijkE",301,0.996689,20,302,1,301,1,1,0,1,1,169,168,133,133,54
"4910",9,"[20]dHoIoHcoxHnJqGKCijkE",301,0.996689,20,302,1,301,1,1,0,1,1,156,155,146,146,54
"4911",10,"[20]dHoIoHcoxHnJqGKCijkE",293,0.996599,20,294,1,293,1,1,0,1,1,138,137,156,156,54
"4912",11,"[20]dHoIoHcoxHnJqGKCijkE",304,0.996721,20,305,1,304,1,1,0,1,1,159,158,146,146,54
"4913",12,"[20]dHoIoHcoxHnJqGKCijkE",299,0.996667,20,300,1,299,1,1,0,1,1,158,157,142,142,54
"4914",13,"[20]dHoIoHcoxHnJqGKCijkE",298,0.996656,20,299,1,298,1,1,0,1,1,155,154,144,144,54
"4915",14,"[20]dHoIoHcoxHnJqGKCijkE",297,0.996644,20,298,1,297,1,1,0,1,1,151,150,147,147,54
"4916",15,"[20]dHoIoHcoxHnJqGKCijkE",299,0.996667,20,300,1,299,1,1,0,1,1,160,159,140,140,54
"4917",16,"[20]dHoIoHcoxHnJqGKCijkE",298,0.996656,20,299,1,298,1,1,0,1,1,157,156,142,142,54
"4918",17,"[20]dHoIoHcoxHnJqGKCijkE",302,0.9967,20,303,1,302,1,1,0,1,1,166,165,137,137,54
"4919",18,"[20]dHoIoHcoxHnJqGKCijkE",290,0.996564,20,291,1,290,1,1,0,1,1,153,152,138,138,54
"4920",19,"[20]dHoIoHcoxHnJqGKCijkE",308,0.996764,20,309,1,308,1,1,0,1,1,173,172,136,136,54
"4921",20,"[20]dHoIoHcoxHnJqGKCijkE",293,0.996599,20,294,1,293,1,1,0,1,1,143,142,151,151,54
"4922",21,"[20]dHoIoHcoxHnJqGKCijkE",298,0.996656,20,299,1,298,1,1,0,1,1,159,158,140,140,54
"4923",22,"[20]dHoIoHcoxHnJqGKCijkE",294,0.99661,20,295,1,294,1,1,0,1,1,144,143,151,151,54
"4924",23,"[20]dHoIoHcoxHnJqGKCijkE",293,0.996599,20,294,1,293,1,1,0,1,1,140,139,154,154,54
"4925",24,"[20]dHoIoHcoxHnJqGKCijkE",295,0.996622,20,296,1,295,1,1,0,1,1,149,148,147,147,54
"4926",25,"[20]dHoIoHcoxHnJqGKCijkE",288,0.99654,20,289,1,288,1,1,0,1,1,140,139,149,149,54
"4927",26,"[20]dHoIoHcoxHnJqGKCijkE",292,0.996587,20,293,1,292,1,1,0,1,1,139,138,154,154,54
"4928",27,"[20]dHoIoHcoxHnJqGKCijkE",298,0.996656,20,299,1,298,1,1,0,1,1,155,154,144,144,54
"4929",28,"[20]dHoIoHcoxHnJqGKCijkE",299,0.996667,20,300,1,299,1,1,0,1,1,154,153,146,146,54
"4930",29,"[20]dHoIoHcoxHnJqGKCijkE",299,0.996667,20,300,1,299,1,1,0,1,1,158,157,142,142,54
"4931",30,"[20]dHoIoHcoxHnJqGKCijkE",291,0.996575,20,292,1,291,1,1,0,1,1,133,132,159,159,54
"4932",31,"[20]dHoIoHcoxHnJqGKCijkE",296,0.996633,20,297,1,296,1,1,0,1,1,149,148,148,148,54
"4933",32,"[20]dHoIoHcoxHnJqGKCijkE",296,0.996633,20,297,1,296,1,1,0,1,1,157,156,140,140,54
"4934",33,"[20]dHoIoHcoxHnJqGKCijkE",298,0.996656,20,299,1,298,1,1,0,1,1,154,153,145,145,54
"4935",34,"[20]dHoIoHcoxHnJqGKCijkE",301,0.996689,20,302,1,301,1,1,0,1,1,165,164,137,137,54
"4936",35,"[20]dHoIoHcoxHnJqGKCijkE",290,0.996564,20,291,1,290,1,1,0,1,1,133,132,158,158,54
"4937",36,"[20]dHoIoHcoxHnJqGKCijkE",294,0.99661,20,295,1,294,1,1,0,1,1,146,145,149,149,54
"4938",37,"[20]dHoIoHcoxHnJqGKCijkE",297,0.996644,20,298,1,297,1,1,0,1,1,151,150,147,147,54
"4939",38,"[20]dHoIoHcoxHnJqGKCijkE",297,0.996644,20,298,1,297,1,1,0,1,1,153,152,145,145,54
"4940",39,"[20]dHoIoHcoxHnJqGKCijkE",298,0.996656,20,299,1,298,1,1,0,1,1,153,152,146,146,54
"4941",40,"[20]dHoIoHcoxHnJqGKCijkE",297,0.996644,20,298,1,297,1,1,0,1,1,150,149,148,148,54
"4942",41,"[20]dHoIoHcoxHnJqGKCijkE",299,0.996667,20,300,1,299,1,1,0,1,1,163,162,137,137,54
"4943",42,"[20]dHoIoHcoxHnJqGKCijkE",292,0.996587,20,293,1,292,1,1,0,1,1,140,139,153,153,54
"4944",43,"[20]dHoIoHcoxHnJqGKCijkE",297,0.996644,20,298,1,297,1,1,0,1,1,148,147,150,150,54
"4945",44,"[20]dHoIoHcoxHnJqGKCijkE",298,0.996656,20,299,1,298,1,1,0,1,1,157,156,142,142,54
"4946",45,"[20]dHoIoHcoxHnJqGKCijkE",294,0.99661,20,295,1,294,1,1,0,1,1,142,141,153,153,54
"4947",46,"[20]dHoIoHcoxHnJqGKCijkE",291,0.996575,20,292,1,291,1,1,0,1,1,139,138,153,153,54
"4948",47,"[20]dHoIoHcoxHnJqGKCijkE",297,0.996644,20,298,1,297,1,1,0,1,1,150,149,148,148,54
"4949",48,"[20]dHoIoHcoxHnJqGKCijkE",295,0.996622,20,296,1,295,1,1,0,1,1,147,146,149,149,54
"4950",49,"[20]dHoIoHcoxHnJqGKCijkE",294,0.99661,20,295,1,294,1,1,0,1,1,142,141,153,153,54
"4951",50,"[20]dHoIoHcoxHnJqGKCijkE",292,0.996587,20,293,1,292,1,1,0,1,1,137,136,156,156,54
"4952",51,"[20]dHoIoHcoxHnJqGKCijkE",295,0.996622,20,296,1,295,1,1,0,1,1,146,145,150,150,54
"4953",52,"[20]dHoIoHcoxHnJqGKCijkE",290,0.996564,20,291,1,290,1,1,0,1,1,136,135,155,155,54
"4954",53,"[20]dHoIoHcoxHnJqGKCijkE",299,0.996667,20,300,1,299,1,1,0,1,1,161,160,139,139,54
"4955",54,"[20]dHoIoHcoxHnJqGKCijkE",295,0.996622,20,296,1,295,1,1,0,1,1,152,151,144,144,54
"4956",55,"[20]dHoIoHcoxHnJqGKCijkE",296,0.996633,20,297,1,296,1,1,0,1,1,147,146,150,150,54
"4957",56,"[20]dHoIoHcoxHnJqGKCijkE",291,0.996575,20,292,1,291,1,1,0,1,1,135,134,157,157,54
"4958",57,"[20]dHoIoHcoxHnJqGKCijkE",293,0.996599,20,294,1,293,1,1,0,1,1,138,137,156,156,54
"4959",58,"[20]dHoIoHcoxHnJqGKCijkE",298,0.996656,20,299,1,298,1,1,0,1,1,154,153,145,145,54
"4960",59,"[20]dHoIoHcoxHnJqGKCijkE",297,0.996644,20,298,1,297,1,1,0,1,1,150,149,148,148,54
"4961",60,"[20]dHoIoHcoxHnJqGKCijkE",294,0.99661,20,295,1,294,1,1,0,1,1,148,147,147,147,54
"4962",61,"[20]dHoIoHcoxHnJqGKCijkE",295,0.996622,20,296,1,295,1,1,0,1,1,149,148,147,147,54
"4963",62,"[20]dHoIoHcoxHnJqGKCijkE",296,0.996633,20,297,1,296,1,1,0,1,1,149,148,148,148,54
"4964",63,"[20]dHoIoHcoxHnJqGKCijkE",291,0.996575,20,292,1,291,1,1,0,1,1,136,135,156,156,54
"4965",64,"[20]dHoIoHcoxHnJqGKCijkE",293,0.996599,20,294,1,293,1,1,0,1,1,136,135,158,158,54
"4966",65,"[20]dHoIoHcoxHnJqGKCijkE",306,0.996743,20,307,1,306,1,1,0,1,1,174,173,133,133,54
"4967",66,"[20]dHoIoHcoxHnJqGKCijkE",302,0.9967,20,303,1,302,1,1,0,1,1,168,167,135,135,54
"4968",67,"[20]dHoIoHcoxHnJqGKCijkE",299,0.996667,20,300,1,299,1,1,0,1,1,159,158,141,141,54
"4969",68,"[20]dHoIoHcoxHnJqGKCijkE",293,0.996599,20,294,1,293,1,1,0,1,1,143,142,151,151,54
"4970",69,"[20]dHoIoHcoxHnJqGKCijkE",294,0.99661,20,295,1,294,1,1,0,1,1,141,140,154,154,54
"4971",70,"[20]dHoIoHcoxHnJqGKCijkE",298,0.996656,20,299,1,298,1,1,0,1,1,155,154,144,144,54
"4972",71,"[20]dHoIoHcoxHnJqGKCijkE",295,0.996622,20,296,1,295,1,1,0,1,1,153,152,143,143,54
"4973",72,"[20]dHoIoHcoxHnJqGKCijkE",292,0.996587,20,293,1,292,1,1,0,1,1,141,140,152,152,54
"4974",73,"[20]dHoIoHcoxHnJqGKCijkE",305,0.996732,20,306,1,305,1,1,0,1,1,173,172,133,133,54
"4975",74,"[20]dHoIoHcoxHnJqGKCijkE",299,0.996667,20,300,1,299,1,1,0,1,1,161,160,139,139,54
"4976",75,"[20]dHoIoHcoxHnJqGKCijkE",305,0.996732,20,306,1,305,1,1,0,1,1,168,167,138,138,54
"4977",76,"[20]dHoIoHcoxHnJqGKCijkE",298,0.996656,20,299,1,298,1,1,0,1,1,150,149,149,149,54
"4978",77,"[20]dHoIoHcoxHnJqGKCijkE",293,0.996599,20,294,1,293,1,1,0,1,1,142,141,152,152,54
"4979",78,"[20]dHoIoHcoxHnJqGKCijkE",300,0.996678,20,301,1,300,1,1,0,1,1,160,159,141,141,54
"4980",79,"[20]dHoIoHcoxHnJqGKCijkE",299,0.996667,20,300,1,299,1,1,0,1,1,156,155,144,144,54
"4981",80,"[20]dHoIoHcoxHnJqGKCijkE",296,0.996633,20,297,1,296,1,1,0,1,1,148,147,149,149,54
"4982",81,"[20]dHoIoHcoxHnJqGKCijkE",294,0.99661,20,295,1,294,1,1,0,1,1,137,136,158,158,54
"4983",82,"[20]dHoIoHcoxHnJqGKCijkE",303,0.996711,20,304,1,303,1,1,0,1,1,166,165,138,138,54
"4984",83,"[20]dHoIoHcoxHnJqGKCijkE",292,0.996587,20,293,1,292,1,1,0,1,1,133,132,160,160,54
"4985",84,"[20]dHoIoHcoxHnJqGKCijkE",295,0.996622,20,296,1,295,1,1,0,1,1,146,145,150,150,54
"4986",85,"[20]dHoIoHcoxHnJqGKCijkE",298,0.996656,20,299,1,298,1,1,0,1,1,155,154,144,144,54
"4987",86,"[20]dHoIoHcoxHnJqGKCijkE",290,0.996564,20,291,1,290,1,1,0,1,1,132,131,159,159,54
"4988",87,"[20]dHoIoHcoxHnJqGKCijkE",284,0.996491,20,285,1,284,1,1,0,1,1,126,125,159,159,54
"4989",88,"[20]dHoIoHcoxHnJqGKCijkE",295,0.996622,20,296,1,295,1,1,0,1,1,146,145,150,150,54
"4990",89,"[20]dHoIoHcoxHnJqGKCijkE",296,0.996633,20,297,1,296,1,1,0,1,1,145,144,152,152,54
"4991",90,"[20]dHoIoHcoxHnJqGKCijkE",291,0.996575,20,292,1,291,1,1,0,1,1,137,136,155,155,54
"4992",91,"[20]dHoIoHcoxHnJqGKCijkE",297,0.996644,20,298,1,297,1,1,0,1,1,155,154,143,143,54
"4993",92,"[20]dHoIoHcoxHnJqGKCijkE",302,0.9967,20,303,1,302,1,1,0,1,1,152,151,151,151,54
"4994",93,"[20]dHoIoHcoxHnJqGKCijkE",301,0.996689,20,302,1,301,1,1,0,1,1,158,157,144,144,54
"4995",94,"[20]dHoIoHcoxHnJqGKCijkE",290,0.996564,20,291,1,290,1,1,0,1,1,132,131,159,159,54
"4996",95,"[20]dHoIoHcoxHnJqGKCijkE",289,0.996552,20,290,1,289,1,1,0,1,1,141,140,149,149,54
"4997",96,"[20]dHoIoHcoxHnJqGKCijkE",293,0.996599,20,294,1,293,1,1,0,1,1,141,140,153,153,54
"4998",97,"[20]dHoIoHcoxHnJqGKCijkE",298,0.996656,20,299,1,298,1,1,0,1,1,156,155,143,143,54
"4999",98,"[20]dHoIoHcoxHnJqGKCijkE",294,0.99661,20,295,1,294,1,1,0,1,1,148,147,147,147,54
"5000",99,"[20]dHoIoHcoxHnJqGKCijkE",298,0.996656,20,299,1,298,1,1,0,1,1,158,157,141,141,54
"5001",0,"[25]joIoHcotHnJHGqKCGywwHmkzz",283,0.996479,25,284,1,283,1,1,0,1,1,156,155,128,128,55
"5002",1,"[25]joIoHcotHnJHGqKCGywwHmkzz",274,0.996364,25,275,1,274,1,1,0,1,1,128,127,147,147,55
"5003",2,"[25]joIoHcotHnJHGqKCGywwHmkzz",285,0.996503,25,286,1,285,1,1,0,1,1,142,141,144,144,55
"5004",3,"[25]joIoHcotHnJHGqKCGywwHmkzz",281,0.996454,25,282,1,281,1,1,0,1,1,152,151,130,130,55
"5005",4,"[25]joIoHcotHnJHGqKCGywwHmkzz",272,0.996337,25,273,1,272,1,1,0,1,1,130,129,143,143,55
"5006",5,"[25]joIoHcotHnJHGqKCGywwHmkzz",277,0.996403,25,278,1,277,1,1,0,1,1,131,130,147,147,55
"5007",6,"[25]joIoHcotHnJHGqKCGywwHmkzz",281,0.996454,25,282,1,281,1,1,0,1,1,151,150,131,131,55
"5008",7,"[25]joIoHcotHnJHGqKCGywwHmkzz",282,0.996466,25,283,1,282,1,1,0,1,1,139,138,144,144,55
"5009",8,"[25]joIoHcotHnJHGqKCGywwHmkzz",282,0.996466,25,283,1,282,1,1,0,1,1,118,117,165,165,55
"5010",9,"[25]joIoHcotHnJHGqKCGywwHmkzz",283,0.996479,25,284,1,283,1,1,0,1,1,139,138,145,145,55
"5011",10,"[25]joIoHcotHnJHGqKCGywwHmkzz",272,0.996337,25,273,1,272,1,1,0,1,1,151,150,122,122,55
"5012",11,"[25]joIoHcotHnJHGqKCGywwHmkzz",287,0.996528,25,288,1,287,1,1,0,1,1,141,140,147,147,55
"5013",12,"[25]joIoHcotHnJHGqKCGywwHmkzz",278,0.996416,25,279,1,278,1,1,0,1,1,134,133,145,145,55
"5014",13,"[25]joIoHcotHnJHGqKCGywwHmkzz",280,0.996441,25,281,1,280,1,1,0,1,1,145,144,136,136,55
"5015",14,"[25]joIoHcotHnJHGqKCGywwHmkzz",280,0.996441,25,281,1,280,1,1,0,1,1,153,152,128,128,55
"5016",15,"[25]joIoHcotHnJHGqKCGywwHmkzz",285,0.996503,25,286,1,285,1,1,0,1,1,160,159,126,126,55
"5017",16,"[25]joIoHcotHnJHGqKCGywwHmkzz",279,0.996429,25,280,1,279,1,1,0,1,1,145,144,135,135,55
"5018",17,"[25]joIoHcotHnJHGqKCGywwHmkzz",284,0.996491,25,285,1,284,1,1,0,1,1,148,147,137,137,55
"5019",18,"[25]joIoHcotHnJHGqKCGywwHmkzz",282,0.996466,25,283,1,282,1,1,0,1,1,151,150,132,132,55
"5020",19,"[25]joIoHcotHnJHGqKCGywwHmkzz",284,0.996491,25,285,1,284,1,1,0,1,1,160,159,125,125,55
"5021",20,"[25]joIoHcotHnJHGqKCGywwHmkzz",279,0.996429,25,280,1,279,1,1,0,1,1,132,131,148,148,55
"5022",21,"[25]joIoHcotHnJHGqKCGywwHmkzz",282,0.996466,25,283,1,282,1,1,0,1,1,144,143,139,139,55
"5023",22,"[25]joIoHcotHnJHGqKCGywwHmkzz",281,0.996454,25,282,1,281,1,1,0,1,1,164,163,118,118,55
"5024",23,"[25]joIoHcotHnJHGqKCGywwHmkzz",280,0.996441,25,281,1,280,1,1,0,1,1,158,157,123,123,55
"5025",24,"[25]joIoHcotHnJHGqKCGywwHmkzz",290,0.996564,25,291,1,290,1,1,0,1,1,162,161,129,129,55
"5026",25,"[25]joIoHcotHnJHGqKCGywwHmkzz",284,0.996491,25,285,1,284,1,1,0,1,1,133,132,152,152,55
"5027",26,"[25]joIoHcotHnJHGqKCGywwHmkzz",284,0.996491,25,285,1,284,1,1,0,1,1,137,136,148,148,55
"5028",27,"[25]joIoHcotHnJHGqKCGywwHmkzz",290,0.996564,25,291,1,290,1,1,0,1,1,162,161,129,129,55
"5029",28,"[25]joIoHcotHnJHGqKCGywwHmkzz",280,0.996441,25,281,1,280,1,1,0,1,1,147,146,134,134,55
"5030",29,"[25]joIoHcotHnJHGqKCGywwHmkzz",275,0.996377,25,276,1,275,1,1,0,1,1,125,124,151,151,55
"5031",30,"[25]joIoHcotHnJHGqKCGywwHmkzz",281,0.996454,25,282,1,281,1,1,0,1,1,134,133,148,148,55
"5032",31,"[25]joIoHcotHnJHGqKCGywwHmkzz",276,0.99639,25,277,1,276,1,1,0,1,1,129,128,148,148,55
"5033",32,"[25]joIoHcotHnJHGqKCGywwHmkzz",283,0.996479,25,284,1,283,1,1,0,1,1,143,142,141,141,55
"5034",33,"[25]joIoHcotHnJHGqKCGywwHmkzz",279,0.996429,25,280,1,279,1,1,0,1,1,147,146,133,133,55
"5035",34,"[25]joIoHcotHnJHGqKCGywwHmkzz",276,0.99639,25,277,1,276,1,1,0,1,1,143,142,134,134,55
"5036",35,"[25]joIoHcotHnJHGqKCGywwHmkzz",280,0.996441,25,281,1,280,1,1,0,1,1,142,141,139,139,55
"5037",36,"[25]joIoHcotHnJHGqKCGywwHmkzz",280,0.996441,25,281,1,280,1,1,0,1,1,143,142,138,138,55
"5038",37,"[25]joIoHcotHnJHGqKCGywwHmkzz",279,0.996429,25,280,1,279,1,1,0,1,1,145,144,135,135,55
"5039",38,"[25]joIoHcotHnJHGqKCGywwHmkzz",284,0.996491,25,285,1,284,1,1,0,1,1,143,142,142,142,55
"5040",39,"[25]joIoHcotHnJHGqKCGywwHmkzz",286,0.996516,25,287,1,286,1,1,0,1,1,141,140,146,146,55
"5041",40,"[25]joIoHcotHnJHGqKCGywwHmkzz",284,0.996491,25,285,1,284,1,1,0,1,1,142,141,143,143,55
"5042",41,"[25]joIoHcotHnJHGqKCGywwHmkzz",276,0.99639,25,277,1,276,1,1,0,1,1,151,150,126,126,55
"5043",42,"[25]joIoHcotHnJHGqKCGywwHmkzz",283,0.996479,25,284,1,283,1,1,0,1,1,158,157,126,126,55
"5044",43,"[25]joIoHcotHnJHGqKCGywwHmkzz",276,0.99639,25,277,1,276,1,1,0,1,1,136,135,141,141,55
"5045",44,"[25]joIoHcotHnJHGqKCGywwHmkzz",279,0.996429,25,280,1,279,1,1,0,1,1,139,138,141,141,55
"5046",45,"[25]joIoHcotHnJHGqKCGywwHmkzz",285,0.996503,25,286,1,285,1,1,0,1,1,147,146,139,139,55
"5047",46,"[25]joIoHcotHnJHGqKCGywwHmkzz",277,0.996403,25,278,1,277,1,1,0,1,1,140,139,138,138,55
"5048",47,"[25]joIoHcotHnJHGqKCGywwHmkzz",283,0.996479,25,284,1,283,1,1,0,1,1,148,147,136,136,55
"5049",48,"[25]joIoHcotHnJHGqKCGywwHmkzz",290,0.996564,25,291,1,290,1,1,0,1,1,147,146,144,144,55
"5050",49,"[25]joIoHcotHnJHGqKCGywwHmkzz",277,0.996403,25,278,1,277,1,1,0,1,1,140,139,138,138,55
"5051",50,"[25]joIoHcotHnJHGqKCGywwHmkzz",271,0.996324,25,272,1,271,1,1,0,1,1,135,134,137,137,55
"5052",51,"[25]joIoHcotHnJHGqKCGywwHmkzz",280,0.996441,25,281,1,280,1,1,0,1,1,143,142,138,138,55
"5053",52,"[25]joIoHcotHnJHGqKCGywwHmkzz",275,0.996377,25,276,1,275,1,1,0,1,1,122,121,154,154,55
"5054",53,"[25]joIoHcotHnJHGqKCGywwHmkzz",289,0.996552,25,290,1,289,1,1,0,1,1,142,141,148,148,55
"5055",54,"[25]joIoHcotHnJHGqKCGywwHmkzz",278,0.996416,25,279,1,278,1,1,0,1,1,132,131,147,147,55
"5056",55,"[25]joIoHcotHnJHGqKCGywwHmkzz",289,0.996552,25,290,1,289,1,1,0,1,1,142,141,148,148,55
"5057",56,"[25]joIoHcotHnJHGqKCGywwHmkzz",283,0.996479,25,284,1,283,1,1,0,1,1,148,147,136,136,55
"5058",57,"[25]joIoHcotHnJHGqKCGywwHmkzz",282,0.996466,25,283,1,282,1,1,0,1,1,154,153,129,129,55
"5059",58,"[25]joIoHcotHnJHGqKCGywwHmkzz",283,0.996479,25,284,1,283,1,1,0,1,1,137,136,147,147,55
"5060",59,"[25]joIoHcotHnJHGqKCGywwHmkzz",279,0.996429,25,280,1,279,1,1,0,1,1,150,149,130,130,55
"5061",60,"[25]joIoHcotHnJHGqKCGywwHmkzz",282,0.996466,25,283,1,282,1,1,0,1,1,140,139,143,143,55
"5062",61,"[25]joIoHcotHnJHGqKCGywwHmkzz",275,0.996377,25,276,1,275,1,1,0,1,1,163,162,113,113,55
"5063",62,"[25]joIoHcotHnJHGqKCGywwHmkzz",285,0.996503,25,286,1,285,1,1,0,1,1,144,143,142,142,55
"5064",63,"[25]joIoHcotHnJHGqKCGywwHmkzz",285,0.996503,25,286,1,285,1,1,0,1,1,137,136,149,149,55
"5065",64,"[25]joIoHcotHnJHGqKCGywwHmkzz",286,0.996516,25,287,1,286,1,1,0,1,1,152,151,135,135,55
"5066",65,"[25]joIoHcotHnJHGqKCGywwHmkzz",282,0.996466,25,283,1,282,1,1,0,1,1,139,138,144,144,55
"5067",66,"[25]joIoHcotHnJHGqKCGywwHmkzz",282,0.996466,25,283,1,282,1,1,0,1,1,145,144,138,138,55
"5068",67,"[25]joIoHcotHnJHGqKCGywwHmkzz",290,0.996564,25,291,1,290,1,1,0,1,1,150,149,141,141,55
"5069",68,"[25]joIoHcotHnJHGqKCGywwHmkzz",283,0.996479,25,284,1,283,1,1,0,1,1,155,154,129,129,55
"5070",69,"[25]joIoHcotHnJHGqKCGywwHmkzz",284,0.996491,25,285,1,284,1,1,0,1,1,133,132,152,152,55
"5071",70,"[25]joIoHcotHnJHGqKCGywwHmkzz",274,0.996364,25,275,1,274,1,1,0,1,1,140,139,135,135,55
"5072",71,"[25]joIoHcotHnJHGqKCGywwHmkzz",285,0.996503,25,286,1,285,1,1,0,1,1,135,134,151,151,55
"5073",72,"[25]joIoHcotHnJHGqKCGywwHmkzz",279,0.996429,25,280,1,279,1,1,0,1,1,138,137,142,142,55
"5074",73,"[25]joIoHcotHnJHGqKCGywwHmkzz",287,0.996528,25,288,1,287,1,1,0,1,1,141,140,147,147,55
"5075",74,"[25]joIoHcotHnJHGqKCGywwHmkzz",286,0.996516,25,287,1,286,1,1,0,1,1,151,150,136,136,55
"5076",75,"[25]joIoHcotHnJHGqKCGywwHmkzz",286,0.996516,25,287,1,286,1,1,0,1,1,157,156,130,130,55
"5077",76,"[25]joIoHcotHnJHGqKCGywwHmkzz",284,0.996491,25,285,1,284,1,1,0,1,1,152,151,133,133,55
"5078",77,"[25]joIoHcotHnJHGqKCGywwHmkzz",282,0.996466,25,283,1,282,1,1,0,1,1,154,153,129,129,55
"5079",78,"[25]joIoHcotHnJHGqKCGywwHmkzz",283,0.996479,25,284,1,283,1,1,0,1,1,132,131,152,152,55
"5080",79,"[25]joIoHcotHnJHGqKCGywwHmkzz",282,0.996466,25,283,1,282,1,1,0,1,1,139,138,144,144,55
"5081",80,"[25]joIoHcotHnJHGqKCGywwHmkzz",287,0.996528,25,288,1,287,1,1,0,1,1,158,157,130,130,55
"5082",81,"[25]joIoHcotHnJHGqKCGywwHmkzz",284,0.996491,25,285,1,284,1,1,0,1,1,161,160,124,124,55
"5083",82,"[25]joIoHcotHnJHGqKCGywwHmkzz",281,0.996454,25,282,1,281,1,1,0,1,1,138,137,144,144,55
"5084",83,"[25]joIoHcotHnJHGqKCGywwHmkzz",278,0.996416,25,279,1,278,1,1,0,1,1,151,150,128,128,55
"5085",84,"[25]joIoHcotHnJHGqKCGywwHmkzz",280,0.996441,25,281,1,280,1,1,0,1,1,152,151,129,129,55
"5086",85,"[25]joIoHcotHnJHGqKCGywwHmkzz",293,0.996599,25,294,1,293,1,1,0,1,1,162,161,132,132,55
"5087",86,"[25]joIoHcotHnJHGqKCGywwHmkzz",290,0.996564,25,291,1,290,1,1,0,1,1,151,150,140,140,55
"5088",87,"[25]joIoHcotHnJHGqKCGywwHmkzz",267,0.996269,25,268,1,267,1,1,0,1,1,117,116,151,151,55
"5089",88,"[25]joIoHcotHnJHGqKCGywwHmkzz",278,0.996416,25,279,1,278,1,1,0,1,1,136,135,143,143,55
"5090",89,"[25]joIoHcotHnJHGqKCGywwHmkzz",282,0.996466,25,283,1,282,1,1,0,1,1,147,146,136,136,55
"5091",90,"[25]joIoHcotHnJHGqKCGywwHmkzz",283,0.996479,25,284,1,283,1,1,0,1,1,142,141,142,142,55
"5092",91,"[25]joIoHcotHnJHGqKCGywwHmkzz",287,0.996528,25,288,1,287,1,1,0,1,1,135,134,153,153,55
"5093",92,"[25]joIoHcotHnJHGqKCGywwHmkzz",276,0.99639,25,277,1,276,1,1,0,1,1,150,149,127,127,55
"5094",93,"[25]joIoHcotHnJHGqKCGywwHmkzz",285,0.996503,25,286,1,285,1,1,0,1,1,164,163,122,122,55
"5095",94,"[25]joIoHcotHnJHGqKCGywwHmkzz",282,0.996466,25,283,1,282,1,1,0,1,1,149,148,134,134,55
"5096",95,"[25]joIoHcotHnJHGqKCGywwHmkzz",285,0.996503,25,286,1,285,1,1,0,1,1,142,141,144,144,55
"5097",96,"[25]joIoHcotHnJHGqKCGywwHmkzz",281,0.996454,25,282,1,281,1,1,0,1,1,144,143,138,138,55
"5098",97,"[25]joIoHcotHnJHGqKCGywwHmkzz",282,0.996466,25,283,1,282,1,1,0,1,1,146,145,137,137,55
"5099",98,"[25]joIoHcotHnJHGqKCGywwHmkzz",289,0.996552,25,290,1,289,1,1,0,1,1,133,132,157,157,55
"5100",99,"[25]joIoHcotHnJHGqKCGywwHmkzz",278,0.996416,25,279,1,278,1,1,0,1,1,141,140,138,138,55
"5101",0,"[26]glHoIoHcotHnJHGqKCGCwkdGCv",281,0.996454,26,282,1,281,1,1,0,1,1,149,148,133,133,56
"5102",1,"[26]glHoIoHcotHnJHGqKCGCwkdGCv",278,0.996416,26,279,1,278,1,1,0,1,1,143,142,136,136,56
"5103",2,"[26]glHoIoHcotHnJHGqKCGCwkdGCv",289,0.996552,26,290,1,289,1,1,0,1,1,156,155,134,134,56
"5104",3,"[26]glHoIoHcotHnJHGqKCGCwkdGCv",275,0.996377,26,276,1,275,1,1,0,1,1,120,119,156,156,56
"5105",4,"[26]glHoIoHcotHnJHGqKCGCwkdGCv",268,0.996283,26,269,1,268,1,1,0,1,1,128,127,141,141,56
"5106",5,"[26]glHoIoHcotHnJHGqKCGCwkdGCv",274,0.996364,26,275,1,274,1,1,0,1,1,146,145,129,129,56
"5107",6,"[26]glHoIoHcotHnJHGqKCGCwkdGCv",277,0.996403,26,278,1,277,1,1,0,1,1,124,123,154,154,56
"5108",7,"[26]glHoIoHcotHnJHGqKCGCwkdGCv",278,0.996416,26,279,1,278,1,1,0,1,1,153,152,126,126,56
"5109",8,"[26]glHoIoHcotHnJHGqKCGCwkdGCv",279,0.996429,26,280,1,279,1,1,0,1,1,130,129,150,150,56
"5110",9,"[26]glHoIoHcotHnJHGqKCGCwkdGCv",283,0.996479,26,284,1,283,1,1,0,1,1,138,137,146,146,56
"5111",10,"[26]glHoIoHcotHnJHGqKCGCwkdGCv",288,0.99654,26,289,1,288,1,1,0,1,1,165,164,124,124,56
"5112",11,"[26]glHoIoHcotHnJHGqKCGCwkdGCv",285,0.996503,26,286,1,285,1,1,0,1,1,146,145,140,140,56
"5113",12,"[26]glHoIoHcotHnJHGqKCGCwkdGCv",278,0.996416,26,279,1,278,1,1,0,1,1,135,134,144,144,56
"5114",13,"[26]glHoIoHcotHnJHGqKCGCwkdGCv",282,0.996466,26,283,1,282,1,1,0,1,1,138,137,145,145,56
"5115",14,"[26]glHoIoHcotHnJHGqKCGCwkdGCv",283,0.996479,26,284,1,283,1,1,0,1,1,152,151,132,132,56
"5116",15,"[26]glHoIoHcotHnJHGqKCGCwkdGCv",275,0.996377,26,276,1,275,1,1,0,1,1,122,121,154,154,56
"5117",16,"[26]glHoIoHcotHnJHGqKCGCwkdGCv",272,0.996337,26,273,1,272,1,1,0,1,1,131,130,142,142,56
"5118",17,"[26]glHoIoHcotHnJHGqKCGCwkdGCv",279,0.996429,26,280,1,279,1,1,0,1,1,146,145,134,134,56
"5119",18,"[26]glHoIoHcotHnJHGqKCGCwkdGCv",283,0.996479,26,284,1,283,1,1,0,1,1,140,139,144,144,56
"5120",19,"[26]glHoIoHcotHnJHGqKCGCwkdGCv",279,0.996429,26,280,1,279,1,1,0,1,1,143,142,137,137,56
"5121",20,"[26]glHoIoHcotHnJHGqKCGCwkdGCv",276,0.99639,26,277,1,276,1,1,0,1,1,138,137,139,139,56
"5122",21,"[26]glHoIoHcotHnJHGqKCGCwkdGCv",287,0.996528,26,288,1,287,1,1,0,1,1,150,149,138,138,56
"5123",22,"[26]glHoIoHcotHnJHGqKCGCwkdGCv",282,0.996466,26,283,1,282,1,1,0,1,1,157,156,126,126,56
"5124",23,"[26]glHoIoHcotHnJHGqKCGCwkdGCv",280,0.996441,26,281,1,280,1,1,0,1,1,146,145,135,135,56
"5125",24,"[26]glHoIoHcotHnJHGqKCGCwkdGCv",278,0.996416,26,279,1,278,1,1,0,1,1,154,153,125,125,56
"5126",25,"[26]glHoIoHcotHnJHGqKCGCwkdGCv",280,0.996441,26,281,1,280,1,1,0,1,1,151,150,130,130,56
"5127",26,"[26]glHoIoHcotHnJHGqKCGCwkdGCv",275,0.996377,26,276,1,275,1,1,0,1,1,144,143,132,132,56
"5128",27,"[26]glHoIoHcotHnJHGqKCGCwkdGCv",277,0.996403,26,278,1,277,1,1,0,1,1,143,142,135,135,56
"5129",28,"[26]glHoIoHcotHnJHGqKCGCwkdGCv",278,0.996416,26,279,1,278,1,1,0,1,1,137,136,142,142,56
"5130",29,"[26]glHoIoHcotHnJHGqKCGCwkdGCv",273,0.99635,26,274,1,273,1,1,0,1,1,120,119,154,154,56
"5131",30,"[26]glHoIoHcotHnJHGqKCGCwkdGCv",283,0.996479,26,284,1,283,1,1,0,1,1,165,164,119,119,56
"5132",31,"[26]glHoIoHcotHnJHGqKCGCwkdGCv",276,0.99639,26,277,1,276,1,1,0,1,1,143,142,134,134,56
"5133",32,"[26]glHoIoHcotHnJHGqKCGCwkdGCv",289,0.996552,26,290,1,289,1,1,0,1,1,160,159,130,130,56
"5134",33,"[26]glHoIoHcotHnJHGqKCGCwkdGCv",280,0.996441,26,281,1,280,1,1,0,1,1,138,137,143,143,56
"5135",34,"[26]glHoIoHcotHnJHGqKCGCwkdGCv",285,0.996503,26,286,1,285,1,1,0,1,1,150,149,136,136,56
"5136",35,"[26]glHoIoHcotHnJHGqKCGCwkdGCv",283,0.996479,26,284,1,283,1,1,0,1,1,132,131,152,152,56
"5137",36,"[26]glHoIoHcotHnJHGqKCGCwkdGCv",288,0.99654,26,289,1,288,1,1,0,1,1,151,150,138,138,56
"5138",37,"[26]glHoIoHcotHnJHGqKCGCwkdGCv",283,0.996479,26,284,1,283,1,1,0,1,1,160,159,124,124,56
"5139",38,"[26]glHoIoHcotHnJHGqKCGCwkdGCv",281,0.996454,26,282,1,281,1,1,0,1,1,150,149,132,132,56
"5140",39,"[26]glHoIoHcotHnJHGqKCGCwkdGCv",279,0.996429,26,280,1,279,1,1,0,1,1,136,135,144,144,56
"5141",40,"[26]glHoIoHcotHnJHGqKCGCwkdGCv",288,0.99654,26,289,1,288,1,1,0,1,1,140,139,149,149,56
"5142",41,"[26]glHoIoHcotHnJHGqKCGCwkdGCv",279,0.996429,26,280,1,279,1,1,0,1,1,140,139,140,140,56
"5143",42,"[26]glHoIoHcotHnJHGqKCGCwkdGCv",283,0.996479,26,284,1,283,1,1,0,1,1,154,153,130,130,56
"5144",43,"[26]glHoIoHcotHnJHGqKCGCwkdGCv",290,0.996564,26,291,1,290,1,1,0,1,1,147,146,144,144,56
"5145",44,"[26]glHoIoHcotHnJHGqKCGCwkdGCv",282,0.996466,26,283,1,282,1,1,0,1,1,134,133,149,149,56
"5146",45,"[26]glHoIoHcotHnJHGqKCGCwkdGCv",279,0.996429,26,280,1,279,1,1,0,1,1,135,134,145,145,56
"5147",46,"[26]glHoIoHcotHnJHGqKCGCwkdGCv",279,0.996429,26,280,1,279,1,1,0,1,1,148,147,132,132,56
"5148",47,"[26]glHoIoHcotHnJHGqKCGCwkdGCv",280,0.996441,26,281,1,280,1,1,0,1,1,136,135,145,145,56
"5149",48,"[26]glHoIoHcotHnJHGqKCGCwkdGCv",278,0.996416,26,279,1,278,1,1,0,1,1,153,152,126,126,56
"5150",49,"[26]glHoIoHcotHnJHGqKCGCwkdGCv",281,0.996454,26,282,1,281,1,1,0,1,1,137,136,145,145,56
"5151",50,"[26]glHoIoHcotHnJHGqKCGCwkdGCv",279,0.996429,26,280,1,279,1,1,0,1,1,136,135,144,144,56
"5152",51,"[26]glHoIoHcotHnJHGqKCGCwkdGCv",286,0.996516,26,287,1,286,1,1,0,1,1,143,142,144,144,56
"5153",52,"[26]glHoIoHcotHnJHGqKCGCwkdGCv",278,0.996416,26,279,1,278,1,1,0,1,1,138,137,141,141,56
"5154",53,"[26]glHoIoHcotHnJHGqKCGCwkdGCv",279,0.996429,26,280,1,279,1,1,0,1,1,137,136,143,143,56
"5155",54,"[26]glHoIoHcotHnJHGqKCGCwkdGCv",279,0.996429,26,280,1,279,1,1,0,1,1,142,141,138,138,56
"5156",55,"[26]glHoIoHcotHnJHGqKCGCwkdGCv",277,0.996403,26,278,1,277,1,1,0,1,1,128,127,150,150,56
"5157",56,"[26]glHoIoHcotHnJHGqKCGCwkdGCv",275,0.996377,26,276,1,275,1,1,0,1,1,142,141,134,134,56
"5158",57,"[26]glHoIoHcotHnJHGqKCGCwkdGCv",281,0.996454,26,282,1,281,1,1,0,1,1,143,142,139,139,56
"5159",58,"[26]glHoIoHcotHnJHGqKCGCwkdGCv",281,0.996454,26,282,1,281,1,1,0,1,1,167,166,115,115,56
"5160",59,"[26]glHoIoHcotHnJHGqKCGCwkdGCv",276,0.99639,26,277,1,276,1,1,0,1,1,137,136,140,140,56
"5161",60,"[26]glHoIoHcotHnJHGqKCGCwkdGCv",285,0.996503,26,286,1,285,1,1,0,1,1,161,160,125,125,56
"5162",61,"[26]glHoIoHcotHnJHGqKCGCwkdGCv",284,0.996491,26,285,1,284,1,1,0,1,1,138,137,147,147,56
"5163",62,"[26]glHoIoHcotHnJHGqKCGCwkdGCv",271,0.996324,26,272,1,271,1,1,0,1,1,122,121,150,150,56
"5164",63,"[26]glHoIoHcotHnJHGqKCGCwkdGCv",279,0.996429,26,280,1,279,1,1,0,1,1,136,135,144,144,56
"5165",64,"[26]glHoIoHcotHnJHGqKCGCwkdGCv",274,0.996364,26,275,1,274,1,1,0,1,1,137,136,138,138,56
"5166",65,"[26]glHoIoHcotHnJHGqKCGCwkdGCv",276,0.99639,26,277,1,276,1,1,0,1,1,132,131,145,145,56
"5167",66,"[26]glHoIoHcotHnJHGqKCGCwkdGCv",281,0.996454,26,282,1,281,1,1,0,1,1,144,143,138,138,56
"5168",67,"[26]glHoIoHcotHnJHGqKCGCwkdGCv",271,0.996324,26,272,1,271,1,1,0,1,1,123,122,149,149,56
"5169",68,"[26]glHoIoHcotHnJHGqKCGCwkdGCv",280,0.996441,26,281,1,280,1,1,0,1,1,135,134,146,146,56
"5170",69,"[26]glHoIoHcotHnJHGqKCGCwkdGCv",279,0.996429,26,280,1,279,1,1,0,1,1,142,141,138,138,56
"5171",70,"[26]glHoIoHcotHnJHGqKCGCwkdGCv",280,0.996441,26,281,1,280,1,1,0,1,1,148,147,133,133,56
"5172",71,"[26]glHoIoHcotHnJHGqKCGCwkdGCv",279,0.996429,26,280,1,279,1,1,0,1,1,129,128,151,151,56
"5173",72,"[26]glHoIoHcotHnJHGqKCGCwkdGCv",276,0.99639,26,277,1,276,1,1,0,1,1,130,129,147,147,56
"5174",73,"[26]glHoIoHcotHnJHGqKCGCwkdGCv",286,0.996516,26,287,1,286,1,1,0,1,1,151,150,136,136,56
"5175",74,"[26]glHoIoHcotHnJHGqKCGCwkdGCv",277,0.996403,26,278,1,277,1,1,0,1,1,139,138,139,139,56
"5176",75,"[26]glHoIoHcotHnJHGqKCGCwkdGCv",274,0.996364,26,275,1,274,1,1,0,1,1,131,130,144,144,56
"5177",76,"[26]glHoIoHcotHnJHGqKCGCwkdGCv",282,0.996466,26,283,1,282,1,1,0,1,1,145,144,138,138,56
"5178",77,"[26]glHoIoHcotHnJHGqKCGCwkdGCv",282,0.996466,26,283,1,282,1,1,0,1,1,140,139,143,143,56
"5179",78,"[26]glHoIoHcotHnJHGqKCGCwkdGCv",278,0.996416,26,279,1,278,1,1,0,1,1,137,136,142,142,56
"5180",79,"[26]glHoIoHcotHnJHGqKCGCwkdGCv",283,0.996479,26,284,1,283,1,1,0,1,1,135,134,149,149,56
"5181",80,"[26]glHoIoHcotHnJHGqKCGCwkdGCv",279,0.996429,26,280,1,279,1,1,0,1,1,140,139,140,140,56
"5182",81,"[26]glHoIoHcotHnJHGqKCGCwkdGCv",283,0.996479,26,284,1,283,1,1,0,1,1,146,145,138,138,56
"5183",82,"[26]glHoIoHcotHnJHGqKCGCwkdGCv",279,0.996429,26,280,1,279,1,1,0,1,1,145,144,135,135,56
"5184",83,"[26]glHoIoHcotHnJHGqKCGCwkdGCv",284,0.996491,26,285,1,284,1,1,0,1,1,135,134,150,150,56
"5185",84,"[26]glHoIoHcotHnJHGqKCGCwkdGCv",283,0.996479,26,284,1,283,1,1,0,1,1,136,135,148,148,56
"5186",85,"[26]glHoIoHcotHnJHGqKCGCwkdGCv",283,0.996479,26,284,1,283,1,1,0,1,1,155,154,129,129,56
"5187",86,"[26]glHoIoHcotHnJHGqKCGCwkdGCv",280,0.996441,26,281,1,280,1,1,0,1,1,138,137,143,143,56
"5188",87,"[26]glHoIoHcotHnJHGqKCGCwkdGCv",284,0.996491,26,285,1,284,1,1,0,1,1,143,142,142,142,56
"5189",88,"[26]glHoIoHcotHnJHGqKCGCwkdGCv",277,0.996403,26,278,1,277,1,1,0,1,1,142,141,136,136,56
"5190",89,"[26]glHoIoHcotHnJHGqKCGCwkdGCv",284,0.996491,26,285,1,284,1,1,0,1,1,149,148,136,136,56
"5191",90,"[26]glHoIoHcotHnJHGqKCGCwkdGCv",281,0.996454,26,282,1,281,1,1,0,1,1,136,135,146,146,56
"5192",91,"[26]glHoIoHcotHnJHGqKCGCwkdGCv",282,0.996466,26,283,1,282,1,1,0,1,1,156,155,127,127,56
"5193",92,"[26]glHoIoHcotHnJHGqKCGCwkdGCv",276,0.99639,26,277,1,276,1,1,0,1,1,127,126,150,150,56
"5194",93,"[26]glHoIoHcotHnJHGqKCGCwkdGCv",272,0.996337,26,273,1,272,1,1,0,1,1,135,134,138,138,56
"5195",94,"[26]glHoIoHcotHnJHGqKCGCwkdGCv",278,0.996416,26,279,1,278,1,1,0,1,1,145,144,134,134,56
"5196",95,"[26]glHoIoHcotHnJHGqKCGCwkdGCv",278,0.996416,26,279,1,278,1,1,0,1,1,148,147,131,131,56
"5197",96,"[26]glHoIoHcotHnJHGqKCGCwkdGCv",281,0.996454,26,282,1,281,1,1,0,1,1,157,156,125,125,56
"5198",97,"[26]glHoIoHcotHnJHGqKCGCwkdGCv",287,0.996528,26,288,1,287,1,1,0,1,1,134,133,154,154,56
"5199",98,"[26]glHoIoHcotHnJHGqKCGCwkdGCv",280,0.996441,26,281,1,280,1,1,0,1,1,133,132,148,148,56
"5200",99,"[26]glHoIoHcotHnJHGqKCGCwkdGCv",277,0.996403,26,278,1,277,1,1,0,1,1,140,139,138,138,56
"5201",0,"[30]BmHoIoHcoxHnJqGKCCpmtgAnuqptHD",300,0.996678,30,301,1,300,1,1,0,1,1,162,161,139,139,57
"5202",1,"[30]BmHoIoHcoxHnJqGKCCpmtgAnuqptHD",294,0.99661,30,295,1,294,1,1,0,1,1,141,140,154,154,57
"5203",2,"[30]BmHoIoHcoxHnJqGKCCpmtgAnuqptHD",295,0.996622,30,296,1,295,1,1,0,1,1,151,150,145,145,57
"5204",3,"[30]BmHoIoHcoxHnJqGKCCpmtgAnuqptHD",295,0.996622,30,296,1,295,1,1,0,1,1,145,144,151,151,57
"5205",4,"[30]BmHoIoHcoxHnJqGKCCpmtgAnuqptHD",293,0.996599,30,294,1,293,1,1,0,1,1,142,141,152,152,57
"5206",5,"[30]BmHoIoHcoxHnJqGKCCpmtgAnuqptHD",302,0.9967,30,303,1,302,1,1,0,1,1,170,169,133,133,57
"5207",6,"[30]BmHoIoHcoxHnJqGKCCpmtgAnuqptHD",299,0.996667,30,300,1,299,1,1,0,1,1,159,158,141,141,57
"5208",7,"[30]BmHoIoHcoxHnJqGKCCpmtgAnuqptHD",300,0.996678,30,301,1,300,1,1,0,1,1,161,160,140,140,57
"5209",8,"[30]BmHoIoHcoxHnJqGKCCpmtgAnuqptHD",301,0.996689,30,302,1,301,1,1,0,1,1,164,163,138,138,57
"5210",9,"[30]BmHoIoHcoxHnJqGKCCpmtgAnuqptHD",293,0.996599,30,294,1,293,1,1,0,1,1,137,136,157,157,57
"5211",10,"[30]BmHoIoHcoxHnJqGKCCpmtgAnuqptHD",300,0.996678,30,301,1,300,1,1,0,1,1,162,161,139,139,57
"5212",11,"[30]BmHoIoHcoxHnJqGKCCpmtgAnuqptHD",295,0.996622,30,296,1,295,1,1,0,1,1,146,145,150,150,57
"5213",12,"[30]BmHoIoHcoxHnJqGKCCpmtgAnuqptHD",299,0.996667,30,300,1,299,1,1,0,1,1,156,155,144,144,57
"5214",13,"[30]BmHoIoHcoxHnJqGKCCpmtgAnuqptHD",290,0.996564,30,291,1,290,1,1,0,1,1,140,139,151,151,57
"5215",14,"[30]BmHoIoHcoxHnJqGKCCpmtgAnuqptHD",301,0.996689,30,302,1,301,1,1,0,1,1,167,166,135,135,57
"5216",15,"[30]BmHoIoHcoxHnJqGKCCpmtgAnuqptHD",293,0.996599,30,294,1,293,1,1,0,1,1,139,138,155,155,57
"5217",16,"[30]BmHoIoHcoxHnJqGKCCpmtgAnuqptHD",297,0.996644,30,298,1,297,1,1,0,1,1,153,152,145,145,57
"5218",17,"[30]BmHoIoHcoxHnJqGKCCpmtgAnuqptHD",296,0.996633,30,297,1,296,1,1,0,1,1,145,144,152,152,57
"5219",18,"[30]BmHoIoHcoxHnJqGKCCpmtgAnuqptHD",288,0.99654,30,289,1,288,1,1,0,1,1,130,129,159,159,57
"5220",19,"[30]BmHoIoHcoxHnJqGKCCpmtgAnuqptHD",297,0.996644,30,298,1,297,1,1,0,1,1,152,151,146,146,57
"5221",20,"[30]BmHoIoHcoxHnJqGKCCpmtgAnuqptHD",294,0.99661,30,295,1,294,1,1,0,1,1,141,140,154,154,57
"5222",21,"[30]BmHoIoHcoxHnJqGKCCpmtgAnuqptHD",296,0.996633,30,297,1,296,1,1,0,1,1,146,145,151,151,57
"5223",22,"[30]BmHoIoHcoxHnJqGKCCpmtgAnuqptHD",297,0.996644,30,298,1,297,1,1,0,1,1,152,151,146,146,57
"5224",23,"[30]BmHoIoHcoxHnJqGKCCpmtgAnuqptHD",299,0.996667,30,300,1,299,1,1,0,1,1,158,157,142,142,57
"5225",24,"[30]BmHoIoHcoxHnJqGKCCpmtgAnuqptHD",292,0.996587,30,293,1,292,1,1,0,1,1,137,136,156,156,57
"5226",25,"[30]BmHoIoHcoxHnJqGKCCpmtgAnuqptHD",291,0.996575,30,292,1,291,1,1,0,1,1,144,143,148,148,57
"5227",26,"[30]BmHoIoHcoxHnJqGKCCpmtgAnuqptHD",295,0.996622,30,296,1,295,1,1,0,1,1,160,159,136,136,57
"5228",27,"[30]BmHoIoHcoxHnJqGKCCpmtgAnuqptHD",296,0.996633,30,297,1,296,1,1,0,1,1,144,143,153,153,57
"5229",28,"[30]BmHoIoHcoxHnJqGKCCpmtgAnuqptHD",294,0.99661,30,295,1,294,1,1,0,1,1,153,152,142,142,57
"5230",29,"[30]BmHoIoHcoxHnJqGKCCpmtgAnuqptHD",292,0.996587,30,293,1,292,1,1,0,1,1,137,136,156,156,57
"5231",30,"[30]BmHoIoHcoxHnJqGKCCpmtgAnuqptHD",289,0.996552,30,290,1,289,1,1,0,1,1,132,131,158,158,57
"5232",31,"[30]BmHoIoHcoxHnJqGKCCpmtgAnuqptHD",299,0.996667,30,300,1,299,1,1,0,1,1,165,164,135,135,57
"5233",32,"[30]BmHoIoHcoxHnJqGKCCpmtgAnuqptHD",288,0.99654,30,289,1,288,1,1,0,1,1,135,134,154,154,57
"5234",33,"[30]BmHoIoHcoxHnJqGKCCpmtgAnuqptHD",295,0.996622,30,296,1,295,1,1,0,1,1,149,148,147,147,57
"5235",34,"[30]BmHoIoHcoxHnJqGKCCpmtgAnuqptHD",299,0.996667,30,300,1,299,1,1,0,1,1,149,148,151,151,57
"5236",35,"[30]BmHoIoHcoxHnJqGKCCpmtgAnuqptHD",295,0.996622,30,296,1,295,1,1,0,1,1,143,142,153,153,57
"5237",36,"[30]BmHoIoHcoxHnJqGKCCpmtgAnuqptHD",302,0.9967,30,303,1,302,1,1,0,1,1,170,169,133,133,57
"5238",37,"[30]BmHoIoHcoxHnJqGKCCpmtgAnuqptHD",296,0.996633,30,297,1,296,1,1,0,1,1,153,152,144,144,57
"5239",38,"[30]BmHoIoHcoxHnJqGKCCpmtgAnuqptHD",296,0.996633,30,297,1,296,1,1,0,1,1,145,144,152,152,57
"5240",39,"[30]BmHoIoHcoxHnJqGKCCpmtgAnuqptHD",292,0.996587,30,293,1,292,1,1,0,1,1,134,133,159,159,57
"5241",40,"[30]BmHoIoHcoxHnJqGKCCpmtgAnuqptHD",289,0.996552,30,290,1,289,1,1,0,1,1,130,129,160,160,57
"5242",41,"[30]BmHoIoHcoxHnJqGKCCpmtgAnuqptHD",297,0.996644,30,298,1,297,1,1,0,1,1,150,149,148,148,57
"5243",42,"[30]BmHoIoHcoxHnJqGKCCpmtgAnuqptHD",294,0.99661,30,295,1,294,1,1,0,1,1,154,153,141,141,57
"5244",43,"[30]BmHoIoHcoxHnJqGKCCpmtgAnuqptHD",298,0.996656,30,299,1,298,1,1,0,1,1,152,151,147,147,57
"5245",44,"[30]BmHoIoHcoxHnJqGKCCpmtgAnuqptHD",293,0.996599,30,294,1,293,1,1,0,1,1,143,142,151,151,57
"5246",45,"[30]BmHoIoHcoxHnJqGKCCpmtgAnuqptHD",303,0.996711,30,304,1,303,1,1,0,1,1,170,169,134,134,57
"5247",46,"[30]BmHoIoHcoxHnJqGKCCpmtgAnuqptHD",299,0.996667,30,300,1,299,1,1,0,1,1,159,158,141,141,57
"5248",47,"[30]BmHoIoHcoxHnJqGKCCpmtgAnuqptHD",296,0.996633,30,297,1,296,1,1,0,1,1,147,146,150,150,57
"5249",48,"[30]BmHoIoHcoxHnJqGKCCpmtgAnuqptHD",296,0.996633,30,297,1,296,1,1,0,1,1,148,147,149,149,57
"5250",49,"[30]BmHoIoHcoxHnJqGKCCpmtgAnuqptHD",301,0.996689,30,302,1,301,1,1,0,1,1,165,164,137,137,57
"5251",50,"[30]BmHoIoHcoxHnJqGKCCpmtgAnuqptHD",291,0.996575,30,292,1,291,1,1,0,1,1,141,140,151,151,57
"5252",51,"[30]BmHoIoHcoxHnJqGKCCpmtgAnuqptHD",293,0.996599,30,294,1,293,1,1,0,1,1,135,134,159,159,57
"5253",52,"[30]BmHoIoHcoxHnJqGKCCpmtgAnuqptHD",291,0.996575,30,292,1,291,1,1,0,1,1,136,135,156,156,57
"5254",53,"[30]BmHoIoHcoxHnJqGKCCpmtgAnuqptHD",296,0.996633,30,297,1,296,1,1,0,1,1,137,136,160,160,57
"5255",54,"[30]BmHoIoHcoxHnJqGKCCpmtgAnuqptHD",304,0.996721,30,305,1,304,1,1,0,1,1,173,172,132,132,57
"5256",55,"[30]BmHoIoHcoxHnJqGKCCpmtgAnuqptHD",294,0.99661,30,295,1,294,1,1,0,1,1,144,143,151,151,57
"5257",56,"[30]BmHoIoHcoxHnJqGKCCpmtgAnuqptHD",288,0.99654,30,289,1,288,1,1,0,1,1,125,124,164,164,57
"5258",57,"[30]BmHoIoHcoxHnJqGKCCpmtgAnuqptHD",296,0.996633,30,297,1,296,1,1,0,1,1,146,145,151,151,57
"5259",58,"[30]BmHoIoHcoxHnJqGKCCpmtgAnuqptHD",292,0.996587,30,293,1,292,1,1,0,1,1,134,133,159,159,57
"5260",59,"[30]BmHoIoHcoxHnJqGKCCpmtgAnuqptHD",300,0.996678,30,301,1,300,1,1,0,1,1,162,161,139,139,57
"5261",60,"[30]BmHoIoHcoxHnJqGKCCpmtgAnuqptHD",294,0.99661,30,295,1,294,1,1,0,1,1,147,146,148,148,57
"5262",61,"[30]BmHoIoHcoxHnJqGKCCpmtgAnuqptHD",297,0.996644,30,298,1,297,1,1,0,1,1,153,152,145,145,57
"5263",62,"[30]BmHoIoHcoxHnJqGKCCpmtgAnuqptHD",296,0.996633,30,297,1,296,1,1,0,1,1,148,147,149,149,57
"5264",63,"[30]BmHoIoHcoxHnJqGKCCpmtgAnuqptHD",295,0.996622,30,296,1,295,1,1,0,1,1,146,145,150,150,57
"5265",64,"[30]BmHoIoHcoxHnJqGKCCpmtgAnuqptHD",297,0.996644,30,298,1,297,1,1,0,1,1,151,150,147,147,57
"5266",65,"[30]BmHoIoHcoxHnJqGKCCpmtgAnuqptHD",298,0.996656,30,299,1,298,1,1,0,1,1,152,151,147,147,57
"5267",66,"[30]BmHoIoHcoxHnJqGKCCpmtgAnuqptHD",286,0.996516,30,287,1,286,1,1,0,1,1,130,129,157,157,57
"5268",67,"[30]BmHoIoHcoxHnJqGKCCpmtgAnuqptHD",294,0.99661,30,295,1,294,1,1,0,1,1,144,143,151,151,57
"5269",68,"[30]BmHoIoHcoxHnJqGKCCpmtgAnuqptHD",294,0.99661,30,295,1,294,1,1,0,1,1,144,143,151,151,57
"5270",69,"[30]BmHoIoHcoxHnJqGKCCpmtgAnuqptHD",300,0.996678,30,301,1,300,1,1,0,1,1,162,161,139,139,57
"5271",70,"[30]BmHoIoHcoxHnJqGKCCpmtgAnuqptHD",300,0.996678,30,301,1,300,1,1,0,1,1,160,159,141,141,57
"5272",71,"[30]BmHoIoHcoxHnJqGKCCpmtgAnuqptHD",297,0.996644,30,298,1,297,1,1,0,1,1,149,148,149,149,57
"5273",72,"[30]BmHoIoHcoxHnJqGKCCpmtgAnuqptHD",295,0.996622,30,296,1,295,1,1,0,1,1,149,148,147,147,57
"5274",73,"[30]BmHoIoHcoxHnJqGKCCpmtgAnuqptHD",294,0.99661,30,295,1,294,1,1,0,1,1,156,155,139,139,57
"5275",74,"[30]BmHoIoHcoxHnJqGKCCpmtgAnuqptHD",287,0.996528,30,288,1,287,1,1,0,1,1,134,133,154,154,57
"5276",75,"[30]BmHoIoHcoxHnJqGKCCpmtgAnuqptHD",295,0.996622,30,296,1,295,1,1,0,1,1,155,154,141,141,57
"5277",76,"[30]BmHoIoHcoxHnJqGKCCpmtgAnuqptHD",301,0.996689,30,302,1,301,1,1,0,1,1,164,163,138,138,57
"5278",77,"[30]BmHoIoHcoxHnJqGKCCpmtgAnuqptHD",294,0.99661,30,295,1,294,1,1,0,1,1,147,146,148,148,57
"5279",78,"[30]BmHoIoHcoxHnJqGKCCpmtgAnuqptHD",296,0.996633,30,297,1,296,1,1,0,1,1,148,147,149,149,57
"5280",79,"[30]BmHoIoHcoxHnJqGKCCpmtgAnuqptHD",291,0.996575,30,292,1,291,1,1,0,1,1,138,137,154,154,57
"5281",80,"[30]BmHoIoHcoxHnJqGKCCpmtgAnuqptHD",292,0.996587,30,293,1,292,1,1,0,1,1,141,140,152,152,57
"5282",81,"[30]BmHoIoHcoxHnJqGKCCpmtgAnuqptHD",301,0.996689,30,302,1,301,1,1,0,1,1,157,156,145,145,57
"5283",82,"[30]BmHoIoHcoxHnJqGKCCpmtgAnuqptHD",293,0.996599,30,294,1,293,1,1,0,1,1,142,141,152,152,57
"5284",83,"[30]BmHoIoHcoxHnJqGKCCpmtgAnuqptHD",293,0.996599,30,294,1,293,1,1,0,1,1,140,139,154,154,57
"5285",84,"[30]BmHoIoHcoxHnJqGKCCpmtgAnuqptHD",301,0.996689,30,302,1,301,1,1,0,1,1,159,158,143,143,57
"5286",85,"[30]BmHoIoHcoxHnJqGKCCpmtgAnuqptHD",294,0.99661,30,295,1,294,1,1,0,1,1,143,142,152,152,57
"5287",86,"[30]BmHoIoHcoxHnJqGKCCpmtgAnuqptHD",300,0.996678,30,301,1,300,1,1,0,1,1,161,160,140,140,57
"5288",87,"[30]BmHoIoHcoxHnJqGKCCpmtgAnuqptHD",294,0.99661,30,295,1,294,1,1,0,1,1,142,141,153,153,57
"5289",88,"[30]BmHoIoHcoxHnJqGKCCpmtgAnuqptHD",287,0.996528,30,288,1,287,1,1,0,1,1,124,123,164,164,57
"5290",89,"[30]BmHoIoHcoxHnJqGKCCpmtgAnuqptHD",294,0.99661,30,295,1,294,1,1,0,1,1,156,155,139,139,57
"5291",90,"[30]BmHoIoHcoxHnJqGKCCpmtgAnuqptHD",296,0.996633,30,297,1,296,1,1,0,1,1,148,147,149,149,57
"5292",91,"[30]BmHoIoHcoxHnJqGKCCpmtgAnuqptHD",299,0.996667,30,300,1,299,1,1,0,1,1,157,156,143,143,57
"5293",92,"[30]BmHoIoHcoxHnJqGKCCpmtgAnuqptHD",291,0.996575,30,292,1,291,1,1,0,1,1,132,131,160,160,57
"5294",93,"[30]BmHoIoHcoxHnJqGKCCpmtgAnuqptHD",300,0.996678,30,301,1,300,1,1,0,1,1,159,158,142,142,57
"5295",94,"[30]BmHoIoHcoxHnJqGKCCpmtgAnuqptHD",297,0.996644,30,298,1,297,1,1,0,1,1,150,149,148,148,57
"5296",95,"[30]BmHoIoHcoxHnJqGKCCpmtgAnuqptHD",292,0.996587,30,293,1,292,1,1,0,1,1,137,136,156,156,57
"5297",96,"[30]BmHoIoHcoxHnJqGKCCpmtgAnuqptHD",295,0.996622,30,296,1,295,1,1,0,1,1,149,148,147,147,57
"5298",97,"[30]BmHoIoHcoxHnJqGKCCpmtgAnuqptHD",294,0.99661,30,295,1,294,1,1,0,1,1,143,142,152,152,57
"5299",98,"[30]BmHoIoHcoxHnJqGKCCpmtgAnuqptHD",294,0.99661,30,295,1,294,1,1,0,1,1,155,154,140,140,57
"5300",99,"[30]BmHoIoHcoxHnJqGKCCpmtgAnuqptHD",297,0.996644,30,298,1,297,1,1,0,1,1,156,155,142,142,57
"5301",0,"[19]loIoHcosHnJHGqKCCeG",273,0.99635,19,274,1,273,1,1,0,1,1,133,132,141,141,58
"5302",1,"[19]loIoHcosHnJHGqKCCeG",277,0.996403,19,278,1,277,1,1,0,1,1,131,130,147,147,58
"5303",2,"[19]loIoHcosHnJHGqKCCeG",282,0.996466,19,283,1,282,1,1,0,1,1,142,141,141,141,58
"5304",3,"[19]loIoHcosHnJHGqKCCeG",286,0.996516,19,287,1,286,1,1,0,1,1,136,135,151,151,58
"5305",4,"[19]loIoHcosHnJHGqKCCeG",288,0.99654,19,289,1,288,1,1,0,1,1,152,151,137,137,58
"5306",5,"[19]loIoHcosHnJHGqKCCeG",285,0.996503,19,286,1,285,1,1,0,1,1,137,136,149,149,58
"5307",6,"[19]loIoHcosHnJHGqKCCeG",289,0.996552,19,290,1,289,1,1,0,1,1,140,139,150,150,58
"5308",7,"[19]loIoHcosHnJHGqKCCeG",284,0.996491,19,285,1,284,1,1,0,1,1,147,146,138,138,58
"5309",8,"[19]loIoHcosHnJHGqKCCeG",279,0.996429,19,280,1,279,1,1,0,1,1,132,131,148,148,58
"5310",9,"[19]loIoHcosHnJHGqKCCeG",274,0.996364,19,275,1,274,1,1,0,1,1,139,138,136,136,58
"5311",10,"[19]loIoHcosHnJHGqKCCeG",285,0.996503,19,286,1,285,1,1,0,1,1,150,149,136,136,58
"5312",11,"[19]loIoHcosHnJHGqKCCeG",285,0.996503,19,286,1,285,1,1,0,1,1,161,160,125,125,58
"5313",12,"[19]loIoHcosHnJHGqKCCeG",291,0.996575,19,292,1,291,1,1,0,1,1,141,140,151,151,58
"5314",13,"[19]loIoHcosHnJHGqKCCeG",282,0.996466,19,283,1,282,1,1,0,1,1,133,132,150,150,58
"5315",14,"[19]loIoHcosHnJHGqKCCeG",281,0.996454,19,282,1,281,1,1,0,1,1,142,141,140,140,58
"5316",15,"[19]loIoHcosHnJHGqKCCeG",280,0.996441,19,281,1,280,1,1,0,1,1,130,129,151,151,58
"5317",16,"[19]loIoHcosHnJHGqKCCeG",284,0.996491,19,285,1,284,1,1,0,1,1,144,143,141,141,58
"5318",17,"[19]loIoHcosHnJHGqKCCeG",280,0.996441,19,281,1,280,1,1,0,1,1,153,152,128,128,58
"5319",18,"[19]loIoHcosHnJHGqKCCeG",282,0.996466,19,283,1,282,1,1,0,1,1,158,157,125,125,58
"5320",19,"[19]loIoHcosHnJHGqKCCeG",283,0.996479,19,284,1,283,1,1,0,1,1,147,146,137,137,58
"5321",20,"[19]loIoHcosHnJHGqKCCeG",277,0.996403,19,278,1,277,1,1,0,1,1,143,142,135,135,58
"5322",21,"[19]loIoHcosHnJHGqKCCeG",281,0.996454,19,282,1,281,1,1,0,1,1,131,130,151,151,58
"5323",22,"[19]loIoHcosHnJHGqKCCeG",283,0.996479,19,284,1,283,1,1,0,1,1,151,150,133,133,58
"5324",23,"[19]loIoHcosHnJHGqKCCeG",291,0.996575,19,292,1,291,1,1,0,1,1,150,149,142,142,58
"5325",24,"[19]loIoHcosHnJHGqKCCeG",280,0.996441,19,281,1,280,1,1,0,1,1,130,129,151,151,58
"5326",25,"[19]loIoHcosHnJHGqKCCeG",284,0.996491,19,285,1,284,1,1,0,1,1,150,149,135,135,58
"5327",26,"[19]loIoHcosHnJHGqKCCeG",284,0.996491,19,285,1,284,1,1,0,1,1,153,152,132,132,58
"5328",27,"[19]loIoHcosHnJHGqKCCeG",289,0.996552,19,290,1,289,1,1,0,1,1,151,150,139,139,58
"5329",28,"[19]loIoHcosHnJHGqKCCeG",276,0.99639,19,277,1,276,1,1,0,1,1,136,135,141,141,58
"5330",29,"[19]loIoHcosHnJHGqKCCeG",275,0.996377,19,276,1,275,1,1,0,1,1,132,131,144,144,58
"5331",30,"[19]loIoHcosHnJHGqKCCeG",270,0.99631,19,271,1,270,1,1,0,1,1,125,124,146,146,58
"5332",31,"[19]loIoHcosHnJHGqKCCeG",274,0.996364,19,275,1,274,1,1,0,1,1,132,131,143,143,58
"5333",32,"[19]loIoHcosHnJHGqKCCeG",287,0.996528,19,288,1,287,1,1,0,1,1,152,151,136,136,58
"5334",33,"[19]loIoHcosHnJHGqKCCeG",282,0.996466,19,283,1,282,1,1,0,1,1,140,139,143,143,58
"5335",34,"[19]loIoHcosHnJHGqKCCeG",278,0.996416,19,279,1,278,1,1,0,1,1,141,140,138,138,58
"5336",35,"[19]loIoHcosHnJHGqKCCeG",280,0.996441,19,281,1,280,1,1,0,1,1,140,139,141,141,58
"5337",36,"[19]loIoHcosHnJHGqKCCeG",281,0.996454,19,282,1,281,1,1,0,1,1,131,130,151,151,58
"5338",37,"[19]loIoHcosHnJHGqKCCeG",286,0.996516,19,287,1,286,1,1,0,1,1,148,147,139,139,58
"5339",38,"[19]loIoHcosHnJHGqKCCeG",284,0.996491,19,285,1,284,1,1,0,1,1,155,154,130,130,58
"5340",39,"[19]loIoHcosHnJHGqKCCeG",279,0.996429,19,280,1,279,1,1,0,1,1,143,142,137,137,58
"5341",40,"[19]loIoHcosHnJHGqKCCeG",285,0.996503,19,286,1,285,1,1,0,1,1,147,146,139,139,58
"5342",41,"[19]loIoHcosHnJHGqKCCeG",292,0.996587,19,293,1,292,1,1,0,1,1,151,150,142,142,58
"5343",42,"[19]loIoHcosHnJHGqKCCeG",281,0.996454,19,282,1,281,1,1,0,1,1,147,146,135,135,58
"5344",43,"[19]loIoHcosHnJHGqKCCeG",281,0.996454,19,282,1,281,1,1,0,1,1,131,130,151,151,58
"5345",44,"[19]loIoHcosHnJHGqKCCeG",292,0.996587,19,293,1,292,1,1,0,1,1,150,149,143,143,58
"5346",45,"[19]loIoHcosHnJHGqKCCeG",278,0.996416,19,279,1,278,1,1,0,1,1,142,141,137,137,58
"5347",46,"[19]loIoHcosHnJHGqKCCeG",286,0.996516,19,287,1,286,1,1,0,1,1,142,141,145,145,58
"5348",47,"[19]loIoHcosHnJHGqKCCeG",278,0.996416,19,279,1,278,1,1,0,1,1,152,151,127,127,58
"5349",48,"[19]loIoHcosHnJHGqKCCeG",281,0.996454,19,282,1,281,1,1,0,1,1,129,128,153,153,58
"5350",49,"[19]loIoHcosHnJHGqKCCeG",281,0.996454,19,282,1,281,1,1,0,1,1,128,127,154,154,58
"5351",50,"[19]loIoHcosHnJHGqKCCeG",284,0.996491,19,285,1,284,1,1,0,1,1,158,157,127,127,58
"5352",51,"[19]loIoHcosHnJHGqKCCeG",289,0.996552,19,290,1,289,1,1,0,1,1,157,156,133,133,58
"5353",52,"[19]loIoHcosHnJHGqKCCeG",278,0.996416,19,279,1,278,1,1,0,1,1,133,132,146,146,58
"5354",53,"[19]loIoHcosHnJHGqKCCeG",277,0.996403,19,278,1,277,1,1,0,1,1,127,126,151,151,58
"5355",54,"[19]loIoHcosHnJHGqKCCeG",286,0.996516,19,287,1,286,1,1,0,1,1,141,140,146,146,58
"5356",55,"[19]loIoHcosHnJHGqKCCeG",281,0.996454,19,282,1,281,1,1,0,1,1,130,129,152,152,58
"5357",56,"[19]loIoHcosHnJHGqKCCeG",280,0.996441,19,281,1,280,1,1,0,1,1,126,125,155,155,58
"5358",57,"[19]loIoHcosHnJHGqKCCeG",281,0.996454,19,282,1,281,1,1,0,1,1,135,134,147,147,58
"5359",58,"[19]loIoHcosHnJHGqKCCeG",282,0.996466,19,283,1,282,1,1,0,1,1,136,135,147,147,58
"5360",59,"[19]loIoHcosHnJHGqKCCeG",282,0.996466,19,283,1,282,1,1,0,1,1,143,142,140,140,58
"5361",60,"[19]loIoHcosHnJHGqKCCeG",283,0.996479,19,284,1,283,1,1,0,1,1,138,137,146,146,58
"5362",61,"[19]loIoHcosHnJHGqKCCeG",289,0.996552,19,290,1,289,1,1,0,1,1,161,160,129,129,58
"5363",62,"[19]loIoHcosHnJHGqKCCeG",280,0.996441,19,281,1,280,1,1,0,1,1,145,144,136,136,58
"5364",63,"[19]loIoHcosHnJHGqKCCeG",281,0.996454,19,282,1,281,1,1,0,1,1,136,135,146,146,58
"5365",64,"[19]loIoHcosHnJHGqKCCeG",290,0.996564,19,291,1,290,1,1,0,1,1,147,146,144,144,58
"5366",65,"[19]loIoHcosHnJHGqKCCeG",286,0.996516,19,287,1,286,1,1,0,1,1,155,154,132,132,58
"5367",66,"[19]loIoHcosHnJHGqKCCeG",281,0.996454,19,282,1,281,1,1,0,1,1,134,133,148,148,58
"5368",67,"[19]loIoHcosHnJHGqKCCeG",282,0.996466,19,283,1,282,1,1,0,1,1,130,129,153,153,58
"5369",68,"[19]loIoHcosHnJHGqKCCeG",273,0.99635,19,274,1,273,1,1,0,1,1,136,135,138,138,58
"5370",69,"[19]loIoHcosHnJHGqKCCeG",281,0.996454,19,282,1,281,1,1,0,1,1,131,130,151,151,58
"5371",70,"[19]loIoHcosHnJHGqKCCeG",280,0.996441,19,281,1,280,1,1,0,1,1,150,149,131,131,58
"5372",71,"[19]loIoHcosHnJHGqKCCeG",281,0.996454,19,282,1,281,1,1,0,1,1,134,133,148,148,58
"5373",72,"[19]loIoHcosHnJHGqKCCeG",281,0.996454,19,282,1,281,1,1,0,1,1,148,147,134,134,58
"5374",73,"[19]loIoHcosHnJHGqKCCeG",278,0.996416,19,279,1,278,1,1,0,1,1,140,139,139,139,58
"5375",74,"[19]loIoHcosHnJHGqKCCeG",277,0.996403,19,278,1,277,1,1,0,1,1,128,127,150,150,58
"5376",75,"[19]loIoHcosHnJHGqKCCeG",282,0.996466,19,283,1,282,1,1,0,1,1,145,144,138,138,58
"5377",76,"[19]loIoHcosHnJHGqKCCeG",270,0.99631,19,271,1,270,1,1,0,1,1,119,118,152,152,58
"5378",77,"[19]loIoHcosHnJHGqKCCeG",277,0.996403,19,278,1,277,1,1,0,1,1,145,144,133,133,58
"5379",78,"[19]loIoHcosHnJHGqKCCeG",287,0.996528,19,288,1,287,1,1,0,1,1,138,137,150,150,58
"5380",79,"[19]loIoHcosHnJHGqKCCeG",279,0.996429,19,280,1,279,1,1,0,1,1,128,127,152,152,58
"5381",80,"[19]loIoHcosHnJHGqKCCeG",289,0.996552,19,290,1,289,1,1,0,1,1,150,149,140,140,58
"5382",81,"[19]loIoHcosHnJHGqKCCeG",280,0.996441,19,281,1,280,1,1,0,1,1,134,133,147,147,58
"5383",82,"[19]loIoHcosHnJHGqKCCeG",273,0.99635,19,274,1,273,1,1,0,1,1,135,134,139,139,58
"5384",83,"[19]loIoHcosHnJHGqKCCeG",281,0.996454,19,282,1,281,1,1,0,1,1,136,135,146,146,58
"5385",84,"[19]loIoHcosHnJHGqKCCeG",275,0.996377,19,276,1,275,1,1,0,1,1,153,152,123,123,58
"5386",85,"[19]loIoHcosHnJHGqKCCeG",284,0.996491,19,285,1,284,1,1,0,1,1,132,131,153,153,58
"5387",86,"[19]loIoHcosHnJHGqKCCeG",276,0.99639,19,277,1,276,1,1,0,1,1,146,145,131,131,58
"5388",87,"[19]loIoHcosHnJHGqKCCeG",294,0.99661,19,295,1,294,1,1,0,1,1,155,154,140,140,58
"5389",88,"[19]loIoHcosHnJHGqKCCeG",282,0.996466,19,283,1,282,1,1,0,1,1,150,149,133,133,58
"5390",89,"[19]loIoHcosHnJHGqKCCeG",284,0.996491,19,285,1,284,1,1,0,1,1,156,155,129,129,58
"5391",90,"[19]loIoHcosHnJHGqKCCeG",280,0.996441,19,281,1,280,1,1,0,1,1,130,129,151,151,58
"5392",91,"[19]loIoHcosHnJHGqKCCeG",289,0.996552,19,290,1,289,1,1,0,1,1,152,151,138,138,58
"5393",92,"[19]loIoHcosHnJHGqKCCeG",280,0.996441,19,281,1,280,1,1,0,1,1,139,138,142,142,58
"5394",93,"[19]loIoHcosHnJHGqKCCeG",275,0.996377,19,276,1,275,1,1,0,1,1,138,137,138,138,58
"5395",94,"[19]loIoHcosHnJHGqKCCeG",281,0.996454,19,282,1,281,1,1,0,1,1,150,149,132,132,58
"5396",95,"[19]loIoHcosHnJHGqKCCeG",280,0.996441,19,281,1,280,1,1,0,1,1,145,144,136,136,58
"5397",96,"[19]loIoHcosHnJHGqKCCeG",284,0.996491,19,285,1,284,1,1,0,1,1,146,145,139,139,58
"5398",97,"[19]loIoHcosHnJHGqKCCeG",272,0.996337,19,273,1,272,1,1,0,1,1,127,126,146,146,58
"5399",98,"[19]loIoHcosHnJHGqKCCeG",288,0.99654,19,289,1,288,1,1,0,1,1,143,142,146,146,58
"5400",99,"[19]loIoHcosHnJHGqKCCeG",275,0.996377,19,276,1,275,1,1,0,1,1,137,136,139,139,58
"5401",0,"[30]gvloIbzoHcoxHnJHGqKCnJxjkxzmih",278,0.996416,30,279,1,278,1,1,0,1,1,126,125,153,153,59
"5402",1,"[30]gvloIbzoHcoxHnJHGqKCnJxjkxzmih",286,0.996516,30,287,1,286,1,1,0,1,1,146,145,141,141,59
"5403",2,"[30]gvloIbzoHcoxHnJHGqKCnJxjkxzmih",286,0.996516,30,287,1,286,1,1,0,1,1,141,140,146,146,59
"5404",3,"[30]gvloIbzoHcoxHnJHGqKCnJxjkxzmih",288,0.99654,30,289,1,288,1,1,0,1,1,150,149,139,139,59
"5405",4,"[30]gvloIbzoHcoxHnJHGqKCnJxjkxzmih",278,0.996416,30,279,1,278,1,1,0,1,1,132,131,147,147,59
"5406",5,"[30]gvloIbzoHcoxHnJHGqKCnJxjkxzmih",285,0.996503,30,286,1,285,1,1,0,1,1,146,145,140,140,59
"5407",6,"[30]gvloIbzoHcoxHnJHGqKCnJxjkxzmih",274,0.996364,30,275,1,274,1,1,0,1,1,140,139,135,135,59
"5408",7,"[30]gvloIbzoHcoxHnJHGqKCnJxjkxzmih",278,0.996416,30,279,1,278,1,1,0,1,1,140,139,139,139,59
"5409",8,"[30]gvloIbzoHcoxHnJHGqKCnJxjkxzmih",274,0.996364,30,275,1,274,1,1,0,1,1,141,140,134,134,59
"5410",9,"[30]gvloIbzoHcoxHnJHGqKCnJxjkxzmih",285,0.996503,30,286,1,285,1,1,0,1,1,145,144,141,141,59
"5411",10,"[30]gvloIbzoHcoxHnJHGqKCnJxjkxzmih",279,0.996429,30,280,1,279,1,1,0,1,1,132,131,148,148,59
"5412",11,"[30]gvloIbzoHcoxHnJHGqKCnJxjkxzmih",281,0.996454,30,282,1,281,1,1,0,1,1,145,144,137,137,59
"5413",12,"[30]gvloIbzoHcoxHnJHGqKCnJxjkxzmih",279,0.996429,30,280,1,279,1,1,0,1,1,145,144,135,135,59
"5414",13,"[30]gvloIbzoHcoxHnJHGqKCnJxjkxzmih",284,0.996491,30,285,1,284,1,1,0,1,1,151,150,134,134,59
"5415",14,"[30]gvloIbzoHcoxHnJHGqKCnJxjkxzmih",285,0.996503,30,286,1,285,1,1,0,1,1,143,142,143,143,59
"5416",15,"[30]gvloIbzoHcoxHnJHGqKCnJxjkxzmih",271,0.996324,30,272,1,271,1,1,0,1,1,132,131,140,140,59
"5417",16,"[30]gvloIbzoHcoxHnJHGqKCnJxjkxzmih",277,0.996403,30,278,1,277,1,1,0,1,1,143,142,135,135,59
"5418",17,"[30]gvloIbzoHcoxHnJHGqKCnJxjkxzmih",277,0.996403,30,278,1,277,1,1,0,1,1,138,137,140,140,59
"5419",18,"[30]gvloIbzoHcoxHnJHGqKCnJxjkxzmih",286,0.996516,30,287,1,286,1,1,0,1,1,145,144,142,142,59
"5420",19,"[30]gvloIbzoHcoxHnJHGqKCnJxjkxzmih",281,0.996454,30,282,1,281,1,1,0,1,1,139,138,143,143,59
"5421",20,"[30]gvloIbzoHcoxHnJHGqKCnJxjkxzmih",277,0.996403,30,278,1,277,1,1,0,1,1,151,150,127,127,59
"5422",21,"[30]gvloIbzoHcoxHnJHGqKCnJxjkxzmih",283,0.996479,30,284,1,283,1,1,0,1,1,130,129,154,154,59
"5423",22,"[30]gvloIbzoHcoxHnJHGqKCnJxjkxzmih",280,0.996441,30,281,1,280,1,1,0,1,1,138,137,143,143,59
"5424",23,"[30]gvloIbzoHcoxHnJHGqKCnJxjkxzmih",277,0.996403,30,278,1,277,1,1,0,1,1,133,132,145,145,59
"5425",24,"[30]gvloIbzoHcoxHnJHGqKCnJxjkxzmih",274,0.996364,30,275,1,274,1,1,0,1,1,138,137,137,137,59
"5426",25,"[30]gvloIbzoHcoxHnJHGqKCnJxjkxzmih",274,0.996364,30,275,1,274,1,1,0,1,1,137,136,138,138,59
"5427",26,"[30]gvloIbzoHcoxHnJHGqKCnJxjkxzmih",270,0.99631,30,271,1,270,1,1,0,1,1,122,121,149,149,59
"5428",27,"[30]gvloIbzoHcoxHnJHGqKCnJxjkxzmih",289,0.996552,30,290,1,289,1,1,0,1,1,147,146,143,143,59
"5429",28,"[30]gvloIbzoHcoxHnJHGqKCnJxjkxzmih",281,0.996454,30,282,1,281,1,1,0,1,1,148,147,134,134,59
"5430",29,"[30]gvloIbzoHcoxHnJHGqKCnJxjkxzmih",278,0.996416,30,279,1,278,1,1,0,1,1,128,127,151,151,59
"5431",30,"[30]gvloIbzoHcoxHnJHGqKCnJxjkxzmih",279,0.996429,30,280,1,279,1,1,0,1,1,146,145,134,134,59
"5432",31,"[30]gvloIbzoHcoxHnJHGqKCnJxjkxzmih",281,0.996454,30,282,1,281,1,1,0,1,1,145,144,137,137,59
"5433",32,"[30]gvloIbzoHcoxHnJHGqKCnJxjkxzmih",278,0.996416,30,279,1,278,1,1,0,1,1,133,132,146,146,59
"5434",33,"[30]gvloIbzoHcoxHnJHGqKCnJxjkxzmih",274,0.996364,30,275,1,274,1,1,0,1,1,140,139,135,135,59
"5435",34,"[30]gvloIbzoHcoxHnJHGqKCnJxjkxzmih",280,0.996441,30,281,1,280,1,1,0,1,1,148,147,133,133,59
"5436",35,"[30]gvloIbzoHcoxHnJHGqKCnJxjkxzmih",277,0.996403,30,278,1,277,1,1,0,1,1,130,129,148,148,59
"5437",36,"[30]gvloIbzoHcoxHnJHGqKCnJxjkxzmih",280,0.996441,30,281,1,280,1,1,0,1,1,142,141,139,139,59
"5438",37,"[30]gvloIbzoHcoxHnJHGqKCnJxjkxzmih",277,0.996403,30,278,1,277,1,1,0,1,1,153,152,125,125,59
"5439",38,"[30]gvloIbzoHcoxHnJHGqKCnJxjkxzmih",285,0.996503,30,286,1,285,1,1,0,1,1,135,134,151,151,59
"5440",39,"[30]gvloIbzoHcoxHnJHGqKCnJxjkxzmih",287,0.996528,30,288,1,287,1,1,0,1,1,139,138,149,149,59
"5441",40,"[30]gvloIbzoHcoxHnJHGqKCnJxjkxzmih",274,0.996364,30,275,1,274,1,1,0,1,1,130,129,145,145,59
"5442",41,"[30]gvloIbzoHcoxHnJHGqKCnJxjkxzmih",277,0.996403,30,278,1,277,1,1,0,1,1,133,132,145,145,59
"5443",42,"[30]gvloIbzoHcoxHnJHGqKCnJxjkxzmih",284,0.996491,30,285,1,284,1,1,0,1,1,147,146,138,138,59
"5444",43,"[30]gvloIbzoHcoxHnJHGqKCnJxjkxzmih",275,0.996377,30,276,1,275,1,1,0,1,1,135,134,141,141,59
"5445",44,"[30]gvloIbzoHcoxHnJHGqKCnJxjkxzmih",287,0.996528,30,288,1,287,1,1,0,1,1,154,153,134,134,59
"5446",45,"[30]gvloIbzoHcoxHnJHGqKCnJxjkxzmih",279,0.996429,30,280,1,279,1,1,0,1,1,147,146,133,133,59
"5447",46,"[30]gvloIbzoHcoxHnJHGqKCnJxjkxzmih",287,0.996528,30,288,1,287,1,1,0,1,1,151,150,137,137,59
"5448",47,"[30]gvloIbzoHcoxHnJHGqKCnJxjkxzmih",279,0.996429,30,280,1,279,1,1,0,1,1,140,139,140,140,59
"5449",48,"[30]gvloIbzoHcoxHnJHGqKCnJxjkxzmih",270,0.99631,30,271,1,270,1,1,0,1,1,109,108,162,162,59
"5450",49,"[30]gvloIbzoHcoxHnJHGqKCnJxjkxzmih",274,0.996364,30,275,1,274,1,1,0,1,1,129,128,146,146,59
"5451",50,"[30]gvloIbzoHcoxHnJHGqKCnJxjkxzmih",284,0.996491,30,285,1,284,1,1,0,1,1,145,144,140,140,59
"5452",51,"[30]gvloIbzoHcoxHnJHGqKCnJxjkxzmih",288,0.99654,30,289,1,288,1,1,0,1,1,139,138,150,150,59
"5453",52,"[30]gvloIbzoHcoxHnJHGqKCnJxjkxzmih",273,0.99635,30,274,1,273,1,1,0,1,1,138,137,136,136,59
"5454",53,"[30]gvloIbzoHcoxHnJHGqKCnJxjkxzmih",279,0.996429,30,280,1,279,1,1,0,1,1,128,127,152,152,59
"5455",54,"[30]gvloIbzoHcoxHnJHGqKCnJxjkxzmih",281,0.996454,30,282,1,281,1,1,0,1,1,154,153,128,128,59
"5456",55,"[30]gvloIbzoHcoxHnJHGqKCnJxjkxzmih",276,0.99639,30,277,1,276,1,1,0,1,1,155,154,122,122,59
"5457",56,"[30]gvloIbzoHcoxHnJHGqKCnJxjkxzmih",277,0.996403,30,278,1,277,1,1,0,1,1,140,139,138,138,59
"5458",57,"[30]gvloIbzoHcoxHnJHGqKCnJxjkxzmih",275,0.996377,30,276,1,275,1,1,0,1,1,138,137,138,138,59
"5459",58,"[30]gvloIbzoHcoxHnJHGqKCnJxjkxzmih",277,0.996403,30,278,1,277,1,1,0,1,1,153,152,125,125,59
"5460",59,"[30]gvloIbzoHcoxHnJHGqKCnJxjkxzmih",282,0.996466,30,283,1,282,1,1,0,1,1,153,152,130,130,59
"5461",60,"[30]gvloIbzoHcoxHnJHGqKCnJxjkxzmih",283,0.996479,30,284,1,283,1,1,0,1,1,140,139,144,144,59
"5462",61,"[30]gvloIbzoHcoxHnJHGqKCnJxjkxzmih",271,0.996324,30,272,1,271,1,1,0,1,1,137,136,135,135,59
"5463",62,"[30]gvloIbzoHcoxHnJHGqKCnJxjkxzmih",279,0.996429,30,280,1,279,1,1,0,1,1,136,135,144,144,59
"5464",63,"[30]gvloIbzoHcoxHnJHGqKCnJxjkxzmih",279,0.996429,30,280,1,279,1,1,0,1,1,144,143,136,136,59
"5465",64,"[30]gvloIbzoHcoxHnJHGqKCnJxjkxzmih",277,0.996403,30,278,1,277,1,1,0,1,1,125,124,153,153,59
"5466",65,"[30]gvloIbzoHcoxHnJHGqKCnJxjkxzmih",283,0.996479,30,284,1,283,1,1,0,1,1,137,136,147,147,59
"5467",66,"[30]gvloIbzoHcoxHnJHGqKCnJxjkxzmih",281,0.996454,30,282,1,281,1,1,0,1,1,142,141,140,140,59
"5468",67,"[30]gvloIbzoHcoxHnJHGqKCnJxjkxzmih",280,0.996441,30,281,1,280,1,1,0,1,1,141,140,140,140,59
"5469",68,"[30]gvloIbzoHcoxHnJHGqKCnJxjkxzmih",274,0.996364,30,275,1,274,1,1,0,1,1,141,140,134,134,59
"5470",69,"[30]gvloIbzoHcoxHnJHGqKCnJxjkxzmih",287,0.996528,30,288,1,287,1,1,0,1,1,148,147,140,140,59
"5471",70,"[30]gvloIbzoHcoxHnJHGqKCnJxjkxzmih",274,0.996364,30,275,1,274,1,1,0,1,1,153,152,122,122,59
"5472",71,"[30]gvloIbzoHcoxHnJHGqKCnJxjkxzmih",281,0.996454,30,282,1,281,1,1,0,1,1,142,141,140,140,59
"5473",72,"[30]gvloIbzoHcoxHnJHGqKCnJxjkxzmih",279,0.996429,30,280,1,279,1,1,0,1,1,150,149,130,130,59
"5474",73,"[30]gvloIbzoHcoxHnJHGqKCnJxjkxzmih",280,0.996441,30,281,1,280,1,1,0,1,1,136,135,145,145,59
"5475",74,"[30]gvloIbzoHcoxHnJHGqKCnJxjkxzmih",280,0.996441,30,281,1,280,1,1,0,1,1,154,153,127,127,59
"5476",75,"[30]gvloIbzoHcoxHnJHGqKCnJxjkxzmih",280,0.996441,30,281,1,280,1,1,0,1,1,134,133,147,147,59
"5477",76,"[30]gvloIbzoHcoxHnJHGqKCnJxjkxzmih",281,0.996454,30,282,1,281,1,1,0,1,1,140,139,142,142,59
"5478",77,"[30]gvloIbzoHcoxHnJHGqKCnJxjkxzmih",275,0.996377,30,276,1,275,1,1,0,1,1,141,140,135,135,59
"5479",78,"[30]gvloIbzoHcoxHnJHGqKCnJxjkxzmih",280,0.996441,30,281,1,280,1,1,0,1,1,149,148,132,132,59
"5480",79,"[30]gvloIbzoHcoxHnJHGqKCnJxjkxzmih",272,0.996337,30,273,1,272,1,1,0,1,1,134,133,139,139,59
"5481",80,"[30]gvloIbzoHcoxHnJHGqKCnJxjkxzmih",276,0.99639,30,277,1,276,1,1,0,1,1,154,153,123,123,59
"5482",81,"[30]gvloIbzoHcoxHnJHGqKCnJxjkxzmih",277,0.996403,30,278,1,277,1,1,0,1,1,137,136,141,141,59
"5483",82,"[30]gvloIbzoHcoxHnJHGqKCnJxjkxzmih",281,0.996454,30,282,1,281,1,1,0,1,1,161,160,121,121,59
"5484",83,"[30]gvloIbzoHcoxHnJHGqKCnJxjkxzmih",267,0.996269,30,268,1,267,1,1,0,1,1,130,129,138,138,59
"5485",84,"[30]gvloIbzoHcoxHnJHGqKCnJxjkxzmih",284,0.996491,30,285,1,284,1,1,0,1,1,133,132,152,152,59
"5486",85,"[30]gvloIbzoHcoxHnJHGqKCnJxjkxzmih",274,0.996364,30,275,1,274,1,1,0,1,1,134,133,141,141,59
"5487",86,"[30]gvloIbzoHcoxHnJHGqKCnJxjkxzmih",284,0.996491,30,285,1,284,1,1,0,1,1,139,138,146,146,59
"5488",87,"[30]gvloIbzoHcoxHnJHGqKCnJxjkxzmih",270,0.99631,30,271,1,270,1,1,0,1,1,122,121,149,149,59
"5489",88,"[30]gvloIbzoHcoxHnJHGqKCnJxjkxzmih",276,0.99639,30,277,1,276,1,1,0,1,1,136,135,141,141,59
"5490",89,"[30]gvloIbzoHcoxHnJHGqKCnJxjkxzmih",281,0.996454,30,282,1,281,1,1,0,1,1,133,132,149,149,59
"5491",90,"[30]gvloIbzoHcoxHnJHGqKCnJxjkxzmih",272,0.996337,30,273,1,272,1,1,0,1,1,137,136,136,136,59
"5492",91,"[30]gvloIbzoHcoxHnJHGqKCnJxjkxzmih",289,0.996552,30,290,1,289,1,1,0,1,1,136,135,154,154,59
"5493",92,"[30]gvloIbzoHcoxHnJHGqKCnJxjkxzmih",280,0.996441,30,281,1,280,1,1,0,1,1,157,156,124,124,59
"5494",93,"[30]gvloIbzoHcoxHnJHGqKCnJxjkxzmih",276,0.99639,30,277,1,276,1,1,0,1,1,138,137,139,139,59
"5495",94,"[30]gvloIbzoHcoxHnJHGqKCnJxjkxzmih",283,0.996479,30,284,1,283,1,1,0,1,1,149,148,135,135,59
"5496",95,"[30]gvloIbzoHcoxHnJHGqKCnJxjkxzmih",285,0.996503,30,286,1,285,1,1,0,1,1,153,152,133,133,59
"5497",96,"[30]gvloIbzoHcoxHnJHGqKCnJxjkxzmih",288,0.99654,30,289,1,288,1,1,0,1,1,147,146,142,142,59
"5498",97,"[30]gvloIbzoHcoxHnJHGqKCnJxjkxzmih",275,0.996377,30,276,1,275,1,1,0,1,1,138,137,138,138,59
"5499",98,"[30]gvloIbzoHcoxHnJHGqKCnJxjkxzmih",278,0.996416,30,279,1,278,1,1,0,1,1,130,129,149,149,59
"5500",99,"[30]gvloIbzoHcoxHnJHGqKCnJxjkxzmih",271,0.996324,30,272,1,271,1,1,0,1,1,141,140,131,131,59
"5501",0,"[31]rJHzwFoIyoHcouHnJHGqKCjEKlIcugp",279,0.996429,31,280,1,279,1,1,0,1,1,141,140,139,139,60
"5502",1,"[31]rJHzwFoIyoHcouHnJHGqKCjEKlIcugp",281,0.996454,31,282,1,281,1,1,0,1,1,133,132,149,149,60
"5503",2,"[31]rJHzwFoIyoHcouHnJHGqKCjEKlIcugp",281,0.996454,31,282,1,281,1,1,0,1,1,147,146,135,135,60
"5504",3,"[31]rJHzwFoIyoHcouHnJHGqKCjEKlIcugp",276,0.99639,31,277,1,276,1,1,0,1,1,137,136,140,140,60
"5505",4,"[31]rJHzwFoIyoHcouHnJHGqKCjEKlIcugp",284,0.996491,31,285,1,284,1,1,0,1,1,129,128,156,156,60
"5506",5,"[31]rJHzwFoIyoHcouHnJHGqKCjEKlIcugp",278,0.996416,31,279,1,278,1,1,0,1,1,130,129,149,149,60
"5507",6,"[31]rJHzwFoIyoHcouHnJHGqKCjEKlIcugp",279,0.996429,31,280,1,279,1,1,0,1,1,134,133,146,146,60
"5508",7,"[31]rJHzwFoIyoHcouHnJHGqKCjEKlIcugp",289,0.996552,31,290,1,289,1,1,0,1,1,157,156,133,133,60
"5509",8,"[31]rJHzwFoIyoHcouHnJHGqKCjEKlIcugp",281,0.996454,31,282,1,281,1,1,0,1,1,145,144,137,137,60
"5510",9,"[31]rJHzwFoIyoHcouHnJHGqKCjEKlIcugp",280,0.996441,31,281,1,280,1,1,0,1,1,148,147,133,133,60
"5511",10,"[31]rJHzwFoIyoHcouHnJHGqKCjEKlIcugp",278,0.996416,31,279,1,278,1,1,0,1,1,140,139,139,139,60
"5512",11,"[31]rJHzwFoIyoHcouHnJHGqKCjEKlIcugp",287,0.996528,31,288,1,287,1,1,0,1,1,141,140,147,147,60
"5513",12,"[31]rJHzwFoIyoHcouHnJHGqKCjEKlIcugp",280,0.996441,31,281,1,280,1,1,0,1,1,133,132,148,148,60
"5514",13,"[31]rJHzwFoIyoHcouHnJHGqKCjEKlIcugp",282,0.996466,31,283,1,282,1,1,0,1,1,143,142,140,140,60
"5515",14,"[31]rJHzwFoIyoHcouHnJHGqKCjEKlIcugp",276,0.99639,31,277,1,276,1,1,0,1,1,134,133,143,143,60
"5516",15,"[31]rJHzwFoIyoHcouHnJHGqKCjEKlIcugp",289,0.996552,31,290,1,289,1,1,0,1,1,148,147,142,142,60
"5517",16,"[31]rJHzwFoIyoHcouHnJHGqKCjEKlIcugp",280,0.996441,31,281,1,280,1,1,0,1,1,150,149,131,131,60
"5518",17,"[31]rJHzwFoIyoHcouHnJHGqKCjEKlIcugp",286,0.996516,31,287,1,286,1,1,0,1,1,158,157,129,129,60
"5519",18,"[31]rJHzwFoIyoHcouHnJHGqKCjEKlIcugp",271,0.996324,31,272,1,271,1,1,0,1,1,122,121,150,150,60
"5520",19,"[31]rJHzwFoIyoHcouHnJHGqKCjEKlIcugp",283,0.996479,31,284,1,283,1,1,0,1,1,138,137,146,146,60
"5521",20,"[31]rJHzwFoIyoHcouHnJHGqKCjEKlIcugp",280,0.996441,31,281,1,280,1,1,0,1,1,155,154,126,126,60
"5522",21,"[31]rJHzwFoIyoHcouHnJHGqKCjEKlIcugp",286,0.996516,31,287,1,286,1,1,0,1,1,142,141,145,145,60
"5523",22,"[31]rJHzwFoIyoHcouHnJHGqKCjEKlIcugp",277,0.996403,31,278,1,277,1,1,0,1,1,138,137,140,140,60
"5524",23,"[31]rJHzwFoIyoHcouHnJHGqKCjEKlIcugp",271,0.996324,31,272,1,271,1,1,0,1,1,148,147,124,124,60
"5525",24,"[31]rJHzwFoIyoHcouHnJHGqKCjEKlIcugp",283,0.996479,31,284,1,283,1,1,0,1,1,140,139,144,144,60
"5526",25,"[31]rJHzwFoIyoHcouHnJHGqKCjEKlIcugp",282,0.996466,31,283,1,282,1,1,0,1,1,145,144,138,138,60
"5527",26,"[31]rJHzwFoIyoHcouHnJHGqKCjEKlIcugp",281,0.996454,31,282,1,281,1,1,0,1,1,149,148,133,133,60
"5528",27,"[31]rJHzwFoIyoHcouHnJHGqKCjEKlIcugp",287,0.996528,31,288,1,287,1,1,0,1,1,148,147,140,140,60
"5529",28,"[31]rJHzwFoIyoHcouHnJHGqKCjEKlIcugp",281,0.996454,31,282,1,281,1,1,0,1,1,123,122,159,159,60
"5530",29,"[31]rJHzwFoIyoHcouHnJHGqKCjEKlIcugp",275,0.996377,31,276,1,275,1,1,0,1,1,139,138,137,137,60
"5531",30,"[31]rJHzwFoIyoHcouHnJHGqKCjEKlIcugp",276,0.99639,31,277,1,276,1,1,0,1,1,138,137,139,139,60
"5532",31,"[31]rJHzwFoIyoHcouHnJHGqKCjEKlIcugp",277,0.996403,31,278,1,277,1,1,0,1,1,126,125,152,152,60
"5533",32,"[31]rJHzwFoIyoHcouHnJHGqKCjEKlIcugp",281,0.996454,31,282,1,281,1,1,0,1,1,142,141,140,140,60
"5534",33,"[31]rJHzwFoIyoHcouHnJHGqKCjEKlIcugp",279,0.996429,31,280,1,279,1,1,0,1,1,136,135,144,144,60
"5535",34,"[31]rJHzwFoIyoHcouHnJHGqKCjEKlIcugp",282,0.996466,31,283,1,282,1,1,0,1,1,143,142,140,140,60
"5536",35,"[31]rJHzwFoIyoHcouHnJHGqKCjEKlIcugp",291,0.996575,31,292,1,291,1,1,0,1,1,163,162,129,129,60
"5537",36,"[31]rJHzwFoIyoHcouHnJHGqKCjEKlIcugp",288,0.99654,31,289,1,288,1,1,0,1,1,154,153,135,135,60
"5538",37,"[31]rJHzwFoIyoHcouHnJHGqKCjEKlIcugp",286,0.996516,31,287,1,286,1,1,0,1,1,160,159,127,127,60
"5539",38,"[31]rJHzwFoIyoHcouHnJHGqKCjEKlIcugp",276,0.99639,31,277,1,276,1,1,0,1,1,144,143,133,133,60
"5540",39,"[31]rJHzwFoIyoHcouHnJHGqKCjEKlIcugp",273,0.99635,31,274,1,273,1,1,0,1,1,128,127,146,146,60
"5541",40,"[31]rJHzwFoIyoHcouHnJHGqKCjEKlIcugp",282,0.996466,31,283,1,282,1,1,0,1,1,137,136,146,146,60
"5542",41,"[31]rJHzwFoIyoHcouHnJHGqKCjEKlIcugp",284,0.996491,31,285,1,284,1,1,0,1,1,141,140,144,144,60
"5543",42,"[31]rJHzwFoIyoHcouHnJHGqKCjEKlIcugp",282,0.996466,31,283,1,282,1,1,0,1,1,137,136,146,146,60
"5544",43,"[31]rJHzwFoIyoHcouHnJHGqKCjEKlIcugp",275,0.996377,31,276,1,275,1,1,0,1,1,131,130,145,145,60
"5545",44,"[31]rJHzwFoIyoHcouHnJHGqKCjEKlIcugp",280,0.996441,31,281,1,280,1,1,0,1,1,161,160,120,120,60
"5546",45,"[31]rJHzwFoIyoHcouHnJHGqKCjEKlIcugp",284,0.996491,31,285,1,284,1,1,0,1,1,153,152,132,132,60
"5547",46,"[31]rJHzwFoIyoHcouHnJHGqKCjEKlIcugp",285,0.996503,31,286,1,285,1,1,0,1,1,144,143,142,142,60
"5548",47,"[31]rJHzwFoIyoHcouHnJHGqKCjEKlIcugp",280,0.996441,31,281,1,280,1,1,0,1,1,140,139,141,141,60
"5549",48,"[31]rJHzwFoIyoHcouHnJHGqKCjEKlIcugp",288,0.99654,31,289,1,288,1,1,0,1,1,142,141,147,147,60
"5550",49,"[31]rJHzwFoIyoHcouHnJHGqKCjEKlIcugp",288,0.99654,31,289,1,288,1,1,0,1,1,149,148,140,140,60
"5551",50,"[31]rJHzwFoIyoHcouHnJHGqKCjEKlIcugp",280,0.996441,31,281,1,280,1,1,0,1,1,138,137,143,143,60
"5552",51,"[31]rJHzwFoIyoHcouHnJHGqKCjEKlIcugp",283,0.996479,31,284,1,283,1,1,0,1,1,143,142,141,141,60
"5553",52,"[31]rJHzwFoIyoHcouHnJHGqKCjEKlIcugp",278,0.996416,31,279,1,278,1,1,0,1,1,124,123,155,155,60
"5554",53,"[31]rJHzwFoIyoHcouHnJHGqKCjEKlIcugp",282,0.996466,31,283,1,282,1,1,0,1,1,139,138,144,144,60
"5555",54,"[31]rJHzwFoIyoHcouHnJHGqKCjEKlIcugp",283,0.996479,31,284,1,283,1,1,0,1,1,134,133,150,150,60
"5556",55,"[31]rJHzwFoIyoHcouHnJHGqKCjEKlIcugp",279,0.996429,31,280,1,279,1,1,0,1,1,127,126,153,153,60
"5557",56,"[31]rJHzwFoIyoHcouHnJHGqKCjEKlIcugp",283,0.996479,31,284,1,283,1,1,0,1,1,135,134,149,149,60
"5558",57,"[31]rJHzwFoIyoHcouHnJHGqKCjEKlIcugp",274,0.996364,31,275,1,274,1,1,0,1,1,144,143,131,131,60
"5559",58,"[31]rJHzwFoIyoHcouHnJHGqKCjEKlIcugp",284,0.996491,31,285,1,284,1,1,0,1,1,154,153,131,131,60
"5560",59,"[31]rJHzwFoIyoHcouHnJHGqKCjEKlIcugp",281,0.996454,31,282,1,281,1,1,0,1,1,129,128,153,153,60
"5561",60,"[31]rJHzwFoIyoHcouHnJHGqKCjEKlIcugp",283,0.996479,31,284,1,283,1,1,0,1,1,154,153,130,130,60
"5562",61,"[31]rJHzwFoIyoHcouHnJHGqKCjEKlIcugp",283,0.996479,31,284,1,283,1,1,0,1,1,146,145,138,138,60
"5563",62,"[31]rJHzwFoIyoHcouHnJHGqKCjEKlIcugp",282,0.996466,31,283,1,282,1,1,0,1,1,128,127,155,155,60
"5564",63,"[31]rJHzwFoIyoHcouHnJHGqKCjEKlIcugp",285,0.996503,31,286,1,285,1,1,0,1,1,134,133,152,152,60
"5565",64,"[31]rJHzwFoIyoHcouHnJHGqKCjEKlIcugp",272,0.996337,31,273,1,272,1,1,0,1,1,131,130,142,142,60
"5566",65,"[31]rJHzwFoIyoHcouHnJHGqKCjEKlIcugp",274,0.996364,31,275,1,274,1,1,0,1,1,122,121,153,153,60
"5567",66,"[31]rJHzwFoIyoHcouHnJHGqKCjEKlIcugp",278,0.996416,31,279,1,278,1,1,0,1,1,145,144,134,134,60
"5568",67,"[31]rJHzwFoIyoHcouHnJHGqKCjEKlIcugp",277,0.996403,31,278,1,277,1,1,0,1,1,142,141,136,136,60
"5569",68,"[31]rJHzwFoIyoHcouHnJHGqKCjEKlIcugp",277,0.996403,31,278,1,277,1,1,0,1,1,129,128,149,149,60
"5570",69,"[31]rJHzwFoIyoHcouHnJHGqKCjEKlIcugp",279,0.996429,31,280,1,279,1,1,0,1,1,139,138,141,141,60
"5571",70,"[31]rJHzwFoIyoHcouHnJHGqKCjEKlIcugp",285,0.996503,31,286,1,285,1,1,0,1,1,145,144,141,141,60
"5572",71,"[31]rJHzwFoIyoHcouHnJHGqKCjEKlIcugp",280,0.996441,31,281,1,280,1,1,0,1,1,140,139,141,141,60
"5573",72,"[31]rJHzwFoIyoHcouHnJHGqKCjEKlIcugp",280,0.996441,31,281,1,280,1,1,0,1,1,137,136,144,144,60
"5574",73,"[31]rJHzwFoIyoHcouHnJHGqKCjEKlIcugp",281,0.996454,31,282,1,281,1,1,0,1,1,143,142,139,139,60
"5575",74,"[31]rJHzwFoIyoHcouHnJHGqKCjEKlIcugp",281,0.996454,31,282,1,281,1,1,0,1,1,142,141,140,140,60
"5576",75,"[31]rJHzwFoIyoHcouHnJHGqKCjEKlIcugp",271,0.996324,31,272,1,271,1,1,0,1,1,132,131,140,140,60
"5577",76,"[31]rJHzwFoIyoHcouHnJHGqKCjEKlIcugp",286,0.996516,31,287,1,286,1,1,0,1,1,146,145,141,141,60
"5578",77,"[31]rJHzwFoIyoHcouHnJHGqKCjEKlIcugp",288,0.99654,31,289,1,288,1,1,0,1,1,136,135,153,153,60
"5579",78,"[31]rJHzwFoIyoHcouHnJHGqKCjEKlIcugp",283,0.996479,31,284,1,283,1,1,0,1,1,160,159,124,124,60
"5580",79,"[31]rJHzwFoIyoHcouHnJHGqKCjEKlIcugp",284,0.996491,31,285,1,284,1,1,0,1,1,146,145,139,139,60
"5581",80,"[31]rJHzwFoIyoHcouHnJHGqKCjEKlIcugp",281,0.996454,31,282,1,281,1,1,0,1,1,138,137,144,144,60
"5582",81,"[31]rJHzwFoIyoHcouHnJHGqKCjEKlIcugp",269,0.996296,31,270,1,269,1,1,0,1,1,135,134,135,135,60
"5583",82,"[31]rJHzwFoIyoHcouHnJHGqKCjEKlIcugp",280,0.996441,31,281,1,280,1,1,0,1,1,134,133,147,147,60
"5584",83,"[31]rJHzwFoIyoHcouHnJHGqKCjEKlIcugp",285,0.996503,31,286,1,285,1,1,0,1,1,153,152,133,133,60
"5585",84,"[31]rJHzwFoIyoHcouHnJHGqKCjEKlIcugp",283,0.996479,31,284,1,283,1,1,0,1,1,142,141,142,142,60
"5586",85,"[31]rJHzwFoIyoHcouHnJHGqKCjEKlIcugp",280,0.996441,31,281,1,280,1,1,0,1,1,141,140,140,140,60
"5587",86,"[31]rJHzwFoIyoHcouHnJHGqKCjEKlIcugp",285,0.996503,31,286,1,285,1,1,0,1,1,149,148,137,137,60
"5588",87,"[31]rJHzwFoIyoHcouHnJHGqKCjEKlIcugp",286,0.996516,31,287,1,286,1,1,0,1,1,160,159,127,127,60
"5589",88,"[31]rJHzwFoIyoHcouHnJHGqKCjEKlIcugp",277,0.996403,31,278,1,277,1,1,0,1,1,132,131,146,146,60
"5590",89,"[31]rJHzwFoIyoHcouHnJHGqKCjEKlIcugp",281,0.996454,31,282,1,281,1,1,0,1,1,150,149,132,132,60
"5591",90,"[31]rJHzwFoIyoHcouHnJHGqKCjEKlIcugp",278,0.996416,31,279,1,278,1,1,0,1,1,141,140,138,138,60
"5592",91,"[31]rJHzwFoIyoHcouHnJHGqKCjEKlIcugp",277,0.996403,31,278,1,277,1,1,0,1,1,142,141,136,136,60
"5593",92,"[31]rJHzwFoIyoHcouHnJHGqKCjEKlIcugp",282,0.996466,31,283,1,282,1,1,0,1,1,134,133,149,149,60
"5594",93,"[31]rJHzwFoIyoHcouHnJHGqKCjEKlIcugp",287,0.996528,31,288,1,287,1,1,0,1,1,138,137,150,150,60
"5595",94,"[31]rJHzwFoIyoHcouHnJHGqKCjEKlIcugp",282,0.996466,31,283,1,282,1,1,0,1,1,157,156,126,126,60
"5596",95,"[31]rJHzwFoIyoHcouHnJHGqKCjEKlIcugp",287,0.996528,31,288,1,287,1,1,0,1,1,141,140,147,147,60
"5597",96,"[31]rJHzwFoIyoHcouHnJHGqKCjEKlIcugp",275,0.996377,31,276,1,275,1,1,0,1,1,136,135,140,140,60
"5598",97,"[31]rJHzwFoIyoHcouHnJHGqKCjEKlIcugp",278,0.996416,31,279,1,278,1,1,0,1,1,137,136,142,142,60
"5599",98,"[31]rJHzwFoIyoHcouHnJHGqKCjEKlIcugp",284,0.996491,31,285,1,284,1,1,0,1,1,124,123,161,161,60
"5600",99,"[31]rJHzwFoIyoHcouHnJHGqKCjEKlIcugp",286,0.996516,31,287,1,286,1,1,0,1,1,138,137,149,149,60
"5601",0,"[25]glmHoIoHcoxHnJqGKCDCrxxtb",292,0.996587,25,293,1,292,1,1,0,1,1,141,140,152,152,61
"5602",1,"[25]glmHoIoHcoxHnJqGKCDCrxxtb",297,0.996644,25,298,1,297,1,1,0,1,1,150,149,148,148,61
"5603",2,"[25]glmHoIoHcoxHnJqGKCDCrxxtb",286,0.996516,25,287,1,286,1,1,0,1,1,145,144,142,142,61
"5604",3,"[25]glmHoIoHcoxHnJqGKCDCrxxtb",294,0.99661,25,295,1,294,1,1,0,1,1,150,149,145,145,61
"5605",4,"[25]glmHoIoHcoxHnJqGKCDCrxxtb",302,0.9967,25,303,1,302,1,1,0,1,1,152,151,151,151,61
"5606",5,"[25]glmHoIoHcoxHnJqGKCDCrxxtb",294,0.99661,25,295,1,294,1,1,0,1,1,149,148,146,146,61
"5607",6,"[25]glmHoIoHcoxHnJqGKCDCrxxtb",293,0.996599,25,294,1,293,1,1,0,1,1,146,145,148,148,61
"5608",7,"[25]glmHoIoHcoxHnJqGKCDCrxxtb",293,0.996599,25,294,1,293,1,1,0,1,1,140,139,154,154,61
"5609",8,"[25]glmHoIoHcoxHnJqGKCDCrxxtb",293,0.996599,25,294,1,293,1,1,0,1,1,145,144,149,149,61
"5610",9,"[25]glmHoIoHcoxHnJqGKCDCrxxtb",300,0.996678,25,301,1,300,1,1,0,1,1,159,158,142,142,61
"5611",10,"[25]glmHoIoHcoxHnJqGKCDCrxxtb",293,0.996599,25,294,1,293,1,1,0,1,1,149,148,145,145,61
"5612",11,"[25]glmHoIoHcoxHnJqGKCDCrxxtb",298,0.996656,25,299,1,298,1,1,0,1,1,155,154,144,144,61
"5613",12,"[25]glmHoIoHcoxHnJqGKCDCrxxtb",296,0.996633,25,297,1,296,1,1,0,1,1,151,150,146,146,61
"5614",13,"[25]glmHoIoHcoxHnJqGKCDCrxxtb",293,0.996599,25,294,1,293,1,1,0,1,1,145,144,149,149,61
"5615",14,"[25]glmHoIoHcoxHnJqGKCDCrxxtb",293,0.996599,25,294,1,293,1,1,0,1,1,146,145,148,148,61
"5616",15,"[25]glmHoIoHcoxHnJqGKCDCrxxtb",296,0.996633,25,297,1,296,1,1,0,1,1,150,149,147,147,61
"5617",16,"[25]glmHoIoHcoxHnJqGKCDCrxxtb",301,0.996689,25,302,1,301,1,1,0,1,1,164,163,138,138,61
"5618",17,"[25]glmHoIoHcoxHnJqGKCDCrxxtb",297,0.996644,25,298,1,297,1,1,0,1,1,156,155,142,142,61
"5619",18,"[25]glmHoIoHcoxHnJqGKCDCrxxtb",299,0.996667,25,300,1,299,1,1,0,1,1,154,153,146,146,61
"5620",19,"[25]glmHoIoHcoxHnJqGKCDCrxxtb",295,0.996622,25,296,1,295,1,1,0,1,1,144,143,152,152,61
"5621",20,"[25]glmHoIoHcoxHnJqGKCDCrxxtb",295,0.996622,25,296,1,295,1,1,0,1,1,154,153,142,142,61
"5622",21,"[25]glmHoIoHcoxHnJqGKCDCrxxtb",298,0.996656,25,299,1,298,1,1,0,1,1,155,154,144,144,61
"5623",22,"[25]glmHoIoHcoxHnJqGKCDCrxxtb",293,0.996599,25,294,1,293,1,1,0,1,1,146,145,148,148,61
"5624",23,"[25]glmHoIoHcoxHnJqGKCDCrxxtb",292,0.996587,25,293,1,292,1,1,0,1,1,137,136,156,156,61
"5625",24,"[25]glmHoIoHcoxHnJqGKCDCrxxtb",299,0.996667,25,300,1,299,1,1,0,1,1,158,157,142,142,61
"5626",25,"[25]glmHoIoHcoxHnJqGKCDCrxxtb",296,0.996633,25,297,1,296,1,1,0,1,1,144,143,153,153,61
"5627",26,"[25]glmHoIoHcoxHnJqGKCDCrxxtb",296,0.996633,25,297,1,296,1,1,0,1,1,149,148,148,148,61
"5628",27,"[25]glmHoIoHcoxHnJqGKCDCrxxtb",299,0.996667,25,300,1,299,1,1,0,1,1,159,158,141,141,61
"5629",28,"[25]glmHoIoHcoxHnJqGKCDCrxxtb",289,0.996552,25,290,1,289,1,1,0,1,1,134,133,156,156,61
"5630",29,"[25]glmHoIoHcoxHnJqGKCDCrxxtb",299,0.996667,25,300,1,299,1,1,0,1,1,149,148,151,151,61
"5631",30,"[25]glmHoIoHcoxHnJqGKCDCrxxtb",288,0.99654,25,289,1,288,1,1,0,1,1,128,127,161,161,61
"5632",31,"[25]glmHoIoHcoxHnJqGKCDCrxxtb",293,0.996599,25,294,1,293,1,1,0,1,1,149,148,145,145,61
"5633",32,"[25]glmHoIoHcoxHnJqGKCDCrxxtb",294,0.99661,25,295,1,294,1,1,0,1,1,145,144,150,150,61
"5634",33,"[25]glmHoIoHcoxHnJqGKCDCrxxtb",292,0.996587,25,293,1,292,1,1,0,1,1,137,136,156,156,61
"5635",34,"[25]glmHoIoHcoxHnJqGKCDCrxxtb",302,0.9967,25,303,1,302,1,1,0,1,1,161,160,142,142,61
"5636",35,"[25]glmHoIoHcoxHnJqGKCDCrxxtb",291,0.996575,25,292,1,291,1,1,0,1,1,134,133,158,158,61
"5637",36,"[25]glmHoIoHcoxHnJqGKCDCrxxtb",293,0.996599,25,294,1,293,1,1,0,1,1,138,137,156,156,61
"5638",37,"[25]glmHoIoHcoxHnJqGKCDCrxxtb",297,0.996644,25,298,1,297,1,1,0,1,1,153,152,145,145,61
"5639",38,"[25]glmHoIoHcoxHnJqGKCDCrxxtb",294,0.99661,25,295,1,294,1,1,0,1,1,145,144,150,150,61
"5640",39,"[25]glmHoIoHcoxHnJqGKCDCrxxtb",292,0.996587,25,293,1,292,1,1,0,1,1,144,143,149,149,61
"5641",40,"[25]glmHoIoHcoxHnJqGKCDCrxxtb",294,0.99661,25,295,1,294,1,1,0,1,1,143,142,152,152,61
"5642",41,"[25]glmHoIoHcoxHnJqGKCDCrxxtb",296,0.996633,25,297,1,296,1,1,0,1,1,145,144,152,152,61
"5643",42,"[25]glmHoIoHcoxHnJqGKCDCrxxtb",297,0.996644,25,298,1,297,1,1,0,1,1,156,155,142,142,61
"5644",43,"[25]glmHoIoHcoxHnJqGKCDCrxxtb",290,0.996564,25,291,1,290,1,1,0,1,1,138,137,153,153,61
"5645",44,"[25]glmHoIoHcoxHnJqGKCDCrxxtb",291,0.996575,25,292,1,291,1,1,0,1,1,140,139,152,152,61
"5646",45,"[25]glmHoIoHcoxHnJqGKCDCrxxtb",297,0.996644,25,298,1,297,1,1,0,1,1,153,152,145,145,61
"5647",46,"[25]glmHoIoHcoxHnJqGKCDCrxxtb",303,0.996711,25,304,1,303,1,1,0,1,1,170,169,134,134,61
"5648",47,"[25]glmHoIoHcoxHnJqGKCDCrxxtb",286,0.996516,25,287,1,286,1,1,0,1,1,147,146,140,140,61
"5649",48,"[25]glmHoIoHcoxHnJqGKCDCrxxtb",298,0.996656,25,299,1,298,1,1,0,1,1,156,155,143,143,61
"5650",49,"[25]glmHoIoHcoxHnJqGKCDCrxxtb",292,0.996587,25,293,1,292,1,1,0,1,1,137,136,156,156,61
"5651",50,"[25]glmHoIoHcoxHnJqGKCDCrxxtb",287,0.996528,25,288,1,287,1,1,0,1,1,134,133,154,154,61
"5652",51,"[25]glmHoIoHcoxHnJqGKCDCrxxtb",292,0.996587,25,293,1,292,1,1,0,1,1,138,137,155,155,61
"5653",52,"[25]glmHoIoHcoxHnJqGKCDCrxxtb",293,0.996599,25,294,1,293,1,1,0,1,1,140,139,154,154,61
"5654",53,"[25]glmHoIoHcoxHnJqGKCDCrxxtb",294,0.99661,25,295,1,294,1,1,0,1,1,157,156,138,138,61
"5655",54,"[25]glmHoIoHcoxHnJqGKCDCrxxtb",294,0.99661,25,295,1,294,1,1,0,1,1,142,141,153,153,61
"5656",55,"[25]glmHoIoHcoxHnJqGKCDCrxxtb",298,0.996656,25,299,1,298,1,1,0,1,1,151,150,148,148,61
"5657",56,"[25]glmHoIoHcoxHnJqGKCDCrxxtb",301,0.996689,25,302,1,301,1,1,0,1,1,176,175,126,126,61
"5658",57,"[25]glmHoIoHcoxHnJqGKCDCrxxtb",293,0.996599,25,294,1,293,1,1,0,1,1,142,141,152,152,61
"5659",58,"[25]glmHoIoHcoxHnJqGKCDCrxxtb",295,0.996622,25,296,1,295,1,1,0,1,1,150,149,146,146,61
"5660",59,"[25]glmHoIoHcoxHnJqGKCDCrxxtb",295,0.996622,25,296,1,295,1,1,0,1,1,151,150,145,145,61
"5661",60,"[25]glmHoIoHcoxHnJqGKCDCrxxtb",300,0.996678,25,301,1,300,1,1,0,1,1,156,155,145,145,61
"5662",61,"[25]glmHoIoHcoxHnJqGKCDCrxxtb",290,0.996564,25,291,1,290,1,1,0,1,1,140,139,151,151,61
"5663",62,"[25]glmHoIoHcoxHnJqGKCDCrxxtb",289,0.996552,25,290,1,289,1,1,0,1,1,134,133,156,156,61
"5664",63,"[25]glmHoIoHcoxHnJqGKCDCrxxtb",296,0.996633,25,297,1,296,1,1,0,1,1,163,162,134,134,61
"5665",64,"[25]glmHoIoHcoxHnJqGKCDCrxxtb",291,0.996575,25,292,1,291,1,1,0,1,1,150,149,142,142,61
"5666",65,"[25]glmHoIoHcoxHnJqGKCDCrxxtb",302,0.9967,25,303,1,302,1,1,0,1,1,169,168,134,134,61
"5667",66,"[25]glmHoIoHcoxHnJqGKCDCrxxtb",291,0.996575,25,292,1,291,1,1,0,1,1,140,139,152,152,61
"5668",67,"[25]glmHoIoHcoxHnJqGKCDCrxxtb",295,0.996622,25,296,1,295,1,1,0,1,1,146,145,150,150,61
"5669",68,"[25]glmHoIoHcoxHnJqGKCDCrxxtb",303,0.996711,25,304,1,303,1,1,0,1,1,167,166,137,137,61
"5670",69,"[25]glmHoIoHcoxHnJqGKCDCrxxtb",299,0.996667,25,300,1,299,1,1,0,1,1,158,157,142,142,61
"5671",70,"[25]glmHoIoHcoxHnJqGKCDCrxxtb",291,0.996575,25,292,1,291,1,1,0,1,1,134,133,158,158,61
"5672",71,"[25]glmHoIoHcoxHnJqGKCDCrxxtb",300,0.996678,25,301,1,300,1,1,0,1,1,163,162,138,138,61
"5673",72,"[25]glmHoIoHcoxHnJqGKCDCrxxtb",299,0.996667,25,300,1,299,1,1,0,1,1,158,157,142,142,61
"5674",73,"[25]glmHoIoHcoxHnJqGKCDCrxxtb",297,0.996644,25,298,1,297,1,1,0,1,1,153,152,145,145,61
"5675",74,"[25]glmHoIoHcoxHnJqGKCDCrxxtb",296,0.996633,25,297,1,296,1,1,0,1,1,153,152,144,144,61
"5676",75,"[25]glmHoIoHcoxHnJqGKCDCrxxtb",291,0.996575,25,292,1,291,1,1,0,1,1,133,132,159,159,61
"5677",76,"[25]glmHoIoHcoxHnJqGKCDCrxxtb",291,0.996575,25,292,1,291,1,1,0,1,1,147,146,145,145,61
"5678",77,"[25]glmHoIoHcoxHnJqGKCDCrxxtb",296,0.996633,25,297,1,296,1,1,0,1,1,151,150,146,146,61
"5679",78,"[25]glmHoIoHcoxHnJqGKCDCrxxtb",293,0.996599,25,294,1,293,1,1,0,1,1,138,137,156,156,61
"5680",79,"[25]glmHoIoHcoxHnJqGKCDCrxxtb",297,0.996644,25,298,1,297,1,1,0,1,1,153,152,145,145,61
"5681",80,"[25]glmHoIoHcoxHnJqGKCDCrxxtb",289,0.996552,25,290,1,289,1,1,0,1,1,140,139,150,150,61
"5682",81,"[25]glmHoIoHcoxHnJqGKCDCrxxtb",291,0.996575,25,292,1,291,1,1,0,1,1,139,138,153,153,61
"5683",82,"[25]glmHoIoHcoxHnJqGKCDCrxxtb",302,0.9967,25,303,1,302,1,1,0,1,1,174,173,129,129,61
"5684",83,"[25]glmHoIoHcoxHnJqGKCDCrxxtb",298,0.996656,25,299,1,298,1,1,0,1,1,157,156,142,142,61
"5685",84,"[25]glmHoIoHcoxHnJqGKCDCrxxtb",299,0.996667,25,300,1,299,1,1,0,1,1,155,154,145,145,61
"5686",85,"[25]glmHoIoHcoxHnJqGKCDCrxxtb",289,0.996552,25,290,1,289,1,1,0,1,1,130,129,160,160,61
"5687",86,"[25]glmHoIoHcoxHnJqGKCDCrxxtb",301,0.996689,25,302,1,301,1,1,0,1,1,164,163,138,138,61
"5688",87,"[25]glmHoIoHcoxHnJqGKCDCrxxtb",299,0.996667,25,300,1,299,1,1,0,1,1,160,159,140,140,61
"5689",88,"[25]glmHoIoHcoxHnJqGKCDCrxxtb",299,0.996667,25,300,1,299,1,1,0,1,1,157,156,143,143,61
"5690",89,"[25]glmHoIoHcoxHnJqGKCDCrxxtb",297,0.996644,25,298,1,297,1,1,0,1,1,151,150,147,147,61
"5691",90,"[25]glmHoIoHcoxHnJqGKCDCrxxtb",287,0.996528,25,288,1,287,1,1,0,1,1,144,143,144,144,61
"5692",91,"[25]glmHoIoHcoxHnJqGKCDCrxxtb",297,0.996644,25,298,1,297,1,1,0,1,1,151,150,147,147,61
"5693",92,"[25]glmHoIoHcoxHnJqGKCDCrxxtb",293,0.996599,25,294,1,293,1,1,0,1,1,146,145,148,148,61
"5694",93,"[25]glmHoIoHcoxHnJqGKCDCrxxtb",304,0.996721,25,305,1,304,1,1,0,1,1,173,172,132,132,61
"5695",94,"[25]glmHoIoHcoxHnJqGKCDCrxxtb",297,0.996644,25,298,1,297,1,1,0,1,1,156,155,142,142,61
"5696",95,"[25]glmHoIoHcoxHnJqGKCDCrxxtb",303,0.996711,25,304,1,303,1,1,0,1,1,172,171,132,132,61
"5697",96,"[25]glmHoIoHcoxHnJqGKCDCrxxtb",292,0.996587,25,293,1,292,1,1,0,1,1,138,137,155,155,61
"5698",97,"[25]glmHoIoHcoxHnJqGKCDCrxxtb",298,0.996656,25,299,1,298,1,1,0,1,1,155,154,144,144,61
"5699",98,"[25]glmHoIoHcoxHnJqGKCDCrxxtb",290,0.996564,25,291,1,290,1,1,0,1,1,137,136,154,154,61
"5700",99,"[25]glmHoIoHcoxHnJqGKCDCrxxtb",293,0.996599,25,294,1,293,1,1,0,1,1,148,147,146,146,61
"5701",0,"[26]DFyEHoIdoHcouHnJqGKCzlpGih",294,0.99661,26,295,1,294,1,1,0,1,1,150,149,145,145,62
"5702",1,"[26]DFyEHoIdoHcouHnJqGKCzlpGih",289,0.996552,26,290,1,289,1,1,0,1,1,141,140,149,149,62
"5703",2,"[26]DFyEHoIdoHcouHnJqGKCzlpGih",296,0.996633,26,297,1,296,1,1,0,1,1,149,148,148,148,62
"5704",3,"[26]DFyEHoIdoHcouHnJqGKCzlpGih",295,0.996622,26,296,1,295,1,1,0,1,1,148,147,148,148,62
"5705",4,"[26]DFyEHoIdoHcouHnJqGKCzlpGih",285,0.996503,26,286,1,285,1,1,0,1,1,121,120,165,165,62
"5706",5,"[26]DFyEHoIdoHcouHnJqGKCzlpGih",289,0.996552,26,290,1,289,1,1,0,1,1,132,131,158,158,62
"5707",6,"[26]DFyEHoIdoHcouHnJqGKCzlpGih",293,0.996599,26,294,1,293,1,1,0,1,1,145,144,149,149,62
"5708",7,"[26]DFyEHoIdoHcouHnJqGKCzlpGih",295,0.996622,26,296,1,295,1,1,0,1,1,149,148,147,147,62
"5709",8,"[26]DFyEHoIdoHcouHnJqGKCzlpGih",288,0.99654,26,289,1,288,1,1,0,1,1,133,132,156,156,62
"5710",9,"[26]DFyEHoIdoHcouHnJqGKCzlpGih",292,0.996587,26,293,1,292,1,1,0,1,1,147,146,146,146,62
"5711",10,"[26]DFyEHoIdoHcouHnJqGKCzlpGih",294,0.99661,26,295,1,294,1,1,0,1,1,154,153,141,141,62
"5712",11,"[26]DFyEHoIdoHcouHnJqGKCzlpGih",300,0.996678,26,301,1,300,1,1,0,1,1,165,164,136,136,62
"5713",12,"[26]DFyEHoIdoHcouHnJqGKCzlpGih",298,0.996656,26,299,1,298,1,1,0,1,1,153,152,146,146,62
"5714",13,"[26]DFyEHoIdoHcouHnJqGKCzlpGih",291,0.996575,26,292,1,291,1,1,0,1,1,138,137,154,154,62
"5715",14,"[26]DFyEHoIdoHcouHnJqGKCzlpGih",296,0.996633,26,297,1,296,1,1,0,1,1,159,158,138,138,62
"5716",15,"[26]DFyEHoIdoHcouHnJqGKCzlpGih",291,0.996575,26,292,1,291,1,1,0,1,1,140,139,152,152,62
"5717",16,"[26]DFyEHoIdoHcouHnJqGKCzlpGih",298,0.996656,26,299,1,298,1,1,0,1,1,166,165,133,133,62
"5718",17,"[26]DFyEHoIdoHcouHnJqGKCzlpGih",302,0.9967,26,303,1,302,1,1,0,1,1,166,165,137,137,62
"5719",18,"[26]DFyEHoIdoHcouHnJqGKCzlpGih",294,0.99661,26,295,1,294,1,1,0,1,1,141,140,154,154,62
"5720",19,"[26]DFyEHoIdoHcouHnJqGKCzlpGih",296,0.996633,26,297,1,296,1,1,0,1,1,141,140,156,156,62
"5721",20,"[26]DFyEHoIdoHcouHnJqGKCzlpGih",284,0.996491,26,285,1,284,1,1,0,1,1,118,117,167,167,62
"5722",21,"[26]DFyEHoIdoHcouHnJqGKCzlpGih",284,0.996491,26,285,1,284,1,1,0,1,1,140,139,145,145,62
"5723",22,"[26]DFyEHoIdoHcouHnJqGKCzlpGih",293,0.996599,26,294,1,293,1,1,0,1,1,148,147,146,146,62
"5724",23,"[26]DFyEHoIdoHcouHnJqGKCzlpGih",294,0.99661,26,295,1,294,1,1,0,1,1,149,148,146,146,62
"5725",24,"[26]DFyEHoIdoHcouHnJqGKCzlpGih",292,0.996587,26,293,1,292,1,1,0,1,1,138,137,155,155,62
"5726",25,"[26]DFyEHoIdoHcouHnJqGKCzlpGih",293,0.996599,26,294,1,293,1,1,0,1,1,144,143,150,150,62
"5727",26,"[26]DFyEHoIdoHcouHnJqGKCzlpGih",294,0.99661,26,295,1,294,1,1,0,1,1,155,154,140,140,62
"5728",27,"[26]DFyEHoIdoHcouHnJqGKCzlpGih",293,0.996599,26,294,1,293,1,1,0,1,1,145,144,149,149,62
"5729",28,"[26]DFyEHoIdoHcouHnJqGKCzlpGih",292,0.996587,26,293,1,292,1,1,0,1,1,150,149,143,143,62
"5730",29,"[26]DFyEHoIdoHcouHnJqGKCzlpGih",299,0.996667,26,300,1,299,1,1,0,1,1,154,153,146,146,62
"5731",30,"[26]DFyEHoIdoHcouHnJqGKCzlpGih",291,0.996575,26,292,1,291,1,1,0,1,1,141,140,151,151,62
"5732",31,"[26]DFyEHoIdoHcouHnJqGKCzlpGih",300,0.996678,26,301,1,300,1,1,0,1,1,161,160,140,140,62
"5733",32,"[26]DFyEHoIdoHcouHnJqGKCzlpGih",297,0.996644,26,298,1,297,1,1,0,1,1,155,154,143,143,62
"5734",33,"[26]DFyEHoIdoHcouHnJqGKCzlpGih",293,0.996599,26,294,1,293,1,1,0,1,1,142,141,152,152,62
"5735",34,"[26]DFyEHoIdoHcouHnJqGKCzlpGih",291,0.996575,26,292,1,291,1,1,0,1,1,136,135,156,156,62
"5736",35,"[26]DFyEHoIdoHcouHnJqGKCzlpGih",286,0.996516,26,287,1,286,1,1,0,1,1,126,125,161,161,62
"5737",36,"[26]DFyEHoIdoHcouHnJqGKCzlpGih",295,0.996622,26,296,1,295,1,1,0,1,1,147,146,149,149,62
"5738",37,"[26]DFyEHoIdoHcouHnJqGKCzlpGih",300,0.996678,26,301,1,300,1,1,0,1,1,168,167,133,133,62
"5739",38,"[26]DFyEHoIdoHcouHnJqGKCzlpGih",294,0.99661,26,295,1,294,1,1,0,1,1,141,140,154,154,62
"5740",39,"[26]DFyEHoIdoHcouHnJqGKCzlpGih",296,0.996633,26,297,1,296,1,1,0,1,1,147,146,150,150,62
"5741",40,"[26]DFyEHoIdoHcouHnJqGKCzlpGih",290,0.996564,26,291,1,290,1,1,0,1,1,141,140,150,150,62
"5742",41,"[26]DFyEHoIdoHcouHnJqGKCzlpGih",286,0.996516,26,287,1,286,1,1,0,1,1,153,152,134,134,62
"5743",42,"[26]DFyEHoIdoHcouHnJqGKCzlpGih",300,0.996678,26,301,1,300,1,1,0,1,1,158,157,143,143,62
"5744",43,"[26]DFyEHoIdoHcouHnJqGKCzlpGih",293,0.996599,26,294,1,293,1,1,0,1,1,146,145,148,148,62
"5745",44,"[26]DFyEHoIdoHcouHnJqGKCzlpGih",293,0.996599,26,294,1,293,1,1,0,1,1,140,139,154,154,62
"5746",45,"[26]DFyEHoIdoHcouHnJqGKCzlpGih",293,0.996599,26,294,1,293,1,1,0,1,1,142,141,152,152,62
"5747",46,"[26]DFyEHoIdoHcouHnJqGKCzlpGih",292,0.996587,26,293,1,292,1,1,0,1,1,139,138,154,154,62
"5748",47,"[26]DFyEHoIdoHcouHnJqGKCzlpGih",288,0.99654,26,289,1,288,1,1,0,1,1,128,127,161,161,62
"5749",48,"[26]DFyEHoIdoHcouHnJqGKCzlpGih",291,0.996575,26,292,1,291,1,1,0,1,1,140,139,152,152,62
"5750",49,"[26]DFyEHoIdoHcouHnJqGKCzlpGih",292,0.996587,26,293,1,292,1,1,0,1,1,141,140,152,152,62
"5751",50,"[26]DFyEHoIdoHcouHnJqGKCzlpGih",300,0.996678,26,301,1,300,1,1,0,1,1,159,158,142,142,62
"5752",51,"[26]DFyEHoIdoHcouHnJqGKCzlpGih",302,0.9967,26,303,1,302,1,1,0,1,1,169,168,134,134,62
"5753",52,"[26]DFyEHoIdoHcouHnJqGKCzlpGih",301,0.996689,26,302,1,301,1,1,0,1,1,169,168,133,133,62
"5754",53,"[26]DFyEHoIdoHcouHnJqGKCzlpGih",295,0.996622,26,296,1,295,1,1,0,1,1,146,145,150,150,62
"5755",54,"[26]DFyEHoIdoHcouHnJqGKCzlpGih",289,0.996552,26,290,1,289,1,1,0,1,1,144,143,146,146,62
"5756",55,"[26]DFyEHoIdoHcouHnJqGKCzlpGih",295,0.996622,26,296,1,295,1,1,0,1,1,149,148,147,147,62
"5757",56,"[26]DFyEHoIdoHcouHnJqGKCzlpGih",294,0.99661,26,295,1,294,1,1,0,1,1,143,142,152,152,62
"5758",57,"[26]DFyEHoIdoHcouHnJqGKCzlpGih",294,0.99661,26,295,1,294,1,1,0,1,1,146,145,149,149,62
"5759",58,"[26]DFyEHoIdoHcouHnJqGKCzlpGih",293,0.996599,26,294,1,293,1,1,0,1,1,143,142,151,151,62
"5760",59,"[26]DFyEHoIdoHcouHnJqGKCzlpGih",297,0.996644,26,298,1,297,1,1,0,1,1,160,159,138,138,62
"5761",60,"[26]DFyEHoIdoHcouHnJqGKCzlpGih",293,0.996599,26,294,1,293,1,1,0,1,1,146,145,148,148,62
"5762",61,"[26]DFyEHoIdoHcouHnJqGKCzlpGih",288,0.99654,26,289,1,288,1,1,0,1,1,135,134,154,154,62
"5763",62,"[26]DFyEHoIdoHcouHnJqGKCzlpGih",294,0.99661,26,295,1,294,1,1,0,1,1,145,144,150,150,62
"5764",63,"[26]DFyEHoIdoHcouHnJqGKCzlpGih",291,0.996575,26,292,1,291,1,1,0,1,1,143,142,149,149,62
"5765",64,"[26]DFyEHoIdoHcouHnJqGKCzlpGih",295,0.996622,26,296,1,295,1,1,0,1,1,148,147,148,148,62
"5766",65,"[26]DFyEHoIdoHcouHnJqGKCzlpGih",289,0.996552,26,290,1,289,1,1,0,1,1,133,132,157,157,62
"5767",66,"[26]DFyEHoIdoHcouHnJqGKCzlpGih",290,0.996564,26,291,1,290,1,1,0,1,1,135,134,156,156,62
"5768",67,"[26]DFyEHoIdoHcouHnJqGKCzlpGih",295,0.996622,26,296,1,295,1,1,0,1,1,146,145,150,150,62
"5769",68,"[26]DFyEHoIdoHcouHnJqGKCzlpGih",295,0.996622,26,296,1,295,1,1,0,1,1,147,146,149,149,62
"5770",69,"[26]DFyEHoIdoHcouHnJqGKCzlpGih",299,0.996667,26,300,1,299,1,1,0,1,1,162,161,138,138,62
"5771",70,"[26]DFyEHoIdoHcouHnJqGKCzlpGih",293,0.996599,26,294,1,293,1,1,0,1,1,146,145,148,148,62
"5772",71,"[26]DFyEHoIdoHcouHnJqGKCzlpGih",296,0.996633,26,297,1,296,1,1,0,1,1,149,148,148,148,62
"5773",72,"[26]DFyEHoIdoHcouHnJqGKCzlpGih",288,0.99654,26,289,1,288,1,1,0,1,1,143,142,146,146,62
"5774",73,"[26]DFyEHoIdoHcouHnJqGKCzlpGih",298,0.996656,26,299,1,298,1,1,0,1,1,160,159,139,139,62
"5775",74,"[26]DFyEHoIdoHcouHnJqGKCzlpGih",295,0.996622,26,296,1,295,1,1,0,1,1,151,150,145,145,62
"5776",75,"[26]DFyEHoIdoHcouHnJqGKCzlpGih",294,0.99661,26,295,1,294,1,1,0,1,1,147,146,148,148,62
"5777",76,"[26]DFyEHoIdoHcouHnJqGKCzlpGih",296,0.996633,26,297,1,296,1,1,0,1,1,151,150,146,146,62
"5778",77,"[26]DFyEHoIdoHcouHnJqGKCzlpGih",291,0.996575,26,292,1,291,1,1,0,1,1,136,135,156,156,62
"5779",78,"[26]DFyEHoIdoHcouHnJqGKCzlpGih",291,0.996575,26,292,1,291,1,1,0,1,1,149,148,143,143,62
"5780",79,"[26]DFyEHoIdoHcouHnJqGKCzlpGih",299,0.996667,26,300,1,299,1,1,0,1,1,162,161,138,138,62
"5781",80,"[26]DFyEHoIdoHcouHnJqGKCzlpGih",290,0.996564,26,291,1,290,1,1,0,1,1,135,134,156,156,62
"5782",81,"[26]DFyEHoIdoHcouHnJqGKCzlpGih",300,0.996678,26,301,1,300,1,1,0,1,1,162,161,139,139,62
"5783",82,"[26]DFyEHoIdoHcouHnJqGKCzlpGih",290,0.996564,26,291,1,290,1,1,0,1,1,138,137,153,153,62
"5784",83,"[26]DFyEHoIdoHcouHnJqGKCzlpGih",294,0.99661,26,295,1,294,1,1,0,1,1,152,151,143,143,62
"5785",84,"[26]DFyEHoIdoHcouHnJqGKCzlpGih",295,0.996622,26,296,1,295,1,1,0,1,1,153,152,143,143,62
"5786",85,"[26]DFyEHoIdoHcouHnJqGKCzlpGih",296,0.996633,26,297,1,296,1,1,0,1,1,156,155,141,141,62
"5787",86,"[26]DFyEHoIdoHcouHnJqGKCzlpGih",289,0.996552,26,290,1,289,1,1,0,1,1,144,143,146,146,62
"5788",87,"[26]DFyEHoIdoHcouHnJqGKCzlpGih",299,0.996667,26,300,1,299,1,1,0,1,1,161,160,139,139,62
"5789",88,"[26]DFyEHoIdoHcouHnJqGKCzlpGih",293,0.996599,26,294,1,293,1,1,0,1,1,156,155,138,138,62
"5790",89,"[26]DFyEHoIdoHcouHnJqGKCzlpGih",292,0.996587,26,293,1,292,1,1,0,1,1,143,142,150,150,62
"5791",90,"[26]DFyEHoIdoHcouHnJqGKCzlpGih",297,0.996644,26,298,1,297,1,1,0,1,1,171,170,127,127,62
"5792",91,"[26]DFyEHoIdoHcouHnJqGKCzlpGih",295,0.996622,26,296,1,295,1,1,0,1,1,145,144,151,151,62
"5793",92,"[26]DFyEHoIdoHcouHnJqGKCzlpGih",292,0.996587,26,293,1,292,1,1,0,1,1,141,140,152,152,62
"5794",93,"[26]DFyEHoIdoHcouHnJqGKCzlpGih",295,0.996622,26,296,1,295,1,1,0,1,1,149,148,147,147,62
"5795",94,"[26]DFyEHoIdoHcouHnJqGKCzlpGih",296,0.996633,26,297,1,296,1,1,0,1,1,152,151,145,145,62
"5796",95,"[26]DFyEHoIdoHcouHnJqGKCzlpGih",300,0.996678,26,301,1,300,1,1,0,1,1,160,159,141,141,62
"5797",96,"[26]DFyEHoIdoHcouHnJqGKCzlpGih",293,0.996599,26,294,1,293,1,1,0,1,1,149,148,145,145,62
"5798",97,"[26]DFyEHoIdoHcouHnJqGKCzlpGih",286,0.996516,26,287,1,286,1,1,0,1,1,137,136,150,150,62
"5799",98,"[26]DFyEHoIdoHcouHnJqGKCzlpGih",300,0.996678,26,301,1,300,1,1,0,1,1,165,164,136,136,62
"5800",99,"[26]DFyEHoIdoHcouHnJqGKCzlpGih",301,0.996689,26,302,1,301,1,1,0,1,1,164,163,138,138,62
"5801",0,"[26]HHoIoHcoxHnJHGqKCrvadiiKla",282,0.996466,26,283,1,282,1,1,0,1,1,142,141,141,141,63
"5802",1,"[26]HHoIoHcoxHnJHGqKCrvadiiKla",281,0.996454,26,282,1,281,1,1,0,1,1,137,136,145,145,63
"5803",2,"[26]HHoIoHcoxHnJHGqKCrvadiiKla",287,0.996528,26,288,1,287,1,1,0,1,1,142,141,146,146,63
"5804",3,"[26]HHoIoHcoxHnJHGqKCrvadiiKla",276,0.99639,26,277,1,276,1,1,0,1,1,124,123,153,153,63
"5805",4,"[26]HHoIoHcoxHnJHGqKCrvadiiKla",281,0.996454,26,282,1,281,1,1,0,1,1,135,134,147,147,63
"5806",5,"[26]HHoIoHcoxHnJHGqKCrvadiiKla",277,0.996403,26,278,1,277,1,1,0,1,1,138,137,140,140,63
"5807",6,"[26]HHoIoHcoxHnJHGqKCrvadiiKla",282,0.996466,26,283,1,282,1,1,0,1,1,151,150,132,132,63
"5808",7,"[26]HHoIoHcoxHnJHGqKCrvadiiKla",275,0.996377,26,276,1,275,1,1,0,1,1,140,139,136,136,63
"5809",8,"[26]HHoIoHcoxHnJHGqKCrvadiiKla",281,0.996454,26,282,1,281,1,1,0,1,1,128,127,154,154,63
"5810",9,"[26]HHoIoHcoxHnJHGqKCrvadiiKla",280,0.996441,26,281,1,280,1,1,0,1,1,134,133,147,147,63
"5811",10,"[26]HHoIoHcoxHnJHGqKCrvadiiKla",276,0.99639,26,277,1,276,1,1,0,1,1,126,125,151,151,63
"5812",11,"[26]HHoIoHcoxHnJHGqKCrvadiiKla",276,0.99639,26,277,1,276,1,1,0,1,1,121,120,156,156,63
"5813",12,"[26]HHoIoHcoxHnJHGqKCrvadiiKla",288,0.99654,26,289,1,288,1,1,0,1,1,140,139,149,149,63
"5814",13,"[26]HHoIoHcoxHnJHGqKCrvadiiKla",287,0.996528,26,288,1,287,1,1,0,1,1,147,146,141,141,63
"5815",14,"[26]HHoIoHcoxHnJHGqKCrvadiiKla",279,0.996429,26,280,1,279,1,1,0,1,1,144,143,136,136,63
"5816",15,"[26]HHoIoHcoxHnJHGqKCrvadiiKla",288,0.99654,26,289,1,288,1,1,0,1,1,137,136,152,152,63
"5817",16,"[26]HHoIoHcoxHnJHGqKCrvadiiKla",278,0.996416,26,279,1,278,1,1,0,1,1,140,139,139,139,63
"5818",17,"[26]HHoIoHcoxHnJHGqKCrvadiiKla",282,0.996466,26,283,1,282,1,1,0,1,1,140,139,143,143,63
"5819",18,"[26]HHoIoHcoxHnJHGqKCrvadiiKla",272,0.996337,26,273,1,272,1,1,0,1,1,133,132,140,140,63
"5820",19,"[26]HHoIoHcoxHnJHGqKCrvadiiKla",276,0.99639,26,277,1,276,1,1,0,1,1,126,125,151,151,63
"5821",20,"[26]HHoIoHcoxHnJHGqKCrvadiiKla",288,0.99654,26,289,1,288,1,1,0,1,1,148,147,141,141,63
"5822",21,"[26]HHoIoHcoxHnJHGqKCrvadiiKla",281,0.996454,26,282,1,281,1,1,0,1,1,140,139,142,142,63
"5823",22,"[26]HHoIoHcoxHnJHGqKCrvadiiKla",282,0.996466,26,283,1,282,1,1,0,1,1,141,140,142,142,63
"5824",23,"[26]HHoIoHcoxHnJHGqKCrvadiiKla",287,0.996528,26,288,1,287,1,1,0,1,1,151,150,137,137,63
"5825",24,"[26]HHoIoHcoxHnJHGqKCrvadiiKla",275,0.996377,26,276,1,275,1,1,0,1,1,126,125,150,150,63
"5826",25,"[26]HHoIoHcoxHnJHGqKCrvadiiKla",286,0.996516,26,287,1,286,1,1,0,1,1,142,141,145,145,63
"5827",26,"[26]HHoIoHcoxHnJHGqKCrvadiiKla",284,0.996491,26,285,1,284,1,1,0,1,1,140,139,145,145,63
"5828",27,"[26]HHoIoHcoxHnJHGqKCrvadiiKla",276,0.99639,26,277,1,276,1,1,0,1,1,133,132,144,144,63
"5829",28,"[26]HHoIoHcoxHnJHGqKCrvadiiKla",284,0.996491,26,285,1,284,1,1,0,1,1,148,147,137,137,63
"5830",29,"[26]HHoIoHcoxHnJHGqKCrvadiiKla",285,0.996503,26,286,1,285,1,1,0,1,1,144,143,142,142,63
"5831",30,"[26]HHoIoHcoxHnJHGqKCrvadiiKla",274,0.996364,26,275,1,274,1,1,0,1,1,124,123,151,151,63
"5832",31,"[26]HHoIoHcoxHnJHGqKCrvadiiKla",282,0.996466,26,283,1,282,1,1,0,1,1,143,142,140,140,63
"5833",32,"[26]HHoIoHcoxHnJHGqKCrvadiiKla",281,0.996454,26,282,1,281,1,1,0,1,1,143,142,139,139,63
"5834",33,"[26]HHoIoHcoxHnJHGqKCrvadiiKla",288,0.99654,26,289,1,288,1,1,0,1,1,141,140,148,148,63
"5835",34,"[26]HHoIoHcoxHnJHGqKCrvadiiKla",284,0.996491,26,285,1,284,1,1,0,1,1,139,138,146,146,63
"5836",35,"[26]HHoIoHcoxHnJHGqKCrvadiiKla",281,0.996454,26,282,1,281,1,1,0,1,1,142,141,140,140,63
"5837",36,"[26]HHoIoHcoxHnJHGqKCrvadiiKla",281,0.996454,26,282,1,281,1,1,0,1,1,152,151,130,130,63
"5838",37,"[26]HHoIoHcoxHnJHGqKCrvadiiKla",278,0.996416,26,279,1,278,1,1,0,1,1,135,134,144,144,63
"5839",38,"[26]HHoIoHcoxHnJHGqKCrvadiiKla",277,0.996403,26,278,1,277,1,1,0,1,1,136,135,142,142,63
"5840",39,"[26]HHoIoHcoxHnJHGqKCrvadiiKla",277,0.996403,26,278,1,277,1,1,0,1,1,142,141,136,136,63
"5841",40,"[26]HHoIoHcoxHnJHGqKCrvadiiKla",281,0.996454,26,282,1,281,1,1,0,1,1,141,140,141,141,63
"5842",41,"[26]HHoIoHcoxHnJHGqKCrvadiiKla",283,0.996479,26,284,1,283,1,1,0,1,1,140,139,144,144,63
"5843",42,"[26]HHoIoHcoxHnJHGqKCrvadiiKla",278,0.996416,26,279,1,278,1,1,0,1,1,139,138,140,140,63
"5844",43,"[26]HHoIoHcoxHnJHGqKCrvadiiKla",281,0.996454,26,282,1,281,1,1,0,1,1,142,141,140,140,63
"5845",44,"[26]HHoIoHcoxHnJHGqKCrvadiiKla",279,0.996429,26,280,1,279,1,1,0,1,1,131,130,149,149,63
"5846",45,"[26]HHoIoHcoxHnJHGqKCrvadiiKla",278,0.996416,26,279,1,278,1,1,0,1,1,138,137,141,141,63
"5847",46,"[26]HHoIoHcoxHnJHGqKCrvadiiKla",280,0.996441,26,281,1,280,1,1,0,1,1,134,133,147,147,63
"5848",47,"[26]HHoIoHcoxHnJHGqKCrvadiiKla",284,0.996491,26,285,1,284,1,1,0,1,1,156,155,129,129,63
"5849",48,"[26]HHoIoHcoxHnJHGqKCrvadiiKla",280,0.996441,26,281,1,280,1,1,0,1,1,144,143,137,137,63
"5850",49,"[26]HHoIoHcoxHnJHGqKCrvadiiKla",280,0.996441,26,281,1,280,1,1,0,1,1,159,158,122,122,63
"5851",50,"[26]HHoIoHcoxHnJHGqKCrvadiiKla",272,0.996337,26,273,1,272,1,1,0,1,1,148,147,125,125,63
"5852",51,"[26]HHoIoHcoxHnJHGqKCrvadiiKla",279,0.996429,26,280,1,279,1,1,0,1,1,135,134,145,145,63
"5853",52,"[26]HHoIoHcoxHnJHGqKCrvadiiKla",289,0.996552,26,290,1,289,1,1,0,1,1,149,148,141,141,63
"5854",53,"[26]HHoIoHcoxHnJHGqKCrvadiiKla",284,0.996491,26,285,1,284,1,1,0,1,1,142,141,143,143,63
"5855",54,"[26]HHoIoHcoxHnJHGqKCrvadiiKla",281,0.996454,26,282,1,281,1,1,0,1,1,154,153,128,128,63
"5856",55,"[26]HHoIoHcoxHnJHGqKCrvadiiKla",279,0.996429,26,280,1,279,1,1,0,1,1,128,127,152,152,63
"5857",56,"[26]HHoIoHcoxHnJHGqKCrvadiiKla",288,0.99654,26,289,1,288,1,1,0,1,1,160,159,129,129,63
"5858",57,"[26]HHoIoHcoxHnJHGqKCrvadiiKla",279,0.996429,26,280,1,279,1,1,0,1,1,135,134,145,145,63
"5859",58,"[26]HHoIoHcoxHnJHGqKCrvadiiKla",285,0.996503,26,286,1,285,1,1,0,1,1,153,152,133,133,63
"5860",59,"[26]HHoIoHcoxHnJHGqKCrvadiiKla",284,0.996491,26,285,1,284,1,1,0,1,1,145,144,140,140,63
"5861",60,"[26]HHoIoHcoxHnJHGqKCrvadiiKla",281,0.996454,26,282,1,281,1,1,0,1,1,144,143,138,138,63
"5862",61,"[26]HHoIoHcoxHnJHGqKCrvadiiKla",274,0.996364,26,275,1,274,1,1,0,1,1,126,125,149,149,63
"5863",62,"[26]HHoIoHcoxHnJHGqKCrvadiiKla",277,0.996403,26,278,1,277,1,1,0,1,1,144,143,134,134,63
"5864",63,"[26]HHoIoHcoxHnJHGqKCrvadiiKla",285,0.996503,26,286,1,285,1,1,0,1,1,154,153,132,132,63
"5865",64,"[26]HHoIoHcoxHnJHGqKCrvadiiKla",296,0.996633,26,297,1,296,1,1,0,1,1,146,145,151,151,63
"5866",65,"[26]HHoIoHcoxHnJHGqKCrvadiiKla",278,0.996416,26,279,1,278,1,1,0,1,1,129,128,150,150,63
"5867",66,"[26]HHoIoHcoxHnJHGqKCrvadiiKla",284,0.996491,26,285,1,284,1,1,0,1,1,153,152,132,132,63
"5868",67,"[26]HHoIoHcoxHnJHGqKCrvadiiKla",285,0.996503,26,286,1,285,1,1,0,1,1,156,155,130,130,63
"5869",68,"[26]HHoIoHcoxHnJHGqKCrvadiiKla",277,0.996403,26,278,1,277,1,1,0,1,1,147,146,131,131,63
"5870",69,"[26]HHoIoHcoxHnJHGqKCrvadiiKla",288,0.99654,26,289,1,288,1,1,0,1,1,147,146,142,142,63
"5871",70,"[26]HHoIoHcoxHnJHGqKCrvadiiKla",269,0.996296,26,270,1,269,1,1,0,1,1,121,120,149,149,63
"5872",71,"[26]HHoIoHcoxHnJHGqKCrvadiiKla",279,0.996429,26,280,1,279,1,1,0,1,1,146,145,134,134,63
"5873",72,"[26]HHoIoHcoxHnJHGqKCrvadiiKla",281,0.996454,26,282,1,281,1,1,0,1,1,143,142,139,139,63
"5874",73,"[26]HHoIoHcoxHnJHGqKCrvadiiKla",285,0.996503,26,286,1,285,1,1,0,1,1,139,138,147,147,63
"5875",74,"[26]HHoIoHcoxHnJHGqKCrvadiiKla",284,0.996491,26,285,1,284,1,1,0,1,1,145,144,140,140,63
"5876",75,"[26]HHoIoHcoxHnJHGqKCrvadiiKla",283,0.996479,26,284,1,283,1,1,0,1,1,143,142,141,141,63
"5877",76,"[26]HHoIoHcoxHnJHGqKCrvadiiKla",278,0.996416,26,279,1,278,1,1,0,1,1,131,130,148,148,63
"5878",77,"[26]HHoIoHcoxHnJHGqKCrvadiiKla",284,0.996491,26,285,1,284,1,1,0,1,1,142,141,143,143,63
"5879",78,"[26]HHoIoHcoxHnJHGqKCrvadiiKla",282,0.996466,26,283,1,282,1,1,0,1,1,155,154,128,128,63
"5880",79,"[26]HHoIoHcoxHnJHGqKCrvadiiKla",274,0.996364,26,275,1,274,1,1,0,1,1,132,131,143,143,63
"5881",80,"[26]HHoIoHcoxHnJHGqKCrvadiiKla",277,0.996403,26,278,1,277,1,1,0,1,1,143,142,135,135,63
"5882",81,"[26]HHoIoHcoxHnJHGqKCrvadiiKla",276,0.99639,26,277,1,276,1,1,0,1,1,126,125,151,151,63
"5883",82,"[26]HHoIoHcoxHnJHGqKCrvadiiKla",287,0.996528,26,288,1,287,1,1,0,1,1,134,133,154,154,63
"5884",83,"[26]HHoIoHcoxHnJHGqKCrvadiiKla",284,0.996491,26,285,1,284,1,1,0,1,1,150,149,135,135,63
"5885",84,"[26]HHoIoHcoxHnJHGqKCrvadiiKla",272,0.996337,26,273,1,272,1,1,0,1,1,128,127,145,145,63
"5886",85,"[26]HHoIoHcoxHnJHGqKCrvadiiKla",286,0.996516,26,287,1,286,1,1,0,1,1,139,138,148,148,63
"5887",86,"[26]HHoIoHcoxHnJHGqKCrvadiiKla",284,0.996491,26,285,1,284,1,1,0,1,1,156,155,129,129,63
"5888",87,"[26]HHoIoHcoxHnJHGqKCrvadiiKla",269,0.996296,26,270,1,269,1,1,0,1,1,126,125,144,144,63
"5889",88,"[26]HHoIoHcoxHnJHGqKCrvadiiKla",289,0.996552,26,290,1,289,1,1,0,1,1,147,146,143,143,63
"5890",89,"[26]HHoIoHcoxHnJHGqKCrvadiiKla",287,0.996528,26,288,1,287,1,1,0,1,1,150,149,138,138,63
"5891",90,"[26]HHoIoHcoxHnJHGqKCrvadiiKla",281,0.996454,26,282,1,281,1,1,0,1,1,133,132,149,149,63
"5892",91,"[26]HHoIoHcoxHnJHGqKCrvadiiKla",288,0.99654,26,289,1,288,1,1,0,1,1,146,145,143,143,63
"5893",92,"[26]HHoIoHcoxHnJHGqKCrvadiiKla",284,0.996491,26,285,1,284,1,1,0,1,1,153,152,132,132,63
"5894",93,"[26]HHoIoHcoxHnJHGqKCrvadiiKla",271,0.996324,26,272,1,271,1,1,0,1,1,146,145,126,126,63
"5895",94,"[26]HHoIoHcoxHnJHGqKCrvadiiKla",278,0.996416,26,279,1,278,1,1,0,1,1,131,130,148,148,63
"5896",95,"[26]HHoIoHcoxHnJHGqKCrvadiiKla",274,0.996364,26,275,1,274,1,1,0,1,1,144,143,131,131,63
"5897",96,"[26]HHoIoHcoxHnJHGqKCrvadiiKla",284,0.996491,26,285,1,284,1,1,0,1,1,147,146,138,138,63
"5898",97,"[26]HHoIoHcoxHnJHGqKCrvadiiKla",274,0.996364,26,275,1,274,1,1,0,1,1,135,134,140,140,63
"5899",98,"[26]HHoIoHcoxHnJHGqKCrvadiiKla",275,0.996377,26,276,1,275,1,1,0,1,1,141,140,135,135,63
"5900",99,"[26]HHoIoHcoxHnJHGqKCrvadiiKla",282,0.996466,26,283,1,282,1,1,0,1,1,144,143,139,139,63
"5901",0,"[27]BoIfyoHcovHnJHGqKCjqyHivErj",278,0.996416,27,279,1,278,1,1,0,1,1,137,136,142,142,64
"5902",1,"[27]BoIfyoHcovHnJHGqKCjqyHivErj",286,0.996516,27,287,1,286,1,1,0,1,1,146,145,141,141,64
"5903",2,"[27]BoIfyoHcovHnJHGqKCjqyHivErj",281,0.996454,27,282,1,281,1,1,0,1,1,153,152,129,129,64
"5904",3,"[27]BoIfyoHcovHnJHGqKCjqyHivErj",283,0.996479,27,284,1,283,1,1,0,1,1,151,150,133,133,64
"5905",4,"[27]BoIfyoHcovHnJHGqKCjqyHivErj",284,0.996491,27,285,1,284,1,1,0,1,1,129,128,156,156,64
"5906",5,"[27]BoIfyoHcovHnJHGqKCjqyHivErj",282,0.996466,27,283,1,282,1,1,0,1,1,146,145,137,137,64
"5907",6,"[27]BoIfyoHcovHnJHGqKCjqyHivErj",283,0.996479,27,284,1,283,1,1,0,1,1,143,142,141,141,64
"5908",7,"[27]BoIfyoHcovHnJHGqKCjqyHivErj",287,0.996528,27,288,1,287,1,1,0,1,1,140,139,148,148,64
"5909",8,"[27]BoIfyoHcovHnJHGqKCjqyHivErj",287,0.996528,27,288,1,287,1,1,0,1,1,139,138,149,149,64
"5910",9,"[27]BoIfyoHcovHnJHGqKCjqyHivErj",281,0.996454,27,282,1,281,1,1,0,1,1,142,141,140,140,64
"5911",10,"[27]BoIfyoHcovHnJHGqKCjqyHivErj",274,0.996364,27,275,1,274,1,1,0,1,1,138,137,137,137,64
"5912",11,"[27]BoIfyoHcovHnJHGqKCjqyHivErj",282,0.996466,27,283,1,282,1,1,0,1,1,156,155,127,127,64
"5913",12,"[27]BoIfyoHcovHnJHGqKCjqyHivErj",282,0.996466,27,283,1,282,1,1,0,1,1,146,145,137,137,64
"5914",13,"[27]BoIfyoHcovHnJHGqKCjqyHivErj",281,0.996454,27,282,1,281,1,1,0,1,1,151,150,131,131,64
"5915",14,"[27]BoIfyoHcovHnJHGqKCjqyHivErj",277,0.996403,27,278,1,277,1,1,0,1,1,139,138,139,139,64
"5916",15,"[27]BoIfyoHcovHnJHGqKCjqyHivErj",274,0.996364,27,275,1,274,1,1,0,1,1,117,116,158,158,64
"5917",16,"[27]BoIfyoHcovHnJHGqKCjqyHivErj",284,0.996491,27,285,1,284,1,1,0,1,1,135,134,150,150,64
"5918",17,"[27]BoIfyoHcovHnJHGqKCjqyHivErj",276,0.99639,27,277,1,276,1,1,0,1,1,134,133,143,143,64
"5919",18,"[27]BoIfyoHcovHnJHGqKCjqyHivErj",274,0.996364,27,275,1,274,1,1,0,1,1,128,127,147,147,64
"5920",19,"[27]BoIfyoHcovHnJHGqKCjqyHivErj",283,0.996479,27,284,1,283,1,1,0,1,1,160,159,124,124,64
"5921",20,"[27]BoIfyoHcovHnJHGqKCjqyHivErj",278,0.996416,27,279,1,278,1,1,0,1,1,138,137,141,141,64
"5922",21,"[27]BoIfyoHcovHnJHGqKCjqyHivErj",280,0.996441,27,281,1,280,1,1,0,1,1,149,148,132,132,64
"5923",22,"[27]BoIfyoHcovHnJHGqKCjqyHivErj",279,0.996429,27,280,1,279,1,1,0,1,1,148,147,132,132,64
"5924",23,"[27]BoIfyoHcovHnJHGqKCjqyHivErj",281,0.996454,27,282,1,281,1,1,0,1,1,134,133,148,148,64
"5925",24,"[27]BoIfyoHcovHnJHGqKCjqyHivErj",287,0.996528,27,288,1,287,1,1,0,1,1,145,144,143,143,64
"5926",25,"[27]BoIfyoHcovHnJHGqKCjqyHivErj",274,0.996364,27,275,1,274,1,1,0,1,1,144,143,131,131,64
"5927",26,"[27]BoIfyoHcovHnJHGqKCjqyHivErj",279,0.996429,27,280,1,279,1,1,0,1,1,131,130,149,149,64
"5928",27,"[27]BoIfyoHcovHnJHGqKCjqyHivErj",282,0.996466,27,283,1,282,1,1,0,1,1,133,132,150,150,64
"5929",28,"[27]BoIfyoHcovHnJHGqKCjqyHivErj",286,0.996516,27,287,1,286,1,1,0,1,1,142,141,145,145,64
"5930",29,"[27]BoIfyoHcovHnJHGqKCjqyHivErj",275,0.996377,27,276,1,275,1,1,0,1,1,122,121,154,154,64
"5931",30,"[27]BoIfyoHcovHnJHGqKCjqyHivErj",273,0.99635,27,274,1,273,1,1,0,1,1,129,128,145,145,64
"5932",31,"[27]BoIfyoHcovHnJHGqKCjqyHivErj",277,0.996403,27,278,1,277,1,1,0,1,1,137,136,141,141,64
"5933",32,"[27]BoIfyoHcovHnJHGqKCjqyHivErj",276,0.99639,27,277,1,276,1,1,0,1,1,130,129,147,147,64
"5934",33,"[27]BoIfyoHcovHnJHGqKCjqyHivErj",287,0.996528,27,288,1,287,1,1,0,1,1,140,139,148,148,64
"5935",34,"[27]BoIfyoHcovHnJHGqKCjqyHivErj",291,0.996575,27,292,1,291,1,1,0,1,1,164,163,128,128,64
"5936",35,"[27]BoIfyoHcovHnJHGqKCjqyHivErj",280,0.996441,27,281,1,280,1,1,0,1,1,135,134,146,146,64
"5937",36,"[27]BoIfyoHcovHnJHGqKCjqyHivErj",276,0.99639,27,277,1,276,1,1,0,1,1,154,153,123,123,64
"5938",37,"[27]BoIfyoHcovHnJHGqKCjqyHivErj",275,0.996377,27,276,1,275,1,1,0,1,1,140,139,136,136,64
"5939",38,"[27]BoIfyoHcovHnJHGqKCjqyHivErj",274,0.996364,27,275,1,274,1,1,0,1,1,134,133,141,141,64
"5940",39,"[27]BoIfyoHcovHnJHGqKCjqyHivErj",281,0.996454,27,282,1,281,1,1,0,1,1,131,130,151,151,64
"5941",40,"[27]BoIfyoHcovHnJHGqKCjqyHivErj",283,0.996479,27,284,1,283,1,1,0,1,1,131,130,153,153,64
"5942",41,"[27]BoIfyoHcovHnJHGqKCjqyHivErj",276,0.99639,27,277,1,276,1,1,0,1,1,131,130,146,146,64
"5943",42,"[27]BoIfyoHcovHnJHGqKCjqyHivErj",282,0.996466,27,283,1,282,1,1,0,1,1,147,146,136,136,64
"5944",43,"[27]BoIfyoHcovHnJHGqKCjqyHivErj",281,0.996454,27,282,1,281,1,1,0,1,1,138,137,144,144,64
"5945",44,"[27]BoIfyoHcovHnJHGqKCjqyHivErj",273,0.99635,27,274,1,273,1,1,0,1,1,126,125,148,148,64
"5946",45,"[27]BoIfyoHcovHnJHGqKCjqyHivErj",276,0.99639,27,277,1,276,1,1,0,1,1,116,115,161,161,64
"5947",46,"[27]BoIfyoHcovHnJHGqKCjqyHivErj",283,0.996479,27,284,1,283,1,1,0,1,1,139,138,145,145,64
"5948",47,"[27]BoIfyoHcovHnJHGqKCjqyHivErj",276,0.99639,27,277,1,276,1,1,0,1,1,126,125,151,151,64
"5949",48,"[27]BoIfyoHcovHnJHGqKCjqyHivErj",283,0.996479,27,284,1,283,1,1,0,1,1,140,139,144,144,64
"5950",49,"[27]BoIfyoHcovHnJHGqKCjqyHivErj",281,0.996454,27,282,1,281,1,1,0,1,1,152,151,130,130,64
"5951",50,"[27]BoIfyoHcovHnJHGqKCjqyHivErj",276,0.99639,27,277,1,276,1,1,0,1,1,138,137,139,139,64
"5952",51,"[27]BoIfyoHcovHnJHGqKCjqyHivErj",287,0.996528,27,288,1,287,1,1,0,1,1,131,130,157,157,64
"5953",52,"[27]BoIfyoHcovHnJHGqKCjqyHivErj",278,0.996416,27,279,1,278,1,1,0,1,1,135,134,144,144,64
"5954",53,"[27]BoIfyoHcovHnJHGqKCjqyHivErj",285,0.996503,27,286,1,285,1,1,0,1,1,144,143,142,142,64
"5955",54,"[27]BoIfyoHcovHnJHGqKCjqyHivErj",282,0.996466,27,283,1,282,1,1,0,1,1,139,138,144,144,64
"5956",55,"[27]BoIfyoHcovHnJHGqKCjqyHivErj",277,0.996403,27,278,1,277,1,1,0,1,1,131,130,147,147,64
"5957",56,"[27]BoIfyoHcovHnJHGqKCjqyHivErj",273,0.99635,27,274,1,273,1,1,0,1,1,126,125,148,148,64
"5958",57,"[27]BoIfyoHcovHnJHGqKCjqyHivErj",278,0.996416,27,279,1,278,1,1,0,1,1,145,144,134,134,64
"5959",58,"[27]BoIfyoHcovHnJHGqKCjqyHivErj",280,0.996441,27,281,1,280,1,1,0,1,1,132,131,149,149,64
"5960",59,"[27]BoIfyoHcovHnJHGqKCjqyHivErj",283,0.996479,27,284,1,283,1,1,0,1,1,146,145,138,138,64
"5961",60,"[27]BoIfyoHcovHnJHGqKCjqyHivErj",285,0.996503,27,286,1,285,1,1,0,1,1,147,146,139,139,64
"5962",61,"[27]BoIfyoHcovHnJHGqKCjqyHivErj",284,0.996491,27,285,1,284,1,1,0,1,1,152,151,133,133,64
"5963",62,"[27]BoIfyoHcovHnJHGqKCjqyHivErj",284,0.996491,27,285,1,284,1,1,0,1,1,149,148,136,136,64
"5964",63,"[27]BoIfyoHcovHnJHGqKCjqyHivErj",271,0.996324,27,272,1,271,1,1,0,1,1,125,124,147,147,64
"5965",64,"[27]BoIfyoHcovHnJHGqKCjqyHivErj",282,0.996466,27,283,1,282,1,1,0,1,1,142,141,141,141,64
"5966",65,"[27]BoIfyoHcovHnJHGqKCjqyHivErj",281,0.996454,27,282,1,281,1,1,0,1,1,143,142,139,139,64
"5967",66,"[27]BoIfyoHcovHnJHGqKCjqyHivErj",280,0.996441,27,281,1,280,1,1,0,1,1,147,146,134,134,64
"5968",67,"[27]BoIfyoHcovHnJHGqKCjqyHivErj",276,0.99639,27,277,1,276,1,1,0,1,1,142,141,135,135,64
"5969",68,"[27]BoIfyoHcovHnJHGqKCjqyHivErj",282,0.996466,27,283,1,282,1,1,0,1,1,155,154,128,128,64
"5970",69,"[27]BoIfyoHcovHnJHGqKCjqyHivErj",286,0.996516,27,287,1,286,1,1,0,1,1,143,142,144,144,64
"5971",70,"[27]BoIfyoHcovHnJHGqKCjqyHivErj",282,0.996466,27,283,1,282,1,1,0,1,1,144,143,139,139,64
"5972",71,"[27]BoIfyoHcovHnJHGqKCjqyHivErj",279,0.996429,27,280,1,279,1,1,0,1,1,150,149,130,130,64
"5973",72,"[27]BoIfyoHcovHnJHGqKCjqyHivErj",287,0.996528,27,288,1,287,1,1,0,1,1,139,138,149,149,64
"5974",73,"[27]BoIfyoHcovHnJHGqKCjqyHivErj",282,0.996466,27,283,1,282,1,1,0,1,1,151,150,132,132,64
"5975",74,"[27]BoIfyoHcovHnJHGqKCjqyHivErj",275,0.996377,27,276,1,275,1,1,0,1,1,141,140,135,135,64
"5976",75,"[27]BoIfyoHcovHnJHGqKCjqyHivErj",280,0.996441,27,281,1,280,1,1,0,1,1,159,158,122,122,64
"5977",76,"[27]BoIfyoHcovHnJHGqKCjqyHivErj",282,0.996466,27,283,1,282,1,1,0,1,1,153,152,130,130,64
"5978",77,"[27]BoIfyoHcovHnJHGqKCjqyHivErj",283,0.996479,27,284,1,283,1,1,0,1,1,148,147,136,136,64
"5979",78,"[27]BoIfyoHcovHnJHGqKCjqyHivErj",280,0.996441,27,281,1,280,1,1,0,1,1,124,123,157,157,64
"5980",79,"[27]BoIfyoHcovHnJHGqKCjqyHivErj",283,0.996479,27,284,1,283,1,1,0,1,1,136,135,148,148,64
"5981",80,"[27]BoIfyoHcovHnJHGqKCjqyHivErj",283,0.996479,27,284,1,283,1,1,0,1,1,132,131,152,152,64
"5982",81,"[27]BoIfyoHcovHnJHGqKCjqyHivErj",281,0.996454,27,282,1,281,1,1,0,1,1,141,140,141,141,64
"5983",82,"[27]BoIfyoHcovHnJHGqKCjqyHivErj",284,0.996491,27,285,1,284,1,1,0,1,1,138,137,147,147,64
"5984",83,"[27]BoIfyoHcovHnJHGqKCjqyHivErj",283,0.996479,27,284,1,283,1,1,0,1,1,145,144,139,139,64
"5985",84,"[27]BoIfyoHcovHnJHGqKCjqyHivErj",286,0.996516,27,287,1,286,1,1,0,1,1,146,145,141,141,64
"5986",85,"[27]BoIfyoHcovHnJHGqKCjqyHivErj",278,0.996416,27,279,1,278,1,1,0,1,1,142,141,137,137,64
"5987",86,"[27]BoIfyoHcovHnJHGqKCjqyHivErj",282,0.996466,27,283,1,282,1,1,0,1,1,136,135,147,147,64
"5988",87,"[27]BoIfyoHcovHnJHGqKCjqyHivErj",276,0.99639,27,277,1,276,1,1,0,1,1,146,145,131,131,64
"5989",88,"[27]BoIfyoHcovHnJHGqKCjqyHivErj",274,0.996364,27,275,1,274,1,1,0,1,1,136,135,139,139,64
"5990",89,"[27]BoIfyoHcovHnJHGqKCjqyHivErj",279,0.996429,27,280,1,279,1,1,0,1,1,136,135,144,144,64
"5991",90,"[27]BoIfyoHcovHnJHGqKCjqyHivErj",285,0.996503,27,286,1,285,1,1,0,1,1,149,148,137,137,64
"5992",91,"[27]BoIfyoHcovHnJHGqKCjqyHivErj",283,0.996479,27,284,1,283,1,1,0,1,1,153,152,131,131,64
"5993",92,"[27]BoIfyoHcovHnJHGqKCjqyHivErj",282,0.996466,27,283,1,282,1,1,0,1,1,149,148,134,134,64
"5994",93,"[27]BoIfyoHcovHnJHGqKCjqyHivErj",289,0.996552,27,290,1,289,1,1,0,1,1,150,149,140,140,64
"5995",94,"[27]BoIfyoHcovHnJHGqKCjqyHivErj",281,0.996454,27,282,1,281,1,1,0,1,1,133,132,149,149,64
"5996",95,"[27]BoIfyoHcovHnJHGqKCjqyHivErj",284,0.996491,27,285,1,284,1,1,0,1,1,144,143,141,141,64
"5997",96,"[27]BoIfyoHcovHnJHGqKCjqyHivErj",283,0.996479,27,284,1,283,1,1,0,1,1,135,134,149,149,64
"5998",97,"[27]BoIfyoHcovHnJHGqKCjqyHivErj",287,0.996528,27,288,1,287,1,1,0,1,1,140,139,148,148,64
"5999",98,"[27]BoIfyoHcovHnJHGqKCjqyHivErj",277,0.996403,27,278,1,277,1,1,0,1,1,158,157,120,120,64
"6000",99,"[27]BoIfyoHcovHnJHGqKCjqyHivErj",271,0.996324,27,272,1,271,1,1,0,1,1,127,126,145,145,64
"6001",0,"[28]kHoImoHcowHnJqGKCEDDtncDyGou",294,0.99661,28,295,1,294,1,1,0,1,1,143,142,152,152,65
"6002",1,"[28]kHoImoHcowHnJqGKCEDDtncDyGou",295,0.996622,28,296,1,295,1,1,0,1,1,147,146,149,149,65
"6003",2,"[28]kHoImoHcowHnJqGKCEDDtncDyGou",297,0.996644,28,298,1,297,1,1,0,1,1,151,150,147,147,65
"6004",3,"[28]kHoImoHcowHnJqGKCEDDtncDyGou",295,0.996622,28,296,1,295,1,1,0,1,1,146,145,150,150,65
"6005",4,"[28]kHoImoHcowHnJqGKCEDDtncDyGou",292,0.996587,28,293,1,292,1,1,0,1,1,139,138,154,154,65
"6006",5,"[28]kHoImoHcowHnJqGKCEDDtncDyGou",295,0.996622,28,296,1,295,1,1,0,1,1,144,143,152,152,65
"6007",6,"[28]kHoImoHcowHnJqGKCEDDtncDyGou",299,0.996667,28,300,1,299,1,1,0,1,1,153,152,147,147,65
"6008",7,"[28]kHoImoHcowHnJqGKCEDDtncDyGou",300,0.996678,28,301,1,300,1,1,0,1,1,160,159,141,141,65
"6009",8,"[28]kHoImoHcowHnJqGKCEDDtncDyGou",297,0.996644,28,298,1,297,1,1,0,1,1,153,152,145,145,65
"6010",9,"[28]kHoImoHcowHnJqGKCEDDtncDyGou",297,0.996644,28,298,1,297,1,1,0,1,1,154,153,144,144,65
"6011",10,"[28]kHoImoHcowHnJqGKCEDDtncDyGou",303,0.996711,28,304,1,303,1,1,0,1,1,166,165,138,138,65
"6012",11,"[28]kHoImoHcowHnJqGKCEDDtncDyGou",293,0.996599,28,294,1,293,1,1,0,1,1,139,138,155,155,65
"6013",12,"[28]kHoImoHcowHnJqGKCEDDtncDyGou",296,0.996633,28,297,1,296,1,1,0,1,1,150,149,147,147,65
"6014",13,"[28]kHoImoHcowHnJqGKCEDDtncDyGou",297,0.996644,28,298,1,297,1,1,0,1,1,145,144,153,153,65
"6015",14,"[28]kHoImoHcowHnJqGKCEDDtncDyGou",299,0.996667,28,300,1,299,1,1,0,1,1,157,156,143,143,65
"6016",15,"[28]kHoImoHcowHnJqGKCEDDtncDyGou",292,0.996587,28,293,1,292,1,1,0,1,1,137,136,156,156,65
"6017",16,"[28]kHoImoHcowHnJqGKCEDDtncDyGou",297,0.996644,28,298,1,297,1,1,0,1,1,153,152,145,145,65
"6018",17,"[28]kHoImoHcowHnJqGKCEDDtncDyGou",297,0.996644,28,298,1,297,1,1,0,1,1,149,148,149,149,65
"6019",18,"[28]kHoImoHcowHnJqGKCEDDtncDyGou",288,0.99654,28,289,1,288,1,1,0,1,1,128,127,161,161,65
"6020",19,"[28]kHoImoHcowHnJqGKCEDDtncDyGou",303,0.996711,28,304,1,303,1,1,0,1,1,169,168,135,135,65
"6021",20,"[28]kHoImoHcowHnJqGKCEDDtncDyGou",294,0.99661,28,295,1,294,1,1,0,1,1,149,148,146,146,65
"6022",21,"[28]kHoImoHcowHnJqGKCEDDtncDyGou",294,0.99661,28,295,1,294,1,1,0,1,1,134,133,161,161,65
"6023",22,"[28]kHoImoHcowHnJqGKCEDDtncDyGou",294,0.99661,28,295,1,294,1,1,0,1,1,143,142,152,152,65
"6024",23,"[28]kHoImoHcowHnJqGKCEDDtncDyGou",285,0.996503,28,286,1,285,1,1,0,1,1,134,133,152,152,65
"6025",24,"[28]kHoImoHcowHnJqGKCEDDtncDyGou",291,0.996575,28,292,1,291,1,1,0,1,1,135,134,157,157,65
"6026",25,"[28]kHoImoHcowHnJqGKCEDDtncDyGou",293,0.996599,28,294,1,293,1,1,0,1,1,149,148,145,145,65
"6027",26,"[28]kHoImoHcowHnJqGKCEDDtncDyGou",300,0.996678,28,301,1,300,1,1,0,1,1,164,163,137,137,65
"6028",27,"[28]kHoImoHcowHnJqGKCEDDtncDyGou",287,0.996528,28,288,1,287,1,1,0,1,1,135,134,153,153,65
"6029",28,"[28]kHoImoHcowHnJqGKCEDDtncDyGou",295,0.996622,28,296,1,295,1,1,0,1,1,146,145,150,150,65
"6030",29,"[28]kHoImoHcowHnJqGKCEDDtncDyGou",289,0.996552,28,290,1,289,1,1,0,1,1,138,137,152,152,65
"6031",30,"[28]kHoImoHcowHnJqGKCEDDtncDyGou",297,0.996644,28,298,1,297,1,1,0,1,1,155,154,143,143,65
"6032",31,"[28]kHoImoHcowHnJqGKCEDDtncDyGou",297,0.996644,28,298,1,297,1,1,0,1,1,152,151,146,146,65
"6033",32,"[28]kHoImoHcowHnJqGKCEDDtncDyGou",295,0.996622,28,296,1,295,1,1,0,1,1,142,141,154,154,65
"6034",33,"[28]kHoImoHcowHnJqGKCEDDtncDyGou",301,0.996689,28,302,1,301,1,1,0,1,1,168,167,134,134,65
"6035",34,"[28]kHoImoHcowHnJqGKCEDDtncDyGou",293,0.996599,28,294,1,293,1,1,0,1,1,142,141,152,152,65
"6036",35,"[28]kHoImoHcowHnJqGKCEDDtncDyGou",299,0.996667,28,300,1,299,1,1,0,1,1,161,160,139,139,65
"6037",36,"[28]kHoImoHcowHnJqGKCEDDtncDyGou",300,0.996678,28,301,1,300,1,1,0,1,1,149,148,152,152,65
"6038",37,"[28]kHoImoHcowHnJqGKCEDDtncDyGou",299,0.996667,28,300,1,299,1,1,0,1,1,158,157,142,142,65
"6039",38,"[28]kHoImoHcowHnJqGKCEDDtncDyGou",298,0.996656,28,299,1,298,1,1,0,1,1,146,145,153,153,65
"6040",39,"[28]kHoImoHcowHnJqGKCEDDtncDyGou",299,0.996667,28,300,1,299,1,1,0,1,1,157,156,143,143,65
"6041",40,"[28]kHoImoHcowHnJqGKCEDDtncDyGou",299,0.996667,28,300,1,299,1,1,0,1,1,157,156,143,143,65
"6042",41,"[28]kHoImoHcowHnJqGKCEDDtncDyGou",296,0.996633,28,297,1,296,1,1,0,1,1,153,152,144,144,65
"6043",42,"[28]kHoImoHcowHnJqGKCEDDtncDyGou",301,0.996689,28,302,1,301,1,1,0,1,1,166,165,136,136,65
"6044",43,"[28]kHoImoHcowHnJqGKCEDDtncDyGou",295,0.996622,28,296,1,295,1,1,0,1,1,152,151,144,144,65
"6045",44,"[28]kHoImoHcowHnJqGKCEDDtncDyGou",300,0.996678,28,301,1,300,1,1,0,1,1,156,155,145,145,65
"6046",45,"[28]kHoImoHcowHnJqGKCEDDtncDyGou",301,0.996689,28,302,1,301,1,1,0,1,1,163,162,139,139,65
"6047",46,"[28]kHoImoHcowHnJqGKCEDDtncDyGou",298,0.996656,28,299,1,298,1,1,0,1,1,161,160,138,138,65
"6048",47,"[28]kHoImoHcowHnJqGKCEDDtncDyGou",294,0.99661,28,295,1,294,1,1,0,1,1,139,138,156,156,65
"6049",48,"[28]kHoImoHcowHnJqGKCEDDtncDyGou",297,0.996644,28,298,1,297,1,1,0,1,1,153,152,145,145,65
"6050",49,"[28]kHoImoHcowHnJqGKCEDDtncDyGou",291,0.996575,28,292,1,291,1,1,0,1,1,147,146,145,145,65
"6051",50,"[28]kHoImoHcowHnJqGKCEDDtncDyGou",298,0.996656,28,299,1,298,1,1,0,1,1,154,153,145,145,65
"6052",51,"[28]kHoImoHcowHnJqGKCEDDtncDyGou",295,0.996622,28,296,1,295,1,1,0,1,1,143,142,153,153,65
"6053",52,"[28]kHoImoHcowHnJqGKCEDDtncDyGou",301,0.996689,28,302,1,301,1,1,0,1,1,160,159,142,142,65
"6054",53,"[28]kHoImoHcowHnJqGKCEDDtncDyGou",293,0.996599,28,294,1,293,1,1,0,1,1,142,141,152,152,65
"6055",54,"[28]kHoImoHcowHnJqGKCEDDtncDyGou",293,0.996599,28,294,1,293,1,1,0,1,1,145,144,149,149,65
"6056",55,"[28]kHoImoHcowHnJqGKCEDDtncDyGou",302,0.9967,28,303,1,302,1,1,0,1,1,162,161,141,141,65
"6057",56,"[28]kHoImoHcowHnJqGKCEDDtncDyGou",291,0.996575,28,292,1,291,1,1,0,1,1,134,133,158,158,65
"6058",57,"[28]kHoImoHcowHnJqGKCEDDtncDyGou",294,0.99661,28,295,1,294,1,1,0,1,1,142,141,153,153,65
"6059",58,"[28]kHoImoHcowHnJqGKCEDDtncDyGou",302,0.9967,28,303,1,302,1,1,0,1,1,163,162,140,140,65
"6060",59,"[28]kHoImoHcowHnJqGKCEDDtncDyGou",298,0.996656,28,299,1,298,1,1,0,1,1,157,156,142,142,65
"6061",60,"[28]kHoImoHcowHnJqGKCEDDtncDyGou",295,0.996622,28,296,1,295,1,1,0,1,1,138,137,158,158,65
"6062",61,"[28]kHoImoHcowHnJqGKCEDDtncDyGou",291,0.996575,28,292,1,291,1,1,0,1,1,135,134,157,157,65
"6063",62,"[28]kHoImoHcowHnJqGKCEDDtncDyGou",295,0.996622,28,296,1,295,1,1,0,1,1,144,143,152,152,65
"6064",63,"[28]kHoImoHcowHnJqGKCEDDtncDyGou",297,0.996644,28,298,1,297,1,1,0,1,1,152,151,146,146,65
"6065",64,"[28]kHoImoHcowHnJqGKCEDDtncDyGou",296,0.996633,28,297,1,296,1,1,0,1,1,150,149,147,147,65
"6066",65,"[28]kHoImoHcowHnJqGKCEDDtncDyGou",297,0.996644,28,298,1,297,1,1,0,1,1,150,149,148,148,65
"6067",66,"[28]kHoImoHcowHnJqGKCEDDtncDyGou",297,0.996644,28,298,1,297,1,1,0,1,1,149,148,149,149,65
"6068",67,"[28]kHoImoHcowHnJqGKCEDDtncDyGou",296,0.996633,28,297,1,296,1,1,0,1,1,148,147,149,149,65
"6069",68,"[28]kHoImoHcowHnJqGKCEDDtncDyGou",288,0.99654,28,289,1,288,1,1,0,1,1,141,140,148,148,65
"6070",69,"[28]kHoImoHcowHnJqGKCEDDtncDyGou",296,0.996633,28,297,1,296,1,1,0,1,1,148,147,149,149,65
"6071",70,"[28]kHoImoHcowHnJqGKCEDDtncDyGou",299,0.996667,28,300,1,299,1,1,0,1,1,162,161,138,138,65
"6072",71,"[28]kHoImoHcowHnJqGKCEDDtncDyGou",291,0.996575,28,292,1,291,1,1,0,1,1,131,130,161,161,65
"6073",72,"[28]kHoImoHcowHnJqGKCEDDtncDyGou",298,0.996656,28,299,1,298,1,1,0,1,1,155,154,144,144,65
"6074",73,"[28]kHoImoHcowHnJqGKCEDDtncDyGou",296,0.996633,28,297,1,296,1,1,0,1,1,150,149,147,147,65
"6075",74,"[28]kHoImoHcowHnJqGKCEDDtncDyGou",298,0.996656,28,299,1,298,1,1,0,1,1,146,145,153,153,65
"6076",75,"[28]kHoImoHcowHnJqGKCEDDtncDyGou",298,0.996656,28,299,1,298,1,1,0,1,1,156,155,143,143,65
"6077",76,"[28]kHoImoHcowHnJqGKCEDDtncDyGou",294,0.99661,28,295,1,294,1,1,0,1,1,147,146,148,148,65
"6078",77,"[28]kHoImoHcowHnJqGKCEDDtncDyGou",292,0.996587,28,293,1,292,1,1,0,1,1,145,144,148,148,65
"6079",78,"[28]kHoImoHcowHnJqGKCEDDtncDyGou",298,0.996656,28,299,1,298,1,1,0,1,1,159,158,140,140,65
"6080",79,"[28]kHoImoHcowHnJqGKCEDDtncDyGou",296,0.996633,28,297,1,296,1,1,0,1,1,149,148,148,148,65
"6081",80,"[28]kHoImoHcowHnJqGKCEDDtncDyGou",298,0.996656,28,299,1,298,1,1,0,1,1,161,160,138,138,65
"6082",81,"[28]kHoImoHcowHnJqGKCEDDtncDyGou",300,0.996678,28,301,1,300,1,1,0,1,1,160,159,141,141,65
"6083",82,"[28]kHoImoHcowHnJqGKCEDDtncDyGou",292,0.996587,28,293,1,292,1,1,0,1,1,136,135,157,157,65
"6084",83,"[28]kHoImoHcowHnJqGKCEDDtncDyGou",302,0.9967,28,303,1,302,1,1,0,1,1,160,159,143,143,65
"6085",84,"[28]kHoImoHcowHnJqGKCEDDtncDyGou",298,0.996656,28,299,1,298,1,1,0,1,1,153,152,146,146,65
"6086",85,"[28]kHoImoHcowHnJqGKCEDDtncDyGou",299,0.996667,28,300,1,299,1,1,0,1,1,161,160,139,139,65
"6087",86,"[28]kHoImoHcowHnJqGKCEDDtncDyGou",295,0.996622,28,296,1,295,1,1,0,1,1,148,147,148,148,65
"6088",87,"[28]kHoImoHcowHnJqGKCEDDtncDyGou",292,0.996587,28,293,1,292,1,1,0,1,1,138,137,155,155,65
"6089",88,"[28]kHoImoHcowHnJqGKCEDDtncDyGou",291,0.996575,28,292,1,291,1,1,0,1,1,131,130,161,161,65
"6090",89,"[28]kHoImoHcowHnJqGKCEDDtncDyGou",297,0.996644,28,298,1,297,1,1,0,1,1,153,152,145,145,65
"6091",90,"[28]kHoImoHcowHnJqGKCEDDtncDyGou",291,0.996575,28,292,1,291,1,1,0,1,1,135,134,157,157,65
"6092",91,"[28]kHoImoHcowHnJqGKCEDDtncDyGou",302,0.9967,28,303,1,302,1,1,0,1,1,157,156,146,146,65
"6093",92,"[28]kHoImoHcowHnJqGKCEDDtncDyGou",297,0.996644,28,298,1,297,1,1,0,1,1,148,147,150,150,65
"6094",93,"[28]kHoImoHcowHnJqGKCEDDtncDyGou",299,0.996667,28,300,1,299,1,1,0,1,1,154,153,146,146,65
"6095",94,"[28]kHoImoHcowHnJqGKCEDDtncDyGou",289,0.996552,28,290,1,289,1,1,0,1,1,129,128,161,161,65
"6096",95,"[28]kHoImoHcowHnJqGKCEDDtncDyGou",289,0.996552,28,290,1,289,1,1,0,1,1,130,129,160,160,65
"6097",96,"[28]kHoImoHcowHnJqGKCEDDtncDyGou",296,0.996633,28,297,1,296,1,1,0,1,1,152,151,145,145,65
"6098",97,"[28]kHoImoHcowHnJqGKCEDDtncDyGou",298,0.996656,28,299,1,298,1,1,0,1,1,157,156,142,142,65
"6099",98,"[28]kHoImoHcowHnJqGKCEDDtncDyGou",293,0.996599,28,294,1,293,1,1,0,1,1,143,142,151,151,65
"6100",99,"[28]kHoImoHcowHnJqGKCEDDtncDyGou",295,0.996622,28,296,1,295,1,1,0,1,1,147,146,149,149,65
"6101",0,"[30]vEoIoHcdowHnJHqGKCCDctdJwlumoH",291,0.996575,30,292,1,291,1,1,0,1,1,154,153,138,138,66
"6102",1,"[30]vEoIoHcdowHnJHqGKCCDctdJwlumoH",302,0.9967,30,303,1,302,1,1,0,1,1,156,155,147,147,66
"6103",2,"[30]vEoIoHcdowHnJHqGKCCDctdJwlumoH",295,0.996622,30,296,1,295,1,1,0,1,1,149,148,147,147,66
"6104",3,"[30]vEoIoHcdowHnJHqGKCCDctdJwlumoH",291,0.996575,30,292,1,291,1,1,0,1,1,146,145,146,146,66
"6105",4,"[30]vEoIoHcdowHnJHqGKCCDctdJwlumoH",301,0.996689,30,302,1,301,1,1,0,1,1,169,168,133,133,66
"6106",5,"[30]vEoIoHcdowHnJHqGKCCDctdJwlumoH",290,0.996564,30,291,1,290,1,1,0,1,1,135,134,156,156,66
"6107",6,"[30]vEoIoHcdowHnJHqGKCCDctdJwlumoH",296,0.996633,30,297,1,296,1,1,0,1,1,173,172,124,124,66
"6108",7,"[30]vEoIoHcdowHnJHqGKCCDctdJwlumoH",300,0.996678,30,301,1,300,1,1,0,1,1,152,151,149,149,66
"6109",8,"[30]vEoIoHcdowHnJHqGKCCDctdJwlumoH",293,0.996599,30,294,1,293,1,1,0,1,1,153,152,141,141,66
"6110",9,"[30]vEoIoHcdowHnJHqGKCCDctdJwlumoH",293,0.996599,30,294,1,293,1,1,0,1,1,140,139,154,154,66
"6111",10,"[30]vEoIoHcdowHnJHqGKCCDctdJwlumoH",298,0.996656,30,299,1,298,1,1,0,1,1,149,148,150,150,66
"6112",11,"[30]vEoIoHcdowHnJHqGKCCDctdJwlumoH",295,0.996622,30,296,1,295,1,1,0,1,1,146,145,150,150,66
"6113",12,"[30]vEoIoHcdowHnJHqGKCCDctdJwlumoH",299,0.996667,30,300,1,299,1,1,0,1,1,150,149,150,150,66
"6114",13,"[30]vEoIoHcdowHnJHqGKCCDctdJwlumoH",288,0.99654,30,289,1,288,1,1,0,1,1,127,126,162,162,66
"6115",14,"[30]vEoIoHcdowHnJHqGKCCDctdJwlumoH",294,0.99661,30,295,1,294,1,1,0,1,1,148,147,147,147,66
"6116",15,"[30]vEoIoHcdowHnJHqGKCCDctdJwlumoH",309,0.996774,30,310,1,309,1,1,0,1,1,181,180,129,129,66
"6117",16,"[30]vEoIoHcdowHnJHqGKCCDctdJwlumoH",296,0.996633,30,297,1,296,1,1,0,1,1,153,152,144,144,66
"6118",17,"[30]vEoIoHcdowHnJHqGKCCDctdJwlumoH",301,0.996689,30,302,1,301,1,1,0,1,1,150,149,152,152,66
"6119",18,"[30]vEoIoHcdowHnJHqGKCCDctdJwlumoH",291,0.996575,30,292,1,291,1,1,0,1,1,143,142,149,149,66
"6120",19,"[30]vEoIoHcdowHnJHqGKCCDctdJwlumoH",293,0.996599,30,294,1,293,1,1,0,1,1,134,133,160,160,66
"6121",20,"[30]vEoIoHcdowHnJHqGKCCDctdJwlumoH",289,0.996552,30,290,1,289,1,1,0,1,1,145,144,145,145,66
"6122",21,"[30]vEoIoHcdowHnJHqGKCCDctdJwlumoH",291,0.996575,30,292,1,291,1,1,0,1,1,135,134,157,157,66
"6123",22,"[30]vEoIoHcdowHnJHqGKCCDctdJwlumoH",294,0.99661,30,295,1,294,1,1,0,1,1,143,142,152,152,66
"6124",23,"[30]vEoIoHcdowHnJHqGKCCDctdJwlumoH",294,0.99661,30,295,1,294,1,1,0,1,1,138,137,157,157,66
"6125",24,"[30]vEoIoHcdowHnJHqGKCCDctdJwlumoH",292,0.996587,30,293,1,292,1,1,0,1,1,151,150,142,142,66
"6126",25,"[30]vEoIoHcdowHnJHqGKCCDctdJwlumoH",295,0.996622,30,296,1,295,1,1,0,1,1,153,152,143,143,66
"6127",26,"[30]vEoIoHcdowHnJHqGKCCDctdJwlumoH",286,0.996516,30,287,1,286,1,1,0,1,1,147,146,140,140,66
"6128",27,"[30]vEoIoHcdowHnJHqGKCCDctdJwlumoH",299,0.996667,30,300,1,299,1,1,0,1,1,153,152,147,147,66
"6129",28,"[30]vEoIoHcdowHnJHqGKCCDctdJwlumoH",296,0.996633,30,297,1,296,1,1,0,1,1,134,133,163,163,66
"6130",29,"[30]vEoIoHcdowHnJHqGKCCDctdJwlumoH",299,0.996667,30,300,1,299,1,1,0,1,1,140,139,160,160,66
"6131",30,"[30]vEoIoHcdowHnJHqGKCCDctdJwlumoH",297,0.996644,30,298,1,297,1,1,0,1,1,152,151,146,146,66
"6132",31,"[30]vEoIoHcdowHnJHqGKCCDctdJwlumoH",297,0.996644,30,298,1,297,1,1,0,1,1,151,150,147,147,66
"6133",32,"[30]vEoIoHcdowHnJHqGKCCDctdJwlumoH",295,0.996622,30,296,1,295,1,1,0,1,1,144,143,152,152,66
"6134",33,"[30]vEoIoHcdowHnJHqGKCCDctdJwlumoH",291,0.996575,30,292,1,291,1,1,0,1,1,137,136,155,155,66
"6135",34,"[30]vEoIoHcdowHnJHqGKCCDctdJwlumoH",295,0.996622,30,296,1,295,1,1,0,1,1,151,150,145,145,66
"6136",35,"[30]vEoIoHcdowHnJHqGKCCDctdJwlumoH",289,0.996552,30,290,1,289,1,1,0,1,1,146,145,144,144,66
"6137",36,"[30]vEoIoHcdowHnJHqGKCCDctdJwlumoH",294,0.99661,30,295,1,294,1,1,0,1,1,141,140,154,154,66
"6138",37,"[30]vEoIoHcdowHnJHqGKCCDctdJwlumoH",301,0.996689,30,302,1,301,1,1,0,1,1,157,156,145,145,66
"6139",38,"[30]vEoIoHcdowHnJHqGKCCDctdJwlumoH",289,0.996552,30,290,1,289,1,1,0,1,1,132,131,158,158,66
"6140",39,"[30]vEoIoHcdowHnJHqGKCCDctdJwlumoH",301,0.996689,30,302,1,301,1,1,0,1,1,167,166,135,135,66
"6141",40,"[30]vEoIoHcdowHnJHqGKCCDctdJwlumoH",302,0.9967,30,303,1,302,1,1,0,1,1,166,165,137,137,66
"6142",41,"[30]vEoIoHcdowHnJHqGKCCDctdJwlumoH",294,0.99661,30,295,1,294,1,1,0,1,1,144,143,151,151,66
"6143",42,"[30]vEoIoHcdowHnJHqGKCCDctdJwlumoH",290,0.996564,30,291,1,290,1,1,0,1,1,140,139,151,151,66
"6144",43,"[30]vEoIoHcdowHnJHqGKCCDctdJwlumoH",294,0.99661,30,295,1,294,1,1,0,1,1,146,145,149,149,66
"6145",44,"[30]vEoIoHcdowHnJHqGKCCDctdJwlumoH",291,0.996575,30,292,1,291,1,1,0,1,1,153,152,139,139,66
"6146",45,"[30]vEoIoHcdowHnJHqGKCCDctdJwlumoH",300,0.996678,30,301,1,300,1,1,0,1,1,156,155,145,145,66
"6147",46,"[30]vEoIoHcdowHnJHqGKCCDctdJwlumoH",303,0.996711,30,304,1,303,1,1,0,1,1,159,158,145,145,66
"6148",47,"[30]vEoIoHcdowHnJHqGKCCDctdJwlumoH",301,0.996689,30,302,1,301,1,1,0,1,1,163,162,139,139,66
"6149",48,"[30]vEoIoHcdowHnJHqGKCCDctdJwlumoH",290,0.996564,30,291,1,290,1,1,0,1,1,134,133,157,157,66
"6150",49,"[30]vEoIoHcdowHnJHqGKCCDctdJwlumoH",293,0.996599,30,294,1,293,1,1,0,1,1,149,148,145,145,66
"6151",50,"[30]vEoIoHcdowHnJHqGKCCDctdJwlumoH",292,0.996587,30,293,1,292,1,1,0,1,1,142,141,151,151,66
"6152",51,"[30]vEoIoHcdowHnJHqGKCCDctdJwlumoH",288,0.99654,30,289,1,288,1,1,0,1,1,129,128,160,160,66
"6153",52,"[30]vEoIoHcdowHnJHqGKCCDctdJwlumoH",303,0.996711,30,304,1,303,1,1,0,1,1,170,169,134,134,66
"6154",53,"[30]vEoIoHcdowHnJHqGKCCDctdJwlumoH",290,0.996564,30,291,1,290,1,1,0,1,1,150,149,141,141,66
"6155",54,"[30]vEoIoHcdowHnJHqGKCCDctdJwlumoH",295,0.996622,30,296,1,295,1,1,0,1,1,151,150,145,145,66
"6156",55,"[30]vEoIoHcdowHnJHqGKCCDctdJwlumoH",294,0.99661,30,295,1,294,1,1,0,1,1,151,150,144,144,66
"6157",56,"[30]vEoIoHcdowHnJHqGKCCDctdJwlumoH",304,0.996721,30,305,1,304,1,1,0,1,1,165,164,140,140,66
"6158",57,"[30]vEoIoHcdowHnJHqGKCCDctdJwlumoH",296,0.996633,30,297,1,296,1,1,0,1,1,162,161,135,135,66
"6159",58,"[30]vEoIoHcdowHnJHqGKCCDctdJwlumoH",292,0.996587,30,293,1,292,1,1,0,1,1,146,145,147,147,66
"6160",59,"[30]vEoIoHcdowHnJHqGKCCDctdJwlumoH",287,0.996528,30,288,1,287,1,1,0,1,1,134,133,154,154,66
"6161",60,"[30]vEoIoHcdowHnJHqGKCCDctdJwlumoH",295,0.996622,30,296,1,295,1,1,0,1,1,148,147,148,148,66
"6162",61,"[30]vEoIoHcdowHnJHqGKCCDctdJwlumoH",298,0.996656,30,299,1,298,1,1,0,1,1,163,162,136,136,66
"6163",62,"[30]vEoIoHcdowHnJHqGKCCDctdJwlumoH",300,0.996678,30,301,1,300,1,1,0,1,1,163,162,138,138,66
"6164",63,"[30]vEoIoHcdowHnJHqGKCCDctdJwlumoH",296,0.996633,30,297,1,296,1,1,0,1,1,156,155,141,141,66
"6165",64,"[30]vEoIoHcdowHnJHqGKCCDctdJwlumoH",298,0.996656,30,299,1,298,1,1,0,1,1,154,153,145,145,66
"6166",65,"[30]vEoIoHcdowHnJHqGKCCDctdJwlumoH",301,0.996689,30,302,1,301,1,1,0,1,1,157,156,145,145,66
"6167",66,"[30]vEoIoHcdowHnJHqGKCCDctdJwlumoH",296,0.996633,30,297,1,296,1,1,0,1,1,145,144,152,152,66
"6168",67,"[30]vEoIoHcdowHnJHqGKCCDctdJwlumoH",301,0.996689,30,302,1,301,1,1,0,1,1,153,152,149,149,66
"6169",68,"[30]vEoIoHcdowHnJHqGKCCDctdJwlumoH",301,0.996689,30,302,1,301,1,1,0,1,1,153,152,149,149,66
"6170",69,"[30]vEoIoHcdowHnJHqGKCCDctdJwlumoH",302,0.9967,30,303,1,302,1,1,0,1,1,166,165,137,137,66
"6171",70,"[30]vEoIoHcdowHnJHqGKCCDctdJwlumoH",304,0.996721,30,305,1,304,1,1,0,1,1,164,163,141,141,66
"6172",71,"[30]vEoIoHcdowHnJHqGKCCDctdJwlumoH",299,0.996667,30,300,1,299,1,1,0,1,1,138,137,162,162,66
"6173",72,"[30]vEoIoHcdowHnJHqGKCCDctdJwlumoH",301,0.996689,30,302,1,301,1,1,0,1,1,161,160,141,141,66
"6174",73,"[30]vEoIoHcdowHnJHqGKCCDctdJwlumoH",301,0.996689,30,302,1,301,1,1,0,1,1,163,162,139,139,66
"6175",74,"[30]vEoIoHcdowHnJHqGKCCDctdJwlumoH",292,0.996587,30,293,1,292,1,1,0,1,1,140,139,153,153,66
"6176",75,"[30]vEoIoHcdowHnJHqGKCCDctdJwlumoH",291,0.996575,30,292,1,291,1,1,0,1,1,151,150,141,141,66
"6177",76,"[30]vEoIoHcdowHnJHqGKCCDctdJwlumoH",300,0.996678,30,301,1,300,1,1,0,1,1,148,147,153,153,66
"6178",77,"[30]vEoIoHcdowHnJHqGKCCDctdJwlumoH",296,0.996633,30,297,1,296,1,1,0,1,1,147,146,150,150,66
"6179",78,"[30]vEoIoHcdowHnJHqGKCCDctdJwlumoH",295,0.996622,30,296,1,295,1,1,0,1,1,147,146,149,149,66
"6180",79,"[30]vEoIoHcdowHnJHqGKCCDctdJwlumoH",294,0.99661,30,295,1,294,1,1,0,1,1,153,152,142,142,66
"6181",80,"[30]vEoIoHcdowHnJHqGKCCDctdJwlumoH",281,0.996454,30,282,1,281,1,1,0,1,1,128,127,154,154,66
"6182",81,"[30]vEoIoHcdowHnJHqGKCCDctdJwlumoH",293,0.996599,30,294,1,293,1,1,0,1,1,152,151,142,142,66
"6183",82,"[30]vEoIoHcdowHnJHqGKCCDctdJwlumoH",282,0.996466,30,283,1,282,1,1,0,1,1,117,116,166,166,66
"6184",83,"[30]vEoIoHcdowHnJHqGKCCDctdJwlumoH",301,0.996689,30,302,1,301,1,1,0,1,1,159,158,143,143,66
"6185",84,"[30]vEoIoHcdowHnJHqGKCCDctdJwlumoH",285,0.996503,30,286,1,285,1,1,0,1,1,128,127,158,158,66
"6186",85,"[30]vEoIoHcdowHnJHqGKCCDctdJwlumoH",297,0.996644,30,298,1,297,1,1,0,1,1,151,150,147,147,66
"6187",86,"[30]vEoIoHcdowHnJHqGKCCDctdJwlumoH",286,0.996516,30,287,1,286,1,1,0,1,1,147,146,140,140,66
"6188",87,"[30]vEoIoHcdowHnJHqGKCCDctdJwlumoH",287,0.996528,30,288,1,287,1,1,0,1,1,143,142,145,145,66
"6189",88,"[30]vEoIoHcdowHnJHqGKCCDctdJwlumoH",296,0.996633,30,297,1,296,1,1,0,1,1,156,155,141,141,66
"6190",89,"[30]vEoIoHcdowHnJHqGKCCDctdJwlumoH",289,0.996552,30,290,1,289,1,1,0,1,1,132,131,158,158,66
"6191",90,"[30]vEoIoHcdowHnJHqGKCCDctdJwlumoH",296,0.996633,30,297,1,296,1,1,0,1,1,157,156,140,140,66
"6192",91,"[30]vEoIoHcdowHnJHqGKCCDctdJwlumoH",295,0.996622,30,296,1,295,1,1,0,1,1,149,148,147,147,66
"6193",92,"[30]vEoIoHcdowHnJHqGKCCDctdJwlumoH",289,0.996552,30,290,1,289,1,1,0,1,1,132,131,158,158,66
"6194",93,"[30]vEoIoHcdowHnJHqGKCCDctdJwlumoH",294,0.99661,30,295,1,294,1,1,0,1,1,135,134,160,160,66
"6195",94,"[30]vEoIoHcdowHnJHqGKCCDctdJwlumoH",290,0.996564,30,291,1,290,1,1,0,1,1,134,133,157,157,66
"6196",95,"[30]vEoIoHcdowHnJHqGKCCDctdJwlumoH",292,0.996587,30,293,1,292,1,1,0,1,1,138,137,155,155,66
"6197",96,"[30]vEoIoHcdowHnJHqGKCCDctdJwlumoH",290,0.996564,30,291,1,290,1,1,0,1,1,142,141,149,149,66
"6198",97,"[30]vEoIoHcdowHnJHqGKCCDctdJwlumoH",292,0.996587,30,293,1,292,1,1,0,1,1,144,143,149,149,66
"6199",98,"[30]vEoIoHcdowHnJHqGKCCDctdJwlumoH",299,0.996667,30,300,1,299,1,1,0,1,1,152,151,148,148,66
"6200",99,"[30]vEoIoHcdowHnJHqGKCCDctdJwlumoH",296,0.996633,30,297,1,296,1,1,0,1,1,146,145,151,151,66
"6201",0,"[23]uloIzoHcoxHnJHGqKHqKCBb",308,0.996764,23,309,1,308,1,1,0,1,1,150,149,159,159,67
"6202",1,"[23]uloIzoHcoxHnJHGqKHqKCBb",309,0.996774,23,310,1,309,1,1,0,1,1,157,156,153,153,67
"6203",2,"[23]uloIzoHcoxHnJHGqKHqKCBb",310,0.996785,23,311,1,310,1,1,0,1,1,158,157,153,153,67
"6204",3,"[23]uloIzoHcoxHnJHGqKHqKCBb",307,0.996753,23,308,1,307,1,1,0,1,1,158,157,150,150,67
"6205",4,"[23]uloIzoHcoxHnJHGqKHqKCBb",315,0.996835,23,316,1,315,1,1,0,1,1,152,151,164,164,67
"6206",5,"[23]uloIzoHcoxHnJHGqKHqKCBb",304,0.996721,23,305,1,304,1,1,0,1,1,146,145,159,159,67
"6207",6,"[23]uloIzoHcoxHnJHGqKHqKCBb",313,0.996815,23,314,1,313,1,1,0,1,1,156,155,158,158,67
"6208",7,"[23]uloIzoHcoxHnJHGqKHqKCBb",315,0.996835,23,316,1,315,1,1,0,1,1,146,145,170,170,67
"6209",8,"[23]uloIzoHcoxHnJHGqKHqKCBb",313,0.996815,23,314,1,313,1,1,0,1,1,154,153,160,160,67
"6210",9,"[23]uloIzoHcoxHnJHGqKHqKCBb",322,0.996904,23,323,1,322,1,1,0,1,1,145,144,178,178,67
"6211",10,"[23]uloIzoHcoxHnJHGqKHqKCBb",313,0.996815,23,314,1,313,1,1,0,1,1,155,154,159,159,67
"6212",11,"[23]uloIzoHcoxHnJHGqKHqKCBb",305,0.996732,23,306,1,305,1,1,0,1,1,167,166,139,139,67
"6213",12,"[23]uloIzoHcoxHnJHGqKHqKCBb",300,0.996678,23,301,1,300,1,1,0,1,1,171,170,130,130,67
"6214",13,"[23]uloIzoHcoxHnJHGqKHqKCBb",315,0.996835,23,316,1,315,1,1,0,1,1,144,143,172,172,67
"6215",14,"[23]uloIzoHcoxHnJHGqKHqKCBb",307,0.996753,23,308,1,307,1,1,0,1,1,158,157,150,150,67
"6216",15,"[23]uloIzoHcoxHnJHGqKHqKCBb",309,0.996774,23,310,1,309,1,1,0,1,1,164,163,146,146,67
"6217",16,"[23]uloIzoHcoxHnJHGqKHqKCBb",311,0.996795,23,312,1,311,1,1,0,1,1,143,142,169,169,67
"6218",17,"[23]uloIzoHcoxHnJHGqKHqKCBb",307,0.996753,23,308,1,307,1,1,0,1,1,153,152,155,155,67
"6219",18,"[23]uloIzoHcoxHnJHGqKHqKCBb",311,0.996795,23,312,1,311,1,1,0,1,1,155,154,157,157,67
"6220",19,"[23]uloIzoHcoxHnJHGqKHqKCBb",300,0.996678,23,301,1,300,1,1,0,1,1,160,159,141,141,67
"6221",20,"[23]uloIzoHcoxHnJHGqKHqKCBb",313,0.996815,23,314,1,313,1,1,0,1,1,160,159,154,154,67
"6222",21,"[23]uloIzoHcoxHnJHGqKHqKCBb",309,0.996774,23,310,1,309,1,1,0,1,1,154,153,156,156,67
"6223",22,"[23]uloIzoHcoxHnJHGqKHqKCBb",318,0.996865,23,319,1,318,1,1,0,1,1,167,166,152,152,67
"6224",23,"[23]uloIzoHcoxHnJHGqKHqKCBb",321,0.996894,23,322,1,321,1,1,0,1,1,154,153,168,168,67
"6225",24,"[23]uloIzoHcoxHnJHGqKHqKCBb",311,0.996795,23,312,1,311,1,1,0,1,1,153,152,159,159,67
"6226",25,"[23]uloIzoHcoxHnJHGqKHqKCBb",309,0.996774,23,310,1,309,1,1,0,1,1,159,158,151,151,67
"6227",26,"[23]uloIzoHcoxHnJHGqKHqKCBb",315,0.996835,23,316,1,315,1,1,0,1,1,157,156,159,159,67
"6228",27,"[23]uloIzoHcoxHnJHGqKHqKCBb",310,0.996785,23,311,1,310,1,1,0,1,1,152,151,159,159,67
"6229",28,"[23]uloIzoHcoxHnJHGqKHqKCBb",310,0.996785,23,311,1,310,1,1,0,1,1,164,163,147,147,67
"6230",29,"[23]uloIzoHcoxHnJHGqKHqKCBb",309,0.996774,23,310,1,309,1,1,0,1,1,152,151,158,158,67
"6231",30,"[23]uloIzoHcoxHnJHGqKHqKCBb",307,0.996753,23,308,1,307,1,1,0,1,1,155,154,153,153,67
"6232",31,"[23]uloIzoHcoxHnJHGqKHqKCBb",311,0.996795,23,312,1,311,1,1,0,1,1,155,154,157,157,67
"6233",32,"[23]uloIzoHcoxHnJHGqKHqKCBb",315,0.996835,23,316,1,315,1,1,0,1,1,154,153,162,162,67
"6234",33,"[23]uloIzoHcoxHnJHGqKHqKCBb",310,0.996785,23,311,1,310,1,1,0,1,1,155,154,156,156,67
"6235",34,"[23]uloIzoHcoxHnJHGqKHqKCBb",304,0.996721,23,305,1,304,1,1,0,1,1,173,172,132,132,67
"6236",35,"[23]uloIzoHcoxHnJHGqKHqKCBb",310,0.996785,23,311,1,310,1,1,0,1,1,148,147,163,163,67
"6237",36,"[23]uloIzoHcoxHnJHGqKHqKCBb",310,0.996785,23,311,1,310,1,1,0,1,1,153,152,158,158,67
"6238",37,"[23]uloIzoHcoxHnJHGqKHqKCBb",308,0.996764,23,309,1,308,1,1,0,1,1,156,155,153,153,67
"6239",38,"[23]uloIzoHcoxHnJHGqKHqKCBb",299,0.996667,23,300,1,299,1,1,0,1,1,163,162,137,137,67
"6240",39,"[23]uloIzoHcoxHnJHGqKHqKCBb",306,0.996743,23,307,1,306,1,1,0,1,1,161,160,146,146,67
"6241",40,"[23]uloIzoHcoxHnJHGqKHqKCBb",313,0.996815,23,314,1,313,1,1,0,1,1,158,157,156,156,67
"6242",41,"[23]uloIzoHcoxHnJHGqKHqKCBb",315,0.996835,23,316,1,315,1,1,0,1,1,140,139,176,176,67
"6243",42,"[23]uloIzoHcoxHnJHGqKHqKCBb",315,0.996835,23,316,1,315,1,1,0,1,1,155,154,161,161,67
"6244",43,"[23]uloIzoHcoxHnJHGqKHqKCBb",310,0.996785,23,311,1,310,1,1,0,1,1,151,150,160,160,67
"6245",44,"[23]uloIzoHcoxHnJHGqKHqKCBb",313,0.996815,23,314,1,313,1,1,0,1,1,141,140,173,173,67
"6246",45,"[23]uloIzoHcoxHnJHGqKHqKCBb",312,0.996805,23,313,1,312,1,1,0,1,1,149,148,164,164,67
"6247",46,"[23]uloIzoHcoxHnJHGqKHqKCBb",316,0.996845,23,317,1,316,1,1,0,1,1,152,151,165,165,67
"6248",47,"[23]uloIzoHcoxHnJHGqKHqKCBb",308,0.996764,23,309,1,308,1,1,0,1,1,163,162,146,146,67
"6249",48,"[23]uloIzoHcoxHnJHGqKHqKCBb",309,0.996774,23,310,1,309,1,1,0,1,1,140,139,170,170,67
"6250",49,"[23]uloIzoHcoxHnJHGqKHqKCBb",312,0.996805,23,313,1,312,1,1,0,1,1,161,160,152,152,67
"6251",50,"[23]uloIzoHcoxHnJHGqKHqKCBb",306,0.996743,23,307,1,306,1,1,0,1,1,144,143,163,163,67
"6252",51,"[23]uloIzoHcoxHnJHGqKHqKCBb",309,0.996774,23,310,1,309,1,1,0,1,1,143,142,167,167,67
"6253",52,"[23]uloIzoHcoxHnJHGqKHqKCBb",303,0.996711,23,304,1,303,1,1,0,1,1,150,149,154,154,67
"6254",53,"[23]uloIzoHcoxHnJHGqKHqKCBb",310,0.996785,23,311,1,310,1,1,0,1,1,156,155,155,155,67
"6255",54,"[23]uloIzoHcoxHnJHGqKHqKCBb",309,0.996774,23,310,1,309,1,1,0,1,1,153,152,157,157,67
"6256",55,"[23]uloIzoHcoxHnJHGqKHqKCBb",308,0.996764,23,309,1,308,1,1,0,1,1,149,148,160,160,67
"6257",56,"[23]uloIzoHcoxHnJHGqKHqKCBb",303,0.996711,23,304,1,303,1,1,0,1,1,160,159,144,144,67
"6258",57,"[23]uloIzoHcoxHnJHGqKHqKCBb",311,0.996795,23,312,1,311,1,1,0,1,1,156,155,156,156,67
"6259",58,"[23]uloIzoHcoxHnJHGqKHqKCBb",320,0.996885,23,321,1,320,1,1,0,1,1,155,154,166,166,67
"6260",59,"[23]uloIzoHcoxHnJHGqKHqKCBb",299,0.996667,23,300,1,299,1,1,0,1,1,160,159,140,140,67
"6261",60,"[23]uloIzoHcoxHnJHGqKHqKCBb",310,0.996785,23,311,1,310,1,1,0,1,1,145,144,166,166,67
"6262",61,"[23]uloIzoHcoxHnJHGqKHqKCBb",311,0.996795,23,312,1,311,1,1,0,1,1,160,159,152,152,67
"6263",62,"[23]uloIzoHcoxHnJHGqKHqKCBb",316,0.996845,23,317,1,316,1,1,0,1,1,145,144,172,172,67
"6264",63,"[23]uloIzoHcoxHnJHGqKHqKCBb",310,0.996785,23,311,1,310,1,1,0,1,1,147,146,164,164,67
"6265",64,"[23]uloIzoHcoxHnJHGqKHqKCBb",314,0.996825,23,315,1,314,1,1,0,1,1,152,151,163,163,67
"6266",65,"[23]uloIzoHcoxHnJHGqKHqKCBb",301,0.996689,23,302,1,301,1,1,0,1,1,164,163,138,138,67
"6267",66,"[23]uloIzoHcoxHnJHGqKHqKCBb",312,0.996805,23,313,1,312,1,1,0,1,1,142,141,171,171,67
"6268",67,"[23]uloIzoHcoxHnJHGqKHqKCBb",305,0.996732,23,306,1,305,1,1,0,1,1,145,144,161,161,67
"6269",68,"[23]uloIzoHcoxHnJHGqKHqKCBb",311,0.996795,23,312,1,311,1,1,0,1,1,147,146,165,165,67
"6270",69,"[23]uloIzoHcoxHnJHGqKHqKCBb",309,0.996774,23,310,1,309,1,1,0,1,1,160,159,150,150,67
"6271",70,"[23]uloIzoHcoxHnJHGqKHqKCBb",306,0.996743,23,307,1,306,1,1,0,1,1,155,154,152,152,67
"6272",71,"[23]uloIzoHcoxHnJHGqKHqKCBb",305,0.996732,23,306,1,305,1,1,0,1,1,166,165,140,140,67
"6273",72,"[23]uloIzoHcoxHnJHGqKHqKCBb",307,0.996753,23,308,1,307,1,1,0,1,1,160,159,148,148,67
"6274",73,"[23]uloIzoHcoxHnJHGqKHqKCBb",312,0.996805,23,313,1,312,1,1,0,1,1,150,149,163,163,67
"6275",74,"[23]uloIzoHcoxHnJHGqKHqKCBb",312,0.996805,23,313,1,312,1,1,0,1,1,159,158,154,154,67
"6276",75,"[23]uloIzoHcoxHnJHGqKHqKCBb",307,0.996753,23,308,1,307,1,1,0,1,1,161,160,147,147,67
"6277",76,"[23]uloIzoHcoxHnJHGqKHqKCBb",310,0.996785,23,311,1,310,1,1,0,1,1,157,156,154,154,67
"6278",77,"[23]uloIzoHcoxHnJHGqKHqKCBb",310,0.996785,23,311,1,310,1,1,0,1,1,151,150,160,160,67
"6279",78,"[23]uloIzoHcoxHnJHGqKHqKCBb",305,0.996732,23,306,1,305,1,1,0,1,1,159,158,147,147,67
"6280",79,"[23]uloIzoHcoxHnJHGqKHqKCBb",312,0.996805,23,313,1,312,1,1,0,1,1,142,141,171,171,67
"6281",80,"[23]uloIzoHcoxHnJHGqKHqKCBb",312,0.996805,23,313,1,312,1,1,0,1,1,160,159,153,153,67
"6282",81,"[23]uloIzoHcoxHnJHGqKHqKCBb",307,0.996753,23,308,1,307,1,1,0,1,1,158,157,150,150,67
"6283",82,"[23]uloIzoHcoxHnJHGqKHqKCBb",318,0.996865,23,319,1,318,1,1,0,1,1,151,150,168,168,67
"6284",83,"[23]uloIzoHcoxHnJHGqKHqKCBb",311,0.996795,23,312,1,311,1,1,0,1,1,150,149,162,162,67
"6285",84,"[23]uloIzoHcoxHnJHGqKHqKCBb",308,0.996764,23,309,1,308,1,1,0,1,1,155,154,154,154,67
"6286",85,"[23]uloIzoHcoxHnJHGqKHqKCBb",308,0.996764,23,309,1,308,1,1,0,1,1,152,151,157,157,67
"6287",86,"[23]uloIzoHcoxHnJHGqKHqKCBb",319,0.996875,23,320,1,319,1,1,0,1,1,149,148,171,171,67
"6288",87,"[23]uloIzoHcoxHnJHGqKHqKCBb",305,0.996732,23,306,1,305,1,1,0,1,1,162,161,144,144,67
"6289",88,"[23]uloIzoHcoxHnJHGqKHqKCBb",317,0.996855,23,318,1,317,1,1,0,1,1,145,144,173,173,67
"6290",89,"[23]uloIzoHcoxHnJHGqKHqKCBb",309,0.996774,23,310,1,309,1,1,0,1,1,160,159,150,150,67
"6291",90,"[23]uloIzoHcoxHnJHGqKHqKCBb",315,0.996835,23,316,1,315,1,1,0,1,1,159,158,157,157,67
"6292",91,"[23]uloIzoHcoxHnJHGqKHqKCBb",307,0.996753,23,308,1,307,1,1,0,1,1,163,162,145,145,67
"6293",92,"[23]uloIzoHcoxHnJHGqKHqKCBb",306,0.996743,23,307,1,306,1,1,0,1,1,164,163,143,143,67
"6294",93,"[23]uloIzoHcoxHnJHGqKHqKCBb",307,0.996753,23,308,1,307,1,1,0,1,1,154,153,154,154,67
"6295",94,"[23]uloIzoHcoxHnJHGqKHqKCBb",316,0.996845,23,317,1,316,1,1,0,1,1,147,146,170,170,67
"6296",95,"[23]uloIzoHcoxHnJHGqKHqKCBb",310,0.996785,23,311,1,310,1,1,0,1,1,138,137,173,173,67
"6297",96,"[23]uloIzoHcoxHnJHGqKHqKCBb",317,0.996855,23,318,1,317,1,1,0,1,1,163,162,155,155,67
"6298",97,"[23]uloIzoHcoxHnJHGqKHqKCBb",310,0.996785,23,311,1,310,1,1,0,1,1,154,153,157,157,67
"6299",98,"[23]uloIzoHcoxHnJHGqKHqKCBb",310,0.996785,23,311,1,310,1,1,0,1,1,160,159,151,151,67
"6300",99,"[23]uloIzoHcoxHnJHGqKHqKCBb",316,0.996845,23,317,1,316,1,1,0,1,1,143,142,174,174,67
"6301",0,"[24]JxHoIgpKoHcotHnJqGKCjCEs",289,0.996552,24,290,1,289,1,1,0,1,1,154,153,136,136,68
"6302",1,"[24]JxHoIgpKoHcotHnJqGKCjCEs",294,0.99661,24,295,1,294,1,1,0,1,1,143,142,152,152,68
"6303",2,"[24]JxHoIgpKoHcotHnJqGKCjCEs",287,0.996528,24,288,1,287,1,1,0,1,1,128,127,160,160,68
"6304",3,"[24]JxHoIgpKoHcotHnJqGKCjCEs",295,0.996622,24,296,1,295,1,1,0,1,1,147,146,149,149,68
"6305",4,"[24]JxHoIgpKoHcotHnJqGKCjCEs",298,0.996656,24,299,1,298,1,1,0,1,1,155,154,144,144,68
"6306",5,"[24]JxHoIgpKoHcotHnJqGKCjCEs",295,0.996622,24,296,1,295,1,1,0,1,1,155,154,141,141,68
"6307",6,"[24]JxHoIgpKoHcotHnJqGKCjCEs",290,0.996564,24,291,1,290,1,1,0,1,1,135,134,156,156,68
"6308",7,"[24]JxHoIgpKoHcotHnJqGKCjCEs",294,0.99661,24,295,1,294,1,1,0,1,1,138,137,157,157,68
"6309",8,"[24]JxHoIgpKoHcotHnJqGKCjCEs",300,0.996678,24,301,1,300,1,1,0,1,1,161,160,140,140,68
"6310",9,"[24]JxHoIgpKoHcotHnJqGKCjCEs",300,0.996678,24,301,1,300,1,1,0,1,1,158,157,143,143,68
"6311",10,"[24]JxHoIgpKoHcotHnJqGKCjCEs",293,0.996599,24,294,1,293,1,1,0,1,1,135,134,159,159,68
"6312",11,"[24]JxHoIgpKoHcotHnJqGKCjCEs",291,0.996575,24,292,1,291,1,1,0,1,1,151,150,141,141,68
"6313",12,"[24]JxHoIgpKoHcotHnJqGKCjCEs",306,0.996743,24,307,1,306,1,1,0,1,1,174,173,133,133,68
"6314",13,"[24]JxHoIgpKoHcotHnJqGKCjCEs",301,0.996689,24,302,1,301,1,1,0,1,1,153,152,149,149,68
"6315",14,"[24]JxHoIgpKoHcotHnJqGKCjCEs",299,0.996667,24,300,1,299,1,1,0,1,1,155,154,145,145,68
"6316",15,"[24]JxHoIgpKoHcotHnJqGKCjCEs",292,0.996587,24,293,1,292,1,1,0,1,1,136,135,157,157,68
"6317",16,"[24]JxHoIgpKoHcotHnJqGKCjCEs",303,0.996711,24,304,1,303,1,1,0,1,1,161,160,143,143,68
"6318",17,"[24]JxHoIgpKoHcotHnJqGKCjCEs",300,0.996678,24,301,1,300,1,1,0,1,1,161,160,140,140,68
"6319",18,"[24]JxHoIgpKoHcotHnJqGKCjCEs",300,0.996678,24,301,1,300,1,1,0,1,1,152,151,149,149,68
"6320",19,"[24]JxHoIgpKoHcotHnJqGKCjCEs",300,0.996678,24,301,1,300,1,1,0,1,1,158,157,143,143,68
"6321",20,"[24]JxHoIgpKoHcotHnJqGKCjCEs",290,0.996564,24,291,1,290,1,1,0,1,1,132,131,159,159,68
"6322",21,"[24]JxHoIgpKoHcotHnJqGKCjCEs",299,0.996667,24,300,1,299,1,1,0,1,1,155,154,145,145,68
"6323",22,"[24]JxHoIgpKoHcotHnJqGKCjCEs",299,0.996667,24,300,1,299,1,1,0,1,1,154,153,146,146,68
"6324",23,"[24]JxHoIgpKoHcotHnJqGKCjCEs",300,0.996678,24,301,1,300,1,1,0,1,1,154,153,147,147,68
"6325",24,"[24]JxHoIgpKoHcotHnJqGKCjCEs",300,0.996678,24,301,1,300,1,1,0,1,1,156,155,145,145,68
"6326",25,"[24]JxHoIgpKoHcotHnJqGKCjCEs",297,0.996644,24,298,1,297,1,1,0,1,1,162,161,136,136,68
"6327",26,"[24]JxHoIgpKoHcotHnJqGKCjCEs",297,0.996644,24,298,1,297,1,1,0,1,1,147,146,151,151,68
"6328",27,"[24]JxHoIgpKoHcotHnJqGKCjCEs",295,0.996622,24,296,1,295,1,1,0,1,1,148,147,148,148,68
"6329",28,"[24]JxHoIgpKoHcotHnJqGKCjCEs",301,0.996689,24,302,1,301,1,1,0,1,1,161,160,141,141,68
"6330",29,"[24]JxHoIgpKoHcotHnJqGKCjCEs",299,0.996667,24,300,1,299,1,1,0,1,1,153,152,147,147,68
"6331",30,"[24]JxHoIgpKoHcotHnJqGKCjCEs",297,0.996644,24,298,1,297,1,1,0,1,1,152,151,146,146,68
"6332",31,"[24]JxHoIgpKoHcotHnJqGKCjCEs",296,0.996633,24,297,1,296,1,1,0,1,1,149,148,148,148,68
"6333",32,"[24]JxHoIgpKoHcotHnJqGKCjCEs",293,0.996599,24,294,1,293,1,1,0,1,1,137,136,157,157,68
"6334",33,"[24]JxHoIgpKoHcotHnJqGKCjCEs",302,0.9967,24,303,1,302,1,1,0,1,1,166,165,137,137,68
"6335",34,"[24]JxHoIgpKoHcotHnJqGKCjCEs",301,0.996689,24,302,1,301,1,1,0,1,1,158,157,144,144,68
"6336",35,"[24]JxHoIgpKoHcotHnJqGKCjCEs",293,0.996599,24,294,1,293,1,1,0,1,1,137,136,157,157,68
"6337",36,"[24]JxHoIgpKoHcotHnJqGKCjCEs",296,0.996633,24,297,1,296,1,1,0,1,1,144,143,153,153,68
"6338",37,"[24]JxHoIgpKoHcotHnJqGKCjCEs",294,0.99661,24,295,1,294,1,1,0,1,1,140,139,155,155,68
"6339",38,"[24]JxHoIgpKoHcotHnJqGKCjCEs",299,0.996667,24,300,1,299,1,1,0,1,1,157,156,143,143,68
"6340",39,"[24]JxHoIgpKoHcotHnJqGKCjCEs",296,0.996633,24,297,1,296,1,1,0,1,1,149,148,148,148,68
"6341",40,"[24]JxHoIgpKoHcotHnJqGKCjCEs",299,0.996667,24,300,1,299,1,1,0,1,1,151,150,149,149,68
"6342",41,"[24]JxHoIgpKoHcotHnJqGKCjCEs",298,0.996656,24,299,1,298,1,1,0,1,1,145,144,154,154,68
"6343",42,"[24]JxHoIgpKoHcotHnJqGKCjCEs",289,0.996552,24,290,1,289,1,1,0,1,1,122,121,168,168,68
"6344",43,"[24]JxHoIgpKoHcotHnJqGKCjCEs",301,0.996689,24,302,1,301,1,1,0,1,1,161,160,141,141,68
"6345",44,"[24]JxHoIgpKoHcotHnJqGKCjCEs",308,0.996764,24,309,1,308,1,1,0,1,1,178,177,131,131,68
"6346",45,"[24]JxHoIgpKoHcotHnJqGKCjCEs",291,0.996575,24,292,1,291,1,1,0,1,1,144,143,148,148,68
"6347",46,"[24]JxHoIgpKoHcotHnJqGKCjCEs",296,0.996633,24,297,1,296,1,1,0,1,1,152,151,145,145,68
"6348",47,"[24]JxHoIgpKoHcotHnJqGKCjCEs",295,0.996622,24,296,1,295,1,1,0,1,1,142,141,154,154,68
"6349",48,"[24]JxHoIgpKoHcotHnJqGKCjCEs",299,0.996667,24,300,1,299,1,1,0,1,1,156,155,144,144,68
"6350",49,"[24]JxHoIgpKoHcotHnJqGKCjCEs",289,0.996552,24,290,1,289,1,1,0,1,1,145,144,145,145,68
"6351",50,"[24]JxHoIgpKoHcotHnJqGKCjCEs",298,0.996656,24,299,1,298,1,1,0,1,1,155,154,144,144,68
"6352",51,"[24]JxHoIgpKoHcotHnJqGKCjCEs",291,0.996575,24,292,1,291,1,1,0,1,1,135,134,157,157,68
"6353",52,"[24]JxHoIgpKoHcotHnJqGKCjCEs",294,0.99661,24,295,1,294,1,1,0,1,1,140,139,155,155,68
"6354",53,"[24]JxHoIgpKoHcotHnJqGKCjCEs",292,0.996587,24,293,1,292,1,1,0,1,1,140,139,153,153,68
"6355",54,"[24]JxHoIgpKoHcotHnJqGKCjCEs",292,0.996587,24,293,1,292,1,1,0,1,1,148,147,145,145,68
"6356",55,"[24]JxHoIgpKoHcotHnJqGKCjCEs",296,0.996633,24,297,1,296,1,1,0,1,1,147,146,150,150,68
"6357",56,"[24]JxHoIgpKoHcotHnJqGKCjCEs",287,0.996528,24,288,1,287,1,1,0,1,1,137,136,151,151,68
"6358",57,"[24]JxHoIgpKoHcotHnJqGKCjCEs",299,0.996667,24,300,1,299,1,1,0,1,1,162,161,138,138,68
"6359",58,"[24]JxHoIgpKoHcotHnJqGKCjCEs",302,0.9967,24,303,1,302,1,1,0,1,1,164,163,139,139,68
"6360",59,"[24]JxHoIgpKoHcotHnJqGKCjCEs",298,0.996656,24,299,1,298,1,1,0,1,1,152,151,147,147,68
"6361",60,"[24]JxHoIgpKoHcotHnJqGKCjCEs",296,0.996633,24,297,1,296,1,1,0,1,1,145,144,152,152,68
"6362",61,"[24]JxHoIgpKoHcotHnJqGKCjCEs",299,0.996667,24,300,1,299,1,1,0,1,1,160,159,140,140,68
"6363",62,"[24]JxHoIgpKoHcotHnJqGKCjCEs",297,0.996644,24,298,1,297,1,1,0,1,1,151,150,147,147,68
"6364",63,"[24]JxHoIgpKoHcotHnJqGKCjCEs",291,0.996575,24,292,1,291,1,1,0,1,1,141,140,151,151,68
"6365",64,"[24]JxHoIgpKoHcotHnJqGKCjCEs",296,0.996633,24,297,1,296,1,1,0,1,1,146,145,151,151,68
"6366",65,"[24]JxHoIgpKoHcotHnJqGKCjCEs",299,0.996667,24,300,1,299,1,1,0,1,1,159,158,141,141,68
"6367",66,"[24]JxHoIgpKoHcotHnJqGKCjCEs",295,0.996622,24,296,1,295,1,1,0,1,1,139,138,157,157,68
"6368",67,"[24]JxHoIgpKoHcotHnJqGKCjCEs",296,0.996633,24,297,1,296,1,1,0,1,1,144,143,153,153,68
"6369",68,"[24]JxHoIgpKoHcotHnJqGKCjCEs",301,0.996689,24,302,1,301,1,1,0,1,1,161,160,141,141,68
"6370",69,"[24]JxHoIgpKoHcotHnJqGKCjCEs",297,0.996644,24,298,1,297,1,1,0,1,1,148,147,150,150,68
"6371",70,"[24]JxHoIgpKoHcotHnJqGKCjCEs",302,0.9967,24,303,1,302,1,1,0,1,1,162,161,141,141,68
"6372",71,"[24]JxHoIgpKoHcotHnJqGKCjCEs",300,0.996678,24,301,1,300,1,1,0,1,1,155,154,146,146,68
"6373",72,"[24]JxHoIgpKoHcotHnJqGKCjCEs",294,0.99661,24,295,1,294,1,1,0,1,1,138,137,157,157,68
"6374",73,"[24]JxHoIgpKoHcotHnJqGKCjCEs",290,0.996564,24,291,1,290,1,1,0,1,1,132,131,159,159,68
"6375",74,"[24]JxHoIgpKoHcotHnJqGKCjCEs",299,0.996667,24,300,1,299,1,1,0,1,1,162,161,138,138,68
"6376",75,"[24]JxHoIgpKoHcotHnJqGKCjCEs",285,0.996503,24,286,1,285,1,1,0,1,1,117,116,169,169,68
"6377",76,"[24]JxHoIgpKoHcotHnJqGKCjCEs",296,0.996633,24,297,1,296,1,1,0,1,1,141,140,156,156,68
"6378",77,"[24]JxHoIgpKoHcotHnJqGKCjCEs",302,0.9967,24,303,1,302,1,1,0,1,1,162,161,141,141,68
"6379",78,"[24]JxHoIgpKoHcotHnJqGKCjCEs",305,0.996732,24,306,1,305,1,1,0,1,1,166,165,140,140,68
"6380",79,"[24]JxHoIgpKoHcotHnJqGKCjCEs",300,0.996678,24,301,1,300,1,1,0,1,1,157,156,144,144,68
"6381",80,"[24]JxHoIgpKoHcotHnJqGKCjCEs",295,0.996622,24,296,1,295,1,1,0,1,1,142,141,154,154,68
"6382",81,"[24]JxHoIgpKoHcotHnJqGKCjCEs",299,0.996667,24,300,1,299,1,1,0,1,1,160,159,140,140,68
"6383",82,"[24]JxHoIgpKoHcotHnJqGKCjCEs",300,0.996678,24,301,1,300,1,1,0,1,1,160,159,141,141,68
"6384",83,"[24]JxHoIgpKoHcotHnJqGKCjCEs",294,0.99661,24,295,1,294,1,1,0,1,1,138,137,157,157,68
"6385",84,"[24]JxHoIgpKoHcotHnJqGKCjCEs",296,0.996633,24,297,1,296,1,1,0,1,1,143,142,154,154,68
"6386",85,"[24]JxHoIgpKoHcotHnJqGKCjCEs",302,0.9967,24,303,1,302,1,1,0,1,1,164,163,139,139,68
"6387",86,"[24]JxHoIgpKoHcotHnJqGKCjCEs",297,0.996644,24,298,1,297,1,1,0,1,1,146,145,152,152,68
"6388",87,"[24]JxHoIgpKoHcotHnJqGKCjCEs",296,0.996633,24,297,1,296,1,1,0,1,1,149,148,148,148,68
"6389",88,"[24]JxHoIgpKoHcotHnJqGKCjCEs",302,0.9967,24,303,1,302,1,1,0,1,1,166,165,137,137,68
"6390",89,"[24]JxHoIgpKoHcotHnJqGKCjCEs",295,0.996622,24,296,1,295,1,1,0,1,1,142,141,154,154,68
"6391",90,"[24]JxHoIgpKoHcotHnJqGKCjCEs",292,0.996587,24,293,1,292,1,1,0,1,1,150,149,143,143,68
"6392",91,"[24]JxHoIgpKoHcotHnJqGKCjCEs",299,0.996667,24,300,1,299,1,1,0,1,1,155,154,145,145,68
"6393",92,"[24]JxHoIgpKoHcotHnJqGKCjCEs",300,0.996678,24,301,1,300,1,1,0,1,1,166,165,135,135,68
"6394",93,"[24]JxHoIgpKoHcotHnJqGKCjCEs",297,0.996644,24,298,1,297,1,1,0,1,1,149,148,149,149,68
"6395",94,"[24]JxHoIgpKoHcotHnJqGKCjCEs",305,0.996732,24,306,1,305,1,1,0,1,1,170,169,136,136,68
"6396",95,"[24]JxHoIgpKoHcotHnJqGKCjCEs",301,0.996689,24,302,1,301,1,1,0,1,1,168,167,134,134,68
"6397",96,"[24]JxHoIgpKoHcotHnJqGKCjCEs",298,0.996656,24,299,1,298,1,1,0,1,1,151,150,148,148,68
"6398",97,"[24]JxHoIgpKoHcotHnJqGKCjCEs",298,0.996656,24,299,1,298,1,1,0,1,1,152,151,147,147,68
"6399",98,"[24]JxHoIgpKoHcotHnJqGKCjCEs",293,0.996599,24,294,1,293,1,1,0,1,1,157,156,137,137,68
"6400",99,"[24]JxHoIgpKoHcotHnJqGKCjCEs",290,0.996564,24,291,1,290,1,1,0,1,1,137,136,154,154,68
"6401",0,"[21]gsoIoHcosHnJHGqKCsBnJ",279,0.996429,21,280,1,279,1,1,0,1,1,150,149,130,130,69
"6402",1,"[21]gsoIoHcosHnJHGqKCsBnJ",284,0.996491,21,285,1,284,1,1,0,1,1,128,127,157,157,69
"6403",2,"[21]gsoIoHcosHnJHGqKCsBnJ",279,0.996429,21,280,1,279,1,1,0,1,1,154,153,126,126,69
"6404",3,"[21]gsoIoHcosHnJHGqKCsBnJ",286,0.996516,21,287,1,286,1,1,0,1,1,142,141,145,145,69
"6405",4,"[21]gsoIoHcosHnJHGqKCsBnJ",276,0.99639,21,277,1,276,1,1,0,1,1,138,137,139,139,69
"6406",5,"[21]gsoIoHcosHnJHGqKCsBnJ",289,0.996552,21,290,1,289,1,1,0,1,1,146,145,144,144,69
"6407",6,"[21]gsoIoHcosHnJHGqKCsBnJ",282,0.996466,21,283,1,282,1,1,0,1,1,137,136,146,146,69
"6408",7,"[21]gsoIoHcosHnJHGqKCsBnJ",285,0.996503,21,286,1,285,1,1,0,1,1,155,154,131,131,69
"6409",8,"[21]gsoIoHcosHnJHGqKCsBnJ",283,0.996479,21,284,1,283,1,1,0,1,1,140,139,144,144,69
"6410",9,"[21]gsoIoHcosHnJHGqKCsBnJ",286,0.996516,21,287,1,286,1,1,0,1,1,154,153,133,133,69
"6411",10,"[21]gsoIoHcosHnJHGqKCsBnJ",286,0.996516,21,287,1,286,1,1,0,1,1,150,149,137,137,69
"6412",11,"[21]gsoIoHcosHnJHGqKCsBnJ",280,0.996441,21,281,1,280,1,1,0,1,1,140,139,141,141,69
"6413",12,"[21]gsoIoHcosHnJHGqKCsBnJ",283,0.996479,21,284,1,283,1,1,0,1,1,151,150,133,133,69
"6414",13,"[21]gsoIoHcosHnJHGqKCsBnJ",288,0.99654,21,289,1,288,1,1,0,1,1,157,156,132,132,69
"6415",14,"[21]gsoIoHcosHnJHGqKCsBnJ",283,0.996479,21,284,1,283,1,1,0,1,1,146,145,138,138,69
"6416",15,"[21]gsoIoHcosHnJHGqKCsBnJ",281,0.996454,21,282,1,281,1,1,0,1,1,148,147,134,134,69
"6417",16,"[21]gsoIoHcosHnJHGqKCsBnJ",288,0.99654,21,289,1,288,1,1,0,1,1,150,149,139,139,69
"6418",17,"[21]gsoIoHcosHnJHGqKCsBnJ",280,0.996441,21,281,1,280,1,1,0,1,1,135,134,146,146,69
"6419",18,"[21]gsoIoHcosHnJHGqKCsBnJ",288,0.99654,21,289,1,288,1,1,0,1,1,151,150,138,138,69
"6420",19,"[21]gsoIoHcosHnJHGqKCsBnJ",273,0.99635,21,274,1,273,1,1,0,1,1,123,122,151,151,69
"6421",20,"[21]gsoIoHcosHnJHGqKCsBnJ",286,0.996516,21,287,1,286,1,1,0,1,1,143,142,144,144,69
"6422",21,"[21]gsoIoHcosHnJHGqKCsBnJ",284,0.996491,21,285,1,284,1,1,0,1,1,140,139,145,145,69
"6423",22,"[21]gsoIoHcosHnJHGqKCsBnJ",284,0.996491,21,285,1,284,1,1,0,1,1,142,141,143,143,69
"6424",23,"[21]gsoIoHcosHnJHGqKCsBnJ",276,0.99639,21,277,1,276,1,1,0,1,1,153,152,124,124,69
"6425",24,"[21]gsoIoHcosHnJHGqKCsBnJ",280,0.996441,21,281,1,280,1,1,0,1,1,141,140,140,140,69
"6426",25,"[21]gsoIoHcosHnJHGqKCsBnJ",276,0.99639,21,277,1,276,1,1,0,1,1,136,135,141,141,69
"6427",26,"[21]gsoIoHcosHnJHGqKCsBnJ",284,0.996491,21,285,1,284,1,1,0,1,1,138,137,147,147,69
"6428",27,"[21]gsoIoHcosHnJHGqKCsBnJ",277,0.996403,21,278,1,277,1,1,0,1,1,132,131,146,146,69
"6429",28,"[21]gsoIoHcosHnJHGqKCsBnJ",278,0.996416,21,279,1,278,1,1,0,1,1,127,126,152,152,69
"6430",29,"[21]gsoIoHcosHnJHGqKCsBnJ",279,0.996429,21,280,1,279,1,1,0,1,1,138,137,142,142,69
"6431",30,"[21]gsoIoHcosHnJHGqKCsBnJ",285,0.996503,21,286,1,285,1,1,0,1,1,140,139,146,146,69
"6432",31,"[21]gsoIoHcosHnJHGqKCsBnJ",280,0.996441,21,281,1,280,1,1,0,1,1,126,125,155,155,69
"6433",32,"[21]gsoIoHcosHnJHGqKCsBnJ",274,0.996364,21,275,1,274,1,1,0,1,1,114,113,161,161,69
"6434",33,"[21]gsoIoHcosHnJHGqKCsBnJ",278,0.996416,21,279,1,278,1,1,0,1,1,129,128,150,150,69
"6435",34,"[21]gsoIoHcosHnJHGqKCsBnJ",286,0.996516,21,287,1,286,1,1,0,1,1,146,145,141,141,69
"6436",35,"[21]gsoIoHcosHnJHGqKCsBnJ",271,0.996324,21,272,1,271,1,1,0,1,1,127,126,145,145,69
"6437",36,"[21]gsoIoHcosHnJHGqKCsBnJ",278,0.996416,21,279,1,278,1,1,0,1,1,138,137,141,141,69
"6438",37,"[21]gsoIoHcosHnJHGqKCsBnJ",285,0.996503,21,286,1,285,1,1,0,1,1,137,136,149,149,69
"6439",38,"[21]gsoIoHcosHnJHGqKCsBnJ",281,0.996454,21,282,1,281,1,1,0,1,1,139,138,143,143,69
"6440",39,"[21]gsoIoHcosHnJHGqKCsBnJ",284,0.996491,21,285,1,284,1,1,0,1,1,140,139,145,145,69
"6441",40,"[21]gsoIoHcosHnJHGqKCsBnJ",284,0.996491,21,285,1,284,1,1,0,1,1,146,145,139,139,69
"6442",41,"[21]gsoIoHcosHnJHGqKCsBnJ",282,0.996466,21,283,1,282,1,1,0,1,1,140,139,143,143,69
"6443",42,"[21]gsoIoHcosHnJHGqKCsBnJ",280,0.996441,21,281,1,280,1,1,0,1,1,139,138,142,142,69
"6444",43,"[21]gsoIoHcosHnJHGqKCsBnJ",289,0.996552,21,290,1,289,1,1,0,1,1,146,145,144,144,69
"6445",44,"[21]gsoIoHcosHnJHGqKCsBnJ",289,0.996552,21,290,1,289,1,1,0,1,1,146,145,144,144,69
"6446",45,"[21]gsoIoHcosHnJHGqKCsBnJ",280,0.996441,21,281,1,280,1,1,0,1,1,146,145,135,135,69
"6447",46,"[21]gsoIoHcosHnJHGqKCsBnJ",275,0.996377,21,276,1,275,1,1,0,1,1,124,123,152,152,69
"6448",47,"[21]gsoIoHcosHnJHGqKCsBnJ",275,0.996377,21,276,1,275,1,1,0,1,1,137,136,139,139,69
"6449",48,"[21]gsoIoHcosHnJHGqKCsBnJ",284,0.996491,21,285,1,284,1,1,0,1,1,139,138,146,146,69
"6450",49,"[21]gsoIoHcosHnJHGqKCsBnJ",284,0.996491,21,285,1,284,1,1,0,1,1,142,141,143,143,69
"6451",50,"[21]gsoIoHcosHnJHGqKCsBnJ",290,0.996564,21,291,1,290,1,1,0,1,1,139,138,152,152,69
"6452",51,"[21]gsoIoHcosHnJHGqKCsBnJ",274,0.996364,21,275,1,274,1,1,0,1,1,145,144,130,130,69
"6453",52,"[21]gsoIoHcosHnJHGqKCsBnJ",275,0.996377,21,276,1,275,1,1,0,1,1,138,137,138,138,69
"6454",53,"[21]gsoIoHcosHnJHGqKCsBnJ",283,0.996479,21,284,1,283,1,1,0,1,1,132,131,152,152,69
"6455",54,"[21]gsoIoHcosHnJHGqKCsBnJ",284,0.996491,21,285,1,284,1,1,0,1,1,145,144,140,140,69
"6456",55,"[21]gsoIoHcosHnJHGqKCsBnJ",285,0.996503,21,286,1,285,1,1,0,1,1,162,161,124,124,69
"6457",56,"[21]gsoIoHcosHnJHGqKCsBnJ",278,0.996416,21,279,1,278,1,1,0,1,1,124,123,155,155,69
"6458",57,"[21]gsoIoHcosHnJHGqKCsBnJ",285,0.996503,21,286,1,285,1,1,0,1,1,158,157,128,128,69
"6459",58,"[21]gsoIoHcosHnJHGqKCsBnJ",269,0.996296,21,270,1,269,1,1,0,1,1,129,128,141,141,69
"6460",59,"[21]gsoIoHcosHnJHGqKCsBnJ",280,0.996441,21,281,1,280,1,1,0,1,1,151,150,130,130,69
"6461",60,"[21]gsoIoHcosHnJHGqKCsBnJ",282,0.996466,21,283,1,282,1,1,0,1,1,146,145,137,137,69
"6462",61,"[21]gsoIoHcosHnJHGqKCsBnJ",288,0.99654,21,289,1,288,1,1,0,1,1,145,144,144,144,69
"6463",62,"[21]gsoIoHcosHnJHGqKCsBnJ",282,0.996466,21,283,1,282,1,1,0,1,1,154,153,129,129,69
"6464",63,"[21]gsoIoHcosHnJHGqKCsBnJ",282,0.996466,21,283,1,282,1,1,0,1,1,130,129,153,153,69
"6465",64,"[21]gsoIoHcosHnJHGqKCsBnJ",285,0.996503,21,286,1,285,1,1,0,1,1,135,134,151,151,69
"6466",65,"[21]gsoIoHcosHnJHGqKCsBnJ",282,0.996466,21,283,1,282,1,1,0,1,1,147,146,136,136,69
"6467",66,"[21]gsoIoHcosHnJHGqKCsBnJ",284,0.996491,21,285,1,284,1,1,0,1,1,138,137,147,147,69
"6468",67,"[21]gsoIoHcosHnJHGqKCsBnJ",284,0.996491,21,285,1,284,1,1,0,1,1,147,146,138,138,69
"6469",68,"[21]gsoIoHcosHnJHGqKCsBnJ",284,0.996491,21,285,1,284,1,1,0,1,1,134,133,151,151,69
"6470",69,"[21]gsoIoHcosHnJHGqKCsBnJ",278,0.996416,21,279,1,278,1,1,0,1,1,142,141,137,137,69
"6471",70,"[21]gsoIoHcosHnJHGqKCsBnJ",289,0.996552,21,290,1,289,1,1,0,1,1,137,136,153,153,69
"6472",71,"[21]gsoIoHcosHnJHGqKCsBnJ",278,0.996416,21,279,1,278,1,1,0,1,1,135,134,144,144,69
"6473",72,"[21]gsoIoHcosHnJHGqKCsBnJ",287,0.996528,21,288,1,287,1,1,0,1,1,139,138,149,149,69
"6474",73,"[21]gsoIoHcosHnJHGqKCsBnJ",281,0.996454,21,282,1,281,1,1,0,1,1,148,147,134,134,69
"6475",74,"[21]gsoIoHcosHnJHGqKCsBnJ",275,0.996377,21,276,1,275,1,1,0,1,1,128,127,148,148,69
"6476",75,"[21]gsoIoHcosHnJHGqKCsBnJ",277,0.996403,21,278,1,277,1,1,0,1,1,136,135,142,142,69
"6477",76,"[21]gsoIoHcosHnJHGqKCsBnJ",278,0.996416,21,279,1,278,1,1,0,1,1,118,117,161,161,69
"6478",77,"[21]gsoIoHcosHnJHGqKCsBnJ",281,0.996454,21,282,1,281,1,1,0,1,1,155,154,127,127,69
"6479",78,"[21]gsoIoHcosHnJHGqKCsBnJ",280,0.996441,21,281,1,280,1,1,0,1,1,141,140,140,140,69
"6480",79,"[21]gsoIoHcosHnJHGqKCsBnJ",283,0.996479,21,284,1,283,1,1,0,1,1,154,153,130,130,69
"6481",80,"[21]gsoIoHcosHnJHGqKCsBnJ",279,0.996429,21,280,1,279,1,1,0,1,1,136,135,144,144,69
"6482",81,"[21]gsoIoHcosHnJHGqKCsBnJ",274,0.996364,21,275,1,274,1,1,0,1,1,137,136,138,138,69
"6483",82,"[21]gsoIoHcosHnJHGqKCsBnJ",280,0.996441,21,281,1,280,1,1,0,1,1,132,131,149,149,69
"6484",83,"[21]gsoIoHcosHnJHGqKCsBnJ",275,0.996377,21,276,1,275,1,1,0,1,1,143,142,133,133,69
"6485",84,"[21]gsoIoHcosHnJHGqKCsBnJ",288,0.99654,21,289,1,288,1,1,0,1,1,143,142,146,146,69
"6486",85,"[21]gsoIoHcosHnJHGqKCsBnJ",276,0.99639,21,277,1,276,1,1,0,1,1,132,131,145,145,69
"6487",86,"[21]gsoIoHcosHnJHGqKCsBnJ",279,0.996429,21,280,1,279,1,1,0,1,1,148,147,132,132,69
"6488",87,"[21]gsoIoHcosHnJHGqKCsBnJ",278,0.996416,21,279,1,278,1,1,0,1,1,137,136,142,142,69
"6489",88,"[21]gsoIoHcosHnJHGqKCsBnJ",278,0.996416,21,279,1,278,1,1,0,1,1,138,137,141,141,69
"6490",89,"[21]gsoIoHcosHnJHGqKCsBnJ",283,0.996479,21,284,1,283,1,1,0,1,1,143,142,141,141,69
"6491",90,"[21]gsoIoHcosHnJHGqKCsBnJ",288,0.99654,21,289,1,288,1,1,0,1,1,156,155,133,133,69
"6492",91,"[21]gsoIoHcosHnJHGqKCsBnJ",276,0.99639,21,277,1,276,1,1,0,1,1,129,128,148,148,69
"6493",92,"[21]gsoIoHcosHnJHGqKCsBnJ",283,0.996479,21,284,1,283,1,1,0,1,1,129,128,155,155,69
"6494",93,"[21]gsoIoHcosHnJHGqKCsBnJ",277,0.996403,21,278,1,277,1,1,0,1,1,137,136,141,141,69
"6495",94,"[21]gsoIoHcosHnJHGqKCsBnJ",277,0.996403,21,278,1,277,1,1,0,1,1,140,139,138,138,69
"6496",95,"[21]gsoIoHcosHnJHGqKCsBnJ",281,0.996454,21,282,1,281,1,1,0,1,1,147,146,135,135,69
"6497",96,"[21]gsoIoHcosHnJHGqKCsBnJ",287,0.996528,21,288,1,287,1,1,0,1,1,150,149,138,138,69
"6498",97,"[21]gsoIoHcosHnJHGqKCsBnJ",282,0.996466,21,283,1,282,1,1,0,1,1,156,155,127,127,69
"6499",98,"[21]gsoIoHcosHnJHGqKCsBnJ",290,0.996564,21,291,1,290,1,1,0,1,1,150,149,141,141,69
"6500",99,"[21]gsoIoHcosHnJHGqKCsBnJ",278,0.996416,21,279,1,278,1,1,0,1,1,132,131,147,147,69
"6501",0,"[24]GJHqaIsHcHtHnJqGKCEnIHKa",300,0.996678,24,301,1,300,1,1,0,1,1,157,156,144,144,70
"6502",1,"[24]GJHqaIsHcHtHnJqGKCEnIHKa",290,0.996564,24,291,1,290,1,1,0,1,1,128,127,163,163,70
"6503",2,"[24]GJHqaIsHcHtHnJqGKCEnIHKa",302,0.9967,24,303,1,302,1,1,0,1,1,160,159,143,143,70
"6504",3,"[24]GJHqaIsHcHtHnJqGKCEnIHKa",300,0.996678,24,301,1,300,1,1,0,1,1,149,148,152,152,70
"6505",4,"[24]GJHqaIsHcHtHnJqGKCEnIHKa",298,0.996656,24,299,1,298,1,1,0,1,1,149,148,150,150,70
"6506",5,"[24]GJHqaIsHcHtHnJqGKCEnIHKa",303,0.996711,24,304,1,303,1,1,0,1,1,166,165,138,138,70
"6507",6,"[24]GJHqaIsHcHtHnJqGKCEnIHKa",297,0.996644,24,298,1,297,1,1,0,1,1,144,143,154,154,70
"6508",7,"[24]GJHqaIsHcHtHnJqGKCEnIHKa",300,0.996678,24,301,1,300,1,1,0,1,1,157,156,144,144,70
"6509",8,"[24]GJHqaIsHcHtHnJqGKCEnIHKa",299,0.996667,24,300,1,299,1,1,0,1,1,152,151,148,148,70
"6510",9,"[24]GJHqaIsHcHtHnJqGKCEnIHKa",305,0.996732,24,306,1,305,1,1,0,1,1,170,169,136,136,70
"6511",10,"[24]GJHqaIsHcHtHnJqGKCEnIHKa",299,0.996667,24,300,1,299,1,1,0,1,1,152,151,148,148,70
"6512",11,"[24]GJHqaIsHcHtHnJqGKCEnIHKa",293,0.996599,24,294,1,293,1,1,0,1,1,131,130,163,163,70
"6513",12,"[24]GJHqaIsHcHtHnJqGKCEnIHKa",297,0.996644,24,298,1,297,1,1,0,1,1,145,144,153,153,70
"6514",13,"[24]GJHqaIsHcHtHnJqGKCEnIHKa",301,0.996689,24,302,1,301,1,1,0,1,1,158,157,144,144,70
"6515",14,"[24]GJHqaIsHcHtHnJqGKCEnIHKa",298,0.996656,24,299,1,298,1,1,0,1,1,146,145,153,153,70
"6516",15,"[24]GJHqaIsHcHtHnJqGKCEnIHKa",294,0.99661,24,295,1,294,1,1,0,1,1,140,139,155,155,70
"6517",16,"[24]GJHqaIsHcHtHnJqGKCEnIHKa",304,0.996721,24,305,1,304,1,1,0,1,1,163,162,142,142,70
"6518",17,"[24]GJHqaIsHcHtHnJqGKCEnIHKa",304,0.996721,24,305,1,304,1,1,0,1,1,163,162,142,142,70
"6519",18,"[24]GJHqaIsHcHtHnJqGKCEnIHKa",306,0.996743,24,307,1,306,1,1,0,1,1,172,171,135,135,70
"6520",19,"[24]GJHqaIsHcHtHnJqGKCEnIHKa",298,0.996656,24,299,1,298,1,1,0,1,1,147,146,152,152,70
"6521",20,"[24]GJHqaIsHcHtHnJqGKCEnIHKa",302,0.9967,24,303,1,302,1,1,0,1,1,162,161,141,141,70
"6522",21,"[24]GJHqaIsHcHtHnJqGKCEnIHKa",307,0.996753,24,308,1,307,1,1,0,1,1,161,160,147,147,70
"6523",22,"[24]GJHqaIsHcHtHnJqGKCEnIHKa",301,0.996689,24,302,1,301,1,1,0,1,1,158,157,144,144,70
"6524",23,"[24]GJHqaIsHcHtHnJqGKCEnIHKa",302,0.9967,24,303,1,302,1,1,0,1,1,162,161,141,141,70
"6525",24,"[24]GJHqaIsHcHtHnJqGKCEnIHKa",293,0.996599,24,294,1,293,1,1,0,1,1,137,136,157,157,70
"6526",25,"[24]GJHqaIsHcHtHnJqGKCEnIHKa",298,0.996656,24,299,1,298,1,1,0,1,1,151,150,148,148,70
"6527",26,"[24]GJHqaIsHcHtHnJqGKCEnIHKa",299,0.996667,24,300,1,299,1,1,0,1,1,153,152,147,147,70
"6528",27,"[24]GJHqaIsHcHtHnJqGKCEnIHKa",296,0.996633,24,297,1,296,1,1,0,1,1,141,140,156,156,70
"6529",28,"[24]GJHqaIsHcHtHnJqGKCEnIHKa",294,0.99661,24,295,1,294,1,1,0,1,1,140,139,155,155,70
"6530",29,"[24]GJHqaIsHcHtHnJqGKCEnIHKa",296,0.996633,24,297,1,296,1,1,0,1,1,144,143,153,153,70
"6531",30,"[24]GJHqaIsHcHtHnJqGKCEnIHKa",298,0.996656,24,299,1,298,1,1,0,1,1,149,148,150,150,70
"6532",31,"[24]GJHqaIsHcHtHnJqGKCEnIHKa",305,0.996732,24,306,1,305,1,1,0,1,1,173,172,133,133,70
"6533",32,"[24]GJHqaIsHcHtHnJqGKCEnIHKa",297,0.996644,24,298,1,297,1,1,0,1,1,149,148,149,149,70
"6534",33,"[24]GJHqaIsHcHtHnJqGKCEnIHKa",304,0.996721,24,305,1,304,1,1,0,1,1,169,168,136,136,70
"6535",34,"[24]GJHqaIsHcHtHnJqGKCEnIHKa",308,0.996764,24,309,1,308,1,1,0,1,1,175,174,134,134,70
"6536",35,"[24]GJHqaIsHcHtHnJqGKCEnIHKa",295,0.996622,24,296,1,295,1,1,0,1,1,142,141,154,154,70
"6537",36,"[24]GJHqaIsHcHtHnJqGKCEnIHKa",296,0.996633,24,297,1,296,1,1,0,1,1,139,138,158,158,70
"6538",37,"[24]GJHqaIsHcHtHnJqGKCEnIHKa",296,0.996633,24,297,1,296,1,1,0,1,1,143,142,154,154,70
"6539",38,"[24]GJHqaIsHcHtHnJqGKCEnIHKa",303,0.996711,24,304,1,303,1,1,0,1,1,161,160,143,143,70
"6540",39,"[24]GJHqaIsHcHtHnJqGKCEnIHKa",296,0.996633,24,297,1,296,1,1,0,1,1,144,143,153,153,70
"6541",40,"[24]GJHqaIsHcHtHnJqGKCEnIHKa",301,0.996689,24,302,1,301,1,1,0,1,1,158,157,144,144,70
"6542",41,"[24]GJHqaIsHcHtHnJqGKCEnIHKa",295,0.996622,24,296,1,295,1,1,0,1,1,143,142,153,153,70
"6543",42,"[24]GJHqaIsHcHtHnJqGKCEnIHKa",298,0.996656,24,299,1,298,1,1,0,1,1,151,150,148,148,70
"6544",43,"[24]GJHqaIsHcHtHnJqGKCEnIHKa",298,0.996656,24,299,1,298,1,1,0,1,1,141,140,158,158,70
"6545",44,"[24]GJHqaIsHcHtHnJqGKCEnIHKa",303,0.996711,24,304,1,303,1,1,0,1,1,166,165,138,138,70
"6546",45,"[24]GJHqaIsHcHtHnJqGKCEnIHKa",303,0.996711,24,304,1,303,1,1,0,1,1,164,163,140,140,70
"6547",46,"[24]GJHqaIsHcHtHnJqGKCEnIHKa",297,0.996644,24,298,1,297,1,1,0,1,1,147,146,151,151,70
"6548",47,"[24]GJHqaIsHcHtHnJqGKCEnIHKa",299,0.996667,24,300,1,299,1,1,0,1,1,154,153,146,146,70
"6549",48,"[24]GJHqaIsHcHtHnJqGKCEnIHKa",297,0.996644,24,298,1,297,1,1,0,1,1,147,146,151,151,70
"6550",49,"[24]GJHqaIsHcHtHnJqGKCEnIHKa",299,0.996667,24,300,1,299,1,1,0,1,1,150,149,150,150,70
"6551",50,"[24]GJHqaIsHcHtHnJqGKCEnIHKa",293,0.996599,24,294,1,293,1,1,0,1,1,135,134,159,159,70
"6552",51,"[24]GJHqaIsHcHtHnJqGKCEnIHKa",307,0.996753,24,308,1,307,1,1,0,1,1,172,171,136,136,70
"6553",52,"[24]GJHqaIsHcHtHnJqGKCEnIHKa",296,0.996633,24,297,1,296,1,1,0,1,1,144,143,153,153,70
"6554",53,"[24]GJHqaIsHcHtHnJqGKCEnIHKa",295,0.996622,24,296,1,295,1,1,0,1,1,139,138,157,157,70
"6555",54,"[24]GJHqaIsHcHtHnJqGKCEnIHKa",299,0.996667,24,300,1,299,1,1,0,1,1,144,143,156,156,70
"6556",55,"[24]GJHqaIsHcHtHnJqGKCEnIHKa",298,0.996656,24,299,1,298,1,1,0,1,1,149,148,150,150,70
"6557",56,"[24]GJHqaIsHcHtHnJqGKCEnIHKa",297,0.996644,24,298,1,297,1,1,0,1,1,144,143,154,154,70
"6558",57,"[24]GJHqaIsHcHtHnJqGKCEnIHKa",296,0.996633,24,297,1,296,1,1,0,1,1,144,143,153,153,70
"6559",58,"[24]GJHqaIsHcHtHnJqGKCEnIHKa",299,0.996667,24,300,1,299,1,1,0,1,1,150,149,150,150,70
"6560",59,"[24]GJHqaIsHcHtHnJqGKCEnIHKa",298,0.996656,24,299,1,298,1,1,0,1,1,146,145,153,153,70
"6561",60,"[24]GJHqaIsHcHtHnJqGKCEnIHKa",301,0.996689,24,302,1,301,1,1,0,1,1,160,159,142,142,70
"6562",61,"[24]GJHqaIsHcHtHnJqGKCEnIHKa",303,0.996711,24,304,1,303,1,1,0,1,1,154,153,150,150,70
"6563",62,"[24]GJHqaIsHcHtHnJqGKCEnIHKa",303,0.996711,24,304,1,303,1,1,0,1,1,158,157,146,146,70
"6564",63,"[24]GJHqaIsHcHtHnJqGKCEnIHKa",297,0.996644,24,298,1,297,1,1,0,1,1,148,147,150,150,70
"6565",64,"[24]GJHqaIsHcHtHnJqGKCEnIHKa",299,0.996667,24,300,1,299,1,1,0,1,1,153,152,147,147,70
"6566",65,"[24]GJHqaIsHcHtHnJqGKCEnIHKa",293,0.996599,24,294,1,293,1,1,0,1,1,136,135,158,158,70
"6567",66,"[24]GJHqaIsHcHtHnJqGKCEnIHKa",300,0.996678,24,301,1,300,1,1,0,1,1,151,150,150,150,70
"6568",67,"[24]GJHqaIsHcHtHnJqGKCEnIHKa",305,0.996732,24,306,1,305,1,1,0,1,1,171,170,135,135,70
"6569",68,"[24]GJHqaIsHcHtHnJqGKCEnIHKa",299,0.996667,24,300,1,299,1,1,0,1,1,153,152,147,147,70
"6570",69,"[24]GJHqaIsHcHtHnJqGKCEnIHKa",297,0.996644,24,298,1,297,1,1,0,1,1,147,146,151,151,70
"6571",70,"[24]GJHqaIsHcHtHnJqGKCEnIHKa",301,0.996689,24,302,1,301,1,1,0,1,1,156,155,146,146,70
"6572",71,"[24]GJHqaIsHcHtHnJqGKCEnIHKa",296,0.996633,24,297,1,296,1,1,0,1,1,146,145,151,151,70
"6573",72,"[24]GJHqaIsHcHtHnJqGKCEnIHKa",296,0.996633,24,297,1,296,1,1,0,1,1,145,144,152,152,70
"6574",73,"[24]GJHqaIsHcHtHnJqGKCEnIHKa",302,0.9967,24,303,1,302,1,1,0,1,1,155,154,148,148,70
"6575",74,"[24]GJHqaIsHcHtHnJqGKCEnIHKa",293,0.996599,24,294,1,293,1,1,0,1,1,135,134,159,159,70
"6576",75,"[24]GJHqaIsHcHtHnJqGKCEnIHKa",302,0.9967,24,303,1,302,1,1,0,1,1,160,159,143,143,70
"6577",76,"[24]GJHqaIsHcHtHnJqGKCEnIHKa",298,0.996656,24,299,1,298,1,1,0,1,1,147,146,152,152,70
"6578",77,"[24]GJHqaIsHcHtHnJqGKCEnIHKa",296,0.996633,24,297,1,296,1,1,0,1,1,143,142,154,154,70
"6579",78,"[24]GJHqaIsHcHtHnJqGKCEnIHKa",295,0.996622,24,296,1,295,1,1,0,1,1,138,137,158,158,70
"6580",79,"[24]GJHqaIsHcHtHnJqGKCEnIHKa",296,0.996633,24,297,1,296,1,1,0,1,1,138,137,159,159,70
"6581",80,"[24]GJHqaIsHcHtHnJqGKCEnIHKa",303,0.996711,24,304,1,303,1,1,0,1,1,162,161,142,142,70
"6582",81,"[24]GJHqaIsHcHtHnJqGKCEnIHKa",297,0.996644,24,298,1,297,1,1,0,1,1,138,137,160,160,70
"6583",82,"[24]GJHqaIsHcHtHnJqGKCEnIHKa",296,0.996633,24,297,1,296,1,1,0,1,1,145,144,152,152,70
"6584",83,"[24]GJHqaIsHcHtHnJqGKCEnIHKa",298,0.996656,24,299,1,298,1,1,0,1,1,151,150,148,148,70
"6585",84,"[24]GJHqaIsHcHtHnJqGKCEnIHKa",304,0.996721,24,305,1,304,1,1,0,1,1,164,163,141,141,70
"6586",85,"[24]GJHqaIsHcHtHnJqGKCEnIHKa",302,0.9967,24,303,1,302,1,1,0,1,1,162,161,141,141,70
"6587",86,"[24]GJHqaIsHcHtHnJqGKCEnIHKa",300,0.996678,24,301,1,300,1,1,0,1,1,155,154,146,146,70
"6588",87,"[24]GJHqaIsHcHtHnJqGKCEnIHKa",294,0.99661,24,295,1,294,1,1,0,1,1,140,139,155,155,70
"6589",88,"[24]GJHqaIsHcHtHnJqGKCEnIHKa",303,0.996711,24,304,1,303,1,1,0,1,1,159,158,145,145,70
"6590",89,"[24]GJHqaIsHcHtHnJqGKCEnIHKa",300,0.996678,24,301,1,300,1,1,0,1,1,150,149,151,151,70
"6591",90,"[24]GJHqaIsHcHtHnJqGKCEnIHKa",298,0.996656,24,299,1,298,1,1,0,1,1,144,143,155,155,70
"6592",91,"[24]GJHqaIsHcHtHnJqGKCEnIHKa",292,0.996587,24,293,1,292,1,1,0,1,1,132,131,161,161,70
"6593",92,"[24]GJHqaIsHcHtHnJqGKCEnIHKa",301,0.996689,24,302,1,301,1,1,0,1,1,159,158,143,143,70
"6594",93,"[24]GJHqaIsHcHtHnJqGKCEnIHKa",301,0.996689,24,302,1,301,1,1,0,1,1,158,157,144,144,70
"6595",94,"[24]GJHqaIsHcHtHnJqGKCEnIHKa",297,0.996644,24,298,1,297,1,1,0,1,1,148,147,150,150,70
"6596",95,"[24]GJHqaIsHcHtHnJqGKCEnIHKa",301,0.996689,24,302,1,301,1,1,0,1,1,152,151,150,150,70
"6597",96,"[24]GJHqaIsHcHtHnJqGKCEnIHKa",298,0.996656,24,299,1,298,1,1,0,1,1,148,147,151,151,70
"6598",97,"[24]GJHqaIsHcHtHnJqGKCEnIHKa",293,0.996599,24,294,1,293,1,1,0,1,1,136,135,158,158,70
"6599",98,"[24]GJHqaIsHcHtHnJqGKCEnIHKa",298,0.996656,24,299,1,298,1,1,0,1,1,149,148,150,150,70
"6600",99,"[24]GJHqaIsHcHtHnJqGKCEnIHKa",301,0.996689,24,302,1,301,1,1,0,1,1,159,158,143,143,70
"6601",0,"[27]BoIoHcotHnJHGqKCeJtykFbohuE",286,0.996516,27,287,1,286,1,1,0,1,1,140,139,147,147,71
"6602",1,"[27]BoIoHcotHnJHGqKCeJtykFbohuE",277,0.996403,27,278,1,277,1,1,0,1,1,120,119,158,158,71
"6603",2,"[27]BoIoHcotHnJHGqKCeJtykFbohuE",284,0.996491,27,285,1,284,1,1,0,1,1,132,131,153,153,71
"6604",3,"[27]BoIoHcotHnJHGqKCeJtykFbohuE",283,0.996479,27,284,1,283,1,1,0,1,1,140,139,144,144,71
"6605",4,"[27]BoIoHcotHnJHGqKCeJtykFbohuE",284,0.996491,27,285,1,284,1,1,0,1,1,143,142,142,142,71
"6606",5,"[27]BoIoHcotHnJHGqKCeJtykFbohuE",280,0.996441,27,281,1,280,1,1,0,1,1,141,140,140,140,71
"6607",6,"[27]BoIoHcotHnJHGqKCeJtykFbohuE",285,0.996503,27,286,1,285,1,1,0,1,1,144,143,142,142,71
"6608",7,"[27]BoIoHcotHnJHGqKCeJtykFbohuE",281,0.996454,27,282,1,281,1,1,0,1,1,147,146,135,135,71
"6609",8,"[27]BoIoHcotHnJHGqKCeJtykFbohuE",280,0.996441,27,281,1,280,1,1,0,1,1,132,131,149,149,71
"6610",9,"[27]BoIoHcotHnJHGqKCeJtykFbohuE",281,0.996454,27,282,1,281,1,1,0,1,1,146,145,136,136,71
"6611",10,"[27]BoIoHcotHnJHGqKCeJtykFbohuE",276,0.99639,27,277,1,276,1,1,0,1,1,138,137,139,139,71
"6612",11,"[27]BoIoHcotHnJHGqKCeJtykFbohuE",290,0.996564,27,291,1,290,1,1,0,1,1,148,147,143,143,71
"6613",12,"[27]BoIoHcotHnJHGqKCeJtykFbohuE",281,0.996454,27,282,1,281,1,1,0,1,1,143,142,139,139,71
"6614",13,"[27]BoIoHcotHnJHGqKCeJtykFbohuE",287,0.996528,27,288,1,287,1,1,0,1,1,159,158,129,129,71
"6615",14,"[27]BoIoHcotHnJHGqKCeJtykFbohuE",283,0.996479,27,284,1,283,1,1,0,1,1,141,140,143,143,71
"6616",15,"[27]BoIoHcotHnJHGqKCeJtykFbohuE",276,0.99639,27,277,1,276,1,1,0,1,1,131,130,146,146,71
"6617",16,"[27]BoIoHcotHnJHGqKCeJtykFbohuE",289,0.996552,27,290,1,289,1,1,0,1,1,148,147,142,142,71
"6618",17,"[27]BoIoHcotHnJHGqKCeJtykFbohuE",279,0.996429,27,280,1,279,1,1,0,1,1,142,141,138,138,71
"6619",18,"[27]BoIoHcotHnJHGqKCeJtykFbohuE",282,0.996466,27,283,1,282,1,1,0,1,1,141,140,142,142,71
"6620",19,"[27]BoIoHcotHnJHGqKCeJtykFbohuE",288,0.99654,27,289,1,288,1,1,0,1,1,151,150,138,138,71
"6621",20,"[27]BoIoHcotHnJHGqKCeJtykFbohuE",279,0.996429,27,280,1,279,1,1,0,1,1,149,148,131,131,71
"6622",21,"[27]BoIoHcotHnJHGqKCeJtykFbohuE",283,0.996479,27,284,1,283,1,1,0,1,1,141,140,143,143,71
"6623",22,"[27]BoIoHcotHnJHGqKCeJtykFbohuE",281,0.996454,27,282,1,281,1,1,0,1,1,148,147,134,134,71
"6624",23,"[27]BoIoHcotHnJHGqKCeJtykFbohuE",282,0.996466,27,283,1,282,1,1,0,1,1,135,134,148,148,71
"6625",24,"[27]BoIoHcotHnJHGqKCeJtykFbohuE",280,0.996441,27,281,1,280,1,1,0,1,1,134,133,147,147,71
"6626",25,"[27]BoIoHcotHnJHGqKCeJtykFbohuE",280,0.996441,27,281,1,280,1,1,0,1,1,137,136,144,144,71
"6627",26,"[27]BoIoHcotHnJHGqKCeJtykFbohuE",275,0.996377,27,276,1,275,1,1,0,1,1,130,129,146,146,71
"6628",27,"[27]BoIoHcotHnJHGqKCeJtykFbohuE",281,0.996454,27,282,1,281,1,1,0,1,1,139,138,143,143,71
"6629",28,"[27]BoIoHcotHnJHGqKCeJtykFbohuE",282,0.996466,27,283,1,282,1,1,0,1,1,140,139,143,143,71
"6630",29,"[27]BoIoHcotHnJHGqKCeJtykFbohuE",284,0.996491,27,285,1,284,1,1,0,1,1,166,165,119,119,71
"6631",30,"[27]BoIoHcotHnJHGqKCeJtykFbohuE",289,0.996552,27,290,1,289,1,1,0,1,1,148,147,142,142,71
"6632",31,"[27]BoIoHcotHnJHGqKCeJtykFbohuE",287,0.996528,27,288,1,287,1,1,0,1,1,143,142,145,145,71
"6633",32,"[27]BoIoHcotHnJHGqKCeJtykFbohuE",276,0.99639,27,277,1,276,1,1,0,1,1,128,127,149,149,71
"6634",33,"[27]BoIoHcotHnJHGqKCeJtykFbohuE",282,0.996466,27,283,1,282,1,1,0,1,1,145,144,138,138,71
"6635",34,"[27]BoIoHcotHnJHGqKCeJtykFbohuE",284,0.996491,27,285,1,284,1,1,0,1,1,154,153,131,131,71
"6636",35,"[27]BoIoHcotHnJHGqKCeJtykFbohuE",284,0.996491,27,285,1,284,1,1,0,1,1,142,141,143,143,71
"6637",36,"[27]BoIoHcotHnJHGqKCeJtykFbohuE",280,0.996441,27,281,1,280,1,1,0,1,1,134,133,147,147,71
"6638",37,"[27]BoIoHcotHnJHGqKCeJtykFbohuE",275,0.996377,27,276,1,275,1,1,0,1,1,130,129,146,146,71
"6639",38,"[27]BoIoHcotHnJHGqKCeJtykFbohuE",281,0.996454,27,282,1,281,1,1,0,1,1,144,143,138,138,71
"6640",39,"[27]BoIoHcotHnJHGqKCeJtykFbohuE",283,0.996479,27,284,1,283,1,1,0,1,1,146,145,138,138,71
"6641",40,"[27]BoIoHcotHnJHGqKCeJtykFbohuE",282,0.996466,27,283,1,282,1,1,0,1,1,146,145,137,137,71
"6642",41,"[27]BoIoHcotHnJHGqKCeJtykFbohuE",280,0.996441,27,281,1,280,1,1,0,1,1,137,136,144,144,71
"6643",42,"[27]BoIoHcotHnJHGqKCeJtykFbohuE",276,0.99639,27,277,1,276,1,1,0,1,1,123,122,154,154,71
"6644",43,"[27]BoIoHcotHnJHGqKCeJtykFbohuE",290,0.996564,27,291,1,290,1,1,0,1,1,152,151,139,139,71
"6645",44,"[27]BoIoHcotHnJHGqKCeJtykFbohuE",279,0.996429,27,280,1,279,1,1,0,1,1,135,134,145,145,71
"6646",45,"[27]BoIoHcotHnJHGqKCeJtykFbohuE",278,0.996416,27,279,1,278,1,1,0,1,1,135,134,144,144,71
"6647",46,"[27]BoIoHcotHnJHGqKCeJtykFbohuE",278,0.996416,27,279,1,278,1,1,0,1,1,138,137,141,141,71
"6648",47,"[27]BoIoHcotHnJHGqKCeJtykFbohuE",283,0.996479,27,284,1,283,1,1,0,1,1,134,133,150,150,71
"6649",48,"[27]BoIoHcotHnJHGqKCeJtykFbohuE",284,0.996491,27,285,1,284,1,1,0,1,1,144,143,141,141,71
"6650",49,"[27]BoIoHcotHnJHGqKCeJtykFbohuE",283,0.996479,27,284,1,283,1,1,0,1,1,154,153,130,130,71
"6651",50,"[27]BoIoHcotHnJHGqKCeJtykFbohuE",287,0.996528,27,288,1,287,1,1,0,1,1,143,142,145,145,71
"6652",51,"[27]BoIoHcotHnJHGqKCeJtykFbohuE",282,0.996466,27,283,1,282,1,1,0,1,1,151,150,132,132,71
"6653",52,"[27]BoIoHcotHnJHGqKCeJtykFbohuE",285,0.996503,27,286,1,285,1,1,0,1,1,142,141,144,144,71
"6654",53,"[27]BoIoHcotHnJHGqKCeJtykFbohuE",292,0.996587,27,293,1,292,1,1,0,1,1,165,164,128,128,71
"6655",54,"[27]BoIoHcotHnJHGqKCeJtykFbohuE",287,0.996528,27,288,1,287,1,1,0,1,1,160,159,128,128,71
"6656",55,"[27]BoIoHcotHnJHGqKCeJtykFbohuE",279,0.996429,27,280,1,279,1,1,0,1,1,148,147,132,132,71
"6657",56,"[27]BoIoHcotHnJHGqKCeJtykFbohuE",282,0.996466,27,283,1,282,1,1,0,1,1,124,123,159,159,71
"6658",57,"[27]BoIoHcotHnJHGqKCeJtykFbohuE",285,0.996503,27,286,1,285,1,1,0,1,1,148,147,138,138,71
"6659",58,"[27]BoIoHcotHnJHGqKCeJtykFbohuE",281,0.996454,27,282,1,281,1,1,0,1,1,158,157,124,124,71
"6660",59,"[27]BoIoHcotHnJHGqKCeJtykFbohuE",286,0.996516,27,287,1,286,1,1,0,1,1,140,139,147,147,71
"6661",60,"[27]BoIoHcotHnJHGqKCeJtykFbohuE",275,0.996377,27,276,1,275,1,1,0,1,1,154,153,122,122,71
"6662",61,"[27]BoIoHcotHnJHGqKCeJtykFbohuE",279,0.996429,27,280,1,279,1,1,0,1,1,133,132,147,147,71
"6663",62,"[27]BoIoHcotHnJHGqKCeJtykFbohuE",282,0.996466,27,283,1,282,1,1,0,1,1,138,137,145,145,71
"6664",63,"[27]BoIoHcotHnJHGqKCeJtykFbohuE",278,0.996416,27,279,1,278,1,1,0,1,1,139,138,140,140,71
"6665",64,"[27]BoIoHcotHnJHGqKCeJtykFbohuE",279,0.996429,27,280,1,279,1,1,0,1,1,142,141,138,138,71
"6666",65,"[27]BoIoHcotHnJHGqKCeJtykFbohuE",279,0.996429,27,280,1,279,1,1,0,1,1,145,144,135,135,71
"6667",66,"[27]BoIoHcotHnJHGqKCeJtykFbohuE",284,0.996491,27,285,1,284,1,1,0,1,1,144,143,141,141,71
"6668",67,"[27]BoIoHcotHnJHGqKCeJtykFbohuE",281,0.996454,27,282,1,281,1,1,0,1,1,141,140,141,141,71
"6669",68,"[27]BoIoHcotHnJHGqKCeJtykFbohuE",287,0.996528,27,288,1,287,1,1,0,1,1,157,156,131,131,71
"6670",69,"[27]BoIoHcotHnJHGqKCeJtykFbohuE",286,0.996516,27,287,1,286,1,1,0,1,1,145,144,142,142,71
"6671",70,"[27]BoIoHcotHnJHGqKCeJtykFbohuE",286,0.996516,27,287,1,286,1,1,0,1,1,159,158,128,128,71
"6672",71,"[27]BoIoHcotHnJHGqKCeJtykFbohuE",275,0.996377,27,276,1,275,1,1,0,1,1,140,139,136,136,71
"6673",72,"[27]BoIoHcotHnJHGqKCeJtykFbohuE",279,0.996429,27,280,1,279,1,1,0,1,1,144,143,136,136,71
"6674",73,"[27]BoIoHcotHnJHGqKCeJtykFbohuE",277,0.996403,27,278,1,277,1,1,0,1,1,151,150,127,127,71
"6675",74,"[27]BoIoHcotHnJHGqKCeJtykFbohuE",284,0.996491,27,285,1,284,1,1,0,1,1,148,147,137,137,71
"6676",75,"[27]BoIoHcotHnJHGqKCeJtykFbohuE",285,0.996503,27,286,1,285,1,1,0,1,1,148,147,138,138,71
"6677",76,"[27]BoIoHcotHnJHGqKCeJtykFbohuE",280,0.996441,27,281,1,280,1,1,0,1,1,150,149,131,131,71
"6678",77,"[27]BoIoHcotHnJHGqKCeJtykFbohuE",283,0.996479,27,284,1,283,1,1,0,1,1,145,144,139,139,71
"6679",78,"[27]BoIoHcotHnJHGqKCeJtykFbohuE",284,0.996491,27,285,1,284,1,1,0,1,1,137,136,148,148,71
"6680",79,"[27]BoIoHcotHnJHGqKCeJtykFbohuE",284,0.996491,27,285,1,284,1,1,0,1,1,148,147,137,137,71
"6681",80,"[27]BoIoHcotHnJHGqKCeJtykFbohuE",280,0.996441,27,281,1,280,1,1,0,1,1,142,141,139,139,71
"6682",81,"[27]BoIoHcotHnJHGqKCeJtykFbohuE",277,0.996403,27,278,1,277,1,1,0,1,1,144,143,134,134,71
"6683",82,"[27]BoIoHcotHnJHGqKCeJtykFbohuE",290,0.996564,27,291,1,290,1,1,0,1,1,144,143,147,147,71
"6684",83,"[27]BoIoHcotHnJHGqKCeJtykFbohuE",279,0.996429,27,280,1,279,1,1,0,1,1,156,155,124,124,71
"6685",84,"[27]BoIoHcotHnJHGqKCeJtykFbohuE",277,0.996403,27,278,1,277,1,1,0,1,1,120,119,158,158,71
"6686",85,"[27]BoIoHcotHnJHGqKCeJtykFbohuE",283,0.996479,27,284,1,283,1,1,0,1,1,146,145,138,138,71
"6687",86,"[27]BoIoHcotHnJHGqKCeJtykFbohuE",291,0.996575,27,292,1,291,1,1,0,1,1,154,153,138,138,71
"6688",87,"[27]BoIoHcotHnJHGqKCeJtykFbohuE",282,0.996466,27,283,1,282,1,1,0,1,1,155,154,128,128,71
"6689",88,"[27]BoIoHcotHnJHGqKCeJtykFbohuE",283,0.996479,27,284,1,283,1,1,0,1,1,149,148,135,135,71
"6690",89,"[27]BoIoHcotHnJHGqKCeJtykFbohuE",275,0.996377,27,276,1,275,1,1,0,1,1,131,130,145,145,71
"6691",90,"[27]BoIoHcotHnJHGqKCeJtykFbohuE",276,0.99639,27,277,1,276,1,1,0,1,1,134,133,143,143,71
"6692",91,"[27]BoIoHcotHnJHGqKCeJtykFbohuE",283,0.996479,27,284,1,283,1,1,0,1,1,154,153,130,130,71
"6693",92,"[27]BoIoHcotHnJHGqKCeJtykFbohuE",289,0.996552,27,290,1,289,1,1,0,1,1,164,163,126,126,71
"6694",93,"[27]BoIoHcotHnJHGqKCeJtykFbohuE",282,0.996466,27,283,1,282,1,1,0,1,1,146,145,137,137,71
"6695",94,"[27]BoIoHcotHnJHGqKCeJtykFbohuE",280,0.996441,27,281,1,280,1,1,0,1,1,141,140,140,140,71
"6696",95,"[27]BoIoHcotHnJHGqKCeJtykFbohuE",291,0.996575,27,292,1,291,1,1,0,1,1,144,143,148,148,71
"6697",96,"[27]BoIoHcotHnJHGqKCeJtykFbohuE",278,0.996416,27,279,1,278,1,1,0,1,1,148,147,131,131,71
"6698",97,"[27]BoIoHcotHnJHGqKCeJtykFbohuE",272,0.996337,27,273,1,272,1,1,0,1,1,145,144,128,128,71
"6699",98,"[27]BoIoHcotHnJHGqKCeJtykFbohuE",280,0.996441,27,281,1,280,1,1,0,1,1,136,135,145,145,71
"6700",99,"[27]BoIoHcotHnJHGqKCeJtykFbohuE",281,0.996454,27,282,1,281,1,1,0,1,1,150,149,132,132,71
"6701",0,"[22]koIoHcoxHnJHGqKCAwIKzC",275,0.996377,22,276,1,275,1,1,0,1,1,120,119,156,156,72
"6702",1,"[22]koIoHcoxHnJHGqKCAwIKzC",277,0.996403,22,278,1,277,1,1,0,1,1,140,139,138,138,72
"6703",2,"[22]koIoHcoxHnJHGqKCAwIKzC",274,0.996364,22,275,1,274,1,1,0,1,1,136,135,139,139,72
"6704",3,"[22]koIoHcoxHnJHGqKCAwIKzC",282,0.996466,22,283,1,282,1,1,0,1,1,146,145,137,137,72
"6705",4,"[22]koIoHcoxHnJHGqKCAwIKzC",287,0.996528,22,288,1,287,1,1,0,1,1,160,159,128,128,72
"6706",5,"[22]koIoHcoxHnJHGqKCAwIKzC",278,0.996416,22,279,1,278,1,1,0,1,1,132,131,147,147,72
"6707",6,"[22]koIoHcoxHnJHGqKCAwIKzC",278,0.996416,22,279,1,278,1,1,0,1,1,131,130,148,148,72
"6708",7,"[22]koIoHcoxHnJHGqKCAwIKzC",276,0.99639,22,277,1,276,1,1,0,1,1,137,136,140,140,72
"6709",8,"[22]koIoHcoxHnJHGqKCAwIKzC",276,0.99639,22,277,1,276,1,1,0,1,1,123,122,154,154,72
"6710",9,"[22]koIoHcoxHnJHGqKCAwIKzC",284,0.996491,22,285,1,284,1,1,0,1,1,143,142,142,142,72
"6711",10,"[22]koIoHcoxHnJHGqKCAwIKzC",283,0.996479,22,284,1,283,1,1,0,1,1,147,146,137,137,72
"6712",11,"[22]koIoHcoxHnJHGqKCAwIKzC",282,0.996466,22,283,1,282,1,1,0,1,1,144,143,139,139,72
"6713",12,"[22]koIoHcoxHnJHGqKCAwIKzC",279,0.996429,22,280,1,279,1,1,0,1,1,129,128,151,151,72
"6714",13,"[22]koIoHcoxHnJHGqKCAwIKzC",280,0.996441,22,281,1,280,1,1,0,1,1,126,125,155,155,72
"6715",14,"[22]koIoHcoxHnJHGqKCAwIKzC",285,0.996503,22,286,1,285,1,1,0,1,1,141,140,145,145,72
"6716",15,"[22]koIoHcoxHnJHGqKCAwIKzC",285,0.996503,22,286,1,285,1,1,0,1,1,154,153,132,132,72
"6717",16,"[22]koIoHcoxHnJHGqKCAwIKzC",291,0.996575,22,292,1,291,1,1,0,1,1,151,150,141,141,72
"6718",17,"[22]koIoHcoxHnJHGqKCAwIKzC",287,0.996528,22,288,1,287,1,1,0,1,1,149,148,139,139,72
"6719",18,"[22]koIoHcoxHnJHGqKCAwIKzC",283,0.996479,22,284,1,283,1,1,0,1,1,139,138,145,145,72
"6720",19,"[22]koIoHcoxHnJHGqKCAwIKzC",283,0.996479,22,284,1,283,1,1,0,1,1,133,132,151,151,72
"6721",20,"[22]koIoHcoxHnJHGqKCAwIKzC",290,0.996564,22,291,1,290,1,1,0,1,1,145,144,146,146,72
"6722",21,"[22]koIoHcoxHnJHGqKCAwIKzC",275,0.996377,22,276,1,275,1,1,0,1,1,140,139,136,136,72
"6723",22,"[22]koIoHcoxHnJHGqKCAwIKzC",280,0.996441,22,281,1,280,1,1,0,1,1,129,128,152,152,72
"6724",23,"[22]koIoHcoxHnJHGqKCAwIKzC",282,0.996466,22,283,1,282,1,1,0,1,1,142,141,141,141,72
"6725",24,"[22]koIoHcoxHnJHGqKCAwIKzC",282,0.996466,22,283,1,282,1,1,0,1,1,136,135,147,147,72
"6726",25,"[22]koIoHcoxHnJHGqKCAwIKzC",282,0.996466,22,283,1,282,1,1,0,1,1,147,146,136,136,72
"6727",26,"[22]koIoHcoxHnJHGqKCAwIKzC",280,0.996441,22,281,1,280,1,1,0,1,1,137,136,144,144,72
"6728",27,"[22]koIoHcoxHnJHGqKCAwIKzC",284,0.996491,22,285,1,284,1,1,0,1,1,153,152,132,132,72
"6729",28,"[22]koIoHcoxHnJHGqKCAwIKzC",286,0.996516,22,287,1,286,1,1,0,1,1,160,159,127,127,72
"6730",29,"[22]koIoHcoxHnJHGqKCAwIKzC",279,0.996429,22,280,1,279,1,1,0,1,1,138,137,142,142,72
"6731",30,"[22]koIoHcoxHnJHGqKCAwIKzC",279,0.996429,22,280,1,279,1,1,0,1,1,139,138,141,141,72
"6732",31,"[22]koIoHcoxHnJHGqKCAwIKzC",277,0.996403,22,278,1,277,1,1,0,1,1,131,130,147,147,72
"6733",32,"[22]koIoHcoxHnJHGqKCAwIKzC",284,0.996491,22,285,1,284,1,1,0,1,1,147,146,138,138,72
"6734",33,"[22]koIoHcoxHnJHGqKCAwIKzC",286,0.996516,22,287,1,286,1,1,0,1,1,147,146,140,140,72
"6735",34,"[22]koIoHcoxHnJHGqKCAwIKzC",281,0.996454,22,282,1,281,1,1,0,1,1,151,150,131,131,72
"6736",35,"[22]koIoHcoxHnJHGqKCAwIKzC",277,0.996403,22,278,1,277,1,1,0,1,1,143,142,135,135,72
"6737",36,"[22]koIoHcoxHnJHGqKCAwIKzC",283,0.996479,22,284,1,283,1,1,0,1,1,143,142,141,141,72
"6738",37,"[22]koIoHcoxHnJHGqKCAwIKzC",277,0.996403,22,278,1,277,1,1,0,1,1,140,139,138,138,72
"6739",38,"[22]koIoHcoxHnJHGqKCAwIKzC",279,0.996429,22,280,1,279,1,1,0,1,1,141,140,139,139,72
"6740",39,"[22]koIoHcoxHnJHGqKCAwIKzC",282,0.996466,22,283,1,282,1,1,0,1,1,150,149,133,133,72
"6741",40,"[22]koIoHcoxHnJHGqKCAwIKzC",279,0.996429,22,280,1,279,1,1,0,1,1,142,141,138,138,72
"6742",41,"[22]koIoHcoxHnJHGqKCAwIKzC",282,0.996466,22,283,1,282,1,1,0,1,1,161,160,122,122,72
"6743",42,"[22]koIoHcoxHnJHGqKCAwIKzC",286,0.996516,22,287,1,286,1,1,0,1,1,155,154,132,132,72
"6744",43,"[22]koIoHcoxHnJHGqKCAwIKzC",284,0.996491,22,285,1,284,1,1,0,1,1,144,143,141,141,72
"6745",44,"[22]koIoHcoxHnJHGqKCAwIKzC",280,0.996441,22,281,1,280,1,1,0,1,1,145,144,136,136,72
"6746",45,"[22]koIoHcoxHnJHGqKCAwIKzC",290,0.996564,22,291,1,290,1,1,0,1,1,154,153,137,137,72
"6747",46,"[22]koIoHcoxHnJHGqKCAwIKzC",278,0.996416,22,279,1,278,1,1,0,1,1,138,137,141,141,72
"6748",47,"[22]koIoHcoxHnJHGqKCAwIKzC",285,0.996503,22,286,1,285,1,1,0,1,1,147,146,139,139,72
"6749",48,"[22]koIoHcoxHnJHGqKCAwIKzC",278,0.996416,22,279,1,278,1,1,0,1,1,129,128,150,150,72
"6750",49,"[22]koIoHcoxHnJHGqKCAwIKzC",287,0.996528,22,288,1,287,1,1,0,1,1,153,152,135,135,72
"6751",50,"[22]koIoHcoxHnJHGqKCAwIKzC",283,0.996479,22,284,1,283,1,1,0,1,1,155,154,129,129,72
"6752",51,"[22]koIoHcoxHnJHGqKCAwIKzC",288,0.99654,22,289,1,288,1,1,0,1,1,151,150,138,138,72
"6753",52,"[22]koIoHcoxHnJHGqKCAwIKzC",282,0.996466,22,283,1,282,1,1,0,1,1,135,134,148,148,72
"6754",53,"[22]koIoHcoxHnJHGqKCAwIKzC",281,0.996454,22,282,1,281,1,1,0,1,1,141,140,141,141,72
"6755",54,"[22]koIoHcoxHnJHGqKCAwIKzC",278,0.996416,22,279,1,278,1,1,0,1,1,137,136,142,142,72
"6756",55,"[22]koIoHcoxHnJHGqKCAwIKzC",280,0.996441,22,281,1,280,1,1,0,1,1,146,145,135,135,72
"6757",56,"[22]koIoHcoxHnJHGqKCAwIKzC",279,0.996429,22,280,1,279,1,1,0,1,1,130,129,150,150,72
"6758",57,"[22]koIoHcoxHnJHGqKCAwIKzC",283,0.996479,22,284,1,283,1,1,0,1,1,134,133,150,150,72
"6759",58,"[22]koIoHcoxHnJHGqKCAwIKzC",284,0.996491,22,285,1,284,1,1,0,1,1,144,143,141,141,72
"6760",59,"[22]koIoHcoxHnJHGqKCAwIKzC",279,0.996429,22,280,1,279,1,1,0,1,1,140,139,140,140,72
"6761",60,"[22]koIoHcoxHnJHGqKCAwIKzC",286,0.996516,22,287,1,286,1,1,0,1,1,144,143,143,143,72
"6762",61,"[22]koIoHcoxHnJHGqKCAwIKzC",279,0.996429,22,280,1,279,1,1,0,1,1,133,132,147,147,72
"6763",62,"[22]koIoHcoxHnJHGqKCAwIKzC",277,0.996403,22,278,1,277,1,1,0,1,1,142,141,136,136,72
"6764",63,"[22]koIoHcoxHnJHGqKCAwIKzC",275,0.996377,22,276,1,275,1,1,0,1,1,137,136,139,139,72
"6765",64,"[22]koIoHcoxHnJHGqKCAwIKzC",285,0.996503,22,286,1,285,1,1,0,1,1,145,144,141,141,72
"6766",65,"[22]koIoHcoxHnJHGqKCAwIKzC",286,0.996516,22,287,1,286,1,1,0,1,1,142,141,145,145,72
"6767",66,"[22]koIoHcoxHnJHGqKCAwIKzC",273,0.99635,22,274,1,273,1,1,0,1,1,123,122,151,151,72
"6768",67,"[22]koIoHcoxHnJHGqKCAwIKzC",284,0.996491,22,285,1,284,1,1,0,1,1,160,159,125,125,72
"6769",68,"[22]koIoHcoxHnJHGqKCAwIKzC",282,0.996466,22,283,1,282,1,1,0,1,1,146,145,137,137,72
"6770",69,"[22]koIoHcoxHnJHGqKCAwIKzC",285,0.996503,22,286,1,285,1,1,0,1,1,156,155,130,130,72
"6771",70,"[22]koIoHcoxHnJHGqKCAwIKzC",283,0.996479,22,284,1,283,1,1,0,1,1,132,131,152,152,72
"6772",71,"[22]koIoHcoxHnJHGqKCAwIKzC",276,0.99639,22,277,1,276,1,1,0,1,1,143,142,134,134,72
"6773",72,"[22]koIoHcoxHnJHGqKCAwIKzC",284,0.996491,22,285,1,284,1,1,0,1,1,147,146,138,138,72
"6774",73,"[22]koIoHcoxHnJHGqKCAwIKzC",281,0.996454,22,282,1,281,1,1,0,1,1,146,145,136,136,72
"6775",74,"[22]koIoHcoxHnJHGqKCAwIKzC",278,0.996416,22,279,1,278,1,1,0,1,1,134,133,145,145,72
"6776",75,"[22]koIoHcoxHnJHGqKCAwIKzC",280,0.996441,22,281,1,280,1,1,0,1,1,140,139,141,141,72
"6777",76,"[22]koIoHcoxHnJHGqKCAwIKzC",287,0.996528,22,288,1,287,1,1,0,1,1,156,155,132,132,72
"6778",77,"[22]koIoHcoxHnJHGqKCAwIKzC",283,0.996479,22,284,1,283,1,1,0,1,1,146,145,138,138,72
"6779",78,"[22]koIoHcoxHnJHGqKCAwIKzC",291,0.996575,22,292,1,291,1,1,0,1,1,152,151,140,140,72
"6780",79,"[22]koIoHcoxHnJHGqKCAwIKzC",285,0.996503,22,286,1,285,1,1,0,1,1,145,144,141,141,72
"6781",80,"[22]koIoHcoxHnJHGqKCAwIKzC",286,0.996516,22,287,1,286,1,1,0,1,1,155,154,132,132,72
"6782",81,"[22]koIoHcoxHnJHGqKCAwIKzC",281,0.996454,22,282,1,281,1,1,0,1,1,147,146,135,135,72
"6783",82,"[22]koIoHcoxHnJHGqKCAwIKzC",288,0.99654,22,289,1,288,1,1,0,1,1,138,137,151,151,72
"6784",83,"[22]koIoHcoxHnJHGqKCAwIKzC",287,0.996528,22,288,1,287,1,1,0,1,1,141,140,147,147,72
"6785",84,"[22]koIoHcoxHnJHGqKCAwIKzC",277,0.996403,22,278,1,277,1,1,0,1,1,142,141,136,136,72
"6786",85,"[22]koIoHcoxHnJHGqKCAwIKzC",292,0.996587,22,293,1,292,1,1,0,1,1,140,139,153,153,72
"6787",86,"[22]koIoHcoxHnJHGqKCAwIKzC",282,0.996466,22,283,1,282,1,1,0,1,1,139,138,144,144,72
"6788",87,"[22]koIoHcoxHnJHGqKCAwIKzC",277,0.996403,22,278,1,277,1,1,0,1,1,146,145,132,132,72
"6789",88,"[22]koIoHcoxHnJHGqKCAwIKzC",287,0.996528,22,288,1,287,1,1,0,1,1,134,133,154,154,72
"6790",89,"[22]koIoHcoxHnJHGqKCAwIKzC",286,0.996516,22,287,1,286,1,1,0,1,1,133,132,154,154,72
"6791",90,"[22]koIoHcoxHnJHGqKCAwIKzC",278,0.996416,22,279,1,278,1,1,0,1,1,128,127,151,151,72
"6792",91,"[22]koIoHcoxHnJHGqKCAwIKzC",276,0.99639,22,277,1,276,1,1,0,1,1,132,131,145,145,72
"6793",92,"[22]koIoHcoxHnJHGqKCAwIKzC",272,0.996337,22,273,1,272,1,1,0,1,1,128,127,145,145,72
"6794",93,"[22]koIoHcoxHnJHGqKCAwIKzC",277,0.996403,22,278,1,277,1,1,0,1,1,148,147,130,130,72
"6795",94,"[22]koIoHcoxHnJHGqKCAwIKzC",278,0.996416,22,279,1,278,1,1,0,1,1,128,127,151,151,72
"6796",95,"[22]koIoHcoxHnJHGqKCAwIKzC",276,0.99639,22,277,1,276,1,1,0,1,1,137,136,140,140,72
"6797",96,"[22]koIoHcoxHnJHGqKCAwIKzC",287,0.996528,22,288,1,287,1,1,0,1,1,157,156,131,131,72
"6798",97,"[22]koIoHcoxHnJHGqKCAwIKzC",285,0.996503,22,286,1,285,1,1,0,1,1,132,131,154,154,72
"6799",98,"[22]koIoHcoxHnJHGqKCAwIKzC",277,0.996403,22,278,1,277,1,1,0,1,1,128,127,150,150,72
"6800",99,"[22]koIoHcoxHnJHGqKCAwIKzC",279,0.996429,22,280,1,279,1,1,0,1,1,118,117,162,162,72
"6801",0,"[22]joIoHcoxHnJHGqKCJpnbGb",284,0.996491,22,285,1,284,1,1,0,1,1,138,137,147,147,73
"6802",1,"[22]joIoHcoxHnJHGqKCJpnbGb",281,0.996454,22,282,1,281,1,1,0,1,1,145,144,137,137,73
"6803",2,"[22]joIoHcoxHnJHGqKCJpnbGb",283,0.996479,22,284,1,283,1,1,0,1,1,145,144,139,139,73
"6804",3,"[22]joIoHcoxHnJHGqKCJpnbGb",279,0.996429,22,280,1,279,1,1,0,1,1,138,137,142,142,73
"6805",4,"[22]joIoHcoxHnJHGqKCJpnbGb",285,0.996503,22,286,1,285,1,1,0,1,1,148,147,138,138,73
"6806",5,"[22]joIoHcoxHnJHGqKCJpnbGb",278,0.996416,22,279,1,278,1,1,0,1,1,128,127,151,151,73
"6807",6,"[22]joIoHcoxHnJHGqKCJpnbGb",280,0.996441,22,281,1,280,1,1,0,1,1,146,145,135,135,73
"6808",7,"[22]joIoHcoxHnJHGqKCJpnbGb",284,0.996491,22,285,1,284,1,1,0,1,1,146,145,139,139,73
"6809",8,"[22]joIoHcoxHnJHGqKCJpnbGb",285,0.996503,22,286,1,285,1,1,0,1,1,150,149,136,136,73
"6810",9,"[22]joIoHcoxHnJHGqKCJpnbGb",287,0.996528,22,288,1,287,1,1,0,1,1,148,147,140,140,73
"6811",10,"[22]joIoHcoxHnJHGqKCJpnbGb",279,0.996429,22,280,1,279,1,1,0,1,1,143,142,137,137,73
"6812",11,"[22]joIoHcoxHnJHGqKCJpnbGb",287,0.996528,22,288,1,287,1,1,0,1,1,148,147,140,140,73
"6813",12,"[22]joIoHcoxHnJHGqKCJpnbGb",287,0.996528,22,288,1,287,1,1,0,1,1,150,149,138,138,73
"6814",13,"[22]joIoHcoxHnJHGqKCJpnbGb",278,0.996416,22,279,1,278,1,1,0,1,1,141,140,138,138,73
"6815",14,"[22]joIoHcoxHnJHGqKCJpnbGb",275,0.996377,22,276,1,275,1,1,0,1,1,111,110,165,165,73
"6816",15,"[22]joIoHcoxHnJHGqKCJpnbGb",286,0.996516,22,287,1,286,1,1,0,1,1,144,143,143,143,73
"6817",16,"[22]joIoHcoxHnJHGqKCJpnbGb",285,0.996503,22,286,1,285,1,1,0,1,1,144,143,142,142,73
"6818",17,"[22]joIoHcoxHnJHGqKCJpnbGb",282,0.996466,22,283,1,282,1,1,0,1,1,125,124,158,158,73
"6819",18,"[22]joIoHcoxHnJHGqKCJpnbGb",283,0.996479,22,284,1,283,1,1,0,1,1,153,152,131,131,73
"6820",19,"[22]joIoHcoxHnJHGqKCJpnbGb",281,0.996454,22,282,1,281,1,1,0,1,1,146,145,136,136,73
"6821",20,"[22]joIoHcoxHnJHGqKCJpnbGb",281,0.996454,22,282,1,281,1,1,0,1,1,138,137,144,144,73
"6822",21,"[22]joIoHcoxHnJHGqKCJpnbGb",279,0.996429,22,280,1,279,1,1,0,1,1,135,134,145,145,73
"6823",22,"[22]joIoHcoxHnJHGqKCJpnbGb",275,0.996377,22,276,1,275,1,1,0,1,1,146,145,130,130,73
"6824",23,"[22]joIoHcoxHnJHGqKCJpnbGb",280,0.996441,22,281,1,280,1,1,0,1,1,133,132,148,148,73
"6825",24,"[22]joIoHcoxHnJHGqKCJpnbGb",274,0.996364,22,275,1,274,1,1,0,1,1,131,130,144,144,73
"6826",25,"[22]joIoHcoxHnJHGqKCJpnbGb",284,0.996491,22,285,1,284,1,1,0,1,1,155,154,130,130,73
"6827",26,"[22]joIoHcoxHnJHGqKCJpnbGb",279,0.996429,22,280,1,279,1,1,0,1,1,143,142,137,137,73
"6828",27,"[22]joIoHcoxHnJHGqKCJpnbGb",284,0.996491,22,285,1,284,1,1,0,1,1,152,151,133,133,73
"6829",28,"[22]joIoHcoxHnJHGqKCJpnbGb",281,0.996454,22,282,1,281,1,1,0,1,1,137,136,145,145,73
"6830",29,"[22]joIoHcoxHnJHGqKCJpnbGb",276,0.99639,22,277,1,276,1,1,0,1,1,136,135,141,141,73
"6831",30,"[22]joIoHcoxHnJHGqKCJpnbGb",279,0.996429,22,280,1,279,1,1,0,1,1,141,140,139,139,73
"6832",31,"[22]joIoHcoxHnJHGqKCJpnbGb",276,0.99639,22,277,1,276,1,1,0,1,1,128,127,149,149,73
"6833",32,"[22]joIoHcoxHnJHGqKCJpnbGb",283,0.996479,22,284,1,283,1,1,0,1,1,124,123,160,160,73
"6834",33,"[22]joIoHcoxHnJHGqKCJpnbGb",276,0.99639,22,277,1,276,1,1,0,1,1,156,155,121,121,73
"6835",34,"[22]joIoHcoxHnJHGqKCJpnbGb",284,0.996491,22,285,1,284,1,1,0,1,1,144,143,141,141,73
"6836",35,"[22]joIoHcoxHnJHGqKCJpnbGb",277,0.996403,22,278,1,277,1,1,0,1,1,138,137,140,140,73
"6837",36,"[22]joIoHcoxHnJHGqKCJpnbGb",283,0.996479,22,284,1,283,1,1,0,1,1,147,146,137,137,73
"6838",37,"[22]joIoHcoxHnJHGqKCJpnbGb",282,0.996466,22,283,1,282,1,1,0,1,1,146,145,137,137,73
"6839",38,"[22]joIoHcoxHnJHGqKCJpnbGb",281,0.996454,22,282,1,281,1,1,0,1,1,143,142,139,139,73
"6840",39,"[22]joIoHcoxHnJHGqKCJpnbGb",279,0.996429,22,280,1,279,1,1,0,1,1,140,139,140,140,73
"6841",40,"[22]joIoHcoxHnJHGqKCJpnbGb",278,0.996416,22,279,1,278,1,1,0,1,1,131,130,148,148,73
"6842",41,"[22]joIoHcoxHnJHGqKCJpnbGb",281,0.996454,22,282,1,281,1,1,0,1,1,141,140,141,141,73
"6843",42,"[22]joIoHcoxHnJHGqKCJpnbGb",285,0.996503,22,286,1,285,1,1,0,1,1,134,133,152,152,73
"6844",43,"[22]joIoHcoxHnJHGqKCJpnbGb",284,0.996491,22,285,1,284,1,1,0,1,1,141,140,144,144,73
"6845",44,"[22]joIoHcoxHnJHGqKCJpnbGb",284,0.996491,22,285,1,284,1,1,0,1,1,156,155,129,129,73
"6846",45,"[22]joIoHcoxHnJHGqKCJpnbGb",286,0.996516,22,287,1,286,1,1,0,1,1,151,150,136,136,73
"6847",46,"[22]joIoHcoxHnJHGqKCJpnbGb",277,0.996403,22,278,1,277,1,1,0,1,1,126,125,152,152,73
"6848",47,"[22]joIoHcoxHnJHGqKCJpnbGb",281,0.996454,22,282,1,281,1,1,0,1,1,155,154,127,127,73
"6849",48,"[22]joIoHcoxHnJHGqKCJpnbGb",281,0.996454,22,282,1,281,1,1,0,1,1,133,132,149,149,73
"6850",49,"[22]joIoHcoxHnJHGqKCJpnbGb",278,0.996416,22,279,1,278,1,1,0,1,1,136,135,143,143,73
"6851",50,"[22]joIoHcoxHnJHGqKCJpnbGb",279,0.996429,22,280,1,279,1,1,0,1,1,145,144,135,135,73
"6852",51,"[22]joIoHcoxHnJHGqKCJpnbGb",282,0.996466,22,283,1,282,1,1,0,1,1,140,139,143,143,73
"6853",52,"[22]joIoHcoxHnJHGqKCJpnbGb",273,0.99635,22,274,1,273,1,1,0,1,1,129,128,145,145,73
"6854",53,"[22]joIoHcoxHnJHGqKCJpnbGb",280,0.996441,22,281,1,280,1,1,0,1,1,148,147,133,133,73
"6855",54,"[22]joIoHcoxHnJHGqKCJpnbGb",280,0.996441,22,281,1,280,1,1,0,1,1,136,135,145,145,73
"6856",55,"[22]joIoHcoxHnJHGqKCJpnbGb",284,0.996491,22,285,1,284,1,1,0,1,1,149,148,136,136,73
"6857",56,"[22]joIoHcoxHnJHGqKCJpnbGb",281,0.996454,22,282,1,281,1,1,0,1,1,145,144,137,137,73
"6858",57,"[22]joIoHcoxHnJHGqKCJpnbGb",282,0.996466,22,283,1,282,1,1,0,1,1,128,127,155,155,73
"6859",58,"[22]joIoHcoxHnJHGqKCJpnbGb",280,0.996441,22,281,1,280,1,1,0,1,1,141,140,140,140,73
"6860",59,"[22]joIoHcoxHnJHGqKCJpnbGb",285,0.996503,22,286,1,285,1,1,0,1,1,152,151,134,134,73
"6861",60,"[22]joIoHcoxHnJHGqKCJpnbGb",276,0.99639,22,277,1,276,1,1,0,1,1,138,137,139,139,73
"6862",61,"[22]joIoHcoxHnJHGqKCJpnbGb",285,0.996503,22,286,1,285,1,1,0,1,1,148,147,138,138,73
"6863",62,"[22]joIoHcoxHnJHGqKCJpnbGb",279,0.996429,22,280,1,279,1,1,0,1,1,141,140,139,139,73
"6864",63,"[22]joIoHcoxHnJHGqKCJpnbGb",293,0.996599,22,294,1,293,1,1,0,1,1,154,153,140,140,73
"6865",64,"[22]joIoHcoxHnJHGqKCJpnbGb",286,0.996516,22,287,1,286,1,1,0,1,1,148,147,139,139,73
"6866",65,"[22]joIoHcoxHnJHGqKCJpnbGb",286,0.996516,22,287,1,286,1,1,0,1,1,141,140,146,146,73
"6867",66,"[22]joIoHcoxHnJHGqKCJpnbGb",284,0.996491,22,285,1,284,1,1,0,1,1,143,142,142,142,73
"6868",67,"[22]joIoHcoxHnJHGqKCJpnbGb",277,0.996403,22,278,1,277,1,1,0,1,1,142,141,136,136,73
"6869",68,"[22]joIoHcoxHnJHGqKCJpnbGb",282,0.996466,22,283,1,282,1,1,0,1,1,160,159,123,123,73
"6870",69,"[22]joIoHcoxHnJHGqKCJpnbGb",286,0.996516,22,287,1,286,1,1,0,1,1,159,158,128,128,73
"6871",70,"[22]joIoHcoxHnJHGqKCJpnbGb",284,0.996491,22,285,1,284,1,1,0,1,1,144,143,141,141,73
"6872",71,"[22]joIoHcoxHnJHGqKCJpnbGb",281,0.996454,22,282,1,281,1,1,0,1,1,151,150,131,131,73
"6873",72,"[22]joIoHcoxHnJHGqKCJpnbGb",282,0.996466,22,283,1,282,1,1,0,1,1,161,160,122,122,73
"6874",73,"[22]joIoHcoxHnJHGqKCJpnbGb",281,0.996454,22,282,1,281,1,1,0,1,1,128,127,154,154,73
"6875",74,"[22]joIoHcoxHnJHGqKCJpnbGb",283,0.996479,22,284,1,283,1,1,0,1,1,143,142,141,141,73
"6876",75,"[22]joIoHcoxHnJHGqKCJpnbGb",277,0.996403,22,278,1,277,1,1,0,1,1,130,129,148,148,73
"6877",76,"[22]joIoHcoxHnJHGqKCJpnbGb",282,0.996466,22,283,1,282,1,1,0,1,1,145,144,138,138,73
"6878",77,"[22]joIoHcoxHnJHGqKCJpnbGb",276,0.99639,22,277,1,276,1,1,0,1,1,127,126,150,150,73
"6879",78,"[22]joIoHcoxHnJHGqKCJpnbGb",282,0.996466,22,283,1,282,1,1,0,1,1,134,133,149,149,73
"6880",79,"[22]joIoHcoxHnJHGqKCJpnbGb",282,0.996466,22,283,1,282,1,1,0,1,1,143,142,140,140,73
"6881",80,"[22]joIoHcoxHnJHGqKCJpnbGb",276,0.99639,22,277,1,276,1,1,0,1,1,129,128,148,148,73
"6882",81,"[22]joIoHcoxHnJHGqKCJpnbGb",282,0.996466,22,283,1,282,1,1,0,1,1,149,148,134,134,73
"6883",82,"[22]joIoHcoxHnJHGqKCJpnbGb",279,0.996429,22,280,1,279,1,1,0,1,1,130,129,150,150,73
"6884",83,"[22]joIoHcoxHnJHGqKCJpnbGb",281,0.996454,22,282,1,281,1,1,0,1,1,157,156,125,125,73
"6885",84,"[22]joIoHcoxHnJHGqKCJpnbGb",288,0.99654,22,289,1,288,1,1,0,1,1,147,146,142,142,73
"6886",85,"[22]joIoHcoxHnJHGqKCJpnbGb",277,0.996403,22,278,1,277,1,1,0,1,1,132,131,146,146,73
"6887",86,"[22]joIoHcoxHnJHGqKCJpnbGb",282,0.996466,22,283,1,282,1,1,0,1,1,141,140,142,142,73
"6888",87,"[22]joIoHcoxHnJHGqKCJpnbGb",287,0.996528,22,288,1,287,1,1,0,1,1,144,143,144,144,73
"6889",88,"[22]joIoHcoxHnJHGqKCJpnbGb",288,0.99654,22,289,1,288,1,1,0,1,1,165,164,124,124,73
"6890",89,"[22]joIoHcoxHnJHGqKCJpnbGb",287,0.996528,22,288,1,287,1,1,0,1,1,149,148,139,139,73
"6891",90,"[22]joIoHcoxHnJHGqKCJpnbGb",276,0.99639,22,277,1,276,1,1,0,1,1,132,131,145,145,73
"6892",91,"[22]joIoHcoxHnJHGqKCJpnbGb",285,0.996503,22,286,1,285,1,1,0,1,1,138,137,148,148,73
"6893",92,"[22]joIoHcoxHnJHGqKCJpnbGb",285,0.996503,22,286,1,285,1,1,0,1,1,144,143,142,142,73
"6894",93,"[22]joIoHcoxHnJHGqKCJpnbGb",284,0.996491,22,285,1,284,1,1,0,1,1,140,139,145,145,73
"6895",94,"[22]joIoHcoxHnJHGqKCJpnbGb",286,0.996516,22,287,1,286,1,1,0,1,1,146,145,141,141,73
"6896",95,"[22]joIoHcoxHnJHGqKCJpnbGb",278,0.996416,22,279,1,278,1,1,0,1,1,147,146,132,132,73
"6897",96,"[22]joIoHcoxHnJHGqKCJpnbGb",286,0.996516,22,287,1,286,1,1,0,1,1,153,152,134,134,73
"6898",97,"[22]joIoHcoxHnJHGqKCJpnbGb",280,0.996441,22,281,1,280,1,1,0,1,1,147,146,134,134,73
"6899",98,"[22]joIoHcoxHnJHGqKCJpnbGb",290,0.996564,22,291,1,290,1,1,0,1,1,141,140,150,150,73
"6900",99,"[22]joIoHcoxHnJHGqKCJpnbGb",278,0.996416,22,279,1,278,1,1,0,1,1,145,144,134,134,73
"6901",0,"[20]BoIloHcouHnJHGqKChva",277,0.996403,20,278,1,277,1,1,0,1,1,143,142,135,135,74
"6902",1,"[20]BoIloHcouHnJHGqKChva",273,0.99635,20,274,1,273,1,1,0,1,1,146,145,128,128,74
"6903",2,"[20]BoIloHcouHnJHGqKChva",281,0.996454,20,282,1,281,1,1,0,1,1,151,150,131,131,74
"6904",3,"[20]BoIloHcouHnJHGqKChva",283,0.996479,20,284,1,283,1,1,0,1,1,137,136,147,147,74
"6905",4,"[20]BoIloHcouHnJHGqKChva",279,0.996429,20,280,1,279,1,1,0,1,1,133,132,147,147,74
"6906",5,"[20]BoIloHcouHnJHGqKChva",283,0.996479,20,284,1,283,1,1,0,1,1,141,140,143,143,74
"6907",6,"[20]BoIloHcouHnJHGqKChva",291,0.996575,20,292,1,291,1,1,0,1,1,165,164,127,127,74
"6908",7,"[20]BoIloHcouHnJHGqKChva",280,0.996441,20,281,1,280,1,1,0,1,1,149,148,132,132,74
"6909",8,"[20]BoIloHcouHnJHGqKChva",279,0.996429,20,280,1,279,1,1,0,1,1,146,145,134,134,74
"6910",9,"[20]BoIloHcouHnJHGqKChva",279,0.996429,20,280,1,279,1,1,0,1,1,135,134,145,145,74
"6911",10,"[20]BoIloHcouHnJHGqKChva",283,0.996479,20,284,1,283,1,1,0,1,1,140,139,144,144,74
"6912",11,"[20]BoIloHcouHnJHGqKChva",280,0.996441,20,281,1,280,1,1,0,1,1,137,136,144,144,74
"6913",12,"[20]BoIloHcouHnJHGqKChva",278,0.996416,20,279,1,278,1,1,0,1,1,130,129,149,149,74
"6914",13,"[20]BoIloHcouHnJHGqKChva",283,0.996479,20,284,1,283,1,1,0,1,1,139,138,145,145,74
"6915",14,"[20]BoIloHcouHnJHGqKChva",279,0.996429,20,280,1,279,1,1,0,1,1,137,136,143,143,74
"6916",15,"[20]BoIloHcouHnJHGqKChva",290,0.996564,20,291,1,290,1,1,0,1,1,140,139,151,151,74
"6917",16,"[20]BoIloHcouHnJHGqKChva",284,0.996491,20,285,1,284,1,1,0,1,1,152,151,133,133,74
"6918",17,"[20]BoIloHcouHnJHGqKChva",285,0.996503,20,286,1,285,1,1,0,1,1,149,148,137,137,74
"6919",18,"[20]BoIloHcouHnJHGqKChva",289,0.996552,20,290,1,289,1,1,0,1,1,149,148,141,141,74
"6920",19,"[20]BoIloHcouHnJHGqKChva",282,0.996466,20,283,1,282,1,1,0,1,1,152,151,131,131,74
"6921",20,"[20]BoIloHcouHnJHGqKChva",280,0.996441,20,281,1,280,1,1,0,1,1,171,170,110,110,74
"6922",21,"[20]BoIloHcouHnJHGqKChva",289,0.996552,20,290,1,289,1,1,0,1,1,145,144,145,145,74
"6923",22,"[20]BoIloHcouHnJHGqKChva",281,0.996454,20,282,1,281,1,1,0,1,1,144,143,138,138,74
"6924",23,"[20]BoIloHcouHnJHGqKChva",275,0.996377,20,276,1,275,1,1,0,1,1,139,138,137,137,74
"6925",24,"[20]BoIloHcouHnJHGqKChva",283,0.996479,20,284,1,283,1,1,0,1,1,144,143,140,140,74
"6926",25,"[20]BoIloHcouHnJHGqKChva",280,0.996441,20,281,1,280,1,1,0,1,1,155,154,126,126,74
"6927",26,"[20]BoIloHcouHnJHGqKChva",280,0.996441,20,281,1,280,1,1,0,1,1,133,132,148,148,74
"6928",27,"[20]BoIloHcouHnJHGqKChva",285,0.996503,20,286,1,285,1,1,0,1,1,151,150,135,135,74
"6929",28,"[20]BoIloHcouHnJHGqKChva",290,0.996564,20,291,1,290,1,1,0,1,1,150,149,141,141,74
"6930",29,"[20]BoIloHcouHnJHGqKChva",284,0.996491,20,285,1,284,1,1,0,1,1,141,140,144,144,74
"6931",30,"[20]BoIloHcouHnJHGqKChva",275,0.996377,20,276,1,275,1,1,0,1,1,120,119,156,156,74
"6932",31,"[20]BoIloHcouHnJHGqKChva",278,0.996416,20,279,1,278,1,1,0,1,1,146,145,133,133,74
"6933",32,"[20]BoIloHcouHnJHGqKChva",275,0.996377,20,276,1,275,1,1,0,1,1,133,132,143,143,74
"6934",33,"[20]BoIloHcouHnJHGqKChva",276,0.99639,20,277,1,276,1,1,0,1,1,123,122,154,154,74
"6935",34,"[20]BoIloHcouHnJHGqKChva",273,0.99635,20,274,1,273,1,1,0,1,1,135,134,139,139,74
"6936",35,"[20]BoIloHcouHnJHGqKChva",274,0.996364,20,275,1,274,1,1,0,1,1,145,144,130,130,74
"6937",36,"[20]BoIloHcouHnJHGqKChva",286,0.996516,20,287,1,286,1,1,0,1,1,151,150,136,136,74
"6938",37,"[20]BoIloHcouHnJHGqKChva",280,0.996441,20,281,1,280,1,1,0,1,1,135,134,146,146,74
"6939",38,"[20]BoIloHcouHnJHGqKChva",285,0.996503,20,286,1,285,1,1,0,1,1,149,148,137,137,74
"6940",39,"[20]BoIloHcouHnJHGqKChva",274,0.996364,20,275,1,274,1,1,0,1,1,135,134,140,140,74
"6941",40,"[20]BoIloHcouHnJHGqKChva",289,0.996552,20,290,1,289,1,1,0,1,1,148,147,142,142,74
"6942",41,"[20]BoIloHcouHnJHGqKChva",280,0.996441,20,281,1,280,1,1,0,1,1,141,140,140,140,74
"6943",42,"[20]BoIloHcouHnJHGqKChva",279,0.996429,20,280,1,279,1,1,0,1,1,127,126,153,153,74
"6944",43,"[20]BoIloHcouHnJHGqKChva",275,0.996377,20,276,1,275,1,1,0,1,1,146,145,130,130,74
"6945",44,"[20]BoIloHcouHnJHGqKChva",276,0.99639,20,277,1,276,1,1,0,1,1,143,142,134,134,74
"6946",45,"[20]BoIloHcouHnJHGqKChva",284,0.996491,20,285,1,284,1,1,0,1,1,143,142,142,142,74
"6947",46,"[20]BoIloHcouHnJHGqKChva",277,0.996403,20,278,1,277,1,1,0,1,1,143,142,135,135,74
"6948",47,"[20]BoIloHcouHnJHGqKChva",283,0.996479,20,284,1,283,1,1,0,1,1,144,143,140,140,74
"6949",48,"[20]BoIloHcouHnJHGqKChva",281,0.996454,20,282,1,281,1,1,0,1,1,150,149,132,132,74
"6950",49,"[20]BoIloHcouHnJHGqKChva",276,0.99639,20,277,1,276,1,1,0,1,1,137,136,140,140,74
"6951",50,"[20]BoIloHcouHnJHGqKChva",273,0.99635,20,274,1,273,1,1,0,1,1,154,153,120,120,74
"6952",51,"[20]BoIloHcouHnJHGqKChva",280,0.996441,20,281,1,280,1,1,0,1,1,142,141,139,139,74
"6953",52,"[20]BoIloHcouHnJHGqKChva",282,0.996466,20,283,1,282,1,1,0,1,1,148,147,135,135,74
"6954",53,"[20]BoIloHcouHnJHGqKChva",278,0.996416,20,279,1,278,1,1,0,1,1,139,138,140,140,74
"6955",54,"[20]BoIloHcouHnJHGqKChva",281,0.996454,20,282,1,281,1,1,0,1,1,141,140,141,141,74
"6956",55,"[20]BoIloHcouHnJHGqKChva",279,0.996429,20,280,1,279,1,1,0,1,1,133,132,147,147,74
"6957",56,"[20]BoIloHcouHnJHGqKChva",279,0.996429,20,280,1,279,1,1,0,1,1,126,125,154,154,74
"6958",57,"[20]BoIloHcouHnJHGqKChva",270,0.99631,20,271,1,270,1,1,0,1,1,127,126,144,144,74
"6959",58,"[20]BoIloHcouHnJHGqKChva",275,0.996377,20,276,1,275,1,1,0,1,1,124,123,152,152,74
"6960",59,"[20]BoIloHcouHnJHGqKChva",278,0.996416,20,279,1,278,1,1,0,1,1,139,138,140,140,74
"6961",60,"[20]BoIloHcouHnJHGqKChva",282,0.996466,20,283,1,282,1,1,0,1,1,148,147,135,135,74
"6962",61,"[20]BoIloHcouHnJHGqKChva",286,0.996516,20,287,1,286,1,1,0,1,1,152,151,135,135,74
"6963",62,"[20]BoIloHcouHnJHGqKChva",283,0.996479,20,284,1,283,1,1,0,1,1,145,144,139,139,74
"6964",63,"[20]BoIloHcouHnJHGqKChva",288,0.99654,20,289,1,288,1,1,0,1,1,155,154,134,134,74
"6965",64,"[20]BoIloHcouHnJHGqKChva",291,0.996575,20,292,1,291,1,1,0,1,1,156,155,136,136,74
"6966",65,"[20]BoIloHcouHnJHGqKChva",270,0.99631,20,271,1,270,1,1,0,1,1,138,137,133,133,74
"6967",66,"[20]BoIloHcouHnJHGqKChva",284,0.996491,20,285,1,284,1,1,0,1,1,140,139,145,145,74
"6968",67,"[20]BoIloHcouHnJHGqKChva",274,0.996364,20,275,1,274,1,1,0,1,1,143,142,132,132,74
"6969",68,"[20]BoIloHcouHnJHGqKChva",278,0.996416,20,279,1,278,1,1,0,1,1,145,144,134,134,74
"6970",69,"[20]BoIloHcouHnJHGqKChva",284,0.996491,20,285,1,284,1,1,0,1,1,165,164,120,120,74
"6971",70,"[20]BoIloHcouHnJHGqKChva",273,0.99635,20,274,1,273,1,1,0,1,1,140,139,134,134,74
"6972",71,"[20]BoIloHcouHnJHGqKChva",280,0.996441,20,281,1,280,1,1,0,1,1,145,144,136,136,74
"6973",72,"[20]BoIloHcouHnJHGqKChva",278,0.996416,20,279,1,278,1,1,0,1,1,138,137,141,141,74
"6974",73,"[20]BoIloHcouHnJHGqKChva",278,0.996416,20,279,1,278,1,1,0,1,1,147,146,132,132,74
"6975",74,"[20]BoIloHcouHnJHGqKChva",279,0.996429,20,280,1,279,1,1,0,1,1,163,162,117,117,74
"6976",75,"[20]BoIloHcouHnJHGqKChva",282,0.996466,20,283,1,282,1,1,0,1,1,144,143,139,139,74
"6977",76,"[20]BoIloHcouHnJHGqKChva",280,0.996441,20,281,1,280,1,1,0,1,1,144,143,137,137,74
"6978",77,"[20]BoIloHcouHnJHGqKChva",281,0.996454,20,282,1,281,1,1,0,1,1,131,130,151,151,74
"6979",78,"[20]BoIloHcouHnJHGqKChva",277,0.996403,20,278,1,277,1,1,0,1,1,137,136,141,141,74
"6980",79,"[20]BoIloHcouHnJHGqKChva",288,0.99654,20,289,1,288,1,1,0,1,1,152,151,137,137,74
"6981",80,"[20]BoIloHcouHnJHGqKChva",268,0.996283,20,269,1,268,1,1,0,1,1,132,131,137,137,74
"6982",81,"[20]BoIloHcouHnJHGqKChva",280,0.996441,20,281,1,280,1,1,0,1,1,136,135,145,145,74
"6983",82,"[20]BoIloHcouHnJHGqKChva",280,0.996441,20,281,1,280,1,1,0,1,1,136,135,145,145,74
"6984",83,"[20]BoIloHcouHnJHGqKChva",284,0.996491,20,285,1,284,1,1,0,1,1,150,149,135,135,74
"6985",84,"[20]BoIloHcouHnJHGqKChva",281,0.996454,20,282,1,281,1,1,0,1,1,138,137,144,144,74
"6986",85,"[20]BoIloHcouHnJHGqKChva",287,0.996528,20,288,1,287,1,1,0,1,1,129,128,159,159,74
"6987",86,"[20]BoIloHcouHnJHGqKChva",277,0.996403,20,278,1,277,1,1,0,1,1,137,136,141,141,74
"6988",87,"[20]BoIloHcouHnJHGqKChva",283,0.996479,20,284,1,283,1,1,0,1,1,138,137,146,146,74
"6989",88,"[20]BoIloHcouHnJHGqKChva",280,0.996441,20,281,1,280,1,1,0,1,1,138,137,143,143,74
"6990",89,"[20]BoIloHcouHnJHGqKChva",284,0.996491,20,285,1,284,1,1,0,1,1,159,158,126,126,74
"6991",90,"[20]BoIloHcouHnJHGqKChva",270,0.99631,20,271,1,270,1,1,0,1,1,135,134,136,136,74
"6992",91,"[20]BoIloHcouHnJHGqKChva",280,0.996441,20,281,1,280,1,1,0,1,1,124,123,157,157,74
"6993",92,"[20]BoIloHcouHnJHGqKChva",286,0.996516,20,287,1,286,1,1,0,1,1,152,151,135,135,74
"6994",93,"[20]BoIloHcouHnJHGqKChva",284,0.996491,20,285,1,284,1,1,0,1,1,162,161,123,123,74
"6995",94,"[20]BoIloHcouHnJHGqKChva",278,0.996416,20,279,1,278,1,1,0,1,1,139,138,140,140,74
"6996",95,"[20]BoIloHcouHnJHGqKChva",273,0.99635,20,274,1,273,1,1,0,1,1,139,138,135,135,74
"6997",96,"[20]BoIloHcouHnJHGqKChva",284,0.996491,20,285,1,284,1,1,0,1,1,148,147,137,137,74
"6998",97,"[20]BoIloHcouHnJHGqKChva",275,0.996377,20,276,1,275,1,1,0,1,1,133,132,143,143,74
"6999",98,"[20]BoIloHcouHnJHGqKChva",290,0.996564,20,291,1,290,1,1,0,1,1,152,151,139,139,74
"7000",99,"[20]BoIloHcouHnJHGqKChva",293,0.996599,20,294,1,293,1,1,0,1,1,161,160,133,133,74
"7001",0,"[22]BjsoIoHcowHnJHGqKCAurE",275,0.996377,22,276,1,275,1,1,0,1,1,139,138,137,137,75
"7002",1,"[22]BjsoIoHcowHnJHGqKCAurE",283,0.996479,22,284,1,283,1,1,0,1,1,139,138,145,145,75
"7003",2,"[22]BjsoIoHcowHnJHGqKCAurE",288,0.99654,22,289,1,288,1,1,0,1,1,149,148,140,140,75
"7004",3,"[22]BjsoIoHcowHnJHGqKCAurE",284,0.996491,22,285,1,284,1,1,0,1,1,144,143,141,141,75
"7005",4,"[22]BjsoIoHcowHnJHGqKCAurE",282,0.996466,22,283,1,282,1,1,0,1,1,137,136,146,146,75
"7006",5,"[22]BjsoIoHcowHnJHGqKCAurE",287,0.996528,22,288,1,287,1,1,0,1,1,151,150,137,137,75
"7007",6,"[22]BjsoIoHcowHnJHGqKCAurE",287,0.996528,22,288,1,287,1,1,0,1,1,137,136,151,151,75
"7008",7,"[22]BjsoIoHcowHnJHGqKCAurE",274,0.996364,22,275,1,274,1,1,0,1,1,121,120,154,154,75
"7009",8,"[22]BjsoIoHcowHnJHGqKCAurE",285,0.996503,22,286,1,285,1,1,0,1,1,156,155,130,130,75
"7010",9,"[22]BjsoIoHcowHnJHGqKCAurE",284,0.996491,22,285,1,284,1,1,0,1,1,141,140,144,144,75
"7011",10,"[22]BjsoIoHcowHnJHGqKCAurE",286,0.996516,22,287,1,286,1,1,0,1,1,140,139,147,147,75
"7012",11,"[22]BjsoIoHcowHnJHGqKCAurE",278,0.996416,22,279,1,278,1,1,0,1,1,134,133,145,145,75
"7013",12,"[22]BjsoIoHcowHnJHGqKCAurE",284,0.996491,22,285,1,284,1,1,0,1,1,150,149,135,135,75
"7014",13,"[22]BjsoIoHcowHnJHGqKCAurE",279,0.996429,22,280,1,279,1,1,0,1,1,132,131,148,148,75
"7015",14,"[22]BjsoIoHcowHnJHGqKCAurE",280,0.996441,22,281,1,280,1,1,0,1,1,130,129,151,151,75
"7016",15,"[22]BjsoIoHcowHnJHGqKCAurE",281,0.996454,22,282,1,281,1,1,0,1,1,134,133,148,148,75
"7017",16,"[22]BjsoIoHcowHnJHGqKCAurE",278,0.996416,22,279,1,278,1,1,0,1,1,137,136,142,142,75
"7018",17,"[22]BjsoIoHcowHnJHGqKCAurE",281,0.996454,22,282,1,281,1,1,0,1,1,145,144,137,137,75
"7019",18,"[22]BjsoIoHcowHnJHGqKCAurE",285,0.996503,22,286,1,285,1,1,0,1,1,144,143,142,142,75
"7020",19,"[22]BjsoIoHcowHnJHGqKCAurE",287,0.996528,22,288,1,287,1,1,0,1,1,146,145,142,142,75
"7021",20,"[22]BjsoIoHcowHnJHGqKCAurE",280,0.996441,22,281,1,280,1,1,0,1,1,133,132,148,148,75
"7022",21,"[22]BjsoIoHcowHnJHGqKCAurE",279,0.996429,22,280,1,279,1,1,0,1,1,128,127,152,152,75
"7023",22,"[22]BjsoIoHcowHnJHGqKCAurE",282,0.996466,22,283,1,282,1,1,0,1,1,137,136,146,146,75
"7024",23,"[22]BjsoIoHcowHnJHGqKCAurE",293,0.996599,22,294,1,293,1,1,0,1,1,165,164,129,129,75
"7025",24,"[22]BjsoIoHcowHnJHGqKCAurE",283,0.996479,22,284,1,283,1,1,0,1,1,139,138,145,145,75
"7026",25,"[22]BjsoIoHcowHnJHGqKCAurE",283,0.996479,22,284,1,283,1,1,0,1,1,133,132,151,151,75
"7027",26,"[22]BjsoIoHcowHnJHGqKCAurE",277,0.996403,22,278,1,277,1,1,0,1,1,139,138,139,139,75
"7028",27,"[22]BjsoIoHcowHnJHGqKCAurE",277,0.996403,22,278,1,277,1,1,0,1,1,124,123,154,154,75
"7029",28,"[22]BjsoIoHcowHnJHGqKCAurE",276,0.99639,22,277,1,276,1,1,0,1,1,130,129,147,147,75
"7030",29,"[22]BjsoIoHcowHnJHGqKCAurE",283,0.996479,22,284,1,283,1,1,0,1,1,132,131,152,152,75
"7031",30,"[22]BjsoIoHcowHnJHGqKCAurE",278,0.996416,22,279,1,278,1,1,0,1,1,149,148,130,130,75
"7032",31,"[22]BjsoIoHcowHnJHGqKCAurE",278,0.996416,22,279,1,278,1,1,0,1,1,145,144,134,134,75
"7033",32,"[22]BjsoIoHcowHnJHGqKCAurE",283,0.996479,22,284,1,283,1,1,0,1,1,133,132,151,151,75
"7034",33,"[22]BjsoIoHcowHnJHGqKCAurE",282,0.996466,22,283,1,282,1,1,0,1,1,132,131,151,151,75
"7035",34,"[22]BjsoIoHcowHnJHGqKCAurE",287,0.996528,22,288,1,287,1,1,0,1,1,143,142,145,145,75
"7036",35,"[22]BjsoIoHcowHnJHGqKCAurE",285,0.996503,22,286,1,285,1,1,0,1,1,153,152,133,133,75
"7037",36,"[22]BjsoIoHcowHnJHGqKCAurE",285,0.996503,22,286,1,285,1,1,0,1,1,151,150,135,135,75
"7038",37,"[22]BjsoIoHcowHnJHGqKCAurE",279,0.996429,22,280,1,279,1,1,0,1,1,137,136,143,143,75
"7039",38,"[22]BjsoIoHcowHnJHGqKCAurE",281,0.996454,22,282,1,281,1,1,0,1,1,135,134,147,147,75
"7040",39,"[22]BjsoIoHcowHnJHGqKCAurE",278,0.996416,22,279,1,278,1,1,0,1,1,145,144,134,134,75
"7041",40,"[22]BjsoIoHcowHnJHGqKCAurE",278,0.996416,22,279,1,278,1,1,0,1,1,138,137,141,141,75
"7042",41,"[22]BjsoIoHcowHnJHGqKCAurE",281,0.996454,22,282,1,281,1,1,0,1,1,137,136,145,145,75
"7043",42,"[22]BjsoIoHcowHnJHGqKCAurE",280,0.996441,22,281,1,280,1,1,0,1,1,151,150,130,130,75
"7044",43,"[22]BjsoIoHcowHnJHGqKCAurE",277,0.996403,22,278,1,277,1,1,0,1,1,123,122,155,155,75
"7045",44,"[22]BjsoIoHcowHnJHGqKCAurE",271,0.996324,22,272,1,271,1,1,0,1,1,121,120,151,151,75
"7046",45,"[22]BjsoIoHcowHnJHGqKCAurE",274,0.996364,22,275,1,274,1,1,0,1,1,122,121,153,153,75
"7047",46,"[22]BjsoIoHcowHnJHGqKCAurE",284,0.996491,22,285,1,284,1,1,0,1,1,157,156,128,128,75
"7048",47,"[22]BjsoIoHcowHnJHGqKCAurE",281,0.996454,22,282,1,281,1,1,0,1,1,143,142,139,139,75
"7049",48,"[22]BjsoIoHcowHnJHGqKCAurE",291,0.996575,22,292,1,291,1,1,0,1,1,155,154,137,137,75
"7050",49,"[22]BjsoIoHcowHnJHGqKCAurE",279,0.996429,22,280,1,279,1,1,0,1,1,147,146,133,133,75
"7051",50,"[22]BjsoIoHcowHnJHGqKCAurE",282,0.996466,22,283,1,282,1,1,0,1,1,138,137,145,145,75
"7052",51,"[22]BjsoIoHcowHnJHGqKCAurE",278,0.996416,22,279,1,278,1,1,0,1,1,153,152,126,126,75
"7053",52,"[22]BjsoIoHcowHnJHGqKCAurE",284,0.996491,22,285,1,284,1,1,0,1,1,146,145,139,139,75
"7054",53,"[22]BjsoIoHcowHnJHGqKCAurE",278,0.996416,22,279,1,278,1,1,0,1,1,131,130,148,148,75
"7055",54,"[22]BjsoIoHcowHnJHGqKCAurE",280,0.996441,22,281,1,280,1,1,0,1,1,141,140,140,140,75
"7056",55,"[22]BjsoIoHcowHnJHGqKCAurE",277,0.996403,22,278,1,277,1,1,0,1,1,146,145,132,132,75
"7057",56,"[22]BjsoIoHcowHnJHGqKCAurE",280,0.996441,22,281,1,280,1,1,0,1,1,134,133,147,147,75
"7058",57,"[22]BjsoIoHcowHnJHGqKCAurE",289,0.996552,22,290,1,289,1,1,0,1,1,148,147,142,142,75
"7059",58,"[22]BjsoIoHcowHnJHGqKCAurE",282,0.996466,22,283,1,282,1,1,0,1,1,166,165,117,117,75
"7060",59,"[22]BjsoIoHcowHnJHGqKCAurE",278,0.996416,22,279,1,278,1,1,0,1,1,143,142,136,136,75
"7061",60,"[22]BjsoIoHcowHnJHGqKCAurE",273,0.99635,22,274,1,273,1,1,0,1,1,125,124,149,149,75
"7062",61,"[22]BjsoIoHcowHnJHGqKCAurE",289,0.996552,22,290,1,289,1,1,0,1,1,155,154,135,135,75
"7063",62,"[22]BjsoIoHcowHnJHGqKCAurE",282,0.996466,22,283,1,282,1,1,0,1,1,132,131,151,151,75
"7064",63,"[22]BjsoIoHcowHnJHGqKCAurE",281,0.996454,22,282,1,281,1,1,0,1,1,142,141,140,140,75
"7065",64,"[22]BjsoIoHcowHnJHGqKCAurE",274,0.996364,22,275,1,274,1,1,0,1,1,145,144,130,130,75
"7066",65,"[22]BjsoIoHcowHnJHGqKCAurE",288,0.99654,22,289,1,288,1,1,0,1,1,145,144,144,144,75
"7067",66,"[22]BjsoIoHcowHnJHGqKCAurE",275,0.996377,22,276,1,275,1,1,0,1,1,141,140,135,135,75
"7068",67,"[22]BjsoIoHcowHnJHGqKCAurE",279,0.996429,22,280,1,279,1,1,0,1,1,129,128,151,151,75
"7069",68,"[22]BjsoIoHcowHnJHGqKCAurE",283,0.996479,22,284,1,283,1,1,0,1,1,135,134,149,149,75
"7070",69,"[22]BjsoIoHcowHnJHGqKCAurE",282,0.996466,22,283,1,282,1,1,0,1,1,150,149,133,133,75
"7071",70,"[22]BjsoIoHcowHnJHGqKCAurE",282,0.996466,22,283,1,282,1,1,0,1,1,139,138,144,144,75
"7072",71,"[22]BjsoIoHcowHnJHGqKCAurE",276,0.99639,22,277,1,276,1,1,0,1,1,137,136,140,140,75
"7073",72,"[22]BjsoIoHcowHnJHGqKCAurE",290,0.996564,22,291,1,290,1,1,0,1,1,153,152,138,138,75
"7074",73,"[22]BjsoIoHcowHnJHGqKCAurE",278,0.996416,22,279,1,278,1,1,0,1,1,155,154,124,124,75
"7075",74,"[22]BjsoIoHcowHnJHGqKCAurE",282,0.996466,22,283,1,282,1,1,0,1,1,148,147,135,135,75
"7076",75,"[22]BjsoIoHcowHnJHGqKCAurE",287,0.996528,22,288,1,287,1,1,0,1,1,152,151,136,136,75
"7077",76,"[22]BjsoIoHcowHnJHGqKCAurE",281,0.996454,22,282,1,281,1,1,0,1,1,145,144,137,137,75
"7078",77,"[22]BjsoIoHcowHnJHGqKCAurE",278,0.996416,22,279,1,278,1,1,0,1,1,141,140,138,138,75
"7079",78,"[22]BjsoIoHcowHnJHGqKCAurE",282,0.996466,22,283,1,282,1,1,0,1,1,137,136,146,146,75
"7080",79,"[22]BjsoIoHcowHnJHGqKCAurE",282,0.996466,22,283,1,282,1,1,0,1,1,142,141,141,141,75
"7081",80,"[22]BjsoIoHcowHnJHGqKCAurE",284,0.996491,22,285,1,284,1,1,0,1,1,142,141,143,143,75
"7082",81,"[22]BjsoIoHcowHnJHGqKCAurE",287,0.996528,22,288,1,287,1,1,0,1,1,135,134,153,153,75
"7083",82,"[22]BjsoIoHcowHnJHGqKCAurE",287,0.996528,22,288,1,287,1,1,0,1,1,149,148,139,139,75
"7084",83,"[22]BjsoIoHcowHnJHGqKCAurE",274,0.996364,22,275,1,274,1,1,0,1,1,136,135,139,139,75
"7085",84,"[22]BjsoIoHcowHnJHGqKCAurE",291,0.996575,22,292,1,291,1,1,0,1,1,175,174,117,117,75
"7086",85,"[22]BjsoIoHcowHnJHGqKCAurE",278,0.996416,22,279,1,278,1,1,0,1,1,142,141,137,137,75
"7087",86,"[22]BjsoIoHcowHnJHGqKCAurE",279,0.996429,22,280,1,279,1,1,0,1,1,137,136,143,143,75
"7088",87,"[22]BjsoIoHcowHnJHGqKCAurE",284,0.996491,22,285,1,284,1,1,0,1,1,146,145,139,139,75
"7089",88,"[22]BjsoIoHcowHnJHGqKCAurE",284,0.996491,22,285,1,284,1,1,0,1,1,147,146,138,138,75
"7090",89,"[22]BjsoIoHcowHnJHGqKCAurE",280,0.996441,22,281,1,280,1,1,0,1,1,146,145,135,135,75
"7091",90,"[22]BjsoIoHcowHnJHGqKCAurE",281,0.996454,22,282,1,281,1,1,0,1,1,146,145,136,136,75
"7092",91,"[22]BjsoIoHcowHnJHGqKCAurE",278,0.996416,22,279,1,278,1,1,0,1,1,140,139,139,139,75
"7093",92,"[22]BjsoIoHcowHnJHGqKCAurE",272,0.996337,22,273,1,272,1,1,0,1,1,133,132,140,140,75
"7094",93,"[22]BjsoIoHcowHnJHGqKCAurE",272,0.996337,22,273,1,272,1,1,0,1,1,138,137,135,135,75
"7095",94,"[22]BjsoIoHcowHnJHGqKCAurE",286,0.996516,22,287,1,286,1,1,0,1,1,144,143,143,143,75
"7096",95,"[22]BjsoIoHcowHnJHGqKCAurE",273,0.99635,22,274,1,273,1,1,0,1,1,137,136,137,137,75
"7097",96,"[22]BjsoIoHcowHnJHGqKCAurE",279,0.996429,22,280,1,279,1,1,0,1,1,134,133,146,146,75
"7098",97,"[22]BjsoIoHcowHnJHGqKCAurE",289,0.996552,22,290,1,289,1,1,0,1,1,159,158,131,131,75
"7099",98,"[22]BjsoIoHcowHnJHGqKCAurE",277,0.996403,22,278,1,277,1,1,0,1,1,127,126,151,151,75
"7100",99,"[22]BjsoIoHcowHnJHGqKCAurE",285,0.996503,22,286,1,285,1,1,0,1,1,129,128,157,157,75
"7101",0,"[24]CHoIoHcovHnJHGqKCugGdwlF",278,0.996416,24,279,1,278,1,1,0,1,1,131,130,148,148,76
"7102",1,"[24]CHoIoHcovHnJHGqKCugGdwlF",288,0.99654,24,289,1,288,1,1,0,1,1,146,145,143,143,76
"7103",2,"[24]CHoIoHcovHnJHGqKCugGdwlF",284,0.996491,24,285,1,284,1,1,0,1,1,147,146,138,138,76
"7104",3,"[24]CHoIoHcovHnJHGqKCugGdwlF",278,0.996416,24,279,1,278,1,1,0,1,1,148,147,131,131,76
"7105",4,"[24]CHoIoHcovHnJHGqKCugGdwlF",283,0.996479,24,284,1,283,1,1,0,1,1,145,144,139,139,76
"7106",5,"[24]CHoIoHcovHnJHGqKCugGdwlF",276,0.99639,24,277,1,276,1,1,0,1,1,141,140,136,136,76
"7107",6,"[24]CHoIoHcovHnJHGqKCugGdwlF",289,0.996552,24,290,1,289,1,1,0,1,1,148,147,142,142,76
"7108",7,"[24]CHoIoHcovHnJHGqKCugGdwlF",280,0.996441,24,281,1,280,1,1,0,1,1,143,142,138,138,76
"7109",8,"[24]CHoIoHcovHnJHGqKCugGdwlF",283,0.996479,24,284,1,283,1,1,0,1,1,140,139,144,144,76
"7110",9,"[24]CHoIoHcovHnJHGqKCugGdwlF",287,0.996528,24,288,1,287,1,1,0,1,1,144,143,144,144,76
"7111",10,"[24]CHoIoHcovHnJHGqKCugGdwlF",274,0.996364,24,275,1,274,1,1,0,1,1,132,131,143,143,76
"7112",11,"[24]CHoIoHcovHnJHGqKCugGdwlF",285,0.996503,24,286,1,285,1,1,0,1,1,138,137,148,148,76
"7113",12,"[24]CHoIoHcovHnJHGqKCugGdwlF",289,0.996552,24,290,1,289,1,1,0,1,1,161,160,129,129,76
"7114",13,"[24]CHoIoHcovHnJHGqKCugGdwlF",284,0.996491,24,285,1,284,1,1,0,1,1,137,136,148,148,76
"7115",14,"[24]CHoIoHcovHnJHGqKCugGdwlF",283,0.996479,24,284,1,283,1,1,0,1,1,150,149,134,134,76
"7116",15,"[24]CHoIoHcovHnJHGqKCugGdwlF",276,0.99639,24,277,1,276,1,1,0,1,1,139,138,138,138,76
"7117",16,"[24]CHoIoHcovHnJHGqKCugGdwlF",276,0.99639,24,277,1,276,1,1,0,1,1,130,129,147,147,76
"7118",17,"[24]CHoIoHcovHnJHGqKCugGdwlF",277,0.996403,24,278,1,277,1,1,0,1,1,133,132,145,145,76
"7119",18,"[24]CHoIoHcovHnJHGqKCugGdwlF",275,0.996377,24,276,1,275,1,1,0,1,1,148,147,128,128,76
"7120",19,"[24]CHoIoHcovHnJHGqKCugGdwlF",273,0.99635,24,274,1,273,1,1,0,1,1,121,120,153,153,76
"7121",20,"[24]CHoIoHcovHnJHGqKCugGdwlF",288,0.99654,24,289,1,288,1,1,0,1,1,170,169,119,119,76
"7122",21,"[24]CHoIoHcovHnJHGqKCugGdwlF",282,0.996466,24,283,1,282,1,1,0,1,1,151,150,132,132,76
"7123",22,"[24]CHoIoHcovHnJHGqKCugGdwlF",285,0.996503,24,286,1,285,1,1,0,1,1,148,147,138,138,76
"7124",23,"[24]CHoIoHcovHnJHGqKCugGdwlF",279,0.996429,24,280,1,279,1,1,0,1,1,139,138,141,141,76
"7125",24,"[24]CHoIoHcovHnJHGqKCugGdwlF",276,0.99639,24,277,1,276,1,1,0,1,1,137,136,140,140,76
"7126",25,"[24]CHoIoHcovHnJHGqKCugGdwlF",293,0.996599,24,294,1,293,1,1,0,1,1,156,155,138,138,76
"7127",26,"[24]CHoIoHcovHnJHGqKCugGdwlF",280,0.996441,24,281,1,280,1,1,0,1,1,142,141,139,139,76
"7128",27,"[24]CHoIoHcovHnJHGqKCugGdwlF",282,0.996466,24,283,1,282,1,1,0,1,1,165,164,118,118,76
"7129",28,"[24]CHoIoHcovHnJHGqKCugGdwlF",285,0.996503,24,286,1,285,1,1,0,1,1,148,147,138,138,76
"7130",29,"[24]CHoIoHcovHnJHGqKCugGdwlF",279,0.996429,24,280,1,279,1,1,0,1,1,141,140,139,139,76
"7131",30,"[24]CHoIoHcovHnJHGqKCugGdwlF",281,0.996454,24,282,1,281,1,1,0,1,1,126,125,156,156,76
"7132",31,"[24]CHoIoHcovHnJHGqKCugGdwlF",286,0.996516,24,287,1,286,1,1,0,1,1,147,146,140,140,76
"7133",32,"[24]CHoIoHcovHnJHGqKCugGdwlF",278,0.996416,24,279,1,278,1,1,0,1,1,131,130,148,148,76
"7134",33,"[24]CHoIoHcovHnJHGqKCugGdwlF",278,0.996416,24,279,1,278,1,1,0,1,1,133,132,146,146,76
"7135",34,"[24]CHoIoHcovHnJHGqKCugGdwlF",289,0.996552,24,290,1,289,1,1,0,1,1,148,147,142,142,76
"7136",35,"[24]CHoIoHcovHnJHGqKCugGdwlF",286,0.996516,24,287,1,286,1,1,0,1,1,150,149,137,137,76
"7137",36,"[24]CHoIoHcovHnJHGqKCugGdwlF",284,0.996491,24,285,1,284,1,1,0,1,1,135,134,150,150,76
"7138",37,"[24]CHoIoHcovHnJHGqKCugGdwlF",279,0.996429,24,280,1,279,1,1,0,1,1,149,148,131,131,76
"7139",38,"[24]CHoIoHcovHnJHGqKCugGdwlF",276,0.99639,24,277,1,276,1,1,0,1,1,153,152,124,124,76
"7140",39,"[24]CHoIoHcovHnJHGqKCugGdwlF",284,0.996491,24,285,1,284,1,1,0,1,1,139,138,146,146,76
"7141",40,"[24]CHoIoHcovHnJHGqKCugGdwlF",282,0.996466,24,283,1,282,1,1,0,1,1,141,140,142,142,76
"7142",41,"[24]CHoIoHcovHnJHGqKCugGdwlF",287,0.996528,24,288,1,287,1,1,0,1,1,135,134,153,153,76
"7143",42,"[24]CHoIoHcovHnJHGqKCugGdwlF",286,0.996516,24,287,1,286,1,1,0,1,1,152,151,135,135,76
"7144",43,"[24]CHoIoHcovHnJHGqKCugGdwlF",281,0.996454,24,282,1,281,1,1,0,1,1,130,129,152,152,76
"7145",44,"[24]CHoIoHcovHnJHGqKCugGdwlF",278,0.996416,24,279,1,278,1,1,0,1,1,140,139,139,139,76
"7146",45,"[24]CHoIoHcovHnJHGqKCugGdwlF",280,0.996441,24,281,1,280,1,1,0,1,1,132,131,149,149,76
"7147",46,"[24]CHoIoHcovHnJHGqKCugGdwlF",281,0.996454,24,282,1,281,1,1,0,1,1,130,129,152,152,76
"7148",47,"[24]CHoIoHcovHnJHGqKCugGdwlF",292,0.996587,24,293,1,292,1,1,0,1,1,155,154,138,138,76
"7149",48,"[24]CHoIoHcovHnJHGqKCugGdwlF",284,0.996491,24,285,1,284,1,1,0,1,1,147,146,138,138,76
"7150",49,"[24]CHoIoHcovHnJHGqKCugGdwlF",266,0.996255,24,267,1,266,1,1,0,1,1,124,123,143,143,76
"7151",50,"[24]CHoIoHcovHnJHGqKCugGdwlF",280,0.996441,24,281,1,280,1,1,0,1,1,145,144,136,136,76
"7152",51,"[24]CHoIoHcovHnJHGqKCugGdwlF",277,0.996403,24,278,1,277,1,1,0,1,1,130,129,148,148,76
"7153",52,"[24]CHoIoHcovHnJHGqKCugGdwlF",278,0.996416,24,279,1,278,1,1,0,1,1,155,154,124,124,76
"7154",53,"[24]CHoIoHcovHnJHGqKCugGdwlF",273,0.99635,24,274,1,273,1,1,0,1,1,132,131,142,142,76
"7155",54,"[24]CHoIoHcovHnJHGqKCugGdwlF",279,0.996429,24,280,1,279,1,1,0,1,1,128,127,152,152,76
"7156",55,"[24]CHoIoHcovHnJHGqKCugGdwlF",284,0.996491,24,285,1,284,1,1,0,1,1,142,141,143,143,76
"7157",56,"[24]CHoIoHcovHnJHGqKCugGdwlF",273,0.99635,24,274,1,273,1,1,0,1,1,137,136,137,137,76
"7158",57,"[24]CHoIoHcovHnJHGqKCugGdwlF",287,0.996528,24,288,1,287,1,1,0,1,1,152,151,136,136,76
"7159",58,"[24]CHoIoHcovHnJHGqKCugGdwlF",284,0.996491,24,285,1,284,1,1,0,1,1,148,147,137,137,76
"7160",59,"[24]CHoIoHcovHnJHGqKCugGdwlF",291,0.996575,24,292,1,291,1,1,0,1,1,149,148,143,143,76
"7161",60,"[24]CHoIoHcovHnJHGqKCugGdwlF",286,0.996516,24,287,1,286,1,1,0,1,1,141,140,146,146,76
"7162",61,"[24]CHoIoHcovHnJHGqKCugGdwlF",286,0.996516,24,287,1,286,1,1,0,1,1,147,146,140,140,76
"7163",62,"[24]CHoIoHcovHnJHGqKCugGdwlF",284,0.996491,24,285,1,284,1,1,0,1,1,137,136,148,148,76
"7164",63,"[24]CHoIoHcovHnJHGqKCugGdwlF",278,0.996416,24,279,1,278,1,1,0,1,1,139,138,140,140,76
"7165",64,"[24]CHoIoHcovHnJHGqKCugGdwlF",285,0.996503,24,286,1,285,1,1,0,1,1,151,150,135,135,76
"7166",65,"[24]CHoIoHcovHnJHGqKCugGdwlF",284,0.996491,24,285,1,284,1,1,0,1,1,153,152,132,132,76
"7167",66,"[24]CHoIoHcovHnJHGqKCugGdwlF",291,0.996575,24,292,1,291,1,1,0,1,1,150,149,142,142,76
"7168",67,"[24]CHoIoHcovHnJHGqKCugGdwlF",288,0.99654,24,289,1,288,1,1,0,1,1,155,154,134,134,76
"7169",68,"[24]CHoIoHcovHnJHGqKCugGdwlF",288,0.99654,24,289,1,288,1,1,0,1,1,140,139,149,149,76
"7170",69,"[24]CHoIoHcovHnJHGqKCugGdwlF",278,0.996416,24,279,1,278,1,1,0,1,1,150,149,129,129,76
"7171",70,"[24]CHoIoHcovHnJHGqKCugGdwlF",285,0.996503,24,286,1,285,1,1,0,1,1,151,150,135,135,76
"7172",71,"[24]CHoIoHcovHnJHGqKCugGdwlF",286,0.996516,24,287,1,286,1,1,0,1,1,147,146,140,140,76
"7173",72,"[24]CHoIoHcovHnJHGqKCugGdwlF",281,0.996454,24,282,1,281,1,1,0,1,1,145,144,137,137,76
"7174",73,"[24]CHoIoHcovHnJHGqKCugGdwlF",287,0.996528,24,288,1,287,1,1,0,1,1,152,151,136,136,76
"7175",74,"[24]CHoIoHcovHnJHGqKCugGdwlF",286,0.996516,24,287,1,286,1,1,0,1,1,158,157,129,129,76
"7176",75,"[24]CHoIoHcovHnJHGqKCugGdwlF",281,0.996454,24,282,1,281,1,1,0,1,1,147,146,135,135,76
"7177",76,"[24]CHoIoHcovHnJHGqKCugGdwlF",279,0.996429,24,280,1,279,1,1,0,1,1,147,146,133,133,76
"7178",77,"[24]CHoIoHcovHnJHGqKCugGdwlF",278,0.996416,24,279,1,278,1,1,0,1,1,150,149,129,129,76
"7179",78,"[24]CHoIoHcovHnJHGqKCugGdwlF",280,0.996441,24,281,1,280,1,1,0,1,1,137,136,144,144,76
"7180",79,"[24]CHoIoHcovHnJHGqKCugGdwlF",282,0.996466,24,283,1,282,1,1,0,1,1,151,150,132,132,76
"7181",80,"[24]CHoIoHcovHnJHGqKCugGdwlF",273,0.99635,24,274,1,273,1,1,0,1,1,124,123,150,150,76
"7182",81,"[24]CHoIoHcovHnJHGqKCugGdwlF",284,0.996491,24,285,1,284,1,1,0,1,1,143,142,142,142,76
"7183",82,"[24]CHoIoHcovHnJHGqKCugGdwlF",274,0.996364,24,275,1,274,1,1,0,1,1,161,160,114,114,76
"7184",83,"[24]CHoIoHcovHnJHGqKCugGdwlF",279,0.996429,24,280,1,279,1,1,0,1,1,147,146,133,133,76
"7185",84,"[24]CHoIoHcovHnJHGqKCugGdwlF",282,0.996466,24,283,1,282,1,1,0,1,1,130,129,153,153,76
"7186",85,"[24]CHoIoHcovHnJHGqKCugGdwlF",283,0.996479,24,284,1,283,1,1,0,1,1,149,148,135,135,76
"7187",86,"[24]CHoIoHcovHnJHGqKCugGdwlF",290,0.996564,24,291,1,290,1,1,0,1,1,168,167,123,123,76
"7188",87,"[24]CHoIoHcovHnJHGqKCugGdwlF",287,0.996528,24,288,1,287,1,1,0,1,1,140,139,148,148,76
"7189",88,"[24]CHoIoHcovHnJHGqKCugGdwlF",289,0.996552,24,290,1,289,1,1,0,1,1,154,153,136,136,76
"7190",89,"[24]CHoIoHcovHnJHGqKCugGdwlF",279,0.996429,24,280,1,279,1,1,0,1,1,129,128,151,151,76
"7191",90,"[24]CHoIoHcovHnJHGqKCugGdwlF",286,0.996516,24,287,1,286,1,1,0,1,1,148,147,139,139,76
"7192",91,"[24]CHoIoHcovHnJHGqKCugGdwlF",286,0.996516,24,287,1,286,1,1,0,1,1,150,149,137,137,76
"7193",92,"[24]CHoIoHcovHnJHGqKCugGdwlF",283,0.996479,24,284,1,283,1,1,0,1,1,145,144,139,139,76
"7194",93,"[24]CHoIoHcovHnJHGqKCugGdwlF",283,0.996479,24,284,1,283,1,1,0,1,1,129,128,155,155,76
"7195",94,"[24]CHoIoHcovHnJHGqKCugGdwlF",278,0.996416,24,279,1,278,1,1,0,1,1,138,137,141,141,76
"7196",95,"[24]CHoIoHcovHnJHGqKCugGdwlF",280,0.996441,24,281,1,280,1,1,0,1,1,150,149,131,131,76
"7197",96,"[24]CHoIoHcovHnJHGqKCugGdwlF",285,0.996503,24,286,1,285,1,1,0,1,1,148,147,138,138,76
"7198",97,"[24]CHoIoHcovHnJHGqKCugGdwlF",281,0.996454,24,282,1,281,1,1,0,1,1,140,139,142,142,76
"7199",98,"[24]CHoIoHcovHnJHGqKCugGdwlF",280,0.996441,24,281,1,280,1,1,0,1,1,147,146,134,134,76
"7200",99,"[24]CHoIoHcovHnJHGqKCugGdwlF",288,0.99654,24,289,1,288,1,1,0,1,1,148,147,141,141,76
"7201",0,"[25]JsHoIoroHcosHnJqGKCeqAExG",305,0.996732,25,306,1,305,1,1,0,1,1,173,172,133,133,77
"7202",1,"[25]JsHoIoroHcosHnJqGKCeqAExG",297,0.996644,25,298,1,297,1,1,0,1,1,145,144,153,153,77
"7203",2,"[25]JsHoIoroHcosHnJqGKCeqAExG",296,0.996633,25,297,1,296,1,1,0,1,1,146,145,151,151,77
"7204",3,"[25]JsHoIoroHcosHnJqGKCeqAExG",290,0.996564,25,291,1,290,1,1,0,1,1,135,134,156,156,77
"7205",4,"[25]JsHoIoroHcosHnJqGKCeqAExG",296,0.996633,25,297,1,296,1,1,0,1,1,145,144,152,152,77
"7206",5,"[25]JsHoIoroHcosHnJqGKCeqAExG",298,0.996656,25,299,1,298,1,1,0,1,1,151,150,148,148,77
"7207",6,"[25]JsHoIoroHcosHnJqGKCeqAExG",298,0.996656,25,299,1,298,1,1,0,1,1,159,158,140,140,77
"7208",7,"[25]JsHoIoroHcosHnJqGKCeqAExG",299,0.996667,25,300,1,299,1,1,0,1,1,153,152,147,147,77
"7209",8,"[25]JsHoIoroHcosHnJqGKCeqAExG",300,0.996678,25,301,1,300,1,1,0,1,1,162,161,139,139,77
"7210",9,"[25]JsHoIoroHcosHnJqGKCeqAExG",298,0.996656,25,299,1,298,1,1,0,1,1,153,152,146,146,77
"7211",10,"[25]JsHoIoroHcosHnJqGKCeqAExG",305,0.996732,25,306,1,305,1,1,0,1,1,173,172,133,133,77
"7212",11,"[25]JsHoIoroHcosHnJqGKCeqAExG",299,0.996667,25,300,1,299,1,1,0,1,1,152,151,148,148,77
"7213",12,"[25]JsHoIoroHcosHnJqGKCeqAExG",294,0.99661,25,295,1,294,1,1,0,1,1,143,142,152,152,77
"7214",13,"[25]JsHoIoroHcosHnJqGKCeqAExG",301,0.996689,25,302,1,301,1,1,0,1,1,159,158,143,143,77
"7215",14,"[25]JsHoIoroHcosHnJqGKCeqAExG",302,0.9967,25,303,1,302,1,1,0,1,1,160,159,143,143,77
"7216",15,"[25]JsHoIoroHcosHnJqGKCeqAExG",299,0.996667,25,300,1,299,1,1,0,1,1,158,157,142,142,77
"7217",16,"[25]JsHoIoroHcosHnJqGKCeqAExG",296,0.996633,25,297,1,296,1,1,0,1,1,148,147,149,149,77
"7218",17,"[25]JsHoIoroHcosHnJqGKCeqAExG",297,0.996644,25,298,1,297,1,1,0,1,1,150,149,148,148,77
"7219",18,"[25]JsHoIoroHcosHnJqGKCeqAExG",292,0.996587,25,293,1,292,1,1,0,1,1,138,137,155,155,77
"7220",19,"[25]JsHoIoroHcosHnJqGKCeqAExG",291,0.996575,25,292,1,291,1,1,0,1,1,140,139,152,152,77
"7221",20,"[25]JsHoIoroHcosHnJqGKCeqAExG",305,0.996732,25,306,1,305,1,1,0,1,1,164,163,142,142,77
"7222",21,"[25]JsHoIoroHcosHnJqGKCeqAExG",303,0.996711,25,304,1,303,1,1,0,1,1,167,166,137,137,77
"7223",22,"[25]JsHoIoroHcosHnJqGKCeqAExG",296,0.996633,25,297,1,296,1,1,0,1,1,138,137,159,159,77
"7224",23,"[25]JsHoIoroHcosHnJqGKCeqAExG",300,0.996678,25,301,1,300,1,1,0,1,1,149,148,152,152,77
"7225",24,"[25]JsHoIoroHcosHnJqGKCeqAExG",296,0.996633,25,297,1,296,1,1,0,1,1,148,147,149,149,77
"7226",25,"[25]JsHoIoroHcosHnJqGKCeqAExG",293,0.996599,25,294,1,293,1,1,0,1,1,128,127,166,166,77
"7227",26,"[25]JsHoIoroHcosHnJqGKCeqAExG",300,0.996678,25,301,1,300,1,1,0,1,1,163,162,138,138,77
"7228",27,"[25]JsHoIoroHcosHnJqGKCeqAExG",298,0.996656,25,299,1,298,1,1,0,1,1,158,157,141,141,77
"7229",28,"[25]JsHoIoroHcosHnJqGKCeqAExG",305,0.996732,25,306,1,305,1,1,0,1,1,169,168,137,137,77
"7230",29,"[25]JsHoIoroHcosHnJqGKCeqAExG",297,0.996644,25,298,1,297,1,1,0,1,1,152,151,146,146,77
"7231",30,"[25]JsHoIoroHcosHnJqGKCeqAExG",299,0.996667,25,300,1,299,1,1,0,1,1,155,154,145,145,77
"7232",31,"[25]JsHoIoroHcosHnJqGKCeqAExG",298,0.996656,25,299,1,298,1,1,0,1,1,151,150,148,148,77
"7233",32,"[25]JsHoIoroHcosHnJqGKCeqAExG",298,0.996656,25,299,1,298,1,1,0,1,1,149,148,150,150,77
"7234",33,"[25]JsHoIoroHcosHnJqGKCeqAExG",293,0.996599,25,294,1,293,1,1,0,1,1,134,133,160,160,77
"7235",34,"[25]JsHoIoroHcosHnJqGKCeqAExG",299,0.996667,25,300,1,299,1,1,0,1,1,158,157,142,142,77
"7236",35,"[25]JsHoIoroHcosHnJqGKCeqAExG",298,0.996656,25,299,1,298,1,1,0,1,1,150,149,149,149,77
"7237",36,"[25]JsHoIoroHcosHnJqGKCeqAExG",297,0.996644,25,298,1,297,1,1,0,1,1,148,147,150,150,77
"7238",37,"[25]JsHoIoroHcosHnJqGKCeqAExG",298,0.996656,25,299,1,298,1,1,0,1,1,153,152,146,146,77
"7239",38,"[25]JsHoIoroHcosHnJqGKCeqAExG",296,0.996633,25,297,1,296,1,1,0,1,1,150,149,147,147,77
"7240",39,"[25]JsHoIoroHcosHnJqGKCeqAExG",289,0.996552,25,290,1,289,1,1,0,1,1,128,127,162,162,77
"7241",40,"[25]JsHoIoroHcosHnJqGKCeqAExG",300,0.996678,25,301,1,300,1,1,0,1,1,162,161,139,139,77
"7242",41,"[25]JsHoIoroHcosHnJqGKCeqAExG",296,0.996633,25,297,1,296,1,1,0,1,1,150,149,147,147,77
"7243",42,"[25]JsHoIoroHcosHnJqGKCeqAExG",301,0.996689,25,302,1,301,1,1,0,1,1,159,158,143,143,77
"7244",43,"[25]JsHoIoroHcosHnJqGKCeqAExG",300,0.996678,25,301,1,300,1,1,0,1,1,156,155,145,145,77
"7245",44,"[25]JsHoIoroHcosHnJqGKCeqAExG",299,0.996667,25,300,1,299,1,1,0,1,1,154,153,146,146,77
"7246",45,"[25]JsHoIoroHcosHnJqGKCeqAExG",299,0.996667,25,300,1,299,1,1,0,1,1,154,153,146,146,77
"7247",46,"[25]JsHoIoroHcosHnJqGKCeqAExG",300,0.996678,25,301,1,300,1,1,0,1,1,162,161,139,139,77
"7248",47,"[25]JsHoIoroHcosHnJqGKCeqAExG",300,0.996678,25,301,1,300,1,1,0,1,1,153,152,148,148,77
"7249",48,"[25]JsHoIoroHcosHnJqGKCeqAExG",299,0.996667,25,300,1,299,1,1,0,1,1,154,153,146,146,77
"7250",49,"[25]JsHoIoroHcosHnJqGKCeqAExG",293,0.996599,25,294,1,293,1,1,0,1,1,137,136,157,157,77
"7251",50,"[25]JsHoIoroHcosHnJqGKCeqAExG",293,0.996599,25,294,1,293,1,1,0,1,1,136,135,158,158,77
"7252",51,"[25]JsHoIoroHcosHnJqGKCeqAExG",294,0.99661,25,295,1,294,1,1,0,1,1,139,138,156,156,77
"7253",52,"[25]JsHoIoroHcosHnJqGKCeqAExG",297,0.996644,25,298,1,297,1,1,0,1,1,151,150,147,147,77
"7254",53,"[25]JsHoIoroHcosHnJqGKCeqAExG",298,0.996656,25,299,1,298,1,1,0,1,1,145,144,154,154,77
"7255",54,"[25]JsHoIoroHcosHnJqGKCeqAExG",299,0.996667,25,300,1,299,1,1,0,1,1,148,147,152,152,77
"7256",55,"[25]JsHoIoroHcosHnJqGKCeqAExG",298,0.996656,25,299,1,298,1,1,0,1,1,151,150,148,148,77
"7257",56,"[25]JsHoIoroHcosHnJqGKCeqAExG",298,0.996656,25,299,1,298,1,1,0,1,1,154,153,145,145,77
"7258",57,"[25]JsHoIoroHcosHnJqGKCeqAExG",301,0.996689,25,302,1,301,1,1,0,1,1,160,159,142,142,77
"7259",58,"[25]JsHoIoroHcosHnJqGKCeqAExG",298,0.996656,25,299,1,298,1,1,0,1,1,150,149,149,149,77
"7260",59,"[25]JsHoIoroHcosHnJqGKCeqAExG",290,0.996564,25,291,1,290,1,1,0,1,1,125,124,166,166,77
"7261",60,"[25]JsHoIoroHcosHnJqGKCeqAExG",298,0.996656,25,299,1,298,1,1,0,1,1,155,154,144,144,77
"7262",61,"[25]JsHoIoroHcosHnJqGKCeqAExG",298,0.996656,25,299,1,298,1,1,0,1,1,151,150,148,148,77
"7263",62,"[25]JsHoIoroHcosHnJqGKCeqAExG",293,0.996599,25,294,1,293,1,1,0,1,1,142,141,152,152,77
"7264",63,"[25]JsHoIoroHcosHnJqGKCeqAExG",295,0.996622,25,296,1,295,1,1,0,1,1,139,138,157,157,77
"7265",64,"[25]JsHoIoroHcosHnJqGKCeqAExG",299,0.996667,25,300,1,299,1,1,0,1,1,155,154,145,145,77
"7266",65,"[25]JsHoIoroHcosHnJqGKCeqAExG",300,0.996678,25,301,1,300,1,1,0,1,1,157,156,144,144,77
"7267",66,"[25]JsHoIoroHcosHnJqGKCeqAExG",296,0.996633,25,297,1,296,1,1,0,1,1,156,155,141,141,77
"7268",67,"[25]JsHoIoroHcosHnJqGKCeqAExG",299,0.996667,25,300,1,299,1,1,0,1,1,151,150,149,149,77
"7269",68,"[25]JsHoIoroHcosHnJqGKCeqAExG",301,0.996689,25,302,1,301,1,1,0,1,1,159,158,143,143,77
"7270",69,"[25]JsHoIoroHcosHnJqGKCeqAExG",287,0.996528,25,288,1,287,1,1,0,1,1,124,123,164,164,77
"7271",70,"[25]JsHoIoroHcosHnJqGKCeqAExG",301,0.996689,25,302,1,301,1,1,0,1,1,156,155,146,146,77
"7272",71,"[25]JsHoIoroHcosHnJqGKCeqAExG",303,0.996711,25,304,1,303,1,1,0,1,1,160,159,144,144,77
"7273",72,"[25]JsHoIoroHcosHnJqGKCeqAExG",295,0.996622,25,296,1,295,1,1,0,1,1,154,153,142,142,77
"7274",73,"[25]JsHoIoroHcosHnJqGKCeqAExG",299,0.996667,25,300,1,299,1,1,0,1,1,157,156,143,143,77
"7275",74,"[25]JsHoIoroHcosHnJqGKCeqAExG",296,0.996633,25,297,1,296,1,1,0,1,1,148,147,149,149,77
"7276",75,"[25]JsHoIoroHcosHnJqGKCeqAExG",297,0.996644,25,298,1,297,1,1,0,1,1,149,148,149,149,77
"7277",76,"[25]JsHoIoroHcosHnJqGKCeqAExG",304,0.996721,25,305,1,304,1,1,0,1,1,165,164,140,140,77
"7278",77,"[25]JsHoIoroHcosHnJqGKCeqAExG",301,0.996689,25,302,1,301,1,1,0,1,1,159,158,143,143,77
"7279",78,"[25]JsHoIoroHcosHnJqGKCeqAExG",294,0.99661,25,295,1,294,1,1,0,1,1,140,139,155,155,77
"7280",79,"[25]JsHoIoroHcosHnJqGKCeqAExG",300,0.996678,25,301,1,300,1,1,0,1,1,161,160,140,140,77
"7281",80,"[25]JsHoIoroHcosHnJqGKCeqAExG",288,0.99654,25,289,1,288,1,1,0,1,1,140,139,149,149,77
"7282",81,"[25]JsHoIoroHcosHnJqGKCeqAExG",297,0.996644,25,298,1,297,1,1,0,1,1,147,146,151,151,77
"7283",82,"[25]JsHoIoroHcosHnJqGKCeqAExG",307,0.996753,25,308,1,307,1,1,0,1,1,177,176,131,131,77
"7284",83,"[25]JsHoIoroHcosHnJqGKCeqAExG",293,0.996599,25,294,1,293,1,1,0,1,1,133,132,161,161,77
"7285",84,"[25]JsHoIoroHcosHnJqGKCeqAExG",296,0.996633,25,297,1,296,1,1,0,1,1,152,151,145,145,77
"7286",85,"[25]JsHoIoroHcosHnJqGKCeqAExG",300,0.996678,25,301,1,300,1,1,0,1,1,161,160,140,140,77
"7287",86,"[25]JsHoIoroHcosHnJqGKCeqAExG",294,0.99661,25,295,1,294,1,1,0,1,1,152,151,143,143,77
"7288",87,"[25]JsHoIoroHcosHnJqGKCeqAExG",300,0.996678,25,301,1,300,1,1,0,1,1,158,157,143,143,77
"7289",88,"[25]JsHoIoroHcosHnJqGKCeqAExG",291,0.996575,25,292,1,291,1,1,0,1,1,137,136,155,155,77
"7290",89,"[25]JsHoIoroHcosHnJqGKCeqAExG",297,0.996644,25,298,1,297,1,1,0,1,1,148,147,150,150,77
"7291",90,"[25]JsHoIoroHcosHnJqGKCeqAExG",293,0.996599,25,294,1,293,1,1,0,1,1,147,146,147,147,77
"7292",91,"[25]JsHoIoroHcosHnJqGKCeqAExG",292,0.996587,25,293,1,292,1,1,0,1,1,138,137,155,155,77
"7293",92,"[25]JsHoIoroHcosHnJqGKCeqAExG",302,0.9967,25,303,1,302,1,1,0,1,1,166,165,137,137,77
"7294",93,"[25]JsHoIoroHcosHnJqGKCeqAExG",296,0.996633,25,297,1,296,1,1,0,1,1,148,147,149,149,77
"7295",94,"[25]JsHoIoroHcosHnJqGKCeqAExG",300,0.996678,25,301,1,300,1,1,0,1,1,162,161,139,139,77
"7296",95,"[25]JsHoIoroHcosHnJqGKCeqAExG",297,0.996644,25,298,1,297,1,1,0,1,1,149,148,149,149,77
"7297",96,"[25]JsHoIoroHcosHnJqGKCeqAExG",299,0.996667,25,300,1,299,1,1,0,1,1,161,160,139,139,77
"7298",97,"[25]JsHoIoroHcosHnJqGKCeqAExG",294,0.99661,25,295,1,294,1,1,0,1,1,146,145,149,149,77
"7299",98,"[25]JsHoIoroHcosHnJqGKCeqAExG",298,0.996656,25,299,1,298,1,1,0,1,1,150,149,149,149,77
"7300",99,"[25]JsHoIoroHcosHnJqGKCeqAExG",295,0.996622,25,296,1,295,1,1,0,1,1,141,140,155,155,77
"7301",0,"[26]ioIoHcouHnJHGqKCsstaekzaki",282,0.996466,26,283,1,282,1,1,0,1,1,145,144,138,138,78
"7302",1,"[26]ioIoHcouHnJHGqKCsstaekzaki",283,0.996479,26,284,1,283,1,1,0,1,1,145,144,139,139,78
"7303",2,"[26]ioIoHcouHnJHGqKCsstaekzaki",282,0.996466,26,283,1,282,1,1,0,1,1,138,137,145,145,78
"7304",3,"[26]ioIoHcouHnJHGqKCsstaekzaki",277,0.996403,26,278,1,277,1,1,0,1,1,141,140,137,137,78
"7305",4,"[26]ioIoHcouHnJHGqKCsstaekzaki",276,0.99639,26,277,1,276,1,1,0,1,1,139,138,138,138,78
"7306",5,"[26]ioIoHcouHnJHGqKCsstaekzaki",279,0.996429,26,280,1,279,1,1,0,1,1,129,128,151,151,78
"7307",6,"[26]ioIoHcouHnJHGqKCsstaekzaki",284,0.996491,26,285,1,284,1,1,0,1,1,144,143,141,141,78
"7308",7,"[26]ioIoHcouHnJHGqKCsstaekzaki",279,0.996429,26,280,1,279,1,1,0,1,1,130,129,150,150,78
"7309",8,"[26]ioIoHcouHnJHGqKCsstaekzaki",283,0.996479,26,284,1,283,1,1,0,1,1,144,143,140,140,78
"7310",9,"[26]ioIoHcouHnJHGqKCsstaekzaki",281,0.996454,26,282,1,281,1,1,0,1,1,139,138,143,143,78
"7311",10,"[26]ioIoHcouHnJHGqKCsstaekzaki",277,0.996403,26,278,1,277,1,1,0,1,1,145,144,133,133,78
"7312",11,"[26]ioIoHcouHnJHGqKCsstaekzaki",285,0.996503,26,286,1,285,1,1,0,1,1,146,145,140,140,78
"7313",12,"[26]ioIoHcouHnJHGqKCsstaekzaki",285,0.996503,26,286,1,285,1,1,0,1,1,161,160,125,125,78
"7314",13,"[26]ioIoHcouHnJHGqKCsstaekzaki",280,0.996441,26,281,1,280,1,1,0,1,1,144,143,137,137,78
"7315",14,"[26]ioIoHcouHnJHGqKCsstaekzaki",281,0.996454,26,282,1,281,1,1,0,1,1,137,136,145,145,78
"7316",15,"[26]ioIoHcouHnJHGqKCsstaekzaki",281,0.996454,26,282,1,281,1,1,0,1,1,131,130,151,151,78
"7317",16,"[26]ioIoHcouHnJHGqKCsstaekzaki",278,0.996416,26,279,1,278,1,1,0,1,1,134,133,145,145,78
"7318",17,"[26]ioIoHcouHnJHGqKCsstaekzaki",285,0.996503,26,286,1,285,1,1,0,1,1,130,129,156,156,78
"7319",18,"[26]ioIoHcouHnJHGqKCsstaekzaki",286,0.996516,26,287,1,286,1,1,0,1,1,139,138,148,148,78
"7320",19,"[26]ioIoHcouHnJHGqKCsstaekzaki",282,0.996466,26,283,1,282,1,1,0,1,1,141,140,142,142,78
"7321",20,"[26]ioIoHcouHnJHGqKCsstaekzaki",288,0.99654,26,289,1,288,1,1,0,1,1,146,145,143,143,78
"7322",21,"[26]ioIoHcouHnJHGqKCsstaekzaki",280,0.996441,26,281,1,280,1,1,0,1,1,131,130,150,150,78
"7323",22,"[26]ioIoHcouHnJHGqKCsstaekzaki",282,0.996466,26,283,1,282,1,1,0,1,1,148,147,135,135,78
"7324",23,"[26]ioIoHcouHnJHGqKCsstaekzaki",286,0.996516,26,287,1,286,1,1,0,1,1,143,142,144,144,78
"7325",24,"[26]ioIoHcouHnJHGqKCsstaekzaki",284,0.996491,26,285,1,284,1,1,0,1,1,120,119,165,165,78
"7326",25,"[26]ioIoHcouHnJHGqKCsstaekzaki",277,0.996403,26,278,1,277,1,1,0,1,1,128,127,150,150,78
"7327",26,"[26]ioIoHcouHnJHGqKCsstaekzaki",286,0.996516,26,287,1,286,1,1,0,1,1,156,155,131,131,78
"7328",27,"[26]ioIoHcouHnJHGqKCsstaekzaki",284,0.996491,26,285,1,284,1,1,0,1,1,134,133,151,151,78
"7329",28,"[26]ioIoHcouHnJHGqKCsstaekzaki",290,0.996564,26,291,1,290,1,1,0,1,1,145,144,146,146,78
"7330",29,"[26]ioIoHcouHnJHGqKCsstaekzaki",283,0.996479,26,284,1,283,1,1,0,1,1,149,148,135,135,78
"7331",30,"[26]ioIoHcouHnJHGqKCsstaekzaki",276,0.99639,26,277,1,276,1,1,0,1,1,146,145,131,131,78
"7332",31,"[26]ioIoHcouHnJHGqKCsstaekzaki",284,0.996491,26,285,1,284,1,1,0,1,1,140,139,145,145,78
"7333",32,"[26]ioIoHcouHnJHGqKCsstaekzaki",274,0.996364,26,275,1,274,1,1,0,1,1,124,123,151,151,78
"7334",33,"[26]ioIoHcouHnJHGqKCsstaekzaki",281,0.996454,26,282,1,281,1,1,0,1,1,144,143,138,138,78
"7335",34,"[26]ioIoHcouHnJHGqKCsstaekzaki",284,0.996491,26,285,1,284,1,1,0,1,1,144,143,141,141,78
"7336",35,"[26]ioIoHcouHnJHGqKCsstaekzaki",289,0.996552,26,290,1,289,1,1,0,1,1,145,144,145,145,78
"7337",36,"[26]ioIoHcouHnJHGqKCsstaekzaki",279,0.996429,26,280,1,279,1,1,0,1,1,136,135,144,144,78
"7338",37,"[26]ioIoHcouHnJHGqKCsstaekzaki",277,0.996403,26,278,1,277,1,1,0,1,1,148,147,130,130,78
"7339",38,"[26]ioIoHcouHnJHGqKCsstaekzaki",274,0.996364,26,275,1,274,1,1,0,1,1,133,132,142,142,78
"7340",39,"[26]ioIoHcouHnJHGqKCsstaekzaki",289,0.996552,26,290,1,289,1,1,0,1,1,159,158,131,131,78
"7341",40,"[26]ioIoHcouHnJHGqKCsstaekzaki",279,0.996429,26,280,1,279,1,1,0,1,1,139,138,141,141,78
"7342",41,"[26]ioIoHcouHnJHGqKCsstaekzaki",287,0.996528,26,288,1,287,1,1,0,1,1,140,139,148,148,78
"7343",42,"[26]ioIoHcouHnJHGqKCsstaekzaki",290,0.996564,26,291,1,290,1,1,0,1,1,155,154,136,136,78
"7344",43,"[26]ioIoHcouHnJHGqKCsstaekzaki",283,0.996479,26,284,1,283,1,1,0,1,1,143,142,141,141,78
"7345",44,"[26]ioIoHcouHnJHGqKCsstaekzaki",284,0.996491,26,285,1,284,1,1,0,1,1,133,132,152,152,78
"7346",45,"[26]ioIoHcouHnJHGqKCsstaekzaki",276,0.99639,26,277,1,276,1,1,0,1,1,144,143,133,133,78
"7347",46,"[26]ioIoHcouHnJHGqKCsstaekzaki",282,0.996466,26,283,1,282,1,1,0,1,1,150,149,133,133,78
"7348",47,"[26]ioIoHcouHnJHGqKCsstaekzaki",283,0.996479,26,284,1,283,1,1,0,1,1,146,145,138,138,78
"7349",48,"[26]ioIoHcouHnJHGqKCsstaekzaki",279,0.996429,26,280,1,279,1,1,0,1,1,144,143,136,136,78
"7350",49,"[26]ioIoHcouHnJHGqKCsstaekzaki",281,0.996454,26,282,1,281,1,1,0,1,1,146,145,136,136,78
"7351",50,"[26]ioIoHcouHnJHGqKCsstaekzaki",276,0.99639,26,277,1,276,1,1,0,1,1,141,140,136,136,78
"7352",51,"[26]ioIoHcouHnJHGqKCsstaekzaki",279,0.996429,26,280,1,279,1,1,0,1,1,155,154,125,125,78
"7353",52,"[26]ioIoHcouHnJHGqKCsstaekzaki",284,0.996491,26,285,1,284,1,1,0,1,1,135,134,150,150,78
"7354",53,"[26]ioIoHcouHnJHGqKCsstaekzaki",279,0.996429,26,280,1,279,1,1,0,1,1,129,128,151,151,78
"7355",54,"[26]ioIoHcouHnJHGqKCsstaekzaki",288,0.99654,26,289,1,288,1,1,0,1,1,156,155,133,133,78
"7356",55,"[26]ioIoHcouHnJHGqKCsstaekzaki",283,0.996479,26,284,1,283,1,1,0,1,1,122,121,162,162,78
"7357",56,"[26]ioIoHcouHnJHGqKCsstaekzaki",284,0.996491,26,285,1,284,1,1,0,1,1,143,142,142,142,78
"7358",57,"[26]ioIoHcouHnJHGqKCsstaekzaki",282,0.996466,26,283,1,282,1,1,0,1,1,153,152,130,130,78
"7359",58,"[26]ioIoHcouHnJHGqKCsstaekzaki",279,0.996429,26,280,1,279,1,1,0,1,1,138,137,142,142,78
"7360",59,"[26]ioIoHcouHnJHGqKCsstaekzaki",278,0.996416,26,279,1,278,1,1,0,1,1,145,144,134,134,78
"7361",60,"[26]ioIoHcouHnJHGqKCsstaekzaki",284,0.996491,26,285,1,284,1,1,0,1,1,134,133,151,151,78
"7362",61,"[26]ioIoHcouHnJHGqKCsstaekzaki",284,0.996491,26,285,1,284,1,1,0,1,1,135,134,150,150,78
"7363",62,"[26]ioIoHcouHnJHGqKCsstaekzaki",281,0.996454,26,282,1,281,1,1,0,1,1,135,134,147,147,78
"7364",63,"[26]ioIoHcouHnJHGqKCsstaekzaki",272,0.996337,26,273,1,272,1,1,0,1,1,116,115,157,157,78
"7365",64,"[26]ioIoHcouHnJHGqKCsstaekzaki",279,0.996429,26,280,1,279,1,1,0,1,1,130,129,150,150,78
"7366",65,"[26]ioIoHcouHnJHGqKCsstaekzaki",273,0.99635,26,274,1,273,1,1,0,1,1,125,124,149,149,78
"7367",66,"[26]ioIoHcouHnJHGqKCsstaekzaki",289,0.996552,26,290,1,289,1,1,0,1,1,139,138,151,151,78
"7368",67,"[26]ioIoHcouHnJHGqKCsstaekzaki",277,0.996403,26,278,1,277,1,1,0,1,1,145,144,133,133,78
"7369",68,"[26]ioIoHcouHnJHGqKCsstaekzaki",276,0.99639,26,277,1,276,1,1,0,1,1,143,142,134,134,78
"7370",69,"[26]ioIoHcouHnJHGqKCsstaekzaki",282,0.996466,26,283,1,282,1,1,0,1,1,140,139,143,143,78
"7371",70,"[26]ioIoHcouHnJHGqKCsstaekzaki",284,0.996491,26,285,1,284,1,1,0,1,1,150,149,135,135,78
"7372",71,"[26]ioIoHcouHnJHGqKCsstaekzaki",283,0.996479,26,284,1,283,1,1,0,1,1,146,145,138,138,78
"7373",72,"[26]ioIoHcouHnJHGqKCsstaekzaki",287,0.996528,26,288,1,287,1,1,0,1,1,140,139,148,148,78
"7374",73,"[26]ioIoHcouHnJHGqKCsstaekzaki",277,0.996403,26,278,1,277,1,1,0,1,1,135,134,143,143,78
"7375",74,"[26]ioIoHcouHnJHGqKCsstaekzaki",279,0.996429,26,280,1,279,1,1,0,1,1,146,145,134,134,78
"7376",75,"[26]ioIoHcouHnJHGqKCsstaekzaki",280,0.996441,26,281,1,280,1,1,0,1,1,139,138,142,142,78
"7377",76,"[26]ioIoHcouHnJHGqKCsstaekzaki",281,0.996454,26,282,1,281,1,1,0,1,1,141,140,141,141,78
"7378",77,"[26]ioIoHcouHnJHGqKCsstaekzaki",282,0.996466,26,283,1,282,1,1,0,1,1,130,129,153,153,78
"7379",78,"[26]ioIoHcouHnJHGqKCsstaekzaki",280,0.996441,26,281,1,280,1,1,0,1,1,141,140,140,140,78
"7380",79,"[26]ioIoHcouHnJHGqKCsstaekzaki",289,0.996552,26,290,1,289,1,1,0,1,1,153,152,137,137,78
"7381",80,"[26]ioIoHcouHnJHGqKCsstaekzaki",280,0.996441,26,281,1,280,1,1,0,1,1,137,136,144,144,78
"7382",81,"[26]ioIoHcouHnJHGqKCsstaekzaki",282,0.996466,26,283,1,282,1,1,0,1,1,143,142,140,140,78
"7383",82,"[26]ioIoHcouHnJHGqKCsstaekzaki",279,0.996429,26,280,1,279,1,1,0,1,1,135,134,145,145,78
"7384",83,"[26]ioIoHcouHnJHGqKCsstaekzaki",287,0.996528,26,288,1,287,1,1,0,1,1,142,141,146,146,78
"7385",84,"[26]ioIoHcouHnJHGqKCsstaekzaki",280,0.996441,26,281,1,280,1,1,0,1,1,148,147,133,133,78
"7386",85,"[26]ioIoHcouHnJHGqKCsstaekzaki",279,0.996429,26,280,1,279,1,1,0,1,1,138,137,142,142,78
"7387",86,"[26]ioIoHcouHnJHGqKCsstaekzaki",290,0.996564,26,291,1,290,1,1,0,1,1,149,148,142,142,78
"7388",87,"[26]ioIoHcouHnJHGqKCsstaekzaki",288,0.99654,26,289,1,288,1,1,0,1,1,147,146,142,142,78
"7389",88,"[26]ioIoHcouHnJHGqKCsstaekzaki",279,0.996429,26,280,1,279,1,1,0,1,1,138,137,142,142,78
"7390",89,"[26]ioIoHcouHnJHGqKCsstaekzaki",278,0.996416,26,279,1,278,1,1,0,1,1,139,138,140,140,78
"7391",90,"[26]ioIoHcouHnJHGqKCsstaekzaki",279,0.996429,26,280,1,279,1,1,0,1,1,127,126,153,153,78
"7392",91,"[26]ioIoHcouHnJHGqKCsstaekzaki",275,0.996377,26,276,1,275,1,1,0,1,1,117,116,159,159,78
"7393",92,"[26]ioIoHcouHnJHGqKCsstaekzaki",282,0.996466,26,283,1,282,1,1,0,1,1,133,132,150,150,78
"7394",93,"[26]ioIoHcouHnJHGqKCsstaekzaki",291,0.996575,26,292,1,291,1,1,0,1,1,158,157,134,134,78
"7395",94,"[26]ioIoHcouHnJHGqKCsstaekzaki",286,0.996516,26,287,1,286,1,1,0,1,1,152,151,135,135,78
"7396",95,"[26]ioIoHcouHnJHGqKCsstaekzaki",284,0.996491,26,285,1,284,1,1,0,1,1,153,152,132,132,78
"7397",96,"[26]ioIoHcouHnJHGqKCsstaekzaki",288,0.99654,26,289,1,288,1,1,0,1,1,162,161,127,127,78
"7398",97,"[26]ioIoHcouHnJHGqKCsstaekzaki",285,0.996503,26,286,1,285,1,1,0,1,1,147,146,139,139,78
"7399",98,"[26]ioIoHcouHnJHGqKCsstaekzaki",281,0.996454,26,282,1,281,1,1,0,1,1,134,133,148,148,78
"7400",99,"[26]ioIoHcouHnJHGqKCsstaekzaki",280,0.996441,26,281,1,280,1,1,0,1,1,136,135,145,145,78
"7401",0,"[26]JhfHoIoHcotHnJqGKCvDttgqcj",297,0.996644,26,298,1,297,1,1,0,1,1,146,145,152,152,79
"7402",1,"[26]JhfHoIoHcotHnJqGKCvDttgqcj",301,0.996689,26,302,1,301,1,1,0,1,1,164,163,138,138,79
"7403",2,"[26]JhfHoIoHcotHnJqGKCvDttgqcj",308,0.996764,26,309,1,308,1,1,0,1,1,177,176,132,132,79
"7404",3,"[26]JhfHoIoHcotHnJqGKCvDttgqcj",295,0.996622,26,296,1,295,1,1,0,1,1,138,137,158,158,79
"7405",4,"[26]JhfHoIoHcotHnJqGKCvDttgqcj",299,0.996667,26,300,1,299,1,1,0,1,1,157,156,143,143,79
"7406",5,"[26]JhfHoIoHcotHnJqGKCvDttgqcj",298,0.996656,26,299,1,298,1,1,0,1,1,152,151,147,147,79
"7407",6,"[26]JhfHoIoHcotHnJqGKCvDttgqcj",297,0.996644,26,298,1,297,1,1,0,1,1,148,147,150,150,79
"7408",7,"[26]JhfHoIoHcotHnJqGKCvDttgqcj",299,0.996667,26,300,1,299,1,1,0,1,1,154,153,146,146,79
"7409",8,"[26]JhfHoIoHcotHnJqGKCvDttgqcj",297,0.996644,26,298,1,297,1,1,0,1,1,153,152,145,145,79
"7410",9,"[26]JhfHoIoHcotHnJqGKCvDttgqcj",300,0.996678,26,301,1,300,1,1,0,1,1,157,156,144,144,79
"7411",10,"[26]JhfHoIoHcotHnJqGKCvDttgqcj",296,0.996633,26,297,1,296,1,1,0,1,1,149,148,148,148,79
"7412",11,"[26]JhfHoIoHcotHnJqGKCvDttgqcj",295,0.996622,26,296,1,295,1,1,0,1,1,145,144,151,151,79
"7413",12,"[26]JhfHoIoHcotHnJqGKCvDttgqcj",297,0.996644,26,298,1,297,1,1,0,1,1,147,146,151,151,79
"7414",13,"[26]JhfHoIoHcotHnJqGKCvDttgqcj",294,0.99661,26,295,1,294,1,1,0,1,1,138,137,157,157,79
"7415",14,"[26]JhfHoIoHcotHnJqGKCvDttgqcj",302,0.9967,26,303,1,302,1,1,0,1,1,162,161,141,141,79
"7416",15,"[26]JhfHoIoHcotHnJqGKCvDttgqcj",289,0.996552,26,290,1,289,1,1,0,1,1,139,138,151,151,79
"7417",16,"[26]JhfHoIoHcotHnJqGKCvDttgqcj",296,0.996633,26,297,1,296,1,1,0,1,1,145,144,152,152,79
"7418",17,"[26]JhfHoIoHcotHnJqGKCvDttgqcj",297,0.996644,26,298,1,297,1,1,0,1,1,152,151,146,146,79
"7419",18,"[26]JhfHoIoHcotHnJqGKCvDttgqcj",297,0.996644,26,298,1,297,1,1,0,1,1,153,152,145,145,79
"7420",19,"[26]JhfHoIoHcotHnJqGKCvDttgqcj",297,0.996644,26,298,1,297,1,1,0,1,1,148,147,150,150,79
"7421",20,"[26]JhfHoIoHcotHnJqGKCvDttgqcj",298,0.996656,26,299,1,298,1,1,0,1,1,151,150,148,148,79
"7422",21,"[26]JhfHoIoHcotHnJqGKCvDttgqcj",303,0.996711,26,304,1,303,1,1,0,1,1,159,158,145,145,79
"7423",22,"[26]JhfHoIoHcotHnJqGKCvDttgqcj",301,0.996689,26,302,1,301,1,1,0,1,1,158,157,144,144,79
"7424",23,"[26]JhfHoIoHcotHnJqGKCvDttgqcj",300,0.996678,26,301,1,300,1,1,0,1,1,151,150,150,150,79
"7425",24,"[26]JhfHoIoHcotHnJqGKCvDttgqcj",297,0.996644,26,298,1,297,1,1,0,1,1,148,147,150,150,79
"7426",25,"[26]JhfHoIoHcotHnJqGKCvDttgqcj",300,0.996678,26,301,1,300,1,1,0,1,1,153,152,148,148,79
"7427",26,"[26]JhfHoIoHcotHnJqGKCvDttgqcj",301,0.996689,26,302,1,301,1,1,0,1,1,159,158,143,143,79
"7428",27,"[26]JhfHoIoHcotHnJqGKCvDttgqcj",292,0.996587,26,293,1,292,1,1,0,1,1,142,141,151,151,79
"7429",28,"[26]JhfHoIoHcotHnJqGKCvDttgqcj",293,0.996599,26,294,1,293,1,1,0,1,1,136,135,158,158,79
"7430",29,"[26]JhfHoIoHcotHnJqGKCvDttgqcj",304,0.996721,26,305,1,304,1,1,0,1,1,165,164,140,140,79
"7431",30,"[26]JhfHoIoHcotHnJqGKCvDttgqcj",297,0.996644,26,298,1,297,1,1,0,1,1,156,155,142,142,79
"7432",31,"[26]JhfHoIoHcotHnJqGKCvDttgqcj",292,0.996587,26,293,1,292,1,1,0,1,1,133,132,160,160,79
"7433",32,"[26]JhfHoIoHcotHnJqGKCvDttgqcj",293,0.996599,26,294,1,293,1,1,0,1,1,137,136,157,157,79
"7434",33,"[26]JhfHoIoHcotHnJqGKCvDttgqcj",290,0.996564,26,291,1,290,1,1,0,1,1,128,127,163,163,79
"7435",34,"[26]JhfHoIoHcotHnJqGKCvDttgqcj",292,0.996587,26,293,1,292,1,1,0,1,1,133,132,160,160,79
"7436",35,"[26]JhfHoIoHcotHnJqGKCvDttgqcj",292,0.996587,26,293,1,292,1,1,0,1,1,137,136,156,156,79
"7437",36,"[26]JhfHoIoHcotHnJqGKCvDttgqcj",296,0.996633,26,297,1,296,1,1,0,1,1,142,141,155,155,79
"7438",37,"[26]JhfHoIoHcotHnJqGKCvDttgqcj",294,0.99661,26,295,1,294,1,1,0,1,1,142,141,153,153,79
"7439",38,"[26]JhfHoIoHcotHnJqGKCvDttgqcj",297,0.996644,26,298,1,297,1,1,0,1,1,149,148,149,149,79
"7440",39,"[26]JhfHoIoHcotHnJqGKCvDttgqcj",291,0.996575,26,292,1,291,1,1,0,1,1,134,133,158,158,79
"7441",40,"[26]JhfHoIoHcotHnJqGKCvDttgqcj",297,0.996644,26,298,1,297,1,1,0,1,1,147,146,151,151,79
"7442",41,"[26]JhfHoIoHcotHnJqGKCvDttgqcj",302,0.9967,26,303,1,302,1,1,0,1,1,164,163,139,139,79
"7443",42,"[26]JhfHoIoHcotHnJqGKCvDttgqcj",295,0.996622,26,296,1,295,1,1,0,1,1,141,140,155,155,79
"7444",43,"[26]JhfHoIoHcotHnJqGKCvDttgqcj",300,0.996678,26,301,1,300,1,1,0,1,1,155,154,146,146,79
"7445",44,"[26]JhfHoIoHcotHnJqGKCvDttgqcj",297,0.996644,26,298,1,297,1,1,0,1,1,144,143,154,154,79
"7446",45,"[26]JhfHoIoHcotHnJqGKCvDttgqcj",302,0.9967,26,303,1,302,1,1,0,1,1,164,163,139,139,79
"7447",46,"[26]JhfHoIoHcotHnJqGKCvDttgqcj",294,0.99661,26,295,1,294,1,1,0,1,1,130,129,165,165,79
"7448",47,"[26]JhfHoIoHcotHnJqGKCvDttgqcj",295,0.996622,26,296,1,295,1,1,0,1,1,153,152,143,143,79
"7449",48,"[26]JhfHoIoHcotHnJqGKCvDttgqcj",305,0.996732,26,306,1,305,1,1,0,1,1,166,165,140,140,79
"7450",49,"[26]JhfHoIoHcotHnJqGKCvDttgqcj",295,0.996622,26,296,1,295,1,1,0,1,1,134,133,162,162,79
"7451",50,"[26]JhfHoIoHcotHnJqGKCvDttgqcj",299,0.996667,26,300,1,299,1,1,0,1,1,158,157,142,142,79
"7452",51,"[26]JhfHoIoHcotHnJqGKCvDttgqcj",282,0.996466,26,283,1,282,1,1,0,1,1,142,141,141,141,79
"7453",52,"[26]JhfHoIoHcotHnJqGKCvDttgqcj",289,0.996552,26,290,1,289,1,1,0,1,1,125,124,165,165,79
"7454",53,"[26]JhfHoIoHcotHnJqGKCvDttgqcj",303,0.996711,26,304,1,303,1,1,0,1,1,164,163,140,140,79
"7455",54,"[26]JhfHoIoHcotHnJqGKCvDttgqcj",296,0.996633,26,297,1,296,1,1,0,1,1,145,144,152,152,79
"7456",55,"[26]JhfHoIoHcotHnJqGKCvDttgqcj",301,0.996689,26,302,1,301,1,1,0,1,1,158,157,144,144,79
"7457",56,"[26]JhfHoIoHcotHnJqGKCvDttgqcj",297,0.996644,26,298,1,297,1,1,0,1,1,148,147,150,150,79
"7458",57,"[26]JhfHoIoHcotHnJqGKCvDttgqcj",292,0.996587,26,293,1,292,1,1,0,1,1,141,140,152,152,79
"7459",58,"[26]JhfHoIoHcotHnJqGKCvDttgqcj",302,0.9967,26,303,1,302,1,1,0,1,1,163,162,140,140,79
"7460",59,"[26]JhfHoIoHcotHnJqGKCvDttgqcj",295,0.996622,26,296,1,295,1,1,0,1,1,152,151,144,144,79
"7461",60,"[26]JhfHoIoHcotHnJqGKCvDttgqcj",296,0.996633,26,297,1,296,1,1,0,1,1,146,145,151,151,79
"7462",61,"[26]JhfHoIoHcotHnJqGKCvDttgqcj",299,0.996667,26,300,1,299,1,1,0,1,1,154,153,146,146,79
"7463",62,"[26]JhfHoIoHcotHnJqGKCvDttgqcj",297,0.996644,26,298,1,297,1,1,0,1,1,145,144,153,153,79
"7464",63,"[26]JhfHoIoHcotHnJqGKCvDttgqcj",299,0.996667,26,300,1,299,1,1,0,1,1,150,149,150,150,79
"7465",64,"[26]JhfHoIoHcotHnJqGKCvDttgqcj",291,0.996575,26,292,1,291,1,1,0,1,1,130,129,162,162,79
"7466",65,"[26]JhfHoIoHcotHnJqGKCvDttgqcj",302,0.9967,26,303,1,302,1,1,0,1,1,166,165,137,137,79
"7467",66,"[26]JhfHoIoHcotHnJqGKCvDttgqcj",295,0.996622,26,296,1,295,1,1,0,1,1,135,134,161,161,79
"7468",67,"[26]JhfHoIoHcotHnJqGKCvDttgqcj",297,0.996644,26,298,1,297,1,1,0,1,1,140,139,158,158,79
"7469",68,"[26]JhfHoIoHcotHnJqGKCvDttgqcj",297,0.996644,26,298,1,297,1,1,0,1,1,159,158,139,139,79
"7470",69,"[26]JhfHoIoHcotHnJqGKCvDttgqcj",309,0.996774,26,310,1,309,1,1,0,1,1,177,176,133,133,79
"7471",70,"[26]JhfHoIoHcotHnJqGKCvDttgqcj",302,0.9967,26,303,1,302,1,1,0,1,1,160,159,143,143,79
"7472",71,"[26]JhfHoIoHcotHnJqGKCvDttgqcj",296,0.996633,26,297,1,296,1,1,0,1,1,147,146,150,150,79
"7473",72,"[26]JhfHoIoHcotHnJqGKCvDttgqcj",301,0.996689,26,302,1,301,1,1,0,1,1,161,160,141,141,79
"7474",73,"[26]JhfHoIoHcotHnJqGKCvDttgqcj",298,0.996656,26,299,1,298,1,1,0,1,1,154,153,145,145,79
"7475",74,"[26]JhfHoIoHcotHnJqGKCvDttgqcj",299,0.996667,26,300,1,299,1,1,0,1,1,160,159,140,140,79
"7476",75,"[26]JhfHoIoHcotHnJqGKCvDttgqcj",303,0.996711,26,304,1,303,1,1,0,1,1,165,164,139,139,79
"7477",76,"[26]JhfHoIoHcotHnJqGKCvDttgqcj",301,0.996689,26,302,1,301,1,1,0,1,1,156,155,146,146,79
"7478",77,"[26]JhfHoIoHcotHnJqGKCvDttgqcj",302,0.9967,26,303,1,302,1,1,0,1,1,164,163,139,139,79
"7479",78,"[26]JhfHoIoHcotHnJqGKCvDttgqcj",296,0.996633,26,297,1,296,1,1,0,1,1,145,144,152,152,79
"7480",79,"[26]JhfHoIoHcotHnJqGKCvDttgqcj",296,0.996633,26,297,1,296,1,1,0,1,1,151,150,146,146,79
"7481",80,"[26]JhfHoIoHcotHnJqGKCvDttgqcj",296,0.996633,26,297,1,296,1,1,0,1,1,152,151,145,145,79
"7482",81,"[26]JhfHoIoHcotHnJqGKCvDttgqcj",301,0.996689,26,302,1,301,1,1,0,1,1,161,160,141,141,79
"7483",82,"[26]JhfHoIoHcotHnJqGKCvDttgqcj",301,0.996689,26,302,1,301,1,1,0,1,1,151,150,151,151,79
"7484",83,"[26]JhfHoIoHcotHnJqGKCvDttgqcj",298,0.996656,26,299,1,298,1,1,0,1,1,153,152,146,146,79
"7485",84,"[26]JhfHoIoHcotHnJqGKCvDttgqcj",300,0.996678,26,301,1,300,1,1,0,1,1,156,155,145,145,79
"7486",85,"[26]JhfHoIoHcotHnJqGKCvDttgqcj",295,0.996622,26,296,1,295,1,1,0,1,1,151,150,145,145,79
"7487",86,"[26]JhfHoIoHcotHnJqGKCvDttgqcj",303,0.996711,26,304,1,303,1,1,0,1,1,169,168,135,135,79
"7488",87,"[26]JhfHoIoHcotHnJqGKCvDttgqcj",302,0.9967,26,303,1,302,1,1,0,1,1,155,154,148,148,79
"7489",88,"[26]JhfHoIoHcotHnJqGKCvDttgqcj",294,0.99661,26,295,1,294,1,1,0,1,1,137,136,158,158,79
"7490",89,"[26]JhfHoIoHcotHnJqGKCvDttgqcj",297,0.996644,26,298,1,297,1,1,0,1,1,148,147,150,150,79
"7491",90,"[26]JhfHoIoHcotHnJqGKCvDttgqcj",295,0.996622,26,296,1,295,1,1,0,1,1,143,142,153,153,79
"7492",91,"[26]JhfHoIoHcotHnJqGKCvDttgqcj",298,0.996656,26,299,1,298,1,1,0,1,1,155,154,144,144,79
"7493",92,"[26]JhfHoIoHcotHnJqGKCvDttgqcj",294,0.99661,26,295,1,294,1,1,0,1,1,139,138,156,156,79
"7494",93,"[26]JhfHoIoHcotHnJqGKCvDttgqcj",306,0.996743,26,307,1,306,1,1,0,1,1,172,171,135,135,79
"7495",94,"[26]JhfHoIoHcotHnJqGKCvDttgqcj",298,0.996656,26,299,1,298,1,1,0,1,1,150,149,149,149,79
"7496",95,"[26]JhfHoIoHcotHnJqGKCvDttgqcj",293,0.996599,26,294,1,293,1,1,0,1,1,141,140,153,153,79
"7497",96,"[26]JhfHoIoHcotHnJqGKCvDttgqcj",298,0.996656,26,299,1,298,1,1,0,1,1,152,151,147,147,79
"7498",97,"[26]JhfHoIoHcotHnJqGKCvDttgqcj",298,0.996656,26,299,1,298,1,1,0,1,1,146,145,153,153,79
"7499",98,"[26]JhfHoIoHcotHnJqGKCvDttgqcj",300,0.996678,26,301,1,300,1,1,0,1,1,156,155,145,145,79
"7500",99,"[26]JhfHoIoHcotHnJqGKCvDttgqcj",298,0.996656,26,299,1,298,1,1,0,1,1,154,153,145,145,79
"7501",0,"[25]iroIoHcovHnJHGqKCDmFggCxb",281,0.996454,25,282,1,281,1,1,0,1,1,121,120,161,161,80
"7502",1,"[25]iroIoHcovHnJHGqKCDmFggCxb",279,0.996429,25,280,1,279,1,1,0,1,1,139,138,141,141,80
"7503",2,"[25]iroIoHcovHnJHGqKCDmFggCxb",290,0.996564,25,291,1,290,1,1,0,1,1,147,146,144,144,80
"7504",3,"[25]iroIoHcovHnJHGqKCDmFggCxb",280,0.996441,25,281,1,280,1,1,0,1,1,151,150,130,130,80
"7505",4,"[25]iroIoHcovHnJHGqKCDmFggCxb",275,0.996377,25,276,1,275,1,1,0,1,1,124,123,152,152,80
"7506",5,"[25]iroIoHcovHnJHGqKCDmFggCxb",282,0.996466,25,283,1,282,1,1,0,1,1,149,148,134,134,80
"7507",6,"[25]iroIoHcovHnJHGqKCDmFggCxb",283,0.996479,25,284,1,283,1,1,0,1,1,145,144,139,139,80
"7508",7,"[25]iroIoHcovHnJHGqKCDmFggCxb",275,0.996377,25,276,1,275,1,1,0,1,1,138,137,138,138,80
"7509",8,"[25]iroIoHcovHnJHGqKCDmFggCxb",285,0.996503,25,286,1,285,1,1,0,1,1,143,142,143,143,80
"7510",9,"[25]iroIoHcovHnJHGqKCDmFggCxb",280,0.996441,25,281,1,280,1,1,0,1,1,142,141,139,139,80
"7511",10,"[25]iroIoHcovHnJHGqKCDmFggCxb",287,0.996528,25,288,1,287,1,1,0,1,1,147,146,141,141,80
"7512",11,"[25]iroIoHcovHnJHGqKCDmFggCxb",287,0.996528,25,288,1,287,1,1,0,1,1,148,147,140,140,80
"7513",12,"[25]iroIoHcovHnJHGqKCDmFggCxb",275,0.996377,25,276,1,275,1,1,0,1,1,139,138,137,137,80
"7514",13,"[25]iroIoHcovHnJHGqKCDmFggCxb",274,0.996364,25,275,1,274,1,1,0,1,1,137,136,138,138,80
"7515",14,"[25]iroIoHcovHnJHGqKCDmFggCxb",278,0.996416,25,279,1,278,1,1,0,1,1,145,144,134,134,80
"7516",15,"[25]iroIoHcovHnJHGqKCDmFggCxb",275,0.996377,25,276,1,275,1,1,0,1,1,143,142,133,133,80
"7517",16,"[25]iroIoHcovHnJHGqKCDmFggCxb",283,0.996479,25,284,1,283,1,1,0,1,1,139,138,145,145,80
"7518",17,"[25]iroIoHcovHnJHGqKCDmFggCxb",286,0.996516,25,287,1,286,1,1,0,1,1,149,148,138,138,80
"7519",18,"[25]iroIoHcovHnJHGqKCDmFggCxb",285,0.996503,25,286,1,285,1,1,0,1,1,149,148,137,137,80
"7520",19,"[25]iroIoHcovHnJHGqKCDmFggCxb",279,0.996429,25,280,1,279,1,1,0,1,1,135,134,145,145,80
"7521",20,"[25]iroIoHcovHnJHGqKCDmFggCxb",280,0.996441,25,281,1,280,1,1,0,1,1,139,138,142,142,80
"7522",21,"[25]iroIoHcovHnJHGqKCDmFggCxb",276,0.99639,25,277,1,276,1,1,0,1,1,146,145,131,131,80
"7523",22,"[25]iroIoHcovHnJHGqKCDmFggCxb",280,0.996441,25,281,1,280,1,1,0,1,1,132,131,149,149,80
"7524",23,"[25]iroIoHcovHnJHGqKCDmFggCxb",291,0.996575,25,292,1,291,1,1,0,1,1,148,147,144,144,80
"7525",24,"[25]iroIoHcovHnJHGqKCDmFggCxb",284,0.996491,25,285,1,284,1,1,0,1,1,153,152,132,132,80
"7526",25,"[25]iroIoHcovHnJHGqKCDmFggCxb",278,0.996416,25,279,1,278,1,1,0,1,1,135,134,144,144,80
"7527",26,"[25]iroIoHcovHnJHGqKCDmFggCxb",280,0.996441,25,281,1,280,1,1,0,1,1,140,139,141,141,80
"7528",27,"[25]iroIoHcovHnJHGqKCDmFggCxb",284,0.996491,25,285,1,284,1,1,0,1,1,152,151,133,133,80
"7529",28,"[25]iroIoHcovHnJHGqKCDmFggCxb",283,0.996479,25,284,1,283,1,1,0,1,1,143,142,141,141,80
"7530",29,"[25]iroIoHcovHnJHGqKCDmFggCxb",274,0.996364,25,275,1,274,1,1,0,1,1,137,136,138,138,80
"7531",30,"[25]iroIoHcovHnJHGqKCDmFggCxb",287,0.996528,25,288,1,287,1,1,0,1,1,144,143,144,144,80
"7532",31,"[25]iroIoHcovHnJHGqKCDmFggCxb",286,0.996516,25,287,1,286,1,1,0,1,1,145,144,142,142,80
"7533",32,"[25]iroIoHcovHnJHGqKCDmFggCxb",278,0.996416,25,279,1,278,1,1,0,1,1,148,147,131,131,80
"7534",33,"[25]iroIoHcovHnJHGqKCDmFggCxb",282,0.996466,25,283,1,282,1,1,0,1,1,133,132,150,150,80
"7535",34,"[25]iroIoHcovHnJHGqKCDmFggCxb",283,0.996479,25,284,1,283,1,1,0,1,1,144,143,140,140,80
"7536",35,"[25]iroIoHcovHnJHGqKCDmFggCxb",275,0.996377,25,276,1,275,1,1,0,1,1,146,145,130,130,80
"7537",36,"[25]iroIoHcovHnJHGqKCDmFggCxb",277,0.996403,25,278,1,277,1,1,0,1,1,142,141,136,136,80
"7538",37,"[25]iroIoHcovHnJHGqKCDmFggCxb",268,0.996283,25,269,1,268,1,1,0,1,1,118,117,151,151,80
"7539",38,"[25]iroIoHcovHnJHGqKCDmFggCxb",289,0.996552,25,290,1,289,1,1,0,1,1,137,136,153,153,80
"7540",39,"[25]iroIoHcovHnJHGqKCDmFggCxb",288,0.99654,25,289,1,288,1,1,0,1,1,155,154,134,134,80
"7541",40,"[25]iroIoHcovHnJHGqKCDmFggCxb",271,0.996324,25,272,1,271,1,1,0,1,1,145,144,127,127,80
"7542",41,"[25]iroIoHcovHnJHGqKCDmFggCxb",283,0.996479,25,284,1,283,1,1,0,1,1,134,133,150,150,80
"7543",42,"[25]iroIoHcovHnJHGqKCDmFggCxb",286,0.996516,25,287,1,286,1,1,0,1,1,161,160,126,126,80
"7544",43,"[25]iroIoHcovHnJHGqKCDmFggCxb",288,0.99654,25,289,1,288,1,1,0,1,1,143,142,146,146,80
"7545",44,"[25]iroIoHcovHnJHGqKCDmFggCxb",285,0.996503,25,286,1,285,1,1,0,1,1,146,145,140,140,80
"7546",45,"[25]iroIoHcovHnJHGqKCDmFggCxb",276,0.99639,25,277,1,276,1,1,0,1,1,119,118,158,158,80
"7547",46,"[25]iroIoHcovHnJHGqKCDmFggCxb",284,0.996491,25,285,1,284,1,1,0,1,1,136,135,149,149,80
"7548",47,"[25]iroIoHcovHnJHGqKCDmFggCxb",287,0.996528,25,288,1,287,1,1,0,1,1,143,142,145,145,80
"7549",48,"[25]iroIoHcovHnJHGqKCDmFggCxb",285,0.996503,25,286,1,285,1,1,0,1,1,149,148,137,137,80
"7550",49,"[25]iroIoHcovHnJHGqKCDmFggCxb",283,0.996479,25,284,1,283,1,1,0,1,1,140,139,144,144,80
"7551",50,"[25]iroIoHcovHnJHGqKCDmFggCxb",283,0.996479,25,284,1,283,1,1,0,1,1,149,148,135,135,80
"7552",51,"[25]iroIoHcovHnJHGqKCDmFggCxb",278,0.996416,25,279,1,278,1,1,0,1,1,134,133,145,145,80
"7553",52,"[25]iroIoHcovHnJHGqKCDmFggCxb",287,0.996528,25,288,1,287,1,1,0,1,1,137,136,151,151,80
"7554",53,"[25]iroIoHcovHnJHGqKCDmFggCxb",284,0.996491,25,285,1,284,1,1,0,1,1,147,146,138,138,80
"7555",54,"[25]iroIoHcovHnJHGqKCDmFggCxb",275,0.996377,25,276,1,275,1,1,0,1,1,146,145,130,130,80
"7556",55,"[25]iroIoHcovHnJHGqKCDmFggCxb",277,0.996403,25,278,1,277,1,1,0,1,1,137,136,141,141,80
"7557",56,"[25]iroIoHcovHnJHGqKCDmFggCxb",293,0.996599,25,294,1,293,1,1,0,1,1,147,146,147,147,80
"7558",57,"[25]iroIoHcovHnJHGqKCDmFggCxb",285,0.996503,25,286,1,285,1,1,0,1,1,141,140,145,145,80
"7559",58,"[25]iroIoHcovHnJHGqKCDmFggCxb",278,0.996416,25,279,1,278,1,1,0,1,1,134,133,145,145,80
"7560",59,"[25]iroIoHcovHnJHGqKCDmFggCxb",288,0.99654,25,289,1,288,1,1,0,1,1,143,142,146,146,80
"7561",60,"[25]iroIoHcovHnJHGqKCDmFggCxb",288,0.99654,25,289,1,288,1,1,0,1,1,150,149,139,139,80
"7562",61,"[25]iroIoHcovHnJHGqKCDmFggCxb",281,0.996454,25,282,1,281,1,1,0,1,1,131,130,151,151,80
"7563",62,"[25]iroIoHcovHnJHGqKCDmFggCxb",281,0.996454,25,282,1,281,1,1,0,1,1,134,133,148,148,80
"7564",63,"[25]iroIoHcovHnJHGqKCDmFggCxb",276,0.99639,25,277,1,276,1,1,0,1,1,136,135,141,141,80
"7565",64,"[25]iroIoHcovHnJHGqKCDmFggCxb",276,0.99639,25,277,1,276,1,1,0,1,1,130,129,147,147,80
"7566",65,"[25]iroIoHcovHnJHGqKCDmFggCxb",281,0.996454,25,282,1,281,1,1,0,1,1,148,147,134,134,80
"7567",66,"[25]iroIoHcovHnJHGqKCDmFggCxb",279,0.996429,25,280,1,279,1,1,0,1,1,145,144,135,135,80
"7568",67,"[25]iroIoHcovHnJHGqKCDmFggCxb",277,0.996403,25,278,1,277,1,1,0,1,1,145,144,133,133,80
"7569",68,"[25]iroIoHcovHnJHGqKCDmFggCxb",278,0.996416,25,279,1,278,1,1,0,1,1,150,149,129,129,80
"7570",69,"[25]iroIoHcovHnJHGqKCDmFggCxb",281,0.996454,25,282,1,281,1,1,0,1,1,151,150,131,131,80
"7571",70,"[25]iroIoHcovHnJHGqKCDmFggCxb",275,0.996377,25,276,1,275,1,1,0,1,1,139,138,137,137,80
"7572",71,"[25]iroIoHcovHnJHGqKCDmFggCxb",276,0.99639,25,277,1,276,1,1,0,1,1,133,132,144,144,80
"7573",72,"[25]iroIoHcovHnJHGqKCDmFggCxb",278,0.996416,25,279,1,278,1,1,0,1,1,123,122,156,156,80
"7574",73,"[25]iroIoHcovHnJHGqKCDmFggCxb",275,0.996377,25,276,1,275,1,1,0,1,1,128,127,148,148,80
"7575",74,"[25]iroIoHcovHnJHGqKCDmFggCxb",277,0.996403,25,278,1,277,1,1,0,1,1,151,150,127,127,80
"7576",75,"[25]iroIoHcovHnJHGqKCDmFggCxb",278,0.996416,25,279,1,278,1,1,0,1,1,123,122,156,156,80
"7577",76,"[25]iroIoHcovHnJHGqKCDmFggCxb",286,0.996516,25,287,1,286,1,1,0,1,1,146,145,141,141,80
"7578",77,"[25]iroIoHcovHnJHGqKCDmFggCxb",285,0.996503,25,286,1,285,1,1,0,1,1,147,146,139,139,80
"7579",78,"[25]iroIoHcovHnJHGqKCDmFggCxb",274,0.996364,25,275,1,274,1,1,0,1,1,135,134,140,140,80
"7580",79,"[25]iroIoHcovHnJHGqKCDmFggCxb",278,0.996416,25,279,1,278,1,1,0,1,1,135,134,144,144,80
"7581",80,"[25]iroIoHcovHnJHGqKCDmFggCxb",279,0.996429,25,280,1,279,1,1,0,1,1,142,141,138,138,80
"7582",81,"[25]iroIoHcovHnJHGqKCDmFggCxb",285,0.996503,25,286,1,285,1,1,0,1,1,144,143,142,142,80
"7583",82,"[25]iroIoHcovHnJHGqKCDmFggCxb",279,0.996429,25,280,1,279,1,1,0,1,1,141,140,139,139,80
"7584",83,"[25]iroIoHcovHnJHGqKCDmFggCxb",276,0.99639,25,277,1,276,1,1,0,1,1,126,125,151,151,80
"7585",84,"[25]iroIoHcovHnJHGqKCDmFggCxb",281,0.996454,25,282,1,281,1,1,0,1,1,121,120,161,161,80
"7586",85,"[25]iroIoHcovHnJHGqKCDmFggCxb",281,0.996454,25,282,1,281,1,1,0,1,1,128,127,154,154,80
"7587",86,"[25]iroIoHcovHnJHGqKCDmFggCxb",282,0.996466,25,283,1,282,1,1,0,1,1,153,152,130,130,80
"7588",87,"[25]iroIoHcovHnJHGqKCDmFggCxb",280,0.996441,25,281,1,280,1,1,0,1,1,158,157,123,123,80
"7589",88,"[25]iroIoHcovHnJHGqKCDmFggCxb",279,0.996429,25,280,1,279,1,1,0,1,1,142,141,138,138,80
"7590",89,"[25]iroIoHcovHnJHGqKCDmFggCxb",273,0.99635,25,274,1,273,1,1,0,1,1,130,129,144,144,80
"7591",90,"[25]iroIoHcovHnJHGqKCDmFggCxb",279,0.996429,25,280,1,279,1,1,0,1,1,131,130,149,149,80
"7592",91,"[25]iroIoHcovHnJHGqKCDmFggCxb",272,0.996337,25,273,1,272,1,1,0,1,1,125,124,148,148,80
"7593",92,"[25]iroIoHcovHnJHGqKCDmFggCxb",285,0.996503,25,286,1,285,1,1,0,1,1,146,145,140,140,80
"7594",93,"[25]iroIoHcovHnJHGqKCDmFggCxb",284,0.996491,25,285,1,284,1,1,0,1,1,161,160,124,124,80
"7595",94,"[25]iroIoHcovHnJHGqKCDmFggCxb",283,0.996479,25,284,1,283,1,1,0,1,1,150,149,134,134,80
"7596",95,"[25]iroIoHcovHnJHGqKCDmFggCxb",280,0.996441,25,281,1,280,1,1,0,1,1,138,137,143,143,80
"7597",96,"[25]iroIoHcovHnJHGqKCDmFggCxb",283,0.996479,25,284,1,283,1,1,0,1,1,153,152,131,131,80
"7598",97,"[25]iroIoHcovHnJHGqKCDmFggCxb",284,0.996491,25,285,1,284,1,1,0,1,1,131,130,154,154,80
"7599",98,"[25]iroIoHcovHnJHGqKCDmFggCxb",279,0.996429,25,280,1,279,1,1,0,1,1,147,146,133,133,80
"7600",99,"[25]iroIoHcovHnJHGqKCDmFggCxb",281,0.996454,25,282,1,281,1,1,0,1,1,147,146,135,135,80
"7601",0,"[24]joIpleoHcosHnJHqKGCxjkhK",300,0.996678,24,301,1,300,1,1,0,1,1,149,148,152,152,81
"7602",1,"[24]joIpleoHcosHnJHqKGCxjkhK",288,0.99654,24,289,1,288,1,1,0,1,1,128,127,161,161,81
"7603",2,"[24]joIpleoHcosHnJHqKGCxjkhK",300,0.996678,24,301,1,300,1,1,0,1,1,151,150,150,150,81
"7604",3,"[24]joIpleoHcosHnJHqKGCxjkhK",289,0.996552,24,290,1,289,1,1,0,1,1,137,136,153,153,81
"7605",4,"[24]joIpleoHcosHnJHqKGCxjkhK",293,0.996599,24,294,1,293,1,1,0,1,1,152,151,142,142,81
"7606",5,"[24]joIpleoHcosHnJHqKGCxjkhK",289,0.996552,24,290,1,289,1,1,0,1,1,145,144,145,145,81
"7607",6,"[24]joIpleoHcosHnJHqKGCxjkhK",294,0.99661,24,295,1,294,1,1,0,1,1,151,150,144,144,81
"7608",7,"[24]joIpleoHcosHnJHqKGCxjkhK",294,0.99661,24,295,1,294,1,1,0,1,1,139,138,156,156,81
"7609",8,"[24]joIpleoHcosHnJHqKGCxjkhK",295,0.996622,24,296,1,295,1,1,0,1,1,138,137,158,158,81
"7610",9,"[24]joIpleoHcosHnJHqKGCxjkhK",297,0.996644,24,298,1,297,1,1,0,1,1,142,141,156,156,81
"7611",10,"[24]joIpleoHcosHnJHqKGCxjkhK",294,0.99661,24,295,1,294,1,1,0,1,1,153,152,142,142,81
"7612",11,"[24]joIpleoHcosHnJHqKGCxjkhK",286,0.996516,24,287,1,286,1,1,0,1,1,140,139,147,147,81
"7613",12,"[24]joIpleoHcosHnJHqKGCxjkhK",308,0.996764,24,309,1,308,1,1,0,1,1,169,168,140,140,81
"7614",13,"[24]joIpleoHcosHnJHqKGCxjkhK",302,0.9967,24,303,1,302,1,1,0,1,1,164,163,139,139,81
"7615",14,"[24]joIpleoHcosHnJHqKGCxjkhK",301,0.996689,24,302,1,301,1,1,0,1,1,159,158,143,143,81
"7616",15,"[24]joIpleoHcosHnJHqKGCxjkhK",301,0.996689,24,302,1,301,1,1,0,1,1,158,157,144,144,81
"7617",16,"[24]joIpleoHcosHnJHqKGCxjkhK",295,0.996622,24,296,1,295,1,1,0,1,1,144,143,152,152,81
"7618",17,"[24]joIpleoHcosHnJHqKGCxjkhK",285,0.996503,24,286,1,285,1,1,0,1,1,144,143,142,142,81
"7619",18,"[24]joIpleoHcosHnJHqKGCxjkhK",301,0.996689,24,302,1,301,1,1,0,1,1,150,149,152,152,81
"7620",19,"[24]joIpleoHcosHnJHqKGCxjkhK",301,0.996689,24,302,1,301,1,1,0,1,1,158,157,144,144,81
"7621",20,"[24]joIpleoHcosHnJHqKGCxjkhK",291,0.996575,24,292,1,291,1,1,0,1,1,150,149,142,142,81
"7622",21,"[24]joIpleoHcosHnJHqKGCxjkhK",301,0.996689,24,302,1,301,1,1,0,1,1,152,151,150,150,81
"7623",22,"[24]joIpleoHcosHnJHqKGCxjkhK",297,0.996644,24,298,1,297,1,1,0,1,1,156,155,142,142,81
"7624",23,"[24]joIpleoHcosHnJHqKGCxjkhK",292,0.996587,24,293,1,292,1,1,0,1,1,163,162,130,130,81
"7625",24,"[24]joIpleoHcosHnJHqKGCxjkhK",295,0.996622,24,296,1,295,1,1,0,1,1,147,146,149,149,81
"7626",25,"[24]joIpleoHcosHnJHqKGCxjkhK",290,0.996564,24,291,1,290,1,1,0,1,1,135,134,156,156,81
"7627",26,"[24]joIpleoHcosHnJHqKGCxjkhK",293,0.996599,24,294,1,293,1,1,0,1,1,144,143,150,150,81
"7628",27,"[24]joIpleoHcosHnJHqKGCxjkhK",293,0.996599,24,294,1,293,1,1,0,1,1,142,141,152,152,81
"7629",28,"[24]joIpleoHcosHnJHqKGCxjkhK",285,0.996503,24,286,1,285,1,1,0,1,1,149,148,137,137,81
"7630",29,"[24]joIpleoHcosHnJHqKGCxjkhK",288,0.99654,24,289,1,288,1,1,0,1,1,145,144,144,144,81
"7631",30,"[24]joIpleoHcosHnJHqKGCxjkhK",300,0.996678,24,301,1,300,1,1,0,1,1,162,161,139,139,81
"7632",31,"[24]joIpleoHcosHnJHqKGCxjkhK",297,0.996644,24,298,1,297,1,1,0,1,1,154,153,144,144,81
"7633",32,"[24]joIpleoHcosHnJHqKGCxjkhK",291,0.996575,24,292,1,291,1,1,0,1,1,130,129,162,162,81
"7634",33,"[24]joIpleoHcosHnJHqKGCxjkhK",305,0.996732,24,306,1,305,1,1,0,1,1,160,159,146,146,81
"7635",34,"[24]joIpleoHcosHnJHqKGCxjkhK",292,0.996587,24,293,1,292,1,1,0,1,1,141,140,152,152,81
"7636",35,"[24]joIpleoHcosHnJHqKGCxjkhK",294,0.99661,24,295,1,294,1,1,0,1,1,152,151,143,143,81
"7637",36,"[24]joIpleoHcosHnJHqKGCxjkhK",297,0.996644,24,298,1,297,1,1,0,1,1,155,154,143,143,81
"7638",37,"[24]joIpleoHcosHnJHqKGCxjkhK",295,0.996622,24,296,1,295,1,1,0,1,1,143,142,153,153,81
"7639",38,"[24]joIpleoHcosHnJHqKGCxjkhK",286,0.996516,24,287,1,286,1,1,0,1,1,139,138,148,148,81
"7640",39,"[24]joIpleoHcosHnJHqKGCxjkhK",292,0.996587,24,293,1,292,1,1,0,1,1,143,142,150,150,81
"7641",40,"[24]joIpleoHcosHnJHqKGCxjkhK",296,0.996633,24,297,1,296,1,1,0,1,1,149,148,148,148,81
"7642",41,"[24]joIpleoHcosHnJHqKGCxjkhK",300,0.996678,24,301,1,300,1,1,0,1,1,164,163,137,137,81
"7643",42,"[24]joIpleoHcosHnJHqKGCxjkhK",284,0.996491,24,285,1,284,1,1,0,1,1,131,130,154,154,81
"7644",43,"[24]joIpleoHcosHnJHqKGCxjkhK",299,0.996667,24,300,1,299,1,1,0,1,1,161,160,139,139,81
"7645",44,"[24]joIpleoHcosHnJHqKGCxjkhK",303,0.996711,24,304,1,303,1,1,0,1,1,164,163,140,140,81
"7646",45,"[24]joIpleoHcosHnJHqKGCxjkhK",299,0.996667,24,300,1,299,1,1,0,1,1,154,153,146,146,81
"7647",46,"[24]joIpleoHcosHnJHqKGCxjkhK",303,0.996711,24,304,1,303,1,1,0,1,1,168,167,136,136,81
"7648",47,"[24]joIpleoHcosHnJHqKGCxjkhK",296,0.996633,24,297,1,296,1,1,0,1,1,145,144,152,152,81
"7649",48,"[24]joIpleoHcosHnJHqKGCxjkhK",301,0.996689,24,302,1,301,1,1,0,1,1,165,164,137,137,81
"7650",49,"[24]joIpleoHcosHnJHqKGCxjkhK",297,0.996644,24,298,1,297,1,1,0,1,1,141,140,157,157,81
"7651",50,"[24]joIpleoHcosHnJHqKGCxjkhK",296,0.996633,24,297,1,296,1,1,0,1,1,155,154,142,142,81
"7652",51,"[24]joIpleoHcosHnJHqKGCxjkhK",296,0.996633,24,297,1,296,1,1,0,1,1,148,147,149,149,81
"7653",52,"[24]joIpleoHcosHnJHqKGCxjkhK",295,0.996622,24,296,1,295,1,1,0,1,1,148,147,148,148,81
"7654",53,"[24]joIpleoHcosHnJHqKGCxjkhK",299,0.996667,24,300,1,299,1,1,0,1,1,153,152,147,147,81
"7655",54,"[24]joIpleoHcosHnJHqKGCxjkhK",306,0.996743,24,307,1,306,1,1,0,1,1,161,160,146,146,81
"7656",55,"[24]joIpleoHcosHnJHqKGCxjkhK",290,0.996564,24,291,1,290,1,1,0,1,1,134,133,157,157,81
"7657",56,"[24]joIpleoHcosHnJHqKGCxjkhK",288,0.99654,24,289,1,288,1,1,0,1,1,141,140,148,148,81
"7658",57,"[24]joIpleoHcosHnJHqKGCxjkhK",296,0.996633,24,297,1,296,1,1,0,1,1,158,157,139,139,81
"7659",58,"[24]joIpleoHcosHnJHqKGCxjkhK",293,0.996599,24,294,1,293,1,1,0,1,1,151,150,143,143,81
"7660",59,"[24]joIpleoHcosHnJHqKGCxjkhK",298,0.996656,24,299,1,298,1,1,0,1,1,145,144,154,154,81
"7661",60,"[24]joIpleoHcosHnJHqKGCxjkhK",296,0.996633,24,297,1,296,1,1,0,1,1,145,144,152,152,81
"7662",61,"[24]joIpleoHcosHnJHqKGCxjkhK",302,0.9967,24,303,1,302,1,1,0,1,1,155,154,148,148,81
"7663",62,"[24]joIpleoHcosHnJHqKGCxjkhK",304,0.996721,24,305,1,304,1,1,0,1,1,170,169,135,135,81
"7664",63,"[24]joIpleoHcosHnJHqKGCxjkhK",279,0.996429,24,280,1,279,1,1,0,1,1,117,116,163,163,81
"7665",64,"[24]joIpleoHcosHnJHqKGCxjkhK",295,0.996622,24,296,1,295,1,1,0,1,1,150,149,146,146,81
"7666",65,"[24]joIpleoHcosHnJHqKGCxjkhK",297,0.996644,24,298,1,297,1,1,0,1,1,154,153,144,144,81
"7667",66,"[24]joIpleoHcosHnJHqKGCxjkhK",296,0.996633,24,297,1,296,1,1,0,1,1,150,149,147,147,81
"7668",67,"[24]joIpleoHcosHnJHqKGCxjkhK",295,0.996622,24,296,1,295,1,1,0,1,1,155,154,141,141,81
"7669",68,"[24]joIpleoHcosHnJHqKGCxjkhK",290,0.996564,24,291,1,290,1,1,0,1,1,132,131,159,159,81
"7670",69,"[24]joIpleoHcosHnJHqKGCxjkhK",285,0.996503,24,286,1,285,1,1,0,1,1,136,135,150,150,81
"7671",70,"[24]joIpleoHcosHnJHqKGCxjkhK",301,0.996689,24,302,1,301,1,1,0,1,1,160,159,142,142,81
"7672",71,"[24]joIpleoHcosHnJHqKGCxjkhK",301,0.996689,24,302,1,301,1,1,0,1,1,152,151,150,150,81
"7673",72,"[24]joIpleoHcosHnJHqKGCxjkhK",303,0.996711,24,304,1,303,1,1,0,1,1,157,156,147,147,81
"7674",73,"[24]joIpleoHcosHnJHqKGCxjkhK",291,0.996575,24,292,1,291,1,1,0,1,1,130,129,162,162,81
"7675",74,"[24]joIpleoHcosHnJHqKGCxjkhK",301,0.996689,24,302,1,301,1,1,0,1,1,157,156,145,145,81
"7676",75,"[24]joIpleoHcosHnJHqKGCxjkhK",298,0.996656,24,299,1,298,1,1,0,1,1,133,132,166,166,81
"7677",76,"[24]joIpleoHcosHnJHqKGCxjkhK",294,0.99661,24,295,1,294,1,1,0,1,1,146,145,149,149,81
"7678",77,"[24]joIpleoHcosHnJHqKGCxjkhK",296,0.996633,24,297,1,296,1,1,0,1,1,149,148,148,148,81
"7679",78,"[24]joIpleoHcosHnJHqKGCxjkhK",295,0.996622,24,296,1,295,1,1,0,1,1,150,149,146,146,81
"7680",79,"[24]joIpleoHcosHnJHqKGCxjkhK",295,0.996622,24,296,1,295,1,1,0,1,1,149,148,147,147,81
"7681",80,"[24]joIpleoHcosHnJHqKGCxjkhK",300,0.996678,24,301,1,300,1,1,0,1,1,152,151,149,149,81
"7682",81,"[24]joIpleoHcosHnJHqKGCxjkhK",297,0.996644,24,298,1,297,1,1,0,1,1,144,143,154,154,81
"7683",82,"[24]joIpleoHcosHnJHqKGCxjkhK",291,0.996575,24,292,1,291,1,1,0,1,1,144,143,148,148,81
"7684",83,"[24]joIpleoHcosHnJHqKGCxjkhK",296,0.996633,24,297,1,296,1,1,0,1,1,164,163,133,133,81
"7685",84,"[24]joIpleoHcosHnJHqKGCxjkhK",290,0.996564,24,291,1,290,1,1,0,1,1,135,134,156,156,81
"7686",85,"[24]joIpleoHcosHnJHqKGCxjkhK",310,0.996785,24,311,1,310,1,1,0,1,1,160,159,151,151,81
"7687",86,"[24]joIpleoHcosHnJHqKGCxjkhK",299,0.996667,24,300,1,299,1,1,0,1,1,157,156,143,143,81
"7688",87,"[24]joIpleoHcosHnJHqKGCxjkhK",291,0.996575,24,292,1,291,1,1,0,1,1,143,142,149,149,81
"7689",88,"[24]joIpleoHcosHnJHqKGCxjkhK",297,0.996644,24,298,1,297,1,1,0,1,1,143,142,155,155,81
"7690",89,"[24]joIpleoHcosHnJHqKGCxjkhK",304,0.996721,24,305,1,304,1,1,0,1,1,172,171,133,133,81
"7691",90,"[24]joIpleoHcosHnJHqKGCxjkhK",297,0.996644,24,298,1,297,1,1,0,1,1,166,165,132,132,81
"7692",91,"[24]joIpleoHcosHnJHqKGCxjkhK",291,0.996575,24,292,1,291,1,1,0,1,1,145,144,147,147,81
"7693",92,"[24]joIpleoHcosHnJHqKGCxjkhK",293,0.996599,24,294,1,293,1,1,0,1,1,143,142,151,151,81
"7694",93,"[24]joIpleoHcosHnJHqKGCxjkhK",297,0.996644,24,298,1,297,1,1,0,1,1,152,151,146,146,81
"7695",94,"[24]joIpleoHcosHnJHqKGCxjkhK",298,0.996656,24,299,1,298,1,1,0,1,1,143,142,156,156,81
"7696",95,"[24]joIpleoHcosHnJHqKGCxjkhK",302,0.9967,24,303,1,302,1,1,0,1,1,173,172,130,130,81
"7697",96,"[24]joIpleoHcosHnJHqKGCxjkhK",295,0.996622,24,296,1,295,1,1,0,1,1,140,139,156,156,81
"7698",97,"[24]joIpleoHcosHnJHqKGCxjkhK",303,0.996711,24,304,1,303,1,1,0,1,1,157,156,147,147,81
"7699",98,"[24]joIpleoHcosHnJHqKGCxjkhK",295,0.996622,24,296,1,295,1,1,0,1,1,152,151,144,144,81
"7700",99,"[24]joIpleoHcosHnJHqKGCxjkhK",294,0.99661,24,295,1,294,1,1,0,1,1,148,147,147,147,81
"7701",0,"[23]uFjxoIoHcosHnJHGqKChEeb",279,0.996429,23,280,1,279,1,1,0,1,1,135,134,145,145,82
"7702",1,"[23]uFjxoIoHcosHnJHGqKChEeb",280,0.996441,23,281,1,280,1,1,0,1,1,137,136,144,144,82
"7703",2,"[23]uFjxoIoHcosHnJHGqKChEeb",281,0.996454,23,282,1,281,1,1,0,1,1,134,133,148,148,82
"7704",3,"[23]uFjxoIoHcosHnJHGqKChEeb",279,0.996429,23,280,1,279,1,1,0,1,1,133,132,147,147,82
"7705",4,"[23]uFjxoIoHcosHnJHGqKChEeb",277,0.996403,23,278,1,277,1,1,0,1,1,153,152,125,125,82
"7706",5,"[23]uFjxoIoHcosHnJHGqKChEeb",282,0.996466,23,283,1,282,1,1,0,1,1,133,132,150,150,82
"7707",6,"[23]uFjxoIoHcosHnJHGqKChEeb",277,0.996403,23,278,1,277,1,1,0,1,1,118,117,160,160,82
"7708",7,"[23]uFjxoIoHcosHnJHGqKChEeb",287,0.996528,23,288,1,287,1,1,0,1,1,143,142,145,145,82
"7709",8,"[23]uFjxoIoHcosHnJHGqKChEeb",277,0.996403,23,278,1,277,1,1,0,1,1,133,132,145,145,82
"7710",9,"[23]uFjxoIoHcosHnJHGqKChEeb",280,0.996441,23,281,1,280,1,1,0,1,1,152,151,129,129,82
"7711",10,"[23]uFjxoIoHcosHnJHGqKChEeb",280,0.996441,23,281,1,280,1,1,0,1,1,135,134,146,146,82
"7712",11,"[23]uFjxoIoHcosHnJHGqKChEeb",278,0.996416,23,279,1,278,1,1,0,1,1,149,148,130,130,82
"7713",12,"[23]uFjxoIoHcosHnJHGqKChEeb",283,0.996479,23,284,1,283,1,1,0,1,1,131,130,153,153,82
"7714",13,"[23]uFjxoIoHcosHnJHGqKChEeb",287,0.996528,23,288,1,287,1,1,0,1,1,142,141,146,146,82
"7715",14,"[23]uFjxoIoHcosHnJHGqKChEeb",287,0.996528,23,288,1,287,1,1,0,1,1,142,141,146,146,82
"7716",15,"[23]uFjxoIoHcosHnJHGqKChEeb",276,0.99639,23,277,1,276,1,1,0,1,1,145,144,132,132,82
"7717",16,"[23]uFjxoIoHcosHnJHGqKChEeb",284,0.996491,23,285,1,284,1,1,0,1,1,155,154,130,130,82
"7718",17,"[23]uFjxoIoHcosHnJHGqKChEeb",273,0.99635,23,274,1,273,1,1,0,1,1,128,127,146,146,82
"7719",18,"[23]uFjxoIoHcosHnJHGqKChEeb",280,0.996441,23,281,1,280,1,1,0,1,1,156,155,125,125,82
"7720",19,"[23]uFjxoIoHcosHnJHGqKChEeb",278,0.996416,23,279,1,278,1,1,0,1,1,142,141,137,137,82
"7721",20,"[23]uFjxoIoHcosHnJHGqKChEeb",286,0.996516,23,287,1,286,1,1,0,1,1,154,153,133,133,82
"7722",21,"[23]uFjxoIoHcosHnJHGqKChEeb",279,0.996429,23,280,1,279,1,1,0,1,1,143,142,137,137,82
"7723",22,"[23]uFjxoIoHcosHnJHGqKChEeb",282,0.996466,23,283,1,282,1,1,0,1,1,151,150,132,132,82
"7724",23,"[23]uFjxoIoHcosHnJHGqKChEeb",288,0.99654,23,289,1,288,1,1,0,1,1,151,150,138,138,82
"7725",24,"[23]uFjxoIoHcosHnJHGqKChEeb",279,0.996429,23,280,1,279,1,1,0,1,1,146,145,134,134,82
"7726",25,"[23]uFjxoIoHcosHnJHGqKChEeb",276,0.99639,23,277,1,276,1,1,0,1,1,124,123,153,153,82
"7727",26,"[23]uFjxoIoHcosHnJHGqKChEeb",284,0.996491,23,285,1,284,1,1,0,1,1,151,150,134,134,82
"7728",27,"[23]uFjxoIoHcosHnJHGqKChEeb",277,0.996403,23,278,1,277,1,1,0,1,1,140,139,138,138,82
"7729",28,"[23]uFjxoIoHcosHnJHGqKChEeb",277,0.996403,23,278,1,277,1,1,0,1,1,127,126,151,151,82
"7730",29,"[23]uFjxoIoHcosHnJHGqKChEeb",291,0.996575,23,292,1,291,1,1,0,1,1,144,143,148,148,82
"7731",30,"[23]uFjxoIoHcosHnJHGqKChEeb",287,0.996528,23,288,1,287,1,1,0,1,1,153,152,135,135,82
"7732",31,"[23]uFjxoIoHcosHnJHGqKChEeb",282,0.996466,23,283,1,282,1,1,0,1,1,144,143,139,139,82
"7733",32,"[23]uFjxoIoHcosHnJHGqKChEeb",286,0.996516,23,287,1,286,1,1,0,1,1,145,144,142,142,82
"7734",33,"[23]uFjxoIoHcosHnJHGqKChEeb",283,0.996479,23,284,1,283,1,1,0,1,1,141,140,143,143,82
"7735",34,"[23]uFjxoIoHcosHnJHGqKChEeb",281,0.996454,23,282,1,281,1,1,0,1,1,144,143,138,138,82
"7736",35,"[23]uFjxoIoHcosHnJHGqKChEeb",276,0.99639,23,277,1,276,1,1,0,1,1,137,136,140,140,82
"7737",36,"[23]uFjxoIoHcosHnJHGqKChEeb",281,0.996454,23,282,1,281,1,1,0,1,1,136,135,146,146,82
"7738",37,"[23]uFjxoIoHcosHnJHGqKChEeb",282,0.996466,23,283,1,282,1,1,0,1,1,143,142,140,140,82
"7739",38,"[23]uFjxoIoHcosHnJHGqKChEeb",270,0.99631,23,271,1,270,1,1,0,1,1,123,122,148,148,82
"7740",39,"[23]uFjxoIoHcosHnJHGqKChEeb",280,0.996441,23,281,1,280,1,1,0,1,1,141,140,140,140,82
"7741",40,"[23]uFjxoIoHcosHnJHGqKChEeb",286,0.996516,23,287,1,286,1,1,0,1,1,150,149,137,137,82
"7742",41,"[23]uFjxoIoHcosHnJHGqKChEeb",286,0.996516,23,287,1,286,1,1,0,1,1,151,150,136,136,82
"7743",42,"[23]uFjxoIoHcosHnJHGqKChEeb",277,0.996403,23,278,1,277,1,1,0,1,1,136,135,142,142,82
"7744",43,"[23]uFjxoIoHcosHnJHGqKChEeb",277,0.996403,23,278,1,277,1,1,0,1,1,134,133,144,144,82
"7745",44,"[23]uFjxoIoHcosHnJHGqKChEeb",280,0.996441,23,281,1,280,1,1,0,1,1,139,138,142,142,82
"7746",45,"[23]uFjxoIoHcosHnJHGqKChEeb",279,0.996429,23,280,1,279,1,1,0,1,1,140,139,140,140,82
"7747",46,"[23]uFjxoIoHcosHnJHGqKChEeb",278,0.996416,23,279,1,278,1,1,0,1,1,131,130,148,148,82
"7748",47,"[23]uFjxoIoHcosHnJHGqKChEeb",277,0.996403,23,278,1,277,1,1,0,1,1,148,147,130,130,82
"7749",48,"[23]uFjxoIoHcosHnJHGqKChEeb",278,0.996416,23,279,1,278,1,1,0,1,1,116,115,163,163,82
"7750",49,"[23]uFjxoIoHcosHnJHGqKChEeb",283,0.996479,23,284,1,283,1,1,0,1,1,146,145,138,138,82
"7751",50,"[23]uFjxoIoHcosHnJHGqKChEeb",284,0.996491,23,285,1,284,1,1,0,1,1,142,141,143,143,82
"7752",51,"[23]uFjxoIoHcosHnJHGqKChEeb",287,0.996528,23,288,1,287,1,1,0,1,1,148,147,140,140,82
"7753",52,"[23]uFjxoIoHcosHnJHGqKChEeb",285,0.996503,23,286,1,285,1,1,0,1,1,139,138,147,147,82
"7754",53,"[23]uFjxoIoHcosHnJHGqKChEeb",277,0.996403,23,278,1,277,1,1,0,1,1,149,148,129,129,82
"7755",54,"[23]uFjxoIoHcosHnJHGqKChEeb",269,0.996296,23,270,1,269,1,1,0,1,1,126,125,144,144,82
"7756",55,"[23]uFjxoIoHcosHnJHGqKChEeb",282,0.996466,23,283,1,282,1,1,0,1,1,149,148,134,134,82
"7757",56,"[23]uFjxoIoHcosHnJHGqKChEeb",275,0.996377,23,276,1,275,1,1,0,1,1,141,140,135,135,82
"7758",57,"[23]uFjxoIoHcosHnJHGqKChEeb",289,0.996552,23,290,1,289,1,1,0,1,1,147,146,143,143,82
"7759",58,"[23]uFjxoIoHcosHnJHGqKChEeb",284,0.996491,23,285,1,284,1,1,0,1,1,143,142,142,142,82
"7760",59,"[23]uFjxoIoHcosHnJHGqKChEeb",283,0.996479,23,284,1,283,1,1,0,1,1,140,139,144,144,82
"7761",60,"[23]uFjxoIoHcosHnJHGqKChEeb",280,0.996441,23,281,1,280,1,1,0,1,1,134,133,147,147,82
"7762",61,"[23]uFjxoIoHcosHnJHGqKChEeb",286,0.996516,23,287,1,286,1,1,0,1,1,159,158,128,128,82
"7763",62,"[23]uFjxoIoHcosHnJHGqKChEeb",275,0.996377,23,276,1,275,1,1,0,1,1,144,143,132,132,82
"7764",63,"[23]uFjxoIoHcosHnJHGqKChEeb",286,0.996516,23,287,1,286,1,1,0,1,1,137,136,150,150,82
"7765",64,"[23]uFjxoIoHcosHnJHGqKChEeb",280,0.996441,23,281,1,280,1,1,0,1,1,137,136,144,144,82
"7766",65,"[23]uFjxoIoHcosHnJHGqKChEeb",285,0.996503,23,286,1,285,1,1,0,1,1,148,147,138,138,82
"7767",66,"[23]uFjxoIoHcosHnJHGqKChEeb",278,0.996416,23,279,1,278,1,1,0,1,1,138,137,141,141,82
"7768",67,"[23]uFjxoIoHcosHnJHGqKChEeb",287,0.996528,23,288,1,287,1,1,0,1,1,149,148,139,139,82
"7769",68,"[23]uFjxoIoHcosHnJHGqKChEeb",280,0.996441,23,281,1,280,1,1,0,1,1,130,129,151,151,82
"7770",69,"[23]uFjxoIoHcosHnJHGqKChEeb",276,0.99639,23,277,1,276,1,1,0,1,1,135,134,142,142,82
"7771",70,"[23]uFjxoIoHcosHnJHGqKChEeb",282,0.996466,23,283,1,282,1,1,0,1,1,147,146,136,136,82
"7772",71,"[23]uFjxoIoHcosHnJHGqKChEeb",286,0.996516,23,287,1,286,1,1,0,1,1,144,143,143,143,82
"7773",72,"[23]uFjxoIoHcosHnJHGqKChEeb",280,0.996441,23,281,1,280,1,1,0,1,1,124,123,157,157,82
"7774",73,"[23]uFjxoIoHcosHnJHGqKChEeb",280,0.996441,23,281,1,280,1,1,0,1,1,138,137,143,143,82
"7775",74,"[23]uFjxoIoHcosHnJHGqKChEeb",277,0.996403,23,278,1,277,1,1,0,1,1,130,129,148,148,82
"7776",75,"[23]uFjxoIoHcosHnJHGqKChEeb",283,0.996479,23,284,1,283,1,1,0,1,1,154,153,130,130,82
"7777",76,"[23]uFjxoIoHcosHnJHGqKChEeb",277,0.996403,23,278,1,277,1,1,0,1,1,137,136,141,141,82
"7778",77,"[23]uFjxoIoHcosHnJHGqKChEeb",282,0.996466,23,283,1,282,1,1,0,1,1,144,143,139,139,82
"7779",78,"[23]uFjxoIoHcosHnJHGqKChEeb",279,0.996429,23,280,1,279,1,1,0,1,1,138,137,142,142,82
"7780",79,"[23]uFjxoIoHcosHnJHGqKChEeb",278,0.996416,23,279,1,278,1,1,0,1,1,142,141,137,137,82
"7781",80,"[23]uFjxoIoHcosHnJHGqKChEeb",279,0.996429,23,280,1,279,1,1,0,1,1,135,134,145,145,82
"7782",81,"[23]uFjxoIoHcosHnJHGqKChEeb",283,0.996479,23,284,1,283,1,1,0,1,1,138,137,146,146,82
"7783",82,"[23]uFjxoIoHcosHnJHGqKChEeb",286,0.996516,23,287,1,286,1,1,0,1,1,150,149,137,137,82
"7784",83,"[23]uFjxoIoHcosHnJHGqKChEeb",278,0.996416,23,279,1,278,1,1,0,1,1,134,133,145,145,82
"7785",84,"[23]uFjxoIoHcosHnJHGqKChEeb",284,0.996491,23,285,1,284,1,1,0,1,1,147,146,138,138,82
"7786",85,"[23]uFjxoIoHcosHnJHGqKChEeb",281,0.996454,23,282,1,281,1,1,0,1,1,139,138,143,143,82
"7787",86,"[23]uFjxoIoHcosHnJHGqKChEeb",282,0.996466,23,283,1,282,1,1,0,1,1,141,140,142,142,82
"7788",87,"[23]uFjxoIoHcosHnJHGqKChEeb",283,0.996479,23,284,1,283,1,1,0,1,1,134,133,150,150,82
"7789",88,"[23]uFjxoIoHcosHnJHGqKChEeb",283,0.996479,23,284,1,283,1,1,0,1,1,153,152,131,131,82
"7790",89,"[23]uFjxoIoHcosHnJHGqKChEeb",282,0.996466,23,283,1,282,1,1,0,1,1,148,147,135,135,82
"7791",90,"[23]uFjxoIoHcosHnJHGqKChEeb",290,0.996564,23,291,1,290,1,1,0,1,1,156,155,135,135,82
"7792",91,"[23]uFjxoIoHcosHnJHGqKChEeb",284,0.996491,23,285,1,284,1,1,0,1,1,139,138,146,146,82
"7793",92,"[23]uFjxoIoHcosHnJHGqKChEeb",285,0.996503,23,286,1,285,1,1,0,1,1,155,154,131,131,82
"7794",93,"[23]uFjxoIoHcosHnJHGqKChEeb",282,0.996466,23,283,1,282,1,1,0,1,1,146,145,137,137,82
"7795",94,"[23]uFjxoIoHcosHnJHGqKChEeb",278,0.996416,23,279,1,278,1,1,0,1,1,127,126,152,152,82
"7796",95,"[23]uFjxoIoHcosHnJHGqKChEeb",282,0.996466,23,283,1,282,1,1,0,1,1,151,150,132,132,82
"7797",96,"[23]uFjxoIoHcosHnJHGqKChEeb",276,0.99639,23,277,1,276,1,1,0,1,1,138,137,139,139,82
"7798",97,"[23]uFjxoIoHcosHnJHGqKChEeb",275,0.996377,23,276,1,275,1,1,0,1,1,133,132,143,143,82
"7799",98,"[23]uFjxoIoHcosHnJHGqKChEeb",285,0.996503,23,286,1,285,1,1,0,1,1,148,147,138,138,82
"7800",99,"[23]uFjxoIoHcosHnJHGqKChEeb",281,0.996454,23,282,1,281,1,1,0,1,1,149,148,133,133,82
"7801",0,"[17]CHoIoHcoxHnJqGKCn",298,0.996656,17,299,1,298,1,1,0,1,1,149,148,150,150,83
"7802",1,"[17]CHoIoHcoxHnJqGKCn",292,0.996587,17,293,1,292,1,1,0,1,1,138,137,155,155,83
"7803",2,"[17]CHoIoHcoxHnJqGKCn",290,0.996564,17,291,1,290,1,1,0,1,1,141,140,150,150,83
"7804",3,"[17]CHoIoHcoxHnJqGKCn",294,0.99661,17,295,1,294,1,1,0,1,1,141,140,154,154,83
"7805",4,"[17]CHoIoHcoxHnJqGKCn",300,0.996678,17,301,1,300,1,1,0,1,1,162,161,139,139,83
"7806",5,"[17]CHoIoHcoxHnJqGKCn",300,0.996678,17,301,1,300,1,1,0,1,1,159,158,142,142,83
"7807",6,"[17]CHoIoHcoxHnJqGKCn",296,0.996633,17,297,1,296,1,1,0,1,1,145,144,152,152,83
"7808",7,"[17]CHoIoHcoxHnJqGKCn",295,0.996622,17,296,1,295,1,1,0,1,1,144,143,152,152,83
"7809",8,"[17]CHoIoHcoxHnJqGKCn",293,0.996599,17,294,1,293,1,1,0,1,1,139,138,155,155,83
"7810",9,"[17]CHoIoHcoxHnJqGKCn",300,0.996678,17,301,1,300,1,1,0,1,1,154,153,147,147,83
"7811",10,"[17]CHoIoHcoxHnJqGKCn",293,0.996599,17,294,1,293,1,1,0,1,1,146,145,148,148,83
"7812",11,"[17]CHoIoHcoxHnJqGKCn",295,0.996622,17,296,1,295,1,1,0,1,1,146,145,150,150,83
"7813",12,"[17]CHoIoHcoxHnJqGKCn",293,0.996599,17,294,1,293,1,1,0,1,1,140,139,154,154,83
"7814",13,"[17]CHoIoHcoxHnJqGKCn",298,0.996656,17,299,1,298,1,1,0,1,1,159,158,140,140,83
"7815",14,"[17]CHoIoHcoxHnJqGKCn",288,0.99654,17,289,1,288,1,1,0,1,1,124,123,165,165,83
"7816",15,"[17]CHoIoHcoxHnJqGKCn",296,0.996633,17,297,1,296,1,1,0,1,1,149,148,148,148,83
"7817",16,"[17]CHoIoHcoxHnJqGKCn",299,0.996667,17,300,1,299,1,1,0,1,1,156,155,144,144,83
"7818",17,"[17]CHoIoHcoxHnJqGKCn",301,0.996689,17,302,1,301,1,1,0,1,1,165,164,137,137,83
"7819",18,"[17]CHoIoHcoxHnJqGKCn",292,0.996587,17,293,1,292,1,1,0,1,1,141,140,152,152,83
"7820",19,"[17]CHoIoHcoxHnJqGKCn",295,0.996622,17,296,1,295,1,1,0,1,1,150,149,146,146,83
"7821",20,"[17]CHoIoHcoxHnJqGKCn",294,0.99661,17,295,1,294,1,1,0,1,1,140,139,155,155,83
"7822",21,"[17]CHoIoHcoxHnJqGKCn",298,0.996656,17,299,1,298,1,1,0,1,1,157,156,142,142,83
"7823",22,"[17]CHoIoHcoxHnJqGKCn",298,0.996656,17,299,1,298,1,1,0,1,1,154,153,145,145,83
"7824",23,"[17]CHoIoHcoxHnJqGKCn",294,0.99661,17,295,1,294,1,1,0,1,1,147,146,148,148,83
"7825",24,"[17]CHoIoHcoxHnJqGKCn",294,0.99661,17,295,1,294,1,1,0,1,1,143,142,152,152,83
"7826",25,"[17]CHoIoHcoxHnJqGKCn",296,0.996633,17,297,1,296,1,1,0,1,1,152,151,145,145,83
"7827",26,"[17]CHoIoHcoxHnJqGKCn",301,0.996689,17,302,1,301,1,1,0,1,1,168,167,134,134,83
"7828",27,"[17]CHoIoHcoxHnJqGKCn",298,0.996656,17,299,1,298,1,1,0,1,1,152,151,147,147,83
"7829",28,"[17]CHoIoHcoxHnJqGKCn",297,0.996644,17,298,1,297,1,1,0,1,1,155,154,143,143,83
"7830",29,"[17]CHoIoHcoxHnJqGKCn",290,0.996564,17,291,1,290,1,1,0,1,1,137,136,154,154,83
"7831",30,"[17]CHoIoHcoxHnJqGKCn",292,0.996587,17,293,1,292,1,1,0,1,1,136,135,157,157,83
"7832",31,"[17]CHoIoHcoxHnJqGKCn",300,0.996678,17,301,1,300,1,1,0,1,1,161,160,140,140,83
"7833",32,"[17]CHoIoHcoxHnJqGKCn",300,0.996678,17,301,1,300,1,1,0,1,1,156,155,145,145,83
"7834",33,"[17]CHoIoHcoxHnJqGKCn",298,0.996656,17,299,1,298,1,1,0,1,1,151,150,148,148,83
"7835",34,"[17]CHoIoHcoxHnJqGKCn",298,0.996656,17,299,1,298,1,1,0,1,1,154,153,145,145,83
"7836",35,"[17]CHoIoHcoxHnJqGKCn",293,0.996599,17,294,1,293,1,1,0,1,1,141,140,153,153,83
"7837",36,"[17]CHoIoHcoxHnJqGKCn",293,0.996599,17,294,1,293,1,1,0,1,1,141,140,153,153,83
"7838",37,"[17]CHoIoHcoxHnJqGKCn",295,0.996622,17,296,1,295,1,1,0,1,1,143,142,153,153,83
"7839",38,"[17]CHoIoHcoxHnJqGKCn",298,0.996656,17,299,1,298,1,1,0,1,1,157,156,142,142,83
"7840",39,"[17]CHoIoHcoxHnJqGKCn",296,0.996633,17,297,1,296,1,1,0,1,1,145,144,152,152,83
"7841",40,"[17]CHoIoHcoxHnJqGKCn",297,0.996644,17,298,1,297,1,1,0,1,1,149,148,149,149,83
"7842",41,"[17]CHoIoHcoxHnJqGKCn",298,0.996656,17,299,1,298,1,1,0,1,1,156,155,143,143,83
"7843",42,"[17]CHoIoHcoxHnJqGKCn",298,0.996656,17,299,1,298,1,1,0,1,1,154,153,145,145,83
"7844",43,"[17]CHoIoHcoxHnJqGKCn",295,0.996622,17,296,1,295,1,1,0,1,1,146,145,150,150,83
"7845",44,"[17]CHoIoHcoxHnJqGKCn",297,0.996644,17,298,1,297,1,1,0,1,1,151,150,147,147,83
"7846",45,"[17]CHoIoHcoxHnJqGKCn",297,0.996644,17,298,1,297,1,1,0,1,1,154,153,144,144,83
"7847",46,"[17]CHoIoHcoxHnJqGKCn",291,0.996575,17,292,1,291,1,1,0,1,1,143,142,149,149,83
"7848",47,"[17]CHoIoHcoxHnJqGKCn",298,0.996656,17,299,1,298,1,1,0,1,1,157,156,142,142,83
"7849",48,"[17]CHoIoHcoxHnJqGKCn",298,0.996656,17,299,1,298,1,1,0,1,1,152,151,147,147,83
"7850",49,"[17]CHoIoHcoxHnJqGKCn",294,0.99661,17,295,1,294,1,1,0,1,1,148,147,147,147,83
"7851",50,"[17]CHoIoHcoxHnJqGKCn",293,0.996599,17,294,1,293,1,1,0,1,1,142,141,152,152,83
"7852",51,"[17]CHoIoHcoxHnJqGKCn",296,0.996633,17,297,1,296,1,1,0,1,1,145,144,152,152,83
"7853",52,"[17]CHoIoHcoxHnJqGKCn",299,0.996667,17,300,1,299,1,1,0,1,1,158,157,142,142,83
"7854",53,"[17]CHoIoHcoxHnJqGKCn",298,0.996656,17,299,1,298,1,1,0,1,1,156,155,143,143,83
"7855",54,"[17]CHoIoHcoxHnJqGKCn",297,0.996644,17,298,1,297,1,1,0,1,1,156,155,142,142,83
"7856",55,"[17]CHoIoHcoxHnJqGKCn",300,0.996678,17,301,1,300,1,1,0,1,1,164,163,137,137,83
"7857",56,"[17]CHoIoHcoxHnJqGKCn",294,0.99661,17,295,1,294,1,1,0,1,1,152,151,143,143,83
"7858",57,"[17]CHoIoHcoxHnJqGKCn",294,0.99661,17,295,1,294,1,1,0,1,1,147,146,148,148,83
"7859",58,"[17]CHoIoHcoxHnJqGKCn",298,0.996656,17,299,1,298,1,1,0,1,1,151,150,148,148,83
"7860",59,"[17]CHoIoHcoxHnJqGKCn",300,0.996678,17,301,1,300,1,1,0,1,1,153,152,148,148,83
"7861",60,"[17]CHoIoHcoxHnJqGKCn",296,0.996633,17,297,1,296,1,1,0,1,1,147,146,150,150,83
"7862",61,"[17]CHoIoHcoxHnJqGKCn",296,0.996633,17,297,1,296,1,1,0,1,1,157,156,140,140,83
"7863",62,"[17]CHoIoHcoxHnJqGKCn",298,0.996656,17,299,1,298,1,1,0,1,1,147,146,152,152,83
"7864",63,"[17]CHoIoHcoxHnJqGKCn",295,0.996622,17,296,1,295,1,1,0,1,1,146,145,150,150,83
"7865",64,"[17]CHoIoHcoxHnJqGKCn",295,0.996622,17,296,1,295,1,1,0,1,1,151,150,145,145,83
"7866",65,"[17]CHoIoHcoxHnJqGKCn",293,0.996599,17,294,1,293,1,1,0,1,1,140,139,154,154,83
"7867",66,"[17]CHoIoHcoxHnJqGKCn",303,0.996711,17,304,1,303,1,1,0,1,1,175,174,129,129,83
"7868",67,"[17]CHoIoHcoxHnJqGKCn",297,0.996644,17,298,1,297,1,1,0,1,1,151,150,147,147,83
"7869",68,"[17]CHoIoHcoxHnJqGKCn",290,0.996564,17,291,1,290,1,1,0,1,1,133,132,158,158,83
"7870",69,"[17]CHoIoHcoxHnJqGKCn",293,0.996599,17,294,1,293,1,1,0,1,1,136,135,158,158,83
"7871",70,"[17]CHoIoHcoxHnJqGKCn",296,0.996633,17,297,1,296,1,1,0,1,1,146,145,151,151,83
"7872",71,"[17]CHoIoHcoxHnJqGKCn",302,0.9967,17,303,1,302,1,1,0,1,1,165,164,138,138,83
"7873",72,"[17]CHoIoHcoxHnJqGKCn",296,0.996633,17,297,1,296,1,1,0,1,1,149,148,148,148,83
"7874",73,"[17]CHoIoHcoxHnJqGKCn",297,0.996644,17,298,1,297,1,1,0,1,1,151,150,147,147,83
"7875",74,"[17]CHoIoHcoxHnJqGKCn",292,0.996587,17,293,1,292,1,1,0,1,1,139,138,154,154,83
"7876",75,"[17]CHoIoHcoxHnJqGKCn",295,0.996622,17,296,1,295,1,1,0,1,1,145,144,151,151,83
"7877",76,"[17]CHoIoHcoxHnJqGKCn",295,0.996622,17,296,1,295,1,1,0,1,1,149,148,147,147,83
"7878",77,"[17]CHoIoHcoxHnJqGKCn",297,0.996644,17,298,1,297,1,1,0,1,1,162,161,136,136,83
"7879",78,"[17]CHoIoHcoxHnJqGKCn",302,0.9967,17,303,1,302,1,1,0,1,1,166,165,137,137,83
"7880",79,"[17]CHoIoHcoxHnJqGKCn",301,0.996689,17,302,1,301,1,1,0,1,1,161,160,141,141,83
"7881",80,"[17]CHoIoHcoxHnJqGKCn",295,0.996622,17,296,1,295,1,1,0,1,1,146,145,150,150,83
"7882",81,"[17]CHoIoHcoxHnJqGKCn",301,0.996689,17,302,1,301,1,1,0,1,1,158,157,144,144,83
"7883",82,"[17]CHoIoHcoxHnJqGKCn",292,0.996587,17,293,1,292,1,1,0,1,1,138,137,155,155,83
"7884",83,"[17]CHoIoHcoxHnJqGKCn",291,0.996575,17,292,1,291,1,1,0,1,1,134,133,158,158,83
"7885",84,"[17]CHoIoHcoxHnJqGKCn",292,0.996587,17,293,1,292,1,1,0,1,1,141,140,152,152,83
"7886",85,"[17]CHoIoHcoxHnJqGKCn",292,0.996587,17,293,1,292,1,1,0,1,1,146,145,147,147,83
"7887",86,"[17]CHoIoHcoxHnJqGKCn",295,0.996622,17,296,1,295,1,1,0,1,1,148,147,148,148,83
"7888",87,"[17]CHoIoHcoxHnJqGKCn",294,0.99661,17,295,1,294,1,1,0,1,1,142,141,153,153,83
"7889",88,"[17]CHoIoHcoxHnJqGKCn",298,0.996656,17,299,1,298,1,1,0,1,1,152,151,147,147,83
"7890",89,"[17]CHoIoHcoxHnJqGKCn",294,0.99661,17,295,1,294,1,1,0,1,1,142,141,153,153,83
"7891",90,"[17]CHoIoHcoxHnJqGKCn",297,0.996644,17,298,1,297,1,1,0,1,1,148,147,150,150,83
"7892",91,"[17]CHoIoHcoxHnJqGKCn",298,0.996656,17,299,1,298,1,1,0,1,1,154,153,145,145,83
"7893",92,"[17]CHoIoHcoxHnJqGKCn",296,0.996633,17,297,1,296,1,1,0,1,1,144,143,153,153,83
"7894",93,"[17]CHoIoHcoxHnJqGKCn",299,0.996667,17,300,1,299,1,1,0,1,1,157,156,143,143,83
"7895",94,"[17]CHoIoHcoxHnJqGKCn",294,0.99661,17,295,1,294,1,1,0,1,1,147,146,148,148,83
"7896",95,"[17]CHoIoHcoxHnJqGKCn",299,0.996667,17,300,1,299,1,1,0,1,1,167,166,133,133,83
"7897",96,"[17]CHoIoHcoxHnJqGKCn",296,0.996633,17,297,1,296,1,1,0,1,1,149,148,148,148,83
"7898",97,"[17]CHoIoHcoxHnJqGKCn",294,0.99661,17,295,1,294,1,1,0,1,1,142,141,153,153,83
"7899",98,"[17]CHoIoHcoxHnJqGKCn",292,0.996587,17,293,1,292,1,1,0,1,1,142,141,151,151,83
"7900",99,"[17]CHoIoHcoxHnJqGKCn",300,0.996678,17,301,1,300,1,1,0,1,1,162,161,139,139,83
"7901",0,"[23]HoIoHcoxHnJHGqKCihDqBuK",285,0.996503,23,286,1,285,1,1,0,1,1,139,138,147,147,84
"7902",1,"[23]HoIoHcoxHnJHGqKCihDqBuK",276,0.99639,23,277,1,276,1,1,0,1,1,141,140,136,136,84
"7903",2,"[23]HoIoHcoxHnJHGqKCihDqBuK",282,0.996466,23,283,1,282,1,1,0,1,1,135,134,148,148,84
"7904",3,"[23]HoIoHcoxHnJHGqKCihDqBuK",286,0.996516,23,287,1,286,1,1,0,1,1,161,160,126,126,84
"7905",4,"[23]HoIoHcoxHnJHGqKCihDqBuK",282,0.996466,23,283,1,282,1,1,0,1,1,142,141,141,141,84
"7906",5,"[23]HoIoHcoxHnJHGqKCihDqBuK",279,0.996429,23,280,1,279,1,1,0,1,1,143,142,137,137,84
"7907",6,"[23]HoIoHcoxHnJHGqKCihDqBuK",285,0.996503,23,286,1,285,1,1,0,1,1,156,155,130,130,84
"7908",7,"[23]HoIoHcoxHnJHGqKCihDqBuK",280,0.996441,23,281,1,280,1,1,0,1,1,150,149,131,131,84
"7909",8,"[23]HoIoHcoxHnJHGqKCihDqBuK",282,0.996466,23,283,1,282,1,1,0,1,1,150,149,133,133,84
"7910",9,"[23]HoIoHcoxHnJHGqKCihDqBuK",287,0.996528,23,288,1,287,1,1,0,1,1,151,150,137,137,84
"7911",10,"[23]HoIoHcoxHnJHGqKCihDqBuK",281,0.996454,23,282,1,281,1,1,0,1,1,138,137,144,144,84
"7912",11,"[23]HoIoHcoxHnJHGqKCihDqBuK",284,0.996491,23,285,1,284,1,1,0,1,1,135,134,150,150,84
"7913",12,"[23]HoIoHcoxHnJHGqKCihDqBuK",281,0.996454,23,282,1,281,1,1,0,1,1,138,137,144,144,84
"7914",13,"[23]HoIoHcoxHnJHGqKCihDqBuK",271,0.996324,23,272,1,271,1,1,0,1,1,121,120,151,151,84
"7915",14,"[23]HoIoHcoxHnJHGqKCihDqBuK",285,0.996503,23,286,1,285,1,1,0,1,1,158,157,128,128,84
"7916",15,"[23]HoIoHcoxHnJHGqKCihDqBuK",283,0.996479,23,284,1,283,1,1,0,1,1,136,135,148,148,84
"7917",16,"[23]HoIoHcoxHnJHGqKCihDqBuK",271,0.996324,23,272,1,271,1,1,0,1,1,120,119,152,152,84
"7918",17,"[23]HoIoHcoxHnJHGqKCihDqBuK",283,0.996479,23,284,1,283,1,1,0,1,1,140,139,144,144,84
"7919",18,"[23]HoIoHcoxHnJHGqKCihDqBuK",280,0.996441,23,281,1,280,1,1,0,1,1,136,135,145,145,84
"7920",19,"[23]HoIoHcoxHnJHGqKCihDqBuK",276,0.99639,23,277,1,276,1,1,0,1,1,128,127,149,149,84
"7921",20,"[23]HoIoHcoxHnJHGqKCihDqBuK",283,0.996479,23,284,1,283,1,1,0,1,1,132,131,152,152,84
"7922",21,"[23]HoIoHcoxHnJHGqKCihDqBuK",282,0.996466,23,283,1,282,1,1,0,1,1,131,130,152,152,84
"7923",22,"[23]HoIoHcoxHnJHGqKCihDqBuK",280,0.996441,23,281,1,280,1,1,0,1,1,138,137,143,143,84
"7924",23,"[23]HoIoHcoxHnJHGqKCihDqBuK",281,0.996454,23,282,1,281,1,1,0,1,1,139,138,143,143,84
"7925",24,"[23]HoIoHcoxHnJHGqKCihDqBuK",279,0.996429,23,280,1,279,1,1,0,1,1,143,142,137,137,84
"7926",25,"[23]HoIoHcoxHnJHGqKCihDqBuK",281,0.996454,23,282,1,281,1,1,0,1,1,157,156,125,125,84
"7927",26,"[23]HoIoHcoxHnJHGqKCihDqBuK",278,0.996416,23,279,1,278,1,1,0,1,1,150,149,129,129,84
"7928",27,"[23]HoIoHcoxHnJHGqKCihDqBuK",281,0.996454,23,282,1,281,1,1,0,1,1,136,135,146,146,84
"7929",28,"[23]HoIoHcoxHnJHGqKCihDqBuK",280,0.996441,23,281,1,280,1,1,0,1,1,140,139,141,141,84
"7930",29,"[23]HoIoHcoxHnJHGqKCihDqBuK",280,0.996441,23,281,1,280,1,1,0,1,1,140,139,141,141,84
"7931",30,"[23]HoIoHcoxHnJHGqKCihDqBuK",279,0.996429,23,280,1,279,1,1,0,1,1,118,117,162,162,84
"7932",31,"[23]HoIoHcoxHnJHGqKCihDqBuK",280,0.996441,23,281,1,280,1,1,0,1,1,150,149,131,131,84
"7933",32,"[23]HoIoHcoxHnJHGqKCihDqBuK",282,0.996466,23,283,1,282,1,1,0,1,1,141,140,142,142,84
"7934",33,"[23]HoIoHcoxHnJHGqKCihDqBuK",279,0.996429,23,280,1,279,1,1,0,1,1,146,145,134,134,84
"7935",34,"[23]HoIoHcoxHnJHGqKCihDqBuK",287,0.996528,23,288,1,287,1,1,0,1,1,151,150,137,137,84
"7936",35,"[23]HoIoHcoxHnJHGqKCihDqBuK",277,0.996403,23,278,1,277,1,1,0,1,1,141,140,137,137,84
"7937",36,"[23]HoIoHcoxHnJHGqKCihDqBuK",276,0.99639,23,277,1,276,1,1,0,1,1,116,115,161,161,84
"7938",37,"[23]HoIoHcoxHnJHGqKCihDqBuK",285,0.996503,23,286,1,285,1,1,0,1,1,148,147,138,138,84
"7939",38,"[23]HoIoHcoxHnJHGqKCihDqBuK",287,0.996528,23,288,1,287,1,1,0,1,1,156,155,132,132,84
"7940",39,"[23]HoIoHcoxHnJHGqKCihDqBuK",283,0.996479,23,284,1,283,1,1,0,1,1,147,146,137,137,84
"7941",40,"[23]HoIoHcoxHnJHGqKCihDqBuK",276,0.99639,23,277,1,276,1,1,0,1,1,139,138,138,138,84
"7942",41,"[23]HoIoHcoxHnJHGqKCihDqBuK",284,0.996491,23,285,1,284,1,1,0,1,1,155,154,130,130,84
"7943",42,"[23]HoIoHcoxHnJHGqKCihDqBuK",277,0.996403,23,278,1,277,1,1,0,1,1,135,134,143,143,84
"7944",43,"[23]HoIoHcoxHnJHGqKCihDqBuK",285,0.996503,23,286,1,285,1,1,0,1,1,148,147,138,138,84
"7945",44,"[23]HoIoHcoxHnJHGqKCihDqBuK",281,0.996454,23,282,1,281,1,1,0,1,1,143,142,139,139,84
"7946",45,"[23]HoIoHcoxHnJHGqKCihDqBuK",289,0.996552,23,290,1,289,1,1,0,1,1,150,149,140,140,84
"7947",46,"[23]HoIoHcoxHnJHGqKCihDqBuK",283,0.996479,23,284,1,283,1,1,0,1,1,148,147,136,136,84
"7948",47,"[23]HoIoHcoxHnJHGqKCihDqBuK",273,0.99635,23,274,1,273,1,1,0,1,1,132,131,142,142,84
"7949",48,"[23]HoIoHcoxHnJHGqKCihDqBuK",283,0.996479,23,284,1,283,1,1,0,1,1,153,152,131,131,84
"7950",49,"[23]HoIoHcoxHnJHGqKCihDqBuK",281,0.996454,23,282,1,281,1,1,0,1,1,151,150,131,131,84
"7951",50,"[23]HoIoHcoxHnJHGqKCihDqBuK",273,0.99635,23,274,1,273,1,1,0,1,1,137,136,137,137,84
"7952",51,"[23]HoIoHcoxHnJHGqKCihDqBuK",275,0.996377,23,276,1,275,1,1,0,1,1,121,120,155,155,84
"7953",52,"[23]HoIoHcoxHnJHGqKCihDqBuK",284,0.996491,23,285,1,284,1,1,0,1,1,144,143,141,141,84
"7954",53,"[23]HoIoHcoxHnJHGqKCihDqBuK",285,0.996503,23,286,1,285,1,1,0,1,1,151,150,135,135,84
"7955",54,"[23]HoIoHcoxHnJHGqKCihDqBuK",282,0.996466,23,283,1,282,1,1,0,1,1,151,150,132,132,84
"7956",55,"[23]HoIoHcoxHnJHGqKCihDqBuK",282,0.996466,23,283,1,282,1,1,0,1,1,140,139,143,143,84
"7957",56,"[23]HoIoHcoxHnJHGqKCihDqBuK",281,0.996454,23,282,1,281,1,1,0,1,1,158,157,124,124,84
"7958",57,"[23]HoIoHcoxHnJHGqKCihDqBuK",289,0.996552,23,290,1,289,1,1,0,1,1,159,158,131,131,84
"7959",58,"[23]HoIoHcoxHnJHGqKCihDqBuK",279,0.996429,23,280,1,279,1,1,0,1,1,133,132,147,147,84
"7960",59,"[23]HoIoHcoxHnJHGqKCihDqBuK",290,0.996564,23,291,1,290,1,1,0,1,1,167,166,124,124,84
"7961",60,"[23]HoIoHcoxHnJHGqKCihDqBuK",287,0.996528,23,288,1,287,1,1,0,1,1,166,165,122,122,84
"7962",61,"[23]HoIoHcoxHnJHGqKCihDqBuK",279,0.996429,23,280,1,279,1,1,0,1,1,135,134,145,145,84
"7963",62,"[23]HoIoHcoxHnJHGqKCihDqBuK",274,0.996364,23,275,1,274,1,1,0,1,1,128,127,147,147,84
"7964",63,"[23]HoIoHcoxHnJHGqKCihDqBuK",283,0.996479,23,284,1,283,1,1,0,1,1,140,139,144,144,84
"7965",64,"[23]HoIoHcoxHnJHGqKCihDqBuK",277,0.996403,23,278,1,277,1,1,0,1,1,134,133,144,144,84
"7966",65,"[23]HoIoHcoxHnJHGqKCihDqBuK",276,0.99639,23,277,1,276,1,1,0,1,1,133,132,144,144,84
"7967",66,"[23]HoIoHcoxHnJHGqKCihDqBuK",279,0.996429,23,280,1,279,1,1,0,1,1,139,138,141,141,84
"7968",67,"[23]HoIoHcoxHnJHGqKCihDqBuK",269,0.996296,23,270,1,269,1,1,0,1,1,134,133,136,136,84
"7969",68,"[23]HoIoHcoxHnJHGqKCihDqBuK",287,0.996528,23,288,1,287,1,1,0,1,1,135,134,153,153,84
"7970",69,"[23]HoIoHcoxHnJHGqKCihDqBuK",285,0.996503,23,286,1,285,1,1,0,1,1,143,142,143,143,84
"7971",70,"[23]HoIoHcoxHnJHGqKCihDqBuK",284,0.996491,23,285,1,284,1,1,0,1,1,138,137,147,147,84
"7972",71,"[23]HoIoHcoxHnJHGqKCihDqBuK",277,0.996403,23,278,1,277,1,1,0,1,1,151,150,127,127,84
"7973",72,"[23]HoIoHcoxHnJHGqKCihDqBuK",280,0.996441,23,281,1,280,1,1,0,1,1,140,139,141,141,84
"7974",73,"[23]HoIoHcoxHnJHGqKCihDqBuK",280,0.996441,23,281,1,280,1,1,0,1,1,136,135,145,145,84
"7975",74,"[23]HoIoHcoxHnJHGqKCihDqBuK",278,0.996416,23,279,1,278,1,1,0,1,1,142,141,137,137,84
"7976",75,"[23]HoIoHcoxHnJHGqKCihDqBuK",284,0.996491,23,285,1,284,1,1,0,1,1,146,145,139,139,84
"7977",76,"[23]HoIoHcoxHnJHGqKCihDqBuK",280,0.996441,23,281,1,280,1,1,0,1,1,131,130,150,150,84
"7978",77,"[23]HoIoHcoxHnJHGqKCihDqBuK",277,0.996403,23,278,1,277,1,1,0,1,1,129,128,149,149,84
"7979",78,"[23]HoIoHcoxHnJHGqKCihDqBuK",285,0.996503,23,286,1,285,1,1,0,1,1,145,144,141,141,84
"7980",79,"[23]HoIoHcoxHnJHGqKCihDqBuK",275,0.996377,23,276,1,275,1,1,0,1,1,139,138,137,137,84
"7981",80,"[23]HoIoHcoxHnJHGqKCihDqBuK",280,0.996441,23,281,1,280,1,1,0,1,1,136,135,145,145,84
"7982",81,"[23]HoIoHcoxHnJHGqKCihDqBuK",274,0.996364,23,275,1,274,1,1,0,1,1,142,141,133,133,84
"7983",82,"[23]HoIoHcoxHnJHGqKCihDqBuK",279,0.996429,23,280,1,279,1,1,0,1,1,129,128,151,151,84
"7984",83,"[23]HoIoHcoxHnJHGqKCihDqBuK",291,0.996575,23,292,1,291,1,1,0,1,1,162,161,130,130,84
"7985",84,"[23]HoIoHcoxHnJHGqKCihDqBuK",281,0.996454,23,282,1,281,1,1,0,1,1,149,148,133,133,84
"7986",85,"[23]HoIoHcoxHnJHGqKCihDqBuK",285,0.996503,23,286,1,285,1,1,0,1,1,148,147,138,138,84
"7987",86,"[23]HoIoHcoxHnJHGqKCihDqBuK",276,0.99639,23,277,1,276,1,1,0,1,1,138,137,139,139,84
"7988",87,"[23]HoIoHcoxHnJHGqKCihDqBuK",278,0.996416,23,279,1,278,1,1,0,1,1,140,139,139,139,84
"7989",88,"[23]HoIoHcoxHnJHGqKCihDqBuK",283,0.996479,23,284,1,283,1,1,0,1,1,126,125,158,158,84
"7990",89,"[23]HoIoHcoxHnJHGqKCihDqBuK",280,0.996441,23,281,1,280,1,1,0,1,1,146,145,135,135,84
"7991",90,"[23]HoIoHcoxHnJHGqKCihDqBuK",287,0.996528,23,288,1,287,1,1,0,1,1,157,156,131,131,84
"7992",91,"[23]HoIoHcoxHnJHGqKCihDqBuK",277,0.996403,23,278,1,277,1,1,0,1,1,145,144,133,133,84
"7993",92,"[23]HoIoHcoxHnJHGqKCihDqBuK",283,0.996479,23,284,1,283,1,1,0,1,1,150,149,134,134,84
"7994",93,"[23]HoIoHcoxHnJHGqKCihDqBuK",280,0.996441,23,281,1,280,1,1,0,1,1,126,125,155,155,84
"7995",94,"[23]HoIoHcoxHnJHGqKCihDqBuK",289,0.996552,23,290,1,289,1,1,0,1,1,149,148,141,141,84
"7996",95,"[23]HoIoHcoxHnJHGqKCihDqBuK",291,0.996575,23,292,1,291,1,1,0,1,1,159,158,133,133,84
"7997",96,"[23]HoIoHcoxHnJHGqKCihDqBuK",281,0.996454,23,282,1,281,1,1,0,1,1,160,159,122,122,84
"7998",97,"[23]HoIoHcoxHnJHGqKCihDqBuK",279,0.996429,23,280,1,279,1,1,0,1,1,146,145,134,134,84
"7999",98,"[23]HoIoHcoxHnJHGqKCihDqBuK",273,0.99635,23,274,1,273,1,1,0,1,1,144,143,130,130,84
"8000",99,"[23]HoIoHcoxHnJHGqKCihDqBuK",278,0.996416,23,279,1,278,1,1,0,1,1,144,143,135,135,84
"8001",0,"[23]zHoIoHcoxHnJHGqKCksjGgH",288,0.99654,23,289,1,288,1,1,0,1,1,144,143,145,145,85
"8002",1,"[23]zHoIoHcoxHnJHGqKCksjGgH",277,0.996403,23,278,1,277,1,1,0,1,1,148,147,130,130,85
"8003",2,"[23]zHoIoHcoxHnJHGqKCksjGgH",282,0.996466,23,283,1,282,1,1,0,1,1,141,140,142,142,85
"8004",3,"[23]zHoIoHcoxHnJHGqKCksjGgH",276,0.99639,23,277,1,276,1,1,0,1,1,139,138,138,138,85
"8005",4,"[23]zHoIoHcoxHnJHGqKCksjGgH",280,0.996441,23,281,1,280,1,1,0,1,1,149,148,132,132,85
"8006",5,"[23]zHoIoHcoxHnJHGqKCksjGgH",283,0.996479,23,284,1,283,1,1,0,1,1,137,136,147,147,85
"8007",6,"[23]zHoIoHcoxHnJHGqKCksjGgH",284,0.996491,23,285,1,284,1,1,0,1,1,143,142,142,142,85
"8008",7,"[23]zHoIoHcoxHnJHGqKCksjGgH",281,0.996454,23,282,1,281,1,1,0,1,1,143,142,139,139,85
"8009",8,"[23]zHoIoHcoxHnJHGqKCksjGgH",282,0.996466,23,283,1,282,1,1,0,1,1,132,131,151,151,85
"8010",9,"[23]zHoIoHcoxHnJHGqKCksjGgH",278,0.996416,23,279,1,278,1,1,0,1,1,134,133,145,145,85
"8011",10,"[23]zHoIoHcoxHnJHGqKCksjGgH",279,0.996429,23,280,1,279,1,1,0,1,1,146,145,134,134,85
"8012",11,"[23]zHoIoHcoxHnJHGqKCksjGgH",289,0.996552,23,290,1,289,1,1,0,1,1,155,154,135,135,85
"8013",12,"[23]zHoIoHcoxHnJHGqKCksjGgH",274,0.996364,23,275,1,274,1,1,0,1,1,136,135,139,139,85
"8014",13,"[23]zHoIoHcoxHnJHGqKCksjGgH",281,0.996454,23,282,1,281,1,1,0,1,1,154,153,128,128,85
"8015",14,"[23]zHoIoHcoxHnJHGqKCksjGgH",282,0.996466,23,283,1,282,1,1,0,1,1,138,137,145,145,85
"8016",15,"[23]zHoIoHcoxHnJHGqKCksjGgH",271,0.996324,23,272,1,271,1,1,0,1,1,134,133,138,138,85
"8017",16,"[23]zHoIoHcoxHnJHGqKCksjGgH",281,0.996454,23,282,1,281,1,1,0,1,1,129,128,153,153,85
"8018",17,"[23]zHoIoHcoxHnJHGqKCksjGgH",285,0.996503,23,286,1,285,1,1,0,1,1,158,157,128,128,85
"8019",18,"[23]zHoIoHcoxHnJHGqKCksjGgH",294,0.99661,23,295,1,294,1,1,0,1,1,143,142,152,152,85
"8020",19,"[23]zHoIoHcoxHnJHGqKCksjGgH",284,0.996491,23,285,1,284,1,1,0,1,1,142,141,143,143,85
"8021",20,"[23]zHoIoHcoxHnJHGqKCksjGgH",272,0.996337,23,273,1,272,1,1,0,1,1,126,125,147,147,85
"8022",21,"[23]zHoIoHcoxHnJHGqKCksjGgH",282,0.996466,23,283,1,282,1,1,0,1,1,148,147,135,135,85
"8023",22,"[23]zHoIoHcoxHnJHGqKCksjGgH",282,0.996466,23,283,1,282,1,1,0,1,1,132,131,151,151,85
"8024",23,"[23]zHoIoHcoxHnJHGqKCksjGgH",289,0.996552,23,290,1,289,1,1,0,1,1,140,139,150,150,85
"8025",24,"[23]zHoIoHcoxHnJHGqKCksjGgH",277,0.996403,23,278,1,277,1,1,0,1,1,155,154,123,123,85
"8026",25,"[23]zHoIoHcoxHnJHGqKCksjGgH",271,0.996324,23,272,1,271,1,1,0,1,1,138,137,134,134,85
"8027",26,"[23]zHoIoHcoxHnJHGqKCksjGgH",277,0.996403,23,278,1,277,1,1,0,1,1,138,137,140,140,85
"8028",27,"[23]zHoIoHcoxHnJHGqKCksjGgH",288,0.99654,23,289,1,288,1,1,0,1,1,149,148,140,140,85
"8029",28,"[23]zHoIoHcoxHnJHGqKCksjGgH",278,0.996416,23,279,1,278,1,1,0,1,1,135,134,144,144,85
"8030",29,"[23]zHoIoHcoxHnJHGqKCksjGgH",272,0.996337,23,273,1,272,1,1,0,1,1,130,129,143,143,85
"8031",30,"[23]zHoIoHcoxHnJHGqKCksjGgH",275,0.996377,23,276,1,275,1,1,0,1,1,117,116,159,159,85
"8032",31,"[23]zHoIoHcoxHnJHGqKCksjGgH",280,0.996441,23,281,1,280,1,1,0,1,1,139,138,142,142,85
"8033",32,"[23]zHoIoHcoxHnJHGqKCksjGgH",278,0.996416,23,279,1,278,1,1,0,1,1,145,144,134,134,85
"8034",33,"[23]zHoIoHcoxHnJHGqKCksjGgH",282,0.996466,23,283,1,282,1,1,0,1,1,134,133,149,149,85
"8035",34,"[23]zHoIoHcoxHnJHGqKCksjGgH",282,0.996466,23,283,1,282,1,1,0,1,1,143,142,140,140,85
"8036",35,"[23]zHoIoHcoxHnJHGqKCksjGgH",290,0.996564,23,291,1,290,1,1,0,1,1,135,134,156,156,85
"8037",36,"[23]zHoIoHcoxHnJHGqKCksjGgH",286,0.996516,23,287,1,286,1,1,0,1,1,137,136,150,150,85
"8038",37,"[23]zHoIoHcoxHnJHGqKCksjGgH",286,0.996516,23,287,1,286,1,1,0,1,1,153,152,134,134,85
"8039",38,"[23]zHoIoHcoxHnJHGqKCksjGgH",280,0.996441,23,281,1,280,1,1,0,1,1,135,134,146,146,85
"8040",39,"[23]zHoIoHcoxHnJHGqKCksjGgH",279,0.996429,23,280,1,279,1,1,0,1,1,145,144,135,135,85
"8041",40,"[23]zHoIoHcoxHnJHGqKCksjGgH",273,0.99635,23,274,1,273,1,1,0,1,1,129,128,145,145,85
"8042",41,"[23]zHoIoHcoxHnJHGqKCksjGgH",281,0.996454,23,282,1,281,1,1,0,1,1,140,139,142,142,85
"8043",42,"[23]zHoIoHcoxHnJHGqKCksjGgH",280,0.996441,23,281,1,280,1,1,0,1,1,134,133,147,147,85
"8044",43,"[23]zHoIoHcoxHnJHGqKCksjGgH",286,0.996516,23,287,1,286,1,1,0,1,1,147,146,140,140,85
"8045",44,"[23]zHoIoHcoxHnJHGqKCksjGgH",278,0.996416,23,279,1,278,1,1,0,1,1,144,143,135,135,85
"8046",45,"[23]zHoIoHcoxHnJHGqKCksjGgH",287,0.996528,23,288,1,287,1,1,0,1,1,156,155,132,132,85
"8047",46,"[23]zHoIoHcoxHnJHGqKCksjGgH",282,0.996466,23,283,1,282,1,1,0,1,1,140,139,143,143,85
"8048",47,"[23]zHoIoHcoxHnJHGqKCksjGgH",278,0.996416,23,279,1,278,1,1,0,1,1,135,134,144,144,85
"8049",48,"[23]zHoIoHcoxHnJHGqKCksjGgH",284,0.996491,23,285,1,284,1,1,0,1,1,154,153,131,131,85
"8050",49,"[23]zHoIoHcoxHnJHGqKCksjGgH",282,0.996466,23,283,1,282,1,1,0,1,1,137,136,146,146,85
"8051",50,"[23]zHoIoHcoxHnJHGqKCksjGgH",277,0.996403,23,278,1,277,1,1,0,1,1,138,137,140,140,85
"8052",51,"[23]zHoIoHcoxHnJHGqKCksjGgH",283,0.996479,23,284,1,283,1,1,0,1,1,139,138,145,145,85
"8053",52,"[23]zHoIoHcoxHnJHGqKCksjGgH",278,0.996416,23,279,1,278,1,1,0,1,1,135,134,144,144,85
"8054",53,"[23]zHoIoHcoxHnJHGqKCksjGgH",282,0.996466,23,283,1,282,1,1,0,1,1,154,153,129,129,85
"8055",54,"[23]zHoIoHcoxHnJHGqKCksjGgH",288,0.99654,23,289,1,288,1,1,0,1,1,138,137,151,151,85
"8056",55,"[23]zHoIoHcoxHnJHGqKCksjGgH",279,0.996429,23,280,1,279,1,1,0,1,1,142,141,138,138,85
"8057",56,"[23]zHoIoHcoxHnJHGqKCksjGgH",274,0.996364,23,275,1,274,1,1,0,1,1,132,131,143,143,85
"8058",57,"[23]zHoIoHcoxHnJHGqKCksjGgH",277,0.996403,23,278,1,277,1,1,0,1,1,123,122,155,155,85
"8059",58,"[23]zHoIoHcoxHnJHGqKCksjGgH",278,0.996416,23,279,1,278,1,1,0,1,1,151,150,128,128,85
"8060",59,"[23]zHoIoHcoxHnJHGqKCksjGgH",273,0.99635,23,274,1,273,1,1,0,1,1,137,136,137,137,85
"8061",60,"[23]zHoIoHcoxHnJHGqKCksjGgH",281,0.996454,23,282,1,281,1,1,0,1,1,140,139,142,142,85
"8062",61,"[23]zHoIoHcoxHnJHGqKCksjGgH",277,0.996403,23,278,1,277,1,1,0,1,1,157,156,121,121,85
"8063",62,"[23]zHoIoHcoxHnJHGqKCksjGgH",291,0.996575,23,292,1,291,1,1,0,1,1,140,139,152,152,85
"8064",63,"[23]zHoIoHcoxHnJHGqKCksjGgH",283,0.996479,23,284,1,283,1,1,0,1,1,143,142,141,141,85
"8065",64,"[23]zHoIoHcoxHnJHGqKCksjGgH",288,0.99654,23,289,1,288,1,1,0,1,1,146,145,143,143,85
"8066",65,"[23]zHoIoHcoxHnJHGqKCksjGgH",279,0.996429,23,280,1,279,1,1,0,1,1,132,131,148,148,85
"8067",66,"[23]zHoIoHcoxHnJHGqKCksjGgH",280,0.996441,23,281,1,280,1,1,0,1,1,140,139,141,141,85
"8068",67,"[23]zHoIoHcoxHnJHGqKCksjGgH",283,0.996479,23,284,1,283,1,1,0,1,1,144,143,140,140,85
"8069",68,"[23]zHoIoHcoxHnJHGqKCksjGgH",291,0.996575,23,292,1,291,1,1,0,1,1,152,151,140,140,85
"8070",69,"[23]zHoIoHcoxHnJHGqKCksjGgH",284,0.996491,23,285,1,284,1,1,0,1,1,135,134,150,150,85
"8071",70,"[23]zHoIoHcoxHnJHGqKCksjGgH",282,0.996466,23,283,1,282,1,1,0,1,1,140,139,143,143,85
"8072",71,"[23]zHoIoHcoxHnJHGqKCksjGgH",275,0.996377,23,276,1,275,1,1,0,1,1,129,128,147,147,85
"8073",72,"[23]zHoIoHcoxHnJHGqKCksjGgH",289,0.996552,23,290,1,289,1,1,0,1,1,161,160,129,129,85
"8074",73,"[23]zHoIoHcoxHnJHGqKCksjGgH",278,0.996416,23,279,1,278,1,1,0,1,1,141,140,138,138,85
"8075",74,"[23]zHoIoHcoxHnJHGqKCksjGgH",284,0.996491,23,285,1,284,1,1,0,1,1,142,141,143,143,85
"8076",75,"[23]zHoIoHcoxHnJHGqKCksjGgH",278,0.996416,23,279,1,278,1,1,0,1,1,141,140,138,138,85
"8077",76,"[23]zHoIoHcoxHnJHGqKCksjGgH",280,0.996441,23,281,1,280,1,1,0,1,1,136,135,145,145,85
"8078",77,"[23]zHoIoHcoxHnJHGqKCksjGgH",287,0.996528,23,288,1,287,1,1,0,1,1,150,149,138,138,85
"8079",78,"[23]zHoIoHcoxHnJHGqKCksjGgH",279,0.996429,23,280,1,279,1,1,0,1,1,146,145,134,134,85
"8080",79,"[23]zHoIoHcoxHnJHGqKCksjGgH",284,0.996491,23,285,1,284,1,1,0,1,1,156,155,129,129,85
"8081",80,"[23]zHoIoHcoxHnJHGqKCksjGgH",281,0.996454,23,282,1,281,1,1,0,1,1,139,138,143,143,85
"8082",81,"[23]zHoIoHcoxHnJHGqKCksjGgH",280,0.996441,23,281,1,280,1,1,0,1,1,148,147,133,133,85
"8083",82,"[23]zHoIoHcoxHnJHGqKCksjGgH",279,0.996429,23,280,1,279,1,1,0,1,1,130,129,150,150,85
"8084",83,"[23]zHoIoHcoxHnJHGqKCksjGgH",288,0.99654,23,289,1,288,1,1,0,1,1,155,154,134,134,85
"8085",84,"[23]zHoIoHcoxHnJHGqKCksjGgH",282,0.996466,23,283,1,282,1,1,0,1,1,146,145,137,137,85
"8086",85,"[23]zHoIoHcoxHnJHGqKCksjGgH",281,0.996454,23,282,1,281,1,1,0,1,1,143,142,139,139,85
"8087",86,"[23]zHoIoHcoxHnJHGqKCksjGgH",278,0.996416,23,279,1,278,1,1,0,1,1,141,140,138,138,85
"8088",87,"[23]zHoIoHcoxHnJHGqKCksjGgH",277,0.996403,23,278,1,277,1,1,0,1,1,137,136,141,141,85
"8089",88,"[23]zHoIoHcoxHnJHGqKCksjGgH",276,0.99639,23,277,1,276,1,1,0,1,1,141,140,136,136,85
"8090",89,"[23]zHoIoHcoxHnJHGqKCksjGgH",281,0.996454,23,282,1,281,1,1,0,1,1,138,137,144,144,85
"8091",90,"[23]zHoIoHcoxHnJHGqKCksjGgH",285,0.996503,23,286,1,285,1,1,0,1,1,154,153,132,132,85
"8092",91,"[23]zHoIoHcoxHnJHGqKCksjGgH",277,0.996403,23,278,1,277,1,1,0,1,1,138,137,140,140,85
"8093",92,"[23]zHoIoHcoxHnJHGqKCksjGgH",283,0.996479,23,284,1,283,1,1,0,1,1,139,138,145,145,85
"8094",93,"[23]zHoIoHcoxHnJHGqKCksjGgH",279,0.996429,23,280,1,279,1,1,0,1,1,130,129,150,150,85
"8095",94,"[23]zHoIoHcoxHnJHGqKCksjGgH",278,0.996416,23,279,1,278,1,1,0,1,1,145,144,134,134,85
"8096",95,"[23]zHoIoHcoxHnJHGqKCksjGgH",289,0.996552,23,290,1,289,1,1,0,1,1,144,143,146,146,85
"8097",96,"[23]zHoIoHcoxHnJHGqKCksjGgH",280,0.996441,23,281,1,280,1,1,0,1,1,151,150,130,130,85
"8098",97,"[23]zHoIoHcoxHnJHGqKCksjGgH",281,0.996454,23,282,1,281,1,1,0,1,1,134,133,148,148,85
"8099",98,"[23]zHoIoHcoxHnJHGqKCksjGgH",278,0.996416,23,279,1,278,1,1,0,1,1,138,137,141,141,85
"8100",99,"[23]zHoIoHcoxHnJHGqKCksjGgH",283,0.996479,23,284,1,283,1,1,0,1,1,153,152,131,131,85
"8101",0,"[20]jwoIoHcotHnJHGqKCrDx",283,0.996479,20,284,1,283,1,1,0,1,1,148,147,136,136,86
"8102",1,"[20]jwoIoHcotHnJHGqKCrDx",277,0.996403,20,278,1,277,1,1,0,1,1,130,129,148,148,86
"8103",2,"[20]jwoIoHcotHnJHGqKCrDx",273,0.99635,20,274,1,273,1,1,0,1,1,142,141,132,132,86
"8104",3,"[20]jwoIoHcotHnJHGqKCrDx",285,0.996503,20,286,1,285,1,1,0,1,1,156,155,130,130,86
"8105",4,"[20]jwoIoHcotHnJHGqKCrDx",277,0.996403,20,278,1,277,1,1,0,1,1,136,135,142,142,86
"8106",5,"[20]jwoIoHcotHnJHGqKCrDx",291,0.996575,20,292,1,291,1,1,0,1,1,152,151,140,140,86
"8107",6,"[20]jwoIoHcotHnJHGqKCrDx",276,0.99639,20,277,1,276,1,1,0,1,1,134,133,143,143,86
"8108",7,"[20]jwoIoHcotHnJHGqKCrDx",290,0.996564,20,291,1,290,1,1,0,1,1,146,145,145,145,86
"8109",8,"[20]jwoIoHcotHnJHGqKCrDx",275,0.996377,20,276,1,275,1,1,0,1,1,140,139,136,136,86
"8110",9,"[20]jwoIoHcotHnJHGqKCrDx",282,0.996466,20,283,1,282,1,1,0,1,1,144,143,139,139,86
"8111",10,"[20]jwoIoHcotHnJHGqKCrDx",279,0.996429,20,280,1,279,1,1,0,1,1,138,137,142,142,86
"8112",11,"[20]jwoIoHcotHnJHGqKCrDx",283,0.996479,20,284,1,283,1,1,0,1,1,149,148,135,135,86
"8113",12,"[20]jwoIoHcotHnJHGqKCrDx",275,0.996377,20,276,1,275,1,1,0,1,1,144,143,132,132,86
"8114",13,"[20]jwoIoHcotHnJHGqKCrDx",282,0.996466,20,283,1,282,1,1,0,1,1,135,134,148,148,86
"8115",14,"[20]jwoIoHcotHnJHGqKCrDx",279,0.996429,20,280,1,279,1,1,0,1,1,146,145,134,134,86
"8116",15,"[20]jwoIoHcotHnJHGqKCrDx",286,0.996516,20,287,1,286,1,1,0,1,1,149,148,138,138,86
"8117",16,"[20]jwoIoHcotHnJHGqKCrDx",284,0.996491,20,285,1,284,1,1,0,1,1,139,138,146,146,86
"8118",17,"[20]jwoIoHcotHnJHGqKCrDx",280,0.996441,20,281,1,280,1,1,0,1,1,145,144,136,136,86
"8119",18,"[20]jwoIoHcotHnJHGqKCrDx",292,0.996587,20,293,1,292,1,1,0,1,1,146,145,147,147,86
"8120",19,"[20]jwoIoHcotHnJHGqKCrDx",280,0.996441,20,281,1,280,1,1,0,1,1,147,146,134,134,86
"8121",20,"[20]jwoIoHcotHnJHGqKCrDx",278,0.996416,20,279,1,278,1,1,0,1,1,142,141,137,137,86
"8122",21,"[20]jwoIoHcotHnJHGqKCrDx",276,0.99639,20,277,1,276,1,1,0,1,1,139,138,138,138,86
"8123",22,"[20]jwoIoHcotHnJHGqKCrDx",282,0.996466,20,283,1,282,1,1,0,1,1,133,132,150,150,86
"8124",23,"[20]jwoIoHcotHnJHGqKCrDx",280,0.996441,20,281,1,280,1,1,0,1,1,153,152,128,128,86
"8125",24,"[20]jwoIoHcotHnJHGqKCrDx",285,0.996503,20,286,1,285,1,1,0,1,1,146,145,140,140,86
"8126",25,"[20]jwoIoHcotHnJHGqKCrDx",276,0.99639,20,277,1,276,1,1,0,1,1,133,132,144,144,86
"8127",26,"[20]jwoIoHcotHnJHGqKCrDx",274,0.996364,20,275,1,274,1,1,0,1,1,121,120,154,154,86
"8128",27,"[20]jwoIoHcotHnJHGqKCrDx",274,0.996364,20,275,1,274,1,1,0,1,1,144,143,131,131,86
"8129",28,"[20]jwoIoHcotHnJHGqKCrDx",280,0.996441,20,281,1,280,1,1,0,1,1,143,142,138,138,86
"8130",29,"[20]jwoIoHcotHnJHGqKCrDx",284,0.996491,20,285,1,284,1,1,0,1,1,140,139,145,145,86
"8131",30,"[20]jwoIoHcotHnJHGqKCrDx",278,0.996416,20,279,1,278,1,1,0,1,1,138,137,141,141,86
"8132",31,"[20]jwoIoHcotHnJHGqKCrDx",283,0.996479,20,284,1,283,1,1,0,1,1,153,152,131,131,86
"8133",32,"[20]jwoIoHcotHnJHGqKCrDx",285,0.996503,20,286,1,285,1,1,0,1,1,135,134,151,151,86
"8134",33,"[20]jwoIoHcotHnJHGqKCrDx",280,0.996441,20,281,1,280,1,1,0,1,1,138,137,143,143,86
"8135",34,"[20]jwoIoHcotHnJHGqKCrDx",278,0.996416,20,279,1,278,1,1,0,1,1,133,132,146,146,86
"8136",35,"[20]jwoIoHcotHnJHGqKCrDx",286,0.996516,20,287,1,286,1,1,0,1,1,134,133,153,153,86
"8137",36,"[20]jwoIoHcotHnJHGqKCrDx",279,0.996429,20,280,1,279,1,1,0,1,1,145,144,135,135,86
"8138",37,"[20]jwoIoHcotHnJHGqKCrDx",276,0.99639,20,277,1,276,1,1,0,1,1,146,145,131,131,86
"8139",38,"[20]jwoIoHcotHnJHGqKCrDx",287,0.996528,20,288,1,287,1,1,0,1,1,137,136,151,151,86
"8140",39,"[20]jwoIoHcotHnJHGqKCrDx",281,0.996454,20,282,1,281,1,1,0,1,1,135,134,147,147,86
"8141",40,"[20]jwoIoHcotHnJHGqKCrDx",276,0.99639,20,277,1,276,1,1,0,1,1,128,127,149,149,86
"8142",41,"[20]jwoIoHcotHnJHGqKCrDx",286,0.996516,20,287,1,286,1,1,0,1,1,139,138,148,148,86
"8143",42,"[20]jwoIoHcotHnJHGqKCrDx",281,0.996454,20,282,1,281,1,1,0,1,1,126,125,156,156,86
"8144",43,"[20]jwoIoHcotHnJHGqKCrDx",280,0.996441,20,281,1,280,1,1,0,1,1,134,133,147,147,86
"8145",44,"[20]jwoIoHcotHnJHGqKCrDx",286,0.996516,20,287,1,286,1,1,0,1,1,163,162,124,124,86
"8146",45,"[20]jwoIoHcotHnJHGqKCrDx",279,0.996429,20,280,1,279,1,1,0,1,1,127,126,153,153,86
"8147",46,"[20]jwoIoHcotHnJHGqKCrDx",277,0.996403,20,278,1,277,1,1,0,1,1,126,125,152,152,86
"8148",47,"[20]jwoIoHcotHnJHGqKCrDx",279,0.996429,20,280,1,279,1,1,0,1,1,133,132,147,147,86
"8149",48,"[20]jwoIoHcotHnJHGqKCrDx",276,0.99639,20,277,1,276,1,1,0,1,1,144,143,133,133,86
"8150",49,"[20]jwoIoHcotHnJHGqKCrDx",287,0.996528,20,288,1,287,1,1,0,1,1,139,138,149,149,86
"8151",50,"[20]jwoIoHcotHnJHGqKCrDx",281,0.996454,20,282,1,281,1,1,0,1,1,136,135,146,146,86
"8152",51,"[20]jwoIoHcotHnJHGqKCrDx",273,0.99635,20,274,1,273,1,1,0,1,1,126,125,148,148,86
"8153",52,"[20]jwoIoHcotHnJHGqKCrDx",276,0.99639,20,277,1,276,1,1,0,1,1,152,151,125,125,86
"8154",53,"[20]jwoIoHcotHnJHGqKCrDx",282,0.996466,20,283,1,282,1,1,0,1,1,145,144,138,138,86
"8155",54,"[20]jwoIoHcotHnJHGqKCrDx",292,0.996587,20,293,1,292,1,1,0,1,1,150,149,143,143,86
"8156",55,"[20]jwoIoHcotHnJHGqKCrDx",278,0.996416,20,279,1,278,1,1,0,1,1,144,143,135,135,86
"8157",56,"[20]jwoIoHcotHnJHGqKCrDx",277,0.996403,20,278,1,277,1,1,0,1,1,140,139,138,138,86
"8158",57,"[20]jwoIoHcotHnJHGqKCrDx",284,0.996491,20,285,1,284,1,1,0,1,1,148,147,137,137,86
"8159",58,"[20]jwoIoHcotHnJHGqKCrDx",287,0.996528,20,288,1,287,1,1,0,1,1,140,139,148,148,86
"8160",59,"[20]jwoIoHcotHnJHGqKCrDx",277,0.996403,20,278,1,277,1,1,0,1,1,142,141,136,136,86
"8161",60,"[20]jwoIoHcotHnJHGqKCrDx",281,0.996454,20,282,1,281,1,1,0,1,1,142,141,140,140,86
"8162",61,"[20]jwoIoHcotHnJHGqKCrDx",278,0.996416,20,279,1,278,1,1,0,1,1,130,129,149,149,86
"8163",62,"[20]jwoIoHcotHnJHGqKCrDx",282,0.996466,20,283,1,282,1,1,0,1,1,145,144,138,138,86
"8164",63,"[20]jwoIoHcotHnJHGqKCrDx",281,0.996454,20,282,1,281,1,1,0,1,1,145,144,137,137,86
"8165",64,"[20]jwoIoHcotHnJHGqKCrDx",275,0.996377,20,276,1,275,1,1,0,1,1,142,141,134,134,86
"8166",65,"[20]jwoIoHcotHnJHGqKCrDx",279,0.996429,20,280,1,279,1,1,0,1,1,127,126,153,153,86
"8167",66,"[20]jwoIoHcotHnJHGqKCrDx",275,0.996377,20,276,1,275,1,1,0,1,1,122,121,154,154,86
"8168",67,"[20]jwoIoHcotHnJHGqKCrDx",277,0.996403,20,278,1,277,1,1,0,1,1,144,143,134,134,86
"8169",68,"[20]jwoIoHcotHnJHGqKCrDx",278,0.996416,20,279,1,278,1,1,0,1,1,139,138,140,140,86
"8170",69,"[20]jwoIoHcotHnJHGqKCrDx",283,0.996479,20,284,1,283,1,1,0,1,1,146,145,138,138,86
"8171",70,"[20]jwoIoHcotHnJHGqKCrDx",277,0.996403,20,278,1,277,1,1,0,1,1,161,160,117,117,86
"8172",71,"[20]jwoIoHcotHnJHGqKCrDx",285,0.996503,20,286,1,285,1,1,0,1,1,154,153,132,132,86
"8173",72,"[20]jwoIoHcotHnJHGqKCrDx",281,0.996454,20,282,1,281,1,1,0,1,1,150,149,132,132,86
"8174",73,"[20]jwoIoHcotHnJHGqKCrDx",288,0.99654,20,289,1,288,1,1,0,1,1,142,141,147,147,86
"8175",74,"[20]jwoIoHcotHnJHGqKCrDx",280,0.996441,20,281,1,280,1,1,0,1,1,141,140,140,140,86
"8176",75,"[20]jwoIoHcotHnJHGqKCrDx",283,0.996479,20,284,1,283,1,1,0,1,1,149,148,135,135,86
"8177",76,"[20]jwoIoHcotHnJHGqKCrDx",290,0.996564,20,291,1,290,1,1,0,1,1,144,143,147,147,86
"8178",77,"[20]jwoIoHcotHnJHGqKCrDx",283,0.996479,20,284,1,283,1,1,0,1,1,124,123,160,160,86
"8179",78,"[20]jwoIoHcotHnJHGqKCrDx",284,0.996491,20,285,1,284,1,1,0,1,1,139,138,146,146,86
"8180",79,"[20]jwoIoHcotHnJHGqKCrDx",283,0.996479,20,284,1,283,1,1,0,1,1,153,152,131,131,86
"8181",80,"[20]jwoIoHcotHnJHGqKCrDx",280,0.996441,20,281,1,280,1,1,0,1,1,130,129,151,151,86
"8182",81,"[20]jwoIoHcotHnJHGqKCrDx",278,0.996416,20,279,1,278,1,1,0,1,1,143,142,136,136,86
"8183",82,"[20]jwoIoHcotHnJHGqKCrDx",280,0.996441,20,281,1,280,1,1,0,1,1,145,144,136,136,86
"8184",83,"[20]jwoIoHcotHnJHGqKCrDx",282,0.996466,20,283,1,282,1,1,0,1,1,153,152,130,130,86
"8185",84,"[20]jwoIoHcotHnJHGqKCrDx",283,0.996479,20,284,1,283,1,1,0,1,1,135,134,149,149,86
"8186",85,"[20]jwoIoHcotHnJHGqKCrDx",285,0.996503,20,286,1,285,1,1,0,1,1,137,136,149,149,86
"8187",86,"[20]jwoIoHcotHnJHGqKCrDx",280,0.996441,20,281,1,280,1,1,0,1,1,143,142,138,138,86
"8188",87,"[20]jwoIoHcotHnJHGqKCrDx",279,0.996429,20,280,1,279,1,1,0,1,1,141,140,139,139,86
"8189",88,"[20]jwoIoHcotHnJHGqKCrDx",283,0.996479,20,284,1,283,1,1,0,1,1,146,145,138,138,86
"8190",89,"[20]jwoIoHcotHnJHGqKCrDx",273,0.99635,20,274,1,273,1,1,0,1,1,122,121,152,152,86
"8191",90,"[20]jwoIoHcotHnJHGqKCrDx",275,0.996377,20,276,1,275,1,1,0,1,1,123,122,153,153,86
"8192",91,"[20]jwoIoHcotHnJHGqKCrDx",277,0.996403,20,278,1,277,1,1,0,1,1,139,138,139,139,86
"8193",92,"[20]jwoIoHcotHnJHGqKCrDx",285,0.996503,20,286,1,285,1,1,0,1,1,158,157,128,128,86
"8194",93,"[20]jwoIoHcotHnJHGqKCrDx",276,0.99639,20,277,1,276,1,1,0,1,1,137,136,140,140,86
"8195",94,"[20]jwoIoHcotHnJHGqKCrDx",281,0.996454,20,282,1,281,1,1,0,1,1,139,138,143,143,86
"8196",95,"[20]jwoIoHcotHnJHGqKCrDx",279,0.996429,20,280,1,279,1,1,0,1,1,129,128,151,151,86
"8197",96,"[20]jwoIoHcotHnJHGqKCrDx",288,0.99654,20,289,1,288,1,1,0,1,1,149,148,140,140,86
"8198",97,"[20]jwoIoHcotHnJHGqKCrDx",283,0.996479,20,284,1,283,1,1,0,1,1,148,147,136,136,86
"8199",98,"[20]jwoIoHcotHnJHGqKCrDx",279,0.996429,20,280,1,279,1,1,0,1,1,150,149,130,130,86
"8200",99,"[20]jwoIoHcotHnJHGqKCrDx",283,0.996479,20,284,1,283,1,1,0,1,1,138,137,146,146,86
"8201",0,"[24]HoIoHcoxHnJHGqKCjztemalE",284,0.996491,24,285,1,284,1,1,0,1,1,159,158,126,126,88
"8202",1,"[24]HoIoHcoxHnJHGqKCjztemalE",281,0.996454,24,282,1,281,1,1,0,1,1,150,149,132,132,88
"8203",2,"[24]HoIoHcoxHnJHGqKCjztemalE",279,0.996429,24,280,1,279,1,1,0,1,1,129,128,151,151,88
"8204",3,"[24]HoIoHcoxHnJHGqKCjztemalE",276,0.99639,24,277,1,276,1,1,0,1,1,144,143,133,133,88
"8205",4,"[24]HoIoHcoxHnJHGqKCjztemalE",282,0.996466,24,283,1,282,1,1,0,1,1,139,138,144,144,88
"8206",5,"[24]HoIoHcoxHnJHGqKCjztemalE",284,0.996491,24,285,1,284,1,1,0,1,1,135,134,150,150,88
"8207",6,"[24]HoIoHcoxHnJHGqKCjztemalE",291,0.996575,24,292,1,291,1,1,0,1,1,152,151,140,140,88
"8208",7,"[24]HoIoHcoxHnJHGqKCjztemalE",272,0.996337,24,273,1,272,1,1,0,1,1,120,119,153,153,88
"8209",8,"[24]HoIoHcoxHnJHGqKCjztemalE",284,0.996491,24,285,1,284,1,1,0,1,1,150,149,135,135,88
"8210",9,"[24]HoIoHcoxHnJHGqKCjztemalE",280,0.996441,24,281,1,280,1,1,0,1,1,146,145,135,135,88
"8211",10,"[24]HoIoHcoxHnJHGqKCjztemalE",281,0.996454,24,282,1,281,1,1,0,1,1,145,144,137,137,88
"8212",11,"[24]HoIoHcoxHnJHGqKCjztemalE",278,0.996416,24,279,1,278,1,1,0,1,1,135,134,144,144,88
"8213",12,"[24]HoIoHcoxHnJHGqKCjztemalE",276,0.99639,24,277,1,276,1,1,0,1,1,126,125,151,151,88
"8214",13,"[24]HoIoHcoxHnJHGqKCjztemalE",281,0.996454,24,282,1,281,1,1,0,1,1,136,135,146,146,88
"8215",14,"[24]HoIoHcoxHnJHGqKCjztemalE",283,0.996479,24,284,1,283,1,1,0,1,1,140,139,144,144,88
"8216",15,"[24]HoIoHcoxHnJHGqKCjztemalE",276,0.99639,24,277,1,276,1,1,0,1,1,134,133,143,143,88
"8217",16,"[24]HoIoHcoxHnJHGqKCjztemalE",285,0.996503,24,286,1,285,1,1,0,1,1,141,140,145,145,88
"8218",17,"[24]HoIoHcoxHnJHGqKCjztemalE",281,0.996454,24,282,1,281,1,1,0,1,1,138,137,144,144,88
"8219",18,"[24]HoIoHcoxHnJHGqKCjztemalE",284,0.996491,24,285,1,284,1,1,0,1,1,157,156,128,128,88
"8220",19,"[24]HoIoHcoxHnJHGqKCjztemalE",286,0.996516,24,287,1,286,1,1,0,1,1,159,158,128,128,88
"8221",20,"[24]HoIoHcoxHnJHGqKCjztemalE",280,0.996441,24,281,1,280,1,1,0,1,1,145,144,136,136,88
"8222",21,"[24]HoIoHcoxHnJHGqKCjztemalE",284,0.996491,24,285,1,284,1,1,0,1,1,143,142,142,142,88
"8223",22,"[24]HoIoHcoxHnJHGqKCjztemalE",270,0.99631,24,271,1,270,1,1,0,1,1,128,127,143,143,88
"8224",23,"[24]HoIoHcoxHnJHGqKCjztemalE",280,0.996441,24,281,1,280,1,1,0,1,1,141,140,140,140,88
"8225",24,"[24]HoIoHcoxHnJHGqKCjztemalE",288,0.99654,24,289,1,288,1,1,0,1,1,146,145,143,143,88
"8226",25,"[24]HoIoHcoxHnJHGqKCjztemalE",284,0.996491,24,285,1,284,1,1,0,1,1,146,145,139,139,88
"8227",26,"[24]HoIoHcoxHnJHGqKCjztemalE",286,0.996516,24,287,1,286,1,1,0,1,1,154,153,133,133,88
"8228",27,"[24]HoIoHcoxHnJHGqKCjztemalE",278,0.996416,24,279,1,278,1,1,0,1,1,145,144,134,134,88
"8229",28,"[24]HoIoHcoxHnJHGqKCjztemalE",277,0.996403,24,278,1,277,1,1,0,1,1,140,139,138,138,88
"8230",29,"[24]HoIoHcoxHnJHGqKCjztemalE",287,0.996528,24,288,1,287,1,1,0,1,1,139,138,149,149,88
"8231",30,"[24]HoIoHcoxHnJHGqKCjztemalE",284,0.996491,24,285,1,284,1,1,0,1,1,149,148,136,136,88
"8232",31,"[24]HoIoHcoxHnJHGqKCjztemalE",279,0.996429,24,280,1,279,1,1,0,1,1,148,147,132,132,88
"8233",32,"[24]HoIoHcoxHnJHGqKCjztemalE",286,0.996516,24,287,1,286,1,1,0,1,1,143,142,144,144,88
"8234",33,"[24]HoIoHcoxHnJHGqKCjztemalE",285,0.996503,24,286,1,285,1,1,0,1,1,160,159,126,126,88
"8235",34,"[24]HoIoHcoxHnJHGqKCjztemalE",283,0.996479,24,284,1,283,1,1,0,1,1,141,140,143,143,88
"8236",35,"[24]HoIoHcoxHnJHGqKCjztemalE",288,0.99654,24,289,1,288,1,1,0,1,1,161,160,128,128,88
"8237",36,"[24]HoIoHcoxHnJHGqKCjztemalE",284,0.996491,24,285,1,284,1,1,0,1,1,150,149,135,135,88
"8238",37,"[24]HoIoHcoxHnJHGqKCjztemalE",281,0.996454,24,282,1,281,1,1,0,1,1,149,148,133,133,88
"8239",38,"[24]HoIoHcoxHnJHGqKCjztemalE",269,0.996296,24,270,1,269,1,1,0,1,1,135,134,135,135,88
"8240",39,"[24]HoIoHcoxHnJHGqKCjztemalE",285,0.996503,24,286,1,285,1,1,0,1,1,150,149,136,136,88
"8241",40,"[24]HoIoHcoxHnJHGqKCjztemalE",281,0.996454,24,282,1,281,1,1,0,1,1,138,137,144,144,88
"8242",41,"[24]HoIoHcoxHnJHGqKCjztemalE",279,0.996429,24,280,1,279,1,1,0,1,1,126,125,154,154,88
"8243",42,"[24]HoIoHcoxHnJHGqKCjztemalE",275,0.996377,24,276,1,275,1,1,0,1,1,123,122,153,153,88
"8244",43,"[24]HoIoHcoxHnJHGqKCjztemalE",281,0.996454,24,282,1,281,1,1,0,1,1,139,138,143,143,88
"8245",44,"[24]HoIoHcoxHnJHGqKCjztemalE",282,0.996466,24,283,1,282,1,1,0,1,1,146,145,137,137,88
"8246",45,"[24]HoIoHcoxHnJHGqKCjztemalE",276,0.99639,24,277,1,276,1,1,0,1,1,141,140,136,136,88
"8247",46,"[24]HoIoHcoxHnJHGqKCjztemalE",282,0.996466,24,283,1,282,1,1,0,1,1,135,134,148,148,88
"8248",47,"[24]HoIoHcoxHnJHGqKCjztemalE",281,0.996454,24,282,1,281,1,1,0,1,1,149,148,133,133,88
"8249",48,"[24]HoIoHcoxHnJHGqKCjztemalE",282,0.996466,24,283,1,282,1,1,0,1,1,139,138,144,144,88
"8250",49,"[24]HoIoHcoxHnJHGqKCjztemalE",285,0.996503,24,286,1,285,1,1,0,1,1,146,145,140,140,88
"8251",50,"[24]HoIoHcoxHnJHGqKCjztemalE",289,0.996552,24,290,1,289,1,1,0,1,1,140,139,150,150,88
"8252",51,"[24]HoIoHcoxHnJHGqKCjztemalE",281,0.996454,24,282,1,281,1,1,0,1,1,126,125,156,156,88
"8253",52,"[24]HoIoHcoxHnJHGqKCjztemalE",279,0.996429,24,280,1,279,1,1,0,1,1,143,142,137,137,88
"8254",53,"[24]HoIoHcoxHnJHGqKCjztemalE",281,0.996454,24,282,1,281,1,1,0,1,1,151,150,131,131,88
"8255",54,"[24]HoIoHcoxHnJHGqKCjztemalE",285,0.996503,24,286,1,285,1,1,0,1,1,154,153,132,132,88
"8256",55,"[24]HoIoHcoxHnJHGqKCjztemalE",285,0.996503,24,286,1,285,1,1,0,1,1,162,161,124,124,88
"8257",56,"[24]HoIoHcoxHnJHGqKCjztemalE",270,0.99631,24,271,1,270,1,1,0,1,1,129,128,142,142,88
"8258",57,"[24]HoIoHcoxHnJHGqKCjztemalE",282,0.996466,24,283,1,282,1,1,0,1,1,130,129,153,153,88
"8259",58,"[24]HoIoHcoxHnJHGqKCjztemalE",286,0.996516,24,287,1,286,1,1,0,1,1,146,145,141,141,88
"8260",59,"[24]HoIoHcoxHnJHGqKCjztemalE",277,0.996403,24,278,1,277,1,1,0,1,1,141,140,137,137,88
"8261",60,"[24]HoIoHcoxHnJHGqKCjztemalE",279,0.996429,24,280,1,279,1,1,0,1,1,144,143,136,136,88
"8262",61,"[24]HoIoHcoxHnJHGqKCjztemalE",284,0.996491,24,285,1,284,1,1,0,1,1,146,145,139,139,88
"8263",62,"[24]HoIoHcoxHnJHGqKCjztemalE",287,0.996528,24,288,1,287,1,1,0,1,1,145,144,143,143,88
"8264",63,"[24]HoIoHcoxHnJHGqKCjztemalE",282,0.996466,24,283,1,282,1,1,0,1,1,144,143,139,139,88
"8265",64,"[24]HoIoHcoxHnJHGqKCjztemalE",279,0.996429,24,280,1,279,1,1,0,1,1,143,142,137,137,88
"8266",65,"[24]HoIoHcoxHnJHGqKCjztemalE",276,0.99639,24,277,1,276,1,1,0,1,1,130,129,147,147,88
"8267",66,"[24]HoIoHcoxHnJHGqKCjztemalE",278,0.996416,24,279,1,278,1,1,0,1,1,123,122,156,156,88
"8268",67,"[24]HoIoHcoxHnJHGqKCjztemalE",285,0.996503,24,286,1,285,1,1,0,1,1,153,152,133,133,88
"8269",68,"[24]HoIoHcoxHnJHGqKCjztemalE",277,0.996403,24,278,1,277,1,1,0,1,1,136,135,142,142,88
"8270",69,"[24]HoIoHcoxHnJHGqKCjztemalE",279,0.996429,24,280,1,279,1,1,0,1,1,147,146,133,133,88
"8271",70,"[24]HoIoHcoxHnJHGqKCjztemalE",282,0.996466,24,283,1,282,1,1,0,1,1,147,146,136,136,88
"8272",71,"[24]HoIoHcoxHnJHGqKCjztemalE",277,0.996403,24,278,1,277,1,1,0,1,1,142,141,136,136,88
"8273",72,"[24]HoIoHcoxHnJHGqKCjztemalE",276,0.99639,24,277,1,276,1,1,0,1,1,151,150,126,126,88
"8274",73,"[24]HoIoHcoxHnJHGqKCjztemalE",281,0.996454,24,282,1,281,1,1,0,1,1,135,134,147,147,88
"8275",74,"[24]HoIoHcoxHnJHGqKCjztemalE",288,0.99654,24,289,1,288,1,1,0,1,1,148,147,141,141,88
"8276",75,"[24]HoIoHcoxHnJHGqKCjztemalE",278,0.996416,24,279,1,278,1,1,0,1,1,138,137,141,141,88
"8277",76,"[24]HoIoHcoxHnJHGqKCjztemalE",273,0.99635,24,274,1,273,1,1,0,1,1,127,126,147,147,88
"8278",77,"[24]HoIoHcoxHnJHGqKCjztemalE",280,0.996441,24,281,1,280,1,1,0,1,1,142,141,139,139,88
"8279",78,"[24]HoIoHcoxHnJHGqKCjztemalE",283,0.996479,24,284,1,283,1,1,0,1,1,147,146,137,137,88
"8280",79,"[24]HoIoHcoxHnJHGqKCjztemalE",279,0.996429,24,280,1,279,1,1,0,1,1,143,142,137,137,88
"8281",80,"[24]HoIoHcoxHnJHGqKCjztemalE",284,0.996491,24,285,1,284,1,1,0,1,1,135,134,150,150,88
"8282",81,"[24]HoIoHcoxHnJHGqKCjztemalE",278,0.996416,24,279,1,278,1,1,0,1,1,146,145,133,133,88
"8283",82,"[24]HoIoHcoxHnJHGqKCjztemalE",279,0.996429,24,280,1,279,1,1,0,1,1,133,132,147,147,88
"8284",83,"[24]HoIoHcoxHnJHGqKCjztemalE",274,0.996364,24,275,1,274,1,1,0,1,1,119,118,156,156,88
"8285",84,"[24]HoIoHcoxHnJHGqKCjztemalE",278,0.996416,24,279,1,278,1,1,0,1,1,126,125,153,153,88
"8286",85,"[24]HoIoHcoxHnJHGqKCjztemalE",277,0.996403,24,278,1,277,1,1,0,1,1,121,120,157,157,88
"8287",86,"[24]HoIoHcoxHnJHGqKCjztemalE",282,0.996466,24,283,1,282,1,1,0,1,1,148,147,135,135,88
"8288",87,"[24]HoIoHcoxHnJHGqKCjztemalE",284,0.996491,24,285,1,284,1,1,0,1,1,150,149,135,135,88
"8289",88,"[24]HoIoHcoxHnJHGqKCjztemalE",285,0.996503,24,286,1,285,1,1,0,1,1,142,141,144,144,88
"8290",89,"[24]HoIoHcoxHnJHGqKCjztemalE",276,0.99639,24,277,1,276,1,1,0,1,1,133,132,144,144,88
"8291",90,"[24]HoIoHcoxHnJHGqKCjztemalE",275,0.996377,24,276,1,275,1,1,0,1,1,145,144,131,131,88
"8292",91,"[24]HoIoHcoxHnJHGqKCjztemalE",282,0.996466,24,283,1,282,1,1,0,1,1,132,131,151,151,88
"8293",92,"[24]HoIoHcoxHnJHGqKCjztemalE",282,0.996466,24,283,1,282,1,1,0,1,1,145,144,138,138,88
"8294",93,"[24]HoIoHcoxHnJHGqKCjztemalE",291,0.996575,24,292,1,291,1,1,0,1,1,147,146,145,145,88
"8295",94,"[24]HoIoHcoxHnJHGqKCjztemalE",278,0.996416,24,279,1,278,1,1,0,1,1,134,133,145,145,88
"8296",95,"[24]HoIoHcoxHnJHGqKCjztemalE",282,0.996466,24,283,1,282,1,1,0,1,1,146,145,137,137,88
"8297",96,"[24]HoIoHcoxHnJHGqKCjztemalE",277,0.996403,24,278,1,277,1,1,0,1,1,148,147,130,130,88
"8298",97,"[24]HoIoHcoxHnJHGqKCjztemalE",288,0.99654,24,289,1,288,1,1,0,1,1,147,146,142,142,88
"8299",98,"[24]HoIoHcoxHnJHGqKCjztemalE",279,0.996429,24,280,1,279,1,1,0,1,1,129,128,151,151,88
"8300",99,"[24]HoIoHcoxHnJHGqKCjztemalE",280,0.996441,24,281,1,280,1,1,0,1,1,141,140,140,140,88
"8301",0,"[30]wsFHoIoHcoxHnJHGqKCmeygFGuFixt",274,0.996364,30,275,1,274,1,1,0,1,1,113,112,162,162,89
"8302",1,"[30]wsFHoIoHcoxHnJHGqKCmeygFGuFixt",269,0.996296,30,270,1,269,1,1,0,1,1,134,133,136,136,89
"8303",2,"[30]wsFHoIoHcoxHnJHGqKCmeygFGuFixt",282,0.996466,30,283,1,282,1,1,0,1,1,164,163,119,119,89
"8304",3,"[30]wsFHoIoHcoxHnJHGqKCmeygFGuFixt",281,0.996454,30,282,1,281,1,1,0,1,1,142,141,140,140,89
"8305",4,"[30]wsFHoIoHcoxHnJHGqKCmeygFGuFixt",280,0.996441,30,281,1,280,1,1,0,1,1,137,136,144,144,89
"8306",5,"[30]wsFHoIoHcoxHnJHGqKCmeygFGuFixt",276,0.99639,30,277,1,276,1,1,0,1,1,138,137,139,139,89
"8307",6,"[30]wsFHoIoHcoxHnJHGqKCmeygFGuFixt",284,0.996491,30,285,1,284,1,1,0,1,1,146,145,139,139,89
"8308",7,"[30]wsFHoIoHcoxHnJHGqKCmeygFGuFixt",289,0.996552,30,290,1,289,1,1,0,1,1,151,150,139,139,89
"8309",8,"[30]wsFHoIoHcoxHnJHGqKCmeygFGuFixt",290,0.996564,30,291,1,290,1,1,0,1,1,150,149,141,141,89
"8310",9,"[30]wsFHoIoHcoxHnJHGqKCmeygFGuFixt",282,0.996466,30,283,1,282,1,1,0,1,1,132,131,151,151,89
"8311",10,"[30]wsFHoIoHcoxHnJHGqKCmeygFGuFixt",285,0.996503,30,286,1,285,1,1,0,1,1,140,139,146,146,89
"8312",11,"[30]wsFHoIoHcoxHnJHGqKCmeygFGuFixt",277,0.996403,30,278,1,277,1,1,0,1,1,140,139,138,138,89
"8313",12,"[30]wsFHoIoHcoxHnJHGqKCmeygFGuFixt",277,0.996403,30,278,1,277,1,1,0,1,1,141,140,137,137,89
"8314",13,"[30]wsFHoIoHcoxHnJHGqKCmeygFGuFixt",280,0.996441,30,281,1,280,1,1,0,1,1,148,147,133,133,89
"8315",14,"[30]wsFHoIoHcoxHnJHGqKCmeygFGuFixt",277,0.996403,30,278,1,277,1,1,0,1,1,144,143,134,134,89
"8316",15,"[30]wsFHoIoHcoxHnJHGqKCmeygFGuFixt",278,0.996416,30,279,1,278,1,1,0,1,1,144,143,135,135,89
"8317",16,"[30]wsFHoIoHcoxHnJHGqKCmeygFGuFixt",280,0.996441,30,281,1,280,1,1,0,1,1,131,130,150,150,89
"8318",17,"[30]wsFHoIoHcoxHnJHGqKCmeygFGuFixt",279,0.996429,30,280,1,279,1,1,0,1,1,153,152,127,127,89
"8319",18,"[30]wsFHoIoHcoxHnJHGqKCmeygFGuFixt",273,0.99635,30,274,1,273,1,1,0,1,1,131,130,143,143,89
"8320",19,"[30]wsFHoIoHcoxHnJHGqKCmeygFGuFixt",278,0.996416,30,279,1,278,1,1,0,1,1,119,118,160,160,89
"8321",20,"[30]wsFHoIoHcoxHnJHGqKCmeygFGuFixt",277,0.996403,30,278,1,277,1,1,0,1,1,147,146,131,131,89
"8322",21,"[30]wsFHoIoHcoxHnJHGqKCmeygFGuFixt",280,0.996441,30,281,1,280,1,1,0,1,1,152,151,129,129,89
"8323",22,"[30]wsFHoIoHcoxHnJHGqKCmeygFGuFixt",278,0.996416,30,279,1,278,1,1,0,1,1,127,126,152,152,89
"8324",23,"[30]wsFHoIoHcoxHnJHGqKCmeygFGuFixt",276,0.99639,30,277,1,276,1,1,0,1,1,140,139,137,137,89
"8325",24,"[30]wsFHoIoHcoxHnJHGqKCmeygFGuFixt",278,0.996416,30,279,1,278,1,1,0,1,1,142,141,137,137,89
"8326",25,"[30]wsFHoIoHcoxHnJHGqKCmeygFGuFixt",286,0.996516,30,287,1,286,1,1,0,1,1,151,150,136,136,89
"8327",26,"[30]wsFHoIoHcoxHnJHGqKCmeygFGuFixt",283,0.996479,30,284,1,283,1,1,0,1,1,148,147,136,136,89
"8328",27,"[30]wsFHoIoHcoxHnJHGqKCmeygFGuFixt",285,0.996503,30,286,1,285,1,1,0,1,1,158,157,128,128,89
"8329",28,"[30]wsFHoIoHcoxHnJHGqKCmeygFGuFixt",283,0.996479,30,284,1,283,1,1,0,1,1,147,146,137,137,89
"8330",29,"[30]wsFHoIoHcoxHnJHGqKCmeygFGuFixt",280,0.996441,30,281,1,280,1,1,0,1,1,135,134,146,146,89
"8331",30,"[30]wsFHoIoHcoxHnJHGqKCmeygFGuFixt",290,0.996564,30,291,1,290,1,1,0,1,1,147,146,144,144,89
"8332",31,"[30]wsFHoIoHcoxHnJHGqKCmeygFGuFixt",284,0.996491,30,285,1,284,1,1,0,1,1,143,142,142,142,89
"8333",32,"[30]wsFHoIoHcoxHnJHGqKCmeygFGuFixt",280,0.996441,30,281,1,280,1,1,0,1,1,134,133,147,147,89
"8334",33,"[30]wsFHoIoHcoxHnJHGqKCmeygFGuFixt",282,0.996466,30,283,1,282,1,1,0,1,1,158,157,125,125,89
"8335",34,"[30]wsFHoIoHcoxHnJHGqKCmeygFGuFixt",287,0.996528,30,288,1,287,1,1,0,1,1,134,133,154,154,89
"8336",35,"[30]wsFHoIoHcoxHnJHGqKCmeygFGuFixt",282,0.996466,30,283,1,282,1,1,0,1,1,148,147,135,135,89
"8337",36,"[30]wsFHoIoHcoxHnJHGqKCmeygFGuFixt",282,0.996466,30,283,1,282,1,1,0,1,1,151,150,132,132,89
"8338",37,"[30]wsFHoIoHcoxHnJHGqKCmeygFGuFixt",270,0.99631,30,271,1,270,1,1,0,1,1,134,133,137,137,89
"8339",38,"[30]wsFHoIoHcoxHnJHGqKCmeygFGuFixt",285,0.996503,30,286,1,285,1,1,0,1,1,141,140,145,145,89
"8340",39,"[30]wsFHoIoHcoxHnJHGqKCmeygFGuFixt",286,0.996516,30,287,1,286,1,1,0,1,1,162,161,125,125,89
"8341",40,"[30]wsFHoIoHcoxHnJHGqKCmeygFGuFixt",281,0.996454,30,282,1,281,1,1,0,1,1,141,140,141,141,89
"8342",41,"[30]wsFHoIoHcoxHnJHGqKCmeygFGuFixt",275,0.996377,30,276,1,275,1,1,0,1,1,123,122,153,153,89
"8343",42,"[30]wsFHoIoHcoxHnJHGqKCmeygFGuFixt",286,0.996516,30,287,1,286,1,1,0,1,1,142,141,145,145,89
"8344",43,"[30]wsFHoIoHcoxHnJHGqKCmeygFGuFixt",279,0.996429,30,280,1,279,1,1,0,1,1,145,144,135,135,89
"8345",44,"[30]wsFHoIoHcoxHnJHGqKCmeygFGuFixt",278,0.996416,30,279,1,278,1,1,0,1,1,128,127,151,151,89
"8346",45,"[30]wsFHoIoHcoxHnJHGqKCmeygFGuFixt",280,0.996441,30,281,1,280,1,1,0,1,1,145,144,136,136,89
"8347",46,"[30]wsFHoIoHcoxHnJHGqKCmeygFGuFixt",280,0.996441,30,281,1,280,1,1,0,1,1,145,144,136,136,89
"8348",47,"[30]wsFHoIoHcoxHnJHGqKCmeygFGuFixt",283,0.996479,30,284,1,283,1,1,0,1,1,140,139,144,144,89
"8349",48,"[30]wsFHoIoHcoxHnJHGqKCmeygFGuFixt",276,0.99639,30,277,1,276,1,1,0,1,1,128,127,149,149,89
"8350",49,"[30]wsFHoIoHcoxHnJHGqKCmeygFGuFixt",284,0.996491,30,285,1,284,1,1,0,1,1,137,136,148,148,89
"8351",50,"[30]wsFHoIoHcoxHnJHGqKCmeygFGuFixt",277,0.996403,30,278,1,277,1,1,0,1,1,152,151,126,126,89
"8352",51,"[30]wsFHoIoHcoxHnJHGqKCmeygFGuFixt",273,0.99635,30,274,1,273,1,1,0,1,1,117,116,157,157,89
"8353",52,"[30]wsFHoIoHcoxHnJHGqKCmeygFGuFixt",281,0.996454,30,282,1,281,1,1,0,1,1,160,159,122,122,89
"8354",53,"[30]wsFHoIoHcoxHnJHGqKCmeygFGuFixt",282,0.996466,30,283,1,282,1,1,0,1,1,140,139,143,143,89
"8355",54,"[30]wsFHoIoHcoxHnJHGqKCmeygFGuFixt",282,0.996466,30,283,1,282,1,1,0,1,1,145,144,138,138,89
"8356",55,"[30]wsFHoIoHcoxHnJHGqKCmeygFGuFixt",274,0.996364,30,275,1,274,1,1,0,1,1,128,127,147,147,89
"8357",56,"[30]wsFHoIoHcoxHnJHGqKCmeygFGuFixt",277,0.996403,30,278,1,277,1,1,0,1,1,132,131,146,146,89
"8358",57,"[30]wsFHoIoHcoxHnJHGqKCmeygFGuFixt",291,0.996575,30,292,1,291,1,1,0,1,1,156,155,136,136,89
"8359",58,"[30]wsFHoIoHcoxHnJHGqKCmeygFGuFixt",268,0.996283,30,269,1,268,1,1,0,1,1,126,125,143,143,89
"8360",59,"[30]wsFHoIoHcoxHnJHGqKCmeygFGuFixt",280,0.996441,30,281,1,280,1,1,0,1,1,160,159,121,121,89
"8361",60,"[30]wsFHoIoHcoxHnJHGqKCmeygFGuFixt",291,0.996575,30,292,1,291,1,1,0,1,1,161,160,131,131,89
"8362",61,"[30]wsFHoIoHcoxHnJHGqKCmeygFGuFixt",278,0.996416,30,279,1,278,1,1,0,1,1,141,140,138,138,89
"8363",62,"[30]wsFHoIoHcoxHnJHGqKCmeygFGuFixt",280,0.996441,30,281,1,280,1,1,0,1,1,137,136,144,144,89
"8364",63,"[30]wsFHoIoHcoxHnJHGqKCmeygFGuFixt",285,0.996503,30,286,1,285,1,1,0,1,1,151,150,135,135,89
"8365",64,"[30]wsFHoIoHcoxHnJHGqKCmeygFGuFixt",284,0.996491,30,285,1,284,1,1,0,1,1,140,139,145,145,89
"8366",65,"[30]wsFHoIoHcoxHnJHGqKCmeygFGuFixt",284,0.996491,30,285,1,284,1,1,0,1,1,143,142,142,142,89
"8367",66,"[30]wsFHoIoHcoxHnJHGqKCmeygFGuFixt",281,0.996454,30,282,1,281,1,1,0,1,1,133,132,149,149,89
"8368",67,"[30]wsFHoIoHcoxHnJHGqKCmeygFGuFixt",292,0.996587,30,293,1,292,1,1,0,1,1,149,148,144,144,89
"8369",68,"[30]wsFHoIoHcoxHnJHGqKCmeygFGuFixt",291,0.996575,30,292,1,291,1,1,0,1,1,144,143,148,148,89
"8370",69,"[30]wsFHoIoHcoxHnJHGqKCmeygFGuFixt",280,0.996441,30,281,1,280,1,1,0,1,1,139,138,142,142,89
"8371",70,"[30]wsFHoIoHcoxHnJHGqKCmeygFGuFixt",279,0.996429,30,280,1,279,1,1,0,1,1,145,144,135,135,89
"8372",71,"[30]wsFHoIoHcoxHnJHGqKCmeygFGuFixt",279,0.996429,30,280,1,279,1,1,0,1,1,145,144,135,135,89
"8373",72,"[30]wsFHoIoHcoxHnJHGqKCmeygFGuFixt",281,0.996454,30,282,1,281,1,1,0,1,1,150,149,132,132,89
"8374",73,"[30]wsFHoIoHcoxHnJHGqKCmeygFGuFixt",273,0.99635,30,274,1,273,1,1,0,1,1,119,118,155,155,89
"8375",74,"[30]wsFHoIoHcoxHnJHGqKCmeygFGuFixt",276,0.99639,30,277,1,276,1,1,0,1,1,116,115,161,161,89
"8376",75,"[30]wsFHoIoHcoxHnJHGqKCmeygFGuFixt",276,0.99639,30,277,1,276,1,1,0,1,1,138,137,139,139,89
"8377",76,"[30]wsFHoIoHcoxHnJHGqKCmeygFGuFixt",282,0.996466,30,283,1,282,1,1,0,1,1,120,119,163,163,89
"8378",77,"[30]wsFHoIoHcoxHnJHGqKCmeygFGuFixt",286,0.996516,30,287,1,286,1,1,0,1,1,154,153,133,133,89
"8379",78,"[30]wsFHoIoHcoxHnJHGqKCmeygFGuFixt",277,0.996403,30,278,1,277,1,1,0,1,1,144,143,134,134,89
"8380",79,"[30]wsFHoIoHcoxHnJHGqKCmeygFGuFixt",283,0.996479,30,284,1,283,1,1,0,1,1,164,163,120,120,89
"8381",80,"[30]wsFHoIoHcoxHnJHGqKCmeygFGuFixt",278,0.996416,30,279,1,278,1,1,0,1,1,134,133,145,145,89
"8382",81,"[30]wsFHoIoHcoxHnJHGqKCmeygFGuFixt",289,0.996552,30,290,1,289,1,1,0,1,1,143,142,147,147,89
"8383",82,"[30]wsFHoIoHcoxHnJHGqKCmeygFGuFixt",281,0.996454,30,282,1,281,1,1,0,1,1,137,136,145,145,89
"8384",83,"[30]wsFHoIoHcoxHnJHGqKCmeygFGuFixt",279,0.996429,30,280,1,279,1,1,0,1,1,129,128,151,151,89
"8385",84,"[30]wsFHoIoHcoxHnJHGqKCmeygFGuFixt",272,0.996337,30,273,1,272,1,1,0,1,1,127,126,146,146,89
"8386",85,"[30]wsFHoIoHcoxHnJHGqKCmeygFGuFixt",281,0.996454,30,282,1,281,1,1,0,1,1,132,131,150,150,89
"8387",86,"[30]wsFHoIoHcoxHnJHGqKCmeygFGuFixt",283,0.996479,30,284,1,283,1,1,0,1,1,146,145,138,138,89
"8388",87,"[30]wsFHoIoHcoxHnJHGqKCmeygFGuFixt",275,0.996377,30,276,1,275,1,1,0,1,1,132,131,144,144,89
"8389",88,"[30]wsFHoIoHcoxHnJHGqKCmeygFGuFixt",275,0.996377,30,276,1,275,1,1,0,1,1,140,139,136,136,89
"8390",89,"[30]wsFHoIoHcoxHnJHGqKCmeygFGuFixt",287,0.996528,30,288,1,287,1,1,0,1,1,155,154,133,133,89
"8391",90,"[30]wsFHoIoHcoxHnJHGqKCmeygFGuFixt",277,0.996403,30,278,1,277,1,1,0,1,1,145,144,133,133,89
"8392",91,"[30]wsFHoIoHcoxHnJHGqKCmeygFGuFixt",263,0.996212,30,264,1,263,1,1,0,1,1,127,126,137,137,89
"8393",92,"[30]wsFHoIoHcoxHnJHGqKCmeygFGuFixt",282,0.996466,30,283,1,282,1,1,0,1,1,134,133,149,149,89
"8394",93,"[30]wsFHoIoHcoxHnJHGqKCmeygFGuFixt",290,0.996564,30,291,1,290,1,1,0,1,1,156,155,135,135,89
"8395",94,"[30]wsFHoIoHcoxHnJHGqKCmeygFGuFixt",284,0.996491,30,285,1,284,1,1,0,1,1,148,147,137,137,89
"8396",95,"[30]wsFHoIoHcoxHnJHGqKCmeygFGuFixt",283,0.996479,30,284,1,283,1,1,0,1,1,140,139,144,144,89
"8397",96,"[30]wsFHoIoHcoxHnJHGqKCmeygFGuFixt",274,0.996364,30,275,1,274,1,1,0,1,1,152,151,123,123,89
"8398",97,"[30]wsFHoIoHcoxHnJHGqKCmeygFGuFixt",276,0.99639,30,277,1,276,1,1,0,1,1,139,138,138,138,89
"8399",98,"[30]wsFHoIoHcoxHnJHGqKCmeygFGuFixt",289,0.996552,30,290,1,289,1,1,0,1,1,143,142,147,147,89
"8400",99,"[30]wsFHoIoHcoxHnJHGqKCmeygFGuFixt",282,0.996466,30,283,1,282,1,1,0,1,1,150,149,133,133,89
"8401",0,"[28]JEHoIyoHcovHnJHGqKHqKCqzAvHl",311,0.996795,28,312,1,311,1,1,0,1,1,156,155,156,156,90
"8402",1,"[28]JEHoIyoHcovHnJHGqKHqKCqzAvHl",318,0.996865,28,319,1,318,1,1,0,1,1,148,147,171,171,90
"8403",2,"[28]JEHoIyoHcovHnJHGqKHqKCqzAvHl",313,0.996815,28,314,1,313,1,1,0,1,1,174,173,140,140,90
"8404",3,"[28]JEHoIyoHcovHnJHGqKHqKCqzAvHl",320,0.996885,28,321,1,320,1,1,0,1,1,146,145,175,175,90
"8405",4,"[28]JEHoIyoHcovHnJHGqKHqKCqzAvHl",314,0.996825,28,315,1,314,1,1,0,1,1,155,154,160,160,90
"8406",5,"[28]JEHoIyoHcovHnJHGqKHqKCqzAvHl",312,0.996805,28,313,1,312,1,1,0,1,1,153,152,160,160,90
"8407",6,"[28]JEHoIyoHcovHnJHGqKHqKCqzAvHl",315,0.996835,28,316,1,315,1,1,0,1,1,159,158,157,157,90
"8408",7,"[28]JEHoIyoHcovHnJHGqKHqKCqzAvHl",319,0.996875,28,320,1,319,1,1,0,1,1,160,159,160,160,90
"8409",8,"[28]JEHoIyoHcovHnJHGqKHqKCqzAvHl",310,0.996785,28,311,1,310,1,1,0,1,1,166,165,145,145,90
"8410",9,"[28]JEHoIyoHcovHnJHGqKHqKCqzAvHl",318,0.996865,28,319,1,318,1,1,0,1,1,154,153,165,165,90
"8411",10,"[28]JEHoIyoHcovHnJHGqKHqKCqzAvHl",313,0.996815,28,314,1,313,1,1,0,1,1,169,168,145,145,90
"8412",11,"[28]JEHoIyoHcovHnJHGqKHqKCqzAvHl",314,0.996825,28,315,1,314,1,1,0,1,1,168,167,147,147,90
"8413",12,"[28]JEHoIyoHcovHnJHGqKHqKCqzAvHl",313,0.996815,28,314,1,313,1,1,0,1,1,166,165,148,148,90
"8414",13,"[28]JEHoIyoHcovHnJHGqKHqKCqzAvHl",312,0.996805,28,313,1,312,1,1,0,1,1,152,151,161,161,90
"8415",14,"[28]JEHoIyoHcovHnJHGqKHqKCqzAvHl",316,0.996845,28,317,1,316,1,1,0,1,1,164,163,153,153,90
"8416",15,"[28]JEHoIyoHcovHnJHGqKHqKCqzAvHl",311,0.996795,28,312,1,311,1,1,0,1,1,169,168,143,143,90
"8417",16,"[28]JEHoIyoHcovHnJHGqKHqKCqzAvHl",317,0.996855,28,318,1,317,1,1,0,1,1,153,152,165,165,90
"8418",17,"[28]JEHoIyoHcovHnJHGqKHqKCqzAvHl",316,0.996845,28,317,1,316,1,1,0,1,1,149,148,168,168,90
"8419",18,"[28]JEHoIyoHcovHnJHGqKHqKCqzAvHl",309,0.996774,28,310,1,309,1,1,0,1,1,141,140,169,169,90
"8420",19,"[28]JEHoIyoHcovHnJHGqKHqKCqzAvHl",313,0.996815,28,314,1,313,1,1,0,1,1,159,158,155,155,90
"8421",20,"[28]JEHoIyoHcovHnJHGqKHqKCqzAvHl",313,0.996815,28,314,1,313,1,1,0,1,1,169,168,145,145,90
"8422",21,"[28]JEHoIyoHcovHnJHGqKHqKCqzAvHl",317,0.996855,28,318,1,317,1,1,0,1,1,158,157,160,160,90
"8423",22,"[28]JEHoIyoHcovHnJHGqKHqKCqzAvHl",304,0.996721,28,305,1,304,1,1,0,1,1,177,176,128,128,90
"8424",23,"[28]JEHoIyoHcovHnJHGqKHqKCqzAvHl",304,0.996721,28,305,1,304,1,1,0,1,1,158,157,147,147,90
"8425",24,"[28]JEHoIyoHcovHnJHGqKHqKCqzAvHl",313,0.996815,28,314,1,313,1,1,0,1,1,152,151,162,162,90
"8426",25,"[28]JEHoIyoHcovHnJHGqKHqKCqzAvHl",307,0.996753,28,308,1,307,1,1,0,1,1,165,164,143,143,90
"8427",26,"[28]JEHoIyoHcovHnJHGqKHqKCqzAvHl",303,0.996711,28,304,1,303,1,1,0,1,1,155,154,149,149,90
"8428",27,"[28]JEHoIyoHcovHnJHGqKHqKCqzAvHl",298,0.996656,28,299,1,298,1,1,0,1,1,158,157,141,141,90
"8429",28,"[28]JEHoIyoHcovHnJHGqKHqKCqzAvHl",305,0.996732,28,306,1,305,1,1,0,1,1,162,161,144,144,90
"8430",29,"[28]JEHoIyoHcovHnJHGqKHqKCqzAvHl",302,0.9967,28,303,1,302,1,1,0,1,1,159,158,144,144,90
"8431",30,"[28]JEHoIyoHcovHnJHGqKHqKCqzAvHl",305,0.996732,28,306,1,305,1,1,0,1,1,158,157,148,148,90
"8432",31,"[28]JEHoIyoHcovHnJHGqKHqKCqzAvHl",308,0.996764,28,309,1,308,1,1,0,1,1,166,165,143,143,90
"8433",32,"[28]JEHoIyoHcovHnJHGqKHqKCqzAvHl",308,0.996764,28,309,1,308,1,1,0,1,1,162,161,147,147,90
"8434",33,"[28]JEHoIyoHcovHnJHGqKHqKCqzAvHl",308,0.996764,28,309,1,308,1,1,0,1,1,153,152,156,156,90
"8435",34,"[28]JEHoIyoHcovHnJHGqKHqKCqzAvHl",323,0.996914,28,324,1,323,1,1,0,1,1,156,155,168,168,90
"8436",35,"[28]JEHoIyoHcovHnJHGqKHqKCqzAvHl",313,0.996815,28,314,1,313,1,1,0,1,1,142,141,172,172,90
"8437",36,"[28]JEHoIyoHcovHnJHGqKHqKCqzAvHl",312,0.996805,28,313,1,312,1,1,0,1,1,152,151,161,161,90
"8438",37,"[28]JEHoIyoHcovHnJHGqKHqKCqzAvHl",312,0.996805,28,313,1,312,1,1,0,1,1,155,154,158,158,90
"8439",38,"[28]JEHoIyoHcovHnJHGqKHqKCqzAvHl",313,0.996815,28,314,1,313,1,1,0,1,1,168,167,146,146,90
"8440",39,"[28]JEHoIyoHcovHnJHGqKHqKCqzAvHl",317,0.996855,28,318,1,317,1,1,0,1,1,148,147,170,170,90
"8441",40,"[28]JEHoIyoHcovHnJHGqKHqKCqzAvHl",312,0.996805,28,313,1,312,1,1,0,1,1,144,143,169,169,90
"8442",41,"[28]JEHoIyoHcovHnJHGqKHqKCqzAvHl",317,0.996855,28,318,1,317,1,1,0,1,1,164,163,154,154,90
"8443",42,"[28]JEHoIyoHcovHnJHGqKHqKCqzAvHl",310,0.996785,28,311,1,310,1,1,0,1,1,171,170,140,140,90
"8444",43,"[28]JEHoIyoHcovHnJHGqKHqKCqzAvHl",318,0.996865,28,319,1,318,1,1,0,1,1,152,151,167,167,90
"8445",44,"[28]JEHoIyoHcovHnJHGqKHqKCqzAvHl",315,0.996835,28,316,1,315,1,1,0,1,1,142,141,174,174,90
"8446",45,"[28]JEHoIyoHcovHnJHGqKHqKCqzAvHl",306,0.996743,28,307,1,306,1,1,0,1,1,158,157,149,149,90
"8447",46,"[28]JEHoIyoHcovHnJHGqKHqKCqzAvHl",314,0.996825,28,315,1,314,1,1,0,1,1,144,143,171,171,90
"8448",47,"[28]JEHoIyoHcovHnJHGqKHqKCqzAvHl",318,0.996865,28,319,1,318,1,1,0,1,1,150,149,169,169,90
"8449",48,"[28]JEHoIyoHcovHnJHGqKHqKCqzAvHl",320,0.996885,28,321,1,320,1,1,0,1,1,145,144,176,176,90
"8450",49,"[28]JEHoIyoHcovHnJHGqKHqKCqzAvHl",321,0.996894,28,322,1,321,1,1,0,1,1,150,149,172,172,90
"8451",50,"[28]JEHoIyoHcovHnJHGqKHqKCqzAvHl",317,0.996855,28,318,1,317,1,1,0,1,1,150,149,168,168,90
"8452",51,"[28]JEHoIyoHcovHnJHGqKHqKCqzAvHl",315,0.996835,28,316,1,315,1,1,0,1,1,153,152,163,163,90
"8453",52,"[28]JEHoIyoHcovHnJHGqKHqKCqzAvHl",313,0.996815,28,314,1,313,1,1,0,1,1,152,151,162,162,90
"8454",53,"[28]JEHoIyoHcovHnJHGqKHqKCqzAvHl",316,0.996845,28,317,1,316,1,1,0,1,1,160,159,157,157,90
"8455",54,"[28]JEHoIyoHcovHnJHGqKHqKCqzAvHl",312,0.996805,28,313,1,312,1,1,0,1,1,151,150,162,162,90
"8456",55,"[28]JEHoIyoHcovHnJHGqKHqKCqzAvHl",309,0.996774,28,310,1,309,1,1,0,1,1,160,159,150,150,90
"8457",56,"[28]JEHoIyoHcovHnJHGqKHqKCqzAvHl",322,0.996904,28,323,1,322,1,1,0,1,1,153,152,170,170,90
"8458",57,"[28]JEHoIyoHcovHnJHGqKHqKCqzAvHl",309,0.996774,28,310,1,309,1,1,0,1,1,160,159,150,150,90
"8459",58,"[28]JEHoIyoHcovHnJHGqKHqKCqzAvHl",310,0.996785,28,311,1,310,1,1,0,1,1,154,153,157,157,90
"8460",59,"[28]JEHoIyoHcovHnJHGqKHqKCqzAvHl",314,0.996825,28,315,1,314,1,1,0,1,1,142,141,173,173,90
"8461",60,"[28]JEHoIyoHcovHnJHGqKHqKCqzAvHl",315,0.996835,28,316,1,315,1,1,0,1,1,152,151,164,164,90
"8462",61,"[28]JEHoIyoHcovHnJHGqKHqKCqzAvHl",319,0.996875,28,320,1,319,1,1,0,1,1,154,153,166,166,90
"8463",62,"[28]JEHoIyoHcovHnJHGqKHqKCqzAvHl",307,0.996753,28,308,1,307,1,1,0,1,1,163,162,145,145,90
"8464",63,"[28]JEHoIyoHcovHnJHGqKHqKCqzAvHl",317,0.996855,28,318,1,317,1,1,0,1,1,153,152,165,165,90
"8465",64,"[28]JEHoIyoHcovHnJHGqKHqKCqzAvHl",312,0.996805,28,313,1,312,1,1,0,1,1,152,151,161,161,90
"8466",65,"[28]JEHoIyoHcovHnJHGqKHqKCqzAvHl",319,0.996875,28,320,1,319,1,1,0,1,1,164,163,156,156,90
"8467",66,"[28]JEHoIyoHcovHnJHGqKHqKCqzAvHl",314,0.996825,28,315,1,314,1,1,0,1,1,162,161,153,153,90
"8468",67,"[28]JEHoIyoHcovHnJHGqKHqKCqzAvHl",313,0.996815,28,314,1,313,1,1,0,1,1,154,153,160,160,90
"8469",68,"[28]JEHoIyoHcovHnJHGqKHqKCqzAvHl",313,0.996815,28,314,1,313,1,1,0,1,1,154,153,160,160,90
"8470",69,"[28]JEHoIyoHcovHnJHGqKHqKCqzAvHl",308,0.996764,28,309,1,308,1,1,0,1,1,160,159,149,149,90
"8471",70,"[28]JEHoIyoHcovHnJHGqKHqKCqzAvHl",312,0.996805,28,313,1,312,1,1,0,1,1,159,158,154,154,90
"8472",71,"[28]JEHoIyoHcovHnJHGqKHqKCqzAvHl",315,0.996835,28,316,1,315,1,1,0,1,1,165,164,151,151,90
"8473",72,"[28]JEHoIyoHcovHnJHGqKHqKCqzAvHl",312,0.996805,28,313,1,312,1,1,0,1,1,153,152,160,160,90
"8474",73,"[28]JEHoIyoHcovHnJHGqKHqKCqzAvHl",317,0.996855,28,318,1,317,1,1,0,1,1,157,156,161,161,90
"8475",74,"[28]JEHoIyoHcovHnJHGqKHqKCqzAvHl",316,0.996845,28,317,1,316,1,1,0,1,1,142,141,175,175,90
"8476",75,"[28]JEHoIyoHcovHnJHGqKHqKCqzAvHl",306,0.996743,28,307,1,306,1,1,0,1,1,155,154,152,152,90
"8477",76,"[28]JEHoIyoHcovHnJHGqKHqKCqzAvHl",311,0.996795,28,312,1,311,1,1,0,1,1,157,156,155,155,90
"8478",77,"[28]JEHoIyoHcovHnJHGqKHqKCqzAvHl",314,0.996825,28,315,1,314,1,1,0,1,1,168,167,147,147,90
"8479",78,"[28]JEHoIyoHcovHnJHGqKHqKCqzAvHl",312,0.996805,28,313,1,312,1,1,0,1,1,160,159,153,153,90
"8480",79,"[28]JEHoIyoHcovHnJHGqKHqKCqzAvHl",314,0.996825,28,315,1,314,1,1,0,1,1,150,149,165,165,90
"8481",80,"[28]JEHoIyoHcovHnJHGqKHqKCqzAvHl",311,0.996795,28,312,1,311,1,1,0,1,1,156,155,156,156,90
"8482",81,"[28]JEHoIyoHcovHnJHGqKHqKCqzAvHl",317,0.996855,28,318,1,317,1,1,0,1,1,154,153,164,164,90
"8483",82,"[28]JEHoIyoHcovHnJHGqKHqKCqzAvHl",313,0.996815,28,314,1,313,1,1,0,1,1,162,161,152,152,90
"8484",83,"[28]JEHoIyoHcovHnJHGqKHqKCqzAvHl",315,0.996835,28,316,1,315,1,1,0,1,1,167,166,149,149,90
"8485",84,"[28]JEHoIyoHcovHnJHGqKHqKCqzAvHl",317,0.996855,28,318,1,317,1,1,0,1,1,155,154,163,163,90
"8486",85,"[28]JEHoIyoHcovHnJHGqKHqKCqzAvHl",311,0.996795,28,312,1,311,1,1,0,1,1,157,156,155,155,90
"8487",86,"[28]JEHoIyoHcovHnJHGqKHqKCqzAvHl",309,0.996774,28,310,1,309,1,1,0,1,1,146,145,164,164,90
"8488",87,"[28]JEHoIyoHcovHnJHGqKHqKCqzAvHl",311,0.996795,28,312,1,311,1,1,0,1,1,154,153,158,158,90
"8489",88,"[28]JEHoIyoHcovHnJHGqKHqKCqzAvHl",309,0.996774,28,310,1,309,1,1,0,1,1,160,159,150,150,90
"8490",89,"[28]JEHoIyoHcovHnJHGqKHqKCqzAvHl",312,0.996805,28,313,1,312,1,1,0,1,1,155,154,158,158,90
"8491",90,"[28]JEHoIyoHcovHnJHGqKHqKCqzAvHl",315,0.996835,28,316,1,315,1,1,0,1,1,161,160,155,155,90
"8492",91,"[28]JEHoIyoHcovHnJHGqKHqKCqzAvHl",315,0.996835,28,316,1,315,1,1,0,1,1,150,149,166,166,90
"8493",92,"[28]JEHoIyoHcovHnJHGqKHqKCqzAvHl",307,0.996753,28,308,1,307,1,1,0,1,1,158,157,150,150,90
"8494",93,"[28]JEHoIyoHcovHnJHGqKHqKCqzAvHl",306,0.996743,28,307,1,306,1,1,0,1,1,160,159,147,147,90
"8495",94,"[28]JEHoIyoHcovHnJHGqKHqKCqzAvHl",317,0.996855,28,318,1,317,1,1,0,1,1,151,150,167,167,90
"8496",95,"[28]JEHoIyoHcovHnJHGqKHqKCqzAvHl",314,0.996825,28,315,1,314,1,1,0,1,1,153,152,162,162,90
"8497",96,"[28]JEHoIyoHcovHnJHGqKHqKCqzAvHl",309,0.996774,28,310,1,309,1,1,0,1,1,165,164,145,145,90
"8498",97,"[28]JEHoIyoHcovHnJHGqKHqKCqzAvHl",310,0.996785,28,311,1,310,1,1,0,1,1,156,155,155,155,90
"8499",98,"[28]JEHoIyoHcovHnJHGqKHqKCqzAvHl",309,0.996774,28,310,1,309,1,1,0,1,1,168,167,142,142,90
"8500",99,"[28]JEHoIyoHcovHnJHGqKHqKCqzAvHl",319,0.996875,28,320,1,319,1,1,0,1,1,143,142,177,177,90
"8501",0,"[29]sJHoIaqaFyHcsHnbJHGqKCBksacpg",280,0.996441,29,281,1,280,1,1,0,1,1,139,138,142,142,91
"8502",1,"[29]sJHoIaqaFyHcsHnbJHGqKCBksacpg",283,0.996479,29,284,1,283,1,1,0,1,1,157,156,127,127,91
"8503",2,"[29]sJHoIaqaFyHcsHnbJHGqKCBksacpg",289,0.996552,29,290,1,289,1,1,0,1,1,156,155,134,134,91
"8504",3,"[29]sJHoIaqaFyHcsHnbJHGqKCBksacpg",278,0.996416,29,279,1,278,1,1,0,1,1,129,128,150,150,91
"8505",4,"[29]sJHoIaqaFyHcsHnbJHGqKCBksacpg",278,0.996416,29,279,1,278,1,1,0,1,1,135,134,144,144,91
"8506",5,"[29]sJHoIaqaFyHcsHnbJHGqKCBksacpg",279,0.996429,29,280,1,279,1,1,0,1,1,155,154,125,125,91
"8507",6,"[29]sJHoIaqaFyHcsHnbJHGqKCBksacpg",282,0.996466,29,283,1,282,1,1,0,1,1,146,145,137,137,91
"8508",7,"[29]sJHoIaqaFyHcsHnbJHGqKCBksacpg",286,0.996516,29,287,1,286,1,1,0,1,1,137,136,150,150,91
"8509",8,"[29]sJHoIaqaFyHcsHnbJHGqKCBksacpg",284,0.996491,29,285,1,284,1,1,0,1,1,146,145,139,139,91
"8510",9,"[29]sJHoIaqaFyHcsHnbJHGqKCBksacpg",279,0.996429,29,280,1,279,1,1,0,1,1,136,135,144,144,91
"8511",10,"[29]sJHoIaqaFyHcsHnbJHGqKCBksacpg",286,0.996516,29,287,1,286,1,1,0,1,1,149,148,138,138,91
"8512",11,"[29]sJHoIaqaFyHcsHnbJHGqKCBksacpg",276,0.99639,29,277,1,276,1,1,0,1,1,137,136,140,140,91
"8513",12,"[29]sJHoIaqaFyHcsHnbJHGqKCBksacpg",280,0.996441,29,281,1,280,1,1,0,1,1,130,129,151,151,91
"8514",13,"[29]sJHoIaqaFyHcsHnbJHGqKCBksacpg",279,0.996429,29,280,1,279,1,1,0,1,1,135,134,145,145,91
"8515",14,"[29]sJHoIaqaFyHcsHnbJHGqKCBksacpg",282,0.996466,29,283,1,282,1,1,0,1,1,140,139,143,143,91
"8516",15,"[29]sJHoIaqaFyHcsHnbJHGqKCBksacpg",271,0.996324,29,272,1,271,1,1,0,1,1,130,129,142,142,91
"8517",16,"[29]sJHoIaqaFyHcsHnbJHGqKCBksacpg",290,0.996564,29,291,1,290,1,1,0,1,1,151,150,140,140,91
"8518",17,"[29]sJHoIaqaFyHcsHnbJHGqKCBksacpg",278,0.996416,29,279,1,278,1,1,0,1,1,131,130,148,148,91
"8519",18,"[29]sJHoIaqaFyHcsHnbJHGqKCBksacpg",286,0.996516,29,287,1,286,1,1,0,1,1,144,143,143,143,91
"8520",19,"[29]sJHoIaqaFyHcsHnbJHGqKCBksacpg",288,0.99654,29,289,1,288,1,1,0,1,1,151,150,138,138,91
"8521",20,"[29]sJHoIaqaFyHcsHnbJHGqKCBksacpg",290,0.996564,29,291,1,290,1,1,0,1,1,169,168,122,122,91
"8522",21,"[29]sJHoIaqaFyHcsHnbJHGqKCBksacpg",286,0.996516,29,287,1,286,1,1,0,1,1,143,142,144,144,91
"8523",22,"[29]sJHoIaqaFyHcsHnbJHGqKCBksacpg",288,0.99654,29,289,1,288,1,1,0,1,1,152,151,137,137,91
"8524",23,"[29]sJHoIaqaFyHcsHnbJHGqKCBksacpg",281,0.996454,29,282,1,281,1,1,0,1,1,143,142,139,139,91
"8525",24,"[29]sJHoIaqaFyHcsHnbJHGqKCBksacpg",279,0.996429,29,280,1,279,1,1,0,1,1,150,149,130,130,91
"8526",25,"[29]sJHoIaqaFyHcsHnbJHGqKCBksacpg",277,0.996403,29,278,1,277,1,1,0,1,1,131,130,147,147,91
"8527",26,"[29]sJHoIaqaFyHcsHnbJHGqKCBksacpg",282,0.996466,29,283,1,282,1,1,0,1,1,151,150,132,132,91
"8528",27,"[29]sJHoIaqaFyHcsHnbJHGqKCBksacpg",289,0.996552,29,290,1,289,1,1,0,1,1,148,147,142,142,91
"8529",28,"[29]sJHoIaqaFyHcsHnbJHGqKCBksacpg",279,0.996429,29,280,1,279,1,1,0,1,1,150,149,130,130,91
"8530",29,"[29]sJHoIaqaFyHcsHnbJHGqKCBksacpg",285,0.996503,29,286,1,285,1,1,0,1,1,159,158,127,127,91
"8531",30,"[29]sJHoIaqaFyHcsHnbJHGqKCBksacpg",286,0.996516,29,287,1,286,1,1,0,1,1,132,131,155,155,91
"8532",31,"[29]sJHoIaqaFyHcsHnbJHGqKCBksacpg",276,0.99639,29,277,1,276,1,1,0,1,1,137,136,140,140,91
"8533",32,"[29]sJHoIaqaFyHcsHnbJHGqKCBksacpg",280,0.996441,29,281,1,280,1,1,0,1,1,119,118,162,162,91
"8534",33,"[29]sJHoIaqaFyHcsHnbJHGqKCBksacpg",292,0.996587,29,293,1,292,1,1,0,1,1,154,153,139,139,91
"8535",34,"[29]sJHoIaqaFyHcsHnbJHGqKCBksacpg",293,0.996599,29,294,1,293,1,1,0,1,1,157,156,137,137,91
"8536",35,"[29]sJHoIaqaFyHcsHnbJHGqKCBksacpg",286,0.996516,29,287,1,286,1,1,0,1,1,148,147,139,139,91
"8537",36,"[29]sJHoIaqaFyHcsHnbJHGqKCBksacpg",273,0.99635,29,274,1,273,1,1,0,1,1,128,127,146,146,91
"8538",37,"[29]sJHoIaqaFyHcsHnbJHGqKCBksacpg",276,0.99639,29,277,1,276,1,1,0,1,1,126,125,151,151,91
"8539",38,"[29]sJHoIaqaFyHcsHnbJHGqKCBksacpg",281,0.996454,29,282,1,281,1,1,0,1,1,128,127,154,154,91
"8540",39,"[29]sJHoIaqaFyHcsHnbJHGqKCBksacpg",282,0.996466,29,283,1,282,1,1,0,1,1,148,147,135,135,91
"8541",40,"[29]sJHoIaqaFyHcsHnbJHGqKCBksacpg",282,0.996466,29,283,1,282,1,1,0,1,1,143,142,140,140,91
"8542",41,"[29]sJHoIaqaFyHcsHnbJHGqKCBksacpg",287,0.996528,29,288,1,287,1,1,0,1,1,153,152,135,135,91
"8543",42,"[29]sJHoIaqaFyHcsHnbJHGqKCBksacpg",277,0.996403,29,278,1,277,1,1,0,1,1,136,135,142,142,91
"8544",43,"[29]sJHoIaqaFyHcsHnbJHGqKCBksacpg",281,0.996454,29,282,1,281,1,1,0,1,1,143,142,139,139,91
"8545",44,"[29]sJHoIaqaFyHcsHnbJHGqKCBksacpg",282,0.996466,29,283,1,282,1,1,0,1,1,122,121,161,161,91
"8546",45,"[29]sJHoIaqaFyHcsHnbJHGqKCBksacpg",281,0.996454,29,282,1,281,1,1,0,1,1,134,133,148,148,91
"8547",46,"[29]sJHoIaqaFyHcsHnbJHGqKCBksacpg",290,0.996564,29,291,1,290,1,1,0,1,1,148,147,143,143,91
"8548",47,"[29]sJHoIaqaFyHcsHnbJHGqKCBksacpg",287,0.996528,29,288,1,287,1,1,0,1,1,148,147,140,140,91
"8549",48,"[29]sJHoIaqaFyHcsHnbJHGqKCBksacpg",282,0.996466,29,283,1,282,1,1,0,1,1,144,143,139,139,91
"8550",49,"[29]sJHoIaqaFyHcsHnbJHGqKCBksacpg",288,0.99654,29,289,1,288,1,1,0,1,1,159,158,130,130,91
"8551",50,"[29]sJHoIaqaFyHcsHnbJHGqKCBksacpg",279,0.996429,29,280,1,279,1,1,0,1,1,132,131,148,148,91
"8552",51,"[29]sJHoIaqaFyHcsHnbJHGqKCBksacpg",274,0.996364,29,275,1,274,1,1,0,1,1,146,145,129,129,91
"8553",52,"[29]sJHoIaqaFyHcsHnbJHGqKCBksacpg",286,0.996516,29,287,1,286,1,1,0,1,1,144,143,143,143,91
"8554",53,"[29]sJHoIaqaFyHcsHnbJHGqKCBksacpg",285,0.996503,29,286,1,285,1,1,0,1,1,137,136,149,149,91
"8555",54,"[29]sJHoIaqaFyHcsHnbJHGqKCBksacpg",284,0.996491,29,285,1,284,1,1,0,1,1,149,148,136,136,91
"8556",55,"[29]sJHoIaqaFyHcsHnbJHGqKCBksacpg",286,0.996516,29,287,1,286,1,1,0,1,1,149,148,138,138,91
"8557",56,"[29]sJHoIaqaFyHcsHnbJHGqKCBksacpg",282,0.996466,29,283,1,282,1,1,0,1,1,136,135,147,147,91
"8558",57,"[29]sJHoIaqaFyHcsHnbJHGqKCBksacpg",284,0.996491,29,285,1,284,1,1,0,1,1,139,138,146,146,91
"8559",58,"[29]sJHoIaqaFyHcsHnbJHGqKCBksacpg",283,0.996479,29,284,1,283,1,1,0,1,1,156,155,128,128,91
"8560",59,"[29]sJHoIaqaFyHcsHnbJHGqKCBksacpg",278,0.996416,29,279,1,278,1,1,0,1,1,134,133,145,145,91
"8561",60,"[29]sJHoIaqaFyHcsHnbJHGqKCBksacpg",282,0.996466,29,283,1,282,1,1,0,1,1,129,128,154,154,91
"8562",61,"[29]sJHoIaqaFyHcsHnbJHGqKCBksacpg",282,0.996466,29,283,1,282,1,1,0,1,1,135,134,148,148,91
"8563",62,"[29]sJHoIaqaFyHcsHnbJHGqKCBksacpg",283,0.996479,29,284,1,283,1,1,0,1,1,142,141,142,142,91
"8564",63,"[29]sJHoIaqaFyHcsHnbJHGqKCBksacpg",289,0.996552,29,290,1,289,1,1,0,1,1,153,152,137,137,91
"8565",64,"[29]sJHoIaqaFyHcsHnbJHGqKCBksacpg",286,0.996516,29,287,1,286,1,1,0,1,1,142,141,145,145,91
"8566",65,"[29]sJHoIaqaFyHcsHnbJHGqKCBksacpg",281,0.996454,29,282,1,281,1,1,0,1,1,146,145,136,136,91
"8567",66,"[29]sJHoIaqaFyHcsHnbJHGqKCBksacpg",282,0.996466,29,283,1,282,1,1,0,1,1,132,131,151,151,91
"8568",67,"[29]sJHoIaqaFyHcsHnbJHGqKCBksacpg",285,0.996503,29,286,1,285,1,1,0,1,1,134,133,152,152,91
"8569",68,"[29]sJHoIaqaFyHcsHnbJHGqKCBksacpg",283,0.996479,29,284,1,283,1,1,0,1,1,150,149,134,134,91
"8570",69,"[29]sJHoIaqaFyHcsHnbJHGqKCBksacpg",277,0.996403,29,278,1,277,1,1,0,1,1,147,146,131,131,91
"8571",70,"[29]sJHoIaqaFyHcsHnbJHGqKCBksacpg",287,0.996528,29,288,1,287,1,1,0,1,1,144,143,144,144,91
"8572",71,"[29]sJHoIaqaFyHcsHnbJHGqKCBksacpg",282,0.996466,29,283,1,282,1,1,0,1,1,141,140,142,142,91
"8573",72,"[29]sJHoIaqaFyHcsHnbJHGqKCBksacpg",288,0.99654,29,289,1,288,1,1,0,1,1,137,136,152,152,91
"8574",73,"[29]sJHoIaqaFyHcsHnbJHGqKCBksacpg",283,0.996479,29,284,1,283,1,1,0,1,1,150,149,134,134,91
"8575",74,"[29]sJHoIaqaFyHcsHnbJHGqKCBksacpg",283,0.996479,29,284,1,283,1,1,0,1,1,144,143,140,140,91
"8576",75,"[29]sJHoIaqaFyHcsHnbJHGqKCBksacpg",285,0.996503,29,286,1,285,1,1,0,1,1,159,158,127,127,91
"8577",76,"[29]sJHoIaqaFyHcsHnbJHGqKCBksacpg",284,0.996491,29,285,1,284,1,1,0,1,1,131,130,154,154,91
"8578",77,"[29]sJHoIaqaFyHcsHnbJHGqKCBksacpg",286,0.996516,29,287,1,286,1,1,0,1,1,144,143,143,143,91
"8579",78,"[29]sJHoIaqaFyHcsHnbJHGqKCBksacpg",282,0.996466,29,283,1,282,1,1,0,1,1,130,129,153,153,91
"8580",79,"[29]sJHoIaqaFyHcsHnbJHGqKCBksacpg",283,0.996479,29,284,1,283,1,1,0,1,1,144,143,140,140,91
"8581",80,"[29]sJHoIaqaFyHcsHnbJHGqKCBksacpg",282,0.996466,29,283,1,282,1,1,0,1,1,150,149,133,133,91
"8582",81,"[29]sJHoIaqaFyHcsHnbJHGqKCBksacpg",281,0.996454,29,282,1,281,1,1,0,1,1,137,136,145,145,91
"8583",82,"[29]sJHoIaqaFyHcsHnbJHGqKCBksacpg",284,0.996491,29,285,1,284,1,1,0,1,1,150,149,135,135,91
"8584",83,"[29]sJHoIaqaFyHcsHnbJHGqKCBksacpg",284,0.996491,29,285,1,284,1,1,0,1,1,147,146,138,138,91
"8585",84,"[29]sJHoIaqaFyHcsHnbJHGqKCBksacpg",280,0.996441,29,281,1,280,1,1,0,1,1,136,135,145,145,91
"8586",85,"[29]sJHoIaqaFyHcsHnbJHGqKCBksacpg",290,0.996564,29,291,1,290,1,1,0,1,1,150,149,141,141,91
"8587",86,"[29]sJHoIaqaFyHcsHnbJHGqKCBksacpg",287,0.996528,29,288,1,287,1,1,0,1,1,141,140,147,147,91
"8588",87,"[29]sJHoIaqaFyHcsHnbJHGqKCBksacpg",275,0.996377,29,276,1,275,1,1,0,1,1,137,136,139,139,91
"8589",88,"[29]sJHoIaqaFyHcsHnbJHGqKCBksacpg",282,0.996466,29,283,1,282,1,1,0,1,1,154,153,129,129,91
"8590",89,"[29]sJHoIaqaFyHcsHnbJHGqKCBksacpg",286,0.996516,29,287,1,286,1,1,0,1,1,145,144,142,142,91
"8591",90,"[29]sJHoIaqaFyHcsHnbJHGqKCBksacpg",288,0.99654,29,289,1,288,1,1,0,1,1,142,141,147,147,91
"8592",91,"[29]sJHoIaqaFyHcsHnbJHGqKCBksacpg",284,0.996491,29,285,1,284,1,1,0,1,1,147,146,138,138,91
"8593",92,"[29]sJHoIaqaFyHcsHnbJHGqKCBksacpg",285,0.996503,29,286,1,285,1,1,0,1,1,139,138,147,147,91
"8594",93,"[29]sJHoIaqaFyHcsHnbJHGqKCBksacpg",283,0.996479,29,284,1,283,1,1,0,1,1,149,148,135,135,91
"8595",94,"[29]sJHoIaqaFyHcsHnbJHGqKCBksacpg",288,0.99654,29,289,1,288,1,1,0,1,1,147,146,142,142,91
"8596",95,"[29]sJHoIaqaFyHcsHnbJHGqKCBksacpg",281,0.996454,29,282,1,281,1,1,0,1,1,149,148,133,133,91
"8597",96,"[29]sJHoIaqaFyHcsHnbJHGqKCBksacpg",284,0.996491,29,285,1,284,1,1,0,1,1,147,146,138,138,91
"8598",97,"[29]sJHoIaqaFyHcsHnbJHGqKCBksacpg",289,0.996552,29,290,1,289,1,1,0,1,1,141,140,149,149,91
"8599",98,"[29]sJHoIaqaFyHcsHnbJHGqKCBksacpg",282,0.996466,29,283,1,282,1,1,0,1,1,139,138,144,144,91
"8600",99,"[29]sJHoIaqaFyHcsHnbJHGqKCBksacpg",288,0.99654,29,289,1,288,1,1,0,1,1,137,136,152,152,91
"8601",0,"[25]dfHoIoHcowHnJHGqKCBpjGkpc",283,0.996479,25,284,1,283,1,1,0,1,1,149,148,135,135,92
"8602",1,"[25]dfHoIoHcowHnJHGqKCBpjGkpc",283,0.996479,25,284,1,283,1,1,0,1,1,149,148,135,135,92
"8603",2,"[25]dfHoIoHcowHnJHGqKCBpjGkpc",278,0.996416,25,279,1,278,1,1,0,1,1,135,134,144,144,92
"8604",3,"[25]dfHoIoHcowHnJHGqKCBpjGkpc",268,0.996283,25,269,1,268,1,1,0,1,1,141,140,128,128,92
"8605",4,"[25]dfHoIoHcowHnJHGqKCBpjGkpc",273,0.99635,25,274,1,273,1,1,0,1,1,133,132,141,141,92
"8606",5,"[25]dfHoIoHcowHnJHGqKCBpjGkpc",279,0.996429,25,280,1,279,1,1,0,1,1,136,135,144,144,92
"8607",6,"[25]dfHoIoHcowHnJHGqKCBpjGkpc",278,0.996416,25,279,1,278,1,1,0,1,1,151,150,128,128,92
"8608",7,"[25]dfHoIoHcowHnJHGqKCBpjGkpc",280,0.996441,25,281,1,280,1,1,0,1,1,141,140,140,140,92
"8609",8,"[25]dfHoIoHcowHnJHGqKCBpjGkpc",278,0.996416,25,279,1,278,1,1,0,1,1,138,137,141,141,92
"8610",9,"[25]dfHoIoHcowHnJHGqKCBpjGkpc",285,0.996503,25,286,1,285,1,1,0,1,1,145,144,141,141,92
"8611",10,"[25]dfHoIoHcowHnJHGqKCBpjGkpc",281,0.996454,25,282,1,281,1,1,0,1,1,164,163,118,118,92
"8612",11,"[25]dfHoIoHcowHnJHGqKCBpjGkpc",285,0.996503,25,286,1,285,1,1,0,1,1,152,151,134,134,92
"8613",12,"[25]dfHoIoHcowHnJHGqKCBpjGkpc",291,0.996575,25,292,1,291,1,1,0,1,1,162,161,130,130,92
"8614",13,"[25]dfHoIoHcowHnJHGqKCBpjGkpc",282,0.996466,25,283,1,282,1,1,0,1,1,156,155,127,127,92
"8615",14,"[25]dfHoIoHcowHnJHGqKCBpjGkpc",278,0.996416,25,279,1,278,1,1,0,1,1,140,139,139,139,92
"8616",15,"[25]dfHoIoHcowHnJHGqKCBpjGkpc",282,0.996466,25,283,1,282,1,1,0,1,1,148,147,135,135,92
"8617",16,"[25]dfHoIoHcowHnJHGqKCBpjGkpc",272,0.996337,25,273,1,272,1,1,0,1,1,117,116,156,156,92
"8618",17,"[25]dfHoIoHcowHnJHGqKCBpjGkpc",280,0.996441,25,281,1,280,1,1,0,1,1,130,129,151,151,92
"8619",18,"[25]dfHoIoHcowHnJHGqKCBpjGkpc",284,0.996491,25,285,1,284,1,1,0,1,1,140,139,145,145,92
"8620",19,"[25]dfHoIoHcowHnJHGqKCBpjGkpc",286,0.996516,25,287,1,286,1,1,0,1,1,148,147,139,139,92
"8621",20,"[25]dfHoIoHcowHnJHGqKCBpjGkpc",295,0.996622,25,296,1,295,1,1,0,1,1,145,144,151,151,92
"8622",21,"[25]dfHoIoHcowHnJHGqKCBpjGkpc",277,0.996403,25,278,1,277,1,1,0,1,1,142,141,136,136,92
"8623",22,"[25]dfHoIoHcowHnJHGqKCBpjGkpc",280,0.996441,25,281,1,280,1,1,0,1,1,147,146,134,134,92
"8624",23,"[25]dfHoIoHcowHnJHGqKCBpjGkpc",279,0.996429,25,280,1,279,1,1,0,1,1,133,132,147,147,92
"8625",24,"[25]dfHoIoHcowHnJHGqKCBpjGkpc",284,0.996491,25,285,1,284,1,1,0,1,1,139,138,146,146,92
"8626",25,"[25]dfHoIoHcowHnJHGqKCBpjGkpc",278,0.996416,25,279,1,278,1,1,0,1,1,142,141,137,137,92
"8627",26,"[25]dfHoIoHcowHnJHGqKCBpjGkpc",279,0.996429,25,280,1,279,1,1,0,1,1,135,134,145,145,92
"8628",27,"[25]dfHoIoHcowHnJHGqKCBpjGkpc",280,0.996441,25,281,1,280,1,1,0,1,1,135,134,146,146,92
"8629",28,"[25]dfHoIoHcowHnJHGqKCBpjGkpc",285,0.996503,25,286,1,285,1,1,0,1,1,140,139,146,146,92
"8630",29,"[25]dfHoIoHcowHnJHGqKCBpjGkpc",284,0.996491,25,285,1,284,1,1,0,1,1,155,154,130,130,92
"8631",30,"[25]dfHoIoHcowHnJHGqKCBpjGkpc",279,0.996429,25,280,1,279,1,1,0,1,1,154,153,126,126,92
"8632",31,"[25]dfHoIoHcowHnJHGqKCBpjGkpc",282,0.996466,25,283,1,282,1,1,0,1,1,136,135,147,147,92
"8633",32,"[25]dfHoIoHcowHnJHGqKCBpjGkpc",285,0.996503,25,286,1,285,1,1,0,1,1,155,154,131,131,92
"8634",33,"[25]dfHoIoHcowHnJHGqKCBpjGkpc",276,0.99639,25,277,1,276,1,1,0,1,1,117,116,160,160,92
"8635",34,"[25]dfHoIoHcowHnJHGqKCBpjGkpc",280,0.996441,25,281,1,280,1,1,0,1,1,141,140,140,140,92
"8636",35,"[25]dfHoIoHcowHnJHGqKCBpjGkpc",265,0.996241,25,266,1,265,1,1,0,1,1,133,132,133,133,92
"8637",36,"[25]dfHoIoHcowHnJHGqKCBpjGkpc",280,0.996441,25,281,1,280,1,1,0,1,1,130,129,151,151,92
"8638",37,"[25]dfHoIoHcowHnJHGqKCBpjGkpc",286,0.996516,25,287,1,286,1,1,0,1,1,152,151,135,135,92
"8639",38,"[25]dfHoIoHcowHnJHGqKCBpjGkpc",282,0.996466,25,283,1,282,1,1,0,1,1,136,135,147,147,92
"8640",39,"[25]dfHoIoHcowHnJHGqKCBpjGkpc",285,0.996503,25,286,1,285,1,1,0,1,1,139,138,147,147,92
"8641",40,"[25]dfHoIoHcowHnJHGqKCBpjGkpc",279,0.996429,25,280,1,279,1,1,0,1,1,132,131,148,148,92
"8642",41,"[25]dfHoIoHcowHnJHGqKCBpjGkpc",272,0.996337,25,273,1,272,1,1,0,1,1,162,161,111,111,92
"8643",42,"[25]dfHoIoHcowHnJHGqKCBpjGkpc",281,0.996454,25,282,1,281,1,1,0,1,1,150,149,132,132,92
"8644",43,"[25]dfHoIoHcowHnJHGqKCBpjGkpc",274,0.996364,25,275,1,274,1,1,0,1,1,132,131,143,143,92
"8645",44,"[25]dfHoIoHcowHnJHGqKCBpjGkpc",284,0.996491,25,285,1,284,1,1,0,1,1,142,141,143,143,92
"8646",45,"[25]dfHoIoHcowHnJHGqKCBpjGkpc",280,0.996441,25,281,1,280,1,1,0,1,1,130,129,151,151,92
"8647",46,"[25]dfHoIoHcowHnJHGqKCBpjGkpc",284,0.996491,25,285,1,284,1,1,0,1,1,153,152,132,132,92
"8648",47,"[25]dfHoIoHcowHnJHGqKCBpjGkpc",281,0.996454,25,282,1,281,1,1,0,1,1,138,137,144,144,92
"8649",48,"[25]dfHoIoHcowHnJHGqKCBpjGkpc",280,0.996441,25,281,1,280,1,1,0,1,1,127,126,154,154,92
"8650",49,"[25]dfHoIoHcowHnJHGqKCBpjGkpc",274,0.996364,25,275,1,274,1,1,0,1,1,125,124,150,150,92
"8651",50,"[25]dfHoIoHcowHnJHGqKCBpjGkpc",269,0.996296,25,270,1,269,1,1,0,1,1,121,120,149,149,92
"8652",51,"[25]dfHoIoHcowHnJHGqKCBpjGkpc",277,0.996403,25,278,1,277,1,1,0,1,1,142,141,136,136,92
"8653",52,"[25]dfHoIoHcowHnJHGqKCBpjGkpc",278,0.996416,25,279,1,278,1,1,0,1,1,142,141,137,137,92
"8654",53,"[25]dfHoIoHcowHnJHGqKCBpjGkpc",273,0.99635,25,274,1,273,1,1,0,1,1,116,115,158,158,92
"8655",54,"[25]dfHoIoHcowHnJHGqKCBpjGkpc",281,0.996454,25,282,1,281,1,1,0,1,1,149,148,133,133,92
"8656",55,"[25]dfHoIoHcowHnJHGqKCBpjGkpc",282,0.996466,25,283,1,282,1,1,0,1,1,142,141,141,141,92
"8657",56,"[25]dfHoIoHcowHnJHGqKCBpjGkpc",276,0.99639,25,277,1,276,1,1,0,1,1,120,119,157,157,92
"8658",57,"[25]dfHoIoHcowHnJHGqKCBpjGkpc",276,0.99639,25,277,1,276,1,1,0,1,1,134,133,143,143,92
"8659",58,"[25]dfHoIoHcowHnJHGqKCBpjGkpc",278,0.996416,25,279,1,278,1,1,0,1,1,129,128,150,150,92
"8660",59,"[25]dfHoIoHcowHnJHGqKCBpjGkpc",283,0.996479,25,284,1,283,1,1,0,1,1,147,146,137,137,92
"8661",60,"[25]dfHoIoHcowHnJHGqKCBpjGkpc",276,0.99639,25,277,1,276,1,1,0,1,1,135,134,142,142,92
"8662",61,"[25]dfHoIoHcowHnJHGqKCBpjGkpc",286,0.996516,25,287,1,286,1,1,0,1,1,150,149,137,137,92
"8663",62,"[25]dfHoIoHcowHnJHGqKCBpjGkpc",276,0.99639,25,277,1,276,1,1,0,1,1,141,140,136,136,92
"8664",63,"[25]dfHoIoHcowHnJHGqKCBpjGkpc",277,0.996403,25,278,1,277,1,1,0,1,1,136,135,142,142,92
"8665",64,"[25]dfHoIoHcowHnJHGqKCBpjGkpc",286,0.996516,25,287,1,286,1,1,0,1,1,133,132,154,154,92
"8666",65,"[25]dfHoIoHcowHnJHGqKCBpjGkpc",284,0.996491,25,285,1,284,1,1,0,1,1,137,136,148,148,92
"8667",66,"[25]dfHoIoHcowHnJHGqKCBpjGkpc",272,0.996337,25,273,1,272,1,1,0,1,1,139,138,134,134,92
"8668",67,"[25]dfHoIoHcowHnJHGqKCBpjGkpc",281,0.996454,25,282,1,281,1,1,0,1,1,147,146,135,135,92
"8669",68,"[25]dfHoIoHcowHnJHGqKCBpjGkpc",278,0.996416,25,279,1,278,1,1,0,1,1,139,138,140,140,92
"8670",69,"[25]dfHoIoHcowHnJHGqKCBpjGkpc",278,0.996416,25,279,1,278,1,1,0,1,1,143,142,136,136,92
"8671",70,"[25]dfHoIoHcowHnJHGqKCBpjGkpc",279,0.996429,25,280,1,279,1,1,0,1,1,137,136,143,143,92
"8672",71,"[25]dfHoIoHcowHnJHGqKCBpjGkpc",289,0.996552,25,290,1,289,1,1,0,1,1,152,151,138,138,92
"8673",72,"[25]dfHoIoHcowHnJHGqKCBpjGkpc",277,0.996403,25,278,1,277,1,1,0,1,1,138,137,140,140,92
"8674",73,"[25]dfHoIoHcowHnJHGqKCBpjGkpc",287,0.996528,25,288,1,287,1,1,0,1,1,160,159,128,128,92
"8675",74,"[25]dfHoIoHcowHnJHGqKCBpjGkpc",279,0.996429,25,280,1,279,1,1,0,1,1,144,143,136,136,92
"8676",75,"[25]dfHoIoHcowHnJHGqKCBpjGkpc",275,0.996377,25,276,1,275,1,1,0,1,1,125,124,151,151,92
"8677",76,"[25]dfHoIoHcowHnJHGqKCBpjGkpc",272,0.996337,25,273,1,272,1,1,0,1,1,131,130,142,142,92
"8678",77,"[25]dfHoIoHcowHnJHGqKCBpjGkpc",274,0.996364,25,275,1,274,1,1,0,1,1,119,118,156,156,92
"8679",78,"[25]dfHoIoHcowHnJHGqKCBpjGkpc",285,0.996503,25,286,1,285,1,1,0,1,1,147,146,139,139,92
"8680",79,"[25]dfHoIoHcowHnJHGqKCBpjGkpc",273,0.99635,25,274,1,273,1,1,0,1,1,144,143,130,130,92
"8681",80,"[25]dfHoIoHcowHnJHGqKCBpjGkpc",277,0.996403,25,278,1,277,1,1,0,1,1,140,139,138,138,92
"8682",81,"[25]dfHoIoHcowHnJHGqKCBpjGkpc",280,0.996441,25,281,1,280,1,1,0,1,1,142,141,139,139,92
"8683",82,"[25]dfHoIoHcowHnJHGqKCBpjGkpc",282,0.996466,25,283,1,282,1,1,0,1,1,140,139,143,143,92
"8684",83,"[25]dfHoIoHcowHnJHGqKCBpjGkpc",287,0.996528,25,288,1,287,1,1,0,1,1,141,140,147,147,92
"8685",84,"[25]dfHoIoHcowHnJHGqKCBpjGkpc",285,0.996503,25,286,1,285,1,1,0,1,1,136,135,150,150,92
"8686",85,"[25]dfHoIoHcowHnJHGqKCBpjGkpc",272,0.996337,25,273,1,272,1,1,0,1,1,150,149,123,123,92
"8687",86,"[25]dfHoIoHcowHnJHGqKCBpjGkpc",278,0.996416,25,279,1,278,1,1,0,1,1,146,145,133,133,92
"8688",87,"[25]dfHoIoHcowHnJHGqKCBpjGkpc",279,0.996429,25,280,1,279,1,1,0,1,1,122,121,158,158,92
"8689",88,"[25]dfHoIoHcowHnJHGqKCBpjGkpc",284,0.996491,25,285,1,284,1,1,0,1,1,141,140,144,144,92
"8690",89,"[25]dfHoIoHcowHnJHGqKCBpjGkpc",281,0.996454,25,282,1,281,1,1,0,1,1,147,146,135,135,92
"8691",90,"[25]dfHoIoHcowHnJHGqKCBpjGkpc",283,0.996479,25,284,1,283,1,1,0,1,1,150,149,134,134,92
"8692",91,"[25]dfHoIoHcowHnJHGqKCBpjGkpc",278,0.996416,25,279,1,278,1,1,0,1,1,135,134,144,144,92
"8693",92,"[25]dfHoIoHcowHnJHGqKCBpjGkpc",277,0.996403,25,278,1,277,1,1,0,1,1,133,132,145,145,92
"8694",93,"[25]dfHoIoHcowHnJHGqKCBpjGkpc",284,0.996491,25,285,1,284,1,1,0,1,1,149,148,136,136,92
"8695",94,"[25]dfHoIoHcowHnJHGqKCBpjGkpc",280,0.996441,25,281,1,280,1,1,0,1,1,133,132,148,148,92
"8696",95,"[25]dfHoIoHcowHnJHGqKCBpjGkpc",281,0.996454,25,282,1,281,1,1,0,1,1,133,132,149,149,92
"8697",96,"[25]dfHoIoHcowHnJHGqKCBpjGkpc",287,0.996528,25,288,1,287,1,1,0,1,1,143,142,145,145,92
"8698",97,"[25]dfHoIoHcowHnJHGqKCBpjGkpc",276,0.99639,25,277,1,276,1,1,0,1,1,145,144,132,132,92
"8699",98,"[25]dfHoIoHcowHnJHGqKCBpjGkpc",286,0.996516,25,287,1,286,1,1,0,1,1,151,150,136,136,92
"8700",99,"[25]dfHoIoHcowHnJHGqKCBpjGkpc",279,0.996429,25,280,1,279,1,1,0,1,1,159,158,121,121,92
"8701",0,"[25]svJHqaIifHckvHnJHGqKCCsnD",281,0.996454,25,282,1,281,1,1,0,1,1,145,144,137,137,93
"8702",1,"[25]svJHqaIifHckvHnJHGqKCCsnD",279,0.996429,25,280,1,279,1,1,0,1,1,143,142,137,137,93
"8703",2,"[25]svJHqaIifHckvHnJHGqKCCsnD",285,0.996503,25,286,1,285,1,1,0,1,1,164,163,122,122,93
"8704",3,"[25]svJHqaIifHckvHnJHGqKCCsnD",285,0.996503,25,286,1,285,1,1,0,1,1,141,140,145,145,93
"8705",4,"[25]svJHqaIifHckvHnJHGqKCCsnD",290,0.996564,25,291,1,290,1,1,0,1,1,155,154,136,136,93
"8706",5,"[25]svJHqaIifHckvHnJHGqKCCsnD",281,0.996454,25,282,1,281,1,1,0,1,1,130,129,152,152,93
"8707",6,"[25]svJHqaIifHckvHnJHGqKCCsnD",288,0.99654,25,289,1,288,1,1,0,1,1,150,149,139,139,93
"8708",7,"[25]svJHqaIifHckvHnJHGqKCCsnD",285,0.996503,25,286,1,285,1,1,0,1,1,150,149,136,136,93
"8709",8,"[25]svJHqaIifHckvHnJHGqKCCsnD",279,0.996429,25,280,1,279,1,1,0,1,1,137,136,143,143,93
"8710",9,"[25]svJHqaIifHckvHnJHGqKCCsnD",283,0.996479,25,284,1,283,1,1,0,1,1,133,132,151,151,93
"8711",10,"[25]svJHqaIifHckvHnJHGqKCCsnD",285,0.996503,25,286,1,285,1,1,0,1,1,128,127,158,158,93
"8712",11,"[25]svJHqaIifHckvHnJHGqKCCsnD",281,0.996454,25,282,1,281,1,1,0,1,1,135,134,147,147,93
"8713",12,"[25]svJHqaIifHckvHnJHGqKCCsnD",285,0.996503,25,286,1,285,1,1,0,1,1,148,147,138,138,93
"8714",13,"[25]svJHqaIifHckvHnJHGqKCCsnD",280,0.996441,25,281,1,280,1,1,0,1,1,135,134,146,146,93
"8715",14,"[25]svJHqaIifHckvHnJHGqKCCsnD",281,0.996454,25,282,1,281,1,1,0,1,1,143,142,139,139,93
"8716",15,"[25]svJHqaIifHckvHnJHGqKCCsnD",287,0.996528,25,288,1,287,1,1,0,1,1,149,148,139,139,93
"8717",16,"[25]svJHqaIifHckvHnJHGqKCCsnD",283,0.996479,25,284,1,283,1,1,0,1,1,151,150,133,133,93
"8718",17,"[25]svJHqaIifHckvHnJHGqKCCsnD",283,0.996479,25,284,1,283,1,1,0,1,1,131,130,153,153,93
"8719",18,"[25]svJHqaIifHckvHnJHGqKCCsnD",287,0.996528,25,288,1,287,1,1,0,1,1,151,150,137,137,93
"8720",19,"[25]svJHqaIifHckvHnJHGqKCCsnD",282,0.996466,25,283,1,282,1,1,0,1,1,131,130,152,152,93
"8721",20,"[25]svJHqaIifHckvHnJHGqKCCsnD",276,0.99639,25,277,1,276,1,1,0,1,1,125,124,152,152,93
"8722",21,"[25]svJHqaIifHckvHnJHGqKCCsnD",280,0.996441,25,281,1,280,1,1,0,1,1,132,131,149,149,93
"8723",22,"[25]svJHqaIifHckvHnJHGqKCCsnD",278,0.996416,25,279,1,278,1,1,0,1,1,122,121,157,157,93
"8724",23,"[25]svJHqaIifHckvHnJHGqKCCsnD",284,0.996491,25,285,1,284,1,1,0,1,1,162,161,123,123,93
"8725",24,"[25]svJHqaIifHckvHnJHGqKCCsnD",283,0.996479,25,284,1,283,1,1,0,1,1,144,143,140,140,93
"8726",25,"[25]svJHqaIifHckvHnJHGqKCCsnD",275,0.996377,25,276,1,275,1,1,0,1,1,128,127,148,148,93
"8727",26,"[25]svJHqaIifHckvHnJHGqKCCsnD",293,0.996599,25,294,1,293,1,1,0,1,1,163,162,131,131,93
"8728",27,"[25]svJHqaIifHckvHnJHGqKCCsnD",279,0.996429,25,280,1,279,1,1,0,1,1,119,118,161,161,93
"8729",28,"[25]svJHqaIifHckvHnJHGqKCCsnD",288,0.99654,25,289,1,288,1,1,0,1,1,149,148,140,140,93
"8730",29,"[25]svJHqaIifHckvHnJHGqKCCsnD",284,0.996491,25,285,1,284,1,1,0,1,1,149,148,136,136,93
"8731",30,"[25]svJHqaIifHckvHnJHGqKCCsnD",287,0.996528,25,288,1,287,1,1,0,1,1,136,135,152,152,93
"8732",31,"[25]svJHqaIifHckvHnJHGqKCCsnD",280,0.996441,25,281,1,280,1,1,0,1,1,143,142,138,138,93
"8733",32,"[25]svJHqaIifHckvHnJHGqKCCsnD",284,0.996491,25,285,1,284,1,1,0,1,1,158,157,127,127,93
"8734",33,"[25]svJHqaIifHckvHnJHGqKCCsnD",283,0.996479,25,284,1,283,1,1,0,1,1,133,132,151,151,93
"8735",34,"[25]svJHqaIifHckvHnJHGqKCCsnD",275,0.996377,25,276,1,275,1,1,0,1,1,128,127,148,148,93
"8736",35,"[25]svJHqaIifHckvHnJHGqKCCsnD",288,0.99654,25,289,1,288,1,1,0,1,1,138,137,151,151,93
"8737",36,"[25]svJHqaIifHckvHnJHGqKCCsnD",291,0.996575,25,292,1,291,1,1,0,1,1,153,152,139,139,93
"8738",37,"[25]svJHqaIifHckvHnJHGqKCCsnD",287,0.996528,25,288,1,287,1,1,0,1,1,162,161,126,126,93
"8739",38,"[25]svJHqaIifHckvHnJHGqKCCsnD",281,0.996454,25,282,1,281,1,1,0,1,1,143,142,139,139,93
"8740",39,"[25]svJHqaIifHckvHnJHGqKCCsnD",284,0.996491,25,285,1,284,1,1,0,1,1,146,145,139,139,93
"8741",40,"[25]svJHqaIifHckvHnJHGqKCCsnD",284,0.996491,25,285,1,284,1,1,0,1,1,146,145,139,139,93
"8742",41,"[25]svJHqaIifHckvHnJHGqKCCsnD",282,0.996466,25,283,1,282,1,1,0,1,1,143,142,140,140,93
"8743",42,"[25]svJHqaIifHckvHnJHGqKCCsnD",300,0.996678,25,301,1,300,1,1,0,1,1,172,171,129,129,93
"8744",43,"[25]svJHqaIifHckvHnJHGqKCCsnD",280,0.996441,25,281,1,280,1,1,0,1,1,133,132,148,148,93
"8745",44,"[25]svJHqaIifHckvHnJHGqKCCsnD",290,0.996564,25,291,1,290,1,1,0,1,1,152,151,139,139,93
"8746",45,"[25]svJHqaIifHckvHnJHGqKCCsnD",285,0.996503,25,286,1,285,1,1,0,1,1,156,155,130,130,93
"8747",46,"[25]svJHqaIifHckvHnJHGqKCCsnD",287,0.996528,25,288,1,287,1,1,0,1,1,140,139,148,148,93
"8748",47,"[25]svJHqaIifHckvHnJHGqKCCsnD",282,0.996466,25,283,1,282,1,1,0,1,1,142,141,141,141,93
"8749",48,"[25]svJHqaIifHckvHnJHGqKCCsnD",281,0.996454,25,282,1,281,1,1,0,1,1,153,152,129,129,93
"8750",49,"[25]svJHqaIifHckvHnJHGqKCCsnD",282,0.996466,25,283,1,282,1,1,0,1,1,144,143,139,139,93
"8751",50,"[25]svJHqaIifHckvHnJHGqKCCsnD",276,0.99639,25,277,1,276,1,1,0,1,1,123,122,154,154,93
"8752",51,"[25]svJHqaIifHckvHnJHGqKCCsnD",280,0.996441,25,281,1,280,1,1,0,1,1,141,140,140,140,93
"8753",52,"[25]svJHqaIifHckvHnJHGqKCCsnD",277,0.996403,25,278,1,277,1,1,0,1,1,142,141,136,136,93
"8754",53,"[25]svJHqaIifHckvHnJHGqKCCsnD",288,0.99654,25,289,1,288,1,1,0,1,1,158,157,131,131,93
"8755",54,"[25]svJHqaIifHckvHnJHGqKCCsnD",283,0.996479,25,284,1,283,1,1,0,1,1,149,148,135,135,93
"8756",55,"[25]svJHqaIifHckvHnJHGqKCCsnD",284,0.996491,25,285,1,284,1,1,0,1,1,139,138,146,146,93
"8757",56,"[25]svJHqaIifHckvHnJHGqKCCsnD",284,0.996491,25,285,1,284,1,1,0,1,1,142,141,143,143,93
"8758",57,"[25]svJHqaIifHckvHnJHGqKCCsnD",277,0.996403,25,278,1,277,1,1,0,1,1,127,126,151,151,93
"8759",58,"[25]svJHqaIifHckvHnJHGqKCCsnD",278,0.996416,25,279,1,278,1,1,0,1,1,142,141,137,137,93
"8760",59,"[25]svJHqaIifHckvHnJHGqKCCsnD",284,0.996491,25,285,1,284,1,1,0,1,1,139,138,146,146,93
"8761",60,"[25]svJHqaIifHckvHnJHGqKCCsnD",285,0.996503,25,286,1,285,1,1,0,1,1,155,154,131,131,93
"8762",61,"[25]svJHqaIifHckvHnJHGqKCCsnD",287,0.996528,25,288,1,287,1,1,0,1,1,145,144,143,143,93
"8763",62,"[25]svJHqaIifHckvHnJHGqKCCsnD",286,0.996516,25,287,1,286,1,1,0,1,1,142,141,145,145,93
"8764",63,"[25]svJHqaIifHckvHnJHGqKCCsnD",283,0.996479,25,284,1,283,1,1,0,1,1,125,124,159,159,93
"8765",64,"[25]svJHqaIifHckvHnJHGqKCCsnD",286,0.996516,25,287,1,286,1,1,0,1,1,155,154,132,132,93
"8766",65,"[25]svJHqaIifHckvHnJHGqKCCsnD",278,0.996416,25,279,1,278,1,1,0,1,1,131,130,148,148,93
"8767",66,"[25]svJHqaIifHckvHnJHGqKCCsnD",280,0.996441,25,281,1,280,1,1,0,1,1,140,139,141,141,93
"8768",67,"[25]svJHqaIifHckvHnJHGqKCCsnD",289,0.996552,25,290,1,289,1,1,0,1,1,134,133,156,156,93
"8769",68,"[25]svJHqaIifHckvHnJHGqKCCsnD",285,0.996503,25,286,1,285,1,1,0,1,1,149,148,137,137,93
"8770",69,"[25]svJHqaIifHckvHnJHGqKCCsnD",286,0.996516,25,287,1,286,1,1,0,1,1,157,156,130,130,93
"8771",70,"[25]svJHqaIifHckvHnJHGqKCCsnD",285,0.996503,25,286,1,285,1,1,0,1,1,141,140,145,145,93
"8772",71,"[25]svJHqaIifHckvHnJHGqKCCsnD",287,0.996528,25,288,1,287,1,1,0,1,1,147,146,141,141,93
"8773",72,"[25]svJHqaIifHckvHnJHGqKCCsnD",279,0.996429,25,280,1,279,1,1,0,1,1,125,124,155,155,93
"8774",73,"[25]svJHqaIifHckvHnJHGqKCCsnD",280,0.996441,25,281,1,280,1,1,0,1,1,142,141,139,139,93
"8775",74,"[25]svJHqaIifHckvHnJHGqKCCsnD",279,0.996429,25,280,1,279,1,1,0,1,1,128,127,152,152,93
"8776",75,"[25]svJHqaIifHckvHnJHGqKCCsnD",279,0.996429,25,280,1,279,1,1,0,1,1,134,133,146,146,93
"8777",76,"[25]svJHqaIifHckvHnJHGqKCCsnD",281,0.996454,25,282,1,281,1,1,0,1,1,139,138,143,143,93
"8778",77,"[25]svJHqaIifHckvHnJHGqKCCsnD",286,0.996516,25,287,1,286,1,1,0,1,1,142,141,145,145,93
"8779",78,"[25]svJHqaIifHckvHnJHGqKCCsnD",285,0.996503,25,286,1,285,1,1,0,1,1,152,151,134,134,93
"8780",79,"[25]svJHqaIifHckvHnJHGqKCCsnD",280,0.996441,25,281,1,280,1,1,0,1,1,152,151,129,129,93
"8781",80,"[25]svJHqaIifHckvHnJHGqKCCsnD",283,0.996479,25,284,1,283,1,1,0,1,1,143,142,141,141,93
"8782",81,"[25]svJHqaIifHckvHnJHGqKCCsnD",288,0.99654,25,289,1,288,1,1,0,1,1,152,151,137,137,93
"8783",82,"[25]svJHqaIifHckvHnJHGqKCCsnD",286,0.996516,25,287,1,286,1,1,0,1,1,148,147,139,139,93
"8784",83,"[25]svJHqaIifHckvHnJHGqKCCsnD",279,0.996429,25,280,1,279,1,1,0,1,1,137,136,143,143,93
"8785",84,"[25]svJHqaIifHckvHnJHGqKCCsnD",289,0.996552,25,290,1,289,1,1,0,1,1,139,138,151,151,93
"8786",85,"[25]svJHqaIifHckvHnJHGqKCCsnD",279,0.996429,25,280,1,279,1,1,0,1,1,138,137,142,142,93
"8787",86,"[25]svJHqaIifHckvHnJHGqKCCsnD",285,0.996503,25,286,1,285,1,1,0,1,1,142,141,144,144,93
"8788",87,"[25]svJHqaIifHckvHnJHGqKCCsnD",285,0.996503,25,286,1,285,1,1,0,1,1,143,142,143,143,93
"8789",88,"[25]svJHqaIifHckvHnJHGqKCCsnD",286,0.996516,25,287,1,286,1,1,0,1,1,145,144,142,142,93
"8790",89,"[25]svJHqaIifHckvHnJHGqKCCsnD",287,0.996528,25,288,1,287,1,1,0,1,1,146,145,142,142,93
"8791",90,"[25]svJHqaIifHckvHnJHGqKCCsnD",287,0.996528,25,288,1,287,1,1,0,1,1,161,160,127,127,93
"8792",91,"[25]svJHqaIifHckvHnJHGqKCCsnD",281,0.996454,25,282,1,281,1,1,0,1,1,153,152,129,129,93
"8793",92,"[25]svJHqaIifHckvHnJHGqKCCsnD",278,0.996416,25,279,1,278,1,1,0,1,1,156,155,123,123,93
"8794",93,"[25]svJHqaIifHckvHnJHGqKCCsnD",280,0.996441,25,281,1,280,1,1,0,1,1,141,140,140,140,93
"8795",94,"[25]svJHqaIifHckvHnJHGqKCCsnD",285,0.996503,25,286,1,285,1,1,0,1,1,140,139,146,146,93
"8796",95,"[25]svJHqaIifHckvHnJHGqKCCsnD",293,0.996599,25,294,1,293,1,1,0,1,1,159,158,135,135,93
"8797",96,"[25]svJHqaIifHckvHnJHGqKCCsnD",285,0.996503,25,286,1,285,1,1,0,1,1,153,152,133,133,93
"8798",97,"[25]svJHqaIifHckvHnJHGqKCCsnD",297,0.996644,25,298,1,297,1,1,0,1,1,166,165,132,132,93
"8799",98,"[25]svJHqaIifHckvHnJHGqKCCsnD",287,0.996528,25,288,1,287,1,1,0,1,1,151,150,137,137,93
"8800",99,"[25]svJHqaIifHckvHnJHGqKCCsnD",297,0.996644,25,298,1,297,1,1,0,1,1,158,157,140,140,93
"8801",0,"[23]joIoHcosHnJHGqKCsitzHCh",281,0.996454,23,282,1,281,1,1,0,1,1,140,139,142,142,94
"8802",1,"[23]joIoHcosHnJHGqKCsitzHCh",283,0.996479,23,284,1,283,1,1,0,1,1,159,158,125,125,94
"8803",2,"[23]joIoHcosHnJHGqKCsitzHCh",287,0.996528,23,288,1,287,1,1,0,1,1,147,146,141,141,94
"8804",3,"[23]joIoHcosHnJHGqKCsitzHCh",284,0.996491,23,285,1,284,1,1,0,1,1,139,138,146,146,94
"8805",4,"[23]joIoHcosHnJHGqKCsitzHCh",285,0.996503,23,286,1,285,1,1,0,1,1,151,150,135,135,94
"8806",5,"[23]joIoHcosHnJHGqKCsitzHCh",278,0.996416,23,279,1,278,1,1,0,1,1,143,142,136,136,94
"8807",6,"[23]joIoHcosHnJHGqKCsitzHCh",284,0.996491,23,285,1,284,1,1,0,1,1,145,144,140,140,94
"8808",7,"[23]joIoHcosHnJHGqKCsitzHCh",284,0.996491,23,285,1,284,1,1,0,1,1,148,147,137,137,94
"8809",8,"[23]joIoHcosHnJHGqKCsitzHCh",287,0.996528,23,288,1,287,1,1,0,1,1,163,162,125,125,94
"8810",9,"[23]joIoHcosHnJHGqKCsitzHCh",281,0.996454,23,282,1,281,1,1,0,1,1,141,140,141,141,94
"8811",10,"[23]joIoHcosHnJHGqKCsitzHCh",278,0.996416,23,279,1,278,1,1,0,1,1,134,133,145,145,94
"8812",11,"[23]joIoHcosHnJHGqKCsitzHCh",277,0.996403,23,278,1,277,1,1,0,1,1,125,124,153,153,94
"8813",12,"[23]joIoHcosHnJHGqKCsitzHCh",282,0.996466,23,283,1,282,1,1,0,1,1,136,135,147,147,94
"8814",13,"[23]joIoHcosHnJHGqKCsitzHCh",281,0.996454,23,282,1,281,1,1,0,1,1,135,134,147,147,94
"8815",14,"[23]joIoHcosHnJHGqKCsitzHCh",278,0.996416,23,279,1,278,1,1,0,1,1,150,149,129,129,94
"8816",15,"[23]joIoHcosHnJHGqKCsitzHCh",278,0.996416,23,279,1,278,1,1,0,1,1,136,135,143,143,94
"8817",16,"[23]joIoHcosHnJHGqKCsitzHCh",280,0.996441,23,281,1,280,1,1,0,1,1,139,138,142,142,94
"8818",17,"[23]joIoHcosHnJHGqKCsitzHCh",277,0.996403,23,278,1,277,1,1,0,1,1,135,134,143,143,94
"8819",18,"[23]joIoHcosHnJHGqKCsitzHCh",275,0.996377,23,276,1,275,1,1,0,1,1,146,145,130,130,94
"8820",19,"[23]joIoHcosHnJHGqKCsitzHCh",283,0.996479,23,284,1,283,1,1,0,1,1,149,148,135,135,94
"8821",20,"[23]joIoHcosHnJHGqKCsitzHCh",276,0.99639,23,277,1,276,1,1,0,1,1,134,133,143,143,94
"8822",21,"[23]joIoHcosHnJHGqKCsitzHCh",280,0.996441,23,281,1,280,1,1,0,1,1,142,141,139,139,94
"8823",22,"[23]joIoHcosHnJHGqKCsitzHCh",282,0.996466,23,283,1,282,1,1,0,1,1,146,145,137,137,94
"8824",23,"[23]joIoHcosHnJHGqKCsitzHCh",280,0.996441,23,281,1,280,1,1,0,1,1,138,137,143,143,94
"8825",24,"[23]joIoHcosHnJHGqKCsitzHCh",281,0.996454,23,282,1,281,1,1,0,1,1,149,148,133,133,94
"8826",25,"[23]joIoHcosHnJHGqKCsitzHCh",275,0.996377,23,276,1,275,1,1,0,1,1,145,144,131,131,94
"8827",26,"[23]joIoHcosHnJHGqKCsitzHCh",281,0.996454,23,282,1,281,1,1,0,1,1,144,143,138,138,94
"8828",27,"[23]joIoHcosHnJHGqKCsitzHCh",279,0.996429,23,280,1,279,1,1,0,1,1,141,140,139,139,94
"8829",28,"[23]joIoHcosHnJHGqKCsitzHCh",278,0.996416,23,279,1,278,1,1,0,1,1,132,131,147,147,94
"8830",29,"[23]joIoHcosHnJHGqKCsitzHCh",277,0.996403,23,278,1,277,1,1,0,1,1,138,137,140,140,94
"8831",30,"[23]joIoHcosHnJHGqKCsitzHCh",284,0.996491,23,285,1,284,1,1,0,1,1,150,149,135,135,94
"8832",31,"[23]joIoHcosHnJHGqKCsitzHCh",284,0.996491,23,285,1,284,1,1,0,1,1,131,130,154,154,94
"8833",32,"[23]joIoHcosHnJHGqKCsitzHCh",273,0.99635,23,274,1,273,1,1,0,1,1,137,136,137,137,94
"8834",33,"[23]joIoHcosHnJHGqKCsitzHCh",280,0.996441,23,281,1,280,1,1,0,1,1,138,137,143,143,94
"8835",34,"[23]joIoHcosHnJHGqKCsitzHCh",288,0.99654,23,289,1,288,1,1,0,1,1,151,150,138,138,94
"8836",35,"[23]joIoHcosHnJHGqKCsitzHCh",284,0.996491,23,285,1,284,1,1,0,1,1,148,147,137,137,94
"8837",36,"[23]joIoHcosHnJHGqKCsitzHCh",281,0.996454,23,282,1,281,1,1,0,1,1,130,129,152,152,94
"8838",37,"[23]joIoHcosHnJHGqKCsitzHCh",280,0.996441,23,281,1,280,1,1,0,1,1,142,141,139,139,94
"8839",38,"[23]joIoHcosHnJHGqKCsitzHCh",286,0.996516,23,287,1,286,1,1,0,1,1,152,151,135,135,94
"8840",39,"[23]joIoHcosHnJHGqKCsitzHCh",273,0.99635,23,274,1,273,1,1,0,1,1,129,128,145,145,94
"8841",40,"[23]joIoHcosHnJHGqKCsitzHCh",279,0.996429,23,280,1,279,1,1,0,1,1,135,134,145,145,94
"8842",41,"[23]joIoHcosHnJHGqKCsitzHCh",283,0.996479,23,284,1,283,1,1,0,1,1,151,150,133,133,94
"8843",42,"[23]joIoHcosHnJHGqKCsitzHCh",280,0.996441,23,281,1,280,1,1,0,1,1,135,134,146,146,94
"8844",43,"[23]joIoHcosHnJHGqKCsitzHCh",280,0.996441,23,281,1,280,1,1,0,1,1,139,138,142,142,94
"8845",44,"[23]joIoHcosHnJHGqKCsitzHCh",284,0.996491,23,285,1,284,1,1,0,1,1,149,148,136,136,94
"8846",45,"[23]joIoHcosHnJHGqKCsitzHCh",281,0.996454,23,282,1,281,1,1,0,1,1,132,131,150,150,94
"8847",46,"[23]joIoHcosHnJHGqKCsitzHCh",289,0.996552,23,290,1,289,1,1,0,1,1,167,166,123,123,94
"8848",47,"[23]joIoHcosHnJHGqKCsitzHCh",286,0.996516,23,287,1,286,1,1,0,1,1,145,144,142,142,94
"8849",48,"[23]joIoHcosHnJHGqKCsitzHCh",285,0.996503,23,286,1,285,1,1,0,1,1,135,134,151,151,94
"8850",49,"[23]joIoHcosHnJHGqKCsitzHCh",279,0.996429,23,280,1,279,1,1,0,1,1,145,144,135,135,94
"8851",50,"[23]joIoHcosHnJHGqKCsitzHCh",277,0.996403,23,278,1,277,1,1,0,1,1,134,133,144,144,94
"8852",51,"[23]joIoHcosHnJHGqKCsitzHCh",280,0.996441,23,281,1,280,1,1,0,1,1,138,137,143,143,94
"8853",52,"[23]joIoHcosHnJHGqKCsitzHCh",286,0.996516,23,287,1,286,1,1,0,1,1,139,138,148,148,94
"8854",53,"[23]joIoHcosHnJHGqKCsitzHCh",287,0.996528,23,288,1,287,1,1,0,1,1,154,153,134,134,94
"8855",54,"[23]joIoHcosHnJHGqKCsitzHCh",286,0.996516,23,287,1,286,1,1,0,1,1,143,142,144,144,94
"8856",55,"[23]joIoHcosHnJHGqKCsitzHCh",282,0.996466,23,283,1,282,1,1,0,1,1,132,131,151,151,94
"8857",56,"[23]joIoHcosHnJHGqKCsitzHCh",290,0.996564,23,291,1,290,1,1,0,1,1,158,157,133,133,94
"8858",57,"[23]joIoHcosHnJHGqKCsitzHCh",289,0.996552,23,290,1,289,1,1,0,1,1,157,156,133,133,94
"8859",58,"[23]joIoHcosHnJHGqKCsitzHCh",287,0.996528,23,288,1,287,1,1,0,1,1,156,155,132,132,94
"8860",59,"[23]joIoHcosHnJHGqKCsitzHCh",279,0.996429,23,280,1,279,1,1,0,1,1,140,139,140,140,94
"8861",60,"[23]joIoHcosHnJHGqKCsitzHCh",276,0.99639,23,277,1,276,1,1,0,1,1,158,157,119,119,94
"8862",61,"[23]joIoHcosHnJHGqKCsitzHCh",279,0.996429,23,280,1,279,1,1,0,1,1,149,148,131,131,94
"8863",62,"[23]joIoHcosHnJHGqKCsitzHCh",281,0.996454,23,282,1,281,1,1,0,1,1,143,142,139,139,94
"8864",63,"[23]joIoHcosHnJHGqKCsitzHCh",277,0.996403,23,278,1,277,1,1,0,1,1,150,149,128,128,94
"8865",64,"[23]joIoHcosHnJHGqKCsitzHCh",281,0.996454,23,282,1,281,1,1,0,1,1,138,137,144,144,94
"8866",65,"[23]joIoHcosHnJHGqKCsitzHCh",280,0.996441,23,281,1,280,1,1,0,1,1,135,134,146,146,94
"8867",66,"[23]joIoHcosHnJHGqKCsitzHCh",277,0.996403,23,278,1,277,1,1,0,1,1,134,133,144,144,94
"8868",67,"[23]joIoHcosHnJHGqKCsitzHCh",277,0.996403,23,278,1,277,1,1,0,1,1,128,127,150,150,94
"8869",68,"[23]joIoHcosHnJHGqKCsitzHCh",285,0.996503,23,286,1,285,1,1,0,1,1,151,150,135,135,94
"8870",69,"[23]joIoHcosHnJHGqKCsitzHCh",279,0.996429,23,280,1,279,1,1,0,1,1,132,131,148,148,94
"8871",70,"[23]joIoHcosHnJHGqKCsitzHCh",283,0.996479,23,284,1,283,1,1,0,1,1,143,142,141,141,94
"8872",71,"[23]joIoHcosHnJHGqKCsitzHCh",291,0.996575,23,292,1,291,1,1,0,1,1,154,153,138,138,94
"8873",72,"[23]joIoHcosHnJHGqKCsitzHCh",280,0.996441,23,281,1,280,1,1,0,1,1,160,159,121,121,94
"8874",73,"[23]joIoHcosHnJHGqKCsitzHCh",280,0.996441,23,281,1,280,1,1,0,1,1,130,129,151,151,94
"8875",74,"[23]joIoHcosHnJHGqKCsitzHCh",290,0.996564,23,291,1,290,1,1,0,1,1,146,145,145,145,94
"8876",75,"[23]joIoHcosHnJHGqKCsitzHCh",275,0.996377,23,276,1,275,1,1,0,1,1,152,151,124,124,94
"8877",76,"[23]joIoHcosHnJHGqKCsitzHCh",289,0.996552,23,290,1,289,1,1,0,1,1,145,144,145,145,94
"8878",77,"[23]joIoHcosHnJHGqKCsitzHCh",280,0.996441,23,281,1,280,1,1,0,1,1,144,143,137,137,94
"8879",78,"[23]joIoHcosHnJHGqKCsitzHCh",284,0.996491,23,285,1,284,1,1,0,1,1,151,150,134,134,94
"8880",79,"[23]joIoHcosHnJHGqKCsitzHCh",281,0.996454,23,282,1,281,1,1,0,1,1,131,130,151,151,94
"8881",80,"[23]joIoHcosHnJHGqKCsitzHCh",277,0.996403,23,278,1,277,1,1,0,1,1,144,143,134,134,94
"8882",81,"[23]joIoHcosHnJHGqKCsitzHCh",288,0.99654,23,289,1,288,1,1,0,1,1,143,142,146,146,94
"8883",82,"[23]joIoHcosHnJHGqKCsitzHCh",277,0.996403,23,278,1,277,1,1,0,1,1,122,121,156,156,94
"8884",83,"[23]joIoHcosHnJHGqKCsitzHCh",275,0.996377,23,276,1,275,1,1,0,1,1,140,139,136,136,94
"8885",84,"[23]joIoHcosHnJHGqKCsitzHCh",280,0.996441,23,281,1,280,1,1,0,1,1,139,138,142,142,94
"8886",85,"[23]joIoHcosHnJHGqKCsitzHCh",283,0.996479,23,284,1,283,1,1,0,1,1,137,136,147,147,94
"8887",86,"[23]joIoHcosHnJHGqKCsitzHCh",288,0.99654,23,289,1,288,1,1,0,1,1,157,156,132,132,94
"8888",87,"[23]joIoHcosHnJHGqKCsitzHCh",276,0.99639,23,277,1,276,1,1,0,1,1,122,121,155,155,94
"8889",88,"[23]joIoHcosHnJHGqKCsitzHCh",282,0.996466,23,283,1,282,1,1,0,1,1,136,135,147,147,94
"8890",89,"[23]joIoHcosHnJHGqKCsitzHCh",281,0.996454,23,282,1,281,1,1,0,1,1,153,152,129,129,94
"8891",90,"[23]joIoHcosHnJHGqKCsitzHCh",283,0.996479,23,284,1,283,1,1,0,1,1,146,145,138,138,94
"8892",91,"[23]joIoHcosHnJHGqKCsitzHCh",281,0.996454,23,282,1,281,1,1,0,1,1,124,123,158,158,94
"8893",92,"[23]joIoHcosHnJHGqKCsitzHCh",282,0.996466,23,283,1,282,1,1,0,1,1,156,155,127,127,94
"8894",93,"[23]joIoHcosHnJHGqKCsitzHCh",283,0.996479,23,284,1,283,1,1,0,1,1,155,154,129,129,94
"8895",94,"[23]joIoHcosHnJHGqKCsitzHCh",280,0.996441,23,281,1,280,1,1,0,1,1,154,153,127,127,94
"8896",95,"[23]joIoHcosHnJHGqKCsitzHCh",285,0.996503,23,286,1,285,1,1,0,1,1,136,135,150,150,94
"8897",96,"[23]joIoHcosHnJHGqKCsitzHCh",284,0.996491,23,285,1,284,1,1,0,1,1,148,147,137,137,94
"8898",97,"[23]joIoHcosHnJHGqKCsitzHCh",276,0.99639,23,277,1,276,1,1,0,1,1,133,132,144,144,94
"8899",98,"[23]joIoHcosHnJHGqKCsitzHCh",290,0.996564,23,291,1,290,1,1,0,1,1,153,152,138,138,94
"8900",99,"[23]joIoHcosHnJHGqKCsitzHCh",276,0.99639,23,277,1,276,1,1,0,1,1,141,140,136,136,94
"8901",0,"[29]bHoIoHcosHnJHGqKCjIDbqdwDcjox",281,0.996454,29,282,1,281,1,1,0,1,1,151,150,131,131,95
"8902",1,"[29]bHoIoHcosHnJHGqKCjIDbqdwDcjox",282,0.996466,29,283,1,282,1,1,0,1,1,138,137,145,145,95
"8903",2,"[29]bHoIoHcosHnJHGqKCjIDbqdwDcjox",284,0.996491,29,285,1,284,1,1,0,1,1,144,143,141,141,95
"8904",3,"[29]bHoIoHcosHnJHGqKCjIDbqdwDcjox",278,0.996416,29,279,1,278,1,1,0,1,1,158,157,121,121,95
"8905",4,"[29]bHoIoHcosHnJHGqKCjIDbqdwDcjox",271,0.996324,29,272,1,271,1,1,0,1,1,135,134,137,137,95
"8906",5,"[29]bHoIoHcosHnJHGqKCjIDbqdwDcjox",281,0.996454,29,282,1,281,1,1,0,1,1,149,148,133,133,95
"8907",6,"[29]bHoIoHcosHnJHGqKCjIDbqdwDcjox",283,0.996479,29,284,1,283,1,1,0,1,1,133,132,151,151,95
"8908",7,"[29]bHoIoHcosHnJHGqKCjIDbqdwDcjox",287,0.996528,29,288,1,287,1,1,0,1,1,142,141,146,146,95
"8909",8,"[29]bHoIoHcosHnJHGqKCjIDbqdwDcjox",279,0.996429,29,280,1,279,1,1,0,1,1,140,139,140,140,95
"8910",9,"[29]bHoIoHcosHnJHGqKCjIDbqdwDcjox",282,0.996466,29,283,1,282,1,1,0,1,1,141,140,142,142,95
"8911",10,"[29]bHoIoHcosHnJHGqKCjIDbqdwDcjox",282,0.996466,29,283,1,282,1,1,0,1,1,134,133,149,149,95
"8912",11,"[29]bHoIoHcosHnJHGqKCjIDbqdwDcjox",279,0.996429,29,280,1,279,1,1,0,1,1,138,137,142,142,95
"8913",12,"[29]bHoIoHcosHnJHGqKCjIDbqdwDcjox",278,0.996416,29,279,1,278,1,1,0,1,1,153,152,126,126,95
"8914",13,"[29]bHoIoHcosHnJHGqKCjIDbqdwDcjox",281,0.996454,29,282,1,281,1,1,0,1,1,133,132,149,149,95
"8915",14,"[29]bHoIoHcosHnJHGqKCjIDbqdwDcjox",291,0.996575,29,292,1,291,1,1,0,1,1,148,147,144,144,95
"8916",15,"[29]bHoIoHcosHnJHGqKCjIDbqdwDcjox",285,0.996503,29,286,1,285,1,1,0,1,1,145,144,141,141,95
"8917",16,"[29]bHoIoHcosHnJHGqKCjIDbqdwDcjox",278,0.996416,29,279,1,278,1,1,0,1,1,130,129,149,149,95
"8918",17,"[29]bHoIoHcosHnJHGqKCjIDbqdwDcjox",284,0.996491,29,285,1,284,1,1,0,1,1,136,135,149,149,95
"8919",18,"[29]bHoIoHcosHnJHGqKCjIDbqdwDcjox",282,0.996466,29,283,1,282,1,1,0,1,1,153,152,130,130,95
"8920",19,"[29]bHoIoHcosHnJHGqKCjIDbqdwDcjox",281,0.996454,29,282,1,281,1,1,0,1,1,137,136,145,145,95
"8921",20,"[29]bHoIoHcosHnJHGqKCjIDbqdwDcjox",283,0.996479,29,284,1,283,1,1,0,1,1,135,134,149,149,95
"8922",21,"[29]bHoIoHcosHnJHGqKCjIDbqdwDcjox",270,0.99631,29,271,1,270,1,1,0,1,1,144,143,127,127,95
"8923",22,"[29]bHoIoHcosHnJHGqKCjIDbqdwDcjox",291,0.996575,29,292,1,291,1,1,0,1,1,155,154,137,137,95
"8924",23,"[29]bHoIoHcosHnJHGqKCjIDbqdwDcjox",279,0.996429,29,280,1,279,1,1,0,1,1,136,135,144,144,95
"8925",24,"[29]bHoIoHcosHnJHGqKCjIDbqdwDcjox",281,0.996454,29,282,1,281,1,1,0,1,1,148,147,134,134,95
"8926",25,"[29]bHoIoHcosHnJHGqKCjIDbqdwDcjox",287,0.996528,29,288,1,287,1,1,0,1,1,147,146,141,141,95
"8927",26,"[29]bHoIoHcosHnJHGqKCjIDbqdwDcjox",285,0.996503,29,286,1,285,1,1,0,1,1,147,146,139,139,95
"8928",27,"[29]bHoIoHcosHnJHGqKCjIDbqdwDcjox",280,0.996441,29,281,1,280,1,1,0,1,1,130,129,151,151,95
"8929",28,"[29]bHoIoHcosHnJHGqKCjIDbqdwDcjox",283,0.996479,29,284,1,283,1,1,0,1,1,136,135,148,148,95
"8930",29,"[29]bHoIoHcosHnJHGqKCjIDbqdwDcjox",280,0.996441,29,281,1,280,1,1,0,1,1,146,145,135,135,95
"8931",30,"[29]bHoIoHcosHnJHGqKCjIDbqdwDcjox",268,0.996283,29,269,1,268,1,1,0,1,1,118,117,151,151,95
"8932",31,"[29]bHoIoHcosHnJHGqKCjIDbqdwDcjox",285,0.996503,29,286,1,285,1,1,0,1,1,147,146,139,139,95
"8933",32,"[29]bHoIoHcosHnJHGqKCjIDbqdwDcjox",285,0.996503,29,286,1,285,1,1,0,1,1,158,157,128,128,95
"8934",33,"[29]bHoIoHcosHnJHGqKCjIDbqdwDcjox",281,0.996454,29,282,1,281,1,1,0,1,1,139,138,143,143,95
"8935",34,"[29]bHoIoHcosHnJHGqKCjIDbqdwDcjox",284,0.996491,29,285,1,284,1,1,0,1,1,143,142,142,142,95
"8936",35,"[29]bHoIoHcosHnJHGqKCjIDbqdwDcjox",282,0.996466,29,283,1,282,1,1,0,1,1,135,134,148,148,95
"8937",36,"[29]bHoIoHcosHnJHGqKCjIDbqdwDcjox",283,0.996479,29,284,1,283,1,1,0,1,1,125,124,159,159,95
"8938",37,"[29]bHoIoHcosHnJHGqKCjIDbqdwDcjox",285,0.996503,29,286,1,285,1,1,0,1,1,152,151,134,134,95
"8939",38,"[29]bHoIoHcosHnJHGqKCjIDbqdwDcjox",282,0.996466,29,283,1,282,1,1,0,1,1,132,131,151,151,95
"8940",39,"[29]bHoIoHcosHnJHGqKCjIDbqdwDcjox",283,0.996479,29,284,1,283,1,1,0,1,1,143,142,141,141,95
"8941",40,"[29]bHoIoHcosHnJHGqKCjIDbqdwDcjox",278,0.996416,29,279,1,278,1,1,0,1,1,142,141,137,137,95
"8942",41,"[29]bHoIoHcosHnJHGqKCjIDbqdwDcjox",281,0.996454,29,282,1,281,1,1,0,1,1,133,132,149,149,95
"8943",42,"[29]bHoIoHcosHnJHGqKCjIDbqdwDcjox",270,0.99631,29,271,1,270,1,1,0,1,1,143,142,128,128,95
"8944",43,"[29]bHoIoHcosHnJHGqKCjIDbqdwDcjox",284,0.996491,29,285,1,284,1,1,0,1,1,140,139,145,145,95
"8945",44,"[29]bHoIoHcosHnJHGqKCjIDbqdwDcjox",289,0.996552,29,290,1,289,1,1,0,1,1,151,150,139,139,95
"8946",45,"[29]bHoIoHcosHnJHGqKCjIDbqdwDcjox",286,0.996516,29,287,1,286,1,1,0,1,1,148,147,139,139,95
"8947",46,"[29]bHoIoHcosHnJHGqKCjIDbqdwDcjox",286,0.996516,29,287,1,286,1,1,0,1,1,149,148,138,138,95
"8948",47,"[29]bHoIoHcosHnJHGqKCjIDbqdwDcjox",274,0.996364,29,275,1,274,1,1,0,1,1,125,124,150,150,95
"8949",48,"[29]bHoIoHcosHnJHGqKCjIDbqdwDcjox",278,0.996416,29,279,1,278,1,1,0,1,1,135,134,144,144,95
"8950",49,"[29]bHoIoHcosHnJHGqKCjIDbqdwDcjox",286,0.996516,29,287,1,286,1,1,0,1,1,161,160,126,126,95
"8951",50,"[29]bHoIoHcosHnJHGqKCjIDbqdwDcjox",277,0.996403,29,278,1,277,1,1,0,1,1,137,136,141,141,95
"8952",51,"[29]bHoIoHcosHnJHGqKCjIDbqdwDcjox",282,0.996466,29,283,1,282,1,1,0,1,1,143,142,140,140,95
"8953",52,"[29]bHoIoHcosHnJHGqKCjIDbqdwDcjox",284,0.996491,29,285,1,284,1,1,0,1,1,141,140,144,144,95
"8954",53,"[29]bHoIoHcosHnJHGqKCjIDbqdwDcjox",285,0.996503,29,286,1,285,1,1,0,1,1,143,142,143,143,95
"8955",54,"[29]bHoIoHcosHnJHGqKCjIDbqdwDcjox",280,0.996441,29,281,1,280,1,1,0,1,1,158,157,123,123,95
"8956",55,"[29]bHoIoHcosHnJHGqKCjIDbqdwDcjox",285,0.996503,29,286,1,285,1,1,0,1,1,139,138,147,147,95
"8957",56,"[29]bHoIoHcosHnJHGqKCjIDbqdwDcjox",282,0.996466,29,283,1,282,1,1,0,1,1,140,139,143,143,95
"8958",57,"[29]bHoIoHcosHnJHGqKCjIDbqdwDcjox",277,0.996403,29,278,1,277,1,1,0,1,1,143,142,135,135,95
"8959",58,"[29]bHoIoHcosHnJHGqKCjIDbqdwDcjox",285,0.996503,29,286,1,285,1,1,0,1,1,145,144,141,141,95
"8960",59,"[29]bHoIoHcosHnJHGqKCjIDbqdwDcjox",281,0.996454,29,282,1,281,1,1,0,1,1,137,136,145,145,95
"8961",60,"[29]bHoIoHcosHnJHGqKCjIDbqdwDcjox",278,0.996416,29,279,1,278,1,1,0,1,1,137,136,142,142,95
"8962",61,"[29]bHoIoHcosHnJHGqKCjIDbqdwDcjox",271,0.996324,29,272,1,271,1,1,0,1,1,138,137,134,134,95
"8963",62,"[29]bHoIoHcosHnJHGqKCjIDbqdwDcjox",280,0.996441,29,281,1,280,1,1,0,1,1,144,143,137,137,95
"8964",63,"[29]bHoIoHcosHnJHGqKCjIDbqdwDcjox",272,0.996337,29,273,1,272,1,1,0,1,1,132,131,141,141,95
"8965",64,"[29]bHoIoHcosHnJHGqKCjIDbqdwDcjox",276,0.99639,29,277,1,276,1,1,0,1,1,125,124,152,152,95
"8966",65,"[29]bHoIoHcosHnJHGqKCjIDbqdwDcjox",273,0.99635,29,274,1,273,1,1,0,1,1,138,137,136,136,95
"8967",66,"[29]bHoIoHcosHnJHGqKCjIDbqdwDcjox",287,0.996528,29,288,1,287,1,1,0,1,1,148,147,140,140,95
"8968",67,"[29]bHoIoHcosHnJHGqKCjIDbqdwDcjox",281,0.996454,29,282,1,281,1,1,0,1,1,134,133,148,148,95
"8969",68,"[29]bHoIoHcosHnJHGqKCjIDbqdwDcjox",277,0.996403,29,278,1,277,1,1,0,1,1,153,152,125,125,95
"8970",69,"[29]bHoIoHcosHnJHGqKCjIDbqdwDcjox",284,0.996491,29,285,1,284,1,1,0,1,1,141,140,144,144,95
"8971",70,"[29]bHoIoHcosHnJHGqKCjIDbqdwDcjox",283,0.996479,29,284,1,283,1,1,0,1,1,153,152,131,131,95
"8972",71,"[29]bHoIoHcosHnJHGqKCjIDbqdwDcjox",273,0.99635,29,274,1,273,1,1,0,1,1,144,143,130,130,95
"8973",72,"[29]bHoIoHcosHnJHGqKCjIDbqdwDcjox",282,0.996466,29,283,1,282,1,1,0,1,1,146,145,137,137,95
"8974",73,"[29]bHoIoHcosHnJHGqKCjIDbqdwDcjox",279,0.996429,29,280,1,279,1,1,0,1,1,131,130,149,149,95
"8975",74,"[29]bHoIoHcosHnJHGqKCjIDbqdwDcjox",279,0.996429,29,280,1,279,1,1,0,1,1,141,140,139,139,95
"8976",75,"[29]bHoIoHcosHnJHGqKCjIDbqdwDcjox",277,0.996403,29,278,1,277,1,1,0,1,1,147,146,131,131,95
"8977",76,"[29]bHoIoHcosHnJHGqKCjIDbqdwDcjox",271,0.996324,29,272,1,271,1,1,0,1,1,130,129,142,142,95
"8978",77,"[29]bHoIoHcosHnJHGqKCjIDbqdwDcjox",282,0.996466,29,283,1,282,1,1,0,1,1,147,146,136,136,95
"8979",78,"[29]bHoIoHcosHnJHGqKCjIDbqdwDcjox",287,0.996528,29,288,1,287,1,1,0,1,1,147,146,141,141,95
"8980",79,"[29]bHoIoHcosHnJHGqKCjIDbqdwDcjox",278,0.996416,29,279,1,278,1,1,0,1,1,134,133,145,145,95
"8981",80,"[29]bHoIoHcosHnJHGqKCjIDbqdwDcjox",282,0.996466,29,283,1,282,1,1,0,1,1,143,142,140,140,95
"8982",81,"[29]bHoIoHcosHnJHGqKCjIDbqdwDcjox",268,0.996283,29,269,1,268,1,1,0,1,1,129,128,140,140,95
"8983",82,"[29]bHoIoHcosHnJHGqKCjIDbqdwDcjox",284,0.996491,29,285,1,284,1,1,0,1,1,141,140,144,144,95
"8984",83,"[29]bHoIoHcosHnJHGqKCjIDbqdwDcjox",278,0.996416,29,279,1,278,1,1,0,1,1,147,146,132,132,95
"8985",84,"[29]bHoIoHcosHnJHGqKCjIDbqdwDcjox",279,0.996429,29,280,1,279,1,1,0,1,1,133,132,147,147,95
"8986",85,"[29]bHoIoHcosHnJHGqKCjIDbqdwDcjox",279,0.996429,29,280,1,279,1,1,0,1,1,131,130,149,149,95
"8987",86,"[29]bHoIoHcosHnJHGqKCjIDbqdwDcjox",281,0.996454,29,282,1,281,1,1,0,1,1,128,127,154,154,95
"8988",87,"[29]bHoIoHcosHnJHGqKCjIDbqdwDcjox",285,0.996503,29,286,1,285,1,1,0,1,1,142,141,144,144,95
"8989",88,"[29]bHoIoHcosHnJHGqKCjIDbqdwDcjox",284,0.996491,29,285,1,284,1,1,0,1,1,146,145,139,139,95
"8990",89,"[29]bHoIoHcosHnJHGqKCjIDbqdwDcjox",285,0.996503,29,286,1,285,1,1,0,1,1,140,139,146,146,95
"8991",90,"[29]bHoIoHcosHnJHGqKCjIDbqdwDcjox",278,0.996416,29,279,1,278,1,1,0,1,1,143,142,136,136,95
"8992",91,"[29]bHoIoHcosHnJHGqKCjIDbqdwDcjox",278,0.996416,29,279,1,278,1,1,0,1,1,133,132,146,146,95
"8993",92,"[29]bHoIoHcosHnJHGqKCjIDbqdwDcjox",285,0.996503,29,286,1,285,1,1,0,1,1,152,151,134,134,95
"8994",93,"[29]bHoIoHcosHnJHGqKCjIDbqdwDcjox",281,0.996454,29,282,1,281,1,1,0,1,1,150,149,132,132,95
"8995",94,"[29]bHoIoHcosHnJHGqKCjIDbqdwDcjox",281,0.996454,29,282,1,281,1,1,0,1,1,151,150,131,131,95
"8996",95,"[29]bHoIoHcosHnJHGqKCjIDbqdwDcjox",282,0.996466,29,283,1,282,1,1,0,1,1,138,137,145,145,95
"8997",96,"[29]bHoIoHcosHnJHGqKCjIDbqdwDcjox",279,0.996429,29,280,1,279,1,1,0,1,1,133,132,147,147,95
"8998",97,"[29]bHoIoHcosHnJHGqKCjIDbqdwDcjox",285,0.996503,29,286,1,285,1,1,0,1,1,144,143,142,142,95
"8999",98,"[29]bHoIoHcosHnJHGqKCjIDbqdwDcjox",289,0.996552,29,290,1,289,1,1,0,1,1,149,148,141,141,95
"9000",99,"[29]bHoIoHcosHnJHGqKCjIDbqdwDcjox",282,0.996466,29,283,1,282,1,1,0,1,1,151,150,132,132,95
"9001",0,"[22]BHoIoHcotHnJqGKCjEjdvd",296,0.996633,22,297,1,296,1,1,0,1,1,147,146,150,150,96
"9002",1,"[22]BHoIoHcotHnJqGKCjEjdvd",294,0.99661,22,295,1,294,1,1,0,1,1,141,140,154,154,96
"9003",2,"[22]BHoIoHcotHnJqGKCjEjdvd",301,0.996689,22,302,1,301,1,1,0,1,1,154,153,148,148,96
"9004",3,"[22]BHoIoHcotHnJqGKCjEjdvd",292,0.996587,22,293,1,292,1,1,0,1,1,143,142,150,150,96
"9005",4,"[22]BHoIoHcotHnJqGKCjEjdvd",297,0.996644,22,298,1,297,1,1,0,1,1,161,160,137,137,96
"9006",5,"[22]BHoIoHcotHnJqGKCjEjdvd",293,0.996599,22,294,1,293,1,1,0,1,1,138,137,156,156,96
"9007",6,"[22]BHoIoHcotHnJqGKCjEjdvd",288,0.99654,22,289,1,288,1,1,0,1,1,125,124,164,164,96
"9008",7,"[22]BHoIoHcotHnJqGKCjEjdvd",294,0.99661,22,295,1,294,1,1,0,1,1,141,140,154,154,96
"9009",8,"[22]BHoIoHcotHnJqGKCjEjdvd",301,0.996689,22,302,1,301,1,1,0,1,1,169,168,133,133,96
"9010",9,"[22]BHoIoHcotHnJqGKCjEjdvd",303,0.996711,22,304,1,303,1,1,0,1,1,169,168,135,135,96
"9011",10,"[22]BHoIoHcotHnJqGKCjEjdvd",299,0.996667,22,300,1,299,1,1,0,1,1,158,157,142,142,96
"9012",11,"[22]BHoIoHcotHnJqGKCjEjdvd",304,0.996721,22,305,1,304,1,1,0,1,1,175,174,130,130,96
"9013",12,"[22]BHoIoHcotHnJqGKCjEjdvd",297,0.996644,22,298,1,297,1,1,0,1,1,151,150,147,147,96
"9014",13,"[22]BHoIoHcotHnJqGKCjEjdvd",295,0.996622,22,296,1,295,1,1,0,1,1,142,141,154,154,96
"9015",14,"[22]BHoIoHcotHnJqGKCjEjdvd",299,0.996667,22,300,1,299,1,1,0,1,1,156,155,144,144,96
"9016",15,"[22]BHoIoHcotHnJqGKCjEjdvd",298,0.996656,22,299,1,298,1,1,0,1,1,163,162,136,136,96
"9017",16,"[22]BHoIoHcotHnJqGKCjEjdvd",306,0.996743,22,307,1,306,1,1,0,1,1,180,179,127,127,96
"9018",17,"[22]BHoIoHcotHnJqGKCjEjdvd",290,0.996564,22,291,1,290,1,1,0,1,1,131,130,160,160,96
"9019",18,"[22]BHoIoHcotHnJqGKCjEjdvd",299,0.996667,22,300,1,299,1,1,0,1,1,155,154,145,145,96
"9020",19,"[22]BHoIoHcotHnJqGKCjEjdvd",305,0.996732,22,306,1,305,1,1,0,1,1,173,172,133,133,96
"9021",20,"[22]BHoIoHcotHnJqGKCjEjdvd",289,0.996552,22,290,1,289,1,1,0,1,1,137,136,153,153,96
"9022",21,"[22]BHoIoHcotHnJqGKCjEjdvd",294,0.99661,22,295,1,294,1,1,0,1,1,147,146,148,148,96
"9023",22,"[22]BHoIoHcotHnJqGKCjEjdvd",292,0.996587,22,293,1,292,1,1,0,1,1,135,134,158,158,96
"9024",23,"[22]BHoIoHcotHnJqGKCjEjdvd",296,0.996633,22,297,1,296,1,1,0,1,1,147,146,150,150,96
"9025",24,"[22]BHoIoHcotHnJqGKCjEjdvd",297,0.996644,22,298,1,297,1,1,0,1,1,150,149,148,148,96
"9026",25,"[22]BHoIoHcotHnJqGKCjEjdvd",293,0.996599,22,294,1,293,1,1,0,1,1,141,140,153,153,96
"9027",26,"[22]BHoIoHcotHnJqGKCjEjdvd",302,0.9967,22,303,1,302,1,1,0,1,1,167,166,136,136,96
"9028",27,"[22]BHoIoHcotHnJqGKCjEjdvd",295,0.996622,22,296,1,295,1,1,0,1,1,147,146,149,149,96
"9029",28,"[22]BHoIoHcotHnJqGKCjEjdvd",298,0.996656,22,299,1,298,1,1,0,1,1,159,158,140,140,96
"9030",29,"[22]BHoIoHcotHnJqGKCjEjdvd",300,0.996678,22,301,1,300,1,1,0,1,1,162,161,139,139,96
"9031",30,"[22]BHoIoHcotHnJqGKCjEjdvd",298,0.996656,22,299,1,298,1,1,0,1,1,149,148,150,150,96
"9032",31,"[22]BHoIoHcotHnJqGKCjEjdvd",300,0.996678,22,301,1,300,1,1,0,1,1,150,149,151,151,96
"9033",32,"[22]BHoIoHcotHnJqGKCjEjdvd",305,0.996732,22,306,1,305,1,1,0,1,1,173,172,133,133,96
"9034",33,"[22]BHoIoHcotHnJqGKCjEjdvd",297,0.996644,22,298,1,297,1,1,0,1,1,152,151,146,146,96
"9035",34,"[22]BHoIoHcotHnJqGKCjEjdvd",297,0.996644,22,298,1,297,1,1,0,1,1,155,154,143,143,96
"9036",35,"[22]BHoIoHcotHnJqGKCjEjdvd",294,0.99661,22,295,1,294,1,1,0,1,1,142,141,153,153,96
"9037",36,"[22]BHoIoHcotHnJqGKCjEjdvd",301,0.996689,22,302,1,301,1,1,0,1,1,162,161,140,140,96
"9038",37,"[22]BHoIoHcotHnJqGKCjEjdvd",294,0.99661,22,295,1,294,1,1,0,1,1,144,143,151,151,96
"9039",38,"[22]BHoIoHcotHnJqGKCjEjdvd",303,0.996711,22,304,1,303,1,1,0,1,1,175,174,129,129,96
"9040",39,"[22]BHoIoHcotHnJqGKCjEjdvd",295,0.996622,22,296,1,295,1,1,0,1,1,151,150,145,145,96
"9041",40,"[22]BHoIoHcotHnJqGKCjEjdvd",297,0.996644,22,298,1,297,1,1,0,1,1,149,148,149,149,96
"9042",41,"[22]BHoIoHcotHnJqGKCjEjdvd",289,0.996552,22,290,1,289,1,1,0,1,1,134,133,156,156,96
"9043",42,"[22]BHoIoHcotHnJqGKCjEjdvd",297,0.996644,22,298,1,297,1,1,0,1,1,146,145,152,152,96
"9044",43,"[22]BHoIoHcotHnJqGKCjEjdvd",300,0.996678,22,301,1,300,1,1,0,1,1,160,159,141,141,96
"9045",44,"[22]BHoIoHcotHnJqGKCjEjdvd",292,0.996587,22,293,1,292,1,1,0,1,1,137,136,156,156,96
"9046",45,"[22]BHoIoHcotHnJqGKCjEjdvd",306,0.996743,22,307,1,306,1,1,0,1,1,176,175,131,131,96
"9047",46,"[22]BHoIoHcotHnJqGKCjEjdvd",294,0.99661,22,295,1,294,1,1,0,1,1,146,145,149,149,96
"9048",47,"[22]BHoIoHcotHnJqGKCjEjdvd",294,0.99661,22,295,1,294,1,1,0,1,1,142,141,153,153,96
"9049",48,"[22]BHoIoHcotHnJqGKCjEjdvd",305,0.996732,22,306,1,305,1,1,0,1,1,161,160,145,145,96
"9050",49,"[22]BHoIoHcotHnJqGKCjEjdvd",294,0.99661,22,295,1,294,1,1,0,1,1,143,142,152,152,96
"9051",50,"[22]BHoIoHcotHnJqGKCjEjdvd",309,0.996774,22,310,1,309,1,1,0,1,1,180,179,130,130,96
"9052",51,"[22]BHoIoHcotHnJqGKCjEjdvd",302,0.9967,22,303,1,302,1,1,0,1,1,163,162,140,140,96
"9053",52,"[22]BHoIoHcotHnJqGKCjEjdvd",293,0.996599,22,294,1,293,1,1,0,1,1,136,135,158,158,96
"9054",53,"[22]BHoIoHcotHnJqGKCjEjdvd",298,0.996656,22,299,1,298,1,1,0,1,1,155,154,144,144,96
"9055",54,"[22]BHoIoHcotHnJqGKCjEjdvd",297,0.996644,22,298,1,297,1,1,0,1,1,151,150,147,147,96
"9056",55,"[22]BHoIoHcotHnJqGKCjEjdvd",292,0.996587,22,293,1,292,1,1,0,1,1,150,149,143,143,96
"9057",56,"[22]BHoIoHcotHnJqGKCjEjdvd",301,0.996689,22,302,1,301,1,1,0,1,1,160,159,142,142,96
"9058",57,"[22]BHoIoHcotHnJqGKCjEjdvd",302,0.9967,22,303,1,302,1,1,0,1,1,161,160,142,142,96
"9059",58,"[22]BHoIoHcotHnJqGKCjEjdvd",296,0.996633,22,297,1,296,1,1,0,1,1,151,150,146,146,96
"9060",59,"[22]BHoIoHcotHnJqGKCjEjdvd",300,0.996678,22,301,1,300,1,1,0,1,1,160,159,141,141,96
"9061",60,"[22]BHoIoHcotHnJqGKCjEjdvd",293,0.996599,22,294,1,293,1,1,0,1,1,143,142,151,151,96
"9062",61,"[22]BHoIoHcotHnJqGKCjEjdvd",299,0.996667,22,300,1,299,1,1,0,1,1,155,154,145,145,96
"9063",62,"[22]BHoIoHcotHnJqGKCjEjdvd",296,0.996633,22,297,1,296,1,1,0,1,1,148,147,149,149,96
"9064",63,"[22]BHoIoHcotHnJqGKCjEjdvd",288,0.99654,22,289,1,288,1,1,0,1,1,128,127,161,161,96
"9065",64,"[22]BHoIoHcotHnJqGKCjEjdvd",297,0.996644,22,298,1,297,1,1,0,1,1,150,149,148,148,96
"9066",65,"[22]BHoIoHcotHnJqGKCjEjdvd",297,0.996644,22,298,1,297,1,1,0,1,1,150,149,148,148,96
"9067",66,"[22]BHoIoHcotHnJqGKCjEjdvd",295,0.996622,22,296,1,295,1,1,0,1,1,144,143,152,152,96
"9068",67,"[22]BHoIoHcotHnJqGKCjEjdvd",300,0.996678,22,301,1,300,1,1,0,1,1,156,155,145,145,96
"9069",68,"[22]BHoIoHcotHnJqGKCjEjdvd",288,0.99654,22,289,1,288,1,1,0,1,1,123,122,166,166,96
"9070",69,"[22]BHoIoHcotHnJqGKCjEjdvd",297,0.996644,22,298,1,297,1,1,0,1,1,156,155,142,142,96
"9071",70,"[22]BHoIoHcotHnJqGKCjEjdvd",297,0.996644,22,298,1,297,1,1,0,1,1,150,149,148,148,96
"9072",71,"[22]BHoIoHcotHnJqGKCjEjdvd",292,0.996587,22,293,1,292,1,1,0,1,1,145,144,148,148,96
"9073",72,"[22]BHoIoHcotHnJqGKCjEjdvd",306,0.996743,22,307,1,306,1,1,0,1,1,169,168,138,138,96
"9074",73,"[22]BHoIoHcotHnJqGKCjEjdvd",291,0.996575,22,292,1,291,1,1,0,1,1,139,138,153,153,96
"9075",74,"[22]BHoIoHcotHnJqGKCjEjdvd",300,0.996678,22,301,1,300,1,1,0,1,1,164,163,137,137,96
"9076",75,"[22]BHoIoHcotHnJqGKCjEjdvd",301,0.996689,22,302,1,301,1,1,0,1,1,166,165,136,136,96
"9077",76,"[22]BHoIoHcotHnJqGKCjEjdvd",301,0.996689,22,302,1,301,1,1,0,1,1,160,159,142,142,96
"9078",77,"[22]BHoIoHcotHnJqGKCjEjdvd",291,0.996575,22,292,1,291,1,1,0,1,1,139,138,153,153,96
"9079",78,"[22]BHoIoHcotHnJqGKCjEjdvd",305,0.996732,22,306,1,305,1,1,0,1,1,168,167,138,138,96
"9080",79,"[22]BHoIoHcotHnJqGKCjEjdvd",293,0.996599,22,294,1,293,1,1,0,1,1,145,144,149,149,96
"9081",80,"[22]BHoIoHcotHnJqGKCjEjdvd",292,0.996587,22,293,1,292,1,1,0,1,1,136,135,157,157,96
"9082",81,"[22]BHoIoHcotHnJqGKCjEjdvd",299,0.996667,22,300,1,299,1,1,0,1,1,155,154,145,145,96
"9083",82,"[22]BHoIoHcotHnJqGKCjEjdvd",291,0.996575,22,292,1,291,1,1,0,1,1,133,132,159,159,96
"9084",83,"[22]BHoIoHcotHnJqGKCjEjdvd",301,0.996689,22,302,1,301,1,1,0,1,1,168,167,134,134,96
"9085",84,"[22]BHoIoHcotHnJqGKCjEjdvd",293,0.996599,22,294,1,293,1,1,0,1,1,141,140,153,153,96
"9086",85,"[22]BHoIoHcotHnJqGKCjEjdvd",291,0.996575,22,292,1,291,1,1,0,1,1,133,132,159,159,96
"9087",86,"[22]BHoIoHcotHnJqGKCjEjdvd",292,0.996587,22,293,1,292,1,1,0,1,1,136,135,157,157,96
"9088",87,"[22]BHoIoHcotHnJqGKCjEjdvd",294,0.99661,22,295,1,294,1,1,0,1,1,140,139,155,155,96
"9089",88,"[22]BHoIoHcotHnJqGKCjEjdvd",302,0.9967,22,303,1,302,1,1,0,1,1,162,161,141,141,96
"9090",89,"[22]BHoIoHcotHnJqGKCjEjdvd",300,0.996678,22,301,1,300,1,1,0,1,1,160,159,141,141,96
"9091",90,"[22]BHoIoHcotHnJqGKCjEjdvd",297,0.996644,22,298,1,297,1,1,0,1,1,150,149,148,148,96
"9092",91,"[22]BHoIoHcotHnJqGKCjEjdvd",296,0.996633,22,297,1,296,1,1,0,1,1,152,151,145,145,96
"9093",92,"[22]BHoIoHcotHnJqGKCjEjdvd",293,0.996599,22,294,1,293,1,1,0,1,1,144,143,150,150,96
"9094",93,"[22]BHoIoHcotHnJqGKCjEjdvd",304,0.996721,22,305,1,304,1,1,0,1,1,170,169,135,135,96
"9095",94,"[22]BHoIoHcotHnJqGKCjEjdvd",299,0.996667,22,300,1,299,1,1,0,1,1,160,159,140,140,96
"9096",95,"[22]BHoIoHcotHnJqGKCjEjdvd",295,0.996622,22,296,1,295,1,1,0,1,1,148,147,148,148,96
"9097",96,"[22]BHoIoHcotHnJqGKCjEjdvd",297,0.996644,22,298,1,297,1,1,0,1,1,151,150,147,147,96
"9098",97,"[22]BHoIoHcotHnJqGKCjEjdvd",299,0.996667,22,300,1,299,1,1,0,1,1,160,159,140,140,96
"9099",98,"[22]BHoIoHcotHnJqGKCjEjdvd",293,0.996599,22,294,1,293,1,1,0,1,1,144,143,150,150,96
"9100",99,"[22]BHoIoHcotHnJqGKCjEjdvd",302,0.9967,22,303,1,302,1,1,0,1,1,163,162,140,140,96
"9101",0,"[28]edHoIptoHcosHnJHGqKCsxolIIzb",274,0.996364,28,275,1,274,1,1,0,1,1,139,138,136,136,97
"9102",1,"[28]edHoIptoHcosHnJHGqKCsxolIIzb",276,0.99639,28,277,1,276,1,1,0,1,1,145,144,132,132,97
"9103",2,"[28]edHoIptoHcosHnJHGqKCsxolIIzb",285,0.996503,28,286,1,285,1,1,0,1,1,149,148,137,137,97
"9104",3,"[28]edHoIptoHcosHnJHGqKCsxolIIzb",274,0.996364,28,275,1,274,1,1,0,1,1,138,137,137,137,97
"9105",4,"[28]edHoIptoHcosHnJHGqKCsxolIIzb",275,0.996377,28,276,1,275,1,1,0,1,1,150,149,126,126,97
"9106",5,"[28]edHoIptoHcosHnJHGqKCsxolIIzb",285,0.996503,28,286,1,285,1,1,0,1,1,138,137,148,148,97
"9107",6,"[28]edHoIptoHcosHnJHGqKCsxolIIzb",282,0.996466,28,283,1,282,1,1,0,1,1,145,144,138,138,97
"9108",7,"[28]edHoIptoHcosHnJHGqKCsxolIIzb",282,0.996466,28,283,1,282,1,1,0,1,1,144,143,139,139,97
"9109",8,"[28]edHoIptoHcosHnJHGqKCsxolIIzb",287,0.996528,28,288,1,287,1,1,0,1,1,150,149,138,138,97
"9110",9,"[28]edHoIptoHcosHnJHGqKCsxolIIzb",291,0.996575,28,292,1,291,1,1,0,1,1,157,156,135,135,97
"9111",10,"[28]edHoIptoHcosHnJHGqKCsxolIIzb",278,0.996416,28,279,1,278,1,1,0,1,1,133,132,146,146,97
"9112",11,"[28]edHoIptoHcosHnJHGqKCsxolIIzb",282,0.996466,28,283,1,282,1,1,0,1,1,150,149,133,133,97
"9113",12,"[28]edHoIptoHcosHnJHGqKCsxolIIzb",280,0.996441,28,281,1,280,1,1,0,1,1,143,142,138,138,97
"9114",13,"[28]edHoIptoHcosHnJHGqKCsxolIIzb",283,0.996479,28,284,1,283,1,1,0,1,1,157,156,127,127,97
"9115",14,"[28]edHoIptoHcosHnJHGqKCsxolIIzb",272,0.996337,28,273,1,272,1,1,0,1,1,128,127,145,145,97
"9116",15,"[28]edHoIptoHcosHnJHGqKCsxolIIzb",281,0.996454,28,282,1,281,1,1,0,1,1,133,132,149,149,97
"9117",16,"[28]edHoIptoHcosHnJHGqKCsxolIIzb",276,0.99639,28,277,1,276,1,1,0,1,1,127,126,150,150,97
"9118",17,"[28]edHoIptoHcosHnJHGqKCsxolIIzb",277,0.996403,28,278,1,277,1,1,0,1,1,137,136,141,141,97
"9119",18,"[28]edHoIptoHcosHnJHGqKCsxolIIzb",278,0.996416,28,279,1,278,1,1,0,1,1,138,137,141,141,97
"9120",19,"[28]edHoIptoHcosHnJHGqKCsxolIIzb",279,0.996429,28,280,1,279,1,1,0,1,1,135,134,145,145,97
"9121",20,"[28]edHoIptoHcosHnJHGqKCsxolIIzb",287,0.996528,28,288,1,287,1,1,0,1,1,147,146,141,141,97
"9122",21,"[28]edHoIptoHcosHnJHGqKCsxolIIzb",279,0.996429,28,280,1,279,1,1,0,1,1,141,140,139,139,97
"9123",22,"[28]edHoIptoHcosHnJHGqKCsxolIIzb",274,0.996364,28,275,1,274,1,1,0,1,1,128,127,147,147,97
"9124",23,"[28]edHoIptoHcosHnJHGqKCsxolIIzb",277,0.996403,28,278,1,277,1,1,0,1,1,132,131,146,146,97
"9125",24,"[28]edHoIptoHcosHnJHGqKCsxolIIzb",279,0.996429,28,280,1,279,1,1,0,1,1,158,157,122,122,97
"9126",25,"[28]edHoIptoHcosHnJHGqKCsxolIIzb",278,0.996416,28,279,1,278,1,1,0,1,1,136,135,143,143,97
"9127",26,"[28]edHoIptoHcosHnJHGqKCsxolIIzb",285,0.996503,28,286,1,285,1,1,0,1,1,150,149,136,136,97
"9128",27,"[28]edHoIptoHcosHnJHGqKCsxolIIzb",290,0.996564,28,291,1,290,1,1,0,1,1,138,137,153,153,97
"9129",28,"[28]edHoIptoHcosHnJHGqKCsxolIIzb",276,0.99639,28,277,1,276,1,1,0,1,1,140,139,137,137,97
"9130",29,"[28]edHoIptoHcosHnJHGqKCsxolIIzb",281,0.996454,28,282,1,281,1,1,0,1,1,134,133,148,148,97
"9131",30,"[28]edHoIptoHcosHnJHGqKCsxolIIzb",269,0.996296,28,270,1,269,1,1,0,1,1,128,127,142,142,97
"9132",31,"[28]edHoIptoHcosHnJHGqKCsxolIIzb",278,0.996416,28,279,1,278,1,1,0,1,1,147,146,132,132,97
"9133",32,"[28]edHoIptoHcosHnJHGqKCsxolIIzb",275,0.996377,28,276,1,275,1,1,0,1,1,154,153,122,122,97
"9134",33,"[28]edHoIptoHcosHnJHGqKCsxolIIzb",273,0.99635,28,274,1,273,1,1,0,1,1,135,134,139,139,97
"9135",34,"[28]edHoIptoHcosHnJHGqKCsxolIIzb",277,0.996403,28,278,1,277,1,1,0,1,1,135,134,143,143,97
"9136",35,"[28]edHoIptoHcosHnJHGqKCsxolIIzb",296,0.996633,28,297,1,296,1,1,0,1,1,169,168,128,128,97
"9137",36,"[28]edHoIptoHcosHnJHGqKCsxolIIzb",281,0.996454,28,282,1,281,1,1,0,1,1,131,130,151,151,97
"9138",37,"[28]edHoIptoHcosHnJHGqKCsxolIIzb",283,0.996479,28,284,1,283,1,1,0,1,1,142,141,142,142,97
"9139",38,"[28]edHoIptoHcosHnJHGqKCsxolIIzb",274,0.996364,28,275,1,274,1,1,0,1,1,141,140,134,134,97
"9140",39,"[28]edHoIptoHcosHnJHGqKCsxolIIzb",274,0.996364,28,275,1,274,1,1,0,1,1,137,136,138,138,97
"9141",40,"[28]edHoIptoHcosHnJHGqKCsxolIIzb",283,0.996479,28,284,1,283,1,1,0,1,1,127,126,157,157,97
"9142",41,"[28]edHoIptoHcosHnJHGqKCsxolIIzb",270,0.99631,28,271,1,270,1,1,0,1,1,135,134,136,136,97
"9143",42,"[28]edHoIptoHcosHnJHGqKCsxolIIzb",285,0.996503,28,286,1,285,1,1,0,1,1,146,145,140,140,97
"9144",43,"[28]edHoIptoHcosHnJHGqKCsxolIIzb",283,0.996479,28,284,1,283,1,1,0,1,1,138,137,146,146,97
"9145",44,"[28]edHoIptoHcosHnJHGqKCsxolIIzb",275,0.996377,28,276,1,275,1,1,0,1,1,138,137,138,138,97
"9146",45,"[28]edHoIptoHcosHnJHGqKCsxolIIzb",275,0.996377,28,276,1,275,1,1,0,1,1,158,157,118,118,97
"9147",46,"[28]edHoIptoHcosHnJHGqKCsxolIIzb",279,0.996429,28,280,1,279,1,1,0,1,1,135,134,145,145,97
"9148",47,"[28]edHoIptoHcosHnJHGqKCsxolIIzb",284,0.996491,28,285,1,284,1,1,0,1,1,149,148,136,136,97
"9149",48,"[28]edHoIptoHcosHnJHGqKCsxolIIzb",279,0.996429,28,280,1,279,1,1,0,1,1,141,140,139,139,97
"9150",49,"[28]edHoIptoHcosHnJHGqKCsxolIIzb",272,0.996337,28,273,1,272,1,1,0,1,1,140,139,133,133,97
"9151",50,"[28]edHoIptoHcosHnJHGqKCsxolIIzb",278,0.996416,28,279,1,278,1,1,0,1,1,136,135,143,143,97
"9152",51,"[28]edHoIptoHcosHnJHGqKCsxolIIzb",285,0.996503,28,286,1,285,1,1,0,1,1,155,154,131,131,97
"9153",52,"[28]edHoIptoHcosHnJHGqKCsxolIIzb",282,0.996466,28,283,1,282,1,1,0,1,1,141,140,142,142,97
"9154",53,"[28]edHoIptoHcosHnJHGqKCsxolIIzb",282,0.996466,28,283,1,282,1,1,0,1,1,148,147,135,135,97
"9155",54,"[28]edHoIptoHcosHnJHGqKCsxolIIzb",281,0.996454,28,282,1,281,1,1,0,1,1,148,147,134,134,97
"9156",55,"[28]edHoIptoHcosHnJHGqKCsxolIIzb",281,0.996454,28,282,1,281,1,1,0,1,1,134,133,148,148,97
"9157",56,"[28]edHoIptoHcosHnJHGqKCsxolIIzb",276,0.99639,28,277,1,276,1,1,0,1,1,135,134,142,142,97
"9158",57,"[28]edHoIptoHcosHnJHGqKCsxolIIzb",273,0.99635,28,274,1,273,1,1,0,1,1,136,135,138,138,97
"9159",58,"[28]edHoIptoHcosHnJHGqKCsxolIIzb",282,0.996466,28,283,1,282,1,1,0,1,1,142,141,141,141,97
"9160",59,"[28]edHoIptoHcosHnJHGqKCsxolIIzb",282,0.996466,28,283,1,282,1,1,0,1,1,153,152,130,130,97
"9161",60,"[28]edHoIptoHcosHnJHGqKCsxolIIzb",282,0.996466,28,283,1,282,1,1,0,1,1,158,157,125,125,97
"9162",61,"[28]edHoIptoHcosHnJHGqKCsxolIIzb",280,0.996441,28,281,1,280,1,1,0,1,1,140,139,141,141,97
"9163",62,"[28]edHoIptoHcosHnJHGqKCsxolIIzb",283,0.996479,28,284,1,283,1,1,0,1,1,128,127,156,156,97
"9164",63,"[28]edHoIptoHcosHnJHGqKCsxolIIzb",284,0.996491,28,285,1,284,1,1,0,1,1,147,146,138,138,97
"9165",64,"[28]edHoIptoHcosHnJHGqKCsxolIIzb",276,0.99639,28,277,1,276,1,1,0,1,1,140,139,137,137,97
"9166",65,"[28]edHoIptoHcosHnJHGqKCsxolIIzb",286,0.996516,28,287,1,286,1,1,0,1,1,140,139,147,147,97
"9167",66,"[28]edHoIptoHcosHnJHGqKCsxolIIzb",275,0.996377,28,276,1,275,1,1,0,1,1,130,129,146,146,97
"9168",67,"[28]edHoIptoHcosHnJHGqKCsxolIIzb",286,0.996516,28,287,1,286,1,1,0,1,1,158,157,129,129,97
"9169",68,"[28]edHoIptoHcosHnJHGqKCsxolIIzb",277,0.996403,28,278,1,277,1,1,0,1,1,138,137,140,140,97
"9170",69,"[28]edHoIptoHcosHnJHGqKCsxolIIzb",279,0.996429,28,280,1,279,1,1,0,1,1,136,135,144,144,97
"9171",70,"[28]edHoIptoHcosHnJHGqKCsxolIIzb",272,0.996337,28,273,1,272,1,1,0,1,1,129,128,144,144,97
"9172",71,"[28]edHoIptoHcosHnJHGqKCsxolIIzb",272,0.996337,28,273,1,272,1,1,0,1,1,131,130,142,142,97
"9173",72,"[28]edHoIptoHcosHnJHGqKCsxolIIzb",280,0.996441,28,281,1,280,1,1,0,1,1,121,120,160,160,97
"9174",73,"[28]edHoIptoHcosHnJHGqKCsxolIIzb",284,0.996491,28,285,1,284,1,1,0,1,1,156,155,129,129,97
"9175",74,"[28]edHoIptoHcosHnJHGqKCsxolIIzb",280,0.996441,28,281,1,280,1,1,0,1,1,142,141,139,139,97
"9176",75,"[28]edHoIptoHcosHnJHGqKCsxolIIzb",278,0.996416,28,279,1,278,1,1,0,1,1,165,164,114,114,97
"9177",76,"[28]edHoIptoHcosHnJHGqKCsxolIIzb",282,0.996466,28,283,1,282,1,1,0,1,1,141,140,142,142,97
"9178",77,"[28]edHoIptoHcosHnJHGqKCsxolIIzb",283,0.996479,28,284,1,283,1,1,0,1,1,142,141,142,142,97
"9179",78,"[28]edHoIptoHcosHnJHGqKCsxolIIzb",285,0.996503,28,286,1,285,1,1,0,1,1,136,135,150,150,97
"9180",79,"[28]edHoIptoHcosHnJHGqKCsxolIIzb",278,0.996416,28,279,1,278,1,1,0,1,1,145,144,134,134,97
"9181",80,"[28]edHoIptoHcosHnJHGqKCsxolIIzb",284,0.996491,28,285,1,284,1,1,0,1,1,164,163,121,121,97
"9182",81,"[28]edHoIptoHcosHnJHGqKCsxolIIzb",284,0.996491,28,285,1,284,1,1,0,1,1,140,139,145,145,97
"9183",82,"[28]edHoIptoHcosHnJHGqKCsxolIIzb",277,0.996403,28,278,1,277,1,1,0,1,1,144,143,134,134,97
"9184",83,"[28]edHoIptoHcosHnJHGqKCsxolIIzb",274,0.996364,28,275,1,274,1,1,0,1,1,134,133,141,141,97
"9185",84,"[28]edHoIptoHcosHnJHGqKCsxolIIzb",282,0.996466,28,283,1,282,1,1,0,1,1,132,131,151,151,97
"9186",85,"[28]edHoIptoHcosHnJHGqKCsxolIIzb",276,0.99639,28,277,1,276,1,1,0,1,1,145,144,132,132,97
"9187",86,"[28]edHoIptoHcosHnJHGqKCsxolIIzb",282,0.996466,28,283,1,282,1,1,0,1,1,139,138,144,144,97
"9188",87,"[28]edHoIptoHcosHnJHGqKCsxolIIzb",274,0.996364,28,275,1,274,1,1,0,1,1,132,131,143,143,97
"9189",88,"[28]edHoIptoHcosHnJHGqKCsxolIIzb",281,0.996454,28,282,1,281,1,1,0,1,1,151,150,131,131,97
"9190",89,"[28]edHoIptoHcosHnJHGqKCsxolIIzb",285,0.996503,28,286,1,285,1,1,0,1,1,143,142,143,143,97
"9191",90,"[28]edHoIptoHcosHnJHGqKCsxolIIzb",278,0.996416,28,279,1,278,1,1,0,1,1,139,138,140,140,97
"9192",91,"[28]edHoIptoHcosHnJHGqKCsxolIIzb",271,0.996324,28,272,1,271,1,1,0,1,1,123,122,149,149,97
"9193",92,"[28]edHoIptoHcosHnJHGqKCsxolIIzb",281,0.996454,28,282,1,281,1,1,0,1,1,134,133,148,148,97
"9194",93,"[28]edHoIptoHcosHnJHGqKCsxolIIzb",279,0.996429,28,280,1,279,1,1,0,1,1,152,151,128,128,97
"9195",94,"[28]edHoIptoHcosHnJHGqKCsxolIIzb",280,0.996441,28,281,1,280,1,1,0,1,1,143,142,138,138,97
"9196",95,"[28]edHoIptoHcosHnJHGqKCsxolIIzb",278,0.996416,28,279,1,278,1,1,0,1,1,124,123,155,155,97
"9197",96,"[28]edHoIptoHcosHnJHGqKCsxolIIzb",277,0.996403,28,278,1,277,1,1,0,1,1,147,146,131,131,97
"9198",97,"[28]edHoIptoHcosHnJHGqKCsxolIIzb",279,0.996429,28,280,1,279,1,1,0,1,1,145,144,135,135,97
"9199",98,"[28]edHoIptoHcosHnJHGqKCsxolIIzb",282,0.996466,28,283,1,282,1,1,0,1,1,141,140,142,142,97
"9200",99,"[28]edHoIptoHcosHnJHGqKCsxolIIzb",284,0.996491,28,285,1,284,1,1,0,1,1,134,133,151,151,97
"9201",0,"[26]xhJHoIqakBHBvHnJqGKCnjceit",297,0.996644,26,298,1,297,1,1,0,1,1,150,149,148,148,98
"9202",1,"[26]xhJHoIqakBHBvHnJqGKCnjceit",298,0.996656,26,299,1,298,1,1,0,1,1,147,146,152,152,98
"9203",2,"[26]xhJHoIqakBHBvHnJqGKCnjceit",293,0.996599,26,294,1,293,1,1,0,1,1,139,138,155,155,98
"9204",3,"[26]xhJHoIqakBHBvHnJqGKCnjceit",299,0.996667,26,300,1,299,1,1,0,1,1,156,155,144,144,98
"9205",4,"[26]xhJHoIqakBHBvHnJqGKCnjceit",303,0.996711,26,304,1,303,1,1,0,1,1,166,165,138,138,98
"9206",5,"[26]xhJHoIqakBHBvHnJqGKCnjceit",300,0.996678,26,301,1,300,1,1,0,1,1,156,155,145,145,98
"9207",6,"[26]xhJHoIqakBHBvHnJqGKCnjceit",304,0.996721,26,305,1,304,1,1,0,1,1,167,166,138,138,98
"9208",7,"[26]xhJHoIqakBHBvHnJqGKCnjceit",297,0.996644,26,298,1,297,1,1,0,1,1,151,150,147,147,98
"9209",8,"[26]xhJHoIqakBHBvHnJqGKCnjceit",295,0.996622,26,296,1,295,1,1,0,1,1,142,141,154,154,98
"9210",9,"[26]xhJHoIqakBHBvHnJqGKCnjceit",300,0.996678,26,301,1,300,1,1,0,1,1,156,155,145,145,98
"9211",10,"[26]xhJHoIqakBHBvHnJqGKCnjceit",296,0.996633,26,297,1,296,1,1,0,1,1,141,140,156,156,98
"9212",11,"[26]xhJHoIqakBHBvHnJqGKCnjceit",296,0.996633,26,297,1,296,1,1,0,1,1,147,146,150,150,98
"9213",12,"[26]xhJHoIqakBHBvHnJqGKCnjceit",300,0.996678,26,301,1,300,1,1,0,1,1,159,158,142,142,98
"9214",13,"[26]xhJHoIqakBHBvHnJqGKCnjceit",303,0.996711,26,304,1,303,1,1,0,1,1,166,165,138,138,98
"9215",14,"[26]xhJHoIqakBHBvHnJqGKCnjceit",302,0.9967,26,303,1,302,1,1,0,1,1,165,164,138,138,98
"9216",15,"[26]xhJHoIqakBHBvHnJqGKCnjceit",299,0.996667,26,300,1,299,1,1,0,1,1,151,150,149,149,98
"9217",16,"[26]xhJHoIqakBHBvHnJqGKCnjceit",299,0.996667,26,300,1,299,1,1,0,1,1,155,154,145,145,98
"9218",17,"[26]xhJHoIqakBHBvHnJqGKCnjceit",299,0.996667,26,300,1,299,1,1,0,1,1,150,149,150,150,98
"9219",18,"[26]xhJHoIqakBHBvHnJqGKCnjceit",290,0.996564,26,291,1,290,1,1,0,1,1,129,128,162,162,98
"9220",19,"[26]xhJHoIqakBHBvHnJqGKCnjceit",300,0.996678,26,301,1,300,1,1,0,1,1,157,156,144,144,98
"9221",20,"[26]xhJHoIqakBHBvHnJqGKCnjceit",311,0.996795,26,312,1,311,1,1,0,1,1,167,166,145,145,98
"9222",21,"[26]xhJHoIqakBHBvHnJqGKCnjceit",300,0.996678,26,301,1,300,1,1,0,1,1,157,156,144,144,98
"9223",22,"[26]xhJHoIqakBHBvHnJqGKCnjceit",296,0.996633,26,297,1,296,1,1,0,1,1,141,140,156,156,98
"9224",23,"[26]xhJHoIqakBHBvHnJqGKCnjceit",296,0.996633,26,297,1,296,1,1,0,1,1,145,144,152,152,98
"9225",24,"[26]xhJHoIqakBHBvHnJqGKCnjceit",296,0.996633,26,297,1,296,1,1,0,1,1,146,145,151,151,98
"9226",25,"[26]xhJHoIqakBHBvHnJqGKCnjceit",299,0.996667,26,300,1,299,1,1,0,1,1,154,153,146,146,98
"9227",26,"[26]xhJHoIqakBHBvHnJqGKCnjceit",302,0.9967,26,303,1,302,1,1,0,1,1,158,157,145,145,98
"9228",27,"[26]xhJHoIqakBHBvHnJqGKCnjceit",298,0.996656,26,299,1,298,1,1,0,1,1,151,150,148,148,98
"9229",28,"[26]xhJHoIqakBHBvHnJqGKCnjceit",304,0.996721,26,305,1,304,1,1,0,1,1,166,165,139,139,98
"9230",29,"[26]xhJHoIqakBHBvHnJqGKCnjceit",302,0.9967,26,303,1,302,1,1,0,1,1,164,163,139,139,98
"9231",30,"[26]xhJHoIqakBHBvHnJqGKCnjceit",306,0.996743,26,307,1,306,1,1,0,1,1,167,166,140,140,98
"9232",31,"[26]xhJHoIqakBHBvHnJqGKCnjceit",299,0.996667,26,300,1,299,1,1,0,1,1,154,153,146,146,98
"9233",32,"[26]xhJHoIqakBHBvHnJqGKCnjceit",296,0.996633,26,297,1,296,1,1,0,1,1,145,144,152,152,98
"9234",33,"[26]xhJHoIqakBHBvHnJqGKCnjceit",297,0.996644,26,298,1,297,1,1,0,1,1,149,148,149,149,98
"9235",34,"[26]xhJHoIqakBHBvHnJqGKCnjceit",313,0.996815,26,314,1,313,1,1,0,1,1,181,180,133,133,98
"9236",35,"[26]xhJHoIqakBHBvHnJqGKCnjceit",301,0.996689,26,302,1,301,1,1,0,1,1,160,159,142,142,98
"9237",36,"[26]xhJHoIqakBHBvHnJqGKCnjceit",302,0.9967,26,303,1,302,1,1,0,1,1,164,163,139,139,98
"9238",37,"[26]xhJHoIqakBHBvHnJqGKCnjceit",295,0.996622,26,296,1,295,1,1,0,1,1,143,142,153,153,98
"9239",38,"[26]xhJHoIqakBHBvHnJqGKCnjceit",301,0.996689,26,302,1,301,1,1,0,1,1,160,159,142,142,98
"9240",39,"[26]xhJHoIqakBHBvHnJqGKCnjceit",297,0.996644,26,298,1,297,1,1,0,1,1,140,139,158,158,98
"9241",40,"[26]xhJHoIqakBHBvHnJqGKCnjceit",292,0.996587,26,293,1,292,1,1,0,1,1,134,133,159,159,98
"9242",41,"[26]xhJHoIqakBHBvHnJqGKCnjceit",300,0.996678,26,301,1,300,1,1,0,1,1,157,156,144,144,98
"9243",42,"[26]xhJHoIqakBHBvHnJqGKCnjceit",296,0.996633,26,297,1,296,1,1,0,1,1,145,144,152,152,98
"9244",43,"[26]xhJHoIqakBHBvHnJqGKCnjceit",297,0.996644,26,298,1,297,1,1,0,1,1,146,145,152,152,98
"9245",44,"[26]xhJHoIqakBHBvHnJqGKCnjceit",299,0.996667,26,300,1,299,1,1,0,1,1,155,154,145,145,98
"9246",45,"[26]xhJHoIqakBHBvHnJqGKCnjceit",301,0.996689,26,302,1,301,1,1,0,1,1,162,161,140,140,98
"9247",46,"[26]xhJHoIqakBHBvHnJqGKCnjceit",299,0.996667,26,300,1,299,1,1,0,1,1,153,152,147,147,98
"9248",47,"[26]xhJHoIqakBHBvHnJqGKCnjceit",297,0.996644,26,298,1,297,1,1,0,1,1,148,147,150,150,98
"9249",48,"[26]xhJHoIqakBHBvHnJqGKCnjceit",295,0.996622,26,296,1,295,1,1,0,1,1,143,142,153,153,98
"9250",49,"[26]xhJHoIqakBHBvHnJqGKCnjceit",295,0.996622,26,296,1,295,1,1,0,1,1,144,143,152,152,98
"9251",50,"[26]xhJHoIqakBHBvHnJqGKCnjceit",299,0.996667,26,300,1,299,1,1,0,1,1,154,153,146,146,98
"9252",51,"[26]xhJHoIqakBHBvHnJqGKCnjceit",307,0.996753,26,308,1,307,1,1,0,1,1,172,171,136,136,98
"9253",52,"[26]xhJHoIqakBHBvHnJqGKCnjceit",310,0.996785,26,311,1,310,1,1,0,1,1,187,186,124,124,98
"9254",53,"[26]xhJHoIqakBHBvHnJqGKCnjceit",300,0.996678,26,301,1,300,1,1,0,1,1,160,159,141,141,98
"9255",54,"[26]xhJHoIqakBHBvHnJqGKCnjceit",292,0.996587,26,293,1,292,1,1,0,1,1,135,134,158,158,98
"9256",55,"[26]xhJHoIqakBHBvHnJqGKCnjceit",295,0.996622,26,296,1,295,1,1,0,1,1,143,142,153,153,98
"9257",56,"[26]xhJHoIqakBHBvHnJqGKCnjceit",295,0.996622,26,296,1,295,1,1,0,1,1,142,141,154,154,98
"9258",57,"[26]xhJHoIqakBHBvHnJqGKCnjceit",299,0.996667,26,300,1,299,1,1,0,1,1,157,156,143,143,98
"9259",58,"[26]xhJHoIqakBHBvHnJqGKCnjceit",303,0.996711,26,304,1,303,1,1,0,1,1,167,166,137,137,98
"9260",59,"[26]xhJHoIqakBHBvHnJqGKCnjceit",304,0.996721,26,305,1,304,1,1,0,1,1,169,168,136,136,98
"9261",60,"[26]xhJHoIqakBHBvHnJqGKCnjceit",306,0.996743,26,307,1,306,1,1,0,1,1,176,175,131,131,98
"9262",61,"[26]xhJHoIqakBHBvHnJqGKCnjceit",294,0.99661,26,295,1,294,1,1,0,1,1,141,140,154,154,98
"9263",62,"[26]xhJHoIqakBHBvHnJqGKCnjceit",299,0.996667,26,300,1,299,1,1,0,1,1,157,156,143,143,98
"9264",63,"[26]xhJHoIqakBHBvHnJqGKCnjceit",297,0.996644,26,298,1,297,1,1,0,1,1,149,148,149,149,98
"9265",64,"[26]xhJHoIqakBHBvHnJqGKCnjceit",294,0.99661,26,295,1,294,1,1,0,1,1,140,139,155,155,98
"9266",65,"[26]xhJHoIqakBHBvHnJqGKCnjceit",295,0.996622,26,296,1,295,1,1,0,1,1,144,143,152,152,98
"9267",66,"[26]xhJHoIqakBHBvHnJqGKCnjceit",302,0.9967,26,303,1,302,1,1,0,1,1,162,161,141,141,98
"9268",67,"[26]xhJHoIqakBHBvHnJqGKCnjceit",305,0.996732,26,306,1,305,1,1,0,1,1,173,172,133,133,98
"9269",68,"[26]xhJHoIqakBHBvHnJqGKCnjceit",301,0.996689,26,302,1,301,1,1,0,1,1,156,155,146,146,98
"9270",69,"[26]xhJHoIqakBHBvHnJqGKCnjceit",295,0.996622,26,296,1,295,1,1,0,1,1,143,142,153,153,98
"9271",70,"[26]xhJHoIqakBHBvHnJqGKCnjceit",297,0.996644,26,298,1,297,1,1,0,1,1,150,149,148,148,98
"9272",71,"[26]xhJHoIqakBHBvHnJqGKCnjceit",296,0.996633,26,297,1,296,1,1,0,1,1,145,144,152,152,98
"9273",72,"[26]xhJHoIqakBHBvHnJqGKCnjceit",296,0.996633,26,297,1,296,1,1,0,1,1,142,141,155,155,98
"9274",73,"[26]xhJHoIqakBHBvHnJqGKCnjceit",302,0.9967,26,303,1,302,1,1,0,1,1,163,162,140,140,98
"9275",74,"[26]xhJHoIqakBHBvHnJqGKCnjceit",291,0.996575,26,292,1,291,1,1,0,1,1,130,129,162,162,98
"9276",75,"[26]xhJHoIqakBHBvHnJqGKCnjceit",293,0.996599,26,294,1,293,1,1,0,1,1,137,136,157,157,98
"9277",76,"[26]xhJHoIqakBHBvHnJqGKCnjceit",299,0.996667,26,300,1,299,1,1,0,1,1,151,150,149,149,98
"9278",77,"[26]xhJHoIqakBHBvHnJqGKCnjceit",296,0.996633,26,297,1,296,1,1,0,1,1,146,145,151,151,98
"9279",78,"[26]xhJHoIqakBHBvHnJqGKCnjceit",293,0.996599,26,294,1,293,1,1,0,1,1,137,136,157,157,98
"9280",79,"[26]xhJHoIqakBHBvHnJqGKCnjceit",297,0.996644,26,298,1,297,1,1,0,1,1,150,149,148,148,98
"9281",80,"[26]xhJHoIqakBHBvHnJqGKCnjceit",299,0.996667,26,300,1,299,1,1,0,1,1,156,155,144,144,98
"9282",81,"[26]xhJHoIqakBHBvHnJqGKCnjceit",298,0.996656,26,299,1,298,1,1,0,1,1,149,148,150,150,98
"9283",82,"[26]xhJHoIqakBHBvHnJqGKCnjceit",295,0.996622,26,296,1,295,1,1,0,1,1,141,140,155,155,98
"9284",83,"[26]xhJHoIqakBHBvHnJqGKCnjceit",294,0.99661,26,295,1,294,1,1,0,1,1,139,138,156,156,98
"9285",84,"[26]xhJHoIqakBHBvHnJqGKCnjceit",301,0.996689,26,302,1,301,1,1,0,1,1,163,162,139,139,98
"9286",85,"[26]xhJHoIqakBHBvHnJqGKCnjceit",300,0.996678,26,301,1,300,1,1,0,1,1,158,157,143,143,98
"9287",86,"[26]xhJHoIqakBHBvHnJqGKCnjceit",297,0.996644,26,298,1,297,1,1,0,1,1,148,147,150,150,98
"9288",87,"[26]xhJHoIqakBHBvHnJqGKCnjceit",298,0.996656,26,299,1,298,1,1,0,1,1,153,152,146,146,98
"9289",88,"[26]xhJHoIqakBHBvHnJqGKCnjceit",299,0.996667,26,300,1,299,1,1,0,1,1,154,153,146,146,98
"9290",89,"[26]xhJHoIqakBHBvHnJqGKCnjceit",298,0.996656,26,299,1,298,1,1,0,1,1,152,151,147,147,98
"9291",90,"[26]xhJHoIqakBHBvHnJqGKCnjceit",298,0.996656,26,299,1,298,1,1,0,1,1,149,148,150,150,98
"9292",91,"[26]xhJHoIqakBHBvHnJqGKCnjceit",300,0.996678,26,301,1,300,1,1,0,1,1,154,153,147,147,98
"9293",92,"[26]xhJHoIqakBHBvHnJqGKCnjceit",292,0.996587,26,293,1,292,1,1,0,1,1,136,135,157,157,98
"9294",93,"[26]xhJHoIqakBHBvHnJqGKCnjceit",295,0.996622,26,296,1,295,1,1,0,1,1,143,142,153,153,98
"9295",94,"[26]xhJHoIqakBHBvHnJqGKCnjceit",300,0.996678,26,301,1,300,1,1,0,1,1,150,149,151,151,98
"9296",95,"[26]xhJHoIqakBHBvHnJqGKCnjceit",294,0.99661,26,295,1,294,1,1,0,1,1,140,139,155,155,98
"9297",96,"[26]xhJHoIqakBHBvHnJqGKCnjceit",291,0.996575,26,292,1,291,1,1,0,1,1,130,129,162,162,98
"9298",97,"[26]xhJHoIqakBHBvHnJqGKCnjceit",297,0.996644,26,298,1,297,1,1,0,1,1,147,146,151,151,98
"9299",98,"[26]xhJHoIqakBHBvHnJqGKCnjceit",297,0.996644,26,298,1,297,1,1,0,1,1,149,148,149,149,98
"9300",99,"[26]xhJHoIqakBHBvHnJqGKCnjceit",303,0.996711,26,304,1,303,1,1,0,1,1,164,163,140,140,98
"9301",0,"[24]HoIoHcovHnJHGqKCzuouaBfz",273,0.99635,24,274,1,273,1,1,0,1,1,123,122,151,151,99
"9302",1,"[24]HoIoHcovHnJHGqKCzuouaBfz",283,0.996479,24,284,1,283,1,1,0,1,1,137,136,147,147,99
"9303",2,"[24]HoIoHcovHnJHGqKCzuouaBfz",277,0.996403,24,278,1,277,1,1,0,1,1,130,129,148,148,99
"9304",3,"[24]HoIoHcovHnJHGqKCzuouaBfz",291,0.996575,24,292,1,291,1,1,0,1,1,158,157,134,134,99
"9305",4,"[24]HoIoHcovHnJHGqKCzuouaBfz",285,0.996503,24,286,1,285,1,1,0,1,1,145,144,141,141,99
"9306",5,"[24]HoIoHcovHnJHGqKCzuouaBfz",284,0.996491,24,285,1,284,1,1,0,1,1,140,139,145,145,99
"9307",6,"[24]HoIoHcovHnJHGqKCzuouaBfz",278,0.996416,24,279,1,278,1,1,0,1,1,161,160,118,118,99
"9308",7,"[24]HoIoHcovHnJHGqKCzuouaBfz",284,0.996491,24,285,1,284,1,1,0,1,1,150,149,135,135,99
"9309",8,"[24]HoIoHcovHnJHGqKCzuouaBfz",284,0.996491,24,285,1,284,1,1,0,1,1,152,151,133,133,99
"9310",9,"[24]HoIoHcovHnJHGqKCzuouaBfz",285,0.996503,24,286,1,285,1,1,0,1,1,161,160,125,125,99
"9311",10,"[24]HoIoHcovHnJHGqKCzuouaBfz",280,0.996441,24,281,1,280,1,1,0,1,1,147,146,134,134,99
"9312",11,"[24]HoIoHcovHnJHGqKCzuouaBfz",278,0.996416,24,279,1,278,1,1,0,1,1,138,137,141,141,99
"9313",12,"[24]HoIoHcovHnJHGqKCzuouaBfz",269,0.996296,24,270,1,269,1,1,0,1,1,126,125,144,144,99
"9314",13,"[24]HoIoHcovHnJHGqKCzuouaBfz",278,0.996416,24,279,1,278,1,1,0,1,1,148,147,131,131,99
"9315",14,"[24]HoIoHcovHnJHGqKCzuouaBfz",290,0.996564,24,291,1,290,1,1,0,1,1,153,152,138,138,99
"9316",15,"[24]HoIoHcovHnJHGqKCzuouaBfz",284,0.996491,24,285,1,284,1,1,0,1,1,132,131,153,153,99
"9317",16,"[24]HoIoHcovHnJHGqKCzuouaBfz",283,0.996479,24,284,1,283,1,1,0,1,1,140,139,144,144,99
"9318",17,"[24]HoIoHcovHnJHGqKCzuouaBfz",282,0.996466,24,283,1,282,1,1,0,1,1,138,137,145,145,99
"9319",18,"[24]HoIoHcovHnJHGqKCzuouaBfz",280,0.996441,24,281,1,280,1,1,0,1,1,143,142,138,138,99
"9320",19,"[24]HoIoHcovHnJHGqKCzuouaBfz",282,0.996466,24,283,1,282,1,1,0,1,1,136,135,147,147,99
"9321",20,"[24]HoIoHcovHnJHGqKCzuouaBfz",285,0.996503,24,286,1,285,1,1,0,1,1,137,136,149,149,99
"9322",21,"[24]HoIoHcovHnJHGqKCzuouaBfz",281,0.996454,24,282,1,281,1,1,0,1,1,140,139,142,142,99
"9323",22,"[24]HoIoHcovHnJHGqKCzuouaBfz",279,0.996429,24,280,1,279,1,1,0,1,1,135,134,145,145,99
"9324",23,"[24]HoIoHcovHnJHGqKCzuouaBfz",280,0.996441,24,281,1,280,1,1,0,1,1,157,156,124,124,99
"9325",24,"[24]HoIoHcovHnJHGqKCzuouaBfz",280,0.996441,24,281,1,280,1,1,0,1,1,148,147,133,133,99
"9326",25,"[24]HoIoHcovHnJHGqKCzuouaBfz",281,0.996454,24,282,1,281,1,1,0,1,1,143,142,139,139,99
"9327",26,"[24]HoIoHcovHnJHGqKCzuouaBfz",283,0.996479,24,284,1,283,1,1,0,1,1,147,146,137,137,99
"9328",27,"[24]HoIoHcovHnJHGqKCzuouaBfz",277,0.996403,24,278,1,277,1,1,0,1,1,145,144,133,133,99
"9329",28,"[24]HoIoHcovHnJHGqKCzuouaBfz",283,0.996479,24,284,1,283,1,1,0,1,1,137,136,147,147,99
"9330",29,"[24]HoIoHcovHnJHGqKCzuouaBfz",281,0.996454,24,282,1,281,1,1,0,1,1,149,148,133,133,99
"9331",30,"[24]HoIoHcovHnJHGqKCzuouaBfz",287,0.996528,24,288,1,287,1,1,0,1,1,145,144,143,143,99
"9332",31,"[24]HoIoHcovHnJHGqKCzuouaBfz",280,0.996441,24,281,1,280,1,1,0,1,1,139,138,142,142,99
"9333",32,"[24]HoIoHcovHnJHGqKCzuouaBfz",284,0.996491,24,285,1,284,1,1,0,1,1,150,149,135,135,99
"9334",33,"[24]HoIoHcovHnJHGqKCzuouaBfz",293,0.996599,24,294,1,293,1,1,0,1,1,148,147,146,146,99
"9335",34,"[24]HoIoHcovHnJHGqKCzuouaBfz",283,0.996479,24,284,1,283,1,1,0,1,1,143,142,141,141,99
"9336",35,"[24]HoIoHcovHnJHGqKCzuouaBfz",276,0.99639,24,277,1,276,1,1,0,1,1,142,141,135,135,99
"9337",36,"[24]HoIoHcovHnJHGqKCzuouaBfz",284,0.996491,24,285,1,284,1,1,0,1,1,159,158,126,126,99
"9338",37,"[24]HoIoHcovHnJHGqKCzuouaBfz",270,0.99631,24,271,1,270,1,1,0,1,1,125,124,146,146,99
"9339",38,"[24]HoIoHcovHnJHGqKCzuouaBfz",282,0.996466,24,283,1,282,1,1,0,1,1,141,140,142,142,99
"9340",39,"[24]HoIoHcovHnJHGqKCzuouaBfz",291,0.996575,24,292,1,291,1,1,0,1,1,153,152,139,139,99
"9341",40,"[24]HoIoHcovHnJHGqKCzuouaBfz",283,0.996479,24,284,1,283,1,1,0,1,1,141,140,143,143,99
"9342",41,"[24]HoIoHcovHnJHGqKCzuouaBfz",282,0.996466,24,283,1,282,1,1,0,1,1,139,138,144,144,99
"9343",42,"[24]HoIoHcovHnJHGqKCzuouaBfz",284,0.996491,24,285,1,284,1,1,0,1,1,137,136,148,148,99
"9344",43,"[24]HoIoHcovHnJHGqKCzuouaBfz",278,0.996416,24,279,1,278,1,1,0,1,1,132,131,147,147,99
"9345",44,"[24]HoIoHcovHnJHGqKCzuouaBfz",283,0.996479,24,284,1,283,1,1,0,1,1,144,143,140,140,99
"9346",45,"[24]HoIoHcovHnJHGqKCzuouaBfz",284,0.996491,24,285,1,284,1,1,0,1,1,140,139,145,145,99
"9347",46,"[24]HoIoHcovHnJHGqKCzuouaBfz",281,0.996454,24,282,1,281,1,1,0,1,1,153,152,129,129,99
"9348",47,"[24]HoIoHcovHnJHGqKCzuouaBfz",281,0.996454,24,282,1,281,1,1,0,1,1,141,140,141,141,99
"9349",48,"[24]HoIoHcovHnJHGqKCzuouaBfz",277,0.996403,24,278,1,277,1,1,0,1,1,140,139,138,138,99
"9350",49,"[24]HoIoHcovHnJHGqKCzuouaBfz",282,0.996466,24,283,1,282,1,1,0,1,1,144,143,139,139,99
"9351",50,"[24]HoIoHcovHnJHGqKCzuouaBfz",285,0.996503,24,286,1,285,1,1,0,1,1,168,167,118,118,99
"9352",51,"[24]HoIoHcovHnJHGqKCzuouaBfz",275,0.996377,24,276,1,275,1,1,0,1,1,138,137,138,138,99
"9353",52,"[24]HoIoHcovHnJHGqKCzuouaBfz",279,0.996429,24,280,1,279,1,1,0,1,1,142,141,138,138,99
"9354",53,"[24]HoIoHcovHnJHGqKCzuouaBfz",284,0.996491,24,285,1,284,1,1,0,1,1,145,144,140,140,99
"9355",54,"[24]HoIoHcovHnJHGqKCzuouaBfz",293,0.996599,24,294,1,293,1,1,0,1,1,151,150,143,143,99
"9356",55,"[24]HoIoHcovHnJHGqKCzuouaBfz",281,0.996454,24,282,1,281,1,1,0,1,1,151,150,131,131,99
"9357",56,"[24]HoIoHcovHnJHGqKCzuouaBfz",280,0.996441,24,281,1,280,1,1,0,1,1,137,136,144,144,99
"9358",57,"[24]HoIoHcovHnJHGqKCzuouaBfz",282,0.996466,24,283,1,282,1,1,0,1,1,150,149,133,133,99
"9359",58,"[24]HoIoHcovHnJHGqKCzuouaBfz",280,0.996441,24,281,1,280,1,1,0,1,1,132,131,149,149,99
"9360",59,"[24]HoIoHcovHnJHGqKCzuouaBfz",284,0.996491,24,285,1,284,1,1,0,1,1,151,150,134,134,99
"9361",60,"[24]HoIoHcovHnJHGqKCzuouaBfz",285,0.996503,24,286,1,285,1,1,0,1,1,149,148,137,137,99
"9362",61,"[24]HoIoHcovHnJHGqKCzuouaBfz",274,0.996364,24,275,1,274,1,1,0,1,1,125,124,150,150,99
"9363",62,"[24]HoIoHcovHnJHGqKCzuouaBfz",279,0.996429,24,280,1,279,1,1,0,1,1,143,142,137,137,99
"9364",63,"[24]HoIoHcovHnJHGqKCzuouaBfz",288,0.99654,24,289,1,288,1,1,0,1,1,153,152,136,136,99
"9365",64,"[24]HoIoHcovHnJHGqKCzuouaBfz",276,0.99639,24,277,1,276,1,1,0,1,1,133,132,144,144,99
"9366",65,"[24]HoIoHcovHnJHGqKCzuouaBfz",283,0.996479,24,284,1,283,1,1,0,1,1,147,146,137,137,99
"9367",66,"[24]HoIoHcovHnJHGqKCzuouaBfz",277,0.996403,24,278,1,277,1,1,0,1,1,134,133,144,144,99
"9368",67,"[24]HoIoHcovHnJHGqKCzuouaBfz",284,0.996491,24,285,1,284,1,1,0,1,1,132,131,153,153,99
"9369",68,"[24]HoIoHcovHnJHGqKCzuouaBfz",278,0.996416,24,279,1,278,1,1,0,1,1,124,123,155,155,99
"9370",69,"[24]HoIoHcovHnJHGqKCzuouaBfz",282,0.996466,24,283,1,282,1,1,0,1,1,138,137,145,145,99
"9371",70,"[24]HoIoHcovHnJHGqKCzuouaBfz",277,0.996403,24,278,1,277,1,1,0,1,1,135,134,143,143,99
"9372",71,"[24]HoIoHcovHnJHGqKCzuouaBfz",281,0.996454,24,282,1,281,1,1,0,1,1,140,139,142,142,99
"9373",72,"[24]HoIoHcovHnJHGqKCzuouaBfz",272,0.996337,24,273,1,272,1,1,0,1,1,121,120,152,152,99
"9374",73,"[24]HoIoHcovHnJHGqKCzuouaBfz",284,0.996491,24,285,1,284,1,1,0,1,1,144,143,141,141,99
"9375",74,"[24]HoIoHcovHnJHGqKCzuouaBfz",283,0.996479,24,284,1,283,1,1,0,1,1,148,147,136,136,99
"9376",75,"[24]HoIoHcovHnJHGqKCzuouaBfz",288,0.99654,24,289,1,288,1,1,0,1,1,151,150,138,138,99
"9377",76,"[24]HoIoHcovHnJHGqKCzuouaBfz",283,0.996479,24,284,1,283,1,1,0,1,1,154,153,130,130,99
"9378",77,"[24]HoIoHcovHnJHGqKCzuouaBfz",279,0.996429,24,280,1,279,1,1,0,1,1,128,127,152,152,99
"9379",78,"[24]HoIoHcovHnJHGqKCzuouaBfz",281,0.996454,24,282,1,281,1,1,0,1,1,135,134,147,147,99
"9380",79,"[24]HoIoHcovHnJHGqKCzuouaBfz",276,0.99639,24,277,1,276,1,1,0,1,1,141,140,136,136,99
"9381",80,"[24]HoIoHcovHnJHGqKCzuouaBfz",276,0.99639,24,277,1,276,1,1,0,1,1,137,136,140,140,99
"9382",81,"[24]HoIoHcovHnJHGqKCzuouaBfz",276,0.99639,24,277,1,276,1,1,0,1,1,146,145,131,131,99
"9383",82,"[24]HoIoHcovHnJHGqKCzuouaBfz",274,0.996364,24,275,1,274,1,1,0,1,1,136,135,139,139,99
"9384",83,"[24]HoIoHcovHnJHGqKCzuouaBfz",277,0.996403,24,278,1,277,1,1,0,1,1,136,135,142,142,99
"9385",84,"[24]HoIoHcovHnJHGqKCzuouaBfz",289,0.996552,24,290,1,289,1,1,0,1,1,153,152,137,137,99
"9386",85,"[24]HoIoHcovHnJHGqKCzuouaBfz",274,0.996364,24,275,1,274,1,1,0,1,1,141,140,134,134,99
"9387",86,"[24]HoIoHcovHnJHGqKCzuouaBfz",284,0.996491,24,285,1,284,1,1,0,1,1,144,143,141,141,99
"9388",87,"[24]HoIoHcovHnJHGqKCzuouaBfz",281,0.996454,24,282,1,281,1,1,0,1,1,140,139,142,142,99
"9389",88,"[24]HoIoHcovHnJHGqKCzuouaBfz",285,0.996503,24,286,1,285,1,1,0,1,1,143,142,143,143,99
"9390",89,"[24]HoIoHcovHnJHGqKCzuouaBfz",281,0.996454,24,282,1,281,1,1,0,1,1,137,136,145,145,99
"9391",90,"[24]HoIoHcovHnJHGqKCzuouaBfz",279,0.996429,24,280,1,279,1,1,0,1,1,143,142,137,137,99
"9392",91,"[24]HoIoHcovHnJHGqKCzuouaBfz",275,0.996377,24,276,1,275,1,1,0,1,1,135,134,141,141,99
"9393",92,"[24]HoIoHcovHnJHGqKCzuouaBfz",279,0.996429,24,280,1,279,1,1,0,1,1,141,140,139,139,99
"9394",93,"[24]HoIoHcovHnJHGqKCzuouaBfz",275,0.996377,24,276,1,275,1,1,0,1,1,121,120,155,155,99
"9395",94,"[24]HoIoHcovHnJHGqKCzuouaBfz",283,0.996479,24,284,1,283,1,1,0,1,1,139,138,145,145,99
"9396",95,"[24]HoIoHcovHnJHGqKCzuouaBfz",278,0.996416,24,279,1,278,1,1,0,1,1,146,145,133,133,99
"9397",96,"[24]HoIoHcovHnJHGqKCzuouaBfz",290,0.996564,24,291,1,290,1,1,0,1,1,162,161,129,129,99
"9398",97,"[24]HoIoHcovHnJHGqKCzuouaBfz",274,0.996364,24,275,1,274,1,1,0,1,1,137,136,138,138,99
"9399",98,"[24]HoIoHcovHnJHGqKCzuouaBfz",279,0.996429,24,280,1,279,1,1,0,1,1,145,144,135,135,99
"9400",99,"[24]HoIoHcovHnJHGqKCzuouaBfz",274,0.996364,24,275,1,274,1,1,0,1,1,129,128,146,146,99
"9401",0,"[19]goIoHcouHnJHGqKClCh",288,0.99654,19,289,1,288,1,1,0,1,1,146,145,143,143,100
"9402",1,"[19]goIoHcouHnJHGqKClCh",282,0.996466,19,283,1,282,1,1,0,1,1,153,152,130,130,100
"9403",2,"[19]goIoHcouHnJHGqKClCh",291,0.996575,19,292,1,291,1,1,0,1,1,148,147,144,144,100
"9404",3,"[19]goIoHcouHnJHGqKClCh",284,0.996491,19,285,1,284,1,1,0,1,1,145,144,140,140,100
"9405",4,"[19]goIoHcouHnJHGqKClCh",284,0.996491,19,285,1,284,1,1,0,1,1,154,153,131,131,100
"9406",5,"[19]goIoHcouHnJHGqKClCh",286,0.996516,19,287,1,286,1,1,0,1,1,161,160,126,126,100
"9407",6,"[19]goIoHcouHnJHGqKClCh",284,0.996491,19,285,1,284,1,1,0,1,1,145,144,140,140,100
"9408",7,"[19]goIoHcouHnJHGqKClCh",280,0.996441,19,281,1,280,1,1,0,1,1,141,140,140,140,100
"9409",8,"[19]goIoHcouHnJHGqKClCh",283,0.996479,19,284,1,283,1,1,0,1,1,144,143,140,140,100
"9410",9,"[19]goIoHcouHnJHGqKClCh",278,0.996416,19,279,1,278,1,1,0,1,1,140,139,139,139,100
"9411",10,"[19]goIoHcouHnJHGqKClCh",287,0.996528,19,288,1,287,1,1,0,1,1,149,148,139,139,100
"9412",11,"[19]goIoHcouHnJHGqKClCh",275,0.996377,19,276,1,275,1,1,0,1,1,141,140,135,135,100
"9413",12,"[19]goIoHcouHnJHGqKClCh",280,0.996441,19,281,1,280,1,1,0,1,1,152,151,129,129,100
"9414",13,"[19]goIoHcouHnJHGqKClCh",278,0.996416,19,279,1,278,1,1,0,1,1,132,131,147,147,100
"9415",14,"[19]goIoHcouHnJHGqKClCh",280,0.996441,19,281,1,280,1,1,0,1,1,150,149,131,131,100
"9416",15,"[19]goIoHcouHnJHGqKClCh",287,0.996528,19,288,1,287,1,1,0,1,1,159,158,129,129,100
"9417",16,"[19]goIoHcouHnJHGqKClCh",287,0.996528,19,288,1,287,1,1,0,1,1,165,164,123,123,100
"9418",17,"[19]goIoHcouHnJHGqKClCh",283,0.996479,19,284,1,283,1,1,0,1,1,137,136,147,147,100
"9419",18,"[19]goIoHcouHnJHGqKClCh",278,0.996416,19,279,1,278,1,1,0,1,1,150,149,129,129,100
"9420",19,"[19]goIoHcouHnJHGqKClCh",276,0.99639,19,277,1,276,1,1,0,1,1,123,122,154,154,100
"9421",20,"[19]goIoHcouHnJHGqKClCh",286,0.996516,19,287,1,286,1,1,0,1,1,147,146,140,140,100
"9422",21,"[19]goIoHcouHnJHGqKClCh",288,0.99654,19,289,1,288,1,1,0,1,1,161,160,128,128,100
"9423",22,"[19]goIoHcouHnJHGqKClCh",285,0.996503,19,286,1,285,1,1,0,1,1,146,145,140,140,100
"9424",23,"[19]goIoHcouHnJHGqKClCh",286,0.996516,19,287,1,286,1,1,0,1,1,163,162,124,124,100
"9425",24,"[19]goIoHcouHnJHGqKClCh",285,0.996503,19,286,1,285,1,1,0,1,1,142,141,144,144,100
"9426",25,"[19]goIoHcouHnJHGqKClCh",280,0.996441,19,281,1,280,1,1,0,1,1,146,145,135,135,100
"9427",26,"[19]goIoHcouHnJHGqKClCh",274,0.996364,19,275,1,274,1,1,0,1,1,137,136,138,138,100
"9428",27,"[19]goIoHcouHnJHGqKClCh",290,0.996564,19,291,1,290,1,1,0,1,1,146,145,145,145,100
"9429",28,"[19]goIoHcouHnJHGqKClCh",282,0.996466,19,283,1,282,1,1,0,1,1,131,130,152,152,100
"9430",29,"[19]goIoHcouHnJHGqKClCh",274,0.996364,19,275,1,274,1,1,0,1,1,134,133,141,141,100
"9431",30,"[19]goIoHcouHnJHGqKClCh",285,0.996503,19,286,1,285,1,1,0,1,1,150,149,136,136,100
"9432",31,"[19]goIoHcouHnJHGqKClCh",282,0.996466,19,283,1,282,1,1,0,1,1,146,145,137,137,100
"9433",32,"[19]goIoHcouHnJHGqKClCh",283,0.996479,19,284,1,283,1,1,0,1,1,156,155,128,128,100
"9434",33,"[19]goIoHcouHnJHGqKClCh",275,0.996377,19,276,1,275,1,1,0,1,1,127,126,149,149,100
"9435",34,"[19]goIoHcouHnJHGqKClCh",282,0.996466,19,283,1,282,1,1,0,1,1,133,132,150,150,100
"9436",35,"[19]goIoHcouHnJHGqKClCh",272,0.996337,19,273,1,272,1,1,0,1,1,128,127,145,145,100
"9437",36,"[19]goIoHcouHnJHGqKClCh",280,0.996441,19,281,1,280,1,1,0,1,1,147,146,134,134,100
"9438",37,"[19]goIoHcouHnJHGqKClCh",281,0.996454,19,282,1,281,1,1,0,1,1,133,132,149,149,100
"9439",38,"[19]goIoHcouHnJHGqKClCh",283,0.996479,19,284,1,283,1,1,0,1,1,157,156,127,127,100
"9440",39,"[19]goIoHcouHnJHGqKClCh",278,0.996416,19,279,1,278,1,1,0,1,1,129,128,150,150,100
"9441",40,"[19]goIoHcouHnJHGqKClCh",286,0.996516,19,287,1,286,1,1,0,1,1,150,149,137,137,100
"9442",41,"[19]goIoHcouHnJHGqKClCh",286,0.996516,19,287,1,286,1,1,0,1,1,146,145,141,141,100
"9443",42,"[19]goIoHcouHnJHGqKClCh",284,0.996491,19,285,1,284,1,1,0,1,1,145,144,140,140,100
"9444",43,"[19]goIoHcouHnJHGqKClCh",286,0.996516,19,287,1,286,1,1,0,1,1,172,171,115,115,100
"9445",44,"[19]goIoHcouHnJHGqKClCh",284,0.996491,19,285,1,284,1,1,0,1,1,158,157,127,127,100
"9446",45,"[19]goIoHcouHnJHGqKClCh",281,0.996454,19,282,1,281,1,1,0,1,1,130,129,152,152,100
"9447",46,"[19]goIoHcouHnJHGqKClCh",279,0.996429,19,280,1,279,1,1,0,1,1,143,142,137,137,100
"9448",47,"[19]goIoHcouHnJHGqKClCh",284,0.996491,19,285,1,284,1,1,0,1,1,154,153,131,131,100
"9449",48,"[19]goIoHcouHnJHGqKClCh",286,0.996516,19,287,1,286,1,1,0,1,1,142,141,145,145,100
"9450",49,"[19]goIoHcouHnJHGqKClCh",282,0.996466,19,283,1,282,1,1,0,1,1,153,152,130,130,100
"9451",50,"[19]goIoHcouHnJHGqKClCh",281,0.996454,19,282,1,281,1,1,0,1,1,154,153,128,128,100
"9452",51,"[19]goIoHcouHnJHGqKClCh",275,0.996377,19,276,1,275,1,1,0,1,1,130,129,146,146,100
"9453",52,"[19]goIoHcouHnJHGqKClCh",284,0.996491,19,285,1,284,1,1,0,1,1,160,159,125,125,100
"9454",53,"[19]goIoHcouHnJHGqKClCh",284,0.996491,19,285,1,284,1,1,0,1,1,150,149,135,135,100
"9455",54,"[19]goIoHcouHnJHGqKClCh",286,0.996516,19,287,1,286,1,1,0,1,1,148,147,139,139,100
"9456",55,"[19]goIoHcouHnJHGqKClCh",277,0.996403,19,278,1,277,1,1,0,1,1,143,142,135,135,100
"9457",56,"[19]goIoHcouHnJHGqKClCh",282,0.996466,19,283,1,282,1,1,0,1,1,162,161,121,121,100
"9458",57,"[19]goIoHcouHnJHGqKClCh",276,0.99639,19,277,1,276,1,1,0,1,1,149,148,128,128,100
"9459",58,"[19]goIoHcouHnJHGqKClCh",278,0.996416,19,279,1,278,1,1,0,1,1,125,124,154,154,100
"9460",59,"[19]goIoHcouHnJHGqKClCh",274,0.996364,19,275,1,274,1,1,0,1,1,137,136,138,138,100
"9461",60,"[19]goIoHcouHnJHGqKClCh",284,0.996491,19,285,1,284,1,1,0,1,1,142,141,143,143,100
"9462",61,"[19]goIoHcouHnJHGqKClCh",280,0.996441,19,281,1,280,1,1,0,1,1,148,147,133,133,100
"9463",62,"[19]goIoHcouHnJHGqKClCh",290,0.996564,19,291,1,290,1,1,0,1,1,146,145,145,145,100
"9464",63,"[19]goIoHcouHnJHGqKClCh",271,0.996324,19,272,1,271,1,1,0,1,1,122,121,150,150,100
"9465",64,"[19]goIoHcouHnJHGqKClCh",284,0.996491,19,285,1,284,1,1,0,1,1,142,141,143,143,100
"9466",65,"[19]goIoHcouHnJHGqKClCh",288,0.99654,19,289,1,288,1,1,0,1,1,161,160,128,128,100
"9467",66,"[19]goIoHcouHnJHGqKClCh",287,0.996528,19,288,1,287,1,1,0,1,1,144,143,144,144,100
"9468",67,"[19]goIoHcouHnJHGqKClCh",287,0.996528,19,288,1,287,1,1,0,1,1,139,138,149,149,100
"9469",68,"[19]goIoHcouHnJHGqKClCh",285,0.996503,19,286,1,285,1,1,0,1,1,148,147,138,138,100
"9470",69,"[19]goIoHcouHnJHGqKClCh",290,0.996564,19,291,1,290,1,1,0,1,1,142,141,149,149,100
"9471",70,"[19]goIoHcouHnJHGqKClCh",281,0.996454,19,282,1,281,1,1,0,1,1,143,142,139,139,100
"9472",71,"[19]goIoHcouHnJHGqKClCh",285,0.996503,19,286,1,285,1,1,0,1,1,146,145,140,140,100
"9473",72,"[19]goIoHcouHnJHGqKClCh",276,0.99639,19,277,1,276,1,1,0,1,1,134,133,143,143,100
"9474",73,"[19]goIoHcouHnJHGqKClCh",280,0.996441,19,281,1,280,1,1,0,1,1,142,141,139,139,100
"9475",74,"[19]goIoHcouHnJHGqKClCh",278,0.996416,19,279,1,278,1,1,0,1,1,137,136,142,142,100
"9476",75,"[19]goIoHcouHnJHGqKClCh",275,0.996377,19,276,1,275,1,1,0,1,1,139,138,137,137,100
"9477",76,"[19]goIoHcouHnJHGqKClCh",285,0.996503,19,286,1,285,1,1,0,1,1,150,149,136,136,100
"9478",77,"[19]goIoHcouHnJHGqKClCh",282,0.996466,19,283,1,282,1,1,0,1,1,151,150,132,132,100
"9479",78,"[19]goIoHcouHnJHGqKClCh",283,0.996479,19,284,1,283,1,1,0,1,1,150,149,134,134,100
"9480",79,"[19]goIoHcouHnJHGqKClCh",282,0.996466,19,283,1,282,1,1,0,1,1,130,129,153,153,100
"9481",80,"[19]goIoHcouHnJHGqKClCh",279,0.996429,19,280,1,279,1,1,0,1,1,125,124,155,155,100
"9482",81,"[19]goIoHcouHnJHGqKClCh",283,0.996479,19,284,1,283,1,1,0,1,1,137,136,147,147,100
"9483",82,"[19]goIoHcouHnJHGqKClCh",281,0.996454,19,282,1,281,1,1,0,1,1,145,144,137,137,100
"9484",83,"[19]goIoHcouHnJHGqKClCh",284,0.996491,19,285,1,284,1,1,0,1,1,152,151,133,133,100
"9485",84,"[19]goIoHcouHnJHGqKClCh",276,0.99639,19,277,1,276,1,1,0,1,1,134,133,143,143,100
"9486",85,"[19]goIoHcouHnJHGqKClCh",283,0.996479,19,284,1,283,1,1,0,1,1,166,165,118,118,100
"9487",86,"[19]goIoHcouHnJHGqKClCh",288,0.99654,19,289,1,288,1,1,0,1,1,142,141,147,147,100
"9488",87,"[19]goIoHcouHnJHGqKClCh",286,0.996516,19,287,1,286,1,1,0,1,1,144,143,143,143,100
"9489",88,"[19]goIoHcouHnJHGqKClCh",278,0.996416,19,279,1,278,1,1,0,1,1,152,151,127,127,100
"9490",89,"[19]goIoHcouHnJHGqKClCh",285,0.996503,19,286,1,285,1,1,0,1,1,148,147,138,138,100
"9491",90,"[19]goIoHcouHnJHGqKClCh",283,0.996479,19,284,1,283,1,1,0,1,1,131,130,153,153,100
"9492",91,"[19]goIoHcouHnJHGqKClCh",284,0.996491,19,285,1,284,1,1,0,1,1,130,129,155,155,100
"9493",92,"[19]goIoHcouHnJHGqKClCh",281,0.996454,19,282,1,281,1,1,0,1,1,146,145,136,136,100
"9494",93,"[19]goIoHcouHnJHGqKClCh",285,0.996503,19,286,1,285,1,1,0,1,1,145,144,141,141,100
"9495",94,"[19]goIoHcouHnJHGqKClCh",286,0.996516,19,287,1,286,1,1,0,1,1,154,153,133,133,100
"9496",95,"[19]goIoHcouHnJHGqKClCh",282,0.996466,19,283,1,282,1,1,0,1,1,143,142,140,140,100
"9497",96,"[19]goIoHcouHnJHGqKClCh",282,0.996466,19,283,1,282,1,1,0,1,1,145,144,138,138,100
"9498",97,"[19]goIoHcouHnJHGqKClCh",282,0.996466,19,283,1,282,1,1,0,1,1,169,168,114,114,100
"9499",98,"[19]goIoHcouHnJHGqKClCh",281,0.996454,19,282,1,281,1,1,0,1,1,150,149,132,132,100
"9500",99,"[19]goIoHcouHnJHGqKClCh",287,0.996528,19,288,1,287,1,1,0,1,1,140,139,148,148,100
