"","trial_number","genome","merit","accuracy","genome_length","door_rooms","exit_rooms","correct_doors","incorrect_doors","correct_exits","incorrect_exits","doors_taken_0","doors_correct_0","doors_taken_1","doors_correct_1","doors_taken_2","doors_correct_2","seed"
"1",0,"[18]yHoIoHcovHnJqKGCwm",294,0.99661,18,295,1,294,1,1,0,1,1,140,139,155,155,1
"2",1,"[18]yHoIoHcovHnJqKGCwm",290,0.996564,18,291,1,290,1,1,0,1,1,129,128,162,162,1
"3",2,"[18]yHoIoHcovHnJqKGCwm",288,0.99654,18,289,1,288,1,1,0,1,1,121,120,168,168,1
"4",3,"[18]yHoIoHcovHnJqKGCwm",294,0.99661,18,295,1,294,1,1,0,1,1,146,145,149,149,1
"5",4,"[18]yHoIoHcovHnJqKGCwm",300,0.996678,18,301,1,300,1,1,0,1,1,164,163,137,137,1
"6",5,"[18]yHoIoHcovHnJqKGCwm",299,0.996667,18,300,1,299,1,1,0,1,1,144,143,156,156,1
"7",6,"[18]yHoIoHcovHnJqKGCwm",299,0.996667,18,300,1,299,1,1,0,1,1,154,153,146,146,1
"8",7,"[18]yHoIoHcovHnJqKGCwm",301,0.996689,18,302,1,301,1,1,0,1,1,153,152,149,149,1
"9",8,"[18]yHoIoHcovHnJqKGCwm",296,0.996633,18,297,1,296,1,1,0,1,1,150,149,147,147,1
"10",9,"[18]yHoIoHcovHnJqKGCwm",298,0.996656,18,299,1,298,1,1,0,1,1,155,154,144,144,1
"11",10,"[18]yHoIoHcovHnJqKGCwm",304,0.996721,18,305,1,304,1,1,0,1,1,169,168,136,136,1
"12",11,"[18]yHoIoHcovHnJqKGCwm",299,0.996667,18,300,1,299,1,1,0,1,1,146,145,154,154,1
"13",12,"[18]yHoIoHcovHnJqKGCwm",299,0.996667,18,300,1,299,1,1,0,1,1,157,156,143,143,1
"14",13,"[18]yHoIoHcovHnJqKGCwm",302,0.9967,18,303,1,302,1,1,0,1,1,170,169,133,133,1
"15",14,"[18]yHoIoHcovHnJqKGCwm",293,0.996599,18,294,1,293,1,1,0,1,1,137,136,157,157,1
"16",15,"[18]yHoIoHcovHnJqKGCwm",301,0.996689,18,302,1,301,1,1,0,1,1,161,160,141,141,1
"17",16,"[18]yHoIoHcovHnJqKGCwm",290,0.996564,18,291,1,290,1,1,0,1,1,130,129,161,161,1
"18",17,"[18]yHoIoHcovHnJqKGCwm",295,0.996622,18,296,1,295,1,1,0,1,1,143,142,153,153,1
"19",18,"[18]yHoIoHcovHnJqKGCwm",300,0.996678,18,301,1,300,1,1,0,1,1,157,156,144,144,1
"20",19,"[18]yHoIoHcovHnJqKGCwm",302,0.9967,18,303,1,302,1,1,0,1,1,163,162,140,140,1
"21",20,"[18]yHoIoHcovHnJqKGCwm",296,0.996633,18,297,1,296,1,1,0,1,1,147,146,150,150,1
"22",21,"[18]yHoIoHcovHnJqKGCwm",301,0.996689,18,302,1,301,1,1,0,1,1,159,158,143,143,1
"23",22,"[18]yHoIoHcovHnJqKGCwm",291,0.996575,18,292,1,291,1,1,0,1,1,132,131,160,160,1
"24",23,"[18]yHoIoHcovHnJqKGCwm",299,0.996667,18,300,1,299,1,1,0,1,1,155,154,145,145,1
"25",24,"[18]yHoIoHcovHnJqKGCwm",294,0.99661,18,295,1,294,1,1,0,1,1,146,145,149,149,1
"26",25,"[18]yHoIoHcovHnJqKGCwm",299,0.996667,18,300,1,299,1,1,0,1,1,154,153,146,146,1
"27",26,"[18]yHoIoHcovHnJqKGCwm",293,0.996599,18,294,1,293,1,1,0,1,1,139,138,155,155,1
"28",27,"[18]yHoIoHcovHnJqKGCwm",298,0.996656,18,299,1,298,1,1,0,1,1,151,150,148,148,1
"29",28,"[18]yHoIoHcovHnJqKGCwm",300,0.996678,18,301,1,300,1,1,0,1,1,159,158,142,142,1
"30",29,"[18]yHoIoHcovHnJqKGCwm",297,0.996644,18,298,1,297,1,1,0,1,1,150,149,148,148,1
"31",30,"[18]yHoIoHcovHnJqKGCwm",295,0.996622,18,296,1,295,1,1,0,1,1,146,145,150,150,1
"32",31,"[18]yHoIoHcovHnJqKGCwm",295,0.996622,18,296,1,295,1,1,0,1,1,140,139,156,156,1
"33",32,"[18]yHoIoHcovHnJqKGCwm",303,0.996711,18,304,1,303,1,1,0,1,1,167,166,137,137,1
"34",33,"[18]yHoIoHcovHnJqKGCwm",299,0.996667,18,300,1,299,1,1,0,1,1,152,151,148,148,1
"35",34,"[18]yHoIoHcovHnJqKGCwm",294,0.99661,18,295,1,294,1,1,0,1,1,138,137,157,157,1
"36",35,"[18]yHoIoHcovHnJqKGCwm",299,0.996667,18,300,1,299,1,1,0,1,1,153,152,147,147,1
"37",36,"[18]yHoIoHcovHnJqKGCwm",297,0.996644,18,298,1,297,1,1,0,1,1,149,148,149,149,1
"38",37,"[18]yHoIoHcovHnJqKGCwm",301,0.996689,18,302,1,301,1,1,0,1,1,157,156,145,145,1
"39",38,"[18]yHoIoHcovHnJqKGCwm",297,0.996644,18,298,1,297,1,1,0,1,1,145,144,153,153,1
"40",39,"[18]yHoIoHcovHnJqKGCwm",295,0.996622,18,296,1,295,1,1,0,1,1,145,144,151,151,1
"41",40,"[18]yHoIoHcovHnJqKGCwm",297,0.996644,18,298,1,297,1,1,0,1,1,145,144,153,153,1
"42",41,"[18]yHoIoHcovHnJqKGCwm",302,0.9967,18,303,1,302,1,1,0,1,1,158,157,145,145,1
"43",42,"[18]yHoIoHcovHnJqKGCwm",294,0.99661,18,295,1,294,1,1,0,1,1,139,138,156,156,1
"44",43,"[18]yHoIoHcovHnJqKGCwm",297,0.996644,18,298,1,297,1,1,0,1,1,154,153,144,144,1
"45",44,"[18]yHoIoHcovHnJqKGCwm",293,0.996599,18,294,1,293,1,1,0,1,1,136,135,158,158,1
"46",45,"[18]yHoIoHcovHnJqKGCwm",301,0.996689,18,302,1,301,1,1,0,1,1,162,161,140,140,1
"47",46,"[18]yHoIoHcovHnJqKGCwm",304,0.996721,18,305,1,304,1,1,0,1,1,169,168,136,136,1
"48",47,"[18]yHoIoHcovHnJqKGCwm",300,0.996678,18,301,1,300,1,1,0,1,1,147,146,154,154,1
"49",48,"[18]yHoIoHcovHnJqKGCwm",296,0.996633,18,297,1,296,1,1,0,1,1,146,145,151,151,1
"50",49,"[18]yHoIoHcovHnJqKGCwm",294,0.99661,18,295,1,294,1,1,0,1,1,141,140,154,154,1
"51",50,"[18]yHoIoHcovHnJqKGCwm",304,0.996721,18,305,1,304,1,1,0,1,1,169,168,136,136,1
"52",51,"[18]yHoIoHcovHnJqKGCwm",296,0.996633,18,297,1,296,1,1,0,1,1,147,146,150,150,1
"53",52,"[18]yHoIoHcovHnJqKGCwm",299,0.996667,18,300,1,299,1,1,0,1,1,158,157,142,142,1
"54",53,"[18]yHoIoHcovHnJqKGCwm",296,0.996633,18,297,1,296,1,1,0,1,1,152,151,145,145,1
"55",54,"[18]yHoIoHcovHnJqKGCwm",291,0.996575,18,292,1,291,1,1,0,1,1,140,139,152,152,1
"56",55,"[18]yHoIoHcovHnJqKGCwm",296,0.996633,18,297,1,296,1,1,0,1,1,152,151,145,145,1
"57",56,"[18]yHoIoHcovHnJqKGCwm",291,0.996575,18,292,1,291,1,1,0,1,1,149,148,143,143,1
"58",57,"[18]yHoIoHcovHnJqKGCwm",291,0.996575,18,292,1,291,1,1,0,1,1,131,130,161,161,1
"59",58,"[18]yHoIoHcovHnJqKGCwm",303,0.996711,18,304,1,303,1,1,0,1,1,158,157,146,146,1
"60",59,"[18]yHoIoHcovHnJqKGCwm",299,0.996667,18,300,1,299,1,1,0,1,1,155,154,145,145,1
"61",60,"[18]yHoIoHcovHnJqKGCwm",288,0.99654,18,289,1,288,1,1,0,1,1,126,125,163,163,1
"62",61,"[18]yHoIoHcovHnJqKGCwm",294,0.99661,18,295,1,294,1,1,0,1,1,136,135,159,159,1
"63",62,"[18]yHoIoHcovHnJqKGCwm",298,0.996656,18,299,1,298,1,1,0,1,1,148,147,151,151,1
"64",63,"[18]yHoIoHcovHnJqKGCwm",307,0.996753,18,308,1,307,1,1,0,1,1,174,173,134,134,1
"65",64,"[18]yHoIoHcovHnJqKGCwm",303,0.996711,18,304,1,303,1,1,0,1,1,166,165,138,138,1
"66",65,"[18]yHoIoHcovHnJqKGCwm",297,0.996644,18,298,1,297,1,1,0,1,1,155,154,143,143,1
"67",66,"[18]yHoIoHcovHnJqKGCwm",300,0.996678,18,301,1,300,1,1,0,1,1,158,157,143,143,1
"68",67,"[18]yHoIoHcovHnJqKGCwm",297,0.996644,18,298,1,297,1,1,0,1,1,148,147,150,150,1
"69",68,"[18]yHoIoHcovHnJqKGCwm",300,0.996678,18,301,1,300,1,1,0,1,1,155,154,146,146,1
"70",69,"[18]yHoIoHcovHnJqKGCwm",297,0.996644,18,298,1,297,1,1,0,1,1,148,147,150,150,1
"71",70,"[18]yHoIoHcovHnJqKGCwm",298,0.996656,18,299,1,298,1,1,0,1,1,153,152,146,146,1
"72",71,"[18]yHoIoHcovHnJqKGCwm",298,0.996656,18,299,1,298,1,1,0,1,1,150,149,149,149,1
"73",72,"[18]yHoIoHcovHnJqKGCwm",298,0.996656,18,299,1,298,1,1,0,1,1,153,152,146,146,1
"74",73,"[18]yHoIoHcovHnJqKGCwm",298,0.996656,18,299,1,298,1,1,0,1,1,146,145,153,153,1
"75",74,"[18]yHoIoHcovHnJqKGCwm",303,0.996711,18,304,1,303,1,1,0,1,1,170,169,134,134,1
"76",75,"[18]yHoIoHcovHnJqKGCwm",297,0.996644,18,298,1,297,1,1,0,1,1,150,149,148,148,1
"77",76,"[18]yHoIoHcovHnJqKGCwm",291,0.996575,18,292,1,291,1,1,0,1,1,132,131,160,160,1
"78",77,"[18]yHoIoHcovHnJqKGCwm",301,0.996689,18,302,1,301,1,1,0,1,1,161,160,141,141,1
"79",78,"[18]yHoIoHcovHnJqKGCwm",298,0.996656,18,299,1,298,1,1,0,1,1,151,150,148,148,1
"80",79,"[18]yHoIoHcovHnJqKGCwm",298,0.996656,18,299,1,298,1,1,0,1,1,161,160,138,138,1
"81",80,"[18]yHoIoHcovHnJqKGCwm",294,0.99661,18,295,1,294,1,1,0,1,1,139,138,156,156,1
"82",81,"[18]yHoIoHcovHnJqKGCwm",293,0.996599,18,294,1,293,1,1,0,1,1,138,137,156,156,1
"83",82,"[18]yHoIoHcovHnJqKGCwm",294,0.99661,18,295,1,294,1,1,0,1,1,147,146,148,148,1
"84",83,"[18]yHoIoHcovHnJqKGCwm",296,0.996633,18,297,1,296,1,1,0,1,1,154,153,143,143,1
"85",84,"[18]yHoIoHcovHnJqKGCwm",295,0.996622,18,296,1,295,1,1,0,1,1,147,146,149,149,1
"86",85,"[18]yHoIoHcovHnJqKGCwm",297,0.996644,18,298,1,297,1,1,0,1,1,149,148,149,149,1
"87",86,"[18]yHoIoHcovHnJqKGCwm",291,0.996575,18,292,1,291,1,1,0,1,1,137,136,155,155,1
"88",87,"[18]yHoIoHcovHnJqKGCwm",300,0.996678,18,301,1,300,1,1,0,1,1,157,156,144,144,1
"89",88,"[18]yHoIoHcovHnJqKGCwm",298,0.996656,18,299,1,298,1,1,0,1,1,153,152,146,146,1
"90",89,"[18]yHoIoHcovHnJqKGCwm",295,0.996622,18,296,1,295,1,1,0,1,1,151,150,145,145,1
"91",90,"[18]yHoIoHcovHnJqKGCwm",294,0.99661,18,295,1,294,1,1,0,1,1,142,141,153,153,1
"92",91,"[18]yHoIoHcovHnJqKGCwm",298,0.996656,18,299,1,298,1,1,0,1,1,152,151,147,147,1
"93",92,"[18]yHoIoHcovHnJqKGCwm",293,0.996599,18,294,1,293,1,1,0,1,1,138,137,156,156,1
"94",93,"[18]yHoIoHcovHnJqKGCwm",291,0.996575,18,292,1,291,1,1,0,1,1,130,129,162,162,1
"95",94,"[18]yHoIoHcovHnJqKGCwm",294,0.99661,18,295,1,294,1,1,0,1,1,143,142,152,152,1
"96",95,"[18]yHoIoHcovHnJqKGCwm",294,0.99661,18,295,1,294,1,1,0,1,1,151,150,144,144,1
"97",96,"[18]yHoIoHcovHnJqKGCwm",296,0.996633,18,297,1,296,1,1,0,1,1,146,145,151,151,1
"98",97,"[18]yHoIoHcovHnJqKGCwm",291,0.996575,18,292,1,291,1,1,0,1,1,137,136,155,155,1
"99",98,"[18]yHoIoHcovHnJqKGCwm",301,0.996689,18,302,1,301,1,1,0,1,1,164,163,138,138,1
"100",99,"[18]yHoIoHcovHnJqKGCwm",296,0.996633,18,297,1,296,1,1,0,1,1,152,151,145,145,1
"101",0,"[22]loIpJoHcowHnJHGqKCtClB",281,0.996454,22,282,1,281,1,1,0,1,1,156,155,126,126,2
"102",1,"[22]loIpJoHcowHnJHGqKCtClB",282,0.996466,22,283,1,282,1,1,0,1,1,145,144,138,138,2
"103",2,"[22]loIpJoHcowHnJHGqKCtClB",287,0.996528,22,288,1,287,1,1,0,1,1,160,159,128,128,2
"104",3,"[22]loIpJoHcowHnJHGqKCtClB",281,0.996454,22,282,1,281,1,1,0,1,1,135,134,147,147,2
"105",4,"[22]loIpJoHcowHnJHGqKCtClB",278,0.996416,22,279,1,278,1,1,0,1,1,127,126,152,152,2
"106",5,"[22]loIpJoHcowHnJHGqKCtClB",283,0.996479,22,284,1,283,1,1,0,1,1,138,137,146,146,2
"107",6,"[22]loIpJoHcowHnJHGqKCtClB",287,0.996528,22,288,1,287,1,1,0,1,1,141,140,147,147,2
"108",7,"[22]loIpJoHcowHnJHGqKCtClB",277,0.996403,22,278,1,277,1,1,0,1,1,133,132,145,145,2
"109",8,"[22]loIpJoHcowHnJHGqKCtClB",280,0.996441,22,281,1,280,1,1,0,1,1,127,126,154,154,2
"110",9,"[22]loIpJoHcowHnJHGqKCtClB",276,0.99639,22,277,1,276,1,1,0,1,1,135,134,142,142,2
"111",10,"[22]loIpJoHcowHnJHGqKCtClB",280,0.996441,22,281,1,280,1,1,0,1,1,133,132,148,148,2
"112",11,"[22]loIpJoHcowHnJHGqKCtClB",283,0.996479,22,284,1,283,1,1,0,1,1,146,145,138,138,2
"113",12,"[22]loIpJoHcowHnJHGqKCtClB",280,0.996441,22,281,1,280,1,1,0,1,1,138,137,143,143,2
"114",13,"[22]loIpJoHcowHnJHGqKCtClB",280,0.996441,22,281,1,280,1,1,0,1,1,130,129,151,151,2
"115",14,"[22]loIpJoHcowHnJHGqKCtClB",284,0.996491,22,285,1,284,1,1,0,1,1,155,154,130,130,2
"116",15,"[22]loIpJoHcowHnJHGqKCtClB",291,0.996575,22,292,1,291,1,1,0,1,1,154,153,138,138,2
"117",16,"[22]loIpJoHcowHnJHGqKCtClB",285,0.996503,22,286,1,285,1,1,0,1,1,155,154,131,131,2
"118",17,"[22]loIpJoHcowHnJHGqKCtClB",280,0.996441,22,281,1,280,1,1,0,1,1,159,158,122,122,2
"119",18,"[22]loIpJoHcowHnJHGqKCtClB",285,0.996503,22,286,1,285,1,1,0,1,1,143,142,143,143,2
"120",19,"[22]loIpJoHcowHnJHGqKCtClB",288,0.99654,22,289,1,288,1,1,0,1,1,159,158,130,130,2
"121",20,"[22]loIpJoHcowHnJHGqKCtClB",282,0.996466,22,283,1,282,1,1,0,1,1,147,146,136,136,2
"122",21,"[22]loIpJoHcowHnJHGqKCtClB",279,0.996429,22,280,1,279,1,1,0,1,1,133,132,147,147,2
"123",22,"[22]loIpJoHcowHnJHGqKCtClB",284,0.996491,22,285,1,284,1,1,0,1,1,160,159,125,125,2
"124",23,"[22]loIpJoHcowHnJHGqKCtClB",275,0.996377,22,276,1,275,1,1,0,1,1,136,135,140,140,2
"125",24,"[22]loIpJoHcowHnJHGqKCtClB",275,0.996377,22,276,1,275,1,1,0,1,1,131,130,145,145,2
"126",25,"[22]loIpJoHcowHnJHGqKCtClB",281,0.996454,22,282,1,281,1,1,0,1,1,142,141,140,140,2
"127",26,"[22]loIpJoHcowHnJHGqKCtClB",283,0.996479,22,284,1,283,1,1,0,1,1,145,144,139,139,2
"128",27,"[22]loIpJoHcowHnJHGqKCtClB",284,0.996491,22,285,1,284,1,1,0,1,1,142,141,143,143,2
"129",28,"[22]loIpJoHcowHnJHGqKCtClB",278,0.996416,22,279,1,278,1,1,0,1,1,137,136,142,142,2
"130",29,"[22]loIpJoHcowHnJHGqKCtClB",281,0.996454,22,282,1,281,1,1,0,1,1,137,136,145,145,2
"131",30,"[22]loIpJoHcowHnJHGqKCtClB",274,0.996364,22,275,1,274,1,1,0,1,1,131,130,144,144,2
"132",31,"[22]loIpJoHcowHnJHGqKCtClB",278,0.996416,22,279,1,278,1,1,0,1,1,135,134,144,144,2
"133",32,"[22]loIpJoHcowHnJHGqKCtClB",285,0.996503,22,286,1,285,1,1,0,1,1,133,132,153,153,2
"134",33,"[22]loIpJoHcowHnJHGqKCtClB",284,0.996491,22,285,1,284,1,1,0,1,1,151,150,134,134,2
"135",34,"[22]loIpJoHcowHnJHGqKCtClB",279,0.996429,22,280,1,279,1,1,0,1,1,137,136,143,143,2
"136",35,"[22]loIpJoHcowHnJHGqKCtClB",281,0.996454,22,282,1,281,1,1,0,1,1,134,133,148,148,2
"137",36,"[22]loIpJoHcowHnJHGqKCtClB",281,0.996454,22,282,1,281,1,1,0,1,1,151,150,131,131,2
"138",37,"[22]loIpJoHcowHnJHGqKCtClB",280,0.996441,22,281,1,280,1,1,0,1,1,144,143,137,137,2
"139",38,"[22]loIpJoHcowHnJHGqKCtClB",283,0.996479,22,284,1,283,1,1,0,1,1,149,148,135,135,2
"140",39,"[22]loIpJoHcowHnJHGqKCtClB",279,0.996429,22,280,1,279,1,1,0,1,1,137,136,143,143,2
"141",40,"[22]loIpJoHcowHnJHGqKCtClB",278,0.996416,22,279,1,278,1,1,0,1,1,134,133,145,145,2
"142",41,"[22]loIpJoHcowHnJHGqKCtClB",283,0.996479,22,284,1,283,1,1,0,1,1,146,145,138,138,2
"143",42,"[22]loIpJoHcowHnJHGqKCtClB",275,0.996377,22,276,1,275,1,1,0,1,1,133,132,143,143,2
"144",43,"[22]loIpJoHcowHnJHGqKCtClB",290,0.996564,22,291,1,290,1,1,0,1,1,149,148,142,142,2
"145",44,"[22]loIpJoHcowHnJHGqKCtClB",276,0.99639,22,277,1,276,1,1,0,1,1,129,128,148,148,2
"146",45,"[22]loIpJoHcowHnJHGqKCtClB",284,0.996491,22,285,1,284,1,1,0,1,1,135,134,150,150,2
"147",46,"[22]loIpJoHcowHnJHGqKCtClB",276,0.99639,22,277,1,276,1,1,0,1,1,126,125,151,151,2
"148",47,"[22]loIpJoHcowHnJHGqKCtClB",286,0.996516,22,287,1,286,1,1,0,1,1,150,149,137,137,2
"149",48,"[22]loIpJoHcowHnJHGqKCtClB",282,0.996466,22,283,1,282,1,1,0,1,1,147,146,136,136,2
"150",49,"[22]loIpJoHcowHnJHGqKCtClB",282,0.996466,22,283,1,282,1,1,0,1,1,142,141,141,141,2
"151",50,"[22]loIpJoHcowHnJHGqKCtClB",284,0.996491,22,285,1,284,1,1,0,1,1,142,141,143,143,2
"152",51,"[22]loIpJoHcowHnJHGqKCtClB",285,0.996503,22,286,1,285,1,1,0,1,1,144,143,142,142,2
"153",52,"[22]loIpJoHcowHnJHGqKCtClB",277,0.996403,22,278,1,277,1,1,0,1,1,133,132,145,145,2
"154",53,"[22]loIpJoHcowHnJHGqKCtClB",284,0.996491,22,285,1,284,1,1,0,1,1,137,136,148,148,2
"155",54,"[22]loIpJoHcowHnJHGqKCtClB",278,0.996416,22,279,1,278,1,1,0,1,1,143,142,136,136,2
"156",55,"[22]loIpJoHcowHnJHGqKCtClB",286,0.996516,22,287,1,286,1,1,0,1,1,139,138,148,148,2
"157",56,"[22]loIpJoHcowHnJHGqKCtClB",287,0.996528,22,288,1,287,1,1,0,1,1,156,155,132,132,2
"158",57,"[22]loIpJoHcowHnJHGqKCtClB",273,0.99635,22,274,1,273,1,1,0,1,1,134,133,140,140,2
"159",58,"[22]loIpJoHcowHnJHGqKCtClB",280,0.996441,22,281,1,280,1,1,0,1,1,151,150,130,130,2
"160",59,"[22]loIpJoHcowHnJHGqKCtClB",279,0.996429,22,280,1,279,1,1,0,1,1,142,141,138,138,2
"161",60,"[22]loIpJoHcowHnJHGqKCtClB",283,0.996479,22,284,1,283,1,1,0,1,1,154,153,130,130,2
"162",61,"[22]loIpJoHcowHnJHGqKCtClB",282,0.996466,22,283,1,282,1,1,0,1,1,140,139,143,143,2
"163",62,"[22]loIpJoHcowHnJHGqKCtClB",279,0.996429,22,280,1,279,1,1,0,1,1,126,125,154,154,2
"164",63,"[22]loIpJoHcowHnJHGqKCtClB",283,0.996479,22,284,1,283,1,1,0,1,1,145,144,139,139,2
"165",64,"[22]loIpJoHcowHnJHGqKCtClB",282,0.996466,22,283,1,282,1,1,0,1,1,153,152,130,130,2
"166",65,"[22]loIpJoHcowHnJHGqKCtClB",284,0.996491,22,285,1,284,1,1,0,1,1,147,146,138,138,2
"167",66,"[22]loIpJoHcowHnJHGqKCtClB",277,0.996403,22,278,1,277,1,1,0,1,1,145,144,133,133,2
"168",67,"[22]loIpJoHcowHnJHGqKCtClB",278,0.996416,22,279,1,278,1,1,0,1,1,144,143,135,135,2
"169",68,"[22]loIpJoHcowHnJHGqKCtClB",285,0.996503,22,286,1,285,1,1,0,1,1,144,143,142,142,2
"170",69,"[22]loIpJoHcowHnJHGqKCtClB",281,0.996454,22,282,1,281,1,1,0,1,1,145,144,137,137,2
"171",70,"[22]loIpJoHcowHnJHGqKCtClB",278,0.996416,22,279,1,278,1,1,0,1,1,137,136,142,142,2
"172",71,"[22]loIpJoHcowHnJHGqKCtClB",275,0.996377,22,276,1,275,1,1,0,1,1,149,148,127,127,2
"173",72,"[22]loIpJoHcowHnJHGqKCtClB",281,0.996454,22,282,1,281,1,1,0,1,1,139,138,143,143,2
"174",73,"[22]loIpJoHcowHnJHGqKCtClB",281,0.996454,22,282,1,281,1,1,0,1,1,150,149,132,132,2
"175",74,"[22]loIpJoHcowHnJHGqKCtClB",285,0.996503,22,286,1,285,1,1,0,1,1,139,138,147,147,2
"176",75,"[22]loIpJoHcowHnJHGqKCtClB",279,0.996429,22,280,1,279,1,1,0,1,1,132,131,148,148,2
"177",76,"[22]loIpJoHcowHnJHGqKCtClB",284,0.996491,22,285,1,284,1,1,0,1,1,150,149,135,135,2
"178",77,"[22]loIpJoHcowHnJHGqKCtClB",282,0.996466,22,283,1,282,1,1,0,1,1,142,141,141,141,2
"179",78,"[22]loIpJoHcowHnJHGqKCtClB",277,0.996403,22,278,1,277,1,1,0,1,1,143,142,135,135,2
"180",79,"[22]loIpJoHcowHnJHGqKCtClB",286,0.996516,22,287,1,286,1,1,0,1,1,146,145,141,141,2
"181",80,"[22]loIpJoHcowHnJHGqKCtClB",283,0.996479,22,284,1,283,1,1,0,1,1,151,150,133,133,2
"182",81,"[22]loIpJoHcowHnJHGqKCtClB",286,0.996516,22,287,1,286,1,1,0,1,1,149,148,138,138,2
"183",82,"[22]loIpJoHcowHnJHGqKCtClB",278,0.996416,22,279,1,278,1,1,0,1,1,135,134,144,144,2
"184",83,"[22]loIpJoHcowHnJHGqKCtClB",274,0.996364,22,275,1,274,1,1,0,1,1,135,134,140,140,2
"185",84,"[22]loIpJoHcowHnJHGqKCtClB",275,0.996377,22,276,1,275,1,1,0,1,1,142,141,134,134,2
"186",85,"[22]loIpJoHcowHnJHGqKCtClB",286,0.996516,22,287,1,286,1,1,0,1,1,151,150,136,136,2
"187",86,"[22]loIpJoHcowHnJHGqKCtClB",276,0.99639,22,277,1,276,1,1,0,1,1,122,121,155,155,2
"188",87,"[22]loIpJoHcowHnJHGqKCtClB",279,0.996429,22,280,1,279,1,1,0,1,1,129,128,151,151,2
"189",88,"[22]loIpJoHcowHnJHGqKCtClB",280,0.996441,22,281,1,280,1,1,0,1,1,137,136,144,144,2
"190",89,"[22]loIpJoHcowHnJHGqKCtClB",282,0.996466,22,283,1,282,1,1,0,1,1,142,141,141,141,2
"191",90,"[22]loIpJoHcowHnJHGqKCtClB",284,0.996491,22,285,1,284,1,1,0,1,1,137,136,148,148,2
"192",91,"[22]loIpJoHcowHnJHGqKCtClB",278,0.996416,22,279,1,278,1,1,0,1,1,145,144,134,134,2
"193",92,"[22]loIpJoHcowHnJHGqKCtClB",280,0.996441,22,281,1,280,1,1,0,1,1,142,141,139,139,2
"194",93,"[22]loIpJoHcowHnJHGqKCtClB",277,0.996403,22,278,1,277,1,1,0,1,1,141,140,137,137,2
"195",94,"[22]loIpJoHcowHnJHGqKCtClB",277,0.996403,22,278,1,277,1,1,0,1,1,133,132,145,145,2
"196",95,"[22]loIpJoHcowHnJHGqKCtClB",279,0.996429,22,280,1,279,1,1,0,1,1,141,140,139,139,2
"197",96,"[22]loIpJoHcowHnJHGqKCtClB",275,0.996377,22,276,1,275,1,1,0,1,1,138,137,138,138,2
"198",97,"[22]loIpJoHcowHnJHGqKCtClB",274,0.996364,22,275,1,274,1,1,0,1,1,131,130,144,144,2
"199",98,"[22]loIpJoHcowHnJHGqKCtClB",286,0.996516,22,287,1,286,1,1,0,1,1,161,160,126,126,2
"200",99,"[22]loIpJoHcowHnJHGqKCtClB",279,0.996429,22,280,1,279,1,1,0,1,1,137,136,143,143,2
"201",0,"[20]lHoInoHcotHnJqKGCFwz",295,0.996622,20,296,1,295,1,1,0,1,1,145,144,151,151,3
"202",1,"[20]lHoInoHcotHnJqKGCFwz",296,0.996633,20,297,1,296,1,1,0,1,1,148,147,149,149,3
"203",2,"[20]lHoInoHcotHnJqKGCFwz",288,0.99654,20,289,1,288,1,1,0,1,1,119,118,170,170,3
"204",3,"[20]lHoInoHcotHnJqKGCFwz",294,0.99661,20,295,1,294,1,1,0,1,1,145,144,150,150,3
"205",4,"[20]lHoInoHcotHnJqKGCFwz",304,0.996721,20,305,1,304,1,1,0,1,1,170,169,135,135,3
"206",5,"[20]lHoInoHcotHnJqKGCFwz",294,0.99661,20,295,1,294,1,1,0,1,1,141,140,154,154,3
"207",6,"[20]lHoInoHcotHnJqKGCFwz",302,0.9967,20,303,1,302,1,1,0,1,1,163,162,140,140,3
"208",7,"[20]lHoInoHcotHnJqKGCFwz",295,0.996622,20,296,1,295,1,1,0,1,1,145,144,151,151,3
"209",8,"[20]lHoInoHcotHnJqKGCFwz",301,0.996689,20,302,1,301,1,1,0,1,1,157,156,145,145,3
"210",9,"[20]lHoInoHcotHnJqKGCFwz",296,0.996633,20,297,1,296,1,1,0,1,1,140,139,157,157,3
"211",10,"[20]lHoInoHcotHnJqKGCFwz",292,0.996587,20,293,1,292,1,1,0,1,1,134,133,159,159,3
"212",11,"[20]lHoInoHcotHnJqKGCFwz",302,0.9967,20,303,1,302,1,1,0,1,1,162,161,141,141,3
"213",12,"[20]lHoInoHcotHnJqKGCFwz",295,0.996622,20,296,1,295,1,1,0,1,1,153,152,143,143,3
"214",13,"[20]lHoInoHcotHnJqKGCFwz",294,0.99661,20,295,1,294,1,1,0,1,1,140,139,155,155,3
"215",14,"[20]lHoInoHcotHnJqKGCFwz",299,0.996667,20,300,1,299,1,1,0,1,1,154,153,146,146,3
"216",15,"[20]lHoInoHcotHnJqKGCFwz",299,0.996667,20,300,1,299,1,1,0,1,1,159,158,141,141,3
"217",16,"[20]lHoInoHcotHnJqKGCFwz",301,0.996689,20,302,1,301,1,1,0,1,1,157,156,145,145,3
"218",17,"[20]lHoInoHcotHnJqKGCFwz",301,0.996689,20,302,1,301,1,1,0,1,1,162,161,140,140,3
"219",18,"[20]lHoInoHcotHnJqKGCFwz",295,0.996622,20,296,1,295,1,1,0,1,1,144,143,152,152,3
"220",19,"[20]lHoInoHcotHnJqKGCFwz",295,0.996622,20,296,1,295,1,1,0,1,1,146,145,150,150,3
"221",20,"[20]lHoInoHcotHnJqKGCFwz",295,0.996622,20,296,1,295,1,1,0,1,1,148,147,148,148,3
"222",21,"[20]lHoInoHcotHnJqKGCFwz",294,0.99661,20,295,1,294,1,1,0,1,1,142,141,153,153,3
"223",22,"[20]lHoInoHcotHnJqKGCFwz",299,0.996667,20,300,1,299,1,1,0,1,1,154,153,146,146,3
"224",23,"[20]lHoInoHcotHnJqKGCFwz",299,0.996667,20,300,1,299,1,1,0,1,1,152,151,148,148,3
"225",24,"[20]lHoInoHcotHnJqKGCFwz",296,0.996633,20,297,1,296,1,1,0,1,1,144,143,153,153,3
"226",25,"[20]lHoInoHcotHnJqKGCFwz",294,0.99661,20,295,1,294,1,1,0,1,1,149,148,146,146,3
"227",26,"[20]lHoInoHcotHnJqKGCFwz",289,0.996552,20,290,1,289,1,1,0,1,1,138,137,152,152,3
"228",27,"[20]lHoInoHcotHnJqKGCFwz",285,0.996503,20,286,1,285,1,1,0,1,1,130,129,156,156,3
"229",28,"[20]lHoInoHcotHnJqKGCFwz",293,0.996599,20,294,1,293,1,1,0,1,1,143,142,151,151,3
"230",29,"[20]lHoInoHcotHnJqKGCFwz",301,0.996689,20,302,1,301,1,1,0,1,1,163,162,139,139,3
"231",30,"[20]lHoInoHcotHnJqKGCFwz",303,0.996711,20,304,1,303,1,1,0,1,1,159,158,145,145,3
"232",31,"[20]lHoInoHcotHnJqKGCFwz",291,0.996575,20,292,1,291,1,1,0,1,1,130,129,162,162,3
"233",32,"[20]lHoInoHcotHnJqKGCFwz",298,0.996656,20,299,1,298,1,1,0,1,1,149,148,150,150,3
"234",33,"[20]lHoInoHcotHnJqKGCFwz",298,0.996656,20,299,1,298,1,1,0,1,1,153,152,146,146,3
"235",34,"[20]lHoInoHcotHnJqKGCFwz",298,0.996656,20,299,1,298,1,1,0,1,1,151,150,148,148,3
"236",35,"[20]lHoInoHcotHnJqKGCFwz",297,0.996644,20,298,1,297,1,1,0,1,1,143,142,155,155,3
"237",36,"[20]lHoInoHcotHnJqKGCFwz",300,0.996678,20,301,1,300,1,1,0,1,1,163,162,138,138,3
"238",37,"[20]lHoInoHcotHnJqKGCFwz",297,0.996644,20,298,1,297,1,1,0,1,1,150,149,148,148,3
"239",38,"[20]lHoInoHcotHnJqKGCFwz",298,0.996656,20,299,1,298,1,1,0,1,1,155,154,144,144,3
"240",39,"[20]lHoInoHcotHnJqKGCFwz",296,0.996633,20,297,1,296,1,1,0,1,1,152,151,145,145,3
"241",40,"[20]lHoInoHcotHnJqKGCFwz",294,0.99661,20,295,1,294,1,1,0,1,1,145,144,150,150,3
"242",41,"[20]lHoInoHcotHnJqKGCFwz",296,0.996633,20,297,1,296,1,1,0,1,1,143,142,154,154,3
"243",42,"[20]lHoInoHcotHnJqKGCFwz",300,0.996678,20,301,1,300,1,1,0,1,1,158,157,143,143,3
"244",43,"[20]lHoInoHcotHnJqKGCFwz",294,0.99661,20,295,1,294,1,1,0,1,1,147,146,148,148,3
"245",44,"[20]lHoInoHcotHnJqKGCFwz",295,0.996622,20,296,1,295,1,1,0,1,1,143,142,153,153,3
"246",45,"[20]lHoInoHcotHnJqKGCFwz",296,0.996633,20,297,1,296,1,1,0,1,1,153,152,144,144,3
"247",46,"[20]lHoInoHcotHnJqKGCFwz",297,0.996644,20,298,1,297,1,1,0,1,1,147,146,151,151,3
"248",47,"[20]lHoInoHcotHnJqKGCFwz",297,0.996644,20,298,1,297,1,1,0,1,1,153,152,145,145,3
"249",48,"[20]lHoInoHcotHnJqKGCFwz",300,0.996678,20,301,1,300,1,1,0,1,1,162,161,139,139,3
"250",49,"[20]lHoInoHcotHnJqKGCFwz",295,0.996622,20,296,1,295,1,1,0,1,1,147,146,149,149,3
"251",50,"[20]lHoInoHcotHnJqKGCFwz",297,0.996644,20,298,1,297,1,1,0,1,1,139,138,159,159,3
"252",51,"[20]lHoInoHcotHnJqKGCFwz",297,0.996644,20,298,1,297,1,1,0,1,1,157,156,141,141,3
"253",52,"[20]lHoInoHcotHnJqKGCFwz",290,0.996564,20,291,1,290,1,1,0,1,1,142,141,149,149,3
"254",53,"[20]lHoInoHcotHnJqKGCFwz",303,0.996711,20,304,1,303,1,1,0,1,1,167,166,137,137,3
"255",54,"[20]lHoInoHcotHnJqKGCFwz",297,0.996644,20,298,1,297,1,1,0,1,1,148,147,150,150,3
"256",55,"[20]lHoInoHcotHnJqKGCFwz",290,0.996564,20,291,1,290,1,1,0,1,1,124,123,167,167,3
"257",56,"[20]lHoInoHcotHnJqKGCFwz",294,0.99661,20,295,1,294,1,1,0,1,1,147,146,148,148,3
"258",57,"[20]lHoInoHcotHnJqKGCFwz",302,0.9967,20,303,1,302,1,1,0,1,1,161,160,142,142,3
"259",58,"[20]lHoInoHcotHnJqKGCFwz",298,0.996656,20,299,1,298,1,1,0,1,1,151,150,148,148,3
"260",59,"[20]lHoInoHcotHnJqKGCFwz",297,0.996644,20,298,1,297,1,1,0,1,1,145,144,153,153,3
"261",60,"[20]lHoInoHcotHnJqKGCFwz",296,0.996633,20,297,1,296,1,1,0,1,1,146,145,151,151,3
"262",61,"[20]lHoInoHcotHnJqKGCFwz",295,0.996622,20,296,1,295,1,1,0,1,1,147,146,149,149,3
"263",62,"[20]lHoInoHcotHnJqKGCFwz",298,0.996656,20,299,1,298,1,1,0,1,1,153,152,146,146,3
"264",63,"[20]lHoInoHcotHnJqKGCFwz",299,0.996667,20,300,1,299,1,1,0,1,1,149,148,151,151,3
"265",64,"[20]lHoInoHcotHnJqKGCFwz",298,0.996656,20,299,1,298,1,1,0,1,1,153,152,146,146,3
"266",65,"[20]lHoInoHcotHnJqKGCFwz",299,0.996667,20,300,1,299,1,1,0,1,1,155,154,145,145,3
"267",66,"[20]lHoInoHcotHnJqKGCFwz",296,0.996633,20,297,1,296,1,1,0,1,1,152,151,145,145,3
"268",67,"[20]lHoInoHcotHnJqKGCFwz",302,0.9967,20,303,1,302,1,1,0,1,1,163,162,140,140,3
"269",68,"[20]lHoInoHcotHnJqKGCFwz",293,0.996599,20,294,1,293,1,1,0,1,1,140,139,154,154,3
"270",69,"[20]lHoInoHcotHnJqKGCFwz",306,0.996743,20,307,1,306,1,1,0,1,1,176,175,131,131,3
"271",70,"[20]lHoInoHcotHnJqKGCFwz",294,0.99661,20,295,1,294,1,1,0,1,1,145,144,150,150,3
"272",71,"[20]lHoInoHcotHnJqKGCFwz",297,0.996644,20,298,1,297,1,1,0,1,1,149,148,149,149,3
"273",72,"[20]lHoInoHcotHnJqKGCFwz",289,0.996552,20,290,1,289,1,1,0,1,1,130,129,160,160,3
"274",73,"[20]lHoInoHcotHnJqKGCFwz",296,0.996633,20,297,1,296,1,1,0,1,1,153,152,144,144,3
"275",74,"[20]lHoInoHcotHnJqKGCFwz",303,0.996711,20,304,1,303,1,1,0,1,1,168,167,136,136,3
"276",75,"[20]lHoInoHcotHnJqKGCFwz",295,0.996622,20,296,1,295,1,1,0,1,1,149,148,147,147,3
"277",76,"[20]lHoInoHcotHnJqKGCFwz",293,0.996599,20,294,1,293,1,1,0,1,1,141,140,153,153,3
"278",77,"[20]lHoInoHcotHnJqKGCFwz",297,0.996644,20,298,1,297,1,1,0,1,1,150,149,148,148,3
"279",78,"[20]lHoInoHcotHnJqKGCFwz",292,0.996587,20,293,1,292,1,1,0,1,1,135,134,158,158,3
"280",79,"[20]lHoInoHcotHnJqKGCFwz",303,0.996711,20,304,1,303,1,1,0,1,1,171,170,133,133,3
"281",80,"[20]lHoInoHcotHnJqKGCFwz",294,0.99661,20,295,1,294,1,1,0,1,1,140,139,155,155,3
"282",81,"[20]lHoInoHcotHnJqKGCFwz",295,0.996622,20,296,1,295,1,1,0,1,1,143,142,153,153,3
"283",82,"[20]lHoInoHcotHnJqKGCFwz",292,0.996587,20,293,1,292,1,1,0,1,1,135,134,158,158,3
"284",83,"[20]lHoInoHcotHnJqKGCFwz",297,0.996644,20,298,1,297,1,1,0,1,1,148,147,150,150,3
"285",84,"[20]lHoInoHcotHnJqKGCFwz",303,0.996711,20,304,1,303,1,1,0,1,1,163,162,141,141,3
"286",85,"[20]lHoInoHcotHnJqKGCFwz",291,0.996575,20,292,1,291,1,1,0,1,1,139,138,153,153,3
"287",86,"[20]lHoInoHcotHnJqKGCFwz",298,0.996656,20,299,1,298,1,1,0,1,1,150,149,149,149,3
"288",87,"[20]lHoInoHcotHnJqKGCFwz",290,0.996564,20,291,1,290,1,1,0,1,1,129,128,162,162,3
"289",88,"[20]lHoInoHcotHnJqKGCFwz",295,0.996622,20,296,1,295,1,1,0,1,1,146,145,150,150,3
"290",89,"[20]lHoInoHcotHnJqKGCFwz",298,0.996656,20,299,1,298,1,1,0,1,1,153,152,146,146,3
"291",90,"[20]lHoInoHcotHnJqKGCFwz",295,0.996622,20,296,1,295,1,1,0,1,1,145,144,151,151,3
"292",91,"[20]lHoInoHcotHnJqKGCFwz",300,0.996678,20,301,1,300,1,1,0,1,1,159,158,142,142,3
"293",92,"[20]lHoInoHcotHnJqKGCFwz",294,0.99661,20,295,1,294,1,1,0,1,1,145,144,150,150,3
"294",93,"[20]lHoInoHcotHnJqKGCFwz",299,0.996667,20,300,1,299,1,1,0,1,1,142,141,158,158,3
"295",94,"[20]lHoInoHcotHnJqKGCFwz",289,0.996552,20,290,1,289,1,1,0,1,1,133,132,157,157,3
"296",95,"[20]lHoInoHcotHnJqKGCFwz",304,0.996721,20,305,1,304,1,1,0,1,1,172,171,133,133,3
"297",96,"[20]lHoInoHcotHnJqKGCFwz",292,0.996587,20,293,1,292,1,1,0,1,1,136,135,157,157,3
"298",97,"[20]lHoInoHcotHnJqKGCFwz",292,0.996587,20,293,1,292,1,1,0,1,1,135,134,158,158,3
"299",98,"[20]lHoInoHcotHnJqKGCFwz",297,0.996644,20,298,1,297,1,1,0,1,1,154,153,144,144,3
"300",99,"[20]lHoInoHcotHnJqKGCFwz",300,0.996678,20,301,1,300,1,1,0,1,1,154,153,147,147,3
"301",0,"[24]vHoImoHcowHnJHGqKCpwijxc",277,0.996403,24,278,1,277,1,1,0,1,1,148,147,130,130,4
"302",1,"[24]vHoImoHcowHnJHGqKCpwijxc",283,0.996479,24,284,1,283,1,1,0,1,1,154,153,130,130,4
"303",2,"[24]vHoImoHcowHnJHGqKCpwijxc",279,0.996429,24,280,1,279,1,1,0,1,1,160,159,120,120,4
"304",3,"[24]vHoImoHcowHnJHGqKCpwijxc",277,0.996403,24,278,1,277,1,1,0,1,1,139,138,139,139,4
"305",4,"[24]vHoImoHcowHnJHGqKCpwijxc",278,0.996416,24,279,1,278,1,1,0,1,1,157,156,122,122,4
"306",5,"[24]vHoImoHcowHnJHGqKCpwijxc",280,0.996441,24,281,1,280,1,1,0,1,1,130,129,151,151,4
"307",6,"[24]vHoImoHcowHnJHGqKCpwijxc",284,0.996491,24,285,1,284,1,1,0,1,1,148,147,137,137,4
"308",7,"[24]vHoImoHcowHnJHGqKCpwijxc",290,0.996564,24,291,1,290,1,1,0,1,1,156,155,135,135,4
"309",8,"[24]vHoImoHcowHnJHGqKCpwijxc",272,0.996337,24,273,1,272,1,1,0,1,1,144,143,129,129,4
"310",9,"[24]vHoImoHcowHnJHGqKCpwijxc",276,0.99639,24,277,1,276,1,1,0,1,1,148,147,129,129,4
"311",10,"[24]vHoImoHcowHnJHGqKCpwijxc",276,0.99639,24,277,1,276,1,1,0,1,1,135,134,142,142,4
"312",11,"[24]vHoImoHcowHnJHGqKCpwijxc",276,0.99639,24,277,1,276,1,1,0,1,1,143,142,134,134,4
"313",12,"[24]vHoImoHcowHnJHGqKCpwijxc",285,0.996503,24,286,1,285,1,1,0,1,1,159,158,127,127,4
"314",13,"[24]vHoImoHcowHnJHGqKCpwijxc",280,0.996441,24,281,1,280,1,1,0,1,1,146,145,135,135,4
"315",14,"[24]vHoImoHcowHnJHGqKCpwijxc",285,0.996503,24,286,1,285,1,1,0,1,1,150,149,136,136,4
"316",15,"[24]vHoImoHcowHnJHGqKCpwijxc",278,0.996416,24,279,1,278,1,1,0,1,1,144,143,135,135,4
"317",16,"[24]vHoImoHcowHnJHGqKCpwijxc",276,0.99639,24,277,1,276,1,1,0,1,1,160,159,117,117,4
"318",17,"[24]vHoImoHcowHnJHGqKCpwijxc",283,0.996479,24,284,1,283,1,1,0,1,1,156,155,128,128,4
"319",18,"[24]vHoImoHcowHnJHGqKCpwijxc",279,0.996429,24,280,1,279,1,1,0,1,1,136,135,144,144,4
"320",19,"[24]vHoImoHcowHnJHGqKCpwijxc",283,0.996479,24,284,1,283,1,1,0,1,1,138,137,146,146,4
"321",20,"[24]vHoImoHcowHnJHGqKCpwijxc",278,0.996416,24,279,1,278,1,1,0,1,1,147,146,132,132,4
"322",21,"[24]vHoImoHcowHnJHGqKCpwijxc",278,0.996416,24,279,1,278,1,1,0,1,1,133,132,146,146,4
"323",22,"[24]vHoImoHcowHnJHGqKCpwijxc",281,0.996454,24,282,1,281,1,1,0,1,1,148,147,134,134,4
"324",23,"[24]vHoImoHcowHnJHGqKCpwijxc",284,0.996491,24,285,1,284,1,1,0,1,1,142,141,143,143,4
"325",24,"[24]vHoImoHcowHnJHGqKCpwijxc",277,0.996403,24,278,1,277,1,1,0,1,1,147,146,131,131,4
"326",25,"[24]vHoImoHcowHnJHGqKCpwijxc",279,0.996429,24,280,1,279,1,1,0,1,1,142,141,138,138,4
"327",26,"[24]vHoImoHcowHnJHGqKCpwijxc",281,0.996454,24,282,1,281,1,1,0,1,1,154,153,128,128,4
"328",27,"[24]vHoImoHcowHnJHGqKCpwijxc",277,0.996403,24,278,1,277,1,1,0,1,1,145,144,133,133,4
"329",28,"[24]vHoImoHcowHnJHGqKCpwijxc",290,0.996564,24,291,1,290,1,1,0,1,1,155,154,136,136,4
"330",29,"[24]vHoImoHcowHnJHGqKCpwijxc",282,0.996466,24,283,1,282,1,1,0,1,1,146,145,137,137,4
"331",30,"[24]vHoImoHcowHnJHGqKCpwijxc",277,0.996403,24,278,1,277,1,1,0,1,1,146,145,132,132,4
"332",31,"[24]vHoImoHcowHnJHGqKCpwijxc",281,0.996454,24,282,1,281,1,1,0,1,1,159,158,123,123,4
"333",32,"[24]vHoImoHcowHnJHGqKCpwijxc",276,0.99639,24,277,1,276,1,1,0,1,1,126,125,151,151,4
"334",33,"[24]vHoImoHcowHnJHGqKCpwijxc",288,0.99654,24,289,1,288,1,1,0,1,1,145,144,144,144,4
"335",34,"[24]vHoImoHcowHnJHGqKCpwijxc",270,0.99631,24,271,1,270,1,1,0,1,1,138,137,133,133,4
"336",35,"[24]vHoImoHcowHnJHGqKCpwijxc",283,0.996479,24,284,1,283,1,1,0,1,1,153,152,131,131,4
"337",36,"[24]vHoImoHcowHnJHGqKCpwijxc",279,0.996429,24,280,1,279,1,1,0,1,1,136,135,144,144,4
"338",37,"[24]vHoImoHcowHnJHGqKCpwijxc",282,0.996466,24,283,1,282,1,1,0,1,1,153,152,130,130,4
"339",38,"[24]vHoImoHcowHnJHGqKCpwijxc",289,0.996552,24,290,1,289,1,1,0,1,1,150,149,140,140,4
"340",39,"[24]vHoImoHcowHnJHGqKCpwijxc",281,0.996454,24,282,1,281,1,1,0,1,1,131,130,151,151,4
"341",40,"[24]vHoImoHcowHnJHGqKCpwijxc",284,0.996491,24,285,1,284,1,1,0,1,1,142,141,143,143,4
"342",41,"[24]vHoImoHcowHnJHGqKCpwijxc",284,0.996491,24,285,1,284,1,1,0,1,1,134,133,151,151,4
"343",42,"[24]vHoImoHcowHnJHGqKCpwijxc",283,0.996479,24,284,1,283,1,1,0,1,1,147,146,137,137,4
"344",43,"[24]vHoImoHcowHnJHGqKCpwijxc",282,0.996466,24,283,1,282,1,1,0,1,1,126,125,157,157,4
"345",44,"[24]vHoImoHcowHnJHGqKCpwijxc",277,0.996403,24,278,1,277,1,1,0,1,1,145,144,133,133,4
"346",45,"[24]vHoImoHcowHnJHGqKCpwijxc",279,0.996429,24,280,1,279,1,1,0,1,1,159,158,121,121,4
"347",46,"[24]vHoImoHcowHnJHGqKCpwijxc",275,0.996377,24,276,1,275,1,1,0,1,1,143,142,133,133,4
"348",47,"[24]vHoImoHcowHnJHGqKCpwijxc",279,0.996429,24,280,1,279,1,1,0,1,1,147,146,133,133,4
"349",48,"[24]vHoImoHcowHnJHGqKCpwijxc",283,0.996479,24,284,1,283,1,1,0,1,1,144,143,140,140,4
"350",49,"[24]vHoImoHcowHnJHGqKCpwijxc",277,0.996403,24,278,1,277,1,1,0,1,1,132,131,146,146,4
"351",50,"[24]vHoImoHcowHnJHGqKCpwijxc",283,0.996479,24,284,1,283,1,1,0,1,1,144,143,140,140,4
"352",51,"[24]vHoImoHcowHnJHGqKCpwijxc",275,0.996377,24,276,1,275,1,1,0,1,1,144,143,132,132,4
"353",52,"[24]vHoImoHcowHnJHGqKCpwijxc",286,0.996516,24,287,1,286,1,1,0,1,1,153,152,134,134,4
"354",53,"[24]vHoImoHcowHnJHGqKCpwijxc",279,0.996429,24,280,1,279,1,1,0,1,1,132,131,148,148,4
"355",54,"[24]vHoImoHcowHnJHGqKCpwijxc",284,0.996491,24,285,1,284,1,1,0,1,1,157,156,128,128,4
"356",55,"[24]vHoImoHcowHnJHGqKCpwijxc",279,0.996429,24,280,1,279,1,1,0,1,1,137,136,143,143,4
"357",56,"[24]vHoImoHcowHnJHGqKCpwijxc",293,0.996599,24,294,1,293,1,1,0,1,1,153,152,141,141,4
"358",57,"[24]vHoImoHcowHnJHGqKCpwijxc",284,0.996491,24,285,1,284,1,1,0,1,1,138,137,147,147,4
"359",58,"[24]vHoImoHcowHnJHGqKCpwijxc",281,0.996454,24,282,1,281,1,1,0,1,1,145,144,137,137,4
"360",59,"[24]vHoImoHcowHnJHGqKCpwijxc",282,0.996466,24,283,1,282,1,1,0,1,1,145,144,138,138,4
"361",60,"[24]vHoImoHcowHnJHGqKCpwijxc",273,0.99635,24,274,1,273,1,1,0,1,1,128,127,146,146,4
"362",61,"[24]vHoImoHcowHnJHGqKCpwijxc",287,0.996528,24,288,1,287,1,1,0,1,1,134,133,154,154,4
"363",62,"[24]vHoImoHcowHnJHGqKCpwijxc",286,0.996516,24,287,1,286,1,1,0,1,1,157,156,130,130,4
"364",63,"[24]vHoImoHcowHnJHGqKCpwijxc",279,0.996429,24,280,1,279,1,1,0,1,1,139,138,141,141,4
"365",64,"[24]vHoImoHcowHnJHGqKCpwijxc",280,0.996441,24,281,1,280,1,1,0,1,1,147,146,134,134,4
"366",65,"[24]vHoImoHcowHnJHGqKCpwijxc",280,0.996441,24,281,1,280,1,1,0,1,1,160,159,121,121,4
"367",66,"[24]vHoImoHcowHnJHGqKCpwijxc",282,0.996466,24,283,1,282,1,1,0,1,1,150,149,133,133,4
"368",67,"[24]vHoImoHcowHnJHGqKCpwijxc",274,0.996364,24,275,1,274,1,1,0,1,1,133,132,142,142,4
"369",68,"[24]vHoImoHcowHnJHGqKCpwijxc",282,0.996466,24,283,1,282,1,1,0,1,1,136,135,147,147,4
"370",69,"[24]vHoImoHcowHnJHGqKCpwijxc",286,0.996516,24,287,1,286,1,1,0,1,1,142,141,145,145,4
"371",70,"[24]vHoImoHcowHnJHGqKCpwijxc",281,0.996454,24,282,1,281,1,1,0,1,1,141,140,141,141,4
"372",71,"[24]vHoImoHcowHnJHGqKCpwijxc",277,0.996403,24,278,1,277,1,1,0,1,1,138,137,140,140,4
"373",72,"[24]vHoImoHcowHnJHGqKCpwijxc",289,0.996552,24,290,1,289,1,1,0,1,1,142,141,148,148,4
"374",73,"[24]vHoImoHcowHnJHGqKCpwijxc",285,0.996503,24,286,1,285,1,1,0,1,1,154,153,132,132,4
"375",74,"[24]vHoImoHcowHnJHGqKCpwijxc",283,0.996479,24,284,1,283,1,1,0,1,1,151,150,133,133,4
"376",75,"[24]vHoImoHcowHnJHGqKCpwijxc",280,0.996441,24,281,1,280,1,1,0,1,1,141,140,140,140,4
"377",76,"[24]vHoImoHcowHnJHGqKCpwijxc",277,0.996403,24,278,1,277,1,1,0,1,1,132,131,146,146,4
"378",77,"[24]vHoImoHcowHnJHGqKCpwijxc",283,0.996479,24,284,1,283,1,1,0,1,1,151,150,133,133,4
"379",78,"[24]vHoImoHcowHnJHGqKCpwijxc",277,0.996403,24,278,1,277,1,1,0,1,1,150,149,128,128,4
"380",79,"[24]vHoImoHcowHnJHGqKCpwijxc",280,0.996441,24,281,1,280,1,1,0,1,1,135,134,146,146,4
"381",80,"[24]vHoImoHcowHnJHGqKCpwijxc",276,0.99639,24,277,1,276,1,1,0,1,1,132,131,145,145,4
"382",81,"[24]vHoImoHcowHnJHGqKCpwijxc",284,0.996491,24,285,1,284,1,1,0,1,1,146,145,139,139,4
"383",82,"[24]vHoImoHcowHnJHGqKCpwijxc",285,0.996503,24,286,1,285,1,1,0,1,1,139,138,147,147,4
"384",83,"[24]vHoImoHcowHnJHGqKCpwijxc",278,0.996416,24,279,1,278,1,1,0,1,1,135,134,144,144,4
"385",84,"[24]vHoImoHcowHnJHGqKCpwijxc",279,0.996429,24,280,1,279,1,1,0,1,1,136,135,144,144,4
"386",85,"[24]vHoImoHcowHnJHGqKCpwijxc",276,0.99639,24,277,1,276,1,1,0,1,1,126,125,151,151,4
"387",86,"[24]vHoImoHcowHnJHGqKCpwijxc",284,0.996491,24,285,1,284,1,1,0,1,1,152,151,133,133,4
"388",87,"[24]vHoImoHcowHnJHGqKCpwijxc",285,0.996503,24,286,1,285,1,1,0,1,1,135,134,151,151,4
"389",88,"[24]vHoImoHcowHnJHGqKCpwijxc",274,0.996364,24,275,1,274,1,1,0,1,1,125,124,150,150,4
"390",89,"[24]vHoImoHcowHnJHGqKCpwijxc",273,0.99635,24,274,1,273,1,1,0,1,1,128,127,146,146,4
"391",90,"[24]vHoImoHcowHnJHGqKCpwijxc",282,0.996466,24,283,1,282,1,1,0,1,1,153,152,130,130,4
"392",91,"[24]vHoImoHcowHnJHGqKCpwijxc",278,0.996416,24,279,1,278,1,1,0,1,1,123,122,156,156,4
"393",92,"[24]vHoImoHcowHnJHGqKCpwijxc",274,0.996364,24,275,1,274,1,1,0,1,1,141,140,134,134,4
"394",93,"[24]vHoImoHcowHnJHGqKCpwijxc",281,0.996454,24,282,1,281,1,1,0,1,1,148,147,134,134,4
"395",94,"[24]vHoImoHcowHnJHGqKCpwijxc",285,0.996503,24,286,1,285,1,1,0,1,1,146,145,140,140,4
"396",95,"[24]vHoImoHcowHnJHGqKCpwijxc",281,0.996454,24,282,1,281,1,1,0,1,1,134,133,148,148,4
"397",96,"[24]vHoImoHcowHnJHGqKCpwijxc",280,0.996441,24,281,1,280,1,1,0,1,1,143,142,138,138,4
"398",97,"[24]vHoImoHcowHnJHGqKCpwijxc",280,0.996441,24,281,1,280,1,1,0,1,1,143,142,138,138,4
"399",98,"[24]vHoImoHcowHnJHGqKCpwijxc",281,0.996454,24,282,1,281,1,1,0,1,1,143,142,139,139,4
"400",99,"[24]vHoImoHcowHnJHGqKCpwijxc",279,0.996429,24,280,1,279,1,1,0,1,1,129,128,151,151,4
"401",0,"[25]iHoIoHceotHnJqGKCHGKuzsff",297,0.996644,25,298,1,297,1,1,0,1,1,156,155,142,142,5
"402",1,"[25]iHoIoHceotHnJqGKCHGKuzsff",292,0.996587,25,293,1,292,1,1,0,1,1,140,139,153,153,5
"403",2,"[25]iHoIoHceotHnJqGKCHGKuzsff",296,0.996633,25,297,1,296,1,1,0,1,1,149,148,148,148,5
"404",3,"[25]iHoIoHceotHnJqGKCHGKuzsff",292,0.996587,25,293,1,292,1,1,0,1,1,147,146,146,146,5
"405",4,"[25]iHoIoHceotHnJqGKCHGKuzsff",294,0.99661,25,295,1,294,1,1,0,1,1,144,143,151,151,5
"406",5,"[25]iHoIoHceotHnJqGKCHGKuzsff",300,0.996678,25,301,1,300,1,1,0,1,1,161,160,140,140,5
"407",6,"[25]iHoIoHceotHnJqGKCHGKuzsff",293,0.996599,25,294,1,293,1,1,0,1,1,156,155,138,138,5
"408",7,"[25]iHoIoHceotHnJqGKCHGKuzsff",291,0.996575,25,292,1,291,1,1,0,1,1,132,131,160,160,5
"409",8,"[25]iHoIoHceotHnJqGKCHGKuzsff",293,0.996599,25,294,1,293,1,1,0,1,1,144,143,150,150,5
"410",9,"[25]iHoIoHceotHnJqGKCHGKuzsff",290,0.996564,25,291,1,290,1,1,0,1,1,134,133,157,157,5
"411",10,"[25]iHoIoHceotHnJqGKCHGKuzsff",288,0.99654,25,289,1,288,1,1,0,1,1,133,132,156,156,5
"412",11,"[25]iHoIoHceotHnJqGKCHGKuzsff",288,0.99654,25,289,1,288,1,1,0,1,1,128,127,161,161,5
"413",12,"[25]iHoIoHceotHnJqGKCHGKuzsff",293,0.996599,25,294,1,293,1,1,0,1,1,147,146,147,147,5
"414",13,"[25]iHoIoHceotHnJqGKCHGKuzsff",299,0.996667,25,300,1,299,1,1,0,1,1,155,154,145,145,5
"415",14,"[25]iHoIoHceotHnJqGKCHGKuzsff",296,0.996633,25,297,1,296,1,1,0,1,1,149,148,148,148,5
"416",15,"[25]iHoIoHceotHnJqGKCHGKuzsff",300,0.996678,25,301,1,300,1,1,0,1,1,161,160,140,140,5
"417",16,"[25]iHoIoHceotHnJqGKCHGKuzsff",295,0.996622,25,296,1,295,1,1,0,1,1,162,161,134,134,5
"418",17,"[25]iHoIoHceotHnJqGKCHGKuzsff",296,0.996633,25,297,1,296,1,1,0,1,1,161,160,136,136,5
"419",18,"[25]iHoIoHceotHnJqGKCHGKuzsff",304,0.996721,25,305,1,304,1,1,0,1,1,173,172,132,132,5
"420",19,"[25]iHoIoHceotHnJqGKCHGKuzsff",295,0.996622,25,296,1,295,1,1,0,1,1,152,151,144,144,5
"421",20,"[25]iHoIoHceotHnJqGKCHGKuzsff",291,0.996575,25,292,1,291,1,1,0,1,1,140,139,152,152,5
"422",21,"[25]iHoIoHceotHnJqGKCHGKuzsff",293,0.996599,25,294,1,293,1,1,0,1,1,141,140,153,153,5
"423",22,"[25]iHoIoHceotHnJqGKCHGKuzsff",298,0.996656,25,299,1,298,1,1,0,1,1,156,155,143,143,5
"424",23,"[25]iHoIoHceotHnJqGKCHGKuzsff",289,0.996552,25,290,1,289,1,1,0,1,1,129,128,161,161,5
"425",24,"[25]iHoIoHceotHnJqGKCHGKuzsff",299,0.996667,25,300,1,299,1,1,0,1,1,157,156,143,143,5
"426",25,"[25]iHoIoHceotHnJqGKCHGKuzsff",293,0.996599,25,294,1,293,1,1,0,1,1,142,141,152,152,5
"427",26,"[25]iHoIoHceotHnJqGKCHGKuzsff",299,0.996667,25,300,1,299,1,1,0,1,1,157,156,143,143,5
"428",27,"[25]iHoIoHceotHnJqGKCHGKuzsff",294,0.99661,25,295,1,294,1,1,0,1,1,143,142,152,152,5
"429",28,"[25]iHoIoHceotHnJqGKCHGKuzsff",303,0.996711,25,304,1,303,1,1,0,1,1,179,178,125,125,5
"430",29,"[25]iHoIoHceotHnJqGKCHGKuzsff",286,0.996516,25,287,1,286,1,1,0,1,1,132,131,155,155,5
"431",30,"[25]iHoIoHceotHnJqGKCHGKuzsff",303,0.996711,25,304,1,303,1,1,0,1,1,171,170,133,133,5
"432",31,"[25]iHoIoHceotHnJqGKCHGKuzsff",296,0.996633,25,297,1,296,1,1,0,1,1,148,147,149,149,5
"433",32,"[25]iHoIoHceotHnJqGKCHGKuzsff",296,0.996633,25,297,1,296,1,1,0,1,1,150,149,147,147,5
"434",33,"[25]iHoIoHceotHnJqGKCHGKuzsff",300,0.996678,25,301,1,300,1,1,0,1,1,160,159,141,141,5
"435",34,"[25]iHoIoHceotHnJqGKCHGKuzsff",296,0.996633,25,297,1,296,1,1,0,1,1,153,152,144,144,5
"436",35,"[25]iHoIoHceotHnJqGKCHGKuzsff",296,0.996633,25,297,1,296,1,1,0,1,1,151,150,146,146,5
"437",36,"[25]iHoIoHceotHnJqGKCHGKuzsff",301,0.996689,25,302,1,301,1,1,0,1,1,163,162,139,139,5
"438",37,"[25]iHoIoHceotHnJqGKCHGKuzsff",296,0.996633,25,297,1,296,1,1,0,1,1,148,147,149,149,5
"439",38,"[25]iHoIoHceotHnJqGKCHGKuzsff",298,0.996656,25,299,1,298,1,1,0,1,1,160,159,139,139,5
"440",39,"[25]iHoIoHceotHnJqGKCHGKuzsff",295,0.996622,25,296,1,295,1,1,0,1,1,144,143,152,152,5
"441",40,"[25]iHoIoHceotHnJqGKCHGKuzsff",297,0.996644,25,298,1,297,1,1,0,1,1,147,146,151,151,5
"442",41,"[25]iHoIoHceotHnJqGKCHGKuzsff",302,0.9967,25,303,1,302,1,1,0,1,1,168,167,135,135,5
"443",42,"[25]iHoIoHceotHnJqGKCHGKuzsff",298,0.996656,25,299,1,298,1,1,0,1,1,155,154,144,144,5
"444",43,"[25]iHoIoHceotHnJqGKCHGKuzsff",293,0.996599,25,294,1,293,1,1,0,1,1,148,147,146,146,5
"445",44,"[25]iHoIoHceotHnJqGKCHGKuzsff",296,0.996633,25,297,1,296,1,1,0,1,1,153,152,144,144,5
"446",45,"[25]iHoIoHceotHnJqGKCHGKuzsff",301,0.996689,25,302,1,301,1,1,0,1,1,161,160,141,141,5
"447",46,"[25]iHoIoHceotHnJqGKCHGKuzsff",301,0.996689,25,302,1,301,1,1,0,1,1,168,167,134,134,5
"448",47,"[25]iHoIoHceotHnJqGKCHGKuzsff",294,0.99661,25,295,1,294,1,1,0,1,1,151,150,144,144,5
"449",48,"[25]iHoIoHceotHnJqGKCHGKuzsff",296,0.996633,25,297,1,296,1,1,0,1,1,150,149,147,147,5
"450",49,"[25]iHoIoHceotHnJqGKCHGKuzsff",302,0.9967,25,303,1,302,1,1,0,1,1,160,159,143,143,5
"451",50,"[25]iHoIoHceotHnJqGKCHGKuzsff",294,0.99661,25,295,1,294,1,1,0,1,1,145,144,150,150,5
"452",51,"[25]iHoIoHceotHnJqGKCHGKuzsff",301,0.996689,25,302,1,301,1,1,0,1,1,162,161,140,140,5
"453",52,"[25]iHoIoHceotHnJqGKCHGKuzsff",296,0.996633,25,297,1,296,1,1,0,1,1,154,153,143,143,5
"454",53,"[25]iHoIoHceotHnJqGKCHGKuzsff",296,0.996633,25,297,1,296,1,1,0,1,1,146,145,151,151,5
"455",54,"[25]iHoIoHceotHnJqGKCHGKuzsff",302,0.9967,25,303,1,302,1,1,0,1,1,158,157,145,145,5
"456",55,"[25]iHoIoHceotHnJqGKCHGKuzsff",298,0.996656,25,299,1,298,1,1,0,1,1,156,155,143,143,5
"457",56,"[25]iHoIoHceotHnJqGKCHGKuzsff",298,0.996656,25,299,1,298,1,1,0,1,1,149,148,150,150,5
"458",57,"[25]iHoIoHceotHnJqGKCHGKuzsff",300,0.996678,25,301,1,300,1,1,0,1,1,158,157,143,143,5
"459",58,"[25]iHoIoHceotHnJqGKCHGKuzsff",291,0.996575,25,292,1,291,1,1,0,1,1,133,132,159,159,5
"460",59,"[25]iHoIoHceotHnJqGKCHGKuzsff",297,0.996644,25,298,1,297,1,1,0,1,1,148,147,150,150,5
"461",60,"[25]iHoIoHceotHnJqGKCHGKuzsff",294,0.99661,25,295,1,294,1,1,0,1,1,142,141,153,153,5
"462",61,"[25]iHoIoHceotHnJqGKCHGKuzsff",292,0.996587,25,293,1,292,1,1,0,1,1,143,142,150,150,5
"463",62,"[25]iHoIoHceotHnJqGKCHGKuzsff",298,0.996656,25,299,1,298,1,1,0,1,1,155,154,144,144,5
"464",63,"[25]iHoIoHceotHnJqGKCHGKuzsff",295,0.996622,25,296,1,295,1,1,0,1,1,144,143,152,152,5
"465",64,"[25]iHoIoHceotHnJqGKCHGKuzsff",295,0.996622,25,296,1,295,1,1,0,1,1,152,151,144,144,5
"466",65,"[25]iHoIoHceotHnJqGKCHGKuzsff",303,0.996711,25,304,1,303,1,1,0,1,1,163,162,141,141,5
"467",66,"[25]iHoIoHceotHnJqGKCHGKuzsff",286,0.996516,25,287,1,286,1,1,0,1,1,129,128,158,158,5
"468",67,"[25]iHoIoHceotHnJqGKCHGKuzsff",290,0.996564,25,291,1,290,1,1,0,1,1,131,130,160,160,5
"469",68,"[25]iHoIoHceotHnJqGKCHGKuzsff",299,0.996667,25,300,1,299,1,1,0,1,1,159,158,141,141,5
"470",69,"[25]iHoIoHceotHnJqGKCHGKuzsff",294,0.99661,25,295,1,294,1,1,0,1,1,144,143,151,151,5
"471",70,"[25]iHoIoHceotHnJqGKCHGKuzsff",302,0.9967,25,303,1,302,1,1,0,1,1,163,162,140,140,5
"472",71,"[25]iHoIoHceotHnJqGKCHGKuzsff",297,0.996644,25,298,1,297,1,1,0,1,1,159,158,139,139,5
"473",72,"[25]iHoIoHceotHnJqGKCHGKuzsff",297,0.996644,25,298,1,297,1,1,0,1,1,157,156,141,141,5
"474",73,"[25]iHoIoHceotHnJqGKCHGKuzsff",293,0.996599,25,294,1,293,1,1,0,1,1,151,150,143,143,5
"475",74,"[25]iHoIoHceotHnJqGKCHGKuzsff",297,0.996644,25,298,1,297,1,1,0,1,1,151,150,147,147,5
"476",75,"[25]iHoIoHceotHnJqGKCHGKuzsff",293,0.996599,25,294,1,293,1,1,0,1,1,143,142,151,151,5
"477",76,"[25]iHoIoHceotHnJqGKCHGKuzsff",298,0.996656,25,299,1,298,1,1,0,1,1,154,153,145,145,5
"478",77,"[25]iHoIoHceotHnJqGKCHGKuzsff",297,0.996644,25,298,1,297,1,1,0,1,1,152,151,146,146,5
"479",78,"[25]iHoIoHceotHnJqGKCHGKuzsff",293,0.996599,25,294,1,293,1,1,0,1,1,143,142,151,151,5
"480",79,"[25]iHoIoHceotHnJqGKCHGKuzsff",298,0.996656,25,299,1,298,1,1,0,1,1,150,149,149,149,5
"481",80,"[25]iHoIoHceotHnJqGKCHGKuzsff",302,0.9967,25,303,1,302,1,1,0,1,1,163,162,140,140,5
"482",81,"[25]iHoIoHceotHnJqGKCHGKuzsff",292,0.996587,25,293,1,292,1,1,0,1,1,140,139,153,153,5
"483",82,"[25]iHoIoHceotHnJqGKCHGKuzsff",291,0.996575,25,292,1,291,1,1,0,1,1,129,128,163,163,5
"484",83,"[25]iHoIoHceotHnJqGKCHGKuzsff",301,0.996689,25,302,1,301,1,1,0,1,1,168,167,134,134,5
"485",84,"[25]iHoIoHceotHnJqGKCHGKuzsff",301,0.996689,25,302,1,301,1,1,0,1,1,169,168,133,133,5
"486",85,"[25]iHoIoHceotHnJqGKCHGKuzsff",296,0.996633,25,297,1,296,1,1,0,1,1,149,148,148,148,5
"487",86,"[25]iHoIoHceotHnJqGKCHGKuzsff",296,0.996633,25,297,1,296,1,1,0,1,1,150,149,147,147,5
"488",87,"[25]iHoIoHceotHnJqGKCHGKuzsff",297,0.996644,25,298,1,297,1,1,0,1,1,154,153,144,144,5
"489",88,"[25]iHoIoHceotHnJqGKCHGKuzsff",296,0.996633,25,297,1,296,1,1,0,1,1,149,148,148,148,5
"490",89,"[25]iHoIoHceotHnJqGKCHGKuzsff",300,0.996678,25,301,1,300,1,1,0,1,1,165,164,136,136,5
"491",90,"[25]iHoIoHceotHnJqGKCHGKuzsff",288,0.99654,25,289,1,288,1,1,0,1,1,137,136,152,152,5
"492",91,"[25]iHoIoHceotHnJqGKCHGKuzsff",302,0.9967,25,303,1,302,1,1,0,1,1,173,172,130,130,5
"493",92,"[25]iHoIoHceotHnJqGKCHGKuzsff",295,0.996622,25,296,1,295,1,1,0,1,1,144,143,152,152,5
"494",93,"[25]iHoIoHceotHnJqGKCHGKuzsff",293,0.996599,25,294,1,293,1,1,0,1,1,139,138,155,155,5
"495",94,"[25]iHoIoHceotHnJqGKCHGKuzsff",291,0.996575,25,292,1,291,1,1,0,1,1,141,140,151,151,5
"496",95,"[25]iHoIoHceotHnJqGKCHGKuzsff",291,0.996575,25,292,1,291,1,1,0,1,1,135,134,157,157,5
"497",96,"[25]iHoIoHceotHnJqGKCHGKuzsff",299,0.996667,25,300,1,299,1,1,0,1,1,162,161,138,138,5
"498",97,"[25]iHoIoHceotHnJqGKCHGKuzsff",294,0.99661,25,295,1,294,1,1,0,1,1,144,143,151,151,5
"499",98,"[25]iHoIoHceotHnJqGKCHGKuzsff",299,0.996667,25,300,1,299,1,1,0,1,1,157,156,143,143,5
"500",99,"[25]iHoIoHceotHnJqGKCHGKuzsff",293,0.996599,25,294,1,293,1,1,0,1,1,143,142,151,151,5
"501",0,"[25]qxHoIoHcouHnJHGqKCjovkbJz",286,0.996516,25,287,1,286,1,1,0,1,1,141,140,146,146,6
"502",1,"[25]qxHoIoHcouHnJHGqKCjovkbJz",277,0.996403,25,278,1,277,1,1,0,1,1,137,136,141,141,6
"503",2,"[25]qxHoIoHcouHnJHGqKCjovkbJz",280,0.996441,25,281,1,280,1,1,0,1,1,133,132,148,148,6
"504",3,"[25]qxHoIoHcouHnJHGqKCjovkbJz",282,0.996466,25,283,1,282,1,1,0,1,1,139,138,144,144,6
"505",4,"[25]qxHoIoHcouHnJHGqKCjovkbJz",280,0.996441,25,281,1,280,1,1,0,1,1,140,139,141,141,6
"506",5,"[25]qxHoIoHcouHnJHGqKCjovkbJz",280,0.996441,25,281,1,280,1,1,0,1,1,142,141,139,139,6
"507",6,"[25]qxHoIoHcouHnJHGqKCjovkbJz",284,0.996491,25,285,1,284,1,1,0,1,1,149,148,136,136,6
"508",7,"[25]qxHoIoHcouHnJHGqKCjovkbJz",283,0.996479,25,284,1,283,1,1,0,1,1,129,128,155,155,6
"509",8,"[25]qxHoIoHcouHnJHGqKCjovkbJz",269,0.996296,25,270,1,269,1,1,0,1,1,122,121,148,148,6
"510",9,"[25]qxHoIoHcouHnJHGqKCjovkbJz",287,0.996528,25,288,1,287,1,1,0,1,1,148,147,140,140,6
"511",10,"[25]qxHoIoHcouHnJHGqKCjovkbJz",276,0.99639,25,277,1,276,1,1,0,1,1,141,140,136,136,6
"512",11,"[25]qxHoIoHcouHnJHGqKCjovkbJz",278,0.996416,25,279,1,278,1,1,0,1,1,130,129,149,149,6
"513",12,"[25]qxHoIoHcouHnJHGqKCjovkbJz",273,0.99635,25,274,1,273,1,1,0,1,1,129,128,145,145,6
"514",13,"[25]qxHoIoHcouHnJHGqKCjovkbJz",274,0.996364,25,275,1,274,1,1,0,1,1,141,140,134,134,6
"515",14,"[25]qxHoIoHcouHnJHGqKCjovkbJz",280,0.996441,25,281,1,280,1,1,0,1,1,148,147,133,133,6
"516",15,"[25]qxHoIoHcouHnJHGqKCjovkbJz",280,0.996441,25,281,1,280,1,1,0,1,1,127,126,154,154,6
"517",16,"[25]qxHoIoHcouHnJHGqKCjovkbJz",275,0.996377,25,276,1,275,1,1,0,1,1,149,148,127,127,6
"518",17,"[25]qxHoIoHcouHnJHGqKCjovkbJz",278,0.996416,25,279,1,278,1,1,0,1,1,133,132,146,146,6
"519",18,"[25]qxHoIoHcouHnJHGqKCjovkbJz",283,0.996479,25,284,1,283,1,1,0,1,1,138,137,146,146,6
"520",19,"[25]qxHoIoHcouHnJHGqKCjovkbJz",282,0.996466,25,283,1,282,1,1,0,1,1,147,146,136,136,6
"521",20,"[25]qxHoIoHcouHnJHGqKCjovkbJz",286,0.996516,25,287,1,286,1,1,0,1,1,152,151,135,135,6
"522",21,"[25]qxHoIoHcouHnJHGqKCjovkbJz",276,0.99639,25,277,1,276,1,1,0,1,1,147,146,130,130,6
"523",22,"[25]qxHoIoHcouHnJHGqKCjovkbJz",270,0.99631,25,271,1,270,1,1,0,1,1,137,136,134,134,6
"524",23,"[25]qxHoIoHcouHnJHGqKCjovkbJz",283,0.996479,25,284,1,283,1,1,0,1,1,156,155,128,128,6
"525",24,"[25]qxHoIoHcouHnJHGqKCjovkbJz",287,0.996528,25,288,1,287,1,1,0,1,1,147,146,141,141,6
"526",25,"[25]qxHoIoHcouHnJHGqKCjovkbJz",279,0.996429,25,280,1,279,1,1,0,1,1,141,140,139,139,6
"527",26,"[25]qxHoIoHcouHnJHGqKCjovkbJz",290,0.996564,25,291,1,290,1,1,0,1,1,146,145,145,145,6
"528",27,"[25]qxHoIoHcouHnJHGqKCjovkbJz",276,0.99639,25,277,1,276,1,1,0,1,1,139,138,138,138,6
"529",28,"[25]qxHoIoHcouHnJHGqKCjovkbJz",284,0.996491,25,285,1,284,1,1,0,1,1,133,132,152,152,6
"530",29,"[25]qxHoIoHcouHnJHGqKCjovkbJz",289,0.996552,25,290,1,289,1,1,0,1,1,150,149,140,140,6
"531",30,"[25]qxHoIoHcouHnJHGqKCjovkbJz",272,0.996337,25,273,1,272,1,1,0,1,1,134,133,139,139,6
"532",31,"[25]qxHoIoHcouHnJHGqKCjovkbJz",287,0.996528,25,288,1,287,1,1,0,1,1,135,134,153,153,6
"533",32,"[25]qxHoIoHcouHnJHGqKCjovkbJz",275,0.996377,25,276,1,275,1,1,0,1,1,130,129,146,146,6
"534",33,"[25]qxHoIoHcouHnJHGqKCjovkbJz",281,0.996454,25,282,1,281,1,1,0,1,1,140,139,142,142,6
"535",34,"[25]qxHoIoHcouHnJHGqKCjovkbJz",288,0.99654,25,289,1,288,1,1,0,1,1,140,139,149,149,6
"536",35,"[25]qxHoIoHcouHnJHGqKCjovkbJz",279,0.996429,25,280,1,279,1,1,0,1,1,132,131,148,148,6
"537",36,"[25]qxHoIoHcouHnJHGqKCjovkbJz",279,0.996429,25,280,1,279,1,1,0,1,1,135,134,145,145,6
"538",37,"[25]qxHoIoHcouHnJHGqKCjovkbJz",285,0.996503,25,286,1,285,1,1,0,1,1,130,129,156,156,6
"539",38,"[25]qxHoIoHcouHnJHGqKCjovkbJz",281,0.996454,25,282,1,281,1,1,0,1,1,147,146,135,135,6
"540",39,"[25]qxHoIoHcouHnJHGqKCjovkbJz",273,0.99635,25,274,1,273,1,1,0,1,1,126,125,148,148,6
"541",40,"[25]qxHoIoHcouHnJHGqKCjovkbJz",279,0.996429,25,280,1,279,1,1,0,1,1,149,148,131,131,6
"542",41,"[25]qxHoIoHcouHnJHGqKCjovkbJz",276,0.99639,25,277,1,276,1,1,0,1,1,142,141,135,135,6
"543",42,"[25]qxHoIoHcouHnJHGqKCjovkbJz",282,0.996466,25,283,1,282,1,1,0,1,1,140,139,143,143,6
"544",43,"[25]qxHoIoHcouHnJHGqKCjovkbJz",280,0.996441,25,281,1,280,1,1,0,1,1,155,154,126,126,6
"545",44,"[25]qxHoIoHcouHnJHGqKCjovkbJz",282,0.996466,25,283,1,282,1,1,0,1,1,134,133,149,149,6
"546",45,"[25]qxHoIoHcouHnJHGqKCjovkbJz",285,0.996503,25,286,1,285,1,1,0,1,1,149,148,137,137,6
"547",46,"[25]qxHoIoHcouHnJHGqKCjovkbJz",278,0.996416,25,279,1,278,1,1,0,1,1,133,132,146,146,6
"548",47,"[25]qxHoIoHcouHnJHGqKCjovkbJz",285,0.996503,25,286,1,285,1,1,0,1,1,155,154,131,131,6
"549",48,"[25]qxHoIoHcouHnJHGqKCjovkbJz",285,0.996503,25,286,1,285,1,1,0,1,1,149,148,137,137,6
"550",49,"[25]qxHoIoHcouHnJHGqKCjovkbJz",280,0.996441,25,281,1,280,1,1,0,1,1,143,142,138,138,6
"551",50,"[25]qxHoIoHcouHnJHGqKCjovkbJz",278,0.996416,25,279,1,278,1,1,0,1,1,146,145,133,133,6
"552",51,"[25]qxHoIoHcouHnJHGqKCjovkbJz",286,0.996516,25,287,1,286,1,1,0,1,1,140,139,147,147,6
"553",52,"[25]qxHoIoHcouHnJHGqKCjovkbJz",281,0.996454,25,282,1,281,1,1,0,1,1,157,156,125,125,6
"554",53,"[25]qxHoIoHcouHnJHGqKCjovkbJz",290,0.996564,25,291,1,290,1,1,0,1,1,169,168,122,122,6
"555",54,"[25]qxHoIoHcouHnJHGqKCjovkbJz",287,0.996528,25,288,1,287,1,1,0,1,1,154,153,134,134,6
"556",55,"[25]qxHoIoHcouHnJHGqKCjovkbJz",283,0.996479,25,284,1,283,1,1,0,1,1,135,134,149,149,6
"557",56,"[25]qxHoIoHcouHnJHGqKCjovkbJz",275,0.996377,25,276,1,275,1,1,0,1,1,131,130,145,145,6
"558",57,"[25]qxHoIoHcouHnJHGqKCjovkbJz",279,0.996429,25,280,1,279,1,1,0,1,1,142,141,138,138,6
"559",58,"[25]qxHoIoHcouHnJHGqKCjovkbJz",269,0.996296,25,270,1,269,1,1,0,1,1,148,147,122,122,6
"560",59,"[25]qxHoIoHcouHnJHGqKCjovkbJz",284,0.996491,25,285,1,284,1,1,0,1,1,159,158,126,126,6
"561",60,"[25]qxHoIoHcouHnJHGqKCjovkbJz",280,0.996441,25,281,1,280,1,1,0,1,1,135,134,146,146,6
"562",61,"[25]qxHoIoHcouHnJHGqKCjovkbJz",281,0.996454,25,282,1,281,1,1,0,1,1,144,143,138,138,6
"563",62,"[25]qxHoIoHcouHnJHGqKCjovkbJz",280,0.996441,25,281,1,280,1,1,0,1,1,140,139,141,141,6
"564",63,"[25]qxHoIoHcouHnJHGqKCjovkbJz",280,0.996441,25,281,1,280,1,1,0,1,1,149,148,132,132,6
"565",64,"[25]qxHoIoHcouHnJHGqKCjovkbJz",281,0.996454,25,282,1,281,1,1,0,1,1,139,138,143,143,6
"566",65,"[25]qxHoIoHcouHnJHGqKCjovkbJz",283,0.996479,25,284,1,283,1,1,0,1,1,147,146,137,137,6
"567",66,"[25]qxHoIoHcouHnJHGqKCjovkbJz",288,0.99654,25,289,1,288,1,1,0,1,1,151,150,138,138,6
"568",67,"[25]qxHoIoHcouHnJHGqKCjovkbJz",279,0.996429,25,280,1,279,1,1,0,1,1,132,131,148,148,6
"569",68,"[25]qxHoIoHcouHnJHGqKCjovkbJz",277,0.996403,25,278,1,277,1,1,0,1,1,140,139,138,138,6
"570",69,"[25]qxHoIoHcouHnJHGqKCjovkbJz",283,0.996479,25,284,1,283,1,1,0,1,1,153,152,131,131,6
"571",70,"[25]qxHoIoHcouHnJHGqKCjovkbJz",288,0.99654,25,289,1,288,1,1,0,1,1,139,138,150,150,6
"572",71,"[25]qxHoIoHcouHnJHGqKCjovkbJz",276,0.99639,25,277,1,276,1,1,0,1,1,137,136,140,140,6
"573",72,"[25]qxHoIoHcouHnJHGqKCjovkbJz",281,0.996454,25,282,1,281,1,1,0,1,1,145,144,137,137,6
"574",73,"[25]qxHoIoHcouHnJHGqKCjovkbJz",285,0.996503,25,286,1,285,1,1,0,1,1,150,149,136,136,6
"575",74,"[25]qxHoIoHcouHnJHGqKCjovkbJz",275,0.996377,25,276,1,275,1,1,0,1,1,138,137,138,138,6
"576",75,"[25]qxHoIoHcouHnJHGqKCjovkbJz",277,0.996403,25,278,1,277,1,1,0,1,1,130,129,148,148,6
"577",76,"[25]qxHoIoHcouHnJHGqKCjovkbJz",277,0.996403,25,278,1,277,1,1,0,1,1,136,135,142,142,6
"578",77,"[25]qxHoIoHcouHnJHGqKCjovkbJz",274,0.996364,25,275,1,274,1,1,0,1,1,131,130,144,144,6
"579",78,"[25]qxHoIoHcouHnJHGqKCjovkbJz",284,0.996491,25,285,1,284,1,1,0,1,1,147,146,138,138,6
"580",79,"[25]qxHoIoHcouHnJHGqKCjovkbJz",286,0.996516,25,287,1,286,1,1,0,1,1,159,158,128,128,6
"581",80,"[25]qxHoIoHcouHnJHGqKCjovkbJz",280,0.996441,25,281,1,280,1,1,0,1,1,141,140,140,140,6
"582",81,"[25]qxHoIoHcouHnJHGqKCjovkbJz",279,0.996429,25,280,1,279,1,1,0,1,1,130,129,150,150,6
"583",82,"[25]qxHoIoHcouHnJHGqKCjovkbJz",277,0.996403,25,278,1,277,1,1,0,1,1,147,146,131,131,6
"584",83,"[25]qxHoIoHcouHnJHGqKCjovkbJz",271,0.996324,25,272,1,271,1,1,0,1,1,122,121,150,150,6
"585",84,"[25]qxHoIoHcouHnJHGqKCjovkbJz",284,0.996491,25,285,1,284,1,1,0,1,1,153,152,132,132,6
"586",85,"[25]qxHoIoHcouHnJHGqKCjovkbJz",280,0.996441,25,281,1,280,1,1,0,1,1,144,143,137,137,6
"587",86,"[25]qxHoIoHcouHnJHGqKCjovkbJz",283,0.996479,25,284,1,283,1,1,0,1,1,150,149,134,134,6
"588",87,"[25]qxHoIoHcouHnJHGqKCjovkbJz",277,0.996403,25,278,1,277,1,1,0,1,1,133,132,145,145,6
"589",88,"[25]qxHoIoHcouHnJHGqKCjovkbJz",288,0.99654,25,289,1,288,1,1,0,1,1,162,161,127,127,6
"590",89,"[25]qxHoIoHcouHnJHGqKCjovkbJz",282,0.996466,25,283,1,282,1,1,0,1,1,141,140,142,142,6
"591",90,"[25]qxHoIoHcouHnJHGqKCjovkbJz",282,0.996466,25,283,1,282,1,1,0,1,1,148,147,135,135,6
"592",91,"[25]qxHoIoHcouHnJHGqKCjovkbJz",284,0.996491,25,285,1,284,1,1,0,1,1,143,142,142,142,6
"593",92,"[25]qxHoIoHcouHnJHGqKCjovkbJz",284,0.996491,25,285,1,284,1,1,0,1,1,140,139,145,145,6
"594",93,"[25]qxHoIoHcouHnJHGqKCjovkbJz",283,0.996479,25,284,1,283,1,1,0,1,1,150,149,134,134,6
"595",94,"[25]qxHoIoHcouHnJHGqKCjovkbJz",281,0.996454,25,282,1,281,1,1,0,1,1,143,142,139,139,6
"596",95,"[25]qxHoIoHcouHnJHGqKCjovkbJz",282,0.996466,25,283,1,282,1,1,0,1,1,139,138,144,144,6
"597",96,"[25]qxHoIoHcouHnJHGqKCjovkbJz",277,0.996403,25,278,1,277,1,1,0,1,1,134,133,144,144,6
"598",97,"[25]qxHoIoHcouHnJHGqKCjovkbJz",278,0.996416,25,279,1,278,1,1,0,1,1,141,140,138,138,6
"599",98,"[25]qxHoIoHcouHnJHGqKCjovkbJz",279,0.996429,25,280,1,279,1,1,0,1,1,131,130,149,149,6
"600",99,"[25]qxHoIoHcouHnJHGqKCjovkbJz",276,0.99639,25,277,1,276,1,1,0,1,1,135,134,142,142,6
"601",0,"[23]sHoIoHcoxHnJqGKCrimkroe",294,0.99661,23,295,1,294,1,1,0,1,1,141,140,154,154,7
"602",1,"[23]sHoIoHcoxHnJqGKCrimkroe",298,0.996656,23,299,1,298,1,1,0,1,1,153,152,146,146,7
"603",2,"[23]sHoIoHcoxHnJqGKCrimkroe",293,0.996599,23,294,1,293,1,1,0,1,1,143,142,151,151,7
"604",3,"[23]sHoIoHcoxHnJqGKCrimkroe",293,0.996599,23,294,1,293,1,1,0,1,1,135,134,159,159,7
"605",4,"[23]sHoIoHcoxHnJqGKCrimkroe",300,0.996678,23,301,1,300,1,1,0,1,1,161,160,140,140,7
"606",5,"[23]sHoIoHcoxHnJqGKCrimkroe",288,0.99654,23,289,1,288,1,1,0,1,1,124,123,165,165,7
"607",6,"[23]sHoIoHcoxHnJqGKCrimkroe",299,0.996667,23,300,1,299,1,1,0,1,1,154,153,146,146,7
"608",7,"[23]sHoIoHcoxHnJqGKCrimkroe",300,0.996678,23,301,1,300,1,1,0,1,1,163,162,138,138,7
"609",8,"[23]sHoIoHcoxHnJqGKCrimkroe",297,0.996644,23,298,1,297,1,1,0,1,1,154,153,144,144,7
"610",9,"[23]sHoIoHcoxHnJqGKCrimkroe",298,0.996656,23,299,1,298,1,1,0,1,1,156,155,143,143,7
"611",10,"[23]sHoIoHcoxHnJqGKCrimkroe",295,0.996622,23,296,1,295,1,1,0,1,1,149,148,147,147,7
"612",11,"[23]sHoIoHcoxHnJqGKCrimkroe",293,0.996599,23,294,1,293,1,1,0,1,1,137,136,157,157,7
"613",12,"[23]sHoIoHcoxHnJqGKCrimkroe",296,0.996633,23,297,1,296,1,1,0,1,1,151,150,146,146,7
"614",13,"[23]sHoIoHcoxHnJqGKCrimkroe",298,0.996656,23,299,1,298,1,1,0,1,1,149,148,150,150,7
"615",14,"[23]sHoIoHcoxHnJqGKCrimkroe",294,0.99661,23,295,1,294,1,1,0,1,1,148,147,147,147,7
"616",15,"[23]sHoIoHcoxHnJqGKCrimkroe",302,0.9967,23,303,1,302,1,1,0,1,1,164,163,139,139,7
"617",16,"[23]sHoIoHcoxHnJqGKCrimkroe",292,0.996587,23,293,1,292,1,1,0,1,1,141,140,152,152,7
"618",17,"[23]sHoIoHcoxHnJqGKCrimkroe",288,0.99654,23,289,1,288,1,1,0,1,1,124,123,165,165,7
"619",18,"[23]sHoIoHcoxHnJqGKCrimkroe",289,0.996552,23,290,1,289,1,1,0,1,1,128,127,162,162,7
"620",19,"[23]sHoIoHcoxHnJqGKCrimkroe",301,0.996689,23,302,1,301,1,1,0,1,1,163,162,139,139,7
"621",20,"[23]sHoIoHcoxHnJqGKCrimkroe",295,0.996622,23,296,1,295,1,1,0,1,1,144,143,152,152,7
"622",21,"[23]sHoIoHcoxHnJqGKCrimkroe",286,0.996516,23,287,1,286,1,1,0,1,1,126,125,161,161,7
"623",22,"[23]sHoIoHcoxHnJqGKCrimkroe",299,0.996667,23,300,1,299,1,1,0,1,1,159,158,141,141,7
"624",23,"[23]sHoIoHcoxHnJqGKCrimkroe",297,0.996644,23,298,1,297,1,1,0,1,1,152,151,146,146,7
"625",24,"[23]sHoIoHcoxHnJqGKCrimkroe",299,0.996667,23,300,1,299,1,1,0,1,1,161,160,139,139,7
"626",25,"[23]sHoIoHcoxHnJqGKCrimkroe",299,0.996667,23,300,1,299,1,1,0,1,1,150,149,150,150,7
"627",26,"[23]sHoIoHcoxHnJqGKCrimkroe",294,0.99661,23,295,1,294,1,1,0,1,1,143,142,152,152,7
"628",27,"[23]sHoIoHcoxHnJqGKCrimkroe",298,0.996656,23,299,1,298,1,1,0,1,1,150,149,149,149,7
"629",28,"[23]sHoIoHcoxHnJqGKCrimkroe",298,0.996656,23,299,1,298,1,1,0,1,1,156,155,143,143,7
"630",29,"[23]sHoIoHcoxHnJqGKCrimkroe",297,0.996644,23,298,1,297,1,1,0,1,1,150,149,148,148,7
"631",30,"[23]sHoIoHcoxHnJqGKCrimkroe",295,0.996622,23,296,1,295,1,1,0,1,1,148,147,148,148,7
"632",31,"[23]sHoIoHcoxHnJqGKCrimkroe",296,0.996633,23,297,1,296,1,1,0,1,1,149,148,148,148,7
"633",32,"[23]sHoIoHcoxHnJqGKCrimkroe",299,0.996667,23,300,1,299,1,1,0,1,1,161,160,139,139,7
"634",33,"[23]sHoIoHcoxHnJqGKCrimkroe",297,0.996644,23,298,1,297,1,1,0,1,1,151,150,147,147,7
"635",34,"[23]sHoIoHcoxHnJqGKCrimkroe",296,0.996633,23,297,1,296,1,1,0,1,1,159,158,138,138,7
"636",35,"[23]sHoIoHcoxHnJqGKCrimkroe",295,0.996622,23,296,1,295,1,1,0,1,1,146,145,150,150,7
"637",36,"[23]sHoIoHcoxHnJqGKCrimkroe",294,0.99661,23,295,1,294,1,1,0,1,1,146,145,149,149,7
"638",37,"[23]sHoIoHcoxHnJqGKCrimkroe",295,0.996622,23,296,1,295,1,1,0,1,1,145,144,151,151,7
"639",38,"[23]sHoIoHcoxHnJqGKCrimkroe",293,0.996599,23,294,1,293,1,1,0,1,1,145,144,149,149,7
"640",39,"[23]sHoIoHcoxHnJqGKCrimkroe",292,0.996587,23,293,1,292,1,1,0,1,1,139,138,154,154,7
"641",40,"[23]sHoIoHcoxHnJqGKCrimkroe",299,0.996667,23,300,1,299,1,1,0,1,1,154,153,146,146,7
"642",41,"[23]sHoIoHcoxHnJqGKCrimkroe",290,0.996564,23,291,1,290,1,1,0,1,1,134,133,157,157,7
"643",42,"[23]sHoIoHcoxHnJqGKCrimkroe",294,0.99661,23,295,1,294,1,1,0,1,1,143,142,152,152,7
"644",43,"[23]sHoIoHcoxHnJqGKCrimkroe",296,0.996633,23,297,1,296,1,1,0,1,1,155,154,142,142,7
"645",44,"[23]sHoIoHcoxHnJqGKCrimkroe",290,0.996564,23,291,1,290,1,1,0,1,1,135,134,156,156,7
"646",45,"[23]sHoIoHcoxHnJqGKCrimkroe",301,0.996689,23,302,1,301,1,1,0,1,1,159,158,143,143,7
"647",46,"[23]sHoIoHcoxHnJqGKCrimkroe",300,0.996678,23,301,1,300,1,1,0,1,1,159,158,142,142,7
"648",47,"[23]sHoIoHcoxHnJqGKCrimkroe",299,0.996667,23,300,1,299,1,1,0,1,1,154,153,146,146,7
"649",48,"[23]sHoIoHcoxHnJqGKCrimkroe",289,0.996552,23,290,1,289,1,1,0,1,1,136,135,154,154,7
"650",49,"[23]sHoIoHcoxHnJqGKCrimkroe",298,0.996656,23,299,1,298,1,1,0,1,1,157,156,142,142,7
"651",50,"[23]sHoIoHcoxHnJqGKCrimkroe",291,0.996575,23,292,1,291,1,1,0,1,1,135,134,157,157,7
"652",51,"[23]sHoIoHcoxHnJqGKCrimkroe",301,0.996689,23,302,1,301,1,1,0,1,1,166,165,136,136,7
"653",52,"[23]sHoIoHcoxHnJqGKCrimkroe",296,0.996633,23,297,1,296,1,1,0,1,1,142,141,155,155,7
"654",53,"[23]sHoIoHcoxHnJqGKCrimkroe",302,0.9967,23,303,1,302,1,1,0,1,1,169,168,134,134,7
"655",54,"[23]sHoIoHcoxHnJqGKCrimkroe",288,0.99654,23,289,1,288,1,1,0,1,1,128,127,161,161,7
"656",55,"[23]sHoIoHcoxHnJqGKCrimkroe",291,0.996575,23,292,1,291,1,1,0,1,1,138,137,154,154,7
"657",56,"[23]sHoIoHcoxHnJqGKCrimkroe",294,0.99661,23,295,1,294,1,1,0,1,1,144,143,151,151,7
"658",57,"[23]sHoIoHcoxHnJqGKCrimkroe",293,0.996599,23,294,1,293,1,1,0,1,1,139,138,155,155,7
"659",58,"[23]sHoIoHcoxHnJqGKCrimkroe",295,0.996622,23,296,1,295,1,1,0,1,1,143,142,153,153,7
"660",59,"[23]sHoIoHcoxHnJqGKCrimkroe",293,0.996599,23,294,1,293,1,1,0,1,1,139,138,155,155,7
"661",60,"[23]sHoIoHcoxHnJqGKCrimkroe",294,0.99661,23,295,1,294,1,1,0,1,1,141,140,154,154,7
"662",61,"[23]sHoIoHcoxHnJqGKCrimkroe",299,0.996667,23,300,1,299,1,1,0,1,1,155,154,145,145,7
"663",62,"[23]sHoIoHcoxHnJqGKCrimkroe",293,0.996599,23,294,1,293,1,1,0,1,1,139,138,155,155,7
"664",63,"[23]sHoIoHcoxHnJqGKCrimkroe",292,0.996587,23,293,1,292,1,1,0,1,1,136,135,157,157,7
"665",64,"[23]sHoIoHcoxHnJqGKCrimkroe",292,0.996587,23,293,1,292,1,1,0,1,1,136,135,157,157,7
"666",65,"[23]sHoIoHcoxHnJqGKCrimkroe",300,0.996678,23,301,1,300,1,1,0,1,1,166,165,135,135,7
"667",66,"[23]sHoIoHcoxHnJqGKCrimkroe",296,0.996633,23,297,1,296,1,1,0,1,1,146,145,151,151,7
"668",67,"[23]sHoIoHcoxHnJqGKCrimkroe",301,0.996689,23,302,1,301,1,1,0,1,1,155,154,147,147,7
"669",68,"[23]sHoIoHcoxHnJqGKCrimkroe",304,0.996721,23,305,1,304,1,1,0,1,1,170,169,135,135,7
"670",69,"[23]sHoIoHcoxHnJqGKCrimkroe",289,0.996552,23,290,1,289,1,1,0,1,1,129,128,161,161,7
"671",70,"[23]sHoIoHcoxHnJqGKCrimkroe",298,0.996656,23,299,1,298,1,1,0,1,1,161,160,138,138,7
"672",71,"[23]sHoIoHcoxHnJqGKCrimkroe",298,0.996656,23,299,1,298,1,1,0,1,1,157,156,142,142,7
"673",72,"[23]sHoIoHcoxHnJqGKCrimkroe",303,0.996711,23,304,1,303,1,1,0,1,1,163,162,141,141,7
"674",73,"[23]sHoIoHcoxHnJqGKCrimkroe",293,0.996599,23,294,1,293,1,1,0,1,1,136,135,158,158,7
"675",74,"[23]sHoIoHcoxHnJqGKCrimkroe",290,0.996564,23,291,1,290,1,1,0,1,1,137,136,154,154,7
"676",75,"[23]sHoIoHcoxHnJqGKCrimkroe",295,0.996622,23,296,1,295,1,1,0,1,1,146,145,150,150,7
"677",76,"[23]sHoIoHcoxHnJqGKCrimkroe",299,0.996667,23,300,1,299,1,1,0,1,1,152,151,148,148,7
"678",77,"[23]sHoIoHcoxHnJqGKCrimkroe",297,0.996644,23,298,1,297,1,1,0,1,1,150,149,148,148,7
"679",78,"[23]sHoIoHcoxHnJqGKCrimkroe",297,0.996644,23,298,1,297,1,1,0,1,1,151,150,147,147,7
"680",79,"[23]sHoIoHcoxHnJqGKCrimkroe",301,0.996689,23,302,1,301,1,1,0,1,1,163,162,139,139,7
"681",80,"[23]sHoIoHcoxHnJqGKCrimkroe",291,0.996575,23,292,1,291,1,1,0,1,1,134,133,158,158,7
"682",81,"[23]sHoIoHcoxHnJqGKCrimkroe",288,0.99654,23,289,1,288,1,1,0,1,1,136,135,153,153,7
"683",82,"[23]sHoIoHcoxHnJqGKCrimkroe",290,0.996564,23,291,1,290,1,1,0,1,1,144,143,147,147,7
"684",83,"[23]sHoIoHcoxHnJqGKCrimkroe",297,0.996644,23,298,1,297,1,1,0,1,1,150,149,148,148,7
"685",84,"[23]sHoIoHcoxHnJqGKCrimkroe",291,0.996575,23,292,1,291,1,1,0,1,1,135,134,157,157,7
"686",85,"[23]sHoIoHcoxHnJqGKCrimkroe",296,0.996633,23,297,1,296,1,1,0,1,1,144,143,153,153,7
"687",86,"[23]sHoIoHcoxHnJqGKCrimkroe",303,0.996711,23,304,1,303,1,1,0,1,1,160,159,144,144,7
"688",87,"[23]sHoIoHcoxHnJqGKCrimkroe",297,0.996644,23,298,1,297,1,1,0,1,1,153,152,145,145,7
"689",88,"[23]sHoIoHcoxHnJqGKCrimkroe",294,0.99661,23,295,1,294,1,1,0,1,1,145,144,150,150,7
"690",89,"[23]sHoIoHcoxHnJqGKCrimkroe",291,0.996575,23,292,1,291,1,1,0,1,1,125,124,167,167,7
"691",90,"[23]sHoIoHcoxHnJqGKCrimkroe",303,0.996711,23,304,1,303,1,1,0,1,1,158,157,146,146,7
"692",91,"[23]sHoIoHcoxHnJqGKCrimkroe",292,0.996587,23,293,1,292,1,1,0,1,1,134,133,159,159,7
"693",92,"[23]sHoIoHcoxHnJqGKCrimkroe",298,0.996656,23,299,1,298,1,1,0,1,1,156,155,143,143,7
"694",93,"[23]sHoIoHcoxHnJqGKCrimkroe",300,0.996678,23,301,1,300,1,1,0,1,1,161,160,140,140,7
"695",94,"[23]sHoIoHcoxHnJqGKCrimkroe",299,0.996667,23,300,1,299,1,1,0,1,1,156,155,144,144,7
"696",95,"[23]sHoIoHcoxHnJqGKCrimkroe",297,0.996644,23,298,1,297,1,1,0,1,1,153,152,145,145,7
"697",96,"[23]sHoIoHcoxHnJqGKCrimkroe",297,0.996644,23,298,1,297,1,1,0,1,1,149,148,149,149,7
"698",97,"[23]sHoIoHcoxHnJqGKCrimkroe",301,0.996689,23,302,1,301,1,1,0,1,1,159,158,143,143,7
"699",98,"[23]sHoIoHcoxHnJqGKCrimkroe",295,0.996622,23,296,1,295,1,1,0,1,1,146,145,150,150,7
"700",99,"[23]sHoIoHcoxHnJqGKCrimkroe",301,0.996689,23,302,1,301,1,1,0,1,1,161,160,141,141,7
"701",0,"[26]ivoIoHcowHnJHGqKCkmfpeEJaJ",274,0.996364,26,275,1,274,1,1,0,1,1,122,121,153,153,11
"702",1,"[26]ivoIoHcowHnJHGqKCkmfpeEJaJ",283,0.996479,26,284,1,283,1,1,0,1,1,142,141,142,142,11
"703",2,"[26]ivoIoHcowHnJHGqKCkmfpeEJaJ",277,0.996403,26,278,1,277,1,1,0,1,1,140,139,138,138,11
"704",3,"[26]ivoIoHcowHnJHGqKCkmfpeEJaJ",286,0.996516,26,287,1,286,1,1,0,1,1,154,153,133,133,11
"705",4,"[26]ivoIoHcowHnJHGqKCkmfpeEJaJ",284,0.996491,26,285,1,284,1,1,0,1,1,134,133,151,151,11
"706",5,"[26]ivoIoHcowHnJHGqKCkmfpeEJaJ",284,0.996491,26,285,1,284,1,1,0,1,1,136,135,149,149,11
"707",6,"[26]ivoIoHcowHnJHGqKCkmfpeEJaJ",283,0.996479,26,284,1,283,1,1,0,1,1,166,165,118,118,11
"708",7,"[26]ivoIoHcowHnJHGqKCkmfpeEJaJ",281,0.996454,26,282,1,281,1,1,0,1,1,144,143,138,138,11
"709",8,"[26]ivoIoHcowHnJHGqKCkmfpeEJaJ",276,0.99639,26,277,1,276,1,1,0,1,1,149,148,128,128,11
"710",9,"[26]ivoIoHcowHnJHGqKCkmfpeEJaJ",279,0.996429,26,280,1,279,1,1,0,1,1,132,131,148,148,11
"711",10,"[26]ivoIoHcowHnJHGqKCkmfpeEJaJ",283,0.996479,26,284,1,283,1,1,0,1,1,142,141,142,142,11
"712",11,"[26]ivoIoHcowHnJHGqKCkmfpeEJaJ",276,0.99639,26,277,1,276,1,1,0,1,1,129,128,148,148,11
"713",12,"[26]ivoIoHcowHnJHGqKCkmfpeEJaJ",276,0.99639,26,277,1,276,1,1,0,1,1,153,152,124,124,11
"714",13,"[26]ivoIoHcowHnJHGqKCkmfpeEJaJ",280,0.996441,26,281,1,280,1,1,0,1,1,149,148,132,132,11
"715",14,"[26]ivoIoHcowHnJHGqKCkmfpeEJaJ",283,0.996479,26,284,1,283,1,1,0,1,1,151,150,133,133,11
"716",15,"[26]ivoIoHcowHnJHGqKCkmfpeEJaJ",271,0.996324,26,272,1,271,1,1,0,1,1,137,136,135,135,11
"717",16,"[26]ivoIoHcowHnJHGqKCkmfpeEJaJ",276,0.99639,26,277,1,276,1,1,0,1,1,132,131,145,145,11
"718",17,"[26]ivoIoHcowHnJHGqKCkmfpeEJaJ",279,0.996429,26,280,1,279,1,1,0,1,1,136,135,144,144,11
"719",18,"[26]ivoIoHcowHnJHGqKCkmfpeEJaJ",287,0.996528,26,288,1,287,1,1,0,1,1,159,158,129,129,11
"720",19,"[26]ivoIoHcowHnJHGqKCkmfpeEJaJ",278,0.996416,26,279,1,278,1,1,0,1,1,136,135,143,143,11
"721",20,"[26]ivoIoHcowHnJHGqKCkmfpeEJaJ",281,0.996454,26,282,1,281,1,1,0,1,1,138,137,144,144,11
"722",21,"[26]ivoIoHcowHnJHGqKCkmfpeEJaJ",278,0.996416,26,279,1,278,1,1,0,1,1,128,127,151,151,11
"723",22,"[26]ivoIoHcowHnJHGqKCkmfpeEJaJ",280,0.996441,26,281,1,280,1,1,0,1,1,135,134,146,146,11
"724",23,"[26]ivoIoHcowHnJHGqKCkmfpeEJaJ",284,0.996491,26,285,1,284,1,1,0,1,1,151,150,134,134,11
"725",24,"[26]ivoIoHcowHnJHGqKCkmfpeEJaJ",279,0.996429,26,280,1,279,1,1,0,1,1,138,137,142,142,11
"726",25,"[26]ivoIoHcowHnJHGqKCkmfpeEJaJ",280,0.996441,26,281,1,280,1,1,0,1,1,140,139,141,141,11
"727",26,"[26]ivoIoHcowHnJHGqKCkmfpeEJaJ",287,0.996528,26,288,1,287,1,1,0,1,1,152,151,136,136,11
"728",27,"[26]ivoIoHcowHnJHGqKCkmfpeEJaJ",278,0.996416,26,279,1,278,1,1,0,1,1,132,131,147,147,11
"729",28,"[26]ivoIoHcowHnJHGqKCkmfpeEJaJ",287,0.996528,26,288,1,287,1,1,0,1,1,134,133,154,154,11
"730",29,"[26]ivoIoHcowHnJHGqKCkmfpeEJaJ",281,0.996454,26,282,1,281,1,1,0,1,1,138,137,144,144,11
"731",30,"[26]ivoIoHcowHnJHGqKCkmfpeEJaJ",277,0.996403,26,278,1,277,1,1,0,1,1,140,139,138,138,11
"732",31,"[26]ivoIoHcowHnJHGqKCkmfpeEJaJ",281,0.996454,26,282,1,281,1,1,0,1,1,140,139,142,142,11
"733",32,"[26]ivoIoHcowHnJHGqKCkmfpeEJaJ",291,0.996575,26,292,1,291,1,1,0,1,1,152,151,140,140,11
"734",33,"[26]ivoIoHcowHnJHGqKCkmfpeEJaJ",282,0.996466,26,283,1,282,1,1,0,1,1,140,139,143,143,11
"735",34,"[26]ivoIoHcowHnJHGqKCkmfpeEJaJ",287,0.996528,26,288,1,287,1,1,0,1,1,144,143,144,144,11
"736",35,"[26]ivoIoHcowHnJHGqKCkmfpeEJaJ",279,0.996429,26,280,1,279,1,1,0,1,1,147,146,133,133,11
"737",36,"[26]ivoIoHcowHnJHGqKCkmfpeEJaJ",284,0.996491,26,285,1,284,1,1,0,1,1,149,148,136,136,11
"738",37,"[26]ivoIoHcowHnJHGqKCkmfpeEJaJ",282,0.996466,26,283,1,282,1,1,0,1,1,148,147,135,135,11
"739",38,"[26]ivoIoHcowHnJHGqKCkmfpeEJaJ",281,0.996454,26,282,1,281,1,1,0,1,1,139,138,143,143,11
"740",39,"[26]ivoIoHcowHnJHGqKCkmfpeEJaJ",280,0.996441,26,281,1,280,1,1,0,1,1,143,142,138,138,11
"741",40,"[26]ivoIoHcowHnJHGqKCkmfpeEJaJ",276,0.99639,26,277,1,276,1,1,0,1,1,127,126,150,150,11
"742",41,"[26]ivoIoHcowHnJHGqKCkmfpeEJaJ",270,0.99631,26,271,1,270,1,1,0,1,1,140,139,131,131,11
"743",42,"[26]ivoIoHcowHnJHGqKCkmfpeEJaJ",279,0.996429,26,280,1,279,1,1,0,1,1,127,126,153,153,11
"744",43,"[26]ivoIoHcowHnJHGqKCkmfpeEJaJ",281,0.996454,26,282,1,281,1,1,0,1,1,152,151,130,130,11
"745",44,"[26]ivoIoHcowHnJHGqKCkmfpeEJaJ",285,0.996503,26,286,1,285,1,1,0,1,1,145,144,141,141,11
"746",45,"[26]ivoIoHcowHnJHGqKCkmfpeEJaJ",284,0.996491,26,285,1,284,1,1,0,1,1,148,147,137,137,11
"747",46,"[26]ivoIoHcowHnJHGqKCkmfpeEJaJ",276,0.99639,26,277,1,276,1,1,0,1,1,135,134,142,142,11
"748",47,"[26]ivoIoHcowHnJHGqKCkmfpeEJaJ",274,0.996364,26,275,1,274,1,1,0,1,1,133,132,142,142,11
"749",48,"[26]ivoIoHcowHnJHGqKCkmfpeEJaJ",282,0.996466,26,283,1,282,1,1,0,1,1,140,139,143,143,11
"750",49,"[26]ivoIoHcowHnJHGqKCkmfpeEJaJ",278,0.996416,26,279,1,278,1,1,0,1,1,141,140,138,138,11
"751",50,"[26]ivoIoHcowHnJHGqKCkmfpeEJaJ",286,0.996516,26,287,1,286,1,1,0,1,1,146,145,141,141,11
"752",51,"[26]ivoIoHcowHnJHGqKCkmfpeEJaJ",285,0.996503,26,286,1,285,1,1,0,1,1,155,154,131,131,11
"753",52,"[26]ivoIoHcowHnJHGqKCkmfpeEJaJ",285,0.996503,26,286,1,285,1,1,0,1,1,153,152,133,133,11
"754",53,"[26]ivoIoHcowHnJHGqKCkmfpeEJaJ",276,0.99639,26,277,1,276,1,1,0,1,1,129,128,148,148,11
"755",54,"[26]ivoIoHcowHnJHGqKCkmfpeEJaJ",283,0.996479,26,284,1,283,1,1,0,1,1,147,146,137,137,11
"756",55,"[26]ivoIoHcowHnJHGqKCkmfpeEJaJ",279,0.996429,26,280,1,279,1,1,0,1,1,132,131,148,148,11
"757",56,"[26]ivoIoHcowHnJHGqKCkmfpeEJaJ",279,0.996429,26,280,1,279,1,1,0,1,1,142,141,138,138,11
"758",57,"[26]ivoIoHcowHnJHGqKCkmfpeEJaJ",280,0.996441,26,281,1,280,1,1,0,1,1,137,136,144,144,11
"759",58,"[26]ivoIoHcowHnJHGqKCkmfpeEJaJ",280,0.996441,26,281,1,280,1,1,0,1,1,139,138,142,142,11
"760",59,"[26]ivoIoHcowHnJHGqKCkmfpeEJaJ",276,0.99639,26,277,1,276,1,1,0,1,1,128,127,149,149,11
"761",60,"[26]ivoIoHcowHnJHGqKCkmfpeEJaJ",280,0.996441,26,281,1,280,1,1,0,1,1,142,141,139,139,11
"762",61,"[26]ivoIoHcowHnJHGqKCkmfpeEJaJ",288,0.99654,26,289,1,288,1,1,0,1,1,152,151,137,137,11
"763",62,"[26]ivoIoHcowHnJHGqKCkmfpeEJaJ",280,0.996441,26,281,1,280,1,1,0,1,1,145,144,136,136,11
"764",63,"[26]ivoIoHcowHnJHGqKCkmfpeEJaJ",289,0.996552,26,290,1,289,1,1,0,1,1,156,155,134,134,11
"765",64,"[26]ivoIoHcowHnJHGqKCkmfpeEJaJ",287,0.996528,26,288,1,287,1,1,0,1,1,150,149,138,138,11
"766",65,"[26]ivoIoHcowHnJHGqKCkmfpeEJaJ",287,0.996528,26,288,1,287,1,1,0,1,1,142,141,146,146,11
"767",66,"[26]ivoIoHcowHnJHGqKCkmfpeEJaJ",276,0.99639,26,277,1,276,1,1,0,1,1,128,127,149,149,11
"768",67,"[26]ivoIoHcowHnJHGqKCkmfpeEJaJ",286,0.996516,26,287,1,286,1,1,0,1,1,155,154,132,132,11
"769",68,"[26]ivoIoHcowHnJHGqKCkmfpeEJaJ",281,0.996454,26,282,1,281,1,1,0,1,1,128,127,154,154,11
"770",69,"[26]ivoIoHcowHnJHGqKCkmfpeEJaJ",287,0.996528,26,288,1,287,1,1,0,1,1,152,151,136,136,11
"771",70,"[26]ivoIoHcowHnJHGqKCkmfpeEJaJ",288,0.99654,26,289,1,288,1,1,0,1,1,137,136,152,152,11
"772",71,"[26]ivoIoHcowHnJHGqKCkmfpeEJaJ",277,0.996403,26,278,1,277,1,1,0,1,1,126,125,152,152,11
"773",72,"[26]ivoIoHcowHnJHGqKCkmfpeEJaJ",283,0.996479,26,284,1,283,1,1,0,1,1,134,133,150,150,11
"774",73,"[26]ivoIoHcowHnJHGqKCkmfpeEJaJ",278,0.996416,26,279,1,278,1,1,0,1,1,145,144,134,134,11
"775",74,"[26]ivoIoHcowHnJHGqKCkmfpeEJaJ",282,0.996466,26,283,1,282,1,1,0,1,1,136,135,147,147,11
"776",75,"[26]ivoIoHcowHnJHGqKCkmfpeEJaJ",285,0.996503,26,286,1,285,1,1,0,1,1,135,134,151,151,11
"777",76,"[26]ivoIoHcowHnJHGqKCkmfpeEJaJ",287,0.996528,26,288,1,287,1,1,0,1,1,138,137,150,150,11
"778",77,"[26]ivoIoHcowHnJHGqKCkmfpeEJaJ",287,0.996528,26,288,1,287,1,1,0,1,1,150,149,138,138,11
"779",78,"[26]ivoIoHcowHnJHGqKCkmfpeEJaJ",283,0.996479,26,284,1,283,1,1,0,1,1,145,144,139,139,11
"780",79,"[26]ivoIoHcowHnJHGqKCkmfpeEJaJ",278,0.996416,26,279,1,278,1,1,0,1,1,139,138,140,140,11
"781",80,"[26]ivoIoHcowHnJHGqKCkmfpeEJaJ",284,0.996491,26,285,1,284,1,1,0,1,1,153,152,132,132,11
"782",81,"[26]ivoIoHcowHnJHGqKCkmfpeEJaJ",287,0.996528,26,288,1,287,1,1,0,1,1,145,144,143,143,11
"783",82,"[26]ivoIoHcowHnJHGqKCkmfpeEJaJ",283,0.996479,26,284,1,283,1,1,0,1,1,141,140,143,143,11
"784",83,"[26]ivoIoHcowHnJHGqKCkmfpeEJaJ",291,0.996575,26,292,1,291,1,1,0,1,1,143,142,149,149,11
"785",84,"[26]ivoIoHcowHnJHGqKCkmfpeEJaJ",278,0.996416,26,279,1,278,1,1,0,1,1,150,149,129,129,11
"786",85,"[26]ivoIoHcowHnJHGqKCkmfpeEJaJ",274,0.996364,26,275,1,274,1,1,0,1,1,126,125,149,149,11
"787",86,"[26]ivoIoHcowHnJHGqKCkmfpeEJaJ",281,0.996454,26,282,1,281,1,1,0,1,1,145,144,137,137,11
"788",87,"[26]ivoIoHcowHnJHGqKCkmfpeEJaJ",288,0.99654,26,289,1,288,1,1,0,1,1,149,148,140,140,11
"789",88,"[26]ivoIoHcowHnJHGqKCkmfpeEJaJ",274,0.996364,26,275,1,274,1,1,0,1,1,127,126,148,148,11
"790",89,"[26]ivoIoHcowHnJHGqKCkmfpeEJaJ",280,0.996441,26,281,1,280,1,1,0,1,1,143,142,138,138,11
"791",90,"[26]ivoIoHcowHnJHGqKCkmfpeEJaJ",285,0.996503,26,286,1,285,1,1,0,1,1,139,138,147,147,11
"792",91,"[26]ivoIoHcowHnJHGqKCkmfpeEJaJ",276,0.99639,26,277,1,276,1,1,0,1,1,135,134,142,142,11
"793",92,"[26]ivoIoHcowHnJHGqKCkmfpeEJaJ",282,0.996466,26,283,1,282,1,1,0,1,1,143,142,140,140,11
"794",93,"[26]ivoIoHcowHnJHGqKCkmfpeEJaJ",278,0.996416,26,279,1,278,1,1,0,1,1,137,136,142,142,11
"795",94,"[26]ivoIoHcowHnJHGqKCkmfpeEJaJ",278,0.996416,26,279,1,278,1,1,0,1,1,141,140,138,138,11
"796",95,"[26]ivoIoHcowHnJHGqKCkmfpeEJaJ",287,0.996528,26,288,1,287,1,1,0,1,1,151,150,137,137,11
"797",96,"[26]ivoIoHcowHnJHGqKCkmfpeEJaJ",289,0.996552,26,290,1,289,1,1,0,1,1,156,155,134,134,11
"798",97,"[26]ivoIoHcowHnJHGqKCkmfpeEJaJ",282,0.996466,26,283,1,282,1,1,0,1,1,146,145,137,137,11
"799",98,"[26]ivoIoHcowHnJHGqKCkmfpeEJaJ",282,0.996466,26,283,1,282,1,1,0,1,1,143,142,140,140,11
"800",99,"[26]ivoIoHcowHnJHGqKCkmfpeEJaJ",274,0.996364,26,275,1,274,1,1,0,1,1,139,138,136,136,11
"801",0,"[23]goIaoHcouHnJHGqKCExcqoB",278,0.996416,23,279,1,278,1,1,0,1,1,150,149,129,129,12
"802",1,"[23]goIaoHcouHnJHGqKCExcqoB",284,0.996491,23,285,1,284,1,1,0,1,1,148,147,137,137,12
"803",2,"[23]goIaoHcouHnJHGqKCExcqoB",286,0.996516,23,287,1,286,1,1,0,1,1,147,146,140,140,12
"804",3,"[23]goIaoHcouHnJHGqKCExcqoB",285,0.996503,23,286,1,285,1,1,0,1,1,134,133,152,152,12
"805",4,"[23]goIaoHcouHnJHGqKCExcqoB",283,0.996479,23,284,1,283,1,1,0,1,1,138,137,146,146,12
"806",5,"[23]goIaoHcouHnJHGqKCExcqoB",287,0.996528,23,288,1,287,1,1,0,1,1,153,152,135,135,12
"807",6,"[23]goIaoHcouHnJHGqKCExcqoB",278,0.996416,23,279,1,278,1,1,0,1,1,135,134,144,144,12
"808",7,"[23]goIaoHcouHnJHGqKCExcqoB",279,0.996429,23,280,1,279,1,1,0,1,1,141,140,139,139,12
"809",8,"[23]goIaoHcouHnJHGqKCExcqoB",281,0.996454,23,282,1,281,1,1,0,1,1,154,153,128,128,12
"810",9,"[23]goIaoHcouHnJHGqKCExcqoB",271,0.996324,23,272,1,271,1,1,0,1,1,134,133,138,138,12
"811",10,"[23]goIaoHcouHnJHGqKCExcqoB",286,0.996516,23,287,1,286,1,1,0,1,1,150,149,137,137,12
"812",11,"[23]goIaoHcouHnJHGqKCExcqoB",283,0.996479,23,284,1,283,1,1,0,1,1,152,151,132,132,12
"813",12,"[23]goIaoHcouHnJHGqKCExcqoB",287,0.996528,23,288,1,287,1,1,0,1,1,164,163,124,124,12
"814",13,"[23]goIaoHcouHnJHGqKCExcqoB",278,0.996416,23,279,1,278,1,1,0,1,1,140,139,139,139,12
"815",14,"[23]goIaoHcouHnJHGqKCExcqoB",281,0.996454,23,282,1,281,1,1,0,1,1,138,137,144,144,12
"816",15,"[23]goIaoHcouHnJHGqKCExcqoB",272,0.996337,23,273,1,272,1,1,0,1,1,133,132,140,140,12
"817",16,"[23]goIaoHcouHnJHGqKCExcqoB",281,0.996454,23,282,1,281,1,1,0,1,1,138,137,144,144,12
"818",17,"[23]goIaoHcouHnJHGqKCExcqoB",282,0.996466,23,283,1,282,1,1,0,1,1,143,142,140,140,12
"819",18,"[23]goIaoHcouHnJHGqKCExcqoB",281,0.996454,23,282,1,281,1,1,0,1,1,146,145,136,136,12
"820",19,"[23]goIaoHcouHnJHGqKCExcqoB",289,0.996552,23,290,1,289,1,1,0,1,1,146,145,144,144,12
"821",20,"[23]goIaoHcouHnJHGqKCExcqoB",275,0.996377,23,276,1,275,1,1,0,1,1,137,136,139,139,12
"822",21,"[23]goIaoHcouHnJHGqKCExcqoB",280,0.996441,23,281,1,280,1,1,0,1,1,159,158,122,122,12
"823",22,"[23]goIaoHcouHnJHGqKCExcqoB",275,0.996377,23,276,1,275,1,1,0,1,1,144,143,132,132,12
"824",23,"[23]goIaoHcouHnJHGqKCExcqoB",276,0.99639,23,277,1,276,1,1,0,1,1,126,125,151,151,12
"825",24,"[23]goIaoHcouHnJHGqKCExcqoB",283,0.996479,23,284,1,283,1,1,0,1,1,146,145,138,138,12
"826",25,"[23]goIaoHcouHnJHGqKCExcqoB",288,0.99654,23,289,1,288,1,1,0,1,1,151,150,138,138,12
"827",26,"[23]goIaoHcouHnJHGqKCExcqoB",283,0.996479,23,284,1,283,1,1,0,1,1,129,128,155,155,12
"828",27,"[23]goIaoHcouHnJHGqKCExcqoB",291,0.996575,23,292,1,291,1,1,0,1,1,160,159,132,132,12
"829",28,"[23]goIaoHcouHnJHGqKCExcqoB",286,0.996516,23,287,1,286,1,1,0,1,1,148,147,139,139,12
"830",29,"[23]goIaoHcouHnJHGqKCExcqoB",284,0.996491,23,285,1,284,1,1,0,1,1,136,135,149,149,12
"831",30,"[23]goIaoHcouHnJHGqKCExcqoB",282,0.996466,23,283,1,282,1,1,0,1,1,145,144,138,138,12
"832",31,"[23]goIaoHcouHnJHGqKCExcqoB",283,0.996479,23,284,1,283,1,1,0,1,1,132,131,152,152,12
"833",32,"[23]goIaoHcouHnJHGqKCExcqoB",277,0.996403,23,278,1,277,1,1,0,1,1,136,135,142,142,12
"834",33,"[23]goIaoHcouHnJHGqKCExcqoB",280,0.996441,23,281,1,280,1,1,0,1,1,141,140,140,140,12
"835",34,"[23]goIaoHcouHnJHGqKCExcqoB",286,0.996516,23,287,1,286,1,1,0,1,1,140,139,147,147,12
"836",35,"[23]goIaoHcouHnJHGqKCExcqoB",277,0.996403,23,278,1,277,1,1,0,1,1,141,140,137,137,12
"837",36,"[23]goIaoHcouHnJHGqKCExcqoB",278,0.996416,23,279,1,278,1,1,0,1,1,153,152,126,126,12
"838",37,"[23]goIaoHcouHnJHGqKCExcqoB",278,0.996416,23,279,1,278,1,1,0,1,1,151,150,128,128,12
"839",38,"[23]goIaoHcouHnJHGqKCExcqoB",274,0.996364,23,275,1,274,1,1,0,1,1,126,125,149,149,12
"840",39,"[23]goIaoHcouHnJHGqKCExcqoB",284,0.996491,23,285,1,284,1,1,0,1,1,158,157,127,127,12
"841",40,"[23]goIaoHcouHnJHGqKCExcqoB",274,0.996364,23,275,1,274,1,1,0,1,1,150,149,125,125,12
"842",41,"[23]goIaoHcouHnJHGqKCExcqoB",285,0.996503,23,286,1,285,1,1,0,1,1,142,141,144,144,12
"843",42,"[23]goIaoHcouHnJHGqKCExcqoB",279,0.996429,23,280,1,279,1,1,0,1,1,139,138,141,141,12
"844",43,"[23]goIaoHcouHnJHGqKCExcqoB",280,0.996441,23,281,1,280,1,1,0,1,1,138,137,143,143,12
"845",44,"[23]goIaoHcouHnJHGqKCExcqoB",280,0.996441,23,281,1,280,1,1,0,1,1,134,133,147,147,12
"846",45,"[23]goIaoHcouHnJHGqKCExcqoB",283,0.996479,23,284,1,283,1,1,0,1,1,146,145,138,138,12
"847",46,"[23]goIaoHcouHnJHGqKCExcqoB",278,0.996416,23,279,1,278,1,1,0,1,1,149,148,130,130,12
"848",47,"[23]goIaoHcouHnJHGqKCExcqoB",278,0.996416,23,279,1,278,1,1,0,1,1,140,139,139,139,12
"849",48,"[23]goIaoHcouHnJHGqKCExcqoB",282,0.996466,23,283,1,282,1,1,0,1,1,148,147,135,135,12
"850",49,"[23]goIaoHcouHnJHGqKCExcqoB",277,0.996403,23,278,1,277,1,1,0,1,1,138,137,140,140,12
"851",50,"[23]goIaoHcouHnJHGqKCExcqoB",289,0.996552,23,290,1,289,1,1,0,1,1,151,150,139,139,12
"852",51,"[23]goIaoHcouHnJHGqKCExcqoB",281,0.996454,23,282,1,281,1,1,0,1,1,150,149,132,132,12
"853",52,"[23]goIaoHcouHnJHGqKCExcqoB",283,0.996479,23,284,1,283,1,1,0,1,1,144,143,140,140,12
"854",53,"[23]goIaoHcouHnJHGqKCExcqoB",281,0.996454,23,282,1,281,1,1,0,1,1,120,119,162,162,12
"855",54,"[23]goIaoHcouHnJHGqKCExcqoB",279,0.996429,23,280,1,279,1,1,0,1,1,131,130,149,149,12
"856",55,"[23]goIaoHcouHnJHGqKCExcqoB",279,0.996429,23,280,1,279,1,1,0,1,1,138,137,142,142,12
"857",56,"[23]goIaoHcouHnJHGqKCExcqoB",279,0.996429,23,280,1,279,1,1,0,1,1,132,131,148,148,12
"858",57,"[23]goIaoHcouHnJHGqKCExcqoB",278,0.996416,23,279,1,278,1,1,0,1,1,129,128,150,150,12
"859",58,"[23]goIaoHcouHnJHGqKCExcqoB",281,0.996454,23,282,1,281,1,1,0,1,1,150,149,132,132,12
"860",59,"[23]goIaoHcouHnJHGqKCExcqoB",277,0.996403,23,278,1,277,1,1,0,1,1,128,127,150,150,12
"861",60,"[23]goIaoHcouHnJHGqKCExcqoB",284,0.996491,23,285,1,284,1,1,0,1,1,146,145,139,139,12
"862",61,"[23]goIaoHcouHnJHGqKCExcqoB",288,0.99654,23,289,1,288,1,1,0,1,1,148,147,141,141,12
"863",62,"[23]goIaoHcouHnJHGqKCExcqoB",279,0.996429,23,280,1,279,1,1,0,1,1,132,131,148,148,12
"864",63,"[23]goIaoHcouHnJHGqKCExcqoB",276,0.99639,23,277,1,276,1,1,0,1,1,131,130,146,146,12
"865",64,"[23]goIaoHcouHnJHGqKCExcqoB",285,0.996503,23,286,1,285,1,1,0,1,1,146,145,140,140,12
"866",65,"[23]goIaoHcouHnJHGqKCExcqoB",280,0.996441,23,281,1,280,1,1,0,1,1,133,132,148,148,12
"867",66,"[23]goIaoHcouHnJHGqKCExcqoB",281,0.996454,23,282,1,281,1,1,0,1,1,127,126,155,155,12
"868",67,"[23]goIaoHcouHnJHGqKCExcqoB",279,0.996429,23,280,1,279,1,1,0,1,1,146,145,134,134,12
"869",68,"[23]goIaoHcouHnJHGqKCExcqoB",282,0.996466,23,283,1,282,1,1,0,1,1,148,147,135,135,12
"870",69,"[23]goIaoHcouHnJHGqKCExcqoB",285,0.996503,23,286,1,285,1,1,0,1,1,149,148,137,137,12
"871",70,"[23]goIaoHcouHnJHGqKCExcqoB",281,0.996454,23,282,1,281,1,1,0,1,1,152,151,130,130,12
"872",71,"[23]goIaoHcouHnJHGqKCExcqoB",285,0.996503,23,286,1,285,1,1,0,1,1,159,158,127,127,12
"873",72,"[23]goIaoHcouHnJHGqKCExcqoB",278,0.996416,23,279,1,278,1,1,0,1,1,156,155,123,123,12
"874",73,"[23]goIaoHcouHnJHGqKCExcqoB",280,0.996441,23,281,1,280,1,1,0,1,1,137,136,144,144,12
"875",74,"[23]goIaoHcouHnJHGqKCExcqoB",277,0.996403,23,278,1,277,1,1,0,1,1,131,130,147,147,12
"876",75,"[23]goIaoHcouHnJHGqKCExcqoB",279,0.996429,23,280,1,279,1,1,0,1,1,151,150,129,129,12
"877",76,"[23]goIaoHcouHnJHGqKCExcqoB",280,0.996441,23,281,1,280,1,1,0,1,1,139,138,142,142,12
"878",77,"[23]goIaoHcouHnJHGqKCExcqoB",274,0.996364,23,275,1,274,1,1,0,1,1,123,122,152,152,12
"879",78,"[23]goIaoHcouHnJHGqKCExcqoB",288,0.99654,23,289,1,288,1,1,0,1,1,158,157,131,131,12
"880",79,"[23]goIaoHcouHnJHGqKCExcqoB",283,0.996479,23,284,1,283,1,1,0,1,1,143,142,141,141,12
"881",80,"[23]goIaoHcouHnJHGqKCExcqoB",280,0.996441,23,281,1,280,1,1,0,1,1,133,132,148,148,12
"882",81,"[23]goIaoHcouHnJHGqKCExcqoB",284,0.996491,23,285,1,284,1,1,0,1,1,147,146,138,138,12
"883",82,"[23]goIaoHcouHnJHGqKCExcqoB",283,0.996479,23,284,1,283,1,1,0,1,1,138,137,146,146,12
"884",83,"[23]goIaoHcouHnJHGqKCExcqoB",277,0.996403,23,278,1,277,1,1,0,1,1,133,132,145,145,12
"885",84,"[23]goIaoHcouHnJHGqKCExcqoB",285,0.996503,23,286,1,285,1,1,0,1,1,143,142,143,143,12
"886",85,"[23]goIaoHcouHnJHGqKCExcqoB",279,0.996429,23,280,1,279,1,1,0,1,1,152,151,128,128,12
"887",86,"[23]goIaoHcouHnJHGqKCExcqoB",284,0.996491,23,285,1,284,1,1,0,1,1,167,166,118,118,12
"888",87,"[23]goIaoHcouHnJHGqKCExcqoB",282,0.996466,23,283,1,282,1,1,0,1,1,144,143,139,139,12
"889",88,"[23]goIaoHcouHnJHGqKCExcqoB",285,0.996503,23,286,1,285,1,1,0,1,1,147,146,139,139,12
"890",89,"[23]goIaoHcouHnJHGqKCExcqoB",278,0.996416,23,279,1,278,1,1,0,1,1,132,131,147,147,12
"891",90,"[23]goIaoHcouHnJHGqKCExcqoB",288,0.99654,23,289,1,288,1,1,0,1,1,150,149,139,139,12
"892",91,"[23]goIaoHcouHnJHGqKCExcqoB",286,0.996516,23,287,1,286,1,1,0,1,1,145,144,142,142,12
"893",92,"[23]goIaoHcouHnJHGqKCExcqoB",278,0.996416,23,279,1,278,1,1,0,1,1,134,133,145,145,12
"894",93,"[23]goIaoHcouHnJHGqKCExcqoB",276,0.99639,23,277,1,276,1,1,0,1,1,146,145,131,131,12
"895",94,"[23]goIaoHcouHnJHGqKCExcqoB",279,0.996429,23,280,1,279,1,1,0,1,1,151,150,129,129,12
"896",95,"[23]goIaoHcouHnJHGqKCExcqoB",283,0.996479,23,284,1,283,1,1,0,1,1,144,143,140,140,12
"897",96,"[23]goIaoHcouHnJHGqKCExcqoB",283,0.996479,23,284,1,283,1,1,0,1,1,138,137,146,146,12
"898",97,"[23]goIaoHcouHnJHGqKCExcqoB",279,0.996429,23,280,1,279,1,1,0,1,1,136,135,144,144,12
"899",98,"[23]goIaoHcouHnJHGqKCExcqoB",284,0.996491,23,285,1,284,1,1,0,1,1,152,151,133,133,12
"900",99,"[23]goIaoHcouHnJHGqKCExcqoB",277,0.996403,23,278,1,277,1,1,0,1,1,141,140,137,137,12
"901",0,"[27]qFioIoHcovHnJHGqKCAxfowduam",287,0.996528,27,288,1,287,1,1,0,1,1,138,137,150,150,13
"902",1,"[27]qFioIoHcovHnJHGqKCAxfowduam",277,0.996403,27,278,1,277,1,1,0,1,1,134,133,144,144,13
"903",2,"[27]qFioIoHcovHnJHGqKCAxfowduam",276,0.99639,27,277,1,276,1,1,0,1,1,143,142,134,134,13
"904",3,"[27]qFioIoHcovHnJHGqKCAxfowduam",283,0.996479,27,284,1,283,1,1,0,1,1,143,142,141,141,13
"905",4,"[27]qFioIoHcovHnJHGqKCAxfowduam",289,0.996552,27,290,1,289,1,1,0,1,1,155,154,135,135,13
"906",5,"[27]qFioIoHcovHnJHGqKCAxfowduam",282,0.996466,27,283,1,282,1,1,0,1,1,166,165,117,117,13
"907",6,"[27]qFioIoHcovHnJHGqKCAxfowduam",286,0.996516,27,287,1,286,1,1,0,1,1,140,139,147,147,13
"908",7,"[27]qFioIoHcovHnJHGqKCAxfowduam",285,0.996503,27,286,1,285,1,1,0,1,1,146,145,140,140,13
"909",8,"[27]qFioIoHcovHnJHGqKCAxfowduam",281,0.996454,27,282,1,281,1,1,0,1,1,150,149,132,132,13
"910",9,"[27]qFioIoHcovHnJHGqKCAxfowduam",284,0.996491,27,285,1,284,1,1,0,1,1,149,148,136,136,13
"911",10,"[27]qFioIoHcovHnJHGqKCAxfowduam",278,0.996416,27,279,1,278,1,1,0,1,1,135,134,144,144,13
"912",11,"[27]qFioIoHcovHnJHGqKCAxfowduam",276,0.99639,27,277,1,276,1,1,0,1,1,135,134,142,142,13
"913",12,"[27]qFioIoHcovHnJHGqKCAxfowduam",281,0.996454,27,282,1,281,1,1,0,1,1,140,139,142,142,13
"914",13,"[27]qFioIoHcovHnJHGqKCAxfowduam",277,0.996403,27,278,1,277,1,1,0,1,1,153,152,125,125,13
"915",14,"[27]qFioIoHcovHnJHGqKCAxfowduam",287,0.996528,27,288,1,287,1,1,0,1,1,148,147,140,140,13
"916",15,"[27]qFioIoHcovHnJHGqKCAxfowduam",286,0.996516,27,287,1,286,1,1,0,1,1,140,139,147,147,13
"917",16,"[27]qFioIoHcovHnJHGqKCAxfowduam",282,0.996466,27,283,1,282,1,1,0,1,1,147,146,136,136,13
"918",17,"[27]qFioIoHcovHnJHGqKCAxfowduam",282,0.996466,27,283,1,282,1,1,0,1,1,129,128,154,154,13
"919",18,"[27]qFioIoHcovHnJHGqKCAxfowduam",280,0.996441,27,281,1,280,1,1,0,1,1,144,143,137,137,13
"920",19,"[27]qFioIoHcovHnJHGqKCAxfowduam",283,0.996479,27,284,1,283,1,1,0,1,1,138,137,146,146,13
"921",20,"[27]qFioIoHcovHnJHGqKCAxfowduam",285,0.996503,27,286,1,285,1,1,0,1,1,142,141,144,144,13
"922",21,"[27]qFioIoHcovHnJHGqKCAxfowduam",275,0.996377,27,276,1,275,1,1,0,1,1,128,127,148,148,13
"923",22,"[27]qFioIoHcovHnJHGqKCAxfowduam",286,0.996516,27,287,1,286,1,1,0,1,1,138,137,149,149,13
"924",23,"[27]qFioIoHcovHnJHGqKCAxfowduam",284,0.996491,27,285,1,284,1,1,0,1,1,135,134,150,150,13
"925",24,"[27]qFioIoHcovHnJHGqKCAxfowduam",285,0.996503,27,286,1,285,1,1,0,1,1,155,154,131,131,13
"926",25,"[27]qFioIoHcovHnJHGqKCAxfowduam",284,0.996491,27,285,1,284,1,1,0,1,1,134,133,151,151,13
"927",26,"[27]qFioIoHcovHnJHGqKCAxfowduam",276,0.99639,27,277,1,276,1,1,0,1,1,126,125,151,151,13
"928",27,"[27]qFioIoHcovHnJHGqKCAxfowduam",282,0.996466,27,283,1,282,1,1,0,1,1,150,149,133,133,13
"929",28,"[27]qFioIoHcovHnJHGqKCAxfowduam",272,0.996337,27,273,1,272,1,1,0,1,1,136,135,137,137,13
"930",29,"[27]qFioIoHcovHnJHGqKCAxfowduam",280,0.996441,27,281,1,280,1,1,0,1,1,144,143,137,137,13
"931",30,"[27]qFioIoHcovHnJHGqKCAxfowduam",274,0.996364,27,275,1,274,1,1,0,1,1,135,134,140,140,13
"932",31,"[27]qFioIoHcovHnJHGqKCAxfowduam",282,0.996466,27,283,1,282,1,1,0,1,1,153,152,130,130,13
"933",32,"[27]qFioIoHcovHnJHGqKCAxfowduam",274,0.996364,27,275,1,274,1,1,0,1,1,144,143,131,131,13
"934",33,"[27]qFioIoHcovHnJHGqKCAxfowduam",280,0.996441,27,281,1,280,1,1,0,1,1,138,137,143,143,13
"935",34,"[27]qFioIoHcovHnJHGqKCAxfowduam",278,0.996416,27,279,1,278,1,1,0,1,1,129,128,150,150,13
"936",35,"[27]qFioIoHcovHnJHGqKCAxfowduam",282,0.996466,27,283,1,282,1,1,0,1,1,149,148,134,134,13
"937",36,"[27]qFioIoHcovHnJHGqKCAxfowduam",279,0.996429,27,280,1,279,1,1,0,1,1,151,150,129,129,13
"938",37,"[27]qFioIoHcovHnJHGqKCAxfowduam",282,0.996466,27,283,1,282,1,1,0,1,1,148,147,135,135,13
"939",38,"[27]qFioIoHcovHnJHGqKCAxfowduam",277,0.996403,27,278,1,277,1,1,0,1,1,134,133,144,144,13
"940",39,"[27]qFioIoHcovHnJHGqKCAxfowduam",285,0.996503,27,286,1,285,1,1,0,1,1,138,137,148,148,13
"941",40,"[27]qFioIoHcovHnJHGqKCAxfowduam",289,0.996552,27,290,1,289,1,1,0,1,1,148,147,142,142,13
"942",41,"[27]qFioIoHcovHnJHGqKCAxfowduam",286,0.996516,27,287,1,286,1,1,0,1,1,148,147,139,139,13
"943",42,"[27]qFioIoHcovHnJHGqKCAxfowduam",280,0.996441,27,281,1,280,1,1,0,1,1,142,141,139,139,13
"944",43,"[27]qFioIoHcovHnJHGqKCAxfowduam",281,0.996454,27,282,1,281,1,1,0,1,1,150,149,132,132,13
"945",44,"[27]qFioIoHcovHnJHGqKCAxfowduam",278,0.996416,27,279,1,278,1,1,0,1,1,142,141,137,137,13
"946",45,"[27]qFioIoHcovHnJHGqKCAxfowduam",279,0.996429,27,280,1,279,1,1,0,1,1,144,143,136,136,13
"947",46,"[27]qFioIoHcovHnJHGqKCAxfowduam",280,0.996441,27,281,1,280,1,1,0,1,1,140,139,141,141,13
"948",47,"[27]qFioIoHcovHnJHGqKCAxfowduam",283,0.996479,27,284,1,283,1,1,0,1,1,160,159,124,124,13
"949",48,"[27]qFioIoHcovHnJHGqKCAxfowduam",282,0.996466,27,283,1,282,1,1,0,1,1,130,129,153,153,13
"950",49,"[27]qFioIoHcovHnJHGqKCAxfowduam",282,0.996466,27,283,1,282,1,1,0,1,1,145,144,138,138,13
"951",50,"[27]qFioIoHcovHnJHGqKCAxfowduam",271,0.996324,27,272,1,271,1,1,0,1,1,131,130,141,141,13
"952",51,"[27]qFioIoHcovHnJHGqKCAxfowduam",280,0.996441,27,281,1,280,1,1,0,1,1,134,133,147,147,13
"953",52,"[27]qFioIoHcovHnJHGqKCAxfowduam",289,0.996552,27,290,1,289,1,1,0,1,1,152,151,138,138,13
"954",53,"[27]qFioIoHcovHnJHGqKCAxfowduam",287,0.996528,27,288,1,287,1,1,0,1,1,150,149,138,138,13
"955",54,"[27]qFioIoHcovHnJHGqKCAxfowduam",281,0.996454,27,282,1,281,1,1,0,1,1,141,140,141,141,13
"956",55,"[27]qFioIoHcovHnJHGqKCAxfowduam",277,0.996403,27,278,1,277,1,1,0,1,1,131,130,147,147,13
"957",56,"[27]qFioIoHcovHnJHGqKCAxfowduam",273,0.99635,27,274,1,273,1,1,0,1,1,125,124,149,149,13
"958",57,"[27]qFioIoHcovHnJHGqKCAxfowduam",287,0.996528,27,288,1,287,1,1,0,1,1,148,147,140,140,13
"959",58,"[27]qFioIoHcovHnJHGqKCAxfowduam",283,0.996479,27,284,1,283,1,1,0,1,1,156,155,128,128,13
"960",59,"[27]qFioIoHcovHnJHGqKCAxfowduam",279,0.996429,27,280,1,279,1,1,0,1,1,131,130,149,149,13
"961",60,"[27]qFioIoHcovHnJHGqKCAxfowduam",272,0.996337,27,273,1,272,1,1,0,1,1,127,126,146,146,13
"962",61,"[27]qFioIoHcovHnJHGqKCAxfowduam",284,0.996491,27,285,1,284,1,1,0,1,1,152,151,133,133,13
"963",62,"[27]qFioIoHcovHnJHGqKCAxfowduam",278,0.996416,27,279,1,278,1,1,0,1,1,135,134,144,144,13
"964",63,"[27]qFioIoHcovHnJHGqKCAxfowduam",287,0.996528,27,288,1,287,1,1,0,1,1,147,146,141,141,13
"965",64,"[27]qFioIoHcovHnJHGqKCAxfowduam",277,0.996403,27,278,1,277,1,1,0,1,1,135,134,143,143,13
"966",65,"[27]qFioIoHcovHnJHGqKCAxfowduam",286,0.996516,27,287,1,286,1,1,0,1,1,135,134,152,152,13
"967",66,"[27]qFioIoHcovHnJHGqKCAxfowduam",290,0.996564,27,291,1,290,1,1,0,1,1,155,154,136,136,13
"968",67,"[27]qFioIoHcovHnJHGqKCAxfowduam",278,0.996416,27,279,1,278,1,1,0,1,1,144,143,135,135,13
"969",68,"[27]qFioIoHcovHnJHGqKCAxfowduam",276,0.99639,27,277,1,276,1,1,0,1,1,123,122,154,154,13
"970",69,"[27]qFioIoHcovHnJHGqKCAxfowduam",282,0.996466,27,283,1,282,1,1,0,1,1,145,144,138,138,13
"971",70,"[27]qFioIoHcovHnJHGqKCAxfowduam",277,0.996403,27,278,1,277,1,1,0,1,1,145,144,133,133,13
"972",71,"[27]qFioIoHcovHnJHGqKCAxfowduam",292,0.996587,27,293,1,292,1,1,0,1,1,155,154,138,138,13
"973",72,"[27]qFioIoHcovHnJHGqKCAxfowduam",281,0.996454,27,282,1,281,1,1,0,1,1,141,140,141,141,13
"974",73,"[27]qFioIoHcovHnJHGqKCAxfowduam",274,0.996364,27,275,1,274,1,1,0,1,1,126,125,149,149,13
"975",74,"[27]qFioIoHcovHnJHGqKCAxfowduam",272,0.996337,27,273,1,272,1,1,0,1,1,150,149,123,123,13
"976",75,"[27]qFioIoHcovHnJHGqKCAxfowduam",280,0.996441,27,281,1,280,1,1,0,1,1,136,135,145,145,13
"977",76,"[27]qFioIoHcovHnJHGqKCAxfowduam",277,0.996403,27,278,1,277,1,1,0,1,1,141,140,137,137,13
"978",77,"[27]qFioIoHcovHnJHGqKCAxfowduam",284,0.996491,27,285,1,284,1,1,0,1,1,155,154,130,130,13
"979",78,"[27]qFioIoHcovHnJHGqKCAxfowduam",291,0.996575,27,292,1,291,1,1,0,1,1,157,156,135,135,13
"980",79,"[27]qFioIoHcovHnJHGqKCAxfowduam",285,0.996503,27,286,1,285,1,1,0,1,1,144,143,142,142,13
"981",80,"[27]qFioIoHcovHnJHGqKCAxfowduam",281,0.996454,27,282,1,281,1,1,0,1,1,142,141,140,140,13
"982",81,"[27]qFioIoHcovHnJHGqKCAxfowduam",280,0.996441,27,281,1,280,1,1,0,1,1,133,132,148,148,13
"983",82,"[27]qFioIoHcovHnJHGqKCAxfowduam",281,0.996454,27,282,1,281,1,1,0,1,1,155,154,127,127,13
"984",83,"[27]qFioIoHcovHnJHGqKCAxfowduam",277,0.996403,27,278,1,277,1,1,0,1,1,149,148,129,129,13
"985",84,"[27]qFioIoHcovHnJHGqKCAxfowduam",277,0.996403,27,278,1,277,1,1,0,1,1,133,132,145,145,13
"986",85,"[27]qFioIoHcovHnJHGqKCAxfowduam",276,0.99639,27,277,1,276,1,1,0,1,1,128,127,149,149,13
"987",86,"[27]qFioIoHcovHnJHGqKCAxfowduam",282,0.996466,27,283,1,282,1,1,0,1,1,141,140,142,142,13
"988",87,"[27]qFioIoHcovHnJHGqKCAxfowduam",278,0.996416,27,279,1,278,1,1,0,1,1,150,149,129,129,13
"989",88,"[27]qFioIoHcovHnJHGqKCAxfowduam",283,0.996479,27,284,1,283,1,1,0,1,1,138,137,146,146,13
"990",89,"[27]qFioIoHcovHnJHGqKCAxfowduam",280,0.996441,27,281,1,280,1,1,0,1,1,139,138,142,142,13
"991",90,"[27]qFioIoHcovHnJHGqKCAxfowduam",284,0.996491,27,285,1,284,1,1,0,1,1,148,147,137,137,13
"992",91,"[27]qFioIoHcovHnJHGqKCAxfowduam",279,0.996429,27,280,1,279,1,1,0,1,1,130,129,150,150,13
"993",92,"[27]qFioIoHcovHnJHGqKCAxfowduam",283,0.996479,27,284,1,283,1,1,0,1,1,140,139,144,144,13
"994",93,"[27]qFioIoHcovHnJHGqKCAxfowduam",267,0.996269,27,268,1,267,1,1,0,1,1,122,121,146,146,13
"995",94,"[27]qFioIoHcovHnJHGqKCAxfowduam",282,0.996466,27,283,1,282,1,1,0,1,1,132,131,151,151,13
"996",95,"[27]qFioIoHcovHnJHGqKCAxfowduam",277,0.996403,27,278,1,277,1,1,0,1,1,143,142,135,135,13
"997",96,"[27]qFioIoHcovHnJHGqKCAxfowduam",275,0.996377,27,276,1,275,1,1,0,1,1,142,141,134,134,13
"998",97,"[27]qFioIoHcovHnJHGqKCAxfowduam",286,0.996516,27,287,1,286,1,1,0,1,1,158,157,129,129,13
"999",98,"[27]qFioIoHcovHnJHGqKCAxfowduam",280,0.996441,27,281,1,280,1,1,0,1,1,133,132,148,148,13
"1000",99,"[27]qFioIoHcovHnJHGqKCAxfowduam",287,0.996528,27,288,1,287,1,1,0,1,1,155,154,133,133,13
"1001",0,"[27]izoIoHcouHnJHGqKCxJcKbiAhio",276,0.99639,27,277,1,276,1,1,0,1,1,133,132,144,144,14
"1002",1,"[27]izoIoHcouHnJHGqKCxJcKbiAhio",286,0.996516,27,287,1,286,1,1,0,1,1,156,155,131,131,14
"1003",2,"[27]izoIoHcouHnJHGqKCxJcKbiAhio",283,0.996479,27,284,1,283,1,1,0,1,1,138,137,146,146,14
"1004",3,"[27]izoIoHcouHnJHGqKCxJcKbiAhio",285,0.996503,27,286,1,285,1,1,0,1,1,137,136,149,149,14
"1005",4,"[27]izoIoHcouHnJHGqKCxJcKbiAhio",283,0.996479,27,284,1,283,1,1,0,1,1,138,137,146,146,14
"1006",5,"[27]izoIoHcouHnJHGqKCxJcKbiAhio",284,0.996491,27,285,1,284,1,1,0,1,1,138,137,147,147,14
"1007",6,"[27]izoIoHcouHnJHGqKCxJcKbiAhio",284,0.996491,27,285,1,284,1,1,0,1,1,151,150,134,134,14
"1008",7,"[27]izoIoHcouHnJHGqKCxJcKbiAhio",281,0.996454,27,282,1,281,1,1,0,1,1,144,143,138,138,14
"1009",8,"[27]izoIoHcouHnJHGqKCxJcKbiAhio",285,0.996503,27,286,1,285,1,1,0,1,1,143,142,143,143,14
"1010",9,"[27]izoIoHcouHnJHGqKCxJcKbiAhio",286,0.996516,27,287,1,286,1,1,0,1,1,140,139,147,147,14
"1011",10,"[27]izoIoHcouHnJHGqKCxJcKbiAhio",274,0.996364,27,275,1,274,1,1,0,1,1,135,134,140,140,14
"1012",11,"[27]izoIoHcouHnJHGqKCxJcKbiAhio",282,0.996466,27,283,1,282,1,1,0,1,1,147,146,136,136,14
"1013",12,"[27]izoIoHcouHnJHGqKCxJcKbiAhio",285,0.996503,27,286,1,285,1,1,0,1,1,133,132,153,153,14
"1014",13,"[27]izoIoHcouHnJHGqKCxJcKbiAhio",281,0.996454,27,282,1,281,1,1,0,1,1,147,146,135,135,14
"1015",14,"[27]izoIoHcouHnJHGqKCxJcKbiAhio",285,0.996503,27,286,1,285,1,1,0,1,1,146,145,140,140,14
"1016",15,"[27]izoIoHcouHnJHGqKCxJcKbiAhio",280,0.996441,27,281,1,280,1,1,0,1,1,145,144,136,136,14
"1017",16,"[27]izoIoHcouHnJHGqKCxJcKbiAhio",280,0.996441,27,281,1,280,1,1,0,1,1,144,143,137,137,14
"1018",17,"[27]izoIoHcouHnJHGqKCxJcKbiAhio",273,0.99635,27,274,1,273,1,1,0,1,1,142,141,132,132,14
"1019",18,"[27]izoIoHcouHnJHGqKCxJcKbiAhio",277,0.996403,27,278,1,277,1,1,0,1,1,137,136,141,141,14
"1020",19,"[27]izoIoHcouHnJHGqKCxJcKbiAhio",283,0.996479,27,284,1,283,1,1,0,1,1,133,132,151,151,14
"1021",20,"[27]izoIoHcouHnJHGqKCxJcKbiAhio",279,0.996429,27,280,1,279,1,1,0,1,1,134,133,146,146,14
"1022",21,"[27]izoIoHcouHnJHGqKCxJcKbiAhio",287,0.996528,27,288,1,287,1,1,0,1,1,158,157,130,130,14
"1023",22,"[27]izoIoHcouHnJHGqKCxJcKbiAhio",281,0.996454,27,282,1,281,1,1,0,1,1,135,134,147,147,14
"1024",23,"[27]izoIoHcouHnJHGqKCxJcKbiAhio",282,0.996466,27,283,1,282,1,1,0,1,1,152,151,131,131,14
"1025",24,"[27]izoIoHcouHnJHGqKCxJcKbiAhio",279,0.996429,27,280,1,279,1,1,0,1,1,116,115,164,164,14
"1026",25,"[27]izoIoHcouHnJHGqKCxJcKbiAhio",285,0.996503,27,286,1,285,1,1,0,1,1,138,137,148,148,14
"1027",26,"[27]izoIoHcouHnJHGqKCxJcKbiAhio",282,0.996466,27,283,1,282,1,1,0,1,1,137,136,146,146,14
"1028",27,"[27]izoIoHcouHnJHGqKCxJcKbiAhio",275,0.996377,27,276,1,275,1,1,0,1,1,126,125,150,150,14
"1029",28,"[27]izoIoHcouHnJHGqKCxJcKbiAhio",280,0.996441,27,281,1,280,1,1,0,1,1,133,132,148,148,14
"1030",29,"[27]izoIoHcouHnJHGqKCxJcKbiAhio",277,0.996403,27,278,1,277,1,1,0,1,1,135,134,143,143,14
"1031",30,"[27]izoIoHcouHnJHGqKCxJcKbiAhio",280,0.996441,27,281,1,280,1,1,0,1,1,143,142,138,138,14
"1032",31,"[27]izoIoHcouHnJHGqKCxJcKbiAhio",279,0.996429,27,280,1,279,1,1,0,1,1,149,148,131,131,14
"1033",32,"[27]izoIoHcouHnJHGqKCxJcKbiAhio",281,0.996454,27,282,1,281,1,1,0,1,1,145,144,137,137,14
"1034",33,"[27]izoIoHcouHnJHGqKCxJcKbiAhio",282,0.996466,27,283,1,282,1,1,0,1,1,146,145,137,137,14
"1035",34,"[27]izoIoHcouHnJHGqKCxJcKbiAhio",282,0.996466,27,283,1,282,1,1,0,1,1,141,140,142,142,14
"1036",35,"[27]izoIoHcouHnJHGqKCxJcKbiAhio",285,0.996503,27,286,1,285,1,1,0,1,1,139,138,147,147,14
"1037",36,"[27]izoIoHcouHnJHGqKCxJcKbiAhio",277,0.996403,27,278,1,277,1,1,0,1,1,143,142,135,135,14
"1038",37,"[27]izoIoHcouHnJHGqKCxJcKbiAhio",284,0.996491,27,285,1,284,1,1,0,1,1,141,140,144,144,14
"1039",38,"[27]izoIoHcouHnJHGqKCxJcKbiAhio",282,0.996466,27,283,1,282,1,1,0,1,1,143,142,140,140,14
"1040",39,"[27]izoIoHcouHnJHGqKCxJcKbiAhio",282,0.996466,27,283,1,282,1,1,0,1,1,134,133,149,149,14
"1041",40,"[27]izoIoHcouHnJHGqKCxJcKbiAhio",273,0.99635,27,274,1,273,1,1,0,1,1,137,136,137,137,14
"1042",41,"[27]izoIoHcouHnJHGqKCxJcKbiAhio",277,0.996403,27,278,1,277,1,1,0,1,1,115,114,163,163,14
"1043",42,"[27]izoIoHcouHnJHGqKCxJcKbiAhio",278,0.996416,27,279,1,278,1,1,0,1,1,129,128,150,150,14
"1044",43,"[27]izoIoHcouHnJHGqKCxJcKbiAhio",290,0.996564,27,291,1,290,1,1,0,1,1,142,141,149,149,14
"1045",44,"[27]izoIoHcouHnJHGqKCxJcKbiAhio",284,0.996491,27,285,1,284,1,1,0,1,1,143,142,142,142,14
"1046",45,"[27]izoIoHcouHnJHGqKCxJcKbiAhio",285,0.996503,27,286,1,285,1,1,0,1,1,149,148,137,137,14
"1047",46,"[27]izoIoHcouHnJHGqKCxJcKbiAhio",275,0.996377,27,276,1,275,1,1,0,1,1,148,147,128,128,14
"1048",47,"[27]izoIoHcouHnJHGqKCxJcKbiAhio",278,0.996416,27,279,1,278,1,1,0,1,1,148,147,131,131,14
"1049",48,"[27]izoIoHcouHnJHGqKCxJcKbiAhio",275,0.996377,27,276,1,275,1,1,0,1,1,124,123,152,152,14
"1050",49,"[27]izoIoHcouHnJHGqKCxJcKbiAhio",281,0.996454,27,282,1,281,1,1,0,1,1,156,155,126,126,14
"1051",50,"[27]izoIoHcouHnJHGqKCxJcKbiAhio",279,0.996429,27,280,1,279,1,1,0,1,1,148,147,132,132,14
"1052",51,"[27]izoIoHcouHnJHGqKCxJcKbiAhio",279,0.996429,27,280,1,279,1,1,0,1,1,131,130,149,149,14
"1053",52,"[27]izoIoHcouHnJHGqKCxJcKbiAhio",284,0.996491,27,285,1,284,1,1,0,1,1,134,133,151,151,14
"1054",53,"[27]izoIoHcouHnJHGqKCxJcKbiAhio",284,0.996491,27,285,1,284,1,1,0,1,1,152,151,133,133,14
"1055",54,"[27]izoIoHcouHnJHGqKCxJcKbiAhio",284,0.996491,27,285,1,284,1,1,0,1,1,145,144,140,140,14
"1056",55,"[27]izoIoHcouHnJHGqKCxJcKbiAhio",282,0.996466,27,283,1,282,1,1,0,1,1,131,130,152,152,14
"1057",56,"[27]izoIoHcouHnJHGqKCxJcKbiAhio",285,0.996503,27,286,1,285,1,1,0,1,1,132,131,154,154,14
"1058",57,"[27]izoIoHcouHnJHGqKCxJcKbiAhio",284,0.996491,27,285,1,284,1,1,0,1,1,149,148,136,136,14
"1059",58,"[27]izoIoHcouHnJHGqKCxJcKbiAhio",275,0.996377,27,276,1,275,1,1,0,1,1,142,141,134,134,14
"1060",59,"[27]izoIoHcouHnJHGqKCxJcKbiAhio",278,0.996416,27,279,1,278,1,1,0,1,1,152,151,127,127,14
"1061",60,"[27]izoIoHcouHnJHGqKCxJcKbiAhio",283,0.996479,27,284,1,283,1,1,0,1,1,142,141,142,142,14
"1062",61,"[27]izoIoHcouHnJHGqKCxJcKbiAhio",281,0.996454,27,282,1,281,1,1,0,1,1,133,132,149,149,14
"1063",62,"[27]izoIoHcouHnJHGqKCxJcKbiAhio",284,0.996491,27,285,1,284,1,1,0,1,1,140,139,145,145,14
"1064",63,"[27]izoIoHcouHnJHGqKCxJcKbiAhio",285,0.996503,27,286,1,285,1,1,0,1,1,142,141,144,144,14
"1065",64,"[27]izoIoHcouHnJHGqKCxJcKbiAhio",287,0.996528,27,288,1,287,1,1,0,1,1,153,152,135,135,14
"1066",65,"[27]izoIoHcouHnJHGqKCxJcKbiAhio",282,0.996466,27,283,1,282,1,1,0,1,1,152,151,131,131,14
"1067",66,"[27]izoIoHcouHnJHGqKCxJcKbiAhio",283,0.996479,27,284,1,283,1,1,0,1,1,151,150,133,133,14
"1068",67,"[27]izoIoHcouHnJHGqKCxJcKbiAhio",287,0.996528,27,288,1,287,1,1,0,1,1,135,134,153,153,14
"1069",68,"[27]izoIoHcouHnJHGqKCxJcKbiAhio",285,0.996503,27,286,1,285,1,1,0,1,1,148,147,138,138,14
"1070",69,"[27]izoIoHcouHnJHGqKCxJcKbiAhio",283,0.996479,27,284,1,283,1,1,0,1,1,134,133,150,150,14
"1071",70,"[27]izoIoHcouHnJHGqKCxJcKbiAhio",275,0.996377,27,276,1,275,1,1,0,1,1,142,141,134,134,14
"1072",71,"[27]izoIoHcouHnJHGqKCxJcKbiAhio",283,0.996479,27,284,1,283,1,1,0,1,1,144,143,140,140,14
"1073",72,"[27]izoIoHcouHnJHGqKCxJcKbiAhio",277,0.996403,27,278,1,277,1,1,0,1,1,143,142,135,135,14
"1074",73,"[27]izoIoHcouHnJHGqKCxJcKbiAhio",276,0.99639,27,277,1,276,1,1,0,1,1,135,134,142,142,14
"1075",74,"[27]izoIoHcouHnJHGqKCxJcKbiAhio",280,0.996441,27,281,1,280,1,1,0,1,1,144,143,137,137,14
"1076",75,"[27]izoIoHcouHnJHGqKCxJcKbiAhio",281,0.996454,27,282,1,281,1,1,0,1,1,122,121,160,160,14
"1077",76,"[27]izoIoHcouHnJHGqKCxJcKbiAhio",287,0.996528,27,288,1,287,1,1,0,1,1,141,140,147,147,14
"1078",77,"[27]izoIoHcouHnJHGqKCxJcKbiAhio",292,0.996587,27,293,1,292,1,1,0,1,1,153,152,140,140,14
"1079",78,"[27]izoIoHcouHnJHGqKCxJcKbiAhio",283,0.996479,27,284,1,283,1,1,0,1,1,144,143,140,140,14
"1080",79,"[27]izoIoHcouHnJHGqKCxJcKbiAhio",284,0.996491,27,285,1,284,1,1,0,1,1,137,136,148,148,14
"1081",80,"[27]izoIoHcouHnJHGqKCxJcKbiAhio",276,0.99639,27,277,1,276,1,1,0,1,1,151,150,126,126,14
"1082",81,"[27]izoIoHcouHnJHGqKCxJcKbiAhio",273,0.99635,27,274,1,273,1,1,0,1,1,131,130,143,143,14
"1083",82,"[27]izoIoHcouHnJHGqKCxJcKbiAhio",281,0.996454,27,282,1,281,1,1,0,1,1,156,155,126,126,14
"1084",83,"[27]izoIoHcouHnJHGqKCxJcKbiAhio",281,0.996454,27,282,1,281,1,1,0,1,1,139,138,143,143,14
"1085",84,"[27]izoIoHcouHnJHGqKCxJcKbiAhio",285,0.996503,27,286,1,285,1,1,0,1,1,131,130,155,155,14
"1086",85,"[27]izoIoHcouHnJHGqKCxJcKbiAhio",279,0.996429,27,280,1,279,1,1,0,1,1,142,141,138,138,14
"1087",86,"[27]izoIoHcouHnJHGqKCxJcKbiAhio",283,0.996479,27,284,1,283,1,1,0,1,1,142,141,142,142,14
"1088",87,"[27]izoIoHcouHnJHGqKCxJcKbiAhio",290,0.996564,27,291,1,290,1,1,0,1,1,149,148,142,142,14
"1089",88,"[27]izoIoHcouHnJHGqKCxJcKbiAhio",289,0.996552,27,290,1,289,1,1,0,1,1,156,155,134,134,14
"1090",89,"[27]izoIoHcouHnJHGqKCxJcKbiAhio",282,0.996466,27,283,1,282,1,1,0,1,1,146,145,137,137,14
"1091",90,"[27]izoIoHcouHnJHGqKCxJcKbiAhio",285,0.996503,27,286,1,285,1,1,0,1,1,158,157,128,128,14
"1092",91,"[27]izoIoHcouHnJHGqKCxJcKbiAhio",282,0.996466,27,283,1,282,1,1,0,1,1,149,148,134,134,14
"1093",92,"[27]izoIoHcouHnJHGqKCxJcKbiAhio",286,0.996516,27,287,1,286,1,1,0,1,1,152,151,135,135,14
"1094",93,"[27]izoIoHcouHnJHGqKCxJcKbiAhio",278,0.996416,27,279,1,278,1,1,0,1,1,140,139,139,139,14
"1095",94,"[27]izoIoHcouHnJHGqKCxJcKbiAhio",286,0.996516,27,287,1,286,1,1,0,1,1,145,144,142,142,14
"1096",95,"[27]izoIoHcouHnJHGqKCxJcKbiAhio",287,0.996528,27,288,1,287,1,1,0,1,1,134,133,154,154,14
"1097",96,"[27]izoIoHcouHnJHGqKCxJcKbiAhio",276,0.99639,27,277,1,276,1,1,0,1,1,135,134,142,142,14
"1098",97,"[27]izoIoHcouHnJHGqKCxJcKbiAhio",283,0.996479,27,284,1,283,1,1,0,1,1,156,155,128,128,14
"1099",98,"[27]izoIoHcouHnJHGqKCxJcKbiAhio",288,0.99654,27,289,1,288,1,1,0,1,1,145,144,144,144,14
"1100",99,"[27]izoIoHcouHnJHGqKCxJcKbiAhio",292,0.996587,27,293,1,292,1,1,0,1,1,150,149,143,143,14
"1101",0,"[28]sffHoIGloHcouHnJqGKCsarhxzFq",296,0.996633,28,297,1,296,1,1,0,1,1,153,152,144,144,15
"1102",1,"[28]sffHoIGloHcouHnJqGKCsarhxzFq",295,0.996622,28,296,1,295,1,1,0,1,1,147,146,149,149,15
"1103",2,"[28]sffHoIGloHcouHnJqGKCsarhxzFq",291,0.996575,28,292,1,291,1,1,0,1,1,137,136,155,155,15
"1104",3,"[28]sffHoIGloHcouHnJqGKCsarhxzFq",293,0.996599,28,294,1,293,1,1,0,1,1,142,141,152,152,15
"1105",4,"[28]sffHoIGloHcouHnJqGKCsarhxzFq",299,0.996667,28,300,1,299,1,1,0,1,1,163,162,137,137,15
"1106",5,"[28]sffHoIGloHcouHnJqGKCsarhxzFq",290,0.996564,28,291,1,290,1,1,0,1,1,139,138,152,152,15
"1107",6,"[28]sffHoIGloHcouHnJqGKCsarhxzFq",298,0.996656,28,299,1,298,1,1,0,1,1,159,158,140,140,15
"1108",7,"[28]sffHoIGloHcouHnJqGKCsarhxzFq",284,0.996491,28,285,1,284,1,1,0,1,1,122,121,163,163,15
"1109",8,"[28]sffHoIGloHcouHnJqGKCsarhxzFq",295,0.996622,28,296,1,295,1,1,0,1,1,155,154,141,141,15
"1110",9,"[28]sffHoIGloHcouHnJqGKCsarhxzFq",297,0.996644,28,298,1,297,1,1,0,1,1,155,154,143,143,15
"1111",10,"[28]sffHoIGloHcouHnJqGKCsarhxzFq",289,0.996552,28,290,1,289,1,1,0,1,1,136,135,154,154,15
"1112",11,"[28]sffHoIGloHcouHnJqGKCsarhxzFq",286,0.996516,28,287,1,286,1,1,0,1,1,139,138,148,148,15
"1113",12,"[28]sffHoIGloHcouHnJqGKCsarhxzFq",292,0.996587,28,293,1,292,1,1,0,1,1,139,138,154,154,15
"1114",13,"[28]sffHoIGloHcouHnJqGKCsarhxzFq",300,0.996678,28,301,1,300,1,1,0,1,1,173,172,128,128,15
"1115",14,"[28]sffHoIGloHcouHnJqGKCsarhxzFq",292,0.996587,28,293,1,292,1,1,0,1,1,144,143,149,149,15
"1116",15,"[28]sffHoIGloHcouHnJqGKCsarhxzFq",298,0.996656,28,299,1,298,1,1,0,1,1,153,152,146,146,15
"1117",16,"[28]sffHoIGloHcouHnJqGKCsarhxzFq",294,0.99661,28,295,1,294,1,1,0,1,1,151,150,144,144,15
"1118",17,"[28]sffHoIGloHcouHnJqGKCsarhxzFq",289,0.996552,28,290,1,289,1,1,0,1,1,136,135,154,154,15
"1119",18,"[28]sffHoIGloHcouHnJqGKCsarhxzFq",293,0.996599,28,294,1,293,1,1,0,1,1,145,144,149,149,15
"1120",19,"[28]sffHoIGloHcouHnJqGKCsarhxzFq",291,0.996575,28,292,1,291,1,1,0,1,1,139,138,153,153,15
"1121",20,"[28]sffHoIGloHcouHnJqGKCsarhxzFq",299,0.996667,28,300,1,299,1,1,0,1,1,156,155,144,144,15
"1122",21,"[28]sffHoIGloHcouHnJqGKCsarhxzFq",298,0.996656,28,299,1,298,1,1,0,1,1,156,155,143,143,15
"1123",22,"[28]sffHoIGloHcouHnJqGKCsarhxzFq",293,0.996599,28,294,1,293,1,1,0,1,1,148,147,146,146,15
"1124",23,"[28]sffHoIGloHcouHnJqGKCsarhxzFq",290,0.996564,28,291,1,290,1,1,0,1,1,140,139,151,151,15
"1125",24,"[28]sffHoIGloHcouHnJqGKCsarhxzFq",293,0.996599,28,294,1,293,1,1,0,1,1,141,140,153,153,15
"1126",25,"[28]sffHoIGloHcouHnJqGKCsarhxzFq",297,0.996644,28,298,1,297,1,1,0,1,1,155,154,143,143,15
"1127",26,"[28]sffHoIGloHcouHnJqGKCsarhxzFq",298,0.996656,28,299,1,298,1,1,0,1,1,164,163,135,135,15
"1128",27,"[28]sffHoIGloHcouHnJqGKCsarhxzFq",290,0.996564,28,291,1,290,1,1,0,1,1,144,143,147,147,15
"1129",28,"[28]sffHoIGloHcouHnJqGKCsarhxzFq",307,0.996753,28,308,1,307,1,1,0,1,1,185,184,123,123,15
"1130",29,"[28]sffHoIGloHcouHnJqGKCsarhxzFq",297,0.996644,28,298,1,297,1,1,0,1,1,160,159,138,138,15
"1131",30,"[28]sffHoIGloHcouHnJqGKCsarhxzFq",296,0.996633,28,297,1,296,1,1,0,1,1,165,164,132,132,15
"1132",31,"[28]sffHoIGloHcouHnJqGKCsarhxzFq",289,0.996552,28,290,1,289,1,1,0,1,1,140,139,150,150,15
"1133",32,"[28]sffHoIGloHcouHnJqGKCsarhxzFq",287,0.996528,28,288,1,287,1,1,0,1,1,134,133,154,154,15
"1134",33,"[28]sffHoIGloHcouHnJqGKCsarhxzFq",293,0.996599,28,294,1,293,1,1,0,1,1,152,151,142,142,15
"1135",34,"[28]sffHoIGloHcouHnJqGKCsarhxzFq",297,0.996644,28,298,1,297,1,1,0,1,1,154,153,144,144,15
"1136",35,"[28]sffHoIGloHcouHnJqGKCsarhxzFq",288,0.99654,28,289,1,288,1,1,0,1,1,133,132,156,156,15
"1137",36,"[28]sffHoIGloHcouHnJqGKCsarhxzFq",291,0.996575,28,292,1,291,1,1,0,1,1,140,139,152,152,15
"1138",37,"[28]sffHoIGloHcouHnJqGKCsarhxzFq",293,0.996599,28,294,1,293,1,1,0,1,1,152,151,142,142,15
"1139",38,"[28]sffHoIGloHcouHnJqGKCsarhxzFq",291,0.996575,28,292,1,291,1,1,0,1,1,145,144,147,147,15
"1140",39,"[28]sffHoIGloHcouHnJqGKCsarhxzFq",294,0.99661,28,295,1,294,1,1,0,1,1,150,149,145,145,15
"1141",40,"[28]sffHoIGloHcouHnJqGKCsarhxzFq",296,0.996633,28,297,1,296,1,1,0,1,1,157,156,140,140,15
"1142",41,"[28]sffHoIGloHcouHnJqGKCsarhxzFq",293,0.996599,28,294,1,293,1,1,0,1,1,147,146,147,147,15
"1143",42,"[28]sffHoIGloHcouHnJqGKCsarhxzFq",303,0.996711,28,304,1,303,1,1,0,1,1,158,157,146,146,15
"1144",43,"[28]sffHoIGloHcouHnJqGKCsarhxzFq",296,0.996633,28,297,1,296,1,1,0,1,1,153,152,144,144,15
"1145",44,"[28]sffHoIGloHcouHnJqGKCsarhxzFq",290,0.996564,28,291,1,290,1,1,0,1,1,135,134,156,156,15
"1146",45,"[28]sffHoIGloHcouHnJqGKCsarhxzFq",296,0.996633,28,297,1,296,1,1,0,1,1,150,149,147,147,15
"1147",46,"[28]sffHoIGloHcouHnJqGKCsarhxzFq",289,0.996552,28,290,1,289,1,1,0,1,1,131,130,159,159,15
"1148",47,"[28]sffHoIGloHcouHnJqGKCsarhxzFq",296,0.996633,28,297,1,296,1,1,0,1,1,149,148,148,148,15
"1149",48,"[28]sffHoIGloHcouHnJqGKCsarhxzFq",293,0.996599,28,294,1,293,1,1,0,1,1,145,144,149,149,15
"1150",49,"[28]sffHoIGloHcouHnJqGKCsarhxzFq",285,0.996503,28,286,1,285,1,1,0,1,1,125,124,161,161,15
"1151",50,"[28]sffHoIGloHcouHnJqGKCsarhxzFq",292,0.996587,28,293,1,292,1,1,0,1,1,150,149,143,143,15
"1152",51,"[28]sffHoIGloHcouHnJqGKCsarhxzFq",295,0.996622,28,296,1,295,1,1,0,1,1,149,148,147,147,15
"1153",52,"[28]sffHoIGloHcouHnJqGKCsarhxzFq",298,0.996656,28,299,1,298,1,1,0,1,1,159,158,140,140,15
"1154",53,"[28]sffHoIGloHcouHnJqGKCsarhxzFq",300,0.996678,28,301,1,300,1,1,0,1,1,158,157,143,143,15
"1155",54,"[28]sffHoIGloHcouHnJqGKCsarhxzFq",289,0.996552,28,290,1,289,1,1,0,1,1,138,137,152,152,15
"1156",55,"[28]sffHoIGloHcouHnJqGKCsarhxzFq",295,0.996622,28,296,1,295,1,1,0,1,1,147,146,149,149,15
"1157",56,"[28]sffHoIGloHcouHnJqGKCsarhxzFq",294,0.99661,28,295,1,294,1,1,0,1,1,152,151,143,143,15
"1158",57,"[28]sffHoIGloHcouHnJqGKCsarhxzFq",294,0.99661,28,295,1,294,1,1,0,1,1,144,143,151,151,15
"1159",58,"[28]sffHoIGloHcouHnJqGKCsarhxzFq",295,0.996622,28,296,1,295,1,1,0,1,1,148,147,148,148,15
"1160",59,"[28]sffHoIGloHcouHnJqGKCsarhxzFq",289,0.996552,28,290,1,289,1,1,0,1,1,134,133,156,156,15
"1161",60,"[28]sffHoIGloHcouHnJqGKCsarhxzFq",292,0.996587,28,293,1,292,1,1,0,1,1,148,147,145,145,15
"1162",61,"[28]sffHoIGloHcouHnJqGKCsarhxzFq",294,0.99661,28,295,1,294,1,1,0,1,1,147,146,148,148,15
"1163",62,"[28]sffHoIGloHcouHnJqGKCsarhxzFq",296,0.996633,28,297,1,296,1,1,0,1,1,156,155,141,141,15
"1164",63,"[28]sffHoIGloHcouHnJqGKCsarhxzFq",295,0.996622,28,296,1,295,1,1,0,1,1,154,153,142,142,15
"1165",64,"[28]sffHoIGloHcouHnJqGKCsarhxzFq",288,0.99654,28,289,1,288,1,1,0,1,1,133,132,156,156,15
"1166",65,"[28]sffHoIGloHcouHnJqGKCsarhxzFq",296,0.996633,28,297,1,296,1,1,0,1,1,149,148,148,148,15
"1167",66,"[28]sffHoIGloHcouHnJqGKCsarhxzFq",283,0.996479,28,284,1,283,1,1,0,1,1,115,114,169,169,15
"1168",67,"[28]sffHoIGloHcouHnJqGKCsarhxzFq",290,0.996564,28,291,1,290,1,1,0,1,1,140,139,151,151,15
"1169",68,"[28]sffHoIGloHcouHnJqGKCsarhxzFq",288,0.99654,28,289,1,288,1,1,0,1,1,145,144,144,144,15
"1170",69,"[28]sffHoIGloHcouHnJqGKCsarhxzFq",294,0.99661,28,295,1,294,1,1,0,1,1,154,153,141,141,15
"1171",70,"[28]sffHoIGloHcouHnJqGKCsarhxzFq",295,0.996622,28,296,1,295,1,1,0,1,1,157,156,139,139,15
"1172",71,"[28]sffHoIGloHcouHnJqGKCsarhxzFq",297,0.996644,28,298,1,297,1,1,0,1,1,152,151,146,146,15
"1173",72,"[28]sffHoIGloHcouHnJqGKCsarhxzFq",296,0.996633,28,297,1,296,1,1,0,1,1,152,151,145,145,15
"1174",73,"[28]sffHoIGloHcouHnJqGKCsarhxzFq",296,0.996633,28,297,1,296,1,1,0,1,1,152,151,145,145,15
"1175",74,"[28]sffHoIGloHcouHnJqGKCsarhxzFq",283,0.996479,28,284,1,283,1,1,0,1,1,123,122,161,161,15
"1176",75,"[28]sffHoIGloHcouHnJqGKCsarhxzFq",293,0.996599,28,294,1,293,1,1,0,1,1,140,139,154,154,15
"1177",76,"[28]sffHoIGloHcouHnJqGKCsarhxzFq",291,0.996575,28,292,1,291,1,1,0,1,1,136,135,156,156,15
"1178",77,"[28]sffHoIGloHcouHnJqGKCsarhxzFq",296,0.996633,28,297,1,296,1,1,0,1,1,152,151,145,145,15
"1179",78,"[28]sffHoIGloHcouHnJqGKCsarhxzFq",292,0.996587,28,293,1,292,1,1,0,1,1,148,147,145,145,15
"1180",79,"[28]sffHoIGloHcouHnJqGKCsarhxzFq",290,0.996564,28,291,1,290,1,1,0,1,1,138,137,153,153,15
"1181",80,"[28]sffHoIGloHcouHnJqGKCsarhxzFq",295,0.996622,28,296,1,295,1,1,0,1,1,145,144,151,151,15
"1182",81,"[28]sffHoIGloHcouHnJqGKCsarhxzFq",295,0.996622,28,296,1,295,1,1,0,1,1,141,140,155,155,15
"1183",82,"[28]sffHoIGloHcouHnJqGKCsarhxzFq",297,0.996644,28,298,1,297,1,1,0,1,1,154,153,144,144,15
"1184",83,"[28]sffHoIGloHcouHnJqGKCsarhxzFq",291,0.996575,28,292,1,291,1,1,0,1,1,138,137,154,154,15
"1185",84,"[28]sffHoIGloHcouHnJqGKCsarhxzFq",295,0.996622,28,296,1,295,1,1,0,1,1,150,149,146,146,15
"1186",85,"[28]sffHoIGloHcouHnJqGKCsarhxzFq",290,0.996564,28,291,1,290,1,1,0,1,1,134,133,157,157,15
"1187",86,"[28]sffHoIGloHcouHnJqGKCsarhxzFq",289,0.996552,28,290,1,289,1,1,0,1,1,131,130,159,159,15
"1188",87,"[28]sffHoIGloHcouHnJqGKCsarhxzFq",297,0.996644,28,298,1,297,1,1,0,1,1,152,151,146,146,15
"1189",88,"[28]sffHoIGloHcouHnJqGKCsarhxzFq",297,0.996644,28,298,1,297,1,1,0,1,1,155,154,143,143,15
"1190",89,"[28]sffHoIGloHcouHnJqGKCsarhxzFq",297,0.996644,28,298,1,297,1,1,0,1,1,156,155,142,142,15
"1191",90,"[28]sffHoIGloHcouHnJqGKCsarhxzFq",300,0.996678,28,301,1,300,1,1,0,1,1,159,158,142,142,15
"1192",91,"[28]sffHoIGloHcouHnJqGKCsarhxzFq",302,0.9967,28,303,1,302,1,1,0,1,1,163,162,140,140,15
"1193",92,"[28]sffHoIGloHcouHnJqGKCsarhxzFq",288,0.99654,28,289,1,288,1,1,0,1,1,134,133,155,155,15
"1194",93,"[28]sffHoIGloHcouHnJqGKCsarhxzFq",298,0.996656,28,299,1,298,1,1,0,1,1,157,156,142,142,15
"1195",94,"[28]sffHoIGloHcouHnJqGKCsarhxzFq",297,0.996644,28,298,1,297,1,1,0,1,1,156,155,142,142,15
"1196",95,"[28]sffHoIGloHcouHnJqGKCsarhxzFq",296,0.996633,28,297,1,296,1,1,0,1,1,156,155,141,141,15
"1197",96,"[28]sffHoIGloHcouHnJqGKCsarhxzFq",289,0.996552,28,290,1,289,1,1,0,1,1,136,135,154,154,15
"1198",97,"[28]sffHoIGloHcouHnJqGKCsarhxzFq",291,0.996575,28,292,1,291,1,1,0,1,1,147,146,145,145,15
"1199",98,"[28]sffHoIGloHcouHnJqGKCsarhxzFq",299,0.996667,28,300,1,299,1,1,0,1,1,158,157,142,142,15
"1200",99,"[28]sffHoIGloHcouHnJqGKCsarhxzFq",291,0.996575,28,292,1,291,1,1,0,1,1,141,140,151,151,15
"1201",0,"[23]ioIoHcovHnJHGqKCxebKfAh",284,0.996491,23,285,1,284,1,1,0,1,1,152,151,133,133,16
"1202",1,"[23]ioIoHcovHnJHGqKCxebKfAh",275,0.996377,23,276,1,275,1,1,0,1,1,129,128,147,147,16
"1203",2,"[23]ioIoHcovHnJHGqKCxebKfAh",288,0.99654,23,289,1,288,1,1,0,1,1,156,155,133,133,16
"1204",3,"[23]ioIoHcovHnJHGqKCxebKfAh",285,0.996503,23,286,1,285,1,1,0,1,1,162,161,124,124,16
"1205",4,"[23]ioIoHcovHnJHGqKCxebKfAh",270,0.99631,23,271,1,270,1,1,0,1,1,131,130,140,140,16
"1206",5,"[23]ioIoHcovHnJHGqKCxebKfAh",273,0.99635,23,274,1,273,1,1,0,1,1,131,130,143,143,16
"1207",6,"[23]ioIoHcovHnJHGqKCxebKfAh",277,0.996403,23,278,1,277,1,1,0,1,1,133,132,145,145,16
"1208",7,"[23]ioIoHcovHnJHGqKCxebKfAh",285,0.996503,23,286,1,285,1,1,0,1,1,143,142,143,143,16
"1209",8,"[23]ioIoHcovHnJHGqKCxebKfAh",287,0.996528,23,288,1,287,1,1,0,1,1,144,143,144,144,16
"1210",9,"[23]ioIoHcovHnJHGqKCxebKfAh",285,0.996503,23,286,1,285,1,1,0,1,1,136,135,150,150,16
"1211",10,"[23]ioIoHcovHnJHGqKCxebKfAh",281,0.996454,23,282,1,281,1,1,0,1,1,145,144,137,137,16
"1212",11,"[23]ioIoHcovHnJHGqKCxebKfAh",292,0.996587,23,293,1,292,1,1,0,1,1,146,145,147,147,16
"1213",12,"[23]ioIoHcovHnJHGqKCxebKfAh",278,0.996416,23,279,1,278,1,1,0,1,1,140,139,139,139,16
"1214",13,"[23]ioIoHcovHnJHGqKCxebKfAh",287,0.996528,23,288,1,287,1,1,0,1,1,151,150,137,137,16
"1215",14,"[23]ioIoHcovHnJHGqKCxebKfAh",286,0.996516,23,287,1,286,1,1,0,1,1,148,147,139,139,16
"1216",15,"[23]ioIoHcovHnJHGqKCxebKfAh",273,0.99635,23,274,1,273,1,1,0,1,1,145,144,129,129,16
"1217",16,"[23]ioIoHcovHnJHGqKCxebKfAh",286,0.996516,23,287,1,286,1,1,0,1,1,135,134,152,152,16
"1218",17,"[23]ioIoHcovHnJHGqKCxebKfAh",283,0.996479,23,284,1,283,1,1,0,1,1,146,145,138,138,16
"1219",18,"[23]ioIoHcovHnJHGqKCxebKfAh",272,0.996337,23,273,1,272,1,1,0,1,1,131,130,142,142,16
"1220",19,"[23]ioIoHcovHnJHGqKCxebKfAh",268,0.996283,23,269,1,268,1,1,0,1,1,125,124,144,144,16
"1221",20,"[23]ioIoHcovHnJHGqKCxebKfAh",286,0.996516,23,287,1,286,1,1,0,1,1,148,147,139,139,16
"1222",21,"[23]ioIoHcovHnJHGqKCxebKfAh",284,0.996491,23,285,1,284,1,1,0,1,1,135,134,150,150,16
"1223",22,"[23]ioIoHcovHnJHGqKCxebKfAh",278,0.996416,23,279,1,278,1,1,0,1,1,133,132,146,146,16
"1224",23,"[23]ioIoHcovHnJHGqKCxebKfAh",286,0.996516,23,287,1,286,1,1,0,1,1,153,152,134,134,16
"1225",24,"[23]ioIoHcovHnJHGqKCxebKfAh",272,0.996337,23,273,1,272,1,1,0,1,1,141,140,132,132,16
"1226",25,"[23]ioIoHcovHnJHGqKCxebKfAh",281,0.996454,23,282,1,281,1,1,0,1,1,146,145,136,136,16
"1227",26,"[23]ioIoHcovHnJHGqKCxebKfAh",275,0.996377,23,276,1,275,1,1,0,1,1,131,130,145,145,16
"1228",27,"[23]ioIoHcovHnJHGqKCxebKfAh",278,0.996416,23,279,1,278,1,1,0,1,1,138,137,141,141,16
"1229",28,"[23]ioIoHcovHnJHGqKCxebKfAh",287,0.996528,23,288,1,287,1,1,0,1,1,154,153,134,134,16
"1230",29,"[23]ioIoHcovHnJHGqKCxebKfAh",288,0.99654,23,289,1,288,1,1,0,1,1,136,135,153,153,16
"1231",30,"[23]ioIoHcovHnJHGqKCxebKfAh",283,0.996479,23,284,1,283,1,1,0,1,1,144,143,140,140,16
"1232",31,"[23]ioIoHcovHnJHGqKCxebKfAh",275,0.996377,23,276,1,275,1,1,0,1,1,139,138,137,137,16
"1233",32,"[23]ioIoHcovHnJHGqKCxebKfAh",290,0.996564,23,291,1,290,1,1,0,1,1,154,153,137,137,16
"1234",33,"[23]ioIoHcovHnJHGqKCxebKfAh",278,0.996416,23,279,1,278,1,1,0,1,1,146,145,133,133,16
"1235",34,"[23]ioIoHcovHnJHGqKCxebKfAh",278,0.996416,23,279,1,278,1,1,0,1,1,133,132,146,146,16
"1236",35,"[23]ioIoHcovHnJHGqKCxebKfAh",283,0.996479,23,284,1,283,1,1,0,1,1,151,150,133,133,16
"1237",36,"[23]ioIoHcovHnJHGqKCxebKfAh",281,0.996454,23,282,1,281,1,1,0,1,1,152,151,130,130,16
"1238",37,"[23]ioIoHcovHnJHGqKCxebKfAh",279,0.996429,23,280,1,279,1,1,0,1,1,151,150,129,129,16
"1239",38,"[23]ioIoHcovHnJHGqKCxebKfAh",277,0.996403,23,278,1,277,1,1,0,1,1,141,140,137,137,16
"1240",39,"[23]ioIoHcovHnJHGqKCxebKfAh",278,0.996416,23,279,1,278,1,1,0,1,1,131,130,148,148,16
"1241",40,"[23]ioIoHcovHnJHGqKCxebKfAh",284,0.996491,23,285,1,284,1,1,0,1,1,160,159,125,125,16
"1242",41,"[23]ioIoHcovHnJHGqKCxebKfAh",281,0.996454,23,282,1,281,1,1,0,1,1,140,139,142,142,16
"1243",42,"[23]ioIoHcovHnJHGqKCxebKfAh",279,0.996429,23,280,1,279,1,1,0,1,1,132,131,148,148,16
"1244",43,"[23]ioIoHcovHnJHGqKCxebKfAh",281,0.996454,23,282,1,281,1,1,0,1,1,137,136,145,145,16
"1245",44,"[23]ioIoHcovHnJHGqKCxebKfAh",278,0.996416,23,279,1,278,1,1,0,1,1,131,130,148,148,16
"1246",45,"[23]ioIoHcovHnJHGqKCxebKfAh",289,0.996552,23,290,1,289,1,1,0,1,1,151,150,139,139,16
"1247",46,"[23]ioIoHcovHnJHGqKCxebKfAh",290,0.996564,23,291,1,290,1,1,0,1,1,154,153,137,137,16
"1248",47,"[23]ioIoHcovHnJHGqKCxebKfAh",280,0.996441,23,281,1,280,1,1,0,1,1,133,132,148,148,16
"1249",48,"[23]ioIoHcovHnJHGqKCxebKfAh",281,0.996454,23,282,1,281,1,1,0,1,1,128,127,154,154,16
"1250",49,"[23]ioIoHcovHnJHGqKCxebKfAh",283,0.996479,23,284,1,283,1,1,0,1,1,142,141,142,142,16
"1251",50,"[23]ioIoHcovHnJHGqKCxebKfAh",279,0.996429,23,280,1,279,1,1,0,1,1,129,128,151,151,16
"1252",51,"[23]ioIoHcovHnJHGqKCxebKfAh",288,0.99654,23,289,1,288,1,1,0,1,1,155,154,134,134,16
"1253",52,"[23]ioIoHcovHnJHGqKCxebKfAh",286,0.996516,23,287,1,286,1,1,0,1,1,147,146,140,140,16
"1254",53,"[23]ioIoHcovHnJHGqKCxebKfAh",284,0.996491,23,285,1,284,1,1,0,1,1,140,139,145,145,16
"1255",54,"[23]ioIoHcovHnJHGqKCxebKfAh",282,0.996466,23,283,1,282,1,1,0,1,1,149,148,134,134,16
"1256",55,"[23]ioIoHcovHnJHGqKCxebKfAh",276,0.99639,23,277,1,276,1,1,0,1,1,134,133,143,143,16
"1257",56,"[23]ioIoHcovHnJHGqKCxebKfAh",278,0.996416,23,279,1,278,1,1,0,1,1,128,127,151,151,16
"1258",57,"[23]ioIoHcovHnJHGqKCxebKfAh",283,0.996479,23,284,1,283,1,1,0,1,1,156,155,128,128,16
"1259",58,"[23]ioIoHcovHnJHGqKCxebKfAh",279,0.996429,23,280,1,279,1,1,0,1,1,136,135,144,144,16
"1260",59,"[23]ioIoHcovHnJHGqKCxebKfAh",285,0.996503,23,286,1,285,1,1,0,1,1,145,144,141,141,16
"1261",60,"[23]ioIoHcovHnJHGqKCxebKfAh",287,0.996528,23,288,1,287,1,1,0,1,1,138,137,150,150,16
"1262",61,"[23]ioIoHcovHnJHGqKCxebKfAh",280,0.996441,23,281,1,280,1,1,0,1,1,139,138,142,142,16
"1263",62,"[23]ioIoHcovHnJHGqKCxebKfAh",288,0.99654,23,289,1,288,1,1,0,1,1,143,142,146,146,16
"1264",63,"[23]ioIoHcovHnJHGqKCxebKfAh",285,0.996503,23,286,1,285,1,1,0,1,1,138,137,148,148,16
"1265",64,"[23]ioIoHcovHnJHGqKCxebKfAh",278,0.996416,23,279,1,278,1,1,0,1,1,135,134,144,144,16
"1266",65,"[23]ioIoHcovHnJHGqKCxebKfAh",284,0.996491,23,285,1,284,1,1,0,1,1,158,157,127,127,16
"1267",66,"[23]ioIoHcovHnJHGqKCxebKfAh",277,0.996403,23,278,1,277,1,1,0,1,1,136,135,142,142,16
"1268",67,"[23]ioIoHcovHnJHGqKCxebKfAh",275,0.996377,23,276,1,275,1,1,0,1,1,118,117,158,158,16
"1269",68,"[23]ioIoHcovHnJHGqKCxebKfAh",285,0.996503,23,286,1,285,1,1,0,1,1,155,154,131,131,16
"1270",69,"[23]ioIoHcovHnJHGqKCxebKfAh",275,0.996377,23,276,1,275,1,1,0,1,1,124,123,152,152,16
"1271",70,"[23]ioIoHcovHnJHGqKCxebKfAh",283,0.996479,23,284,1,283,1,1,0,1,1,155,154,129,129,16
"1272",71,"[23]ioIoHcovHnJHGqKCxebKfAh",281,0.996454,23,282,1,281,1,1,0,1,1,134,133,148,148,16
"1273",72,"[23]ioIoHcovHnJHGqKCxebKfAh",287,0.996528,23,288,1,287,1,1,0,1,1,139,138,149,149,16
"1274",73,"[23]ioIoHcovHnJHGqKCxebKfAh",279,0.996429,23,280,1,279,1,1,0,1,1,136,135,144,144,16
"1275",74,"[23]ioIoHcovHnJHGqKCxebKfAh",280,0.996441,23,281,1,280,1,1,0,1,1,123,122,158,158,16
"1276",75,"[23]ioIoHcovHnJHGqKCxebKfAh",282,0.996466,23,283,1,282,1,1,0,1,1,138,137,145,145,16
"1277",76,"[23]ioIoHcovHnJHGqKCxebKfAh",286,0.996516,23,287,1,286,1,1,0,1,1,153,152,134,134,16
"1278",77,"[23]ioIoHcovHnJHGqKCxebKfAh",283,0.996479,23,284,1,283,1,1,0,1,1,149,148,135,135,16
"1279",78,"[23]ioIoHcovHnJHGqKCxebKfAh",275,0.996377,23,276,1,275,1,1,0,1,1,134,133,142,142,16
"1280",79,"[23]ioIoHcovHnJHGqKCxebKfAh",277,0.996403,23,278,1,277,1,1,0,1,1,139,138,139,139,16
"1281",80,"[23]ioIoHcovHnJHGqKCxebKfAh",285,0.996503,23,286,1,285,1,1,0,1,1,142,141,144,144,16
"1282",81,"[23]ioIoHcovHnJHGqKCxebKfAh",276,0.99639,23,277,1,276,1,1,0,1,1,140,139,137,137,16
"1283",82,"[23]ioIoHcovHnJHGqKCxebKfAh",275,0.996377,23,276,1,275,1,1,0,1,1,138,137,138,138,16
"1284",83,"[23]ioIoHcovHnJHGqKCxebKfAh",280,0.996441,23,281,1,280,1,1,0,1,1,162,161,119,119,16
"1285",84,"[23]ioIoHcovHnJHGqKCxebKfAh",283,0.996479,23,284,1,283,1,1,0,1,1,137,136,147,147,16
"1286",85,"[23]ioIoHcovHnJHGqKCxebKfAh",278,0.996416,23,279,1,278,1,1,0,1,1,146,145,133,133,16
"1287",86,"[23]ioIoHcovHnJHGqKCxebKfAh",281,0.996454,23,282,1,281,1,1,0,1,1,142,141,140,140,16
"1288",87,"[23]ioIoHcovHnJHGqKCxebKfAh",284,0.996491,23,285,1,284,1,1,0,1,1,133,132,152,152,16
"1289",88,"[23]ioIoHcovHnJHGqKCxebKfAh",285,0.996503,23,286,1,285,1,1,0,1,1,148,147,138,138,16
"1290",89,"[23]ioIoHcovHnJHGqKCxebKfAh",284,0.996491,23,285,1,284,1,1,0,1,1,148,147,137,137,16
"1291",90,"[23]ioIoHcovHnJHGqKCxebKfAh",282,0.996466,23,283,1,282,1,1,0,1,1,136,135,147,147,16
"1292",91,"[23]ioIoHcovHnJHGqKCxebKfAh",273,0.99635,23,274,1,273,1,1,0,1,1,130,129,144,144,16
"1293",92,"[23]ioIoHcovHnJHGqKCxebKfAh",286,0.996516,23,287,1,286,1,1,0,1,1,152,151,135,135,16
"1294",93,"[23]ioIoHcovHnJHGqKCxebKfAh",279,0.996429,23,280,1,279,1,1,0,1,1,163,162,117,117,16
"1295",94,"[23]ioIoHcovHnJHGqKCxebKfAh",289,0.996552,23,290,1,289,1,1,0,1,1,152,151,138,138,16
"1296",95,"[23]ioIoHcovHnJHGqKCxebKfAh",285,0.996503,23,286,1,285,1,1,0,1,1,152,151,134,134,16
"1297",96,"[23]ioIoHcovHnJHGqKCxebKfAh",285,0.996503,23,286,1,285,1,1,0,1,1,162,161,124,124,16
"1298",97,"[23]ioIoHcovHnJHGqKCxebKfAh",289,0.996552,23,290,1,289,1,1,0,1,1,152,151,138,138,16
"1299",98,"[23]ioIoHcovHnJHGqKCxebKfAh",279,0.996429,23,280,1,279,1,1,0,1,1,143,142,137,137,16
"1300",99,"[23]ioIoHcovHnJHGqKCxebKfAh",272,0.996337,23,273,1,272,1,1,0,1,1,119,118,154,154,16
"1301",0,"[20]HoIoHcotHnJHGqKCIzxj",279,0.996429,20,280,1,279,1,1,0,1,1,143,142,137,137,17
"1302",1,"[20]HoIoHcotHnJHGqKCIzxj",289,0.996552,20,290,1,289,1,1,0,1,1,148,147,142,142,17
"1303",2,"[20]HoIoHcotHnJHGqKCIzxj",284,0.996491,20,285,1,284,1,1,0,1,1,142,141,143,143,17
"1304",3,"[20]HoIoHcotHnJHGqKCIzxj",285,0.996503,20,286,1,285,1,1,0,1,1,132,131,154,154,17
"1305",4,"[20]HoIoHcotHnJHGqKCIzxj",287,0.996528,20,288,1,287,1,1,0,1,1,151,150,137,137,17
"1306",5,"[20]HoIoHcotHnJHGqKCIzxj",283,0.996479,20,284,1,283,1,1,0,1,1,137,136,147,147,17
"1307",6,"[20]HoIoHcotHnJHGqKCIzxj",290,0.996564,20,291,1,290,1,1,0,1,1,138,137,153,153,17
"1308",7,"[20]HoIoHcotHnJHGqKCIzxj",290,0.996564,20,291,1,290,1,1,0,1,1,148,147,143,143,17
"1309",8,"[20]HoIoHcotHnJHGqKCIzxj",280,0.996441,20,281,1,280,1,1,0,1,1,157,156,124,124,17
"1310",9,"[20]HoIoHcotHnJHGqKCIzxj",284,0.996491,20,285,1,284,1,1,0,1,1,141,140,144,144,17
"1311",10,"[20]HoIoHcotHnJHGqKCIzxj",283,0.996479,20,284,1,283,1,1,0,1,1,153,152,131,131,17
"1312",11,"[20]HoIoHcotHnJHGqKCIzxj",277,0.996403,20,278,1,277,1,1,0,1,1,140,139,138,138,17
"1313",12,"[20]HoIoHcotHnJHGqKCIzxj",272,0.996337,20,273,1,272,1,1,0,1,1,116,115,157,157,17
"1314",13,"[20]HoIoHcotHnJHGqKCIzxj",284,0.996491,20,285,1,284,1,1,0,1,1,141,140,144,144,17
"1315",14,"[20]HoIoHcotHnJHGqKCIzxj",283,0.996479,20,284,1,283,1,1,0,1,1,157,156,127,127,17
"1316",15,"[20]HoIoHcotHnJHGqKCIzxj",283,0.996479,20,284,1,283,1,1,0,1,1,151,150,133,133,17
"1317",16,"[20]HoIoHcotHnJHGqKCIzxj",282,0.996466,20,283,1,282,1,1,0,1,1,139,138,144,144,17
"1318",17,"[20]HoIoHcotHnJHGqKCIzxj",278,0.996416,20,279,1,278,1,1,0,1,1,141,140,138,138,17
"1319",18,"[20]HoIoHcotHnJHGqKCIzxj",277,0.996403,20,278,1,277,1,1,0,1,1,130,129,148,148,17
"1320",19,"[20]HoIoHcotHnJHGqKCIzxj",276,0.99639,20,277,1,276,1,1,0,1,1,136,135,141,141,17
"1321",20,"[20]HoIoHcotHnJHGqKCIzxj",284,0.996491,20,285,1,284,1,1,0,1,1,156,155,129,129,17
"1322",21,"[20]HoIoHcotHnJHGqKCIzxj",281,0.996454,20,282,1,281,1,1,0,1,1,134,133,148,148,17
"1323",22,"[20]HoIoHcotHnJHGqKCIzxj",277,0.996403,20,278,1,277,1,1,0,1,1,156,155,122,122,17
"1324",23,"[20]HoIoHcotHnJHGqKCIzxj",275,0.996377,20,276,1,275,1,1,0,1,1,139,138,137,137,17
"1325",24,"[20]HoIoHcotHnJHGqKCIzxj",284,0.996491,20,285,1,284,1,1,0,1,1,150,149,135,135,17
"1326",25,"[20]HoIoHcotHnJHGqKCIzxj",282,0.996466,20,283,1,282,1,1,0,1,1,141,140,142,142,17
"1327",26,"[20]HoIoHcotHnJHGqKCIzxj",288,0.99654,20,289,1,288,1,1,0,1,1,156,155,133,133,17
"1328",27,"[20]HoIoHcotHnJHGqKCIzxj",281,0.996454,20,282,1,281,1,1,0,1,1,136,135,146,146,17
"1329",28,"[20]HoIoHcotHnJHGqKCIzxj",279,0.996429,20,280,1,279,1,1,0,1,1,140,139,140,140,17
"1330",29,"[20]HoIoHcotHnJHGqKCIzxj",271,0.996324,20,272,1,271,1,1,0,1,1,135,134,137,137,17
"1331",30,"[20]HoIoHcotHnJHGqKCIzxj",281,0.996454,20,282,1,281,1,1,0,1,1,145,144,137,137,17
"1332",31,"[20]HoIoHcotHnJHGqKCIzxj",283,0.996479,20,284,1,283,1,1,0,1,1,142,141,142,142,17
"1333",32,"[20]HoIoHcotHnJHGqKCIzxj",285,0.996503,20,286,1,285,1,1,0,1,1,131,130,155,155,17
"1334",33,"[20]HoIoHcotHnJHGqKCIzxj",277,0.996403,20,278,1,277,1,1,0,1,1,135,134,143,143,17
"1335",34,"[20]HoIoHcotHnJHGqKCIzxj",275,0.996377,20,276,1,275,1,1,0,1,1,151,150,125,125,17
"1336",35,"[20]HoIoHcotHnJHGqKCIzxj",281,0.996454,20,282,1,281,1,1,0,1,1,132,131,150,150,17
"1337",36,"[20]HoIoHcotHnJHGqKCIzxj",278,0.996416,20,279,1,278,1,1,0,1,1,141,140,138,138,17
"1338",37,"[20]HoIoHcotHnJHGqKCIzxj",285,0.996503,20,286,1,285,1,1,0,1,1,147,146,139,139,17
"1339",38,"[20]HoIoHcotHnJHGqKCIzxj",283,0.996479,20,284,1,283,1,1,0,1,1,142,141,142,142,17
"1340",39,"[20]HoIoHcotHnJHGqKCIzxj",284,0.996491,20,285,1,284,1,1,0,1,1,149,148,136,136,17
"1341",40,"[20]HoIoHcotHnJHGqKCIzxj",273,0.99635,20,274,1,273,1,1,0,1,1,141,140,133,133,17
"1342",41,"[20]HoIoHcotHnJHGqKCIzxj",279,0.996429,20,280,1,279,1,1,0,1,1,133,132,147,147,17
"1343",42,"[20]HoIoHcotHnJHGqKCIzxj",280,0.996441,20,281,1,280,1,1,0,1,1,135,134,146,146,17
"1344",43,"[20]HoIoHcotHnJHGqKCIzxj",284,0.996491,20,285,1,284,1,1,0,1,1,148,147,137,137,17
"1345",44,"[20]HoIoHcotHnJHGqKCIzxj",283,0.996479,20,284,1,283,1,1,0,1,1,146,145,138,138,17
"1346",45,"[20]HoIoHcotHnJHGqKCIzxj",283,0.996479,20,284,1,283,1,1,0,1,1,147,146,137,137,17
"1347",46,"[20]HoIoHcotHnJHGqKCIzxj",284,0.996491,20,285,1,284,1,1,0,1,1,142,141,143,143,17
"1348",47,"[20]HoIoHcotHnJHGqKCIzxj",280,0.996441,20,281,1,280,1,1,0,1,1,139,138,142,142,17
"1349",48,"[20]HoIoHcotHnJHGqKCIzxj",281,0.996454,20,282,1,281,1,1,0,1,1,140,139,142,142,17
"1350",49,"[20]HoIoHcotHnJHGqKCIzxj",276,0.99639,20,277,1,276,1,1,0,1,1,147,146,130,130,17
"1351",50,"[20]HoIoHcotHnJHGqKCIzxj",279,0.996429,20,280,1,279,1,1,0,1,1,137,136,143,143,17
"1352",51,"[20]HoIoHcotHnJHGqKCIzxj",283,0.996479,20,284,1,283,1,1,0,1,1,160,159,124,124,17
"1353",52,"[20]HoIoHcotHnJHGqKCIzxj",279,0.996429,20,280,1,279,1,1,0,1,1,137,136,143,143,17
"1354",53,"[20]HoIoHcotHnJHGqKCIzxj",283,0.996479,20,284,1,283,1,1,0,1,1,153,152,131,131,17
"1355",54,"[20]HoIoHcotHnJHGqKCIzxj",277,0.996403,20,278,1,277,1,1,0,1,1,127,126,151,151,17
"1356",55,"[20]HoIoHcotHnJHGqKCIzxj",283,0.996479,20,284,1,283,1,1,0,1,1,133,132,151,151,17
"1357",56,"[20]HoIoHcotHnJHGqKCIzxj",291,0.996575,20,292,1,291,1,1,0,1,1,156,155,136,136,17
"1358",57,"[20]HoIoHcotHnJHGqKCIzxj",285,0.996503,20,286,1,285,1,1,0,1,1,155,154,131,131,17
"1359",58,"[20]HoIoHcotHnJHGqKCIzxj",273,0.99635,20,274,1,273,1,1,0,1,1,135,134,139,139,17
"1360",59,"[20]HoIoHcotHnJHGqKCIzxj",278,0.996416,20,279,1,278,1,1,0,1,1,146,145,133,133,17
"1361",60,"[20]HoIoHcotHnJHGqKCIzxj",284,0.996491,20,285,1,284,1,1,0,1,1,143,142,142,142,17
"1362",61,"[20]HoIoHcotHnJHGqKCIzxj",281,0.996454,20,282,1,281,1,1,0,1,1,163,162,119,119,17
"1363",62,"[20]HoIoHcotHnJHGqKCIzxj",285,0.996503,20,286,1,285,1,1,0,1,1,141,140,145,145,17
"1364",63,"[20]HoIoHcotHnJHGqKCIzxj",287,0.996528,20,288,1,287,1,1,0,1,1,143,142,145,145,17
"1365",64,"[20]HoIoHcotHnJHGqKCIzxj",284,0.996491,20,285,1,284,1,1,0,1,1,129,128,156,156,17
"1366",65,"[20]HoIoHcotHnJHGqKCIzxj",287,0.996528,20,288,1,287,1,1,0,1,1,151,150,137,137,17
"1367",66,"[20]HoIoHcotHnJHGqKCIzxj",288,0.99654,20,289,1,288,1,1,0,1,1,137,136,152,152,17
"1368",67,"[20]HoIoHcotHnJHGqKCIzxj",281,0.996454,20,282,1,281,1,1,0,1,1,138,137,144,144,17
"1369",68,"[20]HoIoHcotHnJHGqKCIzxj",274,0.996364,20,275,1,274,1,1,0,1,1,135,134,140,140,17
"1370",69,"[20]HoIoHcotHnJHGqKCIzxj",283,0.996479,20,284,1,283,1,1,0,1,1,146,145,138,138,17
"1371",70,"[20]HoIoHcotHnJHGqKCIzxj",285,0.996503,20,286,1,285,1,1,0,1,1,137,136,149,149,17
"1372",71,"[20]HoIoHcotHnJHGqKCIzxj",284,0.996491,20,285,1,284,1,1,0,1,1,164,163,121,121,17
"1373",72,"[20]HoIoHcotHnJHGqKCIzxj",282,0.996466,20,283,1,282,1,1,0,1,1,150,149,133,133,17
"1374",73,"[20]HoIoHcotHnJHGqKCIzxj",281,0.996454,20,282,1,281,1,1,0,1,1,136,135,146,146,17
"1375",74,"[20]HoIoHcotHnJHGqKCIzxj",275,0.996377,20,276,1,275,1,1,0,1,1,135,134,141,141,17
"1376",75,"[20]HoIoHcotHnJHGqKCIzxj",284,0.996491,20,285,1,284,1,1,0,1,1,129,128,156,156,17
"1377",76,"[20]HoIoHcotHnJHGqKCIzxj",287,0.996528,20,288,1,287,1,1,0,1,1,159,158,129,129,17
"1378",77,"[20]HoIoHcotHnJHGqKCIzxj",285,0.996503,20,286,1,285,1,1,0,1,1,146,145,140,140,17
"1379",78,"[20]HoIoHcotHnJHGqKCIzxj",276,0.99639,20,277,1,276,1,1,0,1,1,124,123,153,153,17
"1380",79,"[20]HoIoHcotHnJHGqKCIzxj",287,0.996528,20,288,1,287,1,1,0,1,1,146,145,142,142,17
"1381",80,"[20]HoIoHcotHnJHGqKCIzxj",279,0.996429,20,280,1,279,1,1,0,1,1,130,129,150,150,17
"1382",81,"[20]HoIoHcotHnJHGqKCIzxj",282,0.996466,20,283,1,282,1,1,0,1,1,143,142,140,140,17
"1383",82,"[20]HoIoHcotHnJHGqKCIzxj",283,0.996479,20,284,1,283,1,1,0,1,1,140,139,144,144,17
"1384",83,"[20]HoIoHcotHnJHGqKCIzxj",281,0.996454,20,282,1,281,1,1,0,1,1,138,137,144,144,17
"1385",84,"[20]HoIoHcotHnJHGqKCIzxj",285,0.996503,20,286,1,285,1,1,0,1,1,144,143,142,142,17
"1386",85,"[20]HoIoHcotHnJHGqKCIzxj",275,0.996377,20,276,1,275,1,1,0,1,1,150,149,126,126,17
"1387",86,"[20]HoIoHcotHnJHGqKCIzxj",273,0.99635,20,274,1,273,1,1,0,1,1,143,142,131,131,17
"1388",87,"[20]HoIoHcotHnJHGqKCIzxj",283,0.996479,20,284,1,283,1,1,0,1,1,148,147,136,136,17
"1389",88,"[20]HoIoHcotHnJHGqKCIzxj",275,0.996377,20,276,1,275,1,1,0,1,1,132,131,144,144,17
"1390",89,"[20]HoIoHcotHnJHGqKCIzxj",281,0.996454,20,282,1,281,1,1,0,1,1,135,134,147,147,17
"1391",90,"[20]HoIoHcotHnJHGqKCIzxj",278,0.996416,20,279,1,278,1,1,0,1,1,159,158,120,120,17
"1392",91,"[20]HoIoHcotHnJHGqKCIzxj",280,0.996441,20,281,1,280,1,1,0,1,1,144,143,137,137,17
"1393",92,"[20]HoIoHcotHnJHGqKCIzxj",285,0.996503,20,286,1,285,1,1,0,1,1,138,137,148,148,17
"1394",93,"[20]HoIoHcotHnJHGqKCIzxj",290,0.996564,20,291,1,290,1,1,0,1,1,137,136,154,154,17
"1395",94,"[20]HoIoHcotHnJHGqKCIzxj",278,0.996416,20,279,1,278,1,1,0,1,1,140,139,139,139,17
"1396",95,"[20]HoIoHcotHnJHGqKCIzxj",280,0.996441,20,281,1,280,1,1,0,1,1,140,139,141,141,17
"1397",96,"[20]HoIoHcotHnJHGqKCIzxj",279,0.996429,20,280,1,279,1,1,0,1,1,143,142,137,137,17
"1398",97,"[20]HoIoHcotHnJHGqKCIzxj",289,0.996552,20,290,1,289,1,1,0,1,1,154,153,136,136,17
"1399",98,"[20]HoIoHcotHnJHGqKCIzxj",284,0.996491,20,285,1,284,1,1,0,1,1,142,141,143,143,17
"1400",99,"[20]HoIoHcotHnJHGqKCIzxj",277,0.996403,20,278,1,277,1,1,0,1,1,131,130,147,147,17
"1401",0,"[27]iHoIoHcouHnJHGqKCkermqvirKf",291,0.996575,27,292,1,291,1,1,0,1,1,151,150,141,141,18
"1402",1,"[27]iHoIoHcouHnJHGqKCkermqvirKf",282,0.996466,27,283,1,282,1,1,0,1,1,150,149,133,133,18
"1403",2,"[27]iHoIoHcouHnJHGqKCkermqvirKf",283,0.996479,27,284,1,283,1,1,0,1,1,148,147,136,136,18
"1404",3,"[27]iHoIoHcouHnJHGqKCkermqvirKf",281,0.996454,27,282,1,281,1,1,0,1,1,151,150,131,131,18
"1405",4,"[27]iHoIoHcouHnJHGqKCkermqvirKf",283,0.996479,27,284,1,283,1,1,0,1,1,149,148,135,135,18
"1406",5,"[27]iHoIoHcouHnJHGqKCkermqvirKf",286,0.996516,27,287,1,286,1,1,0,1,1,139,138,148,148,18
"1407",6,"[27]iHoIoHcouHnJHGqKCkermqvirKf",272,0.996337,27,273,1,272,1,1,0,1,1,130,129,143,143,18
"1408",7,"[27]iHoIoHcouHnJHGqKCkermqvirKf",285,0.996503,27,286,1,285,1,1,0,1,1,156,155,130,130,18
"1409",8,"[27]iHoIoHcouHnJHGqKCkermqvirKf",286,0.996516,27,287,1,286,1,1,0,1,1,147,146,140,140,18
"1410",9,"[27]iHoIoHcouHnJHGqKCkermqvirKf",277,0.996403,27,278,1,277,1,1,0,1,1,147,146,131,131,18
"1411",10,"[27]iHoIoHcouHnJHGqKCkermqvirKf",277,0.996403,27,278,1,277,1,1,0,1,1,148,147,130,130,18
"1412",11,"[27]iHoIoHcouHnJHGqKCkermqvirKf",280,0.996441,27,281,1,280,1,1,0,1,1,148,147,133,133,18
"1413",12,"[27]iHoIoHcouHnJHGqKCkermqvirKf",283,0.996479,27,284,1,283,1,1,0,1,1,145,144,139,139,18
"1414",13,"[27]iHoIoHcouHnJHGqKCkermqvirKf",286,0.996516,27,287,1,286,1,1,0,1,1,151,150,136,136,18
"1415",14,"[27]iHoIoHcouHnJHGqKCkermqvirKf",281,0.996454,27,282,1,281,1,1,0,1,1,142,141,140,140,18
"1416",15,"[27]iHoIoHcouHnJHGqKCkermqvirKf",278,0.996416,27,279,1,278,1,1,0,1,1,133,132,146,146,18
"1417",16,"[27]iHoIoHcouHnJHGqKCkermqvirKf",284,0.996491,27,285,1,284,1,1,0,1,1,133,132,152,152,18
"1418",17,"[27]iHoIoHcouHnJHGqKCkermqvirKf",276,0.99639,27,277,1,276,1,1,0,1,1,131,130,146,146,18
"1419",18,"[27]iHoIoHcouHnJHGqKCkermqvirKf",277,0.996403,27,278,1,277,1,1,0,1,1,141,140,137,137,18
"1420",19,"[27]iHoIoHcouHnJHGqKCkermqvirKf",284,0.996491,27,285,1,284,1,1,0,1,1,138,137,147,147,18
"1421",20,"[27]iHoIoHcouHnJHGqKCkermqvirKf",270,0.99631,27,271,1,270,1,1,0,1,1,132,131,139,139,18
"1422",21,"[27]iHoIoHcouHnJHGqKCkermqvirKf",277,0.996403,27,278,1,277,1,1,0,1,1,122,121,156,156,18
"1423",22,"[27]iHoIoHcouHnJHGqKCkermqvirKf",283,0.996479,27,284,1,283,1,1,0,1,1,137,136,147,147,18
"1424",23,"[27]iHoIoHcouHnJHGqKCkermqvirKf",282,0.996466,27,283,1,282,1,1,0,1,1,154,153,129,129,18
"1425",24,"[27]iHoIoHcouHnJHGqKCkermqvirKf",287,0.996528,27,288,1,287,1,1,0,1,1,144,143,144,144,18
"1426",25,"[27]iHoIoHcouHnJHGqKCkermqvirKf",279,0.996429,27,280,1,279,1,1,0,1,1,137,136,143,143,18
"1427",26,"[27]iHoIoHcouHnJHGqKCkermqvirKf",285,0.996503,27,286,1,285,1,1,0,1,1,138,137,148,148,18
"1428",27,"[27]iHoIoHcouHnJHGqKCkermqvirKf",285,0.996503,27,286,1,285,1,1,0,1,1,134,133,152,152,18
"1429",28,"[27]iHoIoHcouHnJHGqKCkermqvirKf",280,0.996441,27,281,1,280,1,1,0,1,1,131,130,150,150,18
"1430",29,"[27]iHoIoHcouHnJHGqKCkermqvirKf",267,0.996269,27,268,1,267,1,1,0,1,1,135,134,133,133,18
"1431",30,"[27]iHoIoHcouHnJHGqKCkermqvirKf",272,0.996337,27,273,1,272,1,1,0,1,1,147,146,126,126,18
"1432",31,"[27]iHoIoHcouHnJHGqKCkermqvirKf",277,0.996403,27,278,1,277,1,1,0,1,1,147,146,131,131,18
"1433",32,"[27]iHoIoHcouHnJHGqKCkermqvirKf",283,0.996479,27,284,1,283,1,1,0,1,1,137,136,147,147,18
"1434",33,"[27]iHoIoHcouHnJHGqKCkermqvirKf",278,0.996416,27,279,1,278,1,1,0,1,1,136,135,143,143,18
"1435",34,"[27]iHoIoHcouHnJHGqKCkermqvirKf",279,0.996429,27,280,1,279,1,1,0,1,1,139,138,141,141,18
"1436",35,"[27]iHoIoHcouHnJHGqKCkermqvirKf",282,0.996466,27,283,1,282,1,1,0,1,1,149,148,134,134,18
"1437",36,"[27]iHoIoHcouHnJHGqKCkermqvirKf",285,0.996503,27,286,1,285,1,1,0,1,1,148,147,138,138,18
"1438",37,"[27]iHoIoHcouHnJHGqKCkermqvirKf",272,0.996337,27,273,1,272,1,1,0,1,1,143,142,130,130,18
"1439",38,"[27]iHoIoHcouHnJHGqKCkermqvirKf",282,0.996466,27,283,1,282,1,1,0,1,1,140,139,143,143,18
"1440",39,"[27]iHoIoHcouHnJHGqKCkermqvirKf",280,0.996441,27,281,1,280,1,1,0,1,1,135,134,146,146,18
"1441",40,"[27]iHoIoHcouHnJHGqKCkermqvirKf",281,0.996454,27,282,1,281,1,1,0,1,1,140,139,142,142,18
"1442",41,"[27]iHoIoHcouHnJHGqKCkermqvirKf",283,0.996479,27,284,1,283,1,1,0,1,1,139,138,145,145,18
"1443",42,"[27]iHoIoHcouHnJHGqKCkermqvirKf",267,0.996269,27,268,1,267,1,1,0,1,1,123,122,145,145,18
"1444",43,"[27]iHoIoHcouHnJHGqKCkermqvirKf",286,0.996516,27,287,1,286,1,1,0,1,1,164,163,123,123,18
"1445",44,"[27]iHoIoHcouHnJHGqKCkermqvirKf",281,0.996454,27,282,1,281,1,1,0,1,1,141,140,141,141,18
"1446",45,"[27]iHoIoHcouHnJHGqKCkermqvirKf",283,0.996479,27,284,1,283,1,1,0,1,1,143,142,141,141,18
"1447",46,"[27]iHoIoHcouHnJHGqKCkermqvirKf",289,0.996552,27,290,1,289,1,1,0,1,1,153,152,137,137,18
"1448",47,"[27]iHoIoHcouHnJHGqKCkermqvirKf",278,0.996416,27,279,1,278,1,1,0,1,1,142,141,137,137,18
"1449",48,"[27]iHoIoHcouHnJHGqKCkermqvirKf",281,0.996454,27,282,1,281,1,1,0,1,1,140,139,142,142,18
"1450",49,"[27]iHoIoHcouHnJHGqKCkermqvirKf",282,0.996466,27,283,1,282,1,1,0,1,1,142,141,141,141,18
"1451",50,"[27]iHoIoHcouHnJHGqKCkermqvirKf",274,0.996364,27,275,1,274,1,1,0,1,1,136,135,139,139,18
"1452",51,"[27]iHoIoHcouHnJHGqKCkermqvirKf",278,0.996416,27,279,1,278,1,1,0,1,1,149,148,130,130,18
"1453",52,"[27]iHoIoHcouHnJHGqKCkermqvirKf",286,0.996516,27,287,1,286,1,1,0,1,1,166,165,121,121,18
"1454",53,"[27]iHoIoHcouHnJHGqKCkermqvirKf",279,0.996429,27,280,1,279,1,1,0,1,1,128,127,152,152,18
"1455",54,"[27]iHoIoHcouHnJHGqKCkermqvirKf",286,0.996516,27,287,1,286,1,1,0,1,1,146,145,141,141,18
"1456",55,"[27]iHoIoHcouHnJHGqKCkermqvirKf",282,0.996466,27,283,1,282,1,1,0,1,1,143,142,140,140,18
"1457",56,"[27]iHoIoHcouHnJHGqKCkermqvirKf",276,0.99639,27,277,1,276,1,1,0,1,1,131,130,146,146,18
"1458",57,"[27]iHoIoHcouHnJHGqKCkermqvirKf",284,0.996491,27,285,1,284,1,1,0,1,1,155,154,130,130,18
"1459",58,"[27]iHoIoHcouHnJHGqKCkermqvirKf",281,0.996454,27,282,1,281,1,1,0,1,1,140,139,142,142,18
"1460",59,"[27]iHoIoHcouHnJHGqKCkermqvirKf",278,0.996416,27,279,1,278,1,1,0,1,1,153,152,126,126,18
"1461",60,"[27]iHoIoHcouHnJHGqKCkermqvirKf",293,0.996599,27,294,1,293,1,1,0,1,1,158,157,136,136,18
"1462",61,"[27]iHoIoHcouHnJHGqKCkermqvirKf",273,0.99635,27,274,1,273,1,1,0,1,1,142,141,132,132,18
"1463",62,"[27]iHoIoHcouHnJHGqKCkermqvirKf",278,0.996416,27,279,1,278,1,1,0,1,1,140,139,139,139,18
"1464",63,"[27]iHoIoHcouHnJHGqKCkermqvirKf",281,0.996454,27,282,1,281,1,1,0,1,1,141,140,141,141,18
"1465",64,"[27]iHoIoHcouHnJHGqKCkermqvirKf",275,0.996377,27,276,1,275,1,1,0,1,1,123,122,153,153,18
"1466",65,"[27]iHoIoHcouHnJHGqKCkermqvirKf",284,0.996491,27,285,1,284,1,1,0,1,1,135,134,150,150,18
"1467",66,"[27]iHoIoHcouHnJHGqKCkermqvirKf",277,0.996403,27,278,1,277,1,1,0,1,1,136,135,142,142,18
"1468",67,"[27]iHoIoHcouHnJHGqKCkermqvirKf",281,0.996454,27,282,1,281,1,1,0,1,1,161,160,121,121,18
"1469",68,"[27]iHoIoHcouHnJHGqKCkermqvirKf",275,0.996377,27,276,1,275,1,1,0,1,1,141,140,135,135,18
"1470",69,"[27]iHoIoHcouHnJHGqKCkermqvirKf",290,0.996564,27,291,1,290,1,1,0,1,1,138,137,153,153,18
"1471",70,"[27]iHoIoHcouHnJHGqKCkermqvirKf",278,0.996416,27,279,1,278,1,1,0,1,1,141,140,138,138,18
"1472",71,"[27]iHoIoHcouHnJHGqKCkermqvirKf",274,0.996364,27,275,1,274,1,1,0,1,1,126,125,149,149,18
"1473",72,"[27]iHoIoHcouHnJHGqKCkermqvirKf",281,0.996454,27,282,1,281,1,1,0,1,1,136,135,146,146,18
"1474",73,"[27]iHoIoHcouHnJHGqKCkermqvirKf",282,0.996466,27,283,1,282,1,1,0,1,1,136,135,147,147,18
"1475",74,"[27]iHoIoHcouHnJHGqKCkermqvirKf",284,0.996491,27,285,1,284,1,1,0,1,1,137,136,148,148,18
"1476",75,"[27]iHoIoHcouHnJHGqKCkermqvirKf",279,0.996429,27,280,1,279,1,1,0,1,1,139,138,141,141,18
"1477",76,"[27]iHoIoHcouHnJHGqKCkermqvirKf",279,0.996429,27,280,1,279,1,1,0,1,1,139,138,141,141,18
"1478",77,"[27]iHoIoHcouHnJHGqKCkermqvirKf",275,0.996377,27,276,1,275,1,1,0,1,1,136,135,140,140,18
"1479",78,"[27]iHoIoHcouHnJHGqKCkermqvirKf",277,0.996403,27,278,1,277,1,1,0,1,1,133,132,145,145,18
"1480",79,"[27]iHoIoHcouHnJHGqKCkermqvirKf",278,0.996416,27,279,1,278,1,1,0,1,1,127,126,152,152,18
"1481",80,"[27]iHoIoHcouHnJHGqKCkermqvirKf",283,0.996479,27,284,1,283,1,1,0,1,1,150,149,134,134,18
"1482",81,"[27]iHoIoHcouHnJHGqKCkermqvirKf",279,0.996429,27,280,1,279,1,1,0,1,1,137,136,143,143,18
"1483",82,"[27]iHoIoHcouHnJHGqKCkermqvirKf",285,0.996503,27,286,1,285,1,1,0,1,1,157,156,129,129,18
"1484",83,"[27]iHoIoHcouHnJHGqKCkermqvirKf",276,0.99639,27,277,1,276,1,1,0,1,1,141,140,136,136,18
"1485",84,"[27]iHoIoHcouHnJHGqKCkermqvirKf",287,0.996528,27,288,1,287,1,1,0,1,1,144,143,144,144,18
"1486",85,"[27]iHoIoHcouHnJHGqKCkermqvirKf",289,0.996552,27,290,1,289,1,1,0,1,1,152,151,138,138,18
"1487",86,"[27]iHoIoHcouHnJHGqKCkermqvirKf",278,0.996416,27,279,1,278,1,1,0,1,1,138,137,141,141,18
"1488",87,"[27]iHoIoHcouHnJHGqKCkermqvirKf",277,0.996403,27,278,1,277,1,1,0,1,1,138,137,140,140,18
"1489",88,"[27]iHoIoHcouHnJHGqKCkermqvirKf",286,0.996516,27,287,1,286,1,1,0,1,1,137,136,150,150,18
"1490",89,"[27]iHoIoHcouHnJHGqKCkermqvirKf",281,0.996454,27,282,1,281,1,1,0,1,1,136,135,146,146,18
"1491",90,"[27]iHoIoHcouHnJHGqKCkermqvirKf",285,0.996503,27,286,1,285,1,1,0,1,1,144,143,142,142,18
"1492",91,"[27]iHoIoHcouHnJHGqKCkermqvirKf",278,0.996416,27,279,1,278,1,1,0,1,1,131,130,148,148,18
"1493",92,"[27]iHoIoHcouHnJHGqKCkermqvirKf",282,0.996466,27,283,1,282,1,1,0,1,1,143,142,140,140,18
"1494",93,"[27]iHoIoHcouHnJHGqKCkermqvirKf",287,0.996528,27,288,1,287,1,1,0,1,1,153,152,135,135,18
"1495",94,"[27]iHoIoHcouHnJHGqKCkermqvirKf",278,0.996416,27,279,1,278,1,1,0,1,1,129,128,150,150,18
"1496",95,"[27]iHoIoHcouHnJHGqKCkermqvirKf",276,0.99639,27,277,1,276,1,1,0,1,1,156,155,121,121,18
"1497",96,"[27]iHoIoHcouHnJHGqKCkermqvirKf",277,0.996403,27,278,1,277,1,1,0,1,1,141,140,137,137,18
"1498",97,"[27]iHoIoHcouHnJHGqKCkermqvirKf",279,0.996429,27,280,1,279,1,1,0,1,1,132,131,148,148,18
"1499",98,"[27]iHoIoHcouHnJHGqKCkermqvirKf",279,0.996429,27,280,1,279,1,1,0,1,1,142,141,138,138,18
"1500",99,"[27]iHoIoHcouHnJHGqKCkermqvirKf",281,0.996454,27,282,1,281,1,1,0,1,1,126,125,156,156,18
"1501",0,"[28]wGHoIoHcouHnJHGqKCKgCoBBeKmt",287,0.996528,28,288,1,287,1,1,0,1,1,156,155,132,132,19
"1502",1,"[28]wGHoIoHcouHnJHGqKCKgCoBBeKmt",284,0.996491,28,285,1,284,1,1,0,1,1,143,142,142,142,19
"1503",2,"[28]wGHoIoHcouHnJHGqKCKgCoBBeKmt",288,0.99654,28,289,1,288,1,1,0,1,1,142,141,147,147,19
"1504",3,"[28]wGHoIoHcouHnJHGqKCKgCoBBeKmt",283,0.996479,28,284,1,283,1,1,0,1,1,136,135,148,148,19
"1505",4,"[28]wGHoIoHcouHnJHGqKCKgCoBBeKmt",273,0.99635,28,274,1,273,1,1,0,1,1,134,133,140,140,19
"1506",5,"[28]wGHoIoHcouHnJHGqKCKgCoBBeKmt",273,0.99635,28,274,1,273,1,1,0,1,1,136,135,138,138,19
"1507",6,"[28]wGHoIoHcouHnJHGqKCKgCoBBeKmt",280,0.996441,28,281,1,280,1,1,0,1,1,141,140,140,140,19
"1508",7,"[28]wGHoIoHcouHnJHGqKCKgCoBBeKmt",278,0.996416,28,279,1,278,1,1,0,1,1,132,131,147,147,19
"1509",8,"[28]wGHoIoHcouHnJHGqKCKgCoBBeKmt",284,0.996491,28,285,1,284,1,1,0,1,1,157,156,128,128,19
"1510",9,"[28]wGHoIoHcouHnJHGqKCKgCoBBeKmt",280,0.996441,28,281,1,280,1,1,0,1,1,125,124,156,156,19
"1511",10,"[28]wGHoIoHcouHnJHGqKCKgCoBBeKmt",272,0.996337,28,273,1,272,1,1,0,1,1,143,142,130,130,19
"1512",11,"[28]wGHoIoHcouHnJHGqKCKgCoBBeKmt",281,0.996454,28,282,1,281,1,1,0,1,1,137,136,145,145,19
"1513",12,"[28]wGHoIoHcouHnJHGqKCKgCoBBeKmt",275,0.996377,28,276,1,275,1,1,0,1,1,137,136,139,139,19
"1514",13,"[28]wGHoIoHcouHnJHGqKCKgCoBBeKmt",280,0.996441,28,281,1,280,1,1,0,1,1,155,154,126,126,19
"1515",14,"[28]wGHoIoHcouHnJHGqKCKgCoBBeKmt",281,0.996454,28,282,1,281,1,1,0,1,1,129,128,153,153,19
"1516",15,"[28]wGHoIoHcouHnJHGqKCKgCoBBeKmt",290,0.996564,28,291,1,290,1,1,0,1,1,153,152,138,138,19
"1517",16,"[28]wGHoIoHcouHnJHGqKCKgCoBBeKmt",285,0.996503,28,286,1,285,1,1,0,1,1,143,142,143,143,19
"1518",17,"[28]wGHoIoHcouHnJHGqKCKgCoBBeKmt",279,0.996429,28,280,1,279,1,1,0,1,1,143,142,137,137,19
"1519",18,"[28]wGHoIoHcouHnJHGqKCKgCoBBeKmt",277,0.996403,28,278,1,277,1,1,0,1,1,141,140,137,137,19
"1520",19,"[28]wGHoIoHcouHnJHGqKCKgCoBBeKmt",278,0.996416,28,279,1,278,1,1,0,1,1,146,145,133,133,19
"1521",20,"[28]wGHoIoHcouHnJHGqKCKgCoBBeKmt",283,0.996479,28,284,1,283,1,1,0,1,1,149,148,135,135,19
"1522",21,"[28]wGHoIoHcouHnJHGqKCKgCoBBeKmt",285,0.996503,28,286,1,285,1,1,0,1,1,147,146,139,139,19
"1523",22,"[28]wGHoIoHcouHnJHGqKCKgCoBBeKmt",284,0.996491,28,285,1,284,1,1,0,1,1,151,150,134,134,19
"1524",23,"[28]wGHoIoHcouHnJHGqKCKgCoBBeKmt",281,0.996454,28,282,1,281,1,1,0,1,1,149,148,133,133,19
"1525",24,"[28]wGHoIoHcouHnJHGqKCKgCoBBeKmt",273,0.99635,28,274,1,273,1,1,0,1,1,125,124,149,149,19
"1526",25,"[28]wGHoIoHcouHnJHGqKCKgCoBBeKmt",286,0.996516,28,287,1,286,1,1,0,1,1,141,140,146,146,19
"1527",26,"[28]wGHoIoHcouHnJHGqKCKgCoBBeKmt",278,0.996416,28,279,1,278,1,1,0,1,1,131,130,148,148,19
"1528",27,"[28]wGHoIoHcouHnJHGqKCKgCoBBeKmt",275,0.996377,28,276,1,275,1,1,0,1,1,139,138,137,137,19
"1529",28,"[28]wGHoIoHcouHnJHGqKCKgCoBBeKmt",284,0.996491,28,285,1,284,1,1,0,1,1,138,137,147,147,19
"1530",29,"[28]wGHoIoHcouHnJHGqKCKgCoBBeKmt",279,0.996429,28,280,1,279,1,1,0,1,1,144,143,136,136,19
"1531",30,"[28]wGHoIoHcouHnJHGqKCKgCoBBeKmt",281,0.996454,28,282,1,281,1,1,0,1,1,135,134,147,147,19
"1532",31,"[28]wGHoIoHcouHnJHGqKCKgCoBBeKmt",270,0.99631,28,271,1,270,1,1,0,1,1,127,126,144,144,19
"1533",32,"[28]wGHoIoHcouHnJHGqKCKgCoBBeKmt",283,0.996479,28,284,1,283,1,1,0,1,1,149,148,135,135,19
"1534",33,"[28]wGHoIoHcouHnJHGqKCKgCoBBeKmt",277,0.996403,28,278,1,277,1,1,0,1,1,140,139,138,138,19
"1535",34,"[28]wGHoIoHcouHnJHGqKCKgCoBBeKmt",277,0.996403,28,278,1,277,1,1,0,1,1,127,126,151,151,19
"1536",35,"[28]wGHoIoHcouHnJHGqKCKgCoBBeKmt",281,0.996454,28,282,1,281,1,1,0,1,1,148,147,134,134,19
"1537",36,"[28]wGHoIoHcouHnJHGqKCKgCoBBeKmt",275,0.996377,28,276,1,275,1,1,0,1,1,144,143,132,132,19
"1538",37,"[28]wGHoIoHcouHnJHGqKCKgCoBBeKmt",281,0.996454,28,282,1,281,1,1,0,1,1,147,146,135,135,19
"1539",38,"[28]wGHoIoHcouHnJHGqKCKgCoBBeKmt",285,0.996503,28,286,1,285,1,1,0,1,1,146,145,140,140,19
"1540",39,"[28]wGHoIoHcouHnJHGqKCKgCoBBeKmt",274,0.996364,28,275,1,274,1,1,0,1,1,130,129,145,145,19
"1541",40,"[28]wGHoIoHcouHnJHGqKCKgCoBBeKmt",287,0.996528,28,288,1,287,1,1,0,1,1,156,155,132,132,19
"1542",41,"[28]wGHoIoHcouHnJHGqKCKgCoBBeKmt",284,0.996491,28,285,1,284,1,1,0,1,1,142,141,143,143,19
"1543",42,"[28]wGHoIoHcouHnJHGqKCKgCoBBeKmt",278,0.996416,28,279,1,278,1,1,0,1,1,128,127,151,151,19
"1544",43,"[28]wGHoIoHcouHnJHGqKCKgCoBBeKmt",285,0.996503,28,286,1,285,1,1,0,1,1,139,138,147,147,19
"1545",44,"[28]wGHoIoHcouHnJHGqKCKgCoBBeKmt",276,0.99639,28,277,1,276,1,1,0,1,1,128,127,149,149,19
"1546",45,"[28]wGHoIoHcouHnJHGqKCKgCoBBeKmt",279,0.996429,28,280,1,279,1,1,0,1,1,149,148,131,131,19
"1547",46,"[28]wGHoIoHcouHnJHGqKCKgCoBBeKmt",276,0.99639,28,277,1,276,1,1,0,1,1,126,125,151,151,19
"1548",47,"[28]wGHoIoHcouHnJHGqKCKgCoBBeKmt",273,0.99635,28,274,1,273,1,1,0,1,1,121,120,153,153,19
"1549",48,"[28]wGHoIoHcouHnJHGqKCKgCoBBeKmt",284,0.996491,28,285,1,284,1,1,0,1,1,145,144,140,140,19
"1550",49,"[28]wGHoIoHcouHnJHGqKCKgCoBBeKmt",279,0.996429,28,280,1,279,1,1,0,1,1,145,144,135,135,19
"1551",50,"[28]wGHoIoHcouHnJHGqKCKgCoBBeKmt",273,0.99635,28,274,1,273,1,1,0,1,1,136,135,138,138,19
"1552",51,"[28]wGHoIoHcouHnJHGqKCKgCoBBeKmt",280,0.996441,28,281,1,280,1,1,0,1,1,136,135,145,145,19
"1553",52,"[28]wGHoIoHcouHnJHGqKCKgCoBBeKmt",267,0.996269,28,268,1,267,1,1,0,1,1,123,122,145,145,19
"1554",53,"[28]wGHoIoHcouHnJHGqKCKgCoBBeKmt",281,0.996454,28,282,1,281,1,1,0,1,1,128,127,154,154,19
"1555",54,"[28]wGHoIoHcouHnJHGqKCKgCoBBeKmt",276,0.99639,28,277,1,276,1,1,0,1,1,127,126,150,150,19
"1556",55,"[28]wGHoIoHcouHnJHGqKCKgCoBBeKmt",286,0.996516,28,287,1,286,1,1,0,1,1,163,162,124,124,19
"1557",56,"[28]wGHoIoHcouHnJHGqKCKgCoBBeKmt",288,0.99654,28,289,1,288,1,1,0,1,1,137,136,152,152,19
"1558",57,"[28]wGHoIoHcouHnJHGqKCKgCoBBeKmt",294,0.99661,28,295,1,294,1,1,0,1,1,148,147,147,147,19
"1559",58,"[28]wGHoIoHcouHnJHGqKCKgCoBBeKmt",274,0.996364,28,275,1,274,1,1,0,1,1,132,131,143,143,19
"1560",59,"[28]wGHoIoHcouHnJHGqKCKgCoBBeKmt",281,0.996454,28,282,1,281,1,1,0,1,1,152,151,130,130,19
"1561",60,"[28]wGHoIoHcouHnJHGqKCKgCoBBeKmt",286,0.996516,28,287,1,286,1,1,0,1,1,143,142,144,144,19
"1562",61,"[28]wGHoIoHcouHnJHGqKCKgCoBBeKmt",284,0.996491,28,285,1,284,1,1,0,1,1,148,147,137,137,19
"1563",62,"[28]wGHoIoHcouHnJHGqKCKgCoBBeKmt",274,0.996364,28,275,1,274,1,1,0,1,1,129,128,146,146,19
"1564",63,"[28]wGHoIoHcouHnJHGqKCKgCoBBeKmt",281,0.996454,28,282,1,281,1,1,0,1,1,149,148,133,133,19
"1565",64,"[28]wGHoIoHcouHnJHGqKCKgCoBBeKmt",283,0.996479,28,284,1,283,1,1,0,1,1,134,133,150,150,19
"1566",65,"[28]wGHoIoHcouHnJHGqKCKgCoBBeKmt",281,0.996454,28,282,1,281,1,1,0,1,1,141,140,141,141,19
"1567",66,"[28]wGHoIoHcouHnJHGqKCKgCoBBeKmt",286,0.996516,28,287,1,286,1,1,0,1,1,164,163,123,123,19
"1568",67,"[28]wGHoIoHcouHnJHGqKCKgCoBBeKmt",272,0.996337,28,273,1,272,1,1,0,1,1,145,144,128,128,19
"1569",68,"[28]wGHoIoHcouHnJHGqKCKgCoBBeKmt",279,0.996429,28,280,1,279,1,1,0,1,1,139,138,141,141,19
"1570",69,"[28]wGHoIoHcouHnJHGqKCKgCoBBeKmt",276,0.99639,28,277,1,276,1,1,0,1,1,141,140,136,136,19
"1571",70,"[28]wGHoIoHcouHnJHGqKCKgCoBBeKmt",284,0.996491,28,285,1,284,1,1,0,1,1,144,143,141,141,19
"1572",71,"[28]wGHoIoHcouHnJHGqKCKgCoBBeKmt",283,0.996479,28,284,1,283,1,1,0,1,1,139,138,145,145,19
"1573",72,"[28]wGHoIoHcouHnJHGqKCKgCoBBeKmt",280,0.996441,28,281,1,280,1,1,0,1,1,150,149,131,131,19
"1574",73,"[28]wGHoIoHcouHnJHGqKCKgCoBBeKmt",283,0.996479,28,284,1,283,1,1,0,1,1,155,154,129,129,19
"1575",74,"[28]wGHoIoHcouHnJHGqKCKgCoBBeKmt",279,0.996429,28,280,1,279,1,1,0,1,1,135,134,145,145,19
"1576",75,"[28]wGHoIoHcouHnJHGqKCKgCoBBeKmt",277,0.996403,28,278,1,277,1,1,0,1,1,128,127,150,150,19
"1577",76,"[28]wGHoIoHcouHnJHGqKCKgCoBBeKmt",279,0.996429,28,280,1,279,1,1,0,1,1,127,126,153,153,19
"1578",77,"[28]wGHoIoHcouHnJHGqKCKgCoBBeKmt",288,0.99654,28,289,1,288,1,1,0,1,1,152,151,137,137,19
"1579",78,"[28]wGHoIoHcouHnJHGqKCKgCoBBeKmt",282,0.996466,28,283,1,282,1,1,0,1,1,147,146,136,136,19
"1580",79,"[28]wGHoIoHcouHnJHGqKCKgCoBBeKmt",279,0.996429,28,280,1,279,1,1,0,1,1,151,150,129,129,19
"1581",80,"[28]wGHoIoHcouHnJHGqKCKgCoBBeKmt",281,0.996454,28,282,1,281,1,1,0,1,1,145,144,137,137,19
"1582",81,"[28]wGHoIoHcouHnJHGqKCKgCoBBeKmt",269,0.996296,28,270,1,269,1,1,0,1,1,121,120,149,149,19
"1583",82,"[28]wGHoIoHcouHnJHGqKCKgCoBBeKmt",275,0.996377,28,276,1,275,1,1,0,1,1,146,145,130,130,19
"1584",83,"[28]wGHoIoHcouHnJHGqKCKgCoBBeKmt",276,0.99639,28,277,1,276,1,1,0,1,1,139,138,138,138,19
"1585",84,"[28]wGHoIoHcouHnJHGqKCKgCoBBeKmt",279,0.996429,28,280,1,279,1,1,0,1,1,139,138,141,141,19
"1586",85,"[28]wGHoIoHcouHnJHGqKCKgCoBBeKmt",280,0.996441,28,281,1,280,1,1,0,1,1,139,138,142,142,19
"1587",86,"[28]wGHoIoHcouHnJHGqKCKgCoBBeKmt",277,0.996403,28,278,1,277,1,1,0,1,1,128,127,150,150,19
"1588",87,"[28]wGHoIoHcouHnJHGqKCKgCoBBeKmt",280,0.996441,28,281,1,280,1,1,0,1,1,139,138,142,142,19
"1589",88,"[28]wGHoIoHcouHnJHGqKCKgCoBBeKmt",280,0.996441,28,281,1,280,1,1,0,1,1,137,136,144,144,19
"1590",89,"[28]wGHoIoHcouHnJHGqKCKgCoBBeKmt",277,0.996403,28,278,1,277,1,1,0,1,1,146,145,132,132,19
"1591",90,"[28]wGHoIoHcouHnJHGqKCKgCoBBeKmt",278,0.996416,28,279,1,278,1,1,0,1,1,127,126,152,152,19
"1592",91,"[28]wGHoIoHcouHnJHGqKCKgCoBBeKmt",286,0.996516,28,287,1,286,1,1,0,1,1,153,152,134,134,19
"1593",92,"[28]wGHoIoHcouHnJHGqKCKgCoBBeKmt",280,0.996441,28,281,1,280,1,1,0,1,1,145,144,136,136,19
"1594",93,"[28]wGHoIoHcouHnJHGqKCKgCoBBeKmt",281,0.996454,28,282,1,281,1,1,0,1,1,143,142,139,139,19
"1595",94,"[28]wGHoIoHcouHnJHGqKCKgCoBBeKmt",279,0.996429,28,280,1,279,1,1,0,1,1,143,142,137,137,19
"1596",95,"[28]wGHoIoHcouHnJHGqKCKgCoBBeKmt",281,0.996454,28,282,1,281,1,1,0,1,1,134,133,148,148,19
"1597",96,"[28]wGHoIoHcouHnJHGqKCKgCoBBeKmt",286,0.996516,28,287,1,286,1,1,0,1,1,146,145,141,141,19
"1598",97,"[28]wGHoIoHcouHnJHGqKCKgCoBBeKmt",277,0.996403,28,278,1,277,1,1,0,1,1,126,125,152,152,19
"1599",98,"[28]wGHoIoHcouHnJHGqKCKgCoBBeKmt",279,0.996429,28,280,1,279,1,1,0,1,1,145,144,135,135,19
"1600",99,"[28]wGHoIoHcouHnJHGqKCKgCoBBeKmt",275,0.996377,28,276,1,275,1,1,0,1,1,134,133,142,142,19
"1601",0,"[22]cHoIoHcowHnJqGKCIdgbwB",296,0.996633,22,297,1,296,1,1,0,1,1,149,148,148,148,20
"1602",1,"[22]cHoIoHcowHnJqGKCIdgbwB",300,0.996678,22,301,1,300,1,1,0,1,1,153,152,148,148,20
"1603",2,"[22]cHoIoHcowHnJqGKCIdgbwB",299,0.996667,22,300,1,299,1,1,0,1,1,146,145,154,154,20
"1604",3,"[22]cHoIoHcowHnJqGKCIdgbwB",295,0.996622,22,296,1,295,1,1,0,1,1,144,143,152,152,20
"1605",4,"[22]cHoIoHcowHnJqGKCIdgbwB",296,0.996633,22,297,1,296,1,1,0,1,1,145,144,152,152,20
"1606",5,"[22]cHoIoHcowHnJqGKCIdgbwB",305,0.996732,22,306,1,305,1,1,0,1,1,175,174,131,131,20
"1607",6,"[22]cHoIoHcowHnJqGKCIdgbwB",291,0.996575,22,292,1,291,1,1,0,1,1,132,131,160,160,20
"1608",7,"[22]cHoIoHcowHnJqGKCIdgbwB",298,0.996656,22,299,1,298,1,1,0,1,1,156,155,143,143,20
"1609",8,"[22]cHoIoHcowHnJqGKCIdgbwB",298,0.996656,22,299,1,298,1,1,0,1,1,152,151,147,147,20
"1610",9,"[22]cHoIoHcowHnJqGKCIdgbwB",301,0.996689,22,302,1,301,1,1,0,1,1,159,158,143,143,20
"1611",10,"[22]cHoIoHcowHnJqGKCIdgbwB",297,0.996644,22,298,1,297,1,1,0,1,1,147,146,151,151,20
"1612",11,"[22]cHoIoHcowHnJqGKCIdgbwB",296,0.996633,22,297,1,296,1,1,0,1,1,146,145,151,151,20
"1613",12,"[22]cHoIoHcowHnJqGKCIdgbwB",301,0.996689,22,302,1,301,1,1,0,1,1,161,160,141,141,20
"1614",13,"[22]cHoIoHcowHnJqGKCIdgbwB",298,0.996656,22,299,1,298,1,1,0,1,1,154,153,145,145,20
"1615",14,"[22]cHoIoHcowHnJqGKCIdgbwB",295,0.996622,22,296,1,295,1,1,0,1,1,146,145,150,150,20
"1616",15,"[22]cHoIoHcowHnJqGKCIdgbwB",293,0.996599,22,294,1,293,1,1,0,1,1,142,141,152,152,20
"1617",16,"[22]cHoIoHcowHnJqGKCIdgbwB",293,0.996599,22,294,1,293,1,1,0,1,1,140,139,154,154,20
"1618",17,"[22]cHoIoHcowHnJqGKCIdgbwB",302,0.9967,22,303,1,302,1,1,0,1,1,156,155,147,147,20
"1619",18,"[22]cHoIoHcowHnJqGKCIdgbwB",297,0.996644,22,298,1,297,1,1,0,1,1,152,151,146,146,20
"1620",19,"[22]cHoIoHcowHnJqGKCIdgbwB",291,0.996575,22,292,1,291,1,1,0,1,1,136,135,156,156,20
"1621",20,"[22]cHoIoHcowHnJqGKCIdgbwB",301,0.996689,22,302,1,301,1,1,0,1,1,152,151,150,150,20
"1622",21,"[22]cHoIoHcowHnJqGKCIdgbwB",295,0.996622,22,296,1,295,1,1,0,1,1,145,144,151,151,20
"1623",22,"[22]cHoIoHcowHnJqGKCIdgbwB",302,0.9967,22,303,1,302,1,1,0,1,1,163,162,140,140,20
"1624",23,"[22]cHoIoHcowHnJqGKCIdgbwB",298,0.996656,22,299,1,298,1,1,0,1,1,148,147,151,151,20
"1625",24,"[22]cHoIoHcowHnJqGKCIdgbwB",292,0.996587,22,293,1,292,1,1,0,1,1,138,137,155,155,20
"1626",25,"[22]cHoIoHcowHnJqGKCIdgbwB",297,0.996644,22,298,1,297,1,1,0,1,1,152,151,146,146,20
"1627",26,"[22]cHoIoHcowHnJqGKCIdgbwB",292,0.996587,22,293,1,292,1,1,0,1,1,137,136,156,156,20
"1628",27,"[22]cHoIoHcowHnJqGKCIdgbwB",296,0.996633,22,297,1,296,1,1,0,1,1,144,143,153,153,20
"1629",28,"[22]cHoIoHcowHnJqGKCIdgbwB",292,0.996587,22,293,1,292,1,1,0,1,1,136,135,157,157,20
"1630",29,"[22]cHoIoHcowHnJqGKCIdgbwB",292,0.996587,22,293,1,292,1,1,0,1,1,135,134,158,158,20
"1631",30,"[22]cHoIoHcowHnJqGKCIdgbwB",293,0.996599,22,294,1,293,1,1,0,1,1,140,139,154,154,20
"1632",31,"[22]cHoIoHcowHnJqGKCIdgbwB",303,0.996711,22,304,1,303,1,1,0,1,1,168,167,136,136,20
"1633",32,"[22]cHoIoHcowHnJqGKCIdgbwB",300,0.996678,22,301,1,300,1,1,0,1,1,162,161,139,139,20
"1634",33,"[22]cHoIoHcowHnJqGKCIdgbwB",293,0.996599,22,294,1,293,1,1,0,1,1,139,138,155,155,20
"1635",34,"[22]cHoIoHcowHnJqGKCIdgbwB",300,0.996678,22,301,1,300,1,1,0,1,1,165,164,136,136,20
"1636",35,"[22]cHoIoHcowHnJqGKCIdgbwB",287,0.996528,22,288,1,287,1,1,0,1,1,127,126,161,161,20
"1637",36,"[22]cHoIoHcowHnJqGKCIdgbwB",300,0.996678,22,301,1,300,1,1,0,1,1,156,155,145,145,20
"1638",37,"[22]cHoIoHcowHnJqGKCIdgbwB",298,0.996656,22,299,1,298,1,1,0,1,1,152,151,147,147,20
"1639",38,"[22]cHoIoHcowHnJqGKCIdgbwB",300,0.996678,22,301,1,300,1,1,0,1,1,161,160,140,140,20
"1640",39,"[22]cHoIoHcowHnJqGKCIdgbwB",301,0.996689,22,302,1,301,1,1,0,1,1,161,160,141,141,20
"1641",40,"[22]cHoIoHcowHnJqGKCIdgbwB",292,0.996587,22,293,1,292,1,1,0,1,1,135,134,158,158,20
"1642",41,"[22]cHoIoHcowHnJqGKCIdgbwB",300,0.996678,22,301,1,300,1,1,0,1,1,158,157,143,143,20
"1643",42,"[22]cHoIoHcowHnJqGKCIdgbwB",299,0.996667,22,300,1,299,1,1,0,1,1,158,157,142,142,20
"1644",43,"[22]cHoIoHcowHnJqGKCIdgbwB",296,0.996633,22,297,1,296,1,1,0,1,1,150,149,147,147,20
"1645",44,"[22]cHoIoHcowHnJqGKCIdgbwB",301,0.996689,22,302,1,301,1,1,0,1,1,162,161,140,140,20
"1646",45,"[22]cHoIoHcowHnJqGKCIdgbwB",297,0.996644,22,298,1,297,1,1,0,1,1,144,143,154,154,20
"1647",46,"[22]cHoIoHcowHnJqGKCIdgbwB",303,0.996711,22,304,1,303,1,1,0,1,1,160,159,144,144,20
"1648",47,"[22]cHoIoHcowHnJqGKCIdgbwB",299,0.996667,22,300,1,299,1,1,0,1,1,154,153,146,146,20
"1649",48,"[22]cHoIoHcowHnJqGKCIdgbwB",292,0.996587,22,293,1,292,1,1,0,1,1,140,139,153,153,20
"1650",49,"[22]cHoIoHcowHnJqGKCIdgbwB",299,0.996667,22,300,1,299,1,1,0,1,1,165,164,135,135,20
"1651",50,"[22]cHoIoHcowHnJqGKCIdgbwB",297,0.996644,22,298,1,297,1,1,0,1,1,150,149,148,148,20
"1652",51,"[22]cHoIoHcowHnJqGKCIdgbwB",297,0.996644,22,298,1,297,1,1,0,1,1,150,149,148,148,20
"1653",52,"[22]cHoIoHcowHnJqGKCIdgbwB",306,0.996743,22,307,1,306,1,1,0,1,1,177,176,130,130,20
"1654",53,"[22]cHoIoHcowHnJqGKCIdgbwB",297,0.996644,22,298,1,297,1,1,0,1,1,152,151,146,146,20
"1655",54,"[22]cHoIoHcowHnJqGKCIdgbwB",299,0.996667,22,300,1,299,1,1,0,1,1,154,153,146,146,20
"1656",55,"[22]cHoIoHcowHnJqGKCIdgbwB",298,0.996656,22,299,1,298,1,1,0,1,1,149,148,150,150,20
"1657",56,"[22]cHoIoHcowHnJqGKCIdgbwB",299,0.996667,22,300,1,299,1,1,0,1,1,156,155,144,144,20
"1658",57,"[22]cHoIoHcowHnJqGKCIdgbwB",300,0.996678,22,301,1,300,1,1,0,1,1,150,149,151,151,20
"1659",58,"[22]cHoIoHcowHnJqGKCIdgbwB",298,0.996656,22,299,1,298,1,1,0,1,1,156,155,143,143,20
"1660",59,"[22]cHoIoHcowHnJqGKCIdgbwB",300,0.996678,22,301,1,300,1,1,0,1,1,157,156,144,144,20
"1661",60,"[22]cHoIoHcowHnJqGKCIdgbwB",292,0.996587,22,293,1,292,1,1,0,1,1,135,134,158,158,20
"1662",61,"[22]cHoIoHcowHnJqGKCIdgbwB",305,0.996732,22,306,1,305,1,1,0,1,1,169,168,137,137,20
"1663",62,"[22]cHoIoHcowHnJqGKCIdgbwB",293,0.996599,22,294,1,293,1,1,0,1,1,149,148,145,145,20
"1664",63,"[22]cHoIoHcowHnJqGKCIdgbwB",291,0.996575,22,292,1,291,1,1,0,1,1,137,136,155,155,20
"1665",64,"[22]cHoIoHcowHnJqGKCIdgbwB",296,0.996633,22,297,1,296,1,1,0,1,1,154,153,143,143,20
"1666",65,"[22]cHoIoHcowHnJqGKCIdgbwB",295,0.996622,22,296,1,295,1,1,0,1,1,150,149,146,146,20
"1667",66,"[22]cHoIoHcowHnJqGKCIdgbwB",292,0.996587,22,293,1,292,1,1,0,1,1,137,136,156,156,20
"1668",67,"[22]cHoIoHcowHnJqGKCIdgbwB",299,0.996667,22,300,1,299,1,1,0,1,1,152,151,148,148,20
"1669",68,"[22]cHoIoHcowHnJqGKCIdgbwB",298,0.996656,22,299,1,298,1,1,0,1,1,158,157,141,141,20
"1670",69,"[22]cHoIoHcowHnJqGKCIdgbwB",297,0.996644,22,298,1,297,1,1,0,1,1,148,147,150,150,20
"1671",70,"[22]cHoIoHcowHnJqGKCIdgbwB",298,0.996656,22,299,1,298,1,1,0,1,1,154,153,145,145,20
"1672",71,"[22]cHoIoHcowHnJqGKCIdgbwB",292,0.996587,22,293,1,292,1,1,0,1,1,140,139,153,153,20
"1673",72,"[22]cHoIoHcowHnJqGKCIdgbwB",295,0.996622,22,296,1,295,1,1,0,1,1,145,144,151,151,20
"1674",73,"[22]cHoIoHcowHnJqGKCIdgbwB",296,0.996633,22,297,1,296,1,1,0,1,1,148,147,149,149,20
"1675",74,"[22]cHoIoHcowHnJqGKCIdgbwB",301,0.996689,22,302,1,301,1,1,0,1,1,170,169,132,132,20
"1676",75,"[22]cHoIoHcowHnJqGKCIdgbwB",291,0.996575,22,292,1,291,1,1,0,1,1,136,135,156,156,20
"1677",76,"[22]cHoIoHcowHnJqGKCIdgbwB",292,0.996587,22,293,1,292,1,1,0,1,1,145,144,148,148,20
"1678",77,"[22]cHoIoHcowHnJqGKCIdgbwB",299,0.996667,22,300,1,299,1,1,0,1,1,158,157,142,142,20
"1679",78,"[22]cHoIoHcowHnJqGKCIdgbwB",294,0.99661,22,295,1,294,1,1,0,1,1,143,142,152,152,20
"1680",79,"[22]cHoIoHcowHnJqGKCIdgbwB",295,0.996622,22,296,1,295,1,1,0,1,1,141,140,155,155,20
"1681",80,"[22]cHoIoHcowHnJqGKCIdgbwB",291,0.996575,22,292,1,291,1,1,0,1,1,133,132,159,159,20
"1682",81,"[22]cHoIoHcowHnJqGKCIdgbwB",290,0.996564,22,291,1,290,1,1,0,1,1,141,140,150,150,20
"1683",82,"[22]cHoIoHcowHnJqGKCIdgbwB",301,0.996689,22,302,1,301,1,1,0,1,1,158,157,144,144,20
"1684",83,"[22]cHoIoHcowHnJqGKCIdgbwB",294,0.99661,22,295,1,294,1,1,0,1,1,150,149,145,145,20
"1685",84,"[22]cHoIoHcowHnJqGKCIdgbwB",298,0.996656,22,299,1,298,1,1,0,1,1,157,156,142,142,20
"1686",85,"[22]cHoIoHcowHnJqGKCIdgbwB",294,0.99661,22,295,1,294,1,1,0,1,1,142,141,153,153,20
"1687",86,"[22]cHoIoHcowHnJqGKCIdgbwB",291,0.996575,22,292,1,291,1,1,0,1,1,134,133,158,158,20
"1688",87,"[22]cHoIoHcowHnJqGKCIdgbwB",290,0.996564,22,291,1,290,1,1,0,1,1,139,138,152,152,20
"1689",88,"[22]cHoIoHcowHnJqGKCIdgbwB",298,0.996656,22,299,1,298,1,1,0,1,1,158,157,141,141,20
"1690",89,"[22]cHoIoHcowHnJqGKCIdgbwB",294,0.99661,22,295,1,294,1,1,0,1,1,138,137,157,157,20
"1691",90,"[22]cHoIoHcowHnJqGKCIdgbwB",295,0.996622,22,296,1,295,1,1,0,1,1,141,140,155,155,20
"1692",91,"[22]cHoIoHcowHnJqGKCIdgbwB",292,0.996587,22,293,1,292,1,1,0,1,1,138,137,155,155,20
"1693",92,"[22]cHoIoHcowHnJqGKCIdgbwB",299,0.996667,22,300,1,299,1,1,0,1,1,158,157,142,142,20
"1694",93,"[22]cHoIoHcowHnJqGKCIdgbwB",293,0.996599,22,294,1,293,1,1,0,1,1,139,138,155,155,20
"1695",94,"[22]cHoIoHcowHnJqGKCIdgbwB",296,0.996633,22,297,1,296,1,1,0,1,1,148,147,149,149,20
"1696",95,"[22]cHoIoHcowHnJqGKCIdgbwB",300,0.996678,22,301,1,300,1,1,0,1,1,155,154,146,146,20
"1697",96,"[22]cHoIoHcowHnJqGKCIdgbwB",296,0.996633,22,297,1,296,1,1,0,1,1,150,149,147,147,20
"1698",97,"[22]cHoIoHcowHnJqGKCIdgbwB",298,0.996656,22,299,1,298,1,1,0,1,1,160,159,139,139,20
"1699",98,"[22]cHoIoHcowHnJqGKCIdgbwB",295,0.996622,22,296,1,295,1,1,0,1,1,145,144,151,151,20
"1700",99,"[22]cHoIoHcowHnJqGKCIdgbwB",302,0.9967,22,303,1,302,1,1,0,1,1,170,169,133,133,20
"1701",0,"[25]JlHoIoHcovHnJHGqKCnrIKJsm",282,0.996466,25,283,1,282,1,1,0,1,1,145,144,138,138,21
"1702",1,"[25]JlHoIoHcovHnJHGqKCnrIKJsm",286,0.996516,25,287,1,286,1,1,0,1,1,143,142,144,144,21
"1703",2,"[25]JlHoIoHcovHnJHGqKCnrIKJsm",287,0.996528,25,288,1,287,1,1,0,1,1,159,158,129,129,21
"1704",3,"[25]JlHoIoHcovHnJHGqKCnrIKJsm",287,0.996528,25,288,1,287,1,1,0,1,1,143,142,145,145,21
"1705",4,"[25]JlHoIoHcovHnJHGqKCnrIKJsm",285,0.996503,25,286,1,285,1,1,0,1,1,159,158,127,127,21
"1706",5,"[25]JlHoIoHcovHnJHGqKCnrIKJsm",286,0.996516,25,287,1,286,1,1,0,1,1,141,140,146,146,21
"1707",6,"[25]JlHoIoHcovHnJHGqKCnrIKJsm",276,0.99639,25,277,1,276,1,1,0,1,1,141,140,136,136,21
"1708",7,"[25]JlHoIoHcovHnJHGqKCnrIKJsm",281,0.996454,25,282,1,281,1,1,0,1,1,142,141,140,140,21
"1709",8,"[25]JlHoIoHcovHnJHGqKCnrIKJsm",278,0.996416,25,279,1,278,1,1,0,1,1,141,140,138,138,21
"1710",9,"[25]JlHoIoHcovHnJHGqKCnrIKJsm",289,0.996552,25,290,1,289,1,1,0,1,1,154,153,136,136,21
"1711",10,"[25]JlHoIoHcovHnJHGqKCnrIKJsm",288,0.99654,25,289,1,288,1,1,0,1,1,154,153,135,135,21
"1712",11,"[25]JlHoIoHcovHnJHGqKCnrIKJsm",286,0.996516,25,287,1,286,1,1,0,1,1,135,134,152,152,21
"1713",12,"[25]JlHoIoHcovHnJHGqKCnrIKJsm",280,0.996441,25,281,1,280,1,1,0,1,1,136,135,145,145,21
"1714",13,"[25]JlHoIoHcovHnJHGqKCnrIKJsm",287,0.996528,25,288,1,287,1,1,0,1,1,133,132,155,155,21
"1715",14,"[25]JlHoIoHcovHnJHGqKCnrIKJsm",284,0.996491,25,285,1,284,1,1,0,1,1,144,143,141,141,21
"1716",15,"[25]JlHoIoHcovHnJHGqKCnrIKJsm",273,0.99635,25,274,1,273,1,1,0,1,1,144,143,130,130,21
"1717",16,"[25]JlHoIoHcovHnJHGqKCnrIKJsm",276,0.99639,25,277,1,276,1,1,0,1,1,131,130,146,146,21
"1718",17,"[25]JlHoIoHcovHnJHGqKCnrIKJsm",280,0.996441,25,281,1,280,1,1,0,1,1,151,150,130,130,21
"1719",18,"[25]JlHoIoHcovHnJHGqKCnrIKJsm",275,0.996377,25,276,1,275,1,1,0,1,1,139,138,137,137,21
"1720",19,"[25]JlHoIoHcovHnJHGqKCnrIKJsm",278,0.996416,25,279,1,278,1,1,0,1,1,139,138,140,140,21
"1721",20,"[25]JlHoIoHcovHnJHGqKCnrIKJsm",277,0.996403,25,278,1,277,1,1,0,1,1,140,139,138,138,21
"1722",21,"[25]JlHoIoHcovHnJHGqKCnrIKJsm",284,0.996491,25,285,1,284,1,1,0,1,1,153,152,132,132,21
"1723",22,"[25]JlHoIoHcovHnJHGqKCnrIKJsm",291,0.996575,25,292,1,291,1,1,0,1,1,144,143,148,148,21
"1724",23,"[25]JlHoIoHcovHnJHGqKCnrIKJsm",280,0.996441,25,281,1,280,1,1,0,1,1,144,143,137,137,21
"1725",24,"[25]JlHoIoHcovHnJHGqKCnrIKJsm",277,0.996403,25,278,1,277,1,1,0,1,1,150,149,128,128,21
"1726",25,"[25]JlHoIoHcovHnJHGqKCnrIKJsm",283,0.996479,25,284,1,283,1,1,0,1,1,150,149,134,134,21
"1727",26,"[25]JlHoIoHcovHnJHGqKCnrIKJsm",276,0.99639,25,277,1,276,1,1,0,1,1,141,140,136,136,21
"1728",27,"[25]JlHoIoHcovHnJHGqKCnrIKJsm",281,0.996454,25,282,1,281,1,1,0,1,1,144,143,138,138,21
"1729",28,"[25]JlHoIoHcovHnJHGqKCnrIKJsm",277,0.996403,25,278,1,277,1,1,0,1,1,135,134,143,143,21
"1730",29,"[25]JlHoIoHcovHnJHGqKCnrIKJsm",278,0.996416,25,279,1,278,1,1,0,1,1,141,140,138,138,21
"1731",30,"[25]JlHoIoHcovHnJHGqKCnrIKJsm",282,0.996466,25,283,1,282,1,1,0,1,1,138,137,145,145,21
"1732",31,"[25]JlHoIoHcovHnJHGqKCnrIKJsm",282,0.996466,25,283,1,282,1,1,0,1,1,145,144,138,138,21
"1733",32,"[25]JlHoIoHcovHnJHGqKCnrIKJsm",280,0.996441,25,281,1,280,1,1,0,1,1,138,137,143,143,21
"1734",33,"[25]JlHoIoHcovHnJHGqKCnrIKJsm",277,0.996403,25,278,1,277,1,1,0,1,1,118,117,160,160,21
"1735",34,"[25]JlHoIoHcovHnJHGqKCnrIKJsm",285,0.996503,25,286,1,285,1,1,0,1,1,137,136,149,149,21
"1736",35,"[25]JlHoIoHcovHnJHGqKCnrIKJsm",285,0.996503,25,286,1,285,1,1,0,1,1,154,153,132,132,21
"1737",36,"[25]JlHoIoHcovHnJHGqKCnrIKJsm",279,0.996429,25,280,1,279,1,1,0,1,1,145,144,135,135,21
"1738",37,"[25]JlHoIoHcovHnJHGqKCnrIKJsm",289,0.996552,25,290,1,289,1,1,0,1,1,151,150,139,139,21
"1739",38,"[25]JlHoIoHcovHnJHGqKCnrIKJsm",281,0.996454,25,282,1,281,1,1,0,1,1,155,154,127,127,21
"1740",39,"[25]JlHoIoHcovHnJHGqKCnrIKJsm",283,0.996479,25,284,1,283,1,1,0,1,1,144,143,140,140,21
"1741",40,"[25]JlHoIoHcovHnJHGqKCnrIKJsm",283,0.996479,25,284,1,283,1,1,0,1,1,149,148,135,135,21
"1742",41,"[25]JlHoIoHcovHnJHGqKCnrIKJsm",285,0.996503,25,286,1,285,1,1,0,1,1,158,157,128,128,21
"1743",42,"[25]JlHoIoHcovHnJHGqKCnrIKJsm",284,0.996491,25,285,1,284,1,1,0,1,1,140,139,145,145,21
"1744",43,"[25]JlHoIoHcovHnJHGqKCnrIKJsm",279,0.996429,25,280,1,279,1,1,0,1,1,131,130,149,149,21
"1745",44,"[25]JlHoIoHcovHnJHGqKCnrIKJsm",277,0.996403,25,278,1,277,1,1,0,1,1,129,128,149,149,21
"1746",45,"[25]JlHoIoHcovHnJHGqKCnrIKJsm",291,0.996575,25,292,1,291,1,1,0,1,1,157,156,135,135,21
"1747",46,"[25]JlHoIoHcovHnJHGqKCnrIKJsm",282,0.996466,25,283,1,282,1,1,0,1,1,138,137,145,145,21
"1748",47,"[25]JlHoIoHcovHnJHGqKCnrIKJsm",284,0.996491,25,285,1,284,1,1,0,1,1,142,141,143,143,21
"1749",48,"[25]JlHoIoHcovHnJHGqKCnrIKJsm",282,0.996466,25,283,1,282,1,1,0,1,1,145,144,138,138,21
"1750",49,"[25]JlHoIoHcovHnJHGqKCnrIKJsm",280,0.996441,25,281,1,280,1,1,0,1,1,136,135,145,145,21
"1751",50,"[25]JlHoIoHcovHnJHGqKCnrIKJsm",282,0.996466,25,283,1,282,1,1,0,1,1,143,142,140,140,21
"1752",51,"[25]JlHoIoHcovHnJHGqKCnrIKJsm",286,0.996516,25,287,1,286,1,1,0,1,1,136,135,151,151,21
"1753",52,"[25]JlHoIoHcovHnJHGqKCnrIKJsm",294,0.99661,25,295,1,294,1,1,0,1,1,159,158,136,136,21
"1754",53,"[25]JlHoIoHcovHnJHGqKCnrIKJsm",275,0.996377,25,276,1,275,1,1,0,1,1,135,134,141,141,21
"1755",54,"[25]JlHoIoHcovHnJHGqKCnrIKJsm",282,0.996466,25,283,1,282,1,1,0,1,1,151,150,132,132,21
"1756",55,"[25]JlHoIoHcovHnJHGqKCnrIKJsm",281,0.996454,25,282,1,281,1,1,0,1,1,148,147,134,134,21
"1757",56,"[25]JlHoIoHcovHnJHGqKCnrIKJsm",286,0.996516,25,287,1,286,1,1,0,1,1,135,134,152,152,21
"1758",57,"[25]JlHoIoHcovHnJHGqKCnrIKJsm",277,0.996403,25,278,1,277,1,1,0,1,1,133,132,145,145,21
"1759",58,"[25]JlHoIoHcovHnJHGqKCnrIKJsm",285,0.996503,25,286,1,285,1,1,0,1,1,136,135,150,150,21
"1760",59,"[25]JlHoIoHcovHnJHGqKCnrIKJsm",274,0.996364,25,275,1,274,1,1,0,1,1,134,133,141,141,21
"1761",60,"[25]JlHoIoHcovHnJHGqKCnrIKJsm",282,0.996466,25,283,1,282,1,1,0,1,1,141,140,142,142,21
"1762",61,"[25]JlHoIoHcovHnJHGqKCnrIKJsm",278,0.996416,25,279,1,278,1,1,0,1,1,128,127,151,151,21
"1763",62,"[25]JlHoIoHcovHnJHGqKCnrIKJsm",277,0.996403,25,278,1,277,1,1,0,1,1,142,141,136,136,21
"1764",63,"[25]JlHoIoHcovHnJHGqKCnrIKJsm",284,0.996491,25,285,1,284,1,1,0,1,1,161,160,124,124,21
"1765",64,"[25]JlHoIoHcovHnJHGqKCnrIKJsm",283,0.996479,25,284,1,283,1,1,0,1,1,150,149,134,134,21
"1766",65,"[25]JlHoIoHcovHnJHGqKCnrIKJsm",277,0.996403,25,278,1,277,1,1,0,1,1,129,128,149,149,21
"1767",66,"[25]JlHoIoHcovHnJHGqKCnrIKJsm",284,0.996491,25,285,1,284,1,1,0,1,1,162,161,123,123,21
"1768",67,"[25]JlHoIoHcovHnJHGqKCnrIKJsm",279,0.996429,25,280,1,279,1,1,0,1,1,142,141,138,138,21
"1769",68,"[25]JlHoIoHcovHnJHGqKCnrIKJsm",278,0.996416,25,279,1,278,1,1,0,1,1,140,139,139,139,21
"1770",69,"[25]JlHoIoHcovHnJHGqKCnrIKJsm",282,0.996466,25,283,1,282,1,1,0,1,1,148,147,135,135,21
"1771",70,"[25]JlHoIoHcovHnJHGqKCnrIKJsm",288,0.99654,25,289,1,288,1,1,0,1,1,148,147,141,141,21
"1772",71,"[25]JlHoIoHcovHnJHGqKCnrIKJsm",279,0.996429,25,280,1,279,1,1,0,1,1,139,138,141,141,21
"1773",72,"[25]JlHoIoHcovHnJHGqKCnrIKJsm",285,0.996503,25,286,1,285,1,1,0,1,1,147,146,139,139,21
"1774",73,"[25]JlHoIoHcovHnJHGqKCnrIKJsm",272,0.996337,25,273,1,272,1,1,0,1,1,132,131,141,141,21
"1775",74,"[25]JlHoIoHcovHnJHGqKCnrIKJsm",287,0.996528,25,288,1,287,1,1,0,1,1,145,144,143,143,21
"1776",75,"[25]JlHoIoHcovHnJHGqKCnrIKJsm",286,0.996516,25,287,1,286,1,1,0,1,1,160,159,127,127,21
"1777",76,"[25]JlHoIoHcovHnJHGqKCnrIKJsm",278,0.996416,25,279,1,278,1,1,0,1,1,143,142,136,136,21
"1778",77,"[25]JlHoIoHcovHnJHGqKCnrIKJsm",274,0.996364,25,275,1,274,1,1,0,1,1,139,138,136,136,21
"1779",78,"[25]JlHoIoHcovHnJHGqKCnrIKJsm",289,0.996552,25,290,1,289,1,1,0,1,1,149,148,141,141,21
"1780",79,"[25]JlHoIoHcovHnJHGqKCnrIKJsm",279,0.996429,25,280,1,279,1,1,0,1,1,152,151,128,128,21
"1781",80,"[25]JlHoIoHcovHnJHGqKCnrIKJsm",285,0.996503,25,286,1,285,1,1,0,1,1,145,144,141,141,21
"1782",81,"[25]JlHoIoHcovHnJHGqKCnrIKJsm",286,0.996516,25,287,1,286,1,1,0,1,1,148,147,139,139,21
"1783",82,"[25]JlHoIoHcovHnJHGqKCnrIKJsm",285,0.996503,25,286,1,285,1,1,0,1,1,138,137,148,148,21
"1784",83,"[25]JlHoIoHcovHnJHGqKCnrIKJsm",283,0.996479,25,284,1,283,1,1,0,1,1,152,151,132,132,21
"1785",84,"[25]JlHoIoHcovHnJHGqKCnrIKJsm",278,0.996416,25,279,1,278,1,1,0,1,1,135,134,144,144,21
"1786",85,"[25]JlHoIoHcovHnJHGqKCnrIKJsm",268,0.996283,25,269,1,268,1,1,0,1,1,126,125,143,143,21
"1787",86,"[25]JlHoIoHcovHnJHGqKCnrIKJsm",277,0.996403,25,278,1,277,1,1,0,1,1,147,146,131,131,21
"1788",87,"[25]JlHoIoHcovHnJHGqKCnrIKJsm",278,0.996416,25,279,1,278,1,1,0,1,1,140,139,139,139,21
"1789",88,"[25]JlHoIoHcovHnJHGqKCnrIKJsm",276,0.99639,25,277,1,276,1,1,0,1,1,131,130,146,146,21
"1790",89,"[25]JlHoIoHcovHnJHGqKCnrIKJsm",286,0.996516,25,287,1,286,1,1,0,1,1,157,156,130,130,21
"1791",90,"[25]JlHoIoHcovHnJHGqKCnrIKJsm",283,0.996479,25,284,1,283,1,1,0,1,1,140,139,144,144,21
"1792",91,"[25]JlHoIoHcovHnJHGqKCnrIKJsm",278,0.996416,25,279,1,278,1,1,0,1,1,137,136,142,142,21
"1793",92,"[25]JlHoIoHcovHnJHGqKCnrIKJsm",283,0.996479,25,284,1,283,1,1,0,1,1,131,130,153,153,21
"1794",93,"[25]JlHoIoHcovHnJHGqKCnrIKJsm",281,0.996454,25,282,1,281,1,1,0,1,1,148,147,134,134,21
"1795",94,"[25]JlHoIoHcovHnJHGqKCnrIKJsm",288,0.99654,25,289,1,288,1,1,0,1,1,158,157,131,131,21
"1796",95,"[25]JlHoIoHcovHnJHGqKCnrIKJsm",282,0.996466,25,283,1,282,1,1,0,1,1,143,142,140,140,21
"1797",96,"[25]JlHoIoHcovHnJHGqKCnrIKJsm",287,0.996528,25,288,1,287,1,1,0,1,1,160,159,128,128,21
"1798",97,"[25]JlHoIoHcovHnJHGqKCnrIKJsm",274,0.996364,25,275,1,274,1,1,0,1,1,140,139,135,135,21
"1799",98,"[25]JlHoIoHcovHnJHGqKCnrIKJsm",286,0.996516,25,287,1,286,1,1,0,1,1,138,137,149,149,21
"1800",99,"[25]JlHoIoHcovHnJHGqKCnrIKJsm",284,0.996491,25,285,1,284,1,1,0,1,1,151,150,134,134,21
"1801",0,"[28]zJgmHuoIoHcovHnJHGqKCjjqjCCK",281,0.996454,28,282,1,281,1,1,0,1,1,151,150,131,131,22
"1802",1,"[28]zJgmHuoIoHcovHnJHGqKCjjqjCCK",281,0.996454,28,282,1,281,1,1,0,1,1,136,135,146,146,22
"1803",2,"[28]zJgmHuoIoHcovHnJHGqKCjjqjCCK",280,0.996441,28,281,1,280,1,1,0,1,1,137,136,144,144,22
"1804",3,"[28]zJgmHuoIoHcovHnJHGqKCjjqjCCK",285,0.996503,28,286,1,285,1,1,0,1,1,147,146,139,139,22
"1805",4,"[28]zJgmHuoIoHcovHnJHGqKCjjqjCCK",282,0.996466,28,283,1,282,1,1,0,1,1,139,138,144,144,22
"1806",5,"[28]zJgmHuoIoHcovHnJHGqKCjjqjCCK",283,0.996479,28,284,1,283,1,1,0,1,1,141,140,143,143,22
"1807",6,"[28]zJgmHuoIoHcovHnJHGqKCjjqjCCK",295,0.996622,28,296,1,295,1,1,0,1,1,151,150,145,145,22
"1808",7,"[28]zJgmHuoIoHcovHnJHGqKCjjqjCCK",276,0.99639,28,277,1,276,1,1,0,1,1,144,143,133,133,22
"1809",8,"[28]zJgmHuoIoHcovHnJHGqKCjjqjCCK",290,0.996564,28,291,1,290,1,1,0,1,1,138,137,153,153,22
"1810",9,"[28]zJgmHuoIoHcovHnJHGqKCjjqjCCK",283,0.996479,28,284,1,283,1,1,0,1,1,137,136,147,147,22
"1811",10,"[28]zJgmHuoIoHcovHnJHGqKCjjqjCCK",283,0.996479,28,284,1,283,1,1,0,1,1,141,140,143,143,22
"1812",11,"[28]zJgmHuoIoHcovHnJHGqKCjjqjCCK",285,0.996503,28,286,1,285,1,1,0,1,1,148,147,138,138,22
"1813",12,"[28]zJgmHuoIoHcovHnJHGqKCjjqjCCK",286,0.996516,28,287,1,286,1,1,0,1,1,152,151,135,135,22
"1814",13,"[28]zJgmHuoIoHcovHnJHGqKCjjqjCCK",282,0.996466,28,283,1,282,1,1,0,1,1,133,132,150,150,22
"1815",14,"[28]zJgmHuoIoHcovHnJHGqKCjjqjCCK",282,0.996466,28,283,1,282,1,1,0,1,1,148,147,135,135,22
"1816",15,"[28]zJgmHuoIoHcovHnJHGqKCjjqjCCK",271,0.996324,28,272,1,271,1,1,0,1,1,110,109,162,162,22
"1817",16,"[28]zJgmHuoIoHcovHnJHGqKCjjqjCCK",283,0.996479,28,284,1,283,1,1,0,1,1,148,147,136,136,22
"1818",17,"[28]zJgmHuoIoHcovHnJHGqKCjjqjCCK",279,0.996429,28,280,1,279,1,1,0,1,1,139,138,141,141,22
"1819",18,"[28]zJgmHuoIoHcovHnJHGqKCjjqjCCK",285,0.996503,28,286,1,285,1,1,0,1,1,144,143,142,142,22
"1820",19,"[28]zJgmHuoIoHcovHnJHGqKCjjqjCCK",283,0.996479,28,284,1,283,1,1,0,1,1,138,137,146,146,22
"1821",20,"[28]zJgmHuoIoHcovHnJHGqKCjjqjCCK",281,0.996454,28,282,1,281,1,1,0,1,1,138,137,144,144,22
"1822",21,"[28]zJgmHuoIoHcovHnJHGqKCjjqjCCK",280,0.996441,28,281,1,280,1,1,0,1,1,142,141,139,139,22
"1823",22,"[28]zJgmHuoIoHcovHnJHGqKCjjqjCCK",287,0.996528,28,288,1,287,1,1,0,1,1,159,158,129,129,22
"1824",23,"[28]zJgmHuoIoHcovHnJHGqKCjjqjCCK",281,0.996454,28,282,1,281,1,1,0,1,1,123,122,159,159,22
"1825",24,"[28]zJgmHuoIoHcovHnJHGqKCjjqjCCK",285,0.996503,28,286,1,285,1,1,0,1,1,154,153,132,132,22
"1826",25,"[28]zJgmHuoIoHcovHnJHGqKCjjqjCCK",282,0.996466,28,283,1,282,1,1,0,1,1,141,140,142,142,22
"1827",26,"[28]zJgmHuoIoHcovHnJHGqKCjjqjCCK",283,0.996479,28,284,1,283,1,1,0,1,1,131,130,153,153,22
"1828",27,"[28]zJgmHuoIoHcovHnJHGqKCjjqjCCK",281,0.996454,28,282,1,281,1,1,0,1,1,148,147,134,134,22
"1829",28,"[28]zJgmHuoIoHcovHnJHGqKCjjqjCCK",278,0.996416,28,279,1,278,1,1,0,1,1,138,137,141,141,22
"1830",29,"[28]zJgmHuoIoHcovHnJHGqKCjjqjCCK",287,0.996528,28,288,1,287,1,1,0,1,1,126,125,162,162,22
"1831",30,"[28]zJgmHuoIoHcovHnJHGqKCjjqjCCK",280,0.996441,28,281,1,280,1,1,0,1,1,147,146,134,134,22
"1832",31,"[28]zJgmHuoIoHcovHnJHGqKCjjqjCCK",287,0.996528,28,288,1,287,1,1,0,1,1,156,155,132,132,22
"1833",32,"[28]zJgmHuoIoHcovHnJHGqKCjjqjCCK",287,0.996528,28,288,1,287,1,1,0,1,1,160,159,128,128,22
"1834",33,"[28]zJgmHuoIoHcovHnJHGqKCjjqjCCK",286,0.996516,28,287,1,286,1,1,0,1,1,137,136,150,150,22
"1835",34,"[28]zJgmHuoIoHcovHnJHGqKCjjqjCCK",287,0.996528,28,288,1,287,1,1,0,1,1,143,142,145,145,22
"1836",35,"[28]zJgmHuoIoHcovHnJHGqKCjjqjCCK",282,0.996466,28,283,1,282,1,1,0,1,1,136,135,147,147,22
"1837",36,"[28]zJgmHuoIoHcovHnJHGqKCjjqjCCK",281,0.996454,28,282,1,281,1,1,0,1,1,144,143,138,138,22
"1838",37,"[28]zJgmHuoIoHcovHnJHGqKCjjqjCCK",281,0.996454,28,282,1,281,1,1,0,1,1,145,144,137,137,22
"1839",38,"[28]zJgmHuoIoHcovHnJHGqKCjjqjCCK",287,0.996528,28,288,1,287,1,1,0,1,1,163,162,125,125,22
"1840",39,"[28]zJgmHuoIoHcovHnJHGqKCjjqjCCK",279,0.996429,28,280,1,279,1,1,0,1,1,141,140,139,139,22
"1841",40,"[28]zJgmHuoIoHcovHnJHGqKCjjqjCCK",281,0.996454,28,282,1,281,1,1,0,1,1,133,132,149,149,22
"1842",41,"[28]zJgmHuoIoHcovHnJHGqKCjjqjCCK",284,0.996491,28,285,1,284,1,1,0,1,1,131,130,154,154,22
"1843",42,"[28]zJgmHuoIoHcovHnJHGqKCjjqjCCK",277,0.996403,28,278,1,277,1,1,0,1,1,137,136,141,141,22
"1844",43,"[28]zJgmHuoIoHcovHnJHGqKCjjqjCCK",289,0.996552,28,290,1,289,1,1,0,1,1,152,151,138,138,22
"1845",44,"[28]zJgmHuoIoHcovHnJHGqKCjjqjCCK",298,0.996656,28,299,1,298,1,1,0,1,1,149,148,150,150,22
"1846",45,"[28]zJgmHuoIoHcovHnJHGqKCjjqjCCK",280,0.996441,28,281,1,280,1,1,0,1,1,145,144,136,136,22
"1847",46,"[28]zJgmHuoIoHcovHnJHGqKCjjqjCCK",287,0.996528,28,288,1,287,1,1,0,1,1,141,140,147,147,22
"1848",47,"[28]zJgmHuoIoHcovHnJHGqKCjjqjCCK",286,0.996516,28,287,1,286,1,1,0,1,1,137,136,150,150,22
"1849",48,"[28]zJgmHuoIoHcovHnJHGqKCjjqjCCK",280,0.996441,28,281,1,280,1,1,0,1,1,158,157,123,123,22
"1850",49,"[28]zJgmHuoIoHcovHnJHGqKCjjqjCCK",279,0.996429,28,280,1,279,1,1,0,1,1,130,129,150,150,22
"1851",50,"[28]zJgmHuoIoHcovHnJHGqKCjjqjCCK",278,0.996416,28,279,1,278,1,1,0,1,1,141,140,138,138,22
"1852",51,"[28]zJgmHuoIoHcovHnJHGqKCjjqjCCK",285,0.996503,28,286,1,285,1,1,0,1,1,144,143,142,142,22
"1853",52,"[28]zJgmHuoIoHcovHnJHGqKCjjqjCCK",284,0.996491,28,285,1,284,1,1,0,1,1,153,152,132,132,22
"1854",53,"[28]zJgmHuoIoHcovHnJHGqKCjjqjCCK",273,0.99635,28,274,1,273,1,1,0,1,1,112,111,162,162,22
"1855",54,"[28]zJgmHuoIoHcovHnJHGqKCjjqjCCK",278,0.996416,28,279,1,278,1,1,0,1,1,147,146,132,132,22
"1856",55,"[28]zJgmHuoIoHcovHnJHGqKCjjqjCCK",283,0.996479,28,284,1,283,1,1,0,1,1,134,133,150,150,22
"1857",56,"[28]zJgmHuoIoHcovHnJHGqKCjjqjCCK",286,0.996516,28,287,1,286,1,1,0,1,1,149,148,138,138,22
"1858",57,"[28]zJgmHuoIoHcovHnJHGqKCjjqjCCK",287,0.996528,28,288,1,287,1,1,0,1,1,139,138,149,149,22
"1859",58,"[28]zJgmHuoIoHcovHnJHGqKCjjqjCCK",278,0.996416,28,279,1,278,1,1,0,1,1,132,131,147,147,22
"1860",59,"[28]zJgmHuoIoHcovHnJHGqKCjjqjCCK",282,0.996466,28,283,1,282,1,1,0,1,1,144,143,139,139,22
"1861",60,"[28]zJgmHuoIoHcovHnJHGqKCjjqjCCK",277,0.996403,28,278,1,277,1,1,0,1,1,139,138,139,139,22
"1862",61,"[28]zJgmHuoIoHcovHnJHGqKCjjqjCCK",282,0.996466,28,283,1,282,1,1,0,1,1,154,153,129,129,22
"1863",62,"[28]zJgmHuoIoHcovHnJHGqKCjjqjCCK",293,0.996599,28,294,1,293,1,1,0,1,1,141,140,153,153,22
"1864",63,"[28]zJgmHuoIoHcovHnJHGqKCjjqjCCK",279,0.996429,28,280,1,279,1,1,0,1,1,131,130,149,149,22
"1865",64,"[28]zJgmHuoIoHcovHnJHGqKCjjqjCCK",287,0.996528,28,288,1,287,1,1,0,1,1,137,136,151,151,22
"1866",65,"[28]zJgmHuoIoHcovHnJHGqKCjjqjCCK",274,0.996364,28,275,1,274,1,1,0,1,1,128,127,147,147,22
"1867",66,"[28]zJgmHuoIoHcovHnJHGqKCjjqjCCK",282,0.996466,28,283,1,282,1,1,0,1,1,150,149,133,133,22
"1868",67,"[28]zJgmHuoIoHcovHnJHGqKCjjqjCCK",280,0.996441,28,281,1,280,1,1,0,1,1,137,136,144,144,22
"1869",68,"[28]zJgmHuoIoHcovHnJHGqKCjjqjCCK",286,0.996516,28,287,1,286,1,1,0,1,1,133,132,154,154,22
"1870",69,"[28]zJgmHuoIoHcovHnJHGqKCjjqjCCK",289,0.996552,28,290,1,289,1,1,0,1,1,139,138,151,151,22
"1871",70,"[28]zJgmHuoIoHcovHnJHGqKCjjqjCCK",270,0.99631,28,271,1,270,1,1,0,1,1,139,138,132,132,22
"1872",71,"[28]zJgmHuoIoHcovHnJHGqKCjjqjCCK",287,0.996528,28,288,1,287,1,1,0,1,1,154,153,134,134,22
"1873",72,"[28]zJgmHuoIoHcovHnJHGqKCjjqjCCK",282,0.996466,28,283,1,282,1,1,0,1,1,148,147,135,135,22
"1874",73,"[28]zJgmHuoIoHcovHnJHGqKCjjqjCCK",287,0.996528,28,288,1,287,1,1,0,1,1,146,145,142,142,22
"1875",74,"[28]zJgmHuoIoHcovHnJHGqKCjjqjCCK",286,0.996516,28,287,1,286,1,1,0,1,1,151,150,136,136,22
"1876",75,"[28]zJgmHuoIoHcovHnJHGqKCjjqjCCK",287,0.996528,28,288,1,287,1,1,0,1,1,144,143,144,144,22
"1877",76,"[28]zJgmHuoIoHcovHnJHGqKCjjqjCCK",277,0.996403,28,278,1,277,1,1,0,1,1,132,131,146,146,22
"1878",77,"[28]zJgmHuoIoHcovHnJHGqKCjjqjCCK",284,0.996491,28,285,1,284,1,1,0,1,1,143,142,142,142,22
"1879",78,"[28]zJgmHuoIoHcovHnJHGqKCjjqjCCK",284,0.996491,28,285,1,284,1,1,0,1,1,149,148,136,136,22
"1880",79,"[28]zJgmHuoIoHcovHnJHGqKCjjqjCCK",287,0.996528,28,288,1,287,1,1,0,1,1,141,140,147,147,22
"1881",80,"[28]zJgmHuoIoHcovHnJHGqKCjjqjCCK",289,0.996552,28,290,1,289,1,1,0,1,1,150,149,140,140,22
"1882",81,"[28]zJgmHuoIoHcovHnJHGqKCjjqjCCK",286,0.996516,28,287,1,286,1,1,0,1,1,138,137,149,149,22
"1883",82,"[28]zJgmHuoIoHcovHnJHGqKCjjqjCCK",289,0.996552,28,290,1,289,1,1,0,1,1,133,132,157,157,22
"1884",83,"[28]zJgmHuoIoHcovHnJHGqKCjjqjCCK",278,0.996416,28,279,1,278,1,1,0,1,1,141,140,138,138,22
"1885",84,"[28]zJgmHuoIoHcovHnJHGqKCjjqjCCK",290,0.996564,28,291,1,290,1,1,0,1,1,152,151,139,139,22
"1886",85,"[28]zJgmHuoIoHcovHnJHGqKCjjqjCCK",280,0.996441,28,281,1,280,1,1,0,1,1,142,141,139,139,22
"1887",86,"[28]zJgmHuoIoHcovHnJHGqKCjjqjCCK",280,0.996441,28,281,1,280,1,1,0,1,1,140,139,141,141,22
"1888",87,"[28]zJgmHuoIoHcovHnJHGqKCjjqjCCK",282,0.996466,28,283,1,282,1,1,0,1,1,141,140,142,142,22
"1889",88,"[28]zJgmHuoIoHcovHnJHGqKCjjqjCCK",280,0.996441,28,281,1,280,1,1,0,1,1,130,129,151,151,22
"1890",89,"[28]zJgmHuoIoHcovHnJHGqKCjjqjCCK",284,0.996491,28,285,1,284,1,1,0,1,1,142,141,143,143,22
"1891",90,"[28]zJgmHuoIoHcovHnJHGqKCjjqjCCK",281,0.996454,28,282,1,281,1,1,0,1,1,140,139,142,142,22
"1892",91,"[28]zJgmHuoIoHcovHnJHGqKCjjqjCCK",285,0.996503,28,286,1,285,1,1,0,1,1,143,142,143,143,22
"1893",92,"[28]zJgmHuoIoHcovHnJHGqKCjjqjCCK",282,0.996466,28,283,1,282,1,1,0,1,1,146,145,137,137,22
"1894",93,"[28]zJgmHuoIoHcovHnJHGqKCjjqjCCK",283,0.996479,28,284,1,283,1,1,0,1,1,130,129,154,154,22
"1895",94,"[28]zJgmHuoIoHcovHnJHGqKCjjqjCCK",281,0.996454,28,282,1,281,1,1,0,1,1,146,145,136,136,22
"1896",95,"[28]zJgmHuoIoHcovHnJHGqKCjjqjCCK",276,0.99639,28,277,1,276,1,1,0,1,1,144,143,133,133,22
"1897",96,"[28]zJgmHuoIoHcovHnJHGqKCjjqjCCK",283,0.996479,28,284,1,283,1,1,0,1,1,148,147,136,136,22
"1898",97,"[28]zJgmHuoIoHcovHnJHGqKCjjqjCCK",280,0.996441,28,281,1,280,1,1,0,1,1,129,128,152,152,22
"1899",98,"[28]zJgmHuoIoHcovHnJHGqKCjjqjCCK",281,0.996454,28,282,1,281,1,1,0,1,1,134,133,148,148,22
"1900",99,"[28]zJgmHuoIoHcovHnJHGqKCjjqjCCK",286,0.996516,28,287,1,286,1,1,0,1,1,139,138,148,148,22
"1901",0,"[26]oJHoIqaHcwHnJHGqKCktxrhfxy",280,0.996441,26,281,1,280,1,1,0,1,1,141,140,140,140,23
"1902",1,"[26]oJHoIqaHcwHnJHGqKCktxrhfxy",284,0.996491,26,285,1,284,1,1,0,1,1,160,159,125,125,23
"1903",2,"[26]oJHoIqaHcwHnJHGqKCktxrhfxy",282,0.996466,26,283,1,282,1,1,0,1,1,131,130,152,152,23
"1904",3,"[26]oJHoIqaHcwHnJHGqKCktxrhfxy",281,0.996454,26,282,1,281,1,1,0,1,1,128,127,154,154,23
"1905",4,"[26]oJHoIqaHcwHnJHGqKCktxrhfxy",281,0.996454,26,282,1,281,1,1,0,1,1,136,135,146,146,23
"1906",5,"[26]oJHoIqaHcwHnJHGqKCktxrhfxy",281,0.996454,26,282,1,281,1,1,0,1,1,134,133,148,148,23
"1907",6,"[26]oJHoIqaHcwHnJHGqKCktxrhfxy",284,0.996491,26,285,1,284,1,1,0,1,1,143,142,142,142,23
"1908",7,"[26]oJHoIqaHcwHnJHGqKCktxrhfxy",287,0.996528,26,288,1,287,1,1,0,1,1,148,147,140,140,23
"1909",8,"[26]oJHoIqaHcwHnJHGqKCktxrhfxy",282,0.996466,26,283,1,282,1,1,0,1,1,140,139,143,143,23
"1910",9,"[26]oJHoIqaHcwHnJHGqKCktxrhfxy",280,0.996441,26,281,1,280,1,1,0,1,1,124,123,157,157,23
"1911",10,"[26]oJHoIqaHcwHnJHGqKCktxrhfxy",285,0.996503,26,286,1,285,1,1,0,1,1,152,151,134,134,23
"1912",11,"[26]oJHoIqaHcwHnJHGqKCktxrhfxy",283,0.996479,26,284,1,283,1,1,0,1,1,146,145,138,138,23
"1913",12,"[26]oJHoIqaHcwHnJHGqKCktxrhfxy",275,0.996377,26,276,1,275,1,1,0,1,1,135,134,141,141,23
"1914",13,"[26]oJHoIqaHcwHnJHGqKCktxrhfxy",276,0.99639,26,277,1,276,1,1,0,1,1,139,138,138,138,23
"1915",14,"[26]oJHoIqaHcwHnJHGqKCktxrhfxy",290,0.996564,26,291,1,290,1,1,0,1,1,154,153,137,137,23
"1916",15,"[26]oJHoIqaHcwHnJHGqKCktxrhfxy",281,0.996454,26,282,1,281,1,1,0,1,1,145,144,137,137,23
"1917",16,"[26]oJHoIqaHcwHnJHGqKCktxrhfxy",283,0.996479,26,284,1,283,1,1,0,1,1,129,128,155,155,23
"1918",17,"[26]oJHoIqaHcwHnJHGqKCktxrhfxy",286,0.996516,26,287,1,286,1,1,0,1,1,141,140,146,146,23
"1919",18,"[26]oJHoIqaHcwHnJHGqKCktxrhfxy",285,0.996503,26,286,1,285,1,1,0,1,1,156,155,130,130,23
"1920",19,"[26]oJHoIqaHcwHnJHGqKCktxrhfxy",294,0.99661,26,295,1,294,1,1,0,1,1,146,145,149,149,23
"1921",20,"[26]oJHoIqaHcwHnJHGqKCktxrhfxy",280,0.996441,26,281,1,280,1,1,0,1,1,127,126,154,154,23
"1922",21,"[26]oJHoIqaHcwHnJHGqKCktxrhfxy",286,0.996516,26,287,1,286,1,1,0,1,1,156,155,131,131,23
"1923",22,"[26]oJHoIqaHcwHnJHGqKCktxrhfxy",280,0.996441,26,281,1,280,1,1,0,1,1,141,140,140,140,23
"1924",23,"[26]oJHoIqaHcwHnJHGqKCktxrhfxy",295,0.996622,26,296,1,295,1,1,0,1,1,161,160,135,135,23
"1925",24,"[26]oJHoIqaHcwHnJHGqKCktxrhfxy",289,0.996552,26,290,1,289,1,1,0,1,1,148,147,142,142,23
"1926",25,"[26]oJHoIqaHcwHnJHGqKCktxrhfxy",287,0.996528,26,288,1,287,1,1,0,1,1,149,148,139,139,23
"1927",26,"[26]oJHoIqaHcwHnJHGqKCktxrhfxy",285,0.996503,26,286,1,285,1,1,0,1,1,147,146,139,139,23
"1928",27,"[26]oJHoIqaHcwHnJHGqKCktxrhfxy",292,0.996587,26,293,1,292,1,1,0,1,1,155,154,138,138,23
"1929",28,"[26]oJHoIqaHcwHnJHGqKCktxrhfxy",275,0.996377,26,276,1,275,1,1,0,1,1,138,137,138,138,23
"1930",29,"[26]oJHoIqaHcwHnJHGqKCktxrhfxy",286,0.996516,26,287,1,286,1,1,0,1,1,140,139,147,147,23
"1931",30,"[26]oJHoIqaHcwHnJHGqKCktxrhfxy",282,0.996466,26,283,1,282,1,1,0,1,1,143,142,140,140,23
"1932",31,"[26]oJHoIqaHcwHnJHGqKCktxrhfxy",283,0.996479,26,284,1,283,1,1,0,1,1,133,132,151,151,23
"1933",32,"[26]oJHoIqaHcwHnJHGqKCktxrhfxy",282,0.996466,26,283,1,282,1,1,0,1,1,151,150,132,132,23
"1934",33,"[26]oJHoIqaHcwHnJHGqKCktxrhfxy",279,0.996429,26,280,1,279,1,1,0,1,1,131,130,149,149,23
"1935",34,"[26]oJHoIqaHcwHnJHGqKCktxrhfxy",281,0.996454,26,282,1,281,1,1,0,1,1,133,132,149,149,23
"1936",35,"[26]oJHoIqaHcwHnJHGqKCktxrhfxy",290,0.996564,26,291,1,290,1,1,0,1,1,153,152,138,138,23
"1937",36,"[26]oJHoIqaHcwHnJHGqKCktxrhfxy",280,0.996441,26,281,1,280,1,1,0,1,1,133,132,148,148,23
"1938",37,"[26]oJHoIqaHcwHnJHGqKCktxrhfxy",277,0.996403,26,278,1,277,1,1,0,1,1,119,118,159,159,23
"1939",38,"[26]oJHoIqaHcwHnJHGqKCktxrhfxy",287,0.996528,26,288,1,287,1,1,0,1,1,141,140,147,147,23
"1940",39,"[26]oJHoIqaHcwHnJHGqKCktxrhfxy",277,0.996403,26,278,1,277,1,1,0,1,1,127,126,151,151,23
"1941",40,"[26]oJHoIqaHcwHnJHGqKCktxrhfxy",278,0.996416,26,279,1,278,1,1,0,1,1,143,142,136,136,23
"1942",41,"[26]oJHoIqaHcwHnJHGqKCktxrhfxy",284,0.996491,26,285,1,284,1,1,0,1,1,144,143,141,141,23
"1943",42,"[26]oJHoIqaHcwHnJHGqKCktxrhfxy",284,0.996491,26,285,1,284,1,1,0,1,1,148,147,137,137,23
"1944",43,"[26]oJHoIqaHcwHnJHGqKCktxrhfxy",286,0.996516,26,287,1,286,1,1,0,1,1,142,141,145,145,23
"1945",44,"[26]oJHoIqaHcwHnJHGqKCktxrhfxy",278,0.996416,26,279,1,278,1,1,0,1,1,145,144,134,134,23
"1946",45,"[26]oJHoIqaHcwHnJHGqKCktxrhfxy",283,0.996479,26,284,1,283,1,1,0,1,1,137,136,147,147,23
"1947",46,"[26]oJHoIqaHcwHnJHGqKCktxrhfxy",279,0.996429,26,280,1,279,1,1,0,1,1,144,143,136,136,23
"1948",47,"[26]oJHoIqaHcwHnJHGqKCktxrhfxy",285,0.996503,26,286,1,285,1,1,0,1,1,138,137,148,148,23
"1949",48,"[26]oJHoIqaHcwHnJHGqKCktxrhfxy",280,0.996441,26,281,1,280,1,1,0,1,1,133,132,148,148,23
"1950",49,"[26]oJHoIqaHcwHnJHGqKCktxrhfxy",281,0.996454,26,282,1,281,1,1,0,1,1,127,126,155,155,23
"1951",50,"[26]oJHoIqaHcwHnJHGqKCktxrhfxy",290,0.996564,26,291,1,290,1,1,0,1,1,159,158,132,132,23
"1952",51,"[26]oJHoIqaHcwHnJHGqKCktxrhfxy",281,0.996454,26,282,1,281,1,1,0,1,1,139,138,143,143,23
"1953",52,"[26]oJHoIqaHcwHnJHGqKCktxrhfxy",281,0.996454,26,282,1,281,1,1,0,1,1,159,158,123,123,23
"1954",53,"[26]oJHoIqaHcwHnJHGqKCktxrhfxy",275,0.996377,26,276,1,275,1,1,0,1,1,143,142,133,133,23
"1955",54,"[26]oJHoIqaHcwHnJHGqKCktxrhfxy",282,0.996466,26,283,1,282,1,1,0,1,1,151,150,132,132,23
"1956",55,"[26]oJHoIqaHcwHnJHGqKCktxrhfxy",289,0.996552,26,290,1,289,1,1,0,1,1,155,154,135,135,23
"1957",56,"[26]oJHoIqaHcwHnJHGqKCktxrhfxy",282,0.996466,26,283,1,282,1,1,0,1,1,139,138,144,144,23
"1958",57,"[26]oJHoIqaHcwHnJHGqKCktxrhfxy",281,0.996454,26,282,1,281,1,1,0,1,1,147,146,135,135,23
"1959",58,"[26]oJHoIqaHcwHnJHGqKCktxrhfxy",286,0.996516,26,287,1,286,1,1,0,1,1,140,139,147,147,23
"1960",59,"[26]oJHoIqaHcwHnJHGqKCktxrhfxy",279,0.996429,26,280,1,279,1,1,0,1,1,142,141,138,138,23
"1961",60,"[26]oJHoIqaHcwHnJHGqKCktxrhfxy",282,0.996466,26,283,1,282,1,1,0,1,1,133,132,150,150,23
"1962",61,"[26]oJHoIqaHcwHnJHGqKCktxrhfxy",289,0.996552,26,290,1,289,1,1,0,1,1,146,145,144,144,23
"1963",62,"[26]oJHoIqaHcwHnJHGqKCktxrhfxy",279,0.996429,26,280,1,279,1,1,0,1,1,135,134,145,145,23
"1964",63,"[26]oJHoIqaHcwHnJHGqKCktxrhfxy",283,0.996479,26,284,1,283,1,1,0,1,1,150,149,134,134,23
"1965",64,"[26]oJHoIqaHcwHnJHGqKCktxrhfxy",291,0.996575,26,292,1,291,1,1,0,1,1,143,142,149,149,23
"1966",65,"[26]oJHoIqaHcwHnJHGqKCktxrhfxy",279,0.996429,26,280,1,279,1,1,0,1,1,147,146,133,133,23
"1967",66,"[26]oJHoIqaHcwHnJHGqKCktxrhfxy",290,0.996564,26,291,1,290,1,1,0,1,1,149,148,142,142,23
"1968",67,"[26]oJHoIqaHcwHnJHGqKCktxrhfxy",281,0.996454,26,282,1,281,1,1,0,1,1,129,128,153,153,23
"1969",68,"[26]oJHoIqaHcwHnJHGqKCktxrhfxy",291,0.996575,26,292,1,291,1,1,0,1,1,145,144,147,147,23
"1970",69,"[26]oJHoIqaHcwHnJHGqKCktxrhfxy",282,0.996466,26,283,1,282,1,1,0,1,1,152,151,131,131,23
"1971",70,"[26]oJHoIqaHcwHnJHGqKCktxrhfxy",286,0.996516,26,287,1,286,1,1,0,1,1,163,162,124,124,23
"1972",71,"[26]oJHoIqaHcwHnJHGqKCktxrhfxy",287,0.996528,26,288,1,287,1,1,0,1,1,152,151,136,136,23
"1973",72,"[26]oJHoIqaHcwHnJHGqKCktxrhfxy",281,0.996454,26,282,1,281,1,1,0,1,1,136,135,146,146,23
"1974",73,"[26]oJHoIqaHcwHnJHGqKCktxrhfxy",284,0.996491,26,285,1,284,1,1,0,1,1,144,143,141,141,23
"1975",74,"[26]oJHoIqaHcwHnJHGqKCktxrhfxy",285,0.996503,26,286,1,285,1,1,0,1,1,146,145,140,140,23
"1976",75,"[26]oJHoIqaHcwHnJHGqKCktxrhfxy",284,0.996491,26,285,1,284,1,1,0,1,1,147,146,138,138,23
"1977",76,"[26]oJHoIqaHcwHnJHGqKCktxrhfxy",283,0.996479,26,284,1,283,1,1,0,1,1,157,156,127,127,23
"1978",77,"[26]oJHoIqaHcwHnJHGqKCktxrhfxy",284,0.996491,26,285,1,284,1,1,0,1,1,151,150,134,134,23
"1979",78,"[26]oJHoIqaHcwHnJHGqKCktxrhfxy",282,0.996466,26,283,1,282,1,1,0,1,1,131,130,152,152,23
"1980",79,"[26]oJHoIqaHcwHnJHGqKCktxrhfxy",283,0.996479,26,284,1,283,1,1,0,1,1,130,129,154,154,23
"1981",80,"[26]oJHoIqaHcwHnJHGqKCktxrhfxy",284,0.996491,26,285,1,284,1,1,0,1,1,141,140,144,144,23
"1982",81,"[26]oJHoIqaHcwHnJHGqKCktxrhfxy",284,0.996491,26,285,1,284,1,1,0,1,1,138,137,147,147,23
"1983",82,"[26]oJHoIqaHcwHnJHGqKCktxrhfxy",293,0.996599,26,294,1,293,1,1,0,1,1,146,145,148,148,23
"1984",83,"[26]oJHoIqaHcwHnJHGqKCktxrhfxy",281,0.996454,26,282,1,281,1,1,0,1,1,149,148,133,133,23
"1985",84,"[26]oJHoIqaHcwHnJHGqKCktxrhfxy",292,0.996587,26,293,1,292,1,1,0,1,1,155,154,138,138,23
"1986",85,"[26]oJHoIqaHcwHnJHGqKCktxrhfxy",294,0.99661,26,295,1,294,1,1,0,1,1,158,157,137,137,23
"1987",86,"[26]oJHoIqaHcwHnJHGqKCktxrhfxy",277,0.996403,26,278,1,277,1,1,0,1,1,149,148,129,129,23
"1988",87,"[26]oJHoIqaHcwHnJHGqKCktxrhfxy",288,0.99654,26,289,1,288,1,1,0,1,1,137,136,152,152,23
"1989",88,"[26]oJHoIqaHcwHnJHGqKCktxrhfxy",284,0.996491,26,285,1,284,1,1,0,1,1,147,146,138,138,23
"1990",89,"[26]oJHoIqaHcwHnJHGqKCktxrhfxy",287,0.996528,26,288,1,287,1,1,0,1,1,154,153,134,134,23
"1991",90,"[26]oJHoIqaHcwHnJHGqKCktxrhfxy",280,0.996441,26,281,1,280,1,1,0,1,1,135,134,146,146,23
"1992",91,"[26]oJHoIqaHcwHnJHGqKCktxrhfxy",280,0.996441,26,281,1,280,1,1,0,1,1,134,133,147,147,23
"1993",92,"[26]oJHoIqaHcwHnJHGqKCktxrhfxy",290,0.996564,26,291,1,290,1,1,0,1,1,154,153,137,137,23
"1994",93,"[26]oJHoIqaHcwHnJHGqKCktxrhfxy",282,0.996466,26,283,1,282,1,1,0,1,1,159,158,124,124,23
"1995",94,"[26]oJHoIqaHcwHnJHGqKCktxrhfxy",282,0.996466,26,283,1,282,1,1,0,1,1,139,138,144,144,23
"1996",95,"[26]oJHoIqaHcwHnJHGqKCktxrhfxy",283,0.996479,26,284,1,283,1,1,0,1,1,130,129,154,154,23
"1997",96,"[26]oJHoIqaHcwHnJHGqKCktxrhfxy",282,0.996466,26,283,1,282,1,1,0,1,1,134,133,149,149,23
"1998",97,"[26]oJHoIqaHcwHnJHGqKCktxrhfxy",287,0.996528,26,288,1,287,1,1,0,1,1,145,144,143,143,23
"1999",98,"[26]oJHoIqaHcwHnJHGqKCktxrhfxy",286,0.996516,26,287,1,286,1,1,0,1,1,146,145,141,141,23
"2000",99,"[26]oJHoIqaHcwHnJHGqKCktxrhfxy",287,0.996528,26,288,1,287,1,1,0,1,1,155,154,133,133,23
"2001",0,"[27]xHoIEDeewfoHcouHnJqGKCymgqz",298,0.996656,27,299,1,298,1,1,0,1,1,152,151,147,147,24
"2002",1,"[27]xHoIEDeewfoHcouHnJqGKCymgqz",296,0.996633,27,297,1,296,1,1,0,1,1,150,149,147,147,24
"2003",2,"[27]xHoIEDeewfoHcouHnJqGKCymgqz",289,0.996552,27,290,1,289,1,1,0,1,1,134,133,156,156,24
"2004",3,"[27]xHoIEDeewfoHcouHnJqGKCymgqz",298,0.996656,27,299,1,298,1,1,0,1,1,150,149,149,149,24
"2005",4,"[27]xHoIEDeewfoHcouHnJqGKCymgqz",299,0.996667,27,300,1,299,1,1,0,1,1,167,166,133,133,24
"2006",5,"[27]xHoIEDeewfoHcouHnJqGKCymgqz",297,0.996644,27,298,1,297,1,1,0,1,1,150,149,148,148,24
"2007",6,"[27]xHoIEDeewfoHcouHnJqGKCymgqz",300,0.996678,27,301,1,300,1,1,0,1,1,159,158,142,142,24
"2008",7,"[27]xHoIEDeewfoHcouHnJqGKCymgqz",301,0.996689,27,302,1,301,1,1,0,1,1,163,162,139,139,24
"2009",8,"[27]xHoIEDeewfoHcouHnJqGKCymgqz",288,0.99654,27,289,1,288,1,1,0,1,1,130,129,159,159,24
"2010",9,"[27]xHoIEDeewfoHcouHnJqGKCymgqz",297,0.996644,27,298,1,297,1,1,0,1,1,151,150,147,147,24
"2011",10,"[27]xHoIEDeewfoHcouHnJqGKCymgqz",300,0.996678,27,301,1,300,1,1,0,1,1,169,168,132,132,24
"2012",11,"[27]xHoIEDeewfoHcouHnJqGKCymgqz",293,0.996599,27,294,1,293,1,1,0,1,1,151,150,143,143,24
"2013",12,"[27]xHoIEDeewfoHcouHnJqGKCymgqz",293,0.996599,27,294,1,293,1,1,0,1,1,142,141,152,152,24
"2014",13,"[27]xHoIEDeewfoHcouHnJqGKCymgqz",294,0.99661,27,295,1,294,1,1,0,1,1,148,147,147,147,24
"2015",14,"[27]xHoIEDeewfoHcouHnJqGKCymgqz",295,0.996622,27,296,1,295,1,1,0,1,1,153,152,143,143,24
"2016",15,"[27]xHoIEDeewfoHcouHnJqGKCymgqz",293,0.996599,27,294,1,293,1,1,0,1,1,145,144,149,149,24
"2017",16,"[27]xHoIEDeewfoHcouHnJqGKCymgqz",294,0.99661,27,295,1,294,1,1,0,1,1,139,138,156,156,24
"2018",17,"[27]xHoIEDeewfoHcouHnJqGKCymgqz",295,0.996622,27,296,1,295,1,1,0,1,1,148,147,148,148,24
"2019",18,"[27]xHoIEDeewfoHcouHnJqGKCymgqz",297,0.996644,27,298,1,297,1,1,0,1,1,153,152,145,145,24
"2020",19,"[27]xHoIEDeewfoHcouHnJqGKCymgqz",296,0.996633,27,297,1,296,1,1,0,1,1,156,155,141,141,24
"2021",20,"[27]xHoIEDeewfoHcouHnJqGKCymgqz",291,0.996575,27,292,1,291,1,1,0,1,1,143,142,149,149,24
"2022",21,"[27]xHoIEDeewfoHcouHnJqGKCymgqz",290,0.996564,27,291,1,290,1,1,0,1,1,147,146,144,144,24
"2023",22,"[27]xHoIEDeewfoHcouHnJqGKCymgqz",299,0.996667,27,300,1,299,1,1,0,1,1,158,157,142,142,24
"2024",23,"[27]xHoIEDeewfoHcouHnJqGKCymgqz",302,0.9967,27,303,1,302,1,1,0,1,1,168,167,135,135,24
"2025",24,"[27]xHoIEDeewfoHcouHnJqGKCymgqz",297,0.996644,27,298,1,297,1,1,0,1,1,148,147,150,150,24
"2026",25,"[27]xHoIEDeewfoHcouHnJqGKCymgqz",295,0.996622,27,296,1,295,1,1,0,1,1,144,143,152,152,24
"2027",26,"[27]xHoIEDeewfoHcouHnJqGKCymgqz",296,0.996633,27,297,1,296,1,1,0,1,1,150,149,147,147,24
"2028",27,"[27]xHoIEDeewfoHcouHnJqGKCymgqz",288,0.99654,27,289,1,288,1,1,0,1,1,144,143,145,145,24
"2029",28,"[27]xHoIEDeewfoHcouHnJqGKCymgqz",293,0.996599,27,294,1,293,1,1,0,1,1,160,159,134,134,24
"2030",29,"[27]xHoIEDeewfoHcouHnJqGKCymgqz",299,0.996667,27,300,1,299,1,1,0,1,1,154,153,146,146,24
"2031",30,"[27]xHoIEDeewfoHcouHnJqGKCymgqz",302,0.9967,27,303,1,302,1,1,0,1,1,172,171,131,131,24
"2032",31,"[27]xHoIEDeewfoHcouHnJqGKCymgqz",309,0.996774,27,310,1,309,1,1,0,1,1,184,183,126,126,24
"2033",32,"[27]xHoIEDeewfoHcouHnJqGKCymgqz",297,0.996644,27,298,1,297,1,1,0,1,1,154,153,144,144,24
"2034",33,"[27]xHoIEDeewfoHcouHnJqGKCymgqz",297,0.996644,27,298,1,297,1,1,0,1,1,154,153,144,144,24
"2035",34,"[27]xHoIEDeewfoHcouHnJqGKCymgqz",300,0.996678,27,301,1,300,1,1,0,1,1,161,160,140,140,24
"2036",35,"[27]xHoIEDeewfoHcouHnJqGKCymgqz",291,0.996575,27,292,1,291,1,1,0,1,1,138,137,154,154,24
"2037",36,"[27]xHoIEDeewfoHcouHnJqGKCymgqz",294,0.99661,27,295,1,294,1,1,0,1,1,141,140,154,154,24
"2038",37,"[27]xHoIEDeewfoHcouHnJqGKCymgqz",295,0.996622,27,296,1,295,1,1,0,1,1,160,159,136,136,24
"2039",38,"[27]xHoIEDeewfoHcouHnJqGKCymgqz",302,0.9967,27,303,1,302,1,1,0,1,1,171,170,132,132,24
"2040",39,"[27]xHoIEDeewfoHcouHnJqGKCymgqz",302,0.9967,27,303,1,302,1,1,0,1,1,167,166,136,136,24
"2041",40,"[27]xHoIEDeewfoHcouHnJqGKCymgqz",296,0.996633,27,297,1,296,1,1,0,1,1,152,151,145,145,24
"2042",41,"[27]xHoIEDeewfoHcouHnJqGKCymgqz",289,0.996552,27,290,1,289,1,1,0,1,1,134,133,156,156,24
"2043",42,"[27]xHoIEDeewfoHcouHnJqGKCymgqz",293,0.996599,27,294,1,293,1,1,0,1,1,141,140,153,153,24
"2044",43,"[27]xHoIEDeewfoHcouHnJqGKCymgqz",295,0.996622,27,296,1,295,1,1,0,1,1,143,142,153,153,24
"2045",44,"[27]xHoIEDeewfoHcouHnJqGKCymgqz",292,0.996587,27,293,1,292,1,1,0,1,1,139,138,154,154,24
"2046",45,"[27]xHoIEDeewfoHcouHnJqGKCymgqz",297,0.996644,27,298,1,297,1,1,0,1,1,152,151,146,146,24
"2047",46,"[27]xHoIEDeewfoHcouHnJqGKCymgqz",289,0.996552,27,290,1,289,1,1,0,1,1,133,132,157,157,24
"2048",47,"[27]xHoIEDeewfoHcouHnJqGKCymgqz",293,0.996599,27,294,1,293,1,1,0,1,1,140,139,154,154,24
"2049",48,"[27]xHoIEDeewfoHcouHnJqGKCymgqz",300,0.996678,27,301,1,300,1,1,0,1,1,161,160,140,140,24
"2050",49,"[27]xHoIEDeewfoHcouHnJqGKCymgqz",308,0.996764,27,309,1,308,1,1,0,1,1,176,175,133,133,24
"2051",50,"[27]xHoIEDeewfoHcouHnJqGKCymgqz",296,0.996633,27,297,1,296,1,1,0,1,1,147,146,150,150,24
"2052",51,"[27]xHoIEDeewfoHcouHnJqGKCymgqz",290,0.996564,27,291,1,290,1,1,0,1,1,133,132,158,158,24
"2053",52,"[27]xHoIEDeewfoHcouHnJqGKCymgqz",294,0.99661,27,295,1,294,1,1,0,1,1,151,150,144,144,24
"2054",53,"[27]xHoIEDeewfoHcouHnJqGKCymgqz",294,0.99661,27,295,1,294,1,1,0,1,1,142,141,153,153,24
"2055",54,"[27]xHoIEDeewfoHcouHnJqGKCymgqz",295,0.996622,27,296,1,295,1,1,0,1,1,146,145,150,150,24
"2056",55,"[27]xHoIEDeewfoHcouHnJqGKCymgqz",291,0.996575,27,292,1,291,1,1,0,1,1,135,134,157,157,24
"2057",56,"[27]xHoIEDeewfoHcouHnJqGKCymgqz",288,0.99654,27,289,1,288,1,1,0,1,1,139,138,150,150,24
"2058",57,"[27]xHoIEDeewfoHcouHnJqGKCymgqz",290,0.996564,27,291,1,290,1,1,0,1,1,144,143,147,147,24
"2059",58,"[27]xHoIEDeewfoHcouHnJqGKCymgqz",298,0.996656,27,299,1,298,1,1,0,1,1,155,154,144,144,24
"2060",59,"[27]xHoIEDeewfoHcouHnJqGKCymgqz",292,0.996587,27,293,1,292,1,1,0,1,1,149,148,144,144,24
"2061",60,"[27]xHoIEDeewfoHcouHnJqGKCymgqz",294,0.99661,27,295,1,294,1,1,0,1,1,157,156,138,138,24
"2062",61,"[27]xHoIEDeewfoHcouHnJqGKCymgqz",293,0.996599,27,294,1,293,1,1,0,1,1,137,136,157,157,24
"2063",62,"[27]xHoIEDeewfoHcouHnJqGKCymgqz",294,0.99661,27,295,1,294,1,1,0,1,1,144,143,151,151,24
"2064",63,"[27]xHoIEDeewfoHcouHnJqGKCymgqz",294,0.99661,27,295,1,294,1,1,0,1,1,140,139,155,155,24
"2065",64,"[27]xHoIEDeewfoHcouHnJqGKCymgqz",297,0.996644,27,298,1,297,1,1,0,1,1,155,154,143,143,24
"2066",65,"[27]xHoIEDeewfoHcouHnJqGKCymgqz",297,0.996644,27,298,1,297,1,1,0,1,1,150,149,148,148,24
"2067",66,"[27]xHoIEDeewfoHcouHnJqGKCymgqz",301,0.996689,27,302,1,301,1,1,0,1,1,165,164,137,137,24
"2068",67,"[27]xHoIEDeewfoHcouHnJqGKCymgqz",294,0.99661,27,295,1,294,1,1,0,1,1,149,148,146,146,24
"2069",68,"[27]xHoIEDeewfoHcouHnJqGKCymgqz",294,0.99661,27,295,1,294,1,1,0,1,1,151,150,144,144,24
"2070",69,"[27]xHoIEDeewfoHcouHnJqGKCymgqz",301,0.996689,27,302,1,301,1,1,0,1,1,170,169,132,132,24
"2071",70,"[27]xHoIEDeewfoHcouHnJqGKCymgqz",295,0.996622,27,296,1,295,1,1,0,1,1,148,147,148,148,24
"2072",71,"[27]xHoIEDeewfoHcouHnJqGKCymgqz",300,0.996678,27,301,1,300,1,1,0,1,1,162,161,139,139,24
"2073",72,"[27]xHoIEDeewfoHcouHnJqGKCymgqz",300,0.996678,27,301,1,300,1,1,0,1,1,160,159,141,141,24
"2074",73,"[27]xHoIEDeewfoHcouHnJqGKCymgqz",299,0.996667,27,300,1,299,1,1,0,1,1,158,157,142,142,24
"2075",74,"[27]xHoIEDeewfoHcouHnJqGKCymgqz",288,0.99654,27,289,1,288,1,1,0,1,1,121,120,168,168,24
"2076",75,"[27]xHoIEDeewfoHcouHnJqGKCymgqz",295,0.996622,27,296,1,295,1,1,0,1,1,153,152,143,143,24
"2077",76,"[27]xHoIEDeewfoHcouHnJqGKCymgqz",296,0.996633,27,297,1,296,1,1,0,1,1,149,148,148,148,24
"2078",77,"[27]xHoIEDeewfoHcouHnJqGKCymgqz",293,0.996599,27,294,1,293,1,1,0,1,1,142,141,152,152,24
"2079",78,"[27]xHoIEDeewfoHcouHnJqGKCymgqz",289,0.996552,27,290,1,289,1,1,0,1,1,143,142,147,147,24
"2080",79,"[27]xHoIEDeewfoHcouHnJqGKCymgqz",296,0.996633,27,297,1,296,1,1,0,1,1,144,143,153,153,24
"2081",80,"[27]xHoIEDeewfoHcouHnJqGKCymgqz",300,0.996678,27,301,1,300,1,1,0,1,1,163,162,138,138,24
"2082",81,"[27]xHoIEDeewfoHcouHnJqGKCymgqz",297,0.996644,27,298,1,297,1,1,0,1,1,150,149,148,148,24
"2083",82,"[27]xHoIEDeewfoHcouHnJqGKCymgqz",306,0.996743,27,307,1,306,1,1,0,1,1,179,178,128,128,24
"2084",83,"[27]xHoIEDeewfoHcouHnJqGKCymgqz",296,0.996633,27,297,1,296,1,1,0,1,1,152,151,145,145,24
"2085",84,"[27]xHoIEDeewfoHcouHnJqGKCymgqz",300,0.996678,27,301,1,300,1,1,0,1,1,158,157,143,143,24
"2086",85,"[27]xHoIEDeewfoHcouHnJqGKCymgqz",292,0.996587,27,293,1,292,1,1,0,1,1,140,139,153,153,24
"2087",86,"[27]xHoIEDeewfoHcouHnJqGKCymgqz",290,0.996564,27,291,1,290,1,1,0,1,1,140,139,151,151,24
"2088",87,"[27]xHoIEDeewfoHcouHnJqGKCymgqz",297,0.996644,27,298,1,297,1,1,0,1,1,154,153,144,144,24
"2089",88,"[27]xHoIEDeewfoHcouHnJqGKCymgqz",292,0.996587,27,293,1,292,1,1,0,1,1,140,139,153,153,24
"2090",89,"[27]xHoIEDeewfoHcouHnJqGKCymgqz",296,0.996633,27,297,1,296,1,1,0,1,1,150,149,147,147,24
"2091",90,"[27]xHoIEDeewfoHcouHnJqGKCymgqz",299,0.996667,27,300,1,299,1,1,0,1,1,158,157,142,142,24
"2092",91,"[27]xHoIEDeewfoHcouHnJqGKCymgqz",297,0.996644,27,298,1,297,1,1,0,1,1,150,149,148,148,24
"2093",92,"[27]xHoIEDeewfoHcouHnJqGKCymgqz",296,0.996633,27,297,1,296,1,1,0,1,1,147,146,150,150,24
"2094",93,"[27]xHoIEDeewfoHcouHnJqGKCymgqz",294,0.99661,27,295,1,294,1,1,0,1,1,149,148,146,146,24
"2095",94,"[27]xHoIEDeewfoHcouHnJqGKCymgqz",291,0.996575,27,292,1,291,1,1,0,1,1,136,135,156,156,24
"2096",95,"[27]xHoIEDeewfoHcouHnJqGKCymgqz",291,0.996575,27,292,1,291,1,1,0,1,1,150,149,142,142,24
"2097",96,"[27]xHoIEDeewfoHcouHnJqGKCymgqz",300,0.996678,27,301,1,300,1,1,0,1,1,158,157,143,143,24
"2098",97,"[27]xHoIEDeewfoHcouHnJqGKCymgqz",294,0.99661,27,295,1,294,1,1,0,1,1,151,150,144,144,24
"2099",98,"[27]xHoIEDeewfoHcouHnJqGKCymgqz",292,0.996587,27,293,1,292,1,1,0,1,1,150,149,143,143,24
"2100",99,"[27]xHoIEDeewfoHcouHnJqGKCymgqz",301,0.996689,27,302,1,301,1,1,0,1,1,164,163,138,138,24
"2101",0,"[24]tHuoIczoHcowHnJHqGKCocBE",301,0.996689,24,302,1,301,1,1,0,1,1,178,177,124,124,25
"2102",1,"[24]tHuoIczoHcowHnJHqGKCocBE",291,0.996575,24,292,1,291,1,1,0,1,1,149,148,143,143,25
"2103",2,"[24]tHuoIczoHcowHnJHqGKCocBE",287,0.996528,24,288,1,287,1,1,0,1,1,135,134,153,153,25
"2104",3,"[24]tHuoIczoHcowHnJHqGKCocBE",291,0.996575,24,292,1,291,1,1,0,1,1,152,151,140,140,25
"2105",4,"[24]tHuoIczoHcowHnJHqGKCocBE",296,0.996633,24,297,1,296,1,1,0,1,1,147,146,150,150,25
"2106",5,"[24]tHuoIczoHcowHnJHqGKCocBE",297,0.996644,24,298,1,297,1,1,0,1,1,147,146,151,151,25
"2107",6,"[24]tHuoIczoHcowHnJHqGKCocBE",287,0.996528,24,288,1,287,1,1,0,1,1,132,131,156,156,25
"2108",7,"[24]tHuoIczoHcowHnJHqGKCocBE",300,0.996678,24,301,1,300,1,1,0,1,1,151,150,150,150,25
"2109",8,"[24]tHuoIczoHcowHnJHqGKCocBE",289,0.996552,24,290,1,289,1,1,0,1,1,133,132,157,157,25
"2110",9,"[24]tHuoIczoHcowHnJHqGKCocBE",296,0.996633,24,297,1,296,1,1,0,1,1,146,145,151,151,25
"2111",10,"[24]tHuoIczoHcowHnJHqGKCocBE",298,0.996656,24,299,1,298,1,1,0,1,1,154,153,145,145,25
"2112",11,"[24]tHuoIczoHcowHnJHqGKCocBE",299,0.996667,24,300,1,299,1,1,0,1,1,147,146,153,153,25
"2113",12,"[24]tHuoIczoHcowHnJHqGKCocBE",296,0.996633,24,297,1,296,1,1,0,1,1,146,145,151,151,25
"2114",13,"[24]tHuoIczoHcowHnJHqGKCocBE",300,0.996678,24,301,1,300,1,1,0,1,1,158,157,143,143,25
"2115",14,"[24]tHuoIczoHcowHnJHqGKCocBE",281,0.996454,24,282,1,281,1,1,0,1,1,136,135,146,146,25
"2116",15,"[24]tHuoIczoHcowHnJHqGKCocBE",293,0.996599,24,294,1,293,1,1,0,1,1,147,146,147,147,25
"2117",16,"[24]tHuoIczoHcowHnJHqGKCocBE",300,0.996678,24,301,1,300,1,1,0,1,1,165,164,136,136,25
"2118",17,"[24]tHuoIczoHcowHnJHqGKCocBE",295,0.996622,24,296,1,295,1,1,0,1,1,146,145,150,150,25
"2119",18,"[24]tHuoIczoHcowHnJHqGKCocBE",293,0.996599,24,294,1,293,1,1,0,1,1,139,138,155,155,25
"2120",19,"[24]tHuoIczoHcowHnJHqGKCocBE",305,0.996732,24,306,1,305,1,1,0,1,1,161,160,145,145,25
"2121",20,"[24]tHuoIczoHcowHnJHqGKCocBE",307,0.996753,24,308,1,307,1,1,0,1,1,168,167,140,140,25
"2122",21,"[24]tHuoIczoHcowHnJHqGKCocBE",292,0.996587,24,293,1,292,1,1,0,1,1,150,149,143,143,25
"2123",22,"[24]tHuoIczoHcowHnJHqGKCocBE",295,0.996622,24,296,1,295,1,1,0,1,1,149,148,147,147,25
"2124",23,"[24]tHuoIczoHcowHnJHqGKCocBE",291,0.996575,24,292,1,291,1,1,0,1,1,136,135,156,156,25
"2125",24,"[24]tHuoIczoHcowHnJHqGKCocBE",303,0.996711,24,304,1,303,1,1,0,1,1,160,159,144,144,25
"2126",25,"[24]tHuoIczoHcowHnJHqGKCocBE",298,0.996656,24,299,1,298,1,1,0,1,1,149,148,150,150,25
"2127",26,"[24]tHuoIczoHcowHnJHqGKCocBE",296,0.996633,24,297,1,296,1,1,0,1,1,156,155,141,141,25
"2128",27,"[24]tHuoIczoHcowHnJHqGKCocBE",287,0.996528,24,288,1,287,1,1,0,1,1,133,132,155,155,25
"2129",28,"[24]tHuoIczoHcowHnJHqGKCocBE",292,0.996587,24,293,1,292,1,1,0,1,1,141,140,152,152,25
"2130",29,"[24]tHuoIczoHcowHnJHqGKCocBE",297,0.996644,24,298,1,297,1,1,0,1,1,158,157,140,140,25
"2131",30,"[24]tHuoIczoHcowHnJHqGKCocBE",293,0.996599,24,294,1,293,1,1,0,1,1,150,149,144,144,25
"2132",31,"[24]tHuoIczoHcowHnJHqGKCocBE",297,0.996644,24,298,1,297,1,1,0,1,1,148,147,150,150,25
"2133",32,"[24]tHuoIczoHcowHnJHqGKCocBE",290,0.996564,24,291,1,290,1,1,0,1,1,145,144,146,146,25
"2134",33,"[24]tHuoIczoHcowHnJHqGKCocBE",287,0.996528,24,288,1,287,1,1,0,1,1,139,138,149,149,25
"2135",34,"[24]tHuoIczoHcowHnJHqGKCocBE",293,0.996599,24,294,1,293,1,1,0,1,1,150,149,144,144,25
"2136",35,"[24]tHuoIczoHcowHnJHqGKCocBE",301,0.996689,24,302,1,301,1,1,0,1,1,161,160,141,141,25
"2137",36,"[24]tHuoIczoHcowHnJHqGKCocBE",298,0.996656,24,299,1,298,1,1,0,1,1,165,164,134,134,25
"2138",37,"[24]tHuoIczoHcowHnJHqGKCocBE",295,0.996622,24,296,1,295,1,1,0,1,1,157,156,139,139,25
"2139",38,"[24]tHuoIczoHcowHnJHqGKCocBE",292,0.996587,24,293,1,292,1,1,0,1,1,140,139,153,153,25
"2140",39,"[24]tHuoIczoHcowHnJHqGKCocBE",300,0.996678,24,301,1,300,1,1,0,1,1,154,153,147,147,25
"2141",40,"[24]tHuoIczoHcowHnJHqGKCocBE",305,0.996732,24,306,1,305,1,1,0,1,1,174,173,132,132,25
"2142",41,"[24]tHuoIczoHcowHnJHqGKCocBE",288,0.99654,24,289,1,288,1,1,0,1,1,140,139,149,149,25
"2143",42,"[24]tHuoIczoHcowHnJHqGKCocBE",295,0.996622,24,296,1,295,1,1,0,1,1,145,144,151,151,25
"2144",43,"[24]tHuoIczoHcowHnJHqGKCocBE",293,0.996599,24,294,1,293,1,1,0,1,1,143,142,151,151,25
"2145",44,"[24]tHuoIczoHcowHnJHqGKCocBE",290,0.996564,24,291,1,290,1,1,0,1,1,151,150,140,140,25
"2146",45,"[24]tHuoIczoHcowHnJHqGKCocBE",297,0.996644,24,298,1,297,1,1,0,1,1,159,158,139,139,25
"2147",46,"[24]tHuoIczoHcowHnJHqGKCocBE",289,0.996552,24,290,1,289,1,1,0,1,1,137,136,153,153,25
"2148",47,"[24]tHuoIczoHcowHnJHqGKCocBE",300,0.996678,24,301,1,300,1,1,0,1,1,166,165,135,135,25
"2149",48,"[24]tHuoIczoHcowHnJHqGKCocBE",299,0.996667,24,300,1,299,1,1,0,1,1,161,160,139,139,25
"2150",49,"[24]tHuoIczoHcowHnJHqGKCocBE",297,0.996644,24,298,1,297,1,1,0,1,1,151,150,147,147,25
"2151",50,"[24]tHuoIczoHcowHnJHqGKCocBE",294,0.99661,24,295,1,294,1,1,0,1,1,137,136,158,158,25
"2152",51,"[24]tHuoIczoHcowHnJHqGKCocBE",297,0.996644,24,298,1,297,1,1,0,1,1,150,149,148,148,25
"2153",52,"[24]tHuoIczoHcowHnJHqGKCocBE",289,0.996552,24,290,1,289,1,1,0,1,1,141,140,149,149,25
"2154",53,"[24]tHuoIczoHcowHnJHqGKCocBE",291,0.996575,24,292,1,291,1,1,0,1,1,144,143,148,148,25
"2155",54,"[24]tHuoIczoHcowHnJHqGKCocBE",293,0.996599,24,294,1,293,1,1,0,1,1,143,142,151,151,25
"2156",55,"[24]tHuoIczoHcowHnJHqGKCocBE",302,0.9967,24,303,1,302,1,1,0,1,1,158,157,145,145,25
"2157",56,"[24]tHuoIczoHcowHnJHqGKCocBE",298,0.996656,24,299,1,298,1,1,0,1,1,164,163,135,135,25
"2158",57,"[24]tHuoIczoHcowHnJHqGKCocBE",290,0.996564,24,291,1,290,1,1,0,1,1,134,133,157,157,25
"2159",58,"[24]tHuoIczoHcowHnJHqGKCocBE",303,0.996711,24,304,1,303,1,1,0,1,1,163,162,141,141,25
"2160",59,"[24]tHuoIczoHcowHnJHqGKCocBE",300,0.996678,24,301,1,300,1,1,0,1,1,167,166,134,134,25
"2161",60,"[24]tHuoIczoHcowHnJHqGKCocBE",294,0.99661,24,295,1,294,1,1,0,1,1,139,138,156,156,25
"2162",61,"[24]tHuoIczoHcowHnJHqGKCocBE",299,0.996667,24,300,1,299,1,1,0,1,1,157,156,143,143,25
"2163",62,"[24]tHuoIczoHcowHnJHqGKCocBE",284,0.996491,24,285,1,284,1,1,0,1,1,121,120,164,164,25
"2164",63,"[24]tHuoIczoHcowHnJHqGKCocBE",292,0.996587,24,293,1,292,1,1,0,1,1,155,154,138,138,25
"2165",64,"[24]tHuoIczoHcowHnJHqGKCocBE",298,0.996656,24,299,1,298,1,1,0,1,1,143,142,156,156,25
"2166",65,"[24]tHuoIczoHcowHnJHqGKCocBE",296,0.996633,24,297,1,296,1,1,0,1,1,144,143,153,153,25
"2167",66,"[24]tHuoIczoHcowHnJHqGKCocBE",299,0.996667,24,300,1,299,1,1,0,1,1,151,150,149,149,25
"2168",67,"[24]tHuoIczoHcowHnJHqGKCocBE",291,0.996575,24,292,1,291,1,1,0,1,1,143,142,149,149,25
"2169",68,"[24]tHuoIczoHcowHnJHqGKCocBE",291,0.996575,24,292,1,291,1,1,0,1,1,146,145,146,146,25
"2170",69,"[24]tHuoIczoHcowHnJHqGKCocBE",283,0.996479,24,284,1,283,1,1,0,1,1,121,120,163,163,25
"2171",70,"[24]tHuoIczoHcowHnJHqGKCocBE",298,0.996656,24,299,1,298,1,1,0,1,1,160,159,139,139,25
"2172",71,"[24]tHuoIczoHcowHnJHqGKCocBE",297,0.996644,24,298,1,297,1,1,0,1,1,146,145,152,152,25
"2173",72,"[24]tHuoIczoHcowHnJHqGKCocBE",299,0.996667,24,300,1,299,1,1,0,1,1,164,163,136,136,25
"2174",73,"[24]tHuoIczoHcowHnJHqGKCocBE",289,0.996552,24,290,1,289,1,1,0,1,1,137,136,153,153,25
"2175",74,"[24]tHuoIczoHcowHnJHqGKCocBE",295,0.996622,24,296,1,295,1,1,0,1,1,152,151,144,144,25
"2176",75,"[24]tHuoIczoHcowHnJHqGKCocBE",297,0.996644,24,298,1,297,1,1,0,1,1,153,152,145,145,25
"2177",76,"[24]tHuoIczoHcowHnJHqGKCocBE",303,0.996711,24,304,1,303,1,1,0,1,1,158,157,146,146,25
"2178",77,"[24]tHuoIczoHcowHnJHqGKCocBE",312,0.996805,24,313,1,312,1,1,0,1,1,176,175,137,137,25
"2179",78,"[24]tHuoIczoHcowHnJHqGKCocBE",291,0.996575,24,292,1,291,1,1,0,1,1,148,147,144,144,25
"2180",79,"[24]tHuoIczoHcowHnJHqGKCocBE",287,0.996528,24,288,1,287,1,1,0,1,1,138,137,150,150,25
"2181",80,"[24]tHuoIczoHcowHnJHqGKCocBE",303,0.996711,24,304,1,303,1,1,0,1,1,150,149,154,154,25
"2182",81,"[24]tHuoIczoHcowHnJHqGKCocBE",300,0.996678,24,301,1,300,1,1,0,1,1,152,151,149,149,25
"2183",82,"[24]tHuoIczoHcowHnJHqGKCocBE",288,0.99654,24,289,1,288,1,1,0,1,1,143,142,146,146,25
"2184",83,"[24]tHuoIczoHcowHnJHqGKCocBE",300,0.996678,24,301,1,300,1,1,0,1,1,158,157,143,143,25
"2185",84,"[24]tHuoIczoHcowHnJHqGKCocBE",294,0.99661,24,295,1,294,1,1,0,1,1,149,148,146,146,25
"2186",85,"[24]tHuoIczoHcowHnJHqGKCocBE",292,0.996587,24,293,1,292,1,1,0,1,1,141,140,152,152,25
"2187",86,"[24]tHuoIczoHcowHnJHqGKCocBE",294,0.99661,24,295,1,294,1,1,0,1,1,145,144,150,150,25
"2188",87,"[24]tHuoIczoHcowHnJHqGKCocBE",293,0.996599,24,294,1,293,1,1,0,1,1,148,147,146,146,25
"2189",88,"[24]tHuoIczoHcowHnJHqGKCocBE",287,0.996528,24,288,1,287,1,1,0,1,1,128,127,160,160,25
"2190",89,"[24]tHuoIczoHcowHnJHqGKCocBE",291,0.996575,24,292,1,291,1,1,0,1,1,135,134,157,157,25
"2191",90,"[24]tHuoIczoHcowHnJHqGKCocBE",292,0.996587,24,293,1,292,1,1,0,1,1,154,153,139,139,25
"2192",91,"[24]tHuoIczoHcowHnJHqGKCocBE",294,0.99661,24,295,1,294,1,1,0,1,1,147,146,148,148,25
"2193",92,"[24]tHuoIczoHcowHnJHqGKCocBE",293,0.996599,24,294,1,293,1,1,0,1,1,144,143,150,150,25
"2194",93,"[24]tHuoIczoHcowHnJHqGKCocBE",304,0.996721,24,305,1,304,1,1,0,1,1,154,153,151,151,25
"2195",94,"[24]tHuoIczoHcowHnJHqGKCocBE",290,0.996564,24,291,1,290,1,1,0,1,1,140,139,151,151,25
"2196",95,"[24]tHuoIczoHcowHnJHqGKCocBE",293,0.996599,24,294,1,293,1,1,0,1,1,154,153,140,140,25
"2197",96,"[24]tHuoIczoHcowHnJHqGKCocBE",292,0.996587,24,293,1,292,1,1,0,1,1,144,143,149,149,25
"2198",97,"[24]tHuoIczoHcowHnJHqGKCocBE",294,0.99661,24,295,1,294,1,1,0,1,1,135,134,160,160,25
"2199",98,"[24]tHuoIczoHcowHnJHqGKCocBE",297,0.996644,24,298,1,297,1,1,0,1,1,152,151,146,146,25
"2200",99,"[24]tHuoIczoHcowHnJHqGKCocBE",285,0.996503,24,286,1,285,1,1,0,1,1,134,133,152,152,25
"2201",0,"[31]wnHrxoIoHcovHnJHGqKCJpwCsGxmdrl",282,0.996466,31,283,1,282,1,1,0,1,1,144,143,139,139,26
"2202",1,"[31]wnHrxoIoHcovHnJHGqKCJpwCsGxmdrl",286,0.996516,31,287,1,286,1,1,0,1,1,156,155,131,131,26
"2203",2,"[31]wnHrxoIoHcovHnJHGqKCJpwCsGxmdrl",274,0.996364,31,275,1,274,1,1,0,1,1,119,118,156,156,26
"2204",3,"[31]wnHrxoIoHcovHnJHGqKCJpwCsGxmdrl",284,0.996491,31,285,1,284,1,1,0,1,1,149,148,136,136,26
"2205",4,"[31]wnHrxoIoHcovHnJHGqKCJpwCsGxmdrl",284,0.996491,31,285,1,284,1,1,0,1,1,127,126,158,158,26
"2206",5,"[31]wnHrxoIoHcovHnJHGqKCJpwCsGxmdrl",281,0.996454,31,282,1,281,1,1,0,1,1,153,152,129,129,26
"2207",6,"[31]wnHrxoIoHcovHnJHGqKCJpwCsGxmdrl",280,0.996441,31,281,1,280,1,1,0,1,1,134,133,147,147,26
"2208",7,"[31]wnHrxoIoHcovHnJHGqKCJpwCsGxmdrl",290,0.996564,31,291,1,290,1,1,0,1,1,148,147,143,143,26
"2209",8,"[31]wnHrxoIoHcovHnJHGqKCJpwCsGxmdrl",284,0.996491,31,285,1,284,1,1,0,1,1,158,157,127,127,26
"2210",9,"[31]wnHrxoIoHcovHnJHGqKCJpwCsGxmdrl",283,0.996479,31,284,1,283,1,1,0,1,1,142,141,142,142,26
"2211",10,"[31]wnHrxoIoHcovHnJHGqKCJpwCsGxmdrl",279,0.996429,31,280,1,279,1,1,0,1,1,142,141,138,138,26
"2212",11,"[31]wnHrxoIoHcovHnJHGqKCJpwCsGxmdrl",282,0.996466,31,283,1,282,1,1,0,1,1,147,146,136,136,26
"2213",12,"[31]wnHrxoIoHcovHnJHGqKCJpwCsGxmdrl",288,0.99654,31,289,1,288,1,1,0,1,1,141,140,148,148,26
"2214",13,"[31]wnHrxoIoHcovHnJHGqKCJpwCsGxmdrl",276,0.99639,31,277,1,276,1,1,0,1,1,134,133,143,143,26
"2215",14,"[31]wnHrxoIoHcovHnJHGqKCJpwCsGxmdrl",276,0.99639,31,277,1,276,1,1,0,1,1,133,132,144,144,26
"2216",15,"[31]wnHrxoIoHcovHnJHGqKCJpwCsGxmdrl",288,0.99654,31,289,1,288,1,1,0,1,1,153,152,136,136,26
"2217",16,"[31]wnHrxoIoHcovHnJHGqKCJpwCsGxmdrl",285,0.996503,31,286,1,285,1,1,0,1,1,138,137,148,148,26
"2218",17,"[31]wnHrxoIoHcovHnJHGqKCJpwCsGxmdrl",285,0.996503,31,286,1,285,1,1,0,1,1,136,135,150,150,26
"2219",18,"[31]wnHrxoIoHcovHnJHGqKCJpwCsGxmdrl",279,0.996429,31,280,1,279,1,1,0,1,1,133,132,147,147,26
"2220",19,"[31]wnHrxoIoHcovHnJHGqKCJpwCsGxmdrl",269,0.996296,31,270,1,269,1,1,0,1,1,122,121,148,148,26
"2221",20,"[31]wnHrxoIoHcovHnJHGqKCJpwCsGxmdrl",284,0.996491,31,285,1,284,1,1,0,1,1,143,142,142,142,26
"2222",21,"[31]wnHrxoIoHcovHnJHGqKCJpwCsGxmdrl",281,0.996454,31,282,1,281,1,1,0,1,1,132,131,150,150,26
"2223",22,"[31]wnHrxoIoHcovHnJHGqKCJpwCsGxmdrl",285,0.996503,31,286,1,285,1,1,0,1,1,143,142,143,143,26
"2224",23,"[31]wnHrxoIoHcovHnJHGqKCJpwCsGxmdrl",280,0.996441,31,281,1,280,1,1,0,1,1,141,140,140,140,26
"2225",24,"[31]wnHrxoIoHcovHnJHGqKCJpwCsGxmdrl",275,0.996377,31,276,1,275,1,1,0,1,1,131,130,145,145,26
"2226",25,"[31]wnHrxoIoHcovHnJHGqKCJpwCsGxmdrl",276,0.99639,31,277,1,276,1,1,0,1,1,148,147,129,129,26
"2227",26,"[31]wnHrxoIoHcovHnJHGqKCJpwCsGxmdrl",275,0.996377,31,276,1,275,1,1,0,1,1,155,154,121,121,26
"2228",27,"[31]wnHrxoIoHcovHnJHGqKCJpwCsGxmdrl",273,0.99635,31,274,1,273,1,1,0,1,1,121,120,153,153,26
"2229",28,"[31]wnHrxoIoHcovHnJHGqKCJpwCsGxmdrl",276,0.99639,31,277,1,276,1,1,0,1,1,141,140,136,136,26
"2230",29,"[31]wnHrxoIoHcovHnJHGqKCJpwCsGxmdrl",284,0.996491,31,285,1,284,1,1,0,1,1,131,130,154,154,26
"2231",30,"[31]wnHrxoIoHcovHnJHGqKCJpwCsGxmdrl",269,0.996296,31,270,1,269,1,1,0,1,1,134,133,136,136,26
"2232",31,"[31]wnHrxoIoHcovHnJHGqKCJpwCsGxmdrl",280,0.996441,31,281,1,280,1,1,0,1,1,150,149,131,131,26
"2233",32,"[31]wnHrxoIoHcovHnJHGqKCJpwCsGxmdrl",287,0.996528,31,288,1,287,1,1,0,1,1,140,139,148,148,26
"2234",33,"[31]wnHrxoIoHcovHnJHGqKCJpwCsGxmdrl",286,0.996516,31,287,1,286,1,1,0,1,1,150,149,137,137,26
"2235",34,"[31]wnHrxoIoHcovHnJHGqKCJpwCsGxmdrl",281,0.996454,31,282,1,281,1,1,0,1,1,145,144,137,137,26
"2236",35,"[31]wnHrxoIoHcovHnJHGqKCJpwCsGxmdrl",288,0.99654,31,289,1,288,1,1,0,1,1,145,144,144,144,26
"2237",36,"[31]wnHrxoIoHcovHnJHGqKCJpwCsGxmdrl",283,0.996479,31,284,1,283,1,1,0,1,1,139,138,145,145,26
"2238",37,"[31]wnHrxoIoHcovHnJHGqKCJpwCsGxmdrl",282,0.996466,31,283,1,282,1,1,0,1,1,143,142,140,140,26
"2239",38,"[31]wnHrxoIoHcovHnJHGqKCJpwCsGxmdrl",288,0.99654,31,289,1,288,1,1,0,1,1,142,141,147,147,26
"2240",39,"[31]wnHrxoIoHcovHnJHGqKCJpwCsGxmdrl",282,0.996466,31,283,1,282,1,1,0,1,1,140,139,143,143,26
"2241",40,"[31]wnHrxoIoHcovHnJHGqKCJpwCsGxmdrl",284,0.996491,31,285,1,284,1,1,0,1,1,138,137,147,147,26
"2242",41,"[31]wnHrxoIoHcovHnJHGqKCJpwCsGxmdrl",281,0.996454,31,282,1,281,1,1,0,1,1,151,150,131,131,26
"2243",42,"[31]wnHrxoIoHcovHnJHGqKCJpwCsGxmdrl",285,0.996503,31,286,1,285,1,1,0,1,1,142,141,144,144,26
"2244",43,"[31]wnHrxoIoHcovHnJHGqKCJpwCsGxmdrl",275,0.996377,31,276,1,275,1,1,0,1,1,150,149,126,126,26
"2245",44,"[31]wnHrxoIoHcovHnJHGqKCJpwCsGxmdrl",287,0.996528,31,288,1,287,1,1,0,1,1,147,146,141,141,26
"2246",45,"[31]wnHrxoIoHcovHnJHGqKCJpwCsGxmdrl",279,0.996429,31,280,1,279,1,1,0,1,1,134,133,146,146,26
"2247",46,"[31]wnHrxoIoHcovHnJHGqKCJpwCsGxmdrl",284,0.996491,31,285,1,284,1,1,0,1,1,153,152,132,132,26
"2248",47,"[31]wnHrxoIoHcovHnJHGqKCJpwCsGxmdrl",280,0.996441,31,281,1,280,1,1,0,1,1,147,146,134,134,26
"2249",48,"[31]wnHrxoIoHcovHnJHGqKCJpwCsGxmdrl",281,0.996454,31,282,1,281,1,1,0,1,1,132,131,150,150,26
"2250",49,"[31]wnHrxoIoHcovHnJHGqKCJpwCsGxmdrl",285,0.996503,31,286,1,285,1,1,0,1,1,144,143,142,142,26
"2251",50,"[31]wnHrxoIoHcovHnJHGqKCJpwCsGxmdrl",281,0.996454,31,282,1,281,1,1,0,1,1,146,145,136,136,26
"2252",51,"[31]wnHrxoIoHcovHnJHGqKCJpwCsGxmdrl",284,0.996491,31,285,1,284,1,1,0,1,1,157,156,128,128,26
"2253",52,"[31]wnHrxoIoHcovHnJHGqKCJpwCsGxmdrl",283,0.996479,31,284,1,283,1,1,0,1,1,142,141,142,142,26
"2254",53,"[31]wnHrxoIoHcovHnJHGqKCJpwCsGxmdrl",273,0.99635,31,274,1,273,1,1,0,1,1,138,137,136,136,26
"2255",54,"[31]wnHrxoIoHcovHnJHGqKCJpwCsGxmdrl",277,0.996403,31,278,1,277,1,1,0,1,1,152,151,126,126,26
"2256",55,"[31]wnHrxoIoHcovHnJHGqKCJpwCsGxmdrl",286,0.996516,31,287,1,286,1,1,0,1,1,153,152,134,134,26
"2257",56,"[31]wnHrxoIoHcovHnJHGqKCJpwCsGxmdrl",282,0.996466,31,283,1,282,1,1,0,1,1,146,145,137,137,26
"2258",57,"[31]wnHrxoIoHcovHnJHGqKCJpwCsGxmdrl",284,0.996491,31,285,1,284,1,1,0,1,1,147,146,138,138,26
"2259",58,"[31]wnHrxoIoHcovHnJHGqKCJpwCsGxmdrl",272,0.996337,31,273,1,272,1,1,0,1,1,144,143,129,129,26
"2260",59,"[31]wnHrxoIoHcovHnJHGqKCJpwCsGxmdrl",275,0.996377,31,276,1,275,1,1,0,1,1,136,135,140,140,26
"2261",60,"[31]wnHrxoIoHcovHnJHGqKCJpwCsGxmdrl",290,0.996564,31,291,1,290,1,1,0,1,1,150,149,141,141,26
"2262",61,"[31]wnHrxoIoHcovHnJHGqKCJpwCsGxmdrl",283,0.996479,31,284,1,283,1,1,0,1,1,133,132,151,151,26
"2263",62,"[31]wnHrxoIoHcovHnJHGqKCJpwCsGxmdrl",282,0.996466,31,283,1,282,1,1,0,1,1,137,136,146,146,26
"2264",63,"[31]wnHrxoIoHcovHnJHGqKCJpwCsGxmdrl",280,0.996441,31,281,1,280,1,1,0,1,1,146,145,135,135,26
"2265",64,"[31]wnHrxoIoHcovHnJHGqKCJpwCsGxmdrl",282,0.996466,31,283,1,282,1,1,0,1,1,133,132,150,150,26
"2266",65,"[31]wnHrxoIoHcovHnJHGqKCJpwCsGxmdrl",278,0.996416,31,279,1,278,1,1,0,1,1,127,126,152,152,26
"2267",66,"[31]wnHrxoIoHcovHnJHGqKCJpwCsGxmdrl",287,0.996528,31,288,1,287,1,1,0,1,1,157,156,131,131,26
"2268",67,"[31]wnHrxoIoHcovHnJHGqKCJpwCsGxmdrl",278,0.996416,31,279,1,278,1,1,0,1,1,140,139,139,139,26
"2269",68,"[31]wnHrxoIoHcovHnJHGqKCJpwCsGxmdrl",286,0.996516,31,287,1,286,1,1,0,1,1,148,147,139,139,26
"2270",69,"[31]wnHrxoIoHcovHnJHGqKCJpwCsGxmdrl",290,0.996564,31,291,1,290,1,1,0,1,1,153,152,138,138,26
"2271",70,"[31]wnHrxoIoHcovHnJHGqKCJpwCsGxmdrl",276,0.99639,31,277,1,276,1,1,0,1,1,133,132,144,144,26
"2272",71,"[31]wnHrxoIoHcovHnJHGqKCJpwCsGxmdrl",286,0.996516,31,287,1,286,1,1,0,1,1,154,153,133,133,26
"2273",72,"[31]wnHrxoIoHcovHnJHGqKCJpwCsGxmdrl",290,0.996564,31,291,1,290,1,1,0,1,1,137,136,154,154,26
"2274",73,"[31]wnHrxoIoHcovHnJHGqKCJpwCsGxmdrl",283,0.996479,31,284,1,283,1,1,0,1,1,145,144,139,139,26
"2275",74,"[31]wnHrxoIoHcovHnJHGqKCJpwCsGxmdrl",275,0.996377,31,276,1,275,1,1,0,1,1,135,134,141,141,26
"2276",75,"[31]wnHrxoIoHcovHnJHGqKCJpwCsGxmdrl",281,0.996454,31,282,1,281,1,1,0,1,1,147,146,135,135,26
"2277",76,"[31]wnHrxoIoHcovHnJHGqKCJpwCsGxmdrl",279,0.996429,31,280,1,279,1,1,0,1,1,141,140,139,139,26
"2278",77,"[31]wnHrxoIoHcovHnJHGqKCJpwCsGxmdrl",278,0.996416,31,279,1,278,1,1,0,1,1,142,141,137,137,26
"2279",78,"[31]wnHrxoIoHcovHnJHGqKCJpwCsGxmdrl",276,0.99639,31,277,1,276,1,1,0,1,1,127,126,150,150,26
"2280",79,"[31]wnHrxoIoHcovHnJHGqKCJpwCsGxmdrl",274,0.996364,31,275,1,274,1,1,0,1,1,118,117,157,157,26
"2281",80,"[31]wnHrxoIoHcovHnJHGqKCJpwCsGxmdrl",281,0.996454,31,282,1,281,1,1,0,1,1,152,151,130,130,26
"2282",81,"[31]wnHrxoIoHcovHnJHGqKCJpwCsGxmdrl",282,0.996466,31,283,1,282,1,1,0,1,1,147,146,136,136,26
"2283",82,"[31]wnHrxoIoHcovHnJHGqKCJpwCsGxmdrl",282,0.996466,31,283,1,282,1,1,0,1,1,139,138,144,144,26
"2284",83,"[31]wnHrxoIoHcovHnJHGqKCJpwCsGxmdrl",282,0.996466,31,283,1,282,1,1,0,1,1,146,145,137,137,26
"2285",84,"[31]wnHrxoIoHcovHnJHGqKCJpwCsGxmdrl",274,0.996364,31,275,1,274,1,1,0,1,1,154,153,121,121,26
"2286",85,"[31]wnHrxoIoHcovHnJHGqKCJpwCsGxmdrl",283,0.996479,31,284,1,283,1,1,0,1,1,140,139,144,144,26
"2287",86,"[31]wnHrxoIoHcovHnJHGqKCJpwCsGxmdrl",274,0.996364,31,275,1,274,1,1,0,1,1,123,122,152,152,26
"2288",87,"[31]wnHrxoIoHcovHnJHGqKCJpwCsGxmdrl",286,0.996516,31,287,1,286,1,1,0,1,1,158,157,129,129,26
"2289",88,"[31]wnHrxoIoHcovHnJHGqKCJpwCsGxmdrl",281,0.996454,31,282,1,281,1,1,0,1,1,141,140,141,141,26
"2290",89,"[31]wnHrxoIoHcovHnJHGqKCJpwCsGxmdrl",285,0.996503,31,286,1,285,1,1,0,1,1,147,146,139,139,26
"2291",90,"[31]wnHrxoIoHcovHnJHGqKCJpwCsGxmdrl",281,0.996454,31,282,1,281,1,1,0,1,1,158,157,124,124,26
"2292",91,"[31]wnHrxoIoHcovHnJHGqKCJpwCsGxmdrl",275,0.996377,31,276,1,275,1,1,0,1,1,143,142,133,133,26
"2293",92,"[31]wnHrxoIoHcovHnJHGqKCJpwCsGxmdrl",271,0.996324,31,272,1,271,1,1,0,1,1,119,118,153,153,26
"2294",93,"[31]wnHrxoIoHcovHnJHGqKCJpwCsGxmdrl",276,0.99639,31,277,1,276,1,1,0,1,1,140,139,137,137,26
"2295",94,"[31]wnHrxoIoHcovHnJHGqKCJpwCsGxmdrl",283,0.996479,31,284,1,283,1,1,0,1,1,151,150,133,133,26
"2296",95,"[31]wnHrxoIoHcovHnJHGqKCJpwCsGxmdrl",284,0.996491,31,285,1,284,1,1,0,1,1,139,138,146,146,26
"2297",96,"[31]wnHrxoIoHcovHnJHGqKCJpwCsGxmdrl",285,0.996503,31,286,1,285,1,1,0,1,1,134,133,152,152,26
"2298",97,"[31]wnHrxoIoHcovHnJHGqKCJpwCsGxmdrl",283,0.996479,31,284,1,283,1,1,0,1,1,140,139,144,144,26
"2299",98,"[31]wnHrxoIoHcovHnJHGqKCJpwCsGxmdrl",279,0.996429,31,280,1,279,1,1,0,1,1,132,131,148,148,26
"2300",99,"[31]wnHrxoIoHcovHnJHGqKCJpwCsGxmdrl",280,0.996441,31,281,1,280,1,1,0,1,1,134,133,147,147,26
"2301",0,"[20]ioIoHcowHnJHGqKCIBmz",283,0.996479,20,284,1,283,1,1,0,1,1,148,147,136,136,27
"2302",1,"[20]ioIoHcowHnJHGqKCIBmz",282,0.996466,20,283,1,282,1,1,0,1,1,160,159,123,123,27
"2303",2,"[20]ioIoHcowHnJHGqKCIBmz",277,0.996403,20,278,1,277,1,1,0,1,1,141,140,137,137,27
"2304",3,"[20]ioIoHcowHnJHGqKCIBmz",278,0.996416,20,279,1,278,1,1,0,1,1,131,130,148,148,27
"2305",4,"[20]ioIoHcowHnJHGqKCIBmz",273,0.99635,20,274,1,273,1,1,0,1,1,126,125,148,148,27
"2306",5,"[20]ioIoHcowHnJHGqKCIBmz",276,0.99639,20,277,1,276,1,1,0,1,1,124,123,153,153,27
"2307",6,"[20]ioIoHcowHnJHGqKCIBmz",283,0.996479,20,284,1,283,1,1,0,1,1,144,143,140,140,27
"2308",7,"[20]ioIoHcowHnJHGqKCIBmz",286,0.996516,20,287,1,286,1,1,0,1,1,154,153,133,133,27
"2309",8,"[20]ioIoHcowHnJHGqKCIBmz",284,0.996491,20,285,1,284,1,1,0,1,1,145,144,140,140,27
"2310",9,"[20]ioIoHcowHnJHGqKCIBmz",279,0.996429,20,280,1,279,1,1,0,1,1,149,148,131,131,27
"2311",10,"[20]ioIoHcowHnJHGqKCIBmz",284,0.996491,20,285,1,284,1,1,0,1,1,135,134,150,150,27
"2312",11,"[20]ioIoHcowHnJHGqKCIBmz",277,0.996403,20,278,1,277,1,1,0,1,1,141,140,137,137,27
"2313",12,"[20]ioIoHcowHnJHGqKCIBmz",289,0.996552,20,290,1,289,1,1,0,1,1,138,137,152,152,27
"2314",13,"[20]ioIoHcowHnJHGqKCIBmz",282,0.996466,20,283,1,282,1,1,0,1,1,143,142,140,140,27
"2315",14,"[20]ioIoHcowHnJHGqKCIBmz",281,0.996454,20,282,1,281,1,1,0,1,1,140,139,142,142,27
"2316",15,"[20]ioIoHcowHnJHGqKCIBmz",277,0.996403,20,278,1,277,1,1,0,1,1,127,126,151,151,27
"2317",16,"[20]ioIoHcowHnJHGqKCIBmz",281,0.996454,20,282,1,281,1,1,0,1,1,150,149,132,132,27
"2318",17,"[20]ioIoHcowHnJHGqKCIBmz",284,0.996491,20,285,1,284,1,1,0,1,1,148,147,137,137,27
"2319",18,"[20]ioIoHcowHnJHGqKCIBmz",279,0.996429,20,280,1,279,1,1,0,1,1,136,135,144,144,27
"2320",19,"[20]ioIoHcowHnJHGqKCIBmz",274,0.996364,20,275,1,274,1,1,0,1,1,134,133,141,141,27
"2321",20,"[20]ioIoHcowHnJHGqKCIBmz",279,0.996429,20,280,1,279,1,1,0,1,1,133,132,147,147,27
"2322",21,"[20]ioIoHcowHnJHGqKCIBmz",280,0.996441,20,281,1,280,1,1,0,1,1,142,141,139,139,27
"2323",22,"[20]ioIoHcowHnJHGqKCIBmz",286,0.996516,20,287,1,286,1,1,0,1,1,151,150,136,136,27
"2324",23,"[20]ioIoHcowHnJHGqKCIBmz",285,0.996503,20,286,1,285,1,1,0,1,1,141,140,145,145,27
"2325",24,"[20]ioIoHcowHnJHGqKCIBmz",283,0.996479,20,284,1,283,1,1,0,1,1,145,144,139,139,27
"2326",25,"[20]ioIoHcowHnJHGqKCIBmz",283,0.996479,20,284,1,283,1,1,0,1,1,151,150,133,133,27
"2327",26,"[20]ioIoHcowHnJHGqKCIBmz",285,0.996503,20,286,1,285,1,1,0,1,1,147,146,139,139,27
"2328",27,"[20]ioIoHcowHnJHGqKCIBmz",275,0.996377,20,276,1,275,1,1,0,1,1,120,119,156,156,27
"2329",28,"[20]ioIoHcowHnJHGqKCIBmz",282,0.996466,20,283,1,282,1,1,0,1,1,144,143,139,139,27
"2330",29,"[20]ioIoHcowHnJHGqKCIBmz",282,0.996466,20,283,1,282,1,1,0,1,1,143,142,140,140,27
"2331",30,"[20]ioIoHcowHnJHGqKCIBmz",280,0.996441,20,281,1,280,1,1,0,1,1,132,131,149,149,27
"2332",31,"[20]ioIoHcowHnJHGqKCIBmz",278,0.996416,20,279,1,278,1,1,0,1,1,143,142,136,136,27
"2333",32,"[20]ioIoHcowHnJHGqKCIBmz",286,0.996516,20,287,1,286,1,1,0,1,1,141,140,146,146,27
"2334",33,"[20]ioIoHcowHnJHGqKCIBmz",289,0.996552,20,290,1,289,1,1,0,1,1,154,153,136,136,27
"2335",34,"[20]ioIoHcowHnJHGqKCIBmz",275,0.996377,20,276,1,275,1,1,0,1,1,138,137,138,138,27
"2336",35,"[20]ioIoHcowHnJHGqKCIBmz",270,0.99631,20,271,1,270,1,1,0,1,1,128,127,143,143,27
"2337",36,"[20]ioIoHcowHnJHGqKCIBmz",276,0.99639,20,277,1,276,1,1,0,1,1,144,143,133,133,27
"2338",37,"[20]ioIoHcowHnJHGqKCIBmz",282,0.996466,20,283,1,282,1,1,0,1,1,143,142,140,140,27
"2339",38,"[20]ioIoHcowHnJHGqKCIBmz",288,0.99654,20,289,1,288,1,1,0,1,1,158,157,131,131,27
"2340",39,"[20]ioIoHcowHnJHGqKCIBmz",269,0.996296,20,270,1,269,1,1,0,1,1,143,142,127,127,27
"2341",40,"[20]ioIoHcowHnJHGqKCIBmz",289,0.996552,20,290,1,289,1,1,0,1,1,151,150,139,139,27
"2342",41,"[20]ioIoHcowHnJHGqKCIBmz",283,0.996479,20,284,1,283,1,1,0,1,1,155,154,129,129,27
"2343",42,"[20]ioIoHcowHnJHGqKCIBmz",281,0.996454,20,282,1,281,1,1,0,1,1,132,131,150,150,27
"2344",43,"[20]ioIoHcowHnJHGqKCIBmz",284,0.996491,20,285,1,284,1,1,0,1,1,147,146,138,138,27
"2345",44,"[20]ioIoHcowHnJHGqKCIBmz",278,0.996416,20,279,1,278,1,1,0,1,1,131,130,148,148,27
"2346",45,"[20]ioIoHcowHnJHGqKCIBmz",280,0.996441,20,281,1,280,1,1,0,1,1,141,140,140,140,27
"2347",46,"[20]ioIoHcowHnJHGqKCIBmz",277,0.996403,20,278,1,277,1,1,0,1,1,154,153,124,124,27
"2348",47,"[20]ioIoHcowHnJHGqKCIBmz",290,0.996564,20,291,1,290,1,1,0,1,1,157,156,134,134,27
"2349",48,"[20]ioIoHcowHnJHGqKCIBmz",279,0.996429,20,280,1,279,1,1,0,1,1,146,145,134,134,27
"2350",49,"[20]ioIoHcowHnJHGqKCIBmz",285,0.996503,20,286,1,285,1,1,0,1,1,146,145,140,140,27
"2351",50,"[20]ioIoHcowHnJHGqKCIBmz",283,0.996479,20,284,1,283,1,1,0,1,1,143,142,141,141,27
"2352",51,"[20]ioIoHcowHnJHGqKCIBmz",283,0.996479,20,284,1,283,1,1,0,1,1,150,149,134,134,27
"2353",52,"[20]ioIoHcowHnJHGqKCIBmz",288,0.99654,20,289,1,288,1,1,0,1,1,154,153,135,135,27
"2354",53,"[20]ioIoHcowHnJHGqKCIBmz",275,0.996377,20,276,1,275,1,1,0,1,1,132,131,144,144,27
"2355",54,"[20]ioIoHcowHnJHGqKCIBmz",279,0.996429,20,280,1,279,1,1,0,1,1,130,129,150,150,27
"2356",55,"[20]ioIoHcowHnJHGqKCIBmz",283,0.996479,20,284,1,283,1,1,0,1,1,149,148,135,135,27
"2357",56,"[20]ioIoHcowHnJHGqKCIBmz",281,0.996454,20,282,1,281,1,1,0,1,1,154,153,128,128,27
"2358",57,"[20]ioIoHcowHnJHGqKCIBmz",284,0.996491,20,285,1,284,1,1,0,1,1,140,139,145,145,27
"2359",58,"[20]ioIoHcowHnJHGqKCIBmz",279,0.996429,20,280,1,279,1,1,0,1,1,144,143,136,136,27
"2360",59,"[20]ioIoHcowHnJHGqKCIBmz",282,0.996466,20,283,1,282,1,1,0,1,1,140,139,143,143,27
"2361",60,"[20]ioIoHcowHnJHGqKCIBmz",279,0.996429,20,280,1,279,1,1,0,1,1,134,133,146,146,27
"2362",61,"[20]ioIoHcowHnJHGqKCIBmz",281,0.996454,20,282,1,281,1,1,0,1,1,138,137,144,144,27
"2363",62,"[20]ioIoHcowHnJHGqKCIBmz",281,0.996454,20,282,1,281,1,1,0,1,1,134,133,148,148,27
"2364",63,"[20]ioIoHcowHnJHGqKCIBmz",274,0.996364,20,275,1,274,1,1,0,1,1,134,133,141,141,27
"2365",64,"[20]ioIoHcowHnJHGqKCIBmz",290,0.996564,20,291,1,290,1,1,0,1,1,150,149,141,141,27
"2366",65,"[20]ioIoHcowHnJHGqKCIBmz",282,0.996466,20,283,1,282,1,1,0,1,1,143,142,140,140,27
"2367",66,"[20]ioIoHcowHnJHGqKCIBmz",288,0.99654,20,289,1,288,1,1,0,1,1,151,150,138,138,27
"2368",67,"[20]ioIoHcowHnJHGqKCIBmz",285,0.996503,20,286,1,285,1,1,0,1,1,135,134,151,151,27
"2369",68,"[20]ioIoHcowHnJHGqKCIBmz",279,0.996429,20,280,1,279,1,1,0,1,1,126,125,154,154,27
"2370",69,"[20]ioIoHcowHnJHGqKCIBmz",284,0.996491,20,285,1,284,1,1,0,1,1,158,157,127,127,27
"2371",70,"[20]ioIoHcowHnJHGqKCIBmz",282,0.996466,20,283,1,282,1,1,0,1,1,139,138,144,144,27
"2372",71,"[20]ioIoHcowHnJHGqKCIBmz",274,0.996364,20,275,1,274,1,1,0,1,1,126,125,149,149,27
"2373",72,"[20]ioIoHcowHnJHGqKCIBmz",279,0.996429,20,280,1,279,1,1,0,1,1,144,143,136,136,27
"2374",73,"[20]ioIoHcowHnJHGqKCIBmz",290,0.996564,20,291,1,290,1,1,0,1,1,158,157,133,133,27
"2375",74,"[20]ioIoHcowHnJHGqKCIBmz",289,0.996552,20,290,1,289,1,1,0,1,1,143,142,147,147,27
"2376",75,"[20]ioIoHcowHnJHGqKCIBmz",283,0.996479,20,284,1,283,1,1,0,1,1,139,138,145,145,27
"2377",76,"[20]ioIoHcowHnJHGqKCIBmz",282,0.996466,20,283,1,282,1,1,0,1,1,145,144,138,138,27
"2378",77,"[20]ioIoHcowHnJHGqKCIBmz",277,0.996403,20,278,1,277,1,1,0,1,1,149,148,129,129,27
"2379",78,"[20]ioIoHcowHnJHGqKCIBmz",282,0.996466,20,283,1,282,1,1,0,1,1,136,135,147,147,27
"2380",79,"[20]ioIoHcowHnJHGqKCIBmz",282,0.996466,20,283,1,282,1,1,0,1,1,142,141,141,141,27
"2381",80,"[20]ioIoHcowHnJHGqKCIBmz",275,0.996377,20,276,1,275,1,1,0,1,1,134,133,142,142,27
"2382",81,"[20]ioIoHcowHnJHGqKCIBmz",288,0.99654,20,289,1,288,1,1,0,1,1,144,143,145,145,27
"2383",82,"[20]ioIoHcowHnJHGqKCIBmz",276,0.99639,20,277,1,276,1,1,0,1,1,118,117,159,159,27
"2384",83,"[20]ioIoHcowHnJHGqKCIBmz",278,0.996416,20,279,1,278,1,1,0,1,1,133,132,146,146,27
"2385",84,"[20]ioIoHcowHnJHGqKCIBmz",289,0.996552,20,290,1,289,1,1,0,1,1,157,156,133,133,27
"2386",85,"[20]ioIoHcowHnJHGqKCIBmz",284,0.996491,20,285,1,284,1,1,0,1,1,152,151,133,133,27
"2387",86,"[20]ioIoHcowHnJHGqKCIBmz",275,0.996377,20,276,1,275,1,1,0,1,1,121,120,155,155,27
"2388",87,"[20]ioIoHcowHnJHGqKCIBmz",282,0.996466,20,283,1,282,1,1,0,1,1,127,126,156,156,27
"2389",88,"[20]ioIoHcowHnJHGqKCIBmz",277,0.996403,20,278,1,277,1,1,0,1,1,135,134,143,143,27
"2390",89,"[20]ioIoHcowHnJHGqKCIBmz",284,0.996491,20,285,1,284,1,1,0,1,1,130,129,155,155,27
"2391",90,"[20]ioIoHcowHnJHGqKCIBmz",277,0.996403,20,278,1,277,1,1,0,1,1,140,139,138,138,27
"2392",91,"[20]ioIoHcowHnJHGqKCIBmz",278,0.996416,20,279,1,278,1,1,0,1,1,139,138,140,140,27
"2393",92,"[20]ioIoHcowHnJHGqKCIBmz",278,0.996416,20,279,1,278,1,1,0,1,1,138,137,141,141,27
"2394",93,"[20]ioIoHcowHnJHGqKCIBmz",280,0.996441,20,281,1,280,1,1,0,1,1,132,131,149,149,27
"2395",94,"[20]ioIoHcowHnJHGqKCIBmz",284,0.996491,20,285,1,284,1,1,0,1,1,137,136,148,148,27
"2396",95,"[20]ioIoHcowHnJHGqKCIBmz",287,0.996528,20,288,1,287,1,1,0,1,1,150,149,138,138,27
"2397",96,"[20]ioIoHcowHnJHGqKCIBmz",282,0.996466,20,283,1,282,1,1,0,1,1,147,146,136,136,27
"2398",97,"[20]ioIoHcowHnJHGqKCIBmz",280,0.996441,20,281,1,280,1,1,0,1,1,151,150,130,130,27
"2399",98,"[20]ioIoHcowHnJHGqKCIBmz",274,0.996364,20,275,1,274,1,1,0,1,1,139,138,136,136,27
"2400",99,"[20]ioIoHcowHnJHGqKCIBmz",277,0.996403,20,278,1,277,1,1,0,1,1,143,142,135,135,27
"2401",0,"[21]hHoIoHcowHnJqGKCtpdFK",300,0.996678,21,301,1,300,1,1,0,1,1,160,159,141,141,28
"2402",1,"[21]hHoIoHcowHnJqGKCtpdFK",305,0.996732,21,306,1,305,1,1,0,1,1,163,162,143,143,28
"2403",2,"[21]hHoIoHcowHnJqGKCtpdFK",295,0.996622,21,296,1,295,1,1,0,1,1,148,147,148,148,28
"2404",3,"[21]hHoIoHcowHnJqGKCtpdFK",294,0.99661,21,295,1,294,1,1,0,1,1,139,138,156,156,28
"2405",4,"[21]hHoIoHcowHnJqGKCtpdFK",293,0.996599,21,294,1,293,1,1,0,1,1,149,148,145,145,28
"2406",5,"[21]hHoIoHcowHnJqGKCtpdFK",302,0.9967,21,303,1,302,1,1,0,1,1,164,163,139,139,28
"2407",6,"[21]hHoIoHcowHnJqGKCtpdFK",300,0.996678,21,301,1,300,1,1,0,1,1,153,152,148,148,28
"2408",7,"[21]hHoIoHcowHnJqGKCtpdFK",298,0.996656,21,299,1,298,1,1,0,1,1,155,154,144,144,28
"2409",8,"[21]hHoIoHcowHnJqGKCtpdFK",298,0.996656,21,299,1,298,1,1,0,1,1,142,141,157,157,28
"2410",9,"[21]hHoIoHcowHnJqGKCtpdFK",292,0.996587,21,293,1,292,1,1,0,1,1,139,138,154,154,28
"2411",10,"[21]hHoIoHcowHnJqGKCtpdFK",293,0.996599,21,294,1,293,1,1,0,1,1,146,145,148,148,28
"2412",11,"[21]hHoIoHcowHnJqGKCtpdFK",299,0.996667,21,300,1,299,1,1,0,1,1,152,151,148,148,28
"2413",12,"[21]hHoIoHcowHnJqGKCtpdFK",292,0.996587,21,293,1,292,1,1,0,1,1,142,141,151,151,28
"2414",13,"[21]hHoIoHcowHnJqGKCtpdFK",300,0.996678,21,301,1,300,1,1,0,1,1,157,156,144,144,28
"2415",14,"[21]hHoIoHcowHnJqGKCtpdFK",298,0.996656,21,299,1,298,1,1,0,1,1,151,150,148,148,28
"2416",15,"[21]hHoIoHcowHnJqGKCtpdFK",295,0.996622,21,296,1,295,1,1,0,1,1,152,151,144,144,28
"2417",16,"[21]hHoIoHcowHnJqGKCtpdFK",290,0.996564,21,291,1,290,1,1,0,1,1,131,130,160,160,28
"2418",17,"[21]hHoIoHcowHnJqGKCtpdFK",291,0.996575,21,292,1,291,1,1,0,1,1,137,136,155,155,28
"2419",18,"[21]hHoIoHcowHnJqGKCtpdFK",302,0.9967,21,303,1,302,1,1,0,1,1,157,156,146,146,28
"2420",19,"[21]hHoIoHcowHnJqGKCtpdFK",297,0.996644,21,298,1,297,1,1,0,1,1,157,156,141,141,28
"2421",20,"[21]hHoIoHcowHnJqGKCtpdFK",299,0.996667,21,300,1,299,1,1,0,1,1,149,148,151,151,28
"2422",21,"[21]hHoIoHcowHnJqGKCtpdFK",297,0.996644,21,298,1,297,1,1,0,1,1,151,150,147,147,28
"2423",22,"[21]hHoIoHcowHnJqGKCtpdFK",308,0.996764,21,309,1,308,1,1,0,1,1,182,181,127,127,28
"2424",23,"[21]hHoIoHcowHnJqGKCtpdFK",294,0.99661,21,295,1,294,1,1,0,1,1,146,145,149,149,28
"2425",24,"[21]hHoIoHcowHnJqGKCtpdFK",301,0.996689,21,302,1,301,1,1,0,1,1,167,166,135,135,28
"2426",25,"[21]hHoIoHcowHnJqGKCtpdFK",296,0.996633,21,297,1,296,1,1,0,1,1,148,147,149,149,28
"2427",26,"[21]hHoIoHcowHnJqGKCtpdFK",292,0.996587,21,293,1,292,1,1,0,1,1,136,135,157,157,28
"2428",27,"[21]hHoIoHcowHnJqGKCtpdFK",293,0.996599,21,294,1,293,1,1,0,1,1,140,139,154,154,28
"2429",28,"[21]hHoIoHcowHnJqGKCtpdFK",290,0.996564,21,291,1,290,1,1,0,1,1,131,130,160,160,28
"2430",29,"[21]hHoIoHcowHnJqGKCtpdFK",292,0.996587,21,293,1,292,1,1,0,1,1,139,138,154,154,28
"2431",30,"[21]hHoIoHcowHnJqGKCtpdFK",290,0.996564,21,291,1,290,1,1,0,1,1,144,143,147,147,28
"2432",31,"[21]hHoIoHcowHnJqGKCtpdFK",288,0.99654,21,289,1,288,1,1,0,1,1,125,124,164,164,28
"2433",32,"[21]hHoIoHcowHnJqGKCtpdFK",297,0.996644,21,298,1,297,1,1,0,1,1,151,150,147,147,28
"2434",33,"[21]hHoIoHcowHnJqGKCtpdFK",295,0.996622,21,296,1,295,1,1,0,1,1,145,144,151,151,28
"2435",34,"[21]hHoIoHcowHnJqGKCtpdFK",301,0.996689,21,302,1,301,1,1,0,1,1,161,160,141,141,28
"2436",35,"[21]hHoIoHcowHnJqGKCtpdFK",294,0.99661,21,295,1,294,1,1,0,1,1,139,138,156,156,28
"2437",36,"[21]hHoIoHcowHnJqGKCtpdFK",298,0.996656,21,299,1,298,1,1,0,1,1,156,155,143,143,28
"2438",37,"[21]hHoIoHcowHnJqGKCtpdFK",296,0.996633,21,297,1,296,1,1,0,1,1,156,155,141,141,28
"2439",38,"[21]hHoIoHcowHnJqGKCtpdFK",295,0.996622,21,296,1,295,1,1,0,1,1,147,146,149,149,28
"2440",39,"[21]hHoIoHcowHnJqGKCtpdFK",291,0.996575,21,292,1,291,1,1,0,1,1,133,132,159,159,28
"2441",40,"[21]hHoIoHcowHnJqGKCtpdFK",289,0.996552,21,290,1,289,1,1,0,1,1,131,130,159,159,28
"2442",41,"[21]hHoIoHcowHnJqGKCtpdFK",292,0.996587,21,293,1,292,1,1,0,1,1,142,141,151,151,28
"2443",42,"[21]hHoIoHcowHnJqGKCtpdFK",297,0.996644,21,298,1,297,1,1,0,1,1,151,150,147,147,28
"2444",43,"[21]hHoIoHcowHnJqGKCtpdFK",294,0.99661,21,295,1,294,1,1,0,1,1,138,137,157,157,28
"2445",44,"[21]hHoIoHcowHnJqGKCtpdFK",291,0.996575,21,292,1,291,1,1,0,1,1,136,135,156,156,28
"2446",45,"[21]hHoIoHcowHnJqGKCtpdFK",296,0.996633,21,297,1,296,1,1,0,1,1,151,150,146,146,28
"2447",46,"[21]hHoIoHcowHnJqGKCtpdFK",294,0.99661,21,295,1,294,1,1,0,1,1,142,141,153,153,28
"2448",47,"[21]hHoIoHcowHnJqGKCtpdFK",293,0.996599,21,294,1,293,1,1,0,1,1,145,144,149,149,28
"2449",48,"[21]hHoIoHcowHnJqGKCtpdFK",291,0.996575,21,292,1,291,1,1,0,1,1,132,131,160,160,28
"2450",49,"[21]hHoIoHcowHnJqGKCtpdFK",299,0.996667,21,300,1,299,1,1,0,1,1,160,159,140,140,28
"2451",50,"[21]hHoIoHcowHnJqGKCtpdFK",294,0.99661,21,295,1,294,1,1,0,1,1,143,142,152,152,28
"2452",51,"[21]hHoIoHcowHnJqGKCtpdFK",294,0.99661,21,295,1,294,1,1,0,1,1,146,145,149,149,28
"2453",52,"[21]hHoIoHcowHnJqGKCtpdFK",296,0.996633,21,297,1,296,1,1,0,1,1,149,148,148,148,28
"2454",53,"[21]hHoIoHcowHnJqGKCtpdFK",298,0.996656,21,299,1,298,1,1,0,1,1,154,153,145,145,28
"2455",54,"[21]hHoIoHcowHnJqGKCtpdFK",298,0.996656,21,299,1,298,1,1,0,1,1,147,146,152,152,28
"2456",55,"[21]hHoIoHcowHnJqGKCtpdFK",297,0.996644,21,298,1,297,1,1,0,1,1,146,145,152,152,28
"2457",56,"[21]hHoIoHcowHnJqGKCtpdFK",303,0.996711,21,304,1,303,1,1,0,1,1,167,166,137,137,28
"2458",57,"[21]hHoIoHcowHnJqGKCtpdFK",295,0.996622,21,296,1,295,1,1,0,1,1,144,143,152,152,28
"2459",58,"[21]hHoIoHcowHnJqGKCtpdFK",298,0.996656,21,299,1,298,1,1,0,1,1,156,155,143,143,28
"2460",59,"[21]hHoIoHcowHnJqGKCtpdFK",294,0.99661,21,295,1,294,1,1,0,1,1,142,141,153,153,28
"2461",60,"[21]hHoIoHcowHnJqGKCtpdFK",303,0.996711,21,304,1,303,1,1,0,1,1,159,158,145,145,28
"2462",61,"[21]hHoIoHcowHnJqGKCtpdFK",287,0.996528,21,288,1,287,1,1,0,1,1,121,120,167,167,28
"2463",62,"[21]hHoIoHcowHnJqGKCtpdFK",300,0.996678,21,301,1,300,1,1,0,1,1,161,160,140,140,28
"2464",63,"[21]hHoIoHcowHnJqGKCtpdFK",300,0.996678,21,301,1,300,1,1,0,1,1,152,151,149,149,28
"2465",64,"[21]hHoIoHcowHnJqGKCtpdFK",296,0.996633,21,297,1,296,1,1,0,1,1,137,136,160,160,28
"2466",65,"[21]hHoIoHcowHnJqGKCtpdFK",299,0.996667,21,300,1,299,1,1,0,1,1,159,158,141,141,28
"2467",66,"[21]hHoIoHcowHnJqGKCtpdFK",304,0.996721,21,305,1,304,1,1,0,1,1,172,171,133,133,28
"2468",67,"[21]hHoIoHcowHnJqGKCtpdFK",291,0.996575,21,292,1,291,1,1,0,1,1,139,138,153,153,28
"2469",68,"[21]hHoIoHcowHnJqGKCtpdFK",297,0.996644,21,298,1,297,1,1,0,1,1,154,153,144,144,28
"2470",69,"[21]hHoIoHcowHnJqGKCtpdFK",294,0.99661,21,295,1,294,1,1,0,1,1,141,140,154,154,28
"2471",70,"[21]hHoIoHcowHnJqGKCtpdFK",298,0.996656,21,299,1,298,1,1,0,1,1,158,157,141,141,28
"2472",71,"[21]hHoIoHcowHnJqGKCtpdFK",298,0.996656,21,299,1,298,1,1,0,1,1,152,151,147,147,28
"2473",72,"[21]hHoIoHcowHnJqGKCtpdFK",299,0.996667,21,300,1,299,1,1,0,1,1,156,155,144,144,28
"2474",73,"[21]hHoIoHcowHnJqGKCtpdFK",300,0.996678,21,301,1,300,1,1,0,1,1,164,163,137,137,28
"2475",74,"[21]hHoIoHcowHnJqGKCtpdFK",294,0.99661,21,295,1,294,1,1,0,1,1,145,144,150,150,28
"2476",75,"[21]hHoIoHcowHnJqGKCtpdFK",294,0.99661,21,295,1,294,1,1,0,1,1,147,146,148,148,28
"2477",76,"[21]hHoIoHcowHnJqGKCtpdFK",297,0.996644,21,298,1,297,1,1,0,1,1,154,153,144,144,28
"2478",77,"[21]hHoIoHcowHnJqGKCtpdFK",298,0.996656,21,299,1,298,1,1,0,1,1,155,154,144,144,28
"2479",78,"[21]hHoIoHcowHnJqGKCtpdFK",296,0.996633,21,297,1,296,1,1,0,1,1,148,147,149,149,28
"2480",79,"[21]hHoIoHcowHnJqGKCtpdFK",304,0.996721,21,305,1,304,1,1,0,1,1,176,175,129,129,28
"2481",80,"[21]hHoIoHcowHnJqGKCtpdFK",291,0.996575,21,292,1,291,1,1,0,1,1,133,132,159,159,28
"2482",81,"[21]hHoIoHcowHnJqGKCtpdFK",295,0.996622,21,296,1,295,1,1,0,1,1,136,135,160,160,28
"2483",82,"[21]hHoIoHcowHnJqGKCtpdFK",290,0.996564,21,291,1,290,1,1,0,1,1,134,133,157,157,28
"2484",83,"[21]hHoIoHcowHnJqGKCtpdFK",296,0.996633,21,297,1,296,1,1,0,1,1,149,148,148,148,28
"2485",84,"[21]hHoIoHcowHnJqGKCtpdFK",300,0.996678,21,301,1,300,1,1,0,1,1,170,169,131,131,28
"2486",85,"[21]hHoIoHcowHnJqGKCtpdFK",296,0.996633,21,297,1,296,1,1,0,1,1,154,153,143,143,28
"2487",86,"[21]hHoIoHcowHnJqGKCtpdFK",295,0.996622,21,296,1,295,1,1,0,1,1,151,150,145,145,28
"2488",87,"[21]hHoIoHcowHnJqGKCtpdFK",302,0.9967,21,303,1,302,1,1,0,1,1,161,160,142,142,28
"2489",88,"[21]hHoIoHcowHnJqGKCtpdFK",298,0.996656,21,299,1,298,1,1,0,1,1,158,157,141,141,28
"2490",89,"[21]hHoIoHcowHnJqGKCtpdFK",294,0.99661,21,295,1,294,1,1,0,1,1,148,147,147,147,28
"2491",90,"[21]hHoIoHcowHnJqGKCtpdFK",298,0.996656,21,299,1,298,1,1,0,1,1,154,153,145,145,28
"2492",91,"[21]hHoIoHcowHnJqGKCtpdFK",298,0.996656,21,299,1,298,1,1,0,1,1,148,147,151,151,28
"2493",92,"[21]hHoIoHcowHnJqGKCtpdFK",294,0.99661,21,295,1,294,1,1,0,1,1,143,142,152,152,28
"2494",93,"[21]hHoIoHcowHnJqGKCtpdFK",294,0.99661,21,295,1,294,1,1,0,1,1,146,145,149,149,28
"2495",94,"[21]hHoIoHcowHnJqGKCtpdFK",296,0.996633,21,297,1,296,1,1,0,1,1,152,151,145,145,28
"2496",95,"[21]hHoIoHcowHnJqGKCtpdFK",299,0.996667,21,300,1,299,1,1,0,1,1,154,153,146,146,28
"2497",96,"[21]hHoIoHcowHnJqGKCtpdFK",298,0.996656,21,299,1,298,1,1,0,1,1,153,152,146,146,28
"2498",97,"[21]hHoIoHcowHnJqGKCtpdFK",299,0.996667,21,300,1,299,1,1,0,1,1,155,154,145,145,28
"2499",98,"[21]hHoIoHcowHnJqGKCtpdFK",298,0.996656,21,299,1,298,1,1,0,1,1,152,151,147,147,28
"2500",99,"[21]hHoIoHcowHnJqGKCtpdFK",294,0.99661,21,295,1,294,1,1,0,1,1,142,141,153,153,28
"2501",0,"[20]oHoIoHcovHnJHGqKCIHB",281,0.996454,20,282,1,281,1,1,0,1,1,139,138,143,143,29
"2502",1,"[20]oHoIoHcovHnJHGqKCIHB",278,0.996416,20,279,1,278,1,1,0,1,1,133,132,146,146,29
"2503",2,"[20]oHoIoHcovHnJHGqKCIHB",284,0.996491,20,285,1,284,1,1,0,1,1,147,146,138,138,29
"2504",3,"[20]oHoIoHcovHnJHGqKCIHB",279,0.996429,20,280,1,279,1,1,0,1,1,150,149,130,130,29
"2505",4,"[20]oHoIoHcovHnJHGqKCIHB",284,0.996491,20,285,1,284,1,1,0,1,1,136,135,149,149,29
"2506",5,"[20]oHoIoHcovHnJHGqKCIHB",274,0.996364,20,275,1,274,1,1,0,1,1,137,136,138,138,29
"2507",6,"[20]oHoIoHcovHnJHGqKCIHB",280,0.996441,20,281,1,280,1,1,0,1,1,159,158,122,122,29
"2508",7,"[20]oHoIoHcovHnJHGqKCIHB",277,0.996403,20,278,1,277,1,1,0,1,1,140,139,138,138,29
"2509",8,"[20]oHoIoHcovHnJHGqKCIHB",291,0.996575,20,292,1,291,1,1,0,1,1,147,146,145,145,29
"2510",9,"[20]oHoIoHcovHnJHGqKCIHB",282,0.996466,20,283,1,282,1,1,0,1,1,145,144,138,138,29
"2511",10,"[20]oHoIoHcovHnJHGqKCIHB",279,0.996429,20,280,1,279,1,1,0,1,1,140,139,140,140,29
"2512",11,"[20]oHoIoHcovHnJHGqKCIHB",277,0.996403,20,278,1,277,1,1,0,1,1,143,142,135,135,29
"2513",12,"[20]oHoIoHcovHnJHGqKCIHB",285,0.996503,20,286,1,285,1,1,0,1,1,152,151,134,134,29
"2514",13,"[20]oHoIoHcovHnJHGqKCIHB",276,0.99639,20,277,1,276,1,1,0,1,1,135,134,142,142,29
"2515",14,"[20]oHoIoHcovHnJHGqKCIHB",279,0.996429,20,280,1,279,1,1,0,1,1,140,139,140,140,29
"2516",15,"[20]oHoIoHcovHnJHGqKCIHB",274,0.996364,20,275,1,274,1,1,0,1,1,142,141,133,133,29
"2517",16,"[20]oHoIoHcovHnJHGqKCIHB",276,0.99639,20,277,1,276,1,1,0,1,1,141,140,136,136,29
"2518",17,"[20]oHoIoHcovHnJHGqKCIHB",281,0.996454,20,282,1,281,1,1,0,1,1,155,154,127,127,29
"2519",18,"[20]oHoIoHcovHnJHGqKCIHB",282,0.996466,20,283,1,282,1,1,0,1,1,148,147,135,135,29
"2520",19,"[20]oHoIoHcovHnJHGqKCIHB",282,0.996466,20,283,1,282,1,1,0,1,1,137,136,146,146,29
"2521",20,"[20]oHoIoHcovHnJHGqKCIHB",276,0.99639,20,277,1,276,1,1,0,1,1,141,140,136,136,29
"2522",21,"[20]oHoIoHcovHnJHGqKCIHB",291,0.996575,20,292,1,291,1,1,0,1,1,157,156,135,135,29
"2523",22,"[20]oHoIoHcovHnJHGqKCIHB",279,0.996429,20,280,1,279,1,1,0,1,1,126,125,154,154,29
"2524",23,"[20]oHoIoHcovHnJHGqKCIHB",287,0.996528,20,288,1,287,1,1,0,1,1,158,157,130,130,29
"2525",24,"[20]oHoIoHcovHnJHGqKCIHB",283,0.996479,20,284,1,283,1,1,0,1,1,153,152,131,131,29
"2526",25,"[20]oHoIoHcovHnJHGqKCIHB",275,0.996377,20,276,1,275,1,1,0,1,1,142,141,134,134,29
"2527",26,"[20]oHoIoHcovHnJHGqKCIHB",281,0.996454,20,282,1,281,1,1,0,1,1,137,136,145,145,29
"2528",27,"[20]oHoIoHcovHnJHGqKCIHB",278,0.996416,20,279,1,278,1,1,0,1,1,137,136,142,142,29
"2529",28,"[20]oHoIoHcovHnJHGqKCIHB",274,0.996364,20,275,1,274,1,1,0,1,1,135,134,140,140,29
"2530",29,"[20]oHoIoHcovHnJHGqKCIHB",280,0.996441,20,281,1,280,1,1,0,1,1,140,139,141,141,29
"2531",30,"[20]oHoIoHcovHnJHGqKCIHB",278,0.996416,20,279,1,278,1,1,0,1,1,129,128,150,150,29
"2532",31,"[20]oHoIoHcovHnJHGqKCIHB",289,0.996552,20,290,1,289,1,1,0,1,1,145,144,145,145,29
"2533",32,"[20]oHoIoHcovHnJHGqKCIHB",276,0.99639,20,277,1,276,1,1,0,1,1,151,150,126,126,29
"2534",33,"[20]oHoIoHcovHnJHGqKCIHB",284,0.996491,20,285,1,284,1,1,0,1,1,140,139,145,145,29
"2535",34,"[20]oHoIoHcovHnJHGqKCIHB",283,0.996479,20,284,1,283,1,1,0,1,1,139,138,145,145,29
"2536",35,"[20]oHoIoHcovHnJHGqKCIHB",284,0.996491,20,285,1,284,1,1,0,1,1,149,148,136,136,29
"2537",36,"[20]oHoIoHcovHnJHGqKCIHB",284,0.996491,20,285,1,284,1,1,0,1,1,154,153,131,131,29
"2538",37,"[20]oHoIoHcovHnJHGqKCIHB",275,0.996377,20,276,1,275,1,1,0,1,1,131,130,145,145,29
"2539",38,"[20]oHoIoHcovHnJHGqKCIHB",278,0.996416,20,279,1,278,1,1,0,1,1,132,131,147,147,29
"2540",39,"[20]oHoIoHcovHnJHGqKCIHB",276,0.99639,20,277,1,276,1,1,0,1,1,145,144,132,132,29
"2541",40,"[20]oHoIoHcovHnJHGqKCIHB",282,0.996466,20,283,1,282,1,1,0,1,1,143,142,140,140,29
"2542",41,"[20]oHoIoHcovHnJHGqKCIHB",289,0.996552,20,290,1,289,1,1,0,1,1,145,144,145,145,29
"2543",42,"[20]oHoIoHcovHnJHGqKCIHB",284,0.996491,20,285,1,284,1,1,0,1,1,156,155,129,129,29
"2544",43,"[20]oHoIoHcovHnJHGqKCIHB",280,0.996441,20,281,1,280,1,1,0,1,1,130,129,151,151,29
"2545",44,"[20]oHoIoHcovHnJHGqKCIHB",284,0.996491,20,285,1,284,1,1,0,1,1,153,152,132,132,29
"2546",45,"[20]oHoIoHcovHnJHGqKCIHB",282,0.996466,20,283,1,282,1,1,0,1,1,141,140,142,142,29
"2547",46,"[20]oHoIoHcovHnJHGqKCIHB",279,0.996429,20,280,1,279,1,1,0,1,1,142,141,138,138,29
"2548",47,"[20]oHoIoHcovHnJHGqKCIHB",280,0.996441,20,281,1,280,1,1,0,1,1,136,135,145,145,29
"2549",48,"[20]oHoIoHcovHnJHGqKCIHB",274,0.996364,20,275,1,274,1,1,0,1,1,132,131,143,143,29
"2550",49,"[20]oHoIoHcovHnJHGqKCIHB",283,0.996479,20,284,1,283,1,1,0,1,1,145,144,139,139,29
"2551",50,"[20]oHoIoHcovHnJHGqKCIHB",282,0.996466,20,283,1,282,1,1,0,1,1,140,139,143,143,29
"2552",51,"[20]oHoIoHcovHnJHGqKCIHB",273,0.99635,20,274,1,273,1,1,0,1,1,121,120,153,153,29
"2553",52,"[20]oHoIoHcovHnJHGqKCIHB",277,0.996403,20,278,1,277,1,1,0,1,1,147,146,131,131,29
"2554",53,"[20]oHoIoHcovHnJHGqKCIHB",284,0.996491,20,285,1,284,1,1,0,1,1,150,149,135,135,29
"2555",54,"[20]oHoIoHcovHnJHGqKCIHB",287,0.996528,20,288,1,287,1,1,0,1,1,151,150,137,137,29
"2556",55,"[20]oHoIoHcovHnJHGqKCIHB",285,0.996503,20,286,1,285,1,1,0,1,1,135,134,151,151,29
"2557",56,"[20]oHoIoHcovHnJHGqKCIHB",276,0.99639,20,277,1,276,1,1,0,1,1,123,122,154,154,29
"2558",57,"[20]oHoIoHcovHnJHGqKCIHB",284,0.996491,20,285,1,284,1,1,0,1,1,147,146,138,138,29
"2559",58,"[20]oHoIoHcovHnJHGqKCIHB",278,0.996416,20,279,1,278,1,1,0,1,1,134,133,145,145,29
"2560",59,"[20]oHoIoHcovHnJHGqKCIHB",282,0.996466,20,283,1,282,1,1,0,1,1,143,142,140,140,29
"2561",60,"[20]oHoIoHcovHnJHGqKCIHB",278,0.996416,20,279,1,278,1,1,0,1,1,150,149,129,129,29
"2562",61,"[20]oHoIoHcovHnJHGqKCIHB",282,0.996466,20,283,1,282,1,1,0,1,1,149,148,134,134,29
"2563",62,"[20]oHoIoHcovHnJHGqKCIHB",276,0.99639,20,277,1,276,1,1,0,1,1,131,130,146,146,29
"2564",63,"[20]oHoIoHcovHnJHGqKCIHB",281,0.996454,20,282,1,281,1,1,0,1,1,145,144,137,137,29
"2565",64,"[20]oHoIoHcovHnJHGqKCIHB",281,0.996454,20,282,1,281,1,1,0,1,1,136,135,146,146,29
"2566",65,"[20]oHoIoHcovHnJHGqKCIHB",284,0.996491,20,285,1,284,1,1,0,1,1,160,159,125,125,29
"2567",66,"[20]oHoIoHcovHnJHGqKCIHB",277,0.996403,20,278,1,277,1,1,0,1,1,143,142,135,135,29
"2568",67,"[20]oHoIoHcovHnJHGqKCIHB",281,0.996454,20,282,1,281,1,1,0,1,1,146,145,136,136,29
"2569",68,"[20]oHoIoHcovHnJHGqKCIHB",287,0.996528,20,288,1,287,1,1,0,1,1,143,142,145,145,29
"2570",69,"[20]oHoIoHcovHnJHGqKCIHB",283,0.996479,20,284,1,283,1,1,0,1,1,140,139,144,144,29
"2571",70,"[20]oHoIoHcovHnJHGqKCIHB",281,0.996454,20,282,1,281,1,1,0,1,1,135,134,147,147,29
"2572",71,"[20]oHoIoHcovHnJHGqKCIHB",276,0.99639,20,277,1,276,1,1,0,1,1,136,135,141,141,29
"2573",72,"[20]oHoIoHcovHnJHGqKCIHB",285,0.996503,20,286,1,285,1,1,0,1,1,133,132,153,153,29
"2574",73,"[20]oHoIoHcovHnJHGqKCIHB",278,0.996416,20,279,1,278,1,1,0,1,1,139,138,140,140,29
"2575",74,"[20]oHoIoHcovHnJHGqKCIHB",277,0.996403,20,278,1,277,1,1,0,1,1,129,128,149,149,29
"2576",75,"[20]oHoIoHcovHnJHGqKCIHB",280,0.996441,20,281,1,280,1,1,0,1,1,144,143,137,137,29
"2577",76,"[20]oHoIoHcovHnJHGqKCIHB",280,0.996441,20,281,1,280,1,1,0,1,1,134,133,147,147,29
"2578",77,"[20]oHoIoHcovHnJHGqKCIHB",273,0.99635,20,274,1,273,1,1,0,1,1,135,134,139,139,29
"2579",78,"[20]oHoIoHcovHnJHGqKCIHB",283,0.996479,20,284,1,283,1,1,0,1,1,152,151,132,132,29
"2580",79,"[20]oHoIoHcovHnJHGqKCIHB",284,0.996491,20,285,1,284,1,1,0,1,1,152,151,133,133,29
"2581",80,"[20]oHoIoHcovHnJHGqKCIHB",282,0.996466,20,283,1,282,1,1,0,1,1,146,145,137,137,29
"2582",81,"[20]oHoIoHcovHnJHGqKCIHB",281,0.996454,20,282,1,281,1,1,0,1,1,137,136,145,145,29
"2583",82,"[20]oHoIoHcovHnJHGqKCIHB",282,0.996466,20,283,1,282,1,1,0,1,1,143,142,140,140,29
"2584",83,"[20]oHoIoHcovHnJHGqKCIHB",277,0.996403,20,278,1,277,1,1,0,1,1,142,141,136,136,29
"2585",84,"[20]oHoIoHcovHnJHGqKCIHB",277,0.996403,20,278,1,277,1,1,0,1,1,136,135,142,142,29
"2586",85,"[20]oHoIoHcovHnJHGqKCIHB",285,0.996503,20,286,1,285,1,1,0,1,1,139,138,147,147,29
"2587",86,"[20]oHoIoHcovHnJHGqKCIHB",279,0.996429,20,280,1,279,1,1,0,1,1,136,135,144,144,29
"2588",87,"[20]oHoIoHcovHnJHGqKCIHB",282,0.996466,20,283,1,282,1,1,0,1,1,140,139,143,143,29
"2589",88,"[20]oHoIoHcovHnJHGqKCIHB",268,0.996283,20,269,1,268,1,1,0,1,1,132,131,137,137,29
"2590",89,"[20]oHoIoHcovHnJHGqKCIHB",278,0.996416,20,279,1,278,1,1,0,1,1,137,136,142,142,29
"2591",90,"[20]oHoIoHcovHnJHGqKCIHB",286,0.996516,20,287,1,286,1,1,0,1,1,147,146,140,140,29
"2592",91,"[20]oHoIoHcovHnJHGqKCIHB",279,0.996429,20,280,1,279,1,1,0,1,1,133,132,147,147,29
"2593",92,"[20]oHoIoHcovHnJHGqKCIHB",278,0.996416,20,279,1,278,1,1,0,1,1,132,131,147,147,29
"2594",93,"[20]oHoIoHcovHnJHGqKCIHB",281,0.996454,20,282,1,281,1,1,0,1,1,146,145,136,136,29
"2595",94,"[20]oHoIoHcovHnJHGqKCIHB",275,0.996377,20,276,1,275,1,1,0,1,1,132,131,144,144,29
"2596",95,"[20]oHoIoHcovHnJHGqKCIHB",275,0.996377,20,276,1,275,1,1,0,1,1,138,137,138,138,29
"2597",96,"[20]oHoIoHcovHnJHGqKCIHB",285,0.996503,20,286,1,285,1,1,0,1,1,147,146,139,139,29
"2598",97,"[20]oHoIoHcovHnJHGqKCIHB",289,0.996552,20,290,1,289,1,1,0,1,1,146,145,144,144,29
"2599",98,"[20]oHoIoHcovHnJHGqKCIHB",282,0.996466,20,283,1,282,1,1,0,1,1,147,146,136,136,29
"2600",99,"[20]oHoIoHcovHnJHGqKCIHB",287,0.996528,20,288,1,287,1,1,0,1,1,130,129,158,158,29
"2601",0,"[25]joIoHcoxHnJHGqKCviCjIBFzE",283,0.996479,25,284,1,283,1,1,0,1,1,148,147,136,136,30
"2602",1,"[25]joIoHcoxHnJHGqKCviCjIBFzE",286,0.996516,25,287,1,286,1,1,0,1,1,146,145,141,141,30
"2603",2,"[25]joIoHcoxHnJHGqKCviCjIBFzE",284,0.996491,25,285,1,284,1,1,0,1,1,139,138,146,146,30
"2604",3,"[25]joIoHcoxHnJHGqKCviCjIBFzE",287,0.996528,25,288,1,287,1,1,0,1,1,170,169,118,118,30
"2605",4,"[25]joIoHcoxHnJHGqKCviCjIBFzE",280,0.996441,25,281,1,280,1,1,0,1,1,154,153,127,127,30
"2606",5,"[25]joIoHcoxHnJHGqKCviCjIBFzE",279,0.996429,25,280,1,279,1,1,0,1,1,129,128,151,151,30
"2607",6,"[25]joIoHcoxHnJHGqKCviCjIBFzE",275,0.996377,25,276,1,275,1,1,0,1,1,134,133,142,142,30
"2608",7,"[25]joIoHcoxHnJHGqKCviCjIBFzE",284,0.996491,25,285,1,284,1,1,0,1,1,148,147,137,137,30
"2609",8,"[25]joIoHcoxHnJHGqKCviCjIBFzE",285,0.996503,25,286,1,285,1,1,0,1,1,151,150,135,135,30
"2610",9,"[25]joIoHcoxHnJHGqKCviCjIBFzE",281,0.996454,25,282,1,281,1,1,0,1,1,137,136,145,145,30
"2611",10,"[25]joIoHcoxHnJHGqKCviCjIBFzE",281,0.996454,25,282,1,281,1,1,0,1,1,139,138,143,143,30
"2612",11,"[25]joIoHcoxHnJHGqKCviCjIBFzE",279,0.996429,25,280,1,279,1,1,0,1,1,138,137,142,142,30
"2613",12,"[25]joIoHcoxHnJHGqKCviCjIBFzE",289,0.996552,25,290,1,289,1,1,0,1,1,165,164,125,125,30
"2614",13,"[25]joIoHcoxHnJHGqKCviCjIBFzE",287,0.996528,25,288,1,287,1,1,0,1,1,146,145,142,142,30
"2615",14,"[25]joIoHcoxHnJHGqKCviCjIBFzE",280,0.996441,25,281,1,280,1,1,0,1,1,130,129,151,151,30
"2616",15,"[25]joIoHcoxHnJHGqKCviCjIBFzE",274,0.996364,25,275,1,274,1,1,0,1,1,128,127,147,147,30
"2617",16,"[25]joIoHcoxHnJHGqKCviCjIBFzE",278,0.996416,25,279,1,278,1,1,0,1,1,137,136,142,142,30
"2618",17,"[25]joIoHcoxHnJHGqKCviCjIBFzE",279,0.996429,25,280,1,279,1,1,0,1,1,145,144,135,135,30
"2619",18,"[25]joIoHcoxHnJHGqKCviCjIBFzE",277,0.996403,25,278,1,277,1,1,0,1,1,116,115,162,162,30
"2620",19,"[25]joIoHcoxHnJHGqKCviCjIBFzE",286,0.996516,25,287,1,286,1,1,0,1,1,152,151,135,135,30
"2621",20,"[25]joIoHcoxHnJHGqKCviCjIBFzE",289,0.996552,25,290,1,289,1,1,0,1,1,160,159,130,130,30
"2622",21,"[25]joIoHcoxHnJHGqKCviCjIBFzE",279,0.996429,25,280,1,279,1,1,0,1,1,149,148,131,131,30
"2623",22,"[25]joIoHcoxHnJHGqKCviCjIBFzE",288,0.99654,25,289,1,288,1,1,0,1,1,152,151,137,137,30
"2624",23,"[25]joIoHcoxHnJHGqKCviCjIBFzE",273,0.99635,25,274,1,273,1,1,0,1,1,126,125,148,148,30
"2625",24,"[25]joIoHcoxHnJHGqKCviCjIBFzE",285,0.996503,25,286,1,285,1,1,0,1,1,138,137,148,148,30
"2626",25,"[25]joIoHcoxHnJHGqKCviCjIBFzE",296,0.996633,25,297,1,296,1,1,0,1,1,151,150,146,146,30
"2627",26,"[25]joIoHcoxHnJHGqKCviCjIBFzE",279,0.996429,25,280,1,279,1,1,0,1,1,144,143,136,136,30
"2628",27,"[25]joIoHcoxHnJHGqKCviCjIBFzE",280,0.996441,25,281,1,280,1,1,0,1,1,126,125,155,155,30
"2629",28,"[25]joIoHcoxHnJHGqKCviCjIBFzE",295,0.996622,25,296,1,295,1,1,0,1,1,162,161,134,134,30
"2630",29,"[25]joIoHcoxHnJHGqKCviCjIBFzE",291,0.996575,25,292,1,291,1,1,0,1,1,164,163,128,128,30
"2631",30,"[25]joIoHcoxHnJHGqKCviCjIBFzE",283,0.996479,25,284,1,283,1,1,0,1,1,146,145,138,138,30
"2632",31,"[25]joIoHcoxHnJHGqKCviCjIBFzE",271,0.996324,25,272,1,271,1,1,0,1,1,127,126,145,145,30
"2633",32,"[25]joIoHcoxHnJHGqKCviCjIBFzE",284,0.996491,25,285,1,284,1,1,0,1,1,154,153,131,131,30
"2634",33,"[25]joIoHcoxHnJHGqKCviCjIBFzE",280,0.996441,25,281,1,280,1,1,0,1,1,150,149,131,131,30
"2635",34,"[25]joIoHcoxHnJHGqKCviCjIBFzE",280,0.996441,25,281,1,280,1,1,0,1,1,142,141,139,139,30
"2636",35,"[25]joIoHcoxHnJHGqKCviCjIBFzE",279,0.996429,25,280,1,279,1,1,0,1,1,145,144,135,135,30
"2637",36,"[25]joIoHcoxHnJHGqKCviCjIBFzE",289,0.996552,25,290,1,289,1,1,0,1,1,159,158,131,131,30
"2638",37,"[25]joIoHcoxHnJHGqKCviCjIBFzE",275,0.996377,25,276,1,275,1,1,0,1,1,121,120,155,155,30
"2639",38,"[25]joIoHcoxHnJHGqKCviCjIBFzE",280,0.996441,25,281,1,280,1,1,0,1,1,144,143,137,137,30
"2640",39,"[25]joIoHcoxHnJHGqKCviCjIBFzE",283,0.996479,25,284,1,283,1,1,0,1,1,134,133,150,150,30
"2641",40,"[25]joIoHcoxHnJHGqKCviCjIBFzE",282,0.996466,25,283,1,282,1,1,0,1,1,147,146,136,136,30
"2642",41,"[25]joIoHcoxHnJHGqKCviCjIBFzE",274,0.996364,25,275,1,274,1,1,0,1,1,133,132,142,142,30
"2643",42,"[25]joIoHcoxHnJHGqKCviCjIBFzE",279,0.996429,25,280,1,279,1,1,0,1,1,139,138,141,141,30
"2644",43,"[25]joIoHcoxHnJHGqKCviCjIBFzE",284,0.996491,25,285,1,284,1,1,0,1,1,143,142,142,142,30
"2645",44,"[25]joIoHcoxHnJHGqKCviCjIBFzE",285,0.996503,25,286,1,285,1,1,0,1,1,152,151,134,134,30
"2646",45,"[25]joIoHcoxHnJHGqKCviCjIBFzE",284,0.996491,25,285,1,284,1,1,0,1,1,151,150,134,134,30
"2647",46,"[25]joIoHcoxHnJHGqKCviCjIBFzE",288,0.99654,25,289,1,288,1,1,0,1,1,149,148,140,140,30
"2648",47,"[25]joIoHcoxHnJHGqKCviCjIBFzE",276,0.99639,25,277,1,276,1,1,0,1,1,141,140,136,136,30
"2649",48,"[25]joIoHcoxHnJHGqKCviCjIBFzE",274,0.996364,25,275,1,274,1,1,0,1,1,151,150,124,124,30
"2650",49,"[25]joIoHcoxHnJHGqKCviCjIBFzE",284,0.996491,25,285,1,284,1,1,0,1,1,153,152,132,132,30
"2651",50,"[25]joIoHcoxHnJHGqKCviCjIBFzE",278,0.996416,25,279,1,278,1,1,0,1,1,146,145,133,133,30
"2652",51,"[25]joIoHcoxHnJHGqKCviCjIBFzE",286,0.996516,25,287,1,286,1,1,0,1,1,137,136,150,150,30
"2653",52,"[25]joIoHcoxHnJHGqKCviCjIBFzE",289,0.996552,25,290,1,289,1,1,0,1,1,146,145,144,144,30
"2654",53,"[25]joIoHcoxHnJHGqKCviCjIBFzE",290,0.996564,25,291,1,290,1,1,0,1,1,151,150,140,140,30
"2655",54,"[25]joIoHcoxHnJHGqKCviCjIBFzE",281,0.996454,25,282,1,281,1,1,0,1,1,150,149,132,132,30
"2656",55,"[25]joIoHcoxHnJHGqKCviCjIBFzE",278,0.996416,25,279,1,278,1,1,0,1,1,122,121,157,157,30
"2657",56,"[25]joIoHcoxHnJHGqKCviCjIBFzE",284,0.996491,25,285,1,284,1,1,0,1,1,144,143,141,141,30
"2658",57,"[25]joIoHcoxHnJHGqKCviCjIBFzE",285,0.996503,25,286,1,285,1,1,0,1,1,122,121,164,164,30
"2659",58,"[25]joIoHcoxHnJHGqKCviCjIBFzE",278,0.996416,25,279,1,278,1,1,0,1,1,147,146,132,132,30
"2660",59,"[25]joIoHcoxHnJHGqKCviCjIBFzE",279,0.996429,25,280,1,279,1,1,0,1,1,145,144,135,135,30
"2661",60,"[25]joIoHcoxHnJHGqKCviCjIBFzE",280,0.996441,25,281,1,280,1,1,0,1,1,137,136,144,144,30
"2662",61,"[25]joIoHcoxHnJHGqKCviCjIBFzE",275,0.996377,25,276,1,275,1,1,0,1,1,126,125,150,150,30
"2663",62,"[25]joIoHcoxHnJHGqKCviCjIBFzE",281,0.996454,25,282,1,281,1,1,0,1,1,156,155,126,126,30
"2664",63,"[25]joIoHcoxHnJHGqKCviCjIBFzE",273,0.99635,25,274,1,273,1,1,0,1,1,126,125,148,148,30
"2665",64,"[25]joIoHcoxHnJHGqKCviCjIBFzE",282,0.996466,25,283,1,282,1,1,0,1,1,141,140,142,142,30
"2666",65,"[25]joIoHcoxHnJHGqKCviCjIBFzE",280,0.996441,25,281,1,280,1,1,0,1,1,142,141,139,139,30
"2667",66,"[25]joIoHcoxHnJHGqKCviCjIBFzE",285,0.996503,25,286,1,285,1,1,0,1,1,142,141,144,144,30
"2668",67,"[25]joIoHcoxHnJHGqKCviCjIBFzE",283,0.996479,25,284,1,283,1,1,0,1,1,145,144,139,139,30
"2669",68,"[25]joIoHcoxHnJHGqKCviCjIBFzE",279,0.996429,25,280,1,279,1,1,0,1,1,127,126,153,153,30
"2670",69,"[25]joIoHcoxHnJHGqKCviCjIBFzE",283,0.996479,25,284,1,283,1,1,0,1,1,135,134,149,149,30
"2671",70,"[25]joIoHcoxHnJHGqKCviCjIBFzE",268,0.996283,25,269,1,268,1,1,0,1,1,132,131,137,137,30
"2672",71,"[25]joIoHcoxHnJHGqKCviCjIBFzE",286,0.996516,25,287,1,286,1,1,0,1,1,142,141,145,145,30
"2673",72,"[25]joIoHcoxHnJHGqKCviCjIBFzE",280,0.996441,25,281,1,280,1,1,0,1,1,137,136,144,144,30
"2674",73,"[25]joIoHcoxHnJHGqKCviCjIBFzE",278,0.996416,25,279,1,278,1,1,0,1,1,148,147,131,131,30
"2675",74,"[25]joIoHcoxHnJHGqKCviCjIBFzE",285,0.996503,25,286,1,285,1,1,0,1,1,144,143,142,142,30
"2676",75,"[25]joIoHcoxHnJHGqKCviCjIBFzE",276,0.99639,25,277,1,276,1,1,0,1,1,140,139,137,137,30
"2677",76,"[25]joIoHcoxHnJHGqKCviCjIBFzE",283,0.996479,25,284,1,283,1,1,0,1,1,141,140,143,143,30
"2678",77,"[25]joIoHcoxHnJHGqKCviCjIBFzE",288,0.99654,25,289,1,288,1,1,0,1,1,147,146,142,142,30
"2679",78,"[25]joIoHcoxHnJHGqKCviCjIBFzE",277,0.996403,25,278,1,277,1,1,0,1,1,140,139,138,138,30
"2680",79,"[25]joIoHcoxHnJHGqKCviCjIBFzE",289,0.996552,25,290,1,289,1,1,0,1,1,149,148,141,141,30
"2681",80,"[25]joIoHcoxHnJHGqKCviCjIBFzE",285,0.996503,25,286,1,285,1,1,0,1,1,147,146,139,139,30
"2682",81,"[25]joIoHcoxHnJHGqKCviCjIBFzE",278,0.996416,25,279,1,278,1,1,0,1,1,155,154,124,124,30
"2683",82,"[25]joIoHcoxHnJHGqKCviCjIBFzE",289,0.996552,25,290,1,289,1,1,0,1,1,153,152,137,137,30
"2684",83,"[25]joIoHcoxHnJHGqKCviCjIBFzE",286,0.996516,25,287,1,286,1,1,0,1,1,157,156,130,130,30
"2685",84,"[25]joIoHcoxHnJHGqKCviCjIBFzE",282,0.996466,25,283,1,282,1,1,0,1,1,153,152,130,130,30
"2686",85,"[25]joIoHcoxHnJHGqKCviCjIBFzE",281,0.996454,25,282,1,281,1,1,0,1,1,145,144,137,137,30
"2687",86,"[25]joIoHcoxHnJHGqKCviCjIBFzE",272,0.996337,25,273,1,272,1,1,0,1,1,129,128,144,144,30
"2688",87,"[25]joIoHcoxHnJHGqKCviCjIBFzE",292,0.996587,25,293,1,292,1,1,0,1,1,165,164,128,128,30
"2689",88,"[25]joIoHcoxHnJHGqKCviCjIBFzE",279,0.996429,25,280,1,279,1,1,0,1,1,142,141,138,138,30
"2690",89,"[25]joIoHcoxHnJHGqKCviCjIBFzE",284,0.996491,25,285,1,284,1,1,0,1,1,142,141,143,143,30
"2691",90,"[25]joIoHcoxHnJHGqKCviCjIBFzE",283,0.996479,25,284,1,283,1,1,0,1,1,139,138,145,145,30
"2692",91,"[25]joIoHcoxHnJHGqKCviCjIBFzE",279,0.996429,25,280,1,279,1,1,0,1,1,135,134,145,145,30
"2693",92,"[25]joIoHcoxHnJHGqKCviCjIBFzE",278,0.996416,25,279,1,278,1,1,0,1,1,135,134,144,144,30
"2694",93,"[25]joIoHcoxHnJHGqKCviCjIBFzE",276,0.99639,25,277,1,276,1,1,0,1,1,137,136,140,140,30
"2695",94,"[25]joIoHcoxHnJHGqKCviCjIBFzE",273,0.99635,25,274,1,273,1,1,0,1,1,138,137,136,136,30
"2696",95,"[25]joIoHcoxHnJHGqKCviCjIBFzE",279,0.996429,25,280,1,279,1,1,0,1,1,149,148,131,131,30
"2697",96,"[25]joIoHcoxHnJHGqKCviCjIBFzE",282,0.996466,25,283,1,282,1,1,0,1,1,134,133,149,149,30
"2698",97,"[25]joIoHcoxHnJHGqKCviCjIBFzE",285,0.996503,25,286,1,285,1,1,0,1,1,142,141,144,144,30
"2699",98,"[25]joIoHcoxHnJHGqKCviCjIBFzE",283,0.996479,25,284,1,283,1,1,0,1,1,145,144,139,139,30
"2700",99,"[25]joIoHcoxHnJHGqKCviCjIBFzE",281,0.996454,25,282,1,281,1,1,0,1,1,162,161,120,120,30
"2701",0,"[21]joIoHcosHnJHGqKCufFyq",288,0.99654,21,289,1,288,1,1,0,1,1,151,150,138,138,31
"2702",1,"[21]joIoHcosHnJHGqKCufFyq",289,0.996552,21,290,1,289,1,1,0,1,1,143,142,147,147,31
"2703",2,"[21]joIoHcosHnJHGqKCufFyq",282,0.996466,21,283,1,282,1,1,0,1,1,143,142,140,140,31
"2704",3,"[21]joIoHcosHnJHGqKCufFyq",288,0.99654,21,289,1,288,1,1,0,1,1,150,149,139,139,31
"2705",4,"[21]joIoHcosHnJHGqKCufFyq",274,0.996364,21,275,1,274,1,1,0,1,1,121,120,154,154,31
"2706",5,"[21]joIoHcosHnJHGqKCufFyq",283,0.996479,21,284,1,283,1,1,0,1,1,144,143,140,140,31
"2707",6,"[21]joIoHcosHnJHGqKCufFyq",281,0.996454,21,282,1,281,1,1,0,1,1,149,148,133,133,31
"2708",7,"[21]joIoHcosHnJHGqKCufFyq",278,0.996416,21,279,1,278,1,1,0,1,1,136,135,143,143,31
"2709",8,"[21]joIoHcosHnJHGqKCufFyq",286,0.996516,21,287,1,286,1,1,0,1,1,143,142,144,144,31
"2710",9,"[21]joIoHcosHnJHGqKCufFyq",279,0.996429,21,280,1,279,1,1,0,1,1,140,139,140,140,31
"2711",10,"[21]joIoHcosHnJHGqKCufFyq",283,0.996479,21,284,1,283,1,1,0,1,1,136,135,148,148,31
"2712",11,"[21]joIoHcosHnJHGqKCufFyq",286,0.996516,21,287,1,286,1,1,0,1,1,148,147,139,139,31
"2713",12,"[21]joIoHcosHnJHGqKCufFyq",285,0.996503,21,286,1,285,1,1,0,1,1,146,145,140,140,31
"2714",13,"[21]joIoHcosHnJHGqKCufFyq",282,0.996466,21,283,1,282,1,1,0,1,1,140,139,143,143,31
"2715",14,"[21]joIoHcosHnJHGqKCufFyq",275,0.996377,21,276,1,275,1,1,0,1,1,138,137,138,138,31
"2716",15,"[21]joIoHcosHnJHGqKCufFyq",279,0.996429,21,280,1,279,1,1,0,1,1,122,121,158,158,31
"2717",16,"[21]joIoHcosHnJHGqKCufFyq",282,0.996466,21,283,1,282,1,1,0,1,1,145,144,138,138,31
"2718",17,"[21]joIoHcosHnJHGqKCufFyq",278,0.996416,21,279,1,278,1,1,0,1,1,136,135,143,143,31
"2719",18,"[21]joIoHcosHnJHGqKCufFyq",281,0.996454,21,282,1,281,1,1,0,1,1,136,135,146,146,31
"2720",19,"[21]joIoHcosHnJHGqKCufFyq",280,0.996441,21,281,1,280,1,1,0,1,1,135,134,146,146,31
"2721",20,"[21]joIoHcosHnJHGqKCufFyq",283,0.996479,21,284,1,283,1,1,0,1,1,125,124,159,159,31
"2722",21,"[21]joIoHcosHnJHGqKCufFyq",287,0.996528,21,288,1,287,1,1,0,1,1,146,145,142,142,31
"2723",22,"[21]joIoHcosHnJHGqKCufFyq",276,0.99639,21,277,1,276,1,1,0,1,1,121,120,156,156,31
"2724",23,"[21]joIoHcosHnJHGqKCufFyq",277,0.996403,21,278,1,277,1,1,0,1,1,132,131,146,146,31
"2725",24,"[21]joIoHcosHnJHGqKCufFyq",286,0.996516,21,287,1,286,1,1,0,1,1,152,151,135,135,31
"2726",25,"[21]joIoHcosHnJHGqKCufFyq",279,0.996429,21,280,1,279,1,1,0,1,1,143,142,137,137,31
"2727",26,"[21]joIoHcosHnJHGqKCufFyq",285,0.996503,21,286,1,285,1,1,0,1,1,130,129,156,156,31
"2728",27,"[21]joIoHcosHnJHGqKCufFyq",282,0.996466,21,283,1,282,1,1,0,1,1,151,150,132,132,31
"2729",28,"[21]joIoHcosHnJHGqKCufFyq",283,0.996479,21,284,1,283,1,1,0,1,1,148,147,136,136,31
"2730",29,"[21]joIoHcosHnJHGqKCufFyq",287,0.996528,21,288,1,287,1,1,0,1,1,140,139,148,148,31
"2731",30,"[21]joIoHcosHnJHGqKCufFyq",278,0.996416,21,279,1,278,1,1,0,1,1,144,143,135,135,31
"2732",31,"[21]joIoHcosHnJHGqKCufFyq",279,0.996429,21,280,1,279,1,1,0,1,1,129,128,151,151,31
"2733",32,"[21]joIoHcosHnJHGqKCufFyq",280,0.996441,21,281,1,280,1,1,0,1,1,134,133,147,147,31
"2734",33,"[21]joIoHcosHnJHGqKCufFyq",279,0.996429,21,280,1,279,1,1,0,1,1,124,123,156,156,31
"2735",34,"[21]joIoHcosHnJHGqKCufFyq",279,0.996429,21,280,1,279,1,1,0,1,1,145,144,135,135,31
"2736",35,"[21]joIoHcosHnJHGqKCufFyq",276,0.99639,21,277,1,276,1,1,0,1,1,129,128,148,148,31
"2737",36,"[21]joIoHcosHnJHGqKCufFyq",282,0.996466,21,283,1,282,1,1,0,1,1,154,153,129,129,31
"2738",37,"[21]joIoHcosHnJHGqKCufFyq",283,0.996479,21,284,1,283,1,1,0,1,1,137,136,147,147,31
"2739",38,"[21]joIoHcosHnJHGqKCufFyq",280,0.996441,21,281,1,280,1,1,0,1,1,156,155,125,125,31
"2740",39,"[21]joIoHcosHnJHGqKCufFyq",277,0.996403,21,278,1,277,1,1,0,1,1,139,138,139,139,31
"2741",40,"[21]joIoHcosHnJHGqKCufFyq",284,0.996491,21,285,1,284,1,1,0,1,1,137,136,148,148,31
"2742",41,"[21]joIoHcosHnJHGqKCufFyq",277,0.996403,21,278,1,277,1,1,0,1,1,146,145,132,132,31
"2743",42,"[21]joIoHcosHnJHGqKCufFyq",284,0.996491,21,285,1,284,1,1,0,1,1,151,150,134,134,31
"2744",43,"[21]joIoHcosHnJHGqKCufFyq",277,0.996403,21,278,1,277,1,1,0,1,1,132,131,146,146,31
"2745",44,"[21]joIoHcosHnJHGqKCufFyq",280,0.996441,21,281,1,280,1,1,0,1,1,146,145,135,135,31
"2746",45,"[21]joIoHcosHnJHGqKCufFyq",277,0.996403,21,278,1,277,1,1,0,1,1,142,141,136,136,31
"2747",46,"[21]joIoHcosHnJHGqKCufFyq",284,0.996491,21,285,1,284,1,1,0,1,1,134,133,151,151,31
"2748",47,"[21]joIoHcosHnJHGqKCufFyq",279,0.996429,21,280,1,279,1,1,0,1,1,139,138,141,141,31
"2749",48,"[21]joIoHcosHnJHGqKCufFyq",282,0.996466,21,283,1,282,1,1,0,1,1,142,141,141,141,31
"2750",49,"[21]joIoHcosHnJHGqKCufFyq",282,0.996466,21,283,1,282,1,1,0,1,1,129,128,154,154,31
"2751",50,"[21]joIoHcosHnJHGqKCufFyq",285,0.996503,21,286,1,285,1,1,0,1,1,145,144,141,141,31
"2752",51,"[21]joIoHcosHnJHGqKCufFyq",285,0.996503,21,286,1,285,1,1,0,1,1,145,144,141,141,31
"2753",52,"[21]joIoHcosHnJHGqKCufFyq",277,0.996403,21,278,1,277,1,1,0,1,1,141,140,137,137,31
"2754",53,"[21]joIoHcosHnJHGqKCufFyq",276,0.99639,21,277,1,276,1,1,0,1,1,131,130,146,146,31
"2755",54,"[21]joIoHcosHnJHGqKCufFyq",287,0.996528,21,288,1,287,1,1,0,1,1,145,144,143,143,31
"2756",55,"[21]joIoHcosHnJHGqKCufFyq",279,0.996429,21,280,1,279,1,1,0,1,1,160,159,120,120,31
"2757",56,"[21]joIoHcosHnJHGqKCufFyq",283,0.996479,21,284,1,283,1,1,0,1,1,146,145,138,138,31
"2758",57,"[21]joIoHcosHnJHGqKCufFyq",279,0.996429,21,280,1,279,1,1,0,1,1,121,120,159,159,31
"2759",58,"[21]joIoHcosHnJHGqKCufFyq",276,0.99639,21,277,1,276,1,1,0,1,1,135,134,142,142,31
"2760",59,"[21]joIoHcosHnJHGqKCufFyq",283,0.996479,21,284,1,283,1,1,0,1,1,152,151,132,132,31
"2761",60,"[21]joIoHcosHnJHGqKCufFyq",285,0.996503,21,286,1,285,1,1,0,1,1,137,136,149,149,31
"2762",61,"[21]joIoHcosHnJHGqKCufFyq",282,0.996466,21,283,1,282,1,1,0,1,1,133,132,150,150,31
"2763",62,"[21]joIoHcosHnJHGqKCufFyq",288,0.99654,21,289,1,288,1,1,0,1,1,142,141,147,147,31
"2764",63,"[21]joIoHcosHnJHGqKCufFyq",279,0.996429,21,280,1,279,1,1,0,1,1,135,134,145,145,31
"2765",64,"[21]joIoHcosHnJHGqKCufFyq",281,0.996454,21,282,1,281,1,1,0,1,1,141,140,141,141,31
"2766",65,"[21]joIoHcosHnJHGqKCufFyq",290,0.996564,21,291,1,290,1,1,0,1,1,153,152,138,138,31
"2767",66,"[21]joIoHcosHnJHGqKCufFyq",276,0.99639,21,277,1,276,1,1,0,1,1,128,127,149,149,31
"2768",67,"[21]joIoHcosHnJHGqKCufFyq",280,0.996441,21,281,1,280,1,1,0,1,1,135,134,146,146,31
"2769",68,"[21]joIoHcosHnJHGqKCufFyq",273,0.99635,21,274,1,273,1,1,0,1,1,140,139,134,134,31
"2770",69,"[21]joIoHcosHnJHGqKCufFyq",282,0.996466,21,283,1,282,1,1,0,1,1,142,141,141,141,31
"2771",70,"[21]joIoHcosHnJHGqKCufFyq",273,0.99635,21,274,1,273,1,1,0,1,1,128,127,146,146,31
"2772",71,"[21]joIoHcosHnJHGqKCufFyq",280,0.996441,21,281,1,280,1,1,0,1,1,136,135,145,145,31
"2773",72,"[21]joIoHcosHnJHGqKCufFyq",272,0.996337,21,273,1,272,1,1,0,1,1,124,123,149,149,31
"2774",73,"[21]joIoHcosHnJHGqKCufFyq",282,0.996466,21,283,1,282,1,1,0,1,1,148,147,135,135,31
"2775",74,"[21]joIoHcosHnJHGqKCufFyq",284,0.996491,21,285,1,284,1,1,0,1,1,146,145,139,139,31
"2776",75,"[21]joIoHcosHnJHGqKCufFyq",286,0.996516,21,287,1,286,1,1,0,1,1,157,156,130,130,31
"2777",76,"[21]joIoHcosHnJHGqKCufFyq",290,0.996564,21,291,1,290,1,1,0,1,1,145,144,146,146,31
"2778",77,"[21]joIoHcosHnJHGqKCufFyq",281,0.996454,21,282,1,281,1,1,0,1,1,148,147,134,134,31
"2779",78,"[21]joIoHcosHnJHGqKCufFyq",279,0.996429,21,280,1,279,1,1,0,1,1,139,138,141,141,31
"2780",79,"[21]joIoHcosHnJHGqKCufFyq",281,0.996454,21,282,1,281,1,1,0,1,1,152,151,130,130,31
"2781",80,"[21]joIoHcosHnJHGqKCufFyq",279,0.996429,21,280,1,279,1,1,0,1,1,138,137,142,142,31
"2782",81,"[21]joIoHcosHnJHGqKCufFyq",276,0.99639,21,277,1,276,1,1,0,1,1,147,146,130,130,31
"2783",82,"[21]joIoHcosHnJHGqKCufFyq",285,0.996503,21,286,1,285,1,1,0,1,1,155,154,131,131,31
"2784",83,"[21]joIoHcosHnJHGqKCufFyq",283,0.996479,21,284,1,283,1,1,0,1,1,151,150,133,133,31
"2785",84,"[21]joIoHcosHnJHGqKCufFyq",277,0.996403,21,278,1,277,1,1,0,1,1,138,137,140,140,31
"2786",85,"[21]joIoHcosHnJHGqKCufFyq",280,0.996441,21,281,1,280,1,1,0,1,1,142,141,139,139,31
"2787",86,"[21]joIoHcosHnJHGqKCufFyq",279,0.996429,21,280,1,279,1,1,0,1,1,136,135,144,144,31
"2788",87,"[21]joIoHcosHnJHGqKCufFyq",279,0.996429,21,280,1,279,1,1,0,1,1,146,145,134,134,31
"2789",88,"[21]joIoHcosHnJHGqKCufFyq",280,0.996441,21,281,1,280,1,1,0,1,1,124,123,157,157,31
"2790",89,"[21]joIoHcosHnJHGqKCufFyq",283,0.996479,21,284,1,283,1,1,0,1,1,146,145,138,138,31
"2791",90,"[21]joIoHcosHnJHGqKCufFyq",282,0.996466,21,283,1,282,1,1,0,1,1,140,139,143,143,31
"2792",91,"[21]joIoHcosHnJHGqKCufFyq",282,0.996466,21,283,1,282,1,1,0,1,1,143,142,140,140,31
"2793",92,"[21]joIoHcosHnJHGqKCufFyq",280,0.996441,21,281,1,280,1,1,0,1,1,153,152,128,128,31
"2794",93,"[21]joIoHcosHnJHGqKCufFyq",272,0.996337,21,273,1,272,1,1,0,1,1,124,123,149,149,31
"2795",94,"[21]joIoHcosHnJHGqKCufFyq",284,0.996491,21,285,1,284,1,1,0,1,1,148,147,137,137,31
"2796",95,"[21]joIoHcosHnJHGqKCufFyq",283,0.996479,21,284,1,283,1,1,0,1,1,161,160,123,123,31
"2797",96,"[21]joIoHcosHnJHGqKCufFyq",285,0.996503,21,286,1,285,1,1,0,1,1,150,149,136,136,31
"2798",97,"[21]joIoHcosHnJHGqKCufFyq",272,0.996337,21,273,1,272,1,1,0,1,1,127,126,146,146,31
"2799",98,"[21]joIoHcosHnJHGqKCufFyq",291,0.996575,21,292,1,291,1,1,0,1,1,142,141,150,150,31
"2800",99,"[21]joIoHcosHnJHGqKCufFyq",285,0.996503,21,286,1,285,1,1,0,1,1,142,141,144,144,31
"2801",0,"[22]igoIoHcotHnJHGqKCapKgk",279,0.996429,22,280,1,279,1,1,0,1,1,137,136,143,143,32
"2802",1,"[22]igoIoHcotHnJHGqKCapKgk",284,0.996491,22,285,1,284,1,1,0,1,1,140,139,145,145,32
"2803",2,"[22]igoIoHcotHnJHGqKCapKgk",285,0.996503,22,286,1,285,1,1,0,1,1,153,152,133,133,32
"2804",3,"[22]igoIoHcotHnJHGqKCapKgk",282,0.996466,22,283,1,282,1,1,0,1,1,123,122,160,160,32
"2805",4,"[22]igoIoHcotHnJHGqKCapKgk",281,0.996454,22,282,1,281,1,1,0,1,1,140,139,142,142,32
"2806",5,"[22]igoIoHcotHnJHGqKCapKgk",287,0.996528,22,288,1,287,1,1,0,1,1,142,141,146,146,32
"2807",6,"[22]igoIoHcotHnJHGqKCapKgk",283,0.996479,22,284,1,283,1,1,0,1,1,141,140,143,143,32
"2808",7,"[22]igoIoHcotHnJHGqKCapKgk",269,0.996296,22,270,1,269,1,1,0,1,1,132,131,138,138,32
"2809",8,"[22]igoIoHcotHnJHGqKCapKgk",280,0.996441,22,281,1,280,1,1,0,1,1,143,142,138,138,32
"2810",9,"[22]igoIoHcotHnJHGqKCapKgk",281,0.996454,22,282,1,281,1,1,0,1,1,136,135,146,146,32
"2811",10,"[22]igoIoHcotHnJHGqKCapKgk",279,0.996429,22,280,1,279,1,1,0,1,1,137,136,143,143,32
"2812",11,"[22]igoIoHcotHnJHGqKCapKgk",285,0.996503,22,286,1,285,1,1,0,1,1,154,153,132,132,32
"2813",12,"[22]igoIoHcotHnJHGqKCapKgk",278,0.996416,22,279,1,278,1,1,0,1,1,150,149,129,129,32
"2814",13,"[22]igoIoHcotHnJHGqKCapKgk",283,0.996479,22,284,1,283,1,1,0,1,1,154,153,130,130,32
"2815",14,"[22]igoIoHcotHnJHGqKCapKgk",284,0.996491,22,285,1,284,1,1,0,1,1,151,150,134,134,32
"2816",15,"[22]igoIoHcotHnJHGqKCapKgk",279,0.996429,22,280,1,279,1,1,0,1,1,141,140,139,139,32
"2817",16,"[22]igoIoHcotHnJHGqKCapKgk",284,0.996491,22,285,1,284,1,1,0,1,1,141,140,144,144,32
"2818",17,"[22]igoIoHcotHnJHGqKCapKgk",284,0.996491,22,285,1,284,1,1,0,1,1,147,146,138,138,32
"2819",18,"[22]igoIoHcotHnJHGqKCapKgk",276,0.99639,22,277,1,276,1,1,0,1,1,134,133,143,143,32
"2820",19,"[22]igoIoHcotHnJHGqKCapKgk",284,0.996491,22,285,1,284,1,1,0,1,1,143,142,142,142,32
"2821",20,"[22]igoIoHcotHnJHGqKCapKgk",276,0.99639,22,277,1,276,1,1,0,1,1,144,143,133,133,32
"2822",21,"[22]igoIoHcotHnJHGqKCapKgk",268,0.996283,22,269,1,268,1,1,0,1,1,135,134,134,134,32
"2823",22,"[22]igoIoHcotHnJHGqKCapKgk",288,0.99654,22,289,1,288,1,1,0,1,1,148,147,141,141,32
"2824",23,"[22]igoIoHcotHnJHGqKCapKgk",276,0.99639,22,277,1,276,1,1,0,1,1,134,133,143,143,32
"2825",24,"[22]igoIoHcotHnJHGqKCapKgk",276,0.99639,22,277,1,276,1,1,0,1,1,119,118,158,158,32
"2826",25,"[22]igoIoHcotHnJHGqKCapKgk",272,0.996337,22,273,1,272,1,1,0,1,1,129,128,144,144,32
"2827",26,"[22]igoIoHcotHnJHGqKCapKgk",286,0.996516,22,287,1,286,1,1,0,1,1,151,150,136,136,32
"2828",27,"[22]igoIoHcotHnJHGqKCapKgk",278,0.996416,22,279,1,278,1,1,0,1,1,135,134,144,144,32
"2829",28,"[22]igoIoHcotHnJHGqKCapKgk",276,0.99639,22,277,1,276,1,1,0,1,1,131,130,146,146,32
"2830",29,"[22]igoIoHcotHnJHGqKCapKgk",280,0.996441,22,281,1,280,1,1,0,1,1,148,147,133,133,32
"2831",30,"[22]igoIoHcotHnJHGqKCapKgk",285,0.996503,22,286,1,285,1,1,0,1,1,142,141,144,144,32
"2832",31,"[22]igoIoHcotHnJHGqKCapKgk",278,0.996416,22,279,1,278,1,1,0,1,1,141,140,138,138,32
"2833",32,"[22]igoIoHcotHnJHGqKCapKgk",288,0.99654,22,289,1,288,1,1,0,1,1,149,148,140,140,32
"2834",33,"[22]igoIoHcotHnJHGqKCapKgk",289,0.996552,22,290,1,289,1,1,0,1,1,141,140,149,149,32
"2835",34,"[22]igoIoHcotHnJHGqKCapKgk",284,0.996491,22,285,1,284,1,1,0,1,1,153,152,132,132,32
"2836",35,"[22]igoIoHcotHnJHGqKCapKgk",283,0.996479,22,284,1,283,1,1,0,1,1,145,144,139,139,32
"2837",36,"[22]igoIoHcotHnJHGqKCapKgk",278,0.996416,22,279,1,278,1,1,0,1,1,134,133,145,145,32
"2838",37,"[22]igoIoHcotHnJHGqKCapKgk",284,0.996491,22,285,1,284,1,1,0,1,1,144,143,141,141,32
"2839",38,"[22]igoIoHcotHnJHGqKCapKgk",277,0.996403,22,278,1,277,1,1,0,1,1,142,141,136,136,32
"2840",39,"[22]igoIoHcotHnJHGqKCapKgk",274,0.996364,22,275,1,274,1,1,0,1,1,144,143,131,131,32
"2841",40,"[22]igoIoHcotHnJHGqKCapKgk",281,0.996454,22,282,1,281,1,1,0,1,1,150,149,132,132,32
"2842",41,"[22]igoIoHcotHnJHGqKCapKgk",281,0.996454,22,282,1,281,1,1,0,1,1,135,134,147,147,32
"2843",42,"[22]igoIoHcotHnJHGqKCapKgk",290,0.996564,22,291,1,290,1,1,0,1,1,144,143,147,147,32
"2844",43,"[22]igoIoHcotHnJHGqKCapKgk",285,0.996503,22,286,1,285,1,1,0,1,1,149,148,137,137,32
"2845",44,"[22]igoIoHcotHnJHGqKCapKgk",287,0.996528,22,288,1,287,1,1,0,1,1,137,136,151,151,32
"2846",45,"[22]igoIoHcotHnJHGqKCapKgk",283,0.996479,22,284,1,283,1,1,0,1,1,140,139,144,144,32
"2847",46,"[22]igoIoHcotHnJHGqKCapKgk",270,0.99631,22,271,1,270,1,1,0,1,1,142,141,129,129,32
"2848",47,"[22]igoIoHcotHnJHGqKCapKgk",284,0.996491,22,285,1,284,1,1,0,1,1,136,135,149,149,32
"2849",48,"[22]igoIoHcotHnJHGqKCapKgk",278,0.996416,22,279,1,278,1,1,0,1,1,130,129,149,149,32
"2850",49,"[22]igoIoHcotHnJHGqKCapKgk",271,0.996324,22,272,1,271,1,1,0,1,1,122,121,150,150,32
"2851",50,"[22]igoIoHcotHnJHGqKCapKgk",285,0.996503,22,286,1,285,1,1,0,1,1,155,154,131,131,32
"2852",51,"[22]igoIoHcotHnJHGqKCapKgk",285,0.996503,22,286,1,285,1,1,0,1,1,149,148,137,137,32
"2853",52,"[22]igoIoHcotHnJHGqKCapKgk",282,0.996466,22,283,1,282,1,1,0,1,1,140,139,143,143,32
"2854",53,"[22]igoIoHcotHnJHGqKCapKgk",281,0.996454,22,282,1,281,1,1,0,1,1,161,160,121,121,32
"2855",54,"[22]igoIoHcotHnJHGqKCapKgk",280,0.996441,22,281,1,280,1,1,0,1,1,129,128,152,152,32
"2856",55,"[22]igoIoHcotHnJHGqKCapKgk",282,0.996466,22,283,1,282,1,1,0,1,1,134,133,149,149,32
"2857",56,"[22]igoIoHcotHnJHGqKCapKgk",272,0.996337,22,273,1,272,1,1,0,1,1,133,132,140,140,32
"2858",57,"[22]igoIoHcotHnJHGqKCapKgk",275,0.996377,22,276,1,275,1,1,0,1,1,124,123,152,152,32
"2859",58,"[22]igoIoHcotHnJHGqKCapKgk",276,0.99639,22,277,1,276,1,1,0,1,1,140,139,137,137,32
"2860",59,"[22]igoIoHcotHnJHGqKCapKgk",286,0.996516,22,287,1,286,1,1,0,1,1,143,142,144,144,32
"2861",60,"[22]igoIoHcotHnJHGqKCapKgk",281,0.996454,22,282,1,281,1,1,0,1,1,151,150,131,131,32
"2862",61,"[22]igoIoHcotHnJHGqKCapKgk",276,0.99639,22,277,1,276,1,1,0,1,1,129,128,148,148,32
"2863",62,"[22]igoIoHcotHnJHGqKCapKgk",282,0.996466,22,283,1,282,1,1,0,1,1,157,156,126,126,32
"2864",63,"[22]igoIoHcotHnJHGqKCapKgk",283,0.996479,22,284,1,283,1,1,0,1,1,144,143,140,140,32
"2865",64,"[22]igoIoHcotHnJHGqKCapKgk",276,0.99639,22,277,1,276,1,1,0,1,1,150,149,127,127,32
"2866",65,"[22]igoIoHcotHnJHGqKCapKgk",278,0.996416,22,279,1,278,1,1,0,1,1,139,138,140,140,32
"2867",66,"[22]igoIoHcotHnJHGqKCapKgk",282,0.996466,22,283,1,282,1,1,0,1,1,158,157,125,125,32
"2868",67,"[22]igoIoHcotHnJHGqKCapKgk",279,0.996429,22,280,1,279,1,1,0,1,1,131,130,149,149,32
"2869",68,"[22]igoIoHcotHnJHGqKCapKgk",290,0.996564,22,291,1,290,1,1,0,1,1,147,146,144,144,32
"2870",69,"[22]igoIoHcotHnJHGqKCapKgk",273,0.99635,22,274,1,273,1,1,0,1,1,132,131,142,142,32
"2871",70,"[22]igoIoHcotHnJHGqKCapKgk",276,0.99639,22,277,1,276,1,1,0,1,1,136,135,141,141,32
"2872",71,"[22]igoIoHcotHnJHGqKCapKgk",276,0.99639,22,277,1,276,1,1,0,1,1,141,140,136,136,32
"2873",72,"[22]igoIoHcotHnJHGqKCapKgk",283,0.996479,22,284,1,283,1,1,0,1,1,146,145,138,138,32
"2874",73,"[22]igoIoHcotHnJHGqKCapKgk",278,0.996416,22,279,1,278,1,1,0,1,1,127,126,152,152,32
"2875",74,"[22]igoIoHcotHnJHGqKCapKgk",276,0.99639,22,277,1,276,1,1,0,1,1,140,139,137,137,32
"2876",75,"[22]igoIoHcotHnJHGqKCapKgk",285,0.996503,22,286,1,285,1,1,0,1,1,158,157,128,128,32
"2877",76,"[22]igoIoHcotHnJHGqKCapKgk",278,0.996416,22,279,1,278,1,1,0,1,1,145,144,134,134,32
"2878",77,"[22]igoIoHcotHnJHGqKCapKgk",286,0.996516,22,287,1,286,1,1,0,1,1,144,143,143,143,32
"2879",78,"[22]igoIoHcotHnJHGqKCapKgk",284,0.996491,22,285,1,284,1,1,0,1,1,152,151,133,133,32
"2880",79,"[22]igoIoHcotHnJHGqKCapKgk",282,0.996466,22,283,1,282,1,1,0,1,1,145,144,138,138,32
"2881",80,"[22]igoIoHcotHnJHGqKCapKgk",287,0.996528,22,288,1,287,1,1,0,1,1,140,139,148,148,32
"2882",81,"[22]igoIoHcotHnJHGqKCapKgk",281,0.996454,22,282,1,281,1,1,0,1,1,151,150,131,131,32
"2883",82,"[22]igoIoHcotHnJHGqKCapKgk",286,0.996516,22,287,1,286,1,1,0,1,1,130,129,157,157,32
"2884",83,"[22]igoIoHcotHnJHGqKCapKgk",278,0.996416,22,279,1,278,1,1,0,1,1,145,144,134,134,32
"2885",84,"[22]igoIoHcotHnJHGqKCapKgk",272,0.996337,22,273,1,272,1,1,0,1,1,127,126,146,146,32
"2886",85,"[22]igoIoHcotHnJHGqKCapKgk",284,0.996491,22,285,1,284,1,1,0,1,1,147,146,138,138,32
"2887",86,"[22]igoIoHcotHnJHGqKCapKgk",286,0.996516,22,287,1,286,1,1,0,1,1,139,138,148,148,32
"2888",87,"[22]igoIoHcotHnJHGqKCapKgk",286,0.996516,22,287,1,286,1,1,0,1,1,161,160,126,126,32
"2889",88,"[22]igoIoHcotHnJHGqKCapKgk",280,0.996441,22,281,1,280,1,1,0,1,1,152,151,129,129,32
"2890",89,"[22]igoIoHcotHnJHGqKCapKgk",275,0.996377,22,276,1,275,1,1,0,1,1,138,137,138,138,32
"2891",90,"[22]igoIoHcotHnJHGqKCapKgk",282,0.996466,22,283,1,282,1,1,0,1,1,145,144,138,138,32
"2892",91,"[22]igoIoHcotHnJHGqKCapKgk",284,0.996491,22,285,1,284,1,1,0,1,1,140,139,145,145,32
"2893",92,"[22]igoIoHcotHnJHGqKCapKgk",285,0.996503,22,286,1,285,1,1,0,1,1,147,146,139,139,32
"2894",93,"[22]igoIoHcotHnJHGqKCapKgk",278,0.996416,22,279,1,278,1,1,0,1,1,128,127,151,151,32
"2895",94,"[22]igoIoHcotHnJHGqKCapKgk",287,0.996528,22,288,1,287,1,1,0,1,1,152,151,136,136,32
"2896",95,"[22]igoIoHcotHnJHGqKCapKgk",273,0.99635,22,274,1,273,1,1,0,1,1,131,130,143,143,32
"2897",96,"[22]igoIoHcotHnJHGqKCapKgk",284,0.996491,22,285,1,284,1,1,0,1,1,146,145,139,139,32
"2898",97,"[22]igoIoHcotHnJHGqKCapKgk",277,0.996403,22,278,1,277,1,1,0,1,1,137,136,141,141,32
"2899",98,"[22]igoIoHcotHnJHGqKCapKgk",279,0.996429,22,280,1,279,1,1,0,1,1,142,141,138,138,32
"2900",99,"[22]igoIoHcotHnJHGqKCapKgk",283,0.996479,22,284,1,283,1,1,0,1,1,153,152,131,131,32
"2901",0,"[26]iwGoIpCoHcoxHnJHGqKCxoCImw",286,0.996516,26,287,1,286,1,1,0,1,1,152,151,135,135,33
"2902",1,"[26]iwGoIpCoHcoxHnJHGqKCxoCImw",274,0.996364,26,275,1,274,1,1,0,1,1,138,137,137,137,33
"2903",2,"[26]iwGoIpCoHcoxHnJHGqKCxoCImw",284,0.996491,26,285,1,284,1,1,0,1,1,139,138,146,146,33
"2904",3,"[26]iwGoIpCoHcoxHnJHGqKCxoCImw",274,0.996364,26,275,1,274,1,1,0,1,1,132,131,143,143,33
"2905",4,"[26]iwGoIpCoHcoxHnJHGqKCxoCImw",284,0.996491,26,285,1,284,1,1,0,1,1,145,144,140,140,33
"2906",5,"[26]iwGoIpCoHcoxHnJHGqKCxoCImw",280,0.996441,26,281,1,280,1,1,0,1,1,152,151,129,129,33
"2907",6,"[26]iwGoIpCoHcoxHnJHGqKCxoCImw",281,0.996454,26,282,1,281,1,1,0,1,1,123,122,159,159,33
"2908",7,"[26]iwGoIpCoHcoxHnJHGqKCxoCImw",277,0.996403,26,278,1,277,1,1,0,1,1,143,142,135,135,33
"2909",8,"[26]iwGoIpCoHcoxHnJHGqKCxoCImw",281,0.996454,26,282,1,281,1,1,0,1,1,131,130,151,151,33
"2910",9,"[26]iwGoIpCoHcoxHnJHGqKCxoCImw",280,0.996441,26,281,1,280,1,1,0,1,1,140,139,141,141,33
"2911",10,"[26]iwGoIpCoHcoxHnJHGqKCxoCImw",277,0.996403,26,278,1,277,1,1,0,1,1,141,140,137,137,33
"2912",11,"[26]iwGoIpCoHcoxHnJHGqKCxoCImw",283,0.996479,26,284,1,283,1,1,0,1,1,137,136,147,147,33
"2913",12,"[26]iwGoIpCoHcoxHnJHGqKCxoCImw",280,0.996441,26,281,1,280,1,1,0,1,1,157,156,124,124,33
"2914",13,"[26]iwGoIpCoHcoxHnJHGqKCxoCImw",280,0.996441,26,281,1,280,1,1,0,1,1,125,124,156,156,33
"2915",14,"[26]iwGoIpCoHcoxHnJHGqKCxoCImw",271,0.996324,26,272,1,271,1,1,0,1,1,130,129,142,142,33
"2916",15,"[26]iwGoIpCoHcoxHnJHGqKCxoCImw",283,0.996479,26,284,1,283,1,1,0,1,1,145,144,139,139,33
"2917",16,"[26]iwGoIpCoHcoxHnJHGqKCxoCImw",278,0.996416,26,279,1,278,1,1,0,1,1,142,141,137,137,33
"2918",17,"[26]iwGoIpCoHcoxHnJHGqKCxoCImw",286,0.996516,26,287,1,286,1,1,0,1,1,141,140,146,146,33
"2919",18,"[26]iwGoIpCoHcoxHnJHGqKCxoCImw",279,0.996429,26,280,1,279,1,1,0,1,1,122,121,158,158,33
"2920",19,"[26]iwGoIpCoHcoxHnJHGqKCxoCImw",279,0.996429,26,280,1,279,1,1,0,1,1,135,134,145,145,33
"2921",20,"[26]iwGoIpCoHcoxHnJHGqKCxoCImw",278,0.996416,26,279,1,278,1,1,0,1,1,147,146,132,132,33
"2922",21,"[26]iwGoIpCoHcoxHnJHGqKCxoCImw",280,0.996441,26,281,1,280,1,1,0,1,1,149,148,132,132,33
"2923",22,"[26]iwGoIpCoHcoxHnJHGqKCxoCImw",280,0.996441,26,281,1,280,1,1,0,1,1,138,137,143,143,33
"2924",23,"[26]iwGoIpCoHcoxHnJHGqKCxoCImw",289,0.996552,26,290,1,289,1,1,0,1,1,145,144,145,145,33
"2925",24,"[26]iwGoIpCoHcoxHnJHGqKCxoCImw",282,0.996466,26,283,1,282,1,1,0,1,1,132,131,151,151,33
"2926",25,"[26]iwGoIpCoHcoxHnJHGqKCxoCImw",275,0.996377,26,276,1,275,1,1,0,1,1,132,131,144,144,33
"2927",26,"[26]iwGoIpCoHcoxHnJHGqKCxoCImw",279,0.996429,26,280,1,279,1,1,0,1,1,130,129,150,150,33
"2928",27,"[26]iwGoIpCoHcoxHnJHGqKCxoCImw",285,0.996503,26,286,1,285,1,1,0,1,1,148,147,138,138,33
"2929",28,"[26]iwGoIpCoHcoxHnJHGqKCxoCImw",284,0.996491,26,285,1,284,1,1,0,1,1,150,149,135,135,33
"2930",29,"[26]iwGoIpCoHcoxHnJHGqKCxoCImw",287,0.996528,26,288,1,287,1,1,0,1,1,151,150,137,137,33
"2931",30,"[26]iwGoIpCoHcoxHnJHGqKCxoCImw",270,0.99631,26,271,1,270,1,1,0,1,1,124,123,147,147,33
"2932",31,"[26]iwGoIpCoHcoxHnJHGqKCxoCImw",281,0.996454,26,282,1,281,1,1,0,1,1,138,137,144,144,33
"2933",32,"[26]iwGoIpCoHcoxHnJHGqKCxoCImw",285,0.996503,26,286,1,285,1,1,0,1,1,150,149,136,136,33
"2934",33,"[26]iwGoIpCoHcoxHnJHGqKCxoCImw",277,0.996403,26,278,1,277,1,1,0,1,1,150,149,128,128,33
"2935",34,"[26]iwGoIpCoHcoxHnJHGqKCxoCImw",279,0.996429,26,280,1,279,1,1,0,1,1,144,143,136,136,33
"2936",35,"[26]iwGoIpCoHcoxHnJHGqKCxoCImw",285,0.996503,26,286,1,285,1,1,0,1,1,131,130,155,155,33
"2937",36,"[26]iwGoIpCoHcoxHnJHGqKCxoCImw",281,0.996454,26,282,1,281,1,1,0,1,1,136,135,146,146,33
"2938",37,"[26]iwGoIpCoHcoxHnJHGqKCxoCImw",281,0.996454,26,282,1,281,1,1,0,1,1,136,135,146,146,33
"2939",38,"[26]iwGoIpCoHcoxHnJHGqKCxoCImw",275,0.996377,26,276,1,275,1,1,0,1,1,151,150,125,125,33
"2940",39,"[26]iwGoIpCoHcoxHnJHGqKCxoCImw",280,0.996441,26,281,1,280,1,1,0,1,1,159,158,122,122,33
"2941",40,"[26]iwGoIpCoHcoxHnJHGqKCxoCImw",285,0.996503,26,286,1,285,1,1,0,1,1,147,146,139,139,33
"2942",41,"[26]iwGoIpCoHcoxHnJHGqKCxoCImw",287,0.996528,26,288,1,287,1,1,0,1,1,137,136,151,151,33
"2943",42,"[26]iwGoIpCoHcoxHnJHGqKCxoCImw",285,0.996503,26,286,1,285,1,1,0,1,1,146,145,140,140,33
"2944",43,"[26]iwGoIpCoHcoxHnJHGqKCxoCImw",272,0.996337,26,273,1,272,1,1,0,1,1,117,116,156,156,33
"2945",44,"[26]iwGoIpCoHcoxHnJHGqKCxoCImw",285,0.996503,26,286,1,285,1,1,0,1,1,147,146,139,139,33
"2946",45,"[26]iwGoIpCoHcoxHnJHGqKCxoCImw",278,0.996416,26,279,1,278,1,1,0,1,1,136,135,143,143,33
"2947",46,"[26]iwGoIpCoHcoxHnJHGqKCxoCImw",286,0.996516,26,287,1,286,1,1,0,1,1,158,157,129,129,33
"2948",47,"[26]iwGoIpCoHcoxHnJHGqKCxoCImw",281,0.996454,26,282,1,281,1,1,0,1,1,146,145,136,136,33
"2949",48,"[26]iwGoIpCoHcoxHnJHGqKCxoCImw",275,0.996377,26,276,1,275,1,1,0,1,1,137,136,139,139,33
"2950",49,"[26]iwGoIpCoHcoxHnJHGqKCxoCImw",281,0.996454,26,282,1,281,1,1,0,1,1,148,147,134,134,33
"2951",50,"[26]iwGoIpCoHcoxHnJHGqKCxoCImw",283,0.996479,26,284,1,283,1,1,0,1,1,133,132,151,151,33
"2952",51,"[26]iwGoIpCoHcoxHnJHGqKCxoCImw",276,0.99639,26,277,1,276,1,1,0,1,1,127,126,150,150,33
"2953",52,"[26]iwGoIpCoHcoxHnJHGqKCxoCImw",278,0.996416,26,279,1,278,1,1,0,1,1,134,133,145,145,33
"2954",53,"[26]iwGoIpCoHcoxHnJHGqKCxoCImw",284,0.996491,26,285,1,284,1,1,0,1,1,155,154,130,130,33
"2955",54,"[26]iwGoIpCoHcoxHnJHGqKCxoCImw",287,0.996528,26,288,1,287,1,1,0,1,1,146,145,142,142,33
"2956",55,"[26]iwGoIpCoHcoxHnJHGqKCxoCImw",283,0.996479,26,284,1,283,1,1,0,1,1,146,145,138,138,33
"2957",56,"[26]iwGoIpCoHcoxHnJHGqKCxoCImw",278,0.996416,26,279,1,278,1,1,0,1,1,136,135,143,143,33
"2958",57,"[26]iwGoIpCoHcoxHnJHGqKCxoCImw",282,0.996466,26,283,1,282,1,1,0,1,1,145,144,138,138,33
"2959",58,"[26]iwGoIpCoHcoxHnJHGqKCxoCImw",277,0.996403,26,278,1,277,1,1,0,1,1,148,147,130,130,33
"2960",59,"[26]iwGoIpCoHcoxHnJHGqKCxoCImw",270,0.99631,26,271,1,270,1,1,0,1,1,132,131,139,139,33
"2961",60,"[26]iwGoIpCoHcoxHnJHGqKCxoCImw",280,0.996441,26,281,1,280,1,1,0,1,1,141,140,140,140,33
"2962",61,"[26]iwGoIpCoHcoxHnJHGqKCxoCImw",279,0.996429,26,280,1,279,1,1,0,1,1,125,124,155,155,33
"2963",62,"[26]iwGoIpCoHcoxHnJHGqKCxoCImw",282,0.996466,26,283,1,282,1,1,0,1,1,144,143,139,139,33
"2964",63,"[26]iwGoIpCoHcoxHnJHGqKCxoCImw",281,0.996454,26,282,1,281,1,1,0,1,1,140,139,142,142,33
"2965",64,"[26]iwGoIpCoHcoxHnJHGqKCxoCImw",277,0.996403,26,278,1,277,1,1,0,1,1,151,150,127,127,33
"2966",65,"[26]iwGoIpCoHcoxHnJHGqKCxoCImw",281,0.996454,26,282,1,281,1,1,0,1,1,153,152,129,129,33
"2967",66,"[26]iwGoIpCoHcoxHnJHGqKCxoCImw",287,0.996528,26,288,1,287,1,1,0,1,1,151,150,137,137,33
"2968",67,"[26]iwGoIpCoHcoxHnJHGqKCxoCImw",284,0.996491,26,285,1,284,1,1,0,1,1,143,142,142,142,33
"2969",68,"[26]iwGoIpCoHcoxHnJHGqKCxoCImw",282,0.996466,26,283,1,282,1,1,0,1,1,155,154,128,128,33
"2970",69,"[26]iwGoIpCoHcoxHnJHGqKCxoCImw",280,0.996441,26,281,1,280,1,1,0,1,1,147,146,134,134,33
"2971",70,"[26]iwGoIpCoHcoxHnJHGqKCxoCImw",281,0.996454,26,282,1,281,1,1,0,1,1,139,138,143,143,33
"2972",71,"[26]iwGoIpCoHcoxHnJHGqKCxoCImw",276,0.99639,26,277,1,276,1,1,0,1,1,132,131,145,145,33
"2973",72,"[26]iwGoIpCoHcoxHnJHGqKCxoCImw",275,0.996377,26,276,1,275,1,1,0,1,1,142,141,134,134,33
"2974",73,"[26]iwGoIpCoHcoxHnJHGqKCxoCImw",279,0.996429,26,280,1,279,1,1,0,1,1,150,149,130,130,33
"2975",74,"[26]iwGoIpCoHcoxHnJHGqKCxoCImw",275,0.996377,26,276,1,275,1,1,0,1,1,142,141,134,134,33
"2976",75,"[26]iwGoIpCoHcoxHnJHGqKCxoCImw",286,0.996516,26,287,1,286,1,1,0,1,1,143,142,144,144,33
"2977",76,"[26]iwGoIpCoHcoxHnJHGqKCxoCImw",283,0.996479,26,284,1,283,1,1,0,1,1,151,150,133,133,33
"2978",77,"[26]iwGoIpCoHcoxHnJHGqKCxoCImw",278,0.996416,26,279,1,278,1,1,0,1,1,151,150,128,128,33
"2979",78,"[26]iwGoIpCoHcoxHnJHGqKCxoCImw",278,0.996416,26,279,1,278,1,1,0,1,1,141,140,138,138,33
"2980",79,"[26]iwGoIpCoHcoxHnJHGqKCxoCImw",270,0.99631,26,271,1,270,1,1,0,1,1,141,140,130,130,33
"2981",80,"[26]iwGoIpCoHcoxHnJHGqKCxoCImw",283,0.996479,26,284,1,283,1,1,0,1,1,148,147,136,136,33
"2982",81,"[26]iwGoIpCoHcoxHnJHGqKCxoCImw",277,0.996403,26,278,1,277,1,1,0,1,1,140,139,138,138,33
"2983",82,"[26]iwGoIpCoHcoxHnJHGqKCxoCImw",279,0.996429,26,280,1,279,1,1,0,1,1,136,135,144,144,33
"2984",83,"[26]iwGoIpCoHcoxHnJHGqKCxoCImw",287,0.996528,26,288,1,287,1,1,0,1,1,155,154,133,133,33
"2985",84,"[26]iwGoIpCoHcoxHnJHGqKCxoCImw",287,0.996528,26,288,1,287,1,1,0,1,1,156,155,132,132,33
"2986",85,"[26]iwGoIpCoHcoxHnJHGqKCxoCImw",294,0.99661,26,295,1,294,1,1,0,1,1,155,154,140,140,33
"2987",86,"[26]iwGoIpCoHcoxHnJHGqKCxoCImw",284,0.996491,26,285,1,284,1,1,0,1,1,142,141,143,143,33
"2988",87,"[26]iwGoIpCoHcoxHnJHGqKCxoCImw",281,0.996454,26,282,1,281,1,1,0,1,1,157,156,125,125,33
"2989",88,"[26]iwGoIpCoHcoxHnJHGqKCxoCImw",276,0.99639,26,277,1,276,1,1,0,1,1,151,150,126,126,33
"2990",89,"[26]iwGoIpCoHcoxHnJHGqKCxoCImw",283,0.996479,26,284,1,283,1,1,0,1,1,155,154,129,129,33
"2991",90,"[26]iwGoIpCoHcoxHnJHGqKCxoCImw",282,0.996466,26,283,1,282,1,1,0,1,1,149,148,134,134,33
"2992",91,"[26]iwGoIpCoHcoxHnJHGqKCxoCImw",281,0.996454,26,282,1,281,1,1,0,1,1,144,143,138,138,33
"2993",92,"[26]iwGoIpCoHcoxHnJHGqKCxoCImw",279,0.996429,26,280,1,279,1,1,0,1,1,143,142,137,137,33
"2994",93,"[26]iwGoIpCoHcoxHnJHGqKCxoCImw",270,0.99631,26,271,1,270,1,1,0,1,1,142,141,129,129,33
"2995",94,"[26]iwGoIpCoHcoxHnJHGqKCxoCImw",280,0.996441,26,281,1,280,1,1,0,1,1,144,143,137,137,33
"2996",95,"[26]iwGoIpCoHcoxHnJHGqKCxoCImw",286,0.996516,26,287,1,286,1,1,0,1,1,151,150,136,136,33
"2997",96,"[26]iwGoIpCoHcoxHnJHGqKCxoCImw",282,0.996466,26,283,1,282,1,1,0,1,1,135,134,148,148,33
"2998",97,"[26]iwGoIpCoHcoxHnJHGqKCxoCImw",287,0.996528,26,288,1,287,1,1,0,1,1,152,151,136,136,33
"2999",98,"[26]iwGoIpCoHcoxHnJHGqKCxoCImw",280,0.996441,26,281,1,280,1,1,0,1,1,163,162,118,118,33
"3000",99,"[26]iwGoIpCoHcoxHnJHGqKCxoCImw",271,0.996324,26,272,1,271,1,1,0,1,1,141,140,131,131,33
"3001",0,"[21]goIoHcoxHnJHGqKCmEInw",285,0.996503,21,286,1,285,1,1,0,1,1,153,152,133,133,34
"3002",1,"[21]goIoHcoxHnJHGqKCmEInw",279,0.996429,21,280,1,279,1,1,0,1,1,148,147,132,132,34
"3003",2,"[21]goIoHcoxHnJHGqKCmEInw",284,0.996491,21,285,1,284,1,1,0,1,1,154,153,131,131,34
"3004",3,"[21]goIoHcoxHnJHGqKCmEInw",281,0.996454,21,282,1,281,1,1,0,1,1,138,137,144,144,34
"3005",4,"[21]goIoHcoxHnJHGqKCmEInw",291,0.996575,21,292,1,291,1,1,0,1,1,153,152,139,139,34
"3006",5,"[21]goIoHcoxHnJHGqKCmEInw",286,0.996516,21,287,1,286,1,1,0,1,1,136,135,151,151,34
"3007",6,"[21]goIoHcoxHnJHGqKCmEInw",283,0.996479,21,284,1,283,1,1,0,1,1,133,132,151,151,34
"3008",7,"[21]goIoHcoxHnJHGqKCmEInw",286,0.996516,21,287,1,286,1,1,0,1,1,145,144,142,142,34
"3009",8,"[21]goIoHcoxHnJHGqKCmEInw",279,0.996429,21,280,1,279,1,1,0,1,1,139,138,141,141,34
"3010",9,"[21]goIoHcoxHnJHGqKCmEInw",283,0.996479,21,284,1,283,1,1,0,1,1,158,157,126,126,34
"3011",10,"[21]goIoHcoxHnJHGqKCmEInw",271,0.996324,21,272,1,271,1,1,0,1,1,129,128,143,143,34
"3012",11,"[21]goIoHcoxHnJHGqKCmEInw",285,0.996503,21,286,1,285,1,1,0,1,1,144,143,142,142,34
"3013",12,"[21]goIoHcoxHnJHGqKCmEInw",279,0.996429,21,280,1,279,1,1,0,1,1,147,146,133,133,34
"3014",13,"[21]goIoHcoxHnJHGqKCmEInw",279,0.996429,21,280,1,279,1,1,0,1,1,149,148,131,131,34
"3015",14,"[21]goIoHcoxHnJHGqKCmEInw",282,0.996466,21,283,1,282,1,1,0,1,1,146,145,137,137,34
"3016",15,"[21]goIoHcoxHnJHGqKCmEInw",289,0.996552,21,290,1,289,1,1,0,1,1,136,135,154,154,34
"3017",16,"[21]goIoHcoxHnJHGqKCmEInw",296,0.996633,21,297,1,296,1,1,0,1,1,159,158,138,138,34
"3018",17,"[21]goIoHcoxHnJHGqKCmEInw",288,0.99654,21,289,1,288,1,1,0,1,1,148,147,141,141,34
"3019",18,"[21]goIoHcoxHnJHGqKCmEInw",277,0.996403,21,278,1,277,1,1,0,1,1,141,140,137,137,34
"3020",19,"[21]goIoHcoxHnJHGqKCmEInw",283,0.996479,21,284,1,283,1,1,0,1,1,130,129,154,154,34
"3021",20,"[21]goIoHcoxHnJHGqKCmEInw",273,0.99635,21,274,1,273,1,1,0,1,1,122,121,152,152,34
"3022",21,"[21]goIoHcoxHnJHGqKCmEInw",277,0.996403,21,278,1,277,1,1,0,1,1,138,137,140,140,34
"3023",22,"[21]goIoHcoxHnJHGqKCmEInw",275,0.996377,21,276,1,275,1,1,0,1,1,136,135,140,140,34
"3024",23,"[21]goIoHcoxHnJHGqKCmEInw",276,0.99639,21,277,1,276,1,1,0,1,1,148,147,129,129,34
"3025",24,"[21]goIoHcoxHnJHGqKCmEInw",288,0.99654,21,289,1,288,1,1,0,1,1,146,145,143,143,34
"3026",25,"[21]goIoHcoxHnJHGqKCmEInw",281,0.996454,21,282,1,281,1,1,0,1,1,130,129,152,152,34
"3027",26,"[21]goIoHcoxHnJHGqKCmEInw",276,0.99639,21,277,1,276,1,1,0,1,1,134,133,143,143,34
"3028",27,"[21]goIoHcoxHnJHGqKCmEInw",281,0.996454,21,282,1,281,1,1,0,1,1,135,134,147,147,34
"3029",28,"[21]goIoHcoxHnJHGqKCmEInw",281,0.996454,21,282,1,281,1,1,0,1,1,149,148,133,133,34
"3030",29,"[21]goIoHcoxHnJHGqKCmEInw",283,0.996479,21,284,1,283,1,1,0,1,1,144,143,140,140,34
"3031",30,"[21]goIoHcoxHnJHGqKCmEInw",288,0.99654,21,289,1,288,1,1,0,1,1,146,145,143,143,34
"3032",31,"[21]goIoHcoxHnJHGqKCmEInw",279,0.996429,21,280,1,279,1,1,0,1,1,134,133,146,146,34
"3033",32,"[21]goIoHcoxHnJHGqKCmEInw",280,0.996441,21,281,1,280,1,1,0,1,1,149,148,132,132,34
"3034",33,"[21]goIoHcoxHnJHGqKCmEInw",278,0.996416,21,279,1,278,1,1,0,1,1,139,138,140,140,34
"3035",34,"[21]goIoHcoxHnJHGqKCmEInw",283,0.996479,21,284,1,283,1,1,0,1,1,136,135,148,148,34
"3036",35,"[21]goIoHcoxHnJHGqKCmEInw",284,0.996491,21,285,1,284,1,1,0,1,1,147,146,138,138,34
"3037",36,"[21]goIoHcoxHnJHGqKCmEInw",294,0.99661,21,295,1,294,1,1,0,1,1,150,149,145,145,34
"3038",37,"[21]goIoHcoxHnJHGqKCmEInw",284,0.996491,21,285,1,284,1,1,0,1,1,144,143,141,141,34
"3039",38,"[21]goIoHcoxHnJHGqKCmEInw",293,0.996599,21,294,1,293,1,1,0,1,1,148,147,146,146,34
"3040",39,"[21]goIoHcoxHnJHGqKCmEInw",280,0.996441,21,281,1,280,1,1,0,1,1,146,145,135,135,34
"3041",40,"[21]goIoHcoxHnJHGqKCmEInw",284,0.996491,21,285,1,284,1,1,0,1,1,142,141,143,143,34
"3042",41,"[21]goIoHcoxHnJHGqKCmEInw",287,0.996528,21,288,1,287,1,1,0,1,1,150,149,138,138,34
"3043",42,"[21]goIoHcoxHnJHGqKCmEInw",283,0.996479,21,284,1,283,1,1,0,1,1,147,146,137,137,34
"3044",43,"[21]goIoHcoxHnJHGqKCmEInw",276,0.99639,21,277,1,276,1,1,0,1,1,136,135,141,141,34
"3045",44,"[21]goIoHcoxHnJHGqKCmEInw",281,0.996454,21,282,1,281,1,1,0,1,1,133,132,149,149,34
"3046",45,"[21]goIoHcoxHnJHGqKCmEInw",285,0.996503,21,286,1,285,1,1,0,1,1,156,155,130,130,34
"3047",46,"[21]goIoHcoxHnJHGqKCmEInw",279,0.996429,21,280,1,279,1,1,0,1,1,145,144,135,135,34
"3048",47,"[21]goIoHcoxHnJHGqKCmEInw",283,0.996479,21,284,1,283,1,1,0,1,1,150,149,134,134,34
"3049",48,"[21]goIoHcoxHnJHGqKCmEInw",280,0.996441,21,281,1,280,1,1,0,1,1,146,145,135,135,34
"3050",49,"[21]goIoHcoxHnJHGqKCmEInw",278,0.996416,21,279,1,278,1,1,0,1,1,143,142,136,136,34
"3051",50,"[21]goIoHcoxHnJHGqKCmEInw",277,0.996403,21,278,1,277,1,1,0,1,1,125,124,153,153,34
"3052",51,"[21]goIoHcoxHnJHGqKCmEInw",285,0.996503,21,286,1,285,1,1,0,1,1,166,165,120,120,34
"3053",52,"[21]goIoHcoxHnJHGqKCmEInw",288,0.99654,21,289,1,288,1,1,0,1,1,151,150,138,138,34
"3054",53,"[21]goIoHcoxHnJHGqKCmEInw",279,0.996429,21,280,1,279,1,1,0,1,1,146,145,134,134,34
"3055",54,"[21]goIoHcoxHnJHGqKCmEInw",283,0.996479,21,284,1,283,1,1,0,1,1,142,141,142,142,34
"3056",55,"[21]goIoHcoxHnJHGqKCmEInw",286,0.996516,21,287,1,286,1,1,0,1,1,141,140,146,146,34
"3057",56,"[21]goIoHcoxHnJHGqKCmEInw",283,0.996479,21,284,1,283,1,1,0,1,1,129,128,155,155,34
"3058",57,"[21]goIoHcoxHnJHGqKCmEInw",268,0.996283,21,269,1,268,1,1,0,1,1,134,133,135,135,34
"3059",58,"[21]goIoHcoxHnJHGqKCmEInw",276,0.99639,21,277,1,276,1,1,0,1,1,143,142,134,134,34
"3060",59,"[21]goIoHcoxHnJHGqKCmEInw",289,0.996552,21,290,1,289,1,1,0,1,1,145,144,145,145,34
"3061",60,"[21]goIoHcoxHnJHGqKCmEInw",275,0.996377,21,276,1,275,1,1,0,1,1,135,134,141,141,34
"3062",61,"[21]goIoHcoxHnJHGqKCmEInw",283,0.996479,21,284,1,283,1,1,0,1,1,137,136,147,147,34
"3063",62,"[21]goIoHcoxHnJHGqKCmEInw",282,0.996466,21,283,1,282,1,1,0,1,1,131,130,152,152,34
"3064",63,"[21]goIoHcoxHnJHGqKCmEInw",289,0.996552,21,290,1,289,1,1,0,1,1,150,149,140,140,34
"3065",64,"[21]goIoHcoxHnJHGqKCmEInw",282,0.996466,21,283,1,282,1,1,0,1,1,139,138,144,144,34
"3066",65,"[21]goIoHcoxHnJHGqKCmEInw",280,0.996441,21,281,1,280,1,1,0,1,1,135,134,146,146,34
"3067",66,"[21]goIoHcoxHnJHGqKCmEInw",278,0.996416,21,279,1,278,1,1,0,1,1,127,126,152,152,34
"3068",67,"[21]goIoHcoxHnJHGqKCmEInw",272,0.996337,21,273,1,272,1,1,0,1,1,131,130,142,142,34
"3069",68,"[21]goIoHcoxHnJHGqKCmEInw",287,0.996528,21,288,1,287,1,1,0,1,1,140,139,148,148,34
"3070",69,"[21]goIoHcoxHnJHGqKCmEInw",284,0.996491,21,285,1,284,1,1,0,1,1,142,141,143,143,34
"3071",70,"[21]goIoHcoxHnJHGqKCmEInw",279,0.996429,21,280,1,279,1,1,0,1,1,134,133,146,146,34
"3072",71,"[21]goIoHcoxHnJHGqKCmEInw",272,0.996337,21,273,1,272,1,1,0,1,1,137,136,136,136,34
"3073",72,"[21]goIoHcoxHnJHGqKCmEInw",287,0.996528,21,288,1,287,1,1,0,1,1,147,146,141,141,34
"3074",73,"[21]goIoHcoxHnJHGqKCmEInw",284,0.996491,21,285,1,284,1,1,0,1,1,133,132,152,152,34
"3075",74,"[21]goIoHcoxHnJHGqKCmEInw",275,0.996377,21,276,1,275,1,1,0,1,1,144,143,132,132,34
"3076",75,"[21]goIoHcoxHnJHGqKCmEInw",277,0.996403,21,278,1,277,1,1,0,1,1,142,141,136,136,34
"3077",76,"[21]goIoHcoxHnJHGqKCmEInw",281,0.996454,21,282,1,281,1,1,0,1,1,139,138,143,143,34
"3078",77,"[21]goIoHcoxHnJHGqKCmEInw",283,0.996479,21,284,1,283,1,1,0,1,1,152,151,132,132,34
"3079",78,"[21]goIoHcoxHnJHGqKCmEInw",285,0.996503,21,286,1,285,1,1,0,1,1,154,153,132,132,34
"3080",79,"[21]goIoHcoxHnJHGqKCmEInw",286,0.996516,21,287,1,286,1,1,0,1,1,144,143,143,143,34
"3081",80,"[21]goIoHcoxHnJHGqKCmEInw",282,0.996466,21,283,1,282,1,1,0,1,1,141,140,142,142,34
"3082",81,"[21]goIoHcoxHnJHGqKCmEInw",291,0.996575,21,292,1,291,1,1,0,1,1,158,157,134,134,34
"3083",82,"[21]goIoHcoxHnJHGqKCmEInw",280,0.996441,21,281,1,280,1,1,0,1,1,136,135,145,145,34
"3084",83,"[21]goIoHcoxHnJHGqKCmEInw",280,0.996441,21,281,1,280,1,1,0,1,1,136,135,145,145,34
"3085",84,"[21]goIoHcoxHnJHGqKCmEInw",288,0.99654,21,289,1,288,1,1,0,1,1,131,130,158,158,34
"3086",85,"[21]goIoHcoxHnJHGqKCmEInw",276,0.99639,21,277,1,276,1,1,0,1,1,144,143,133,133,34
"3087",86,"[21]goIoHcoxHnJHGqKCmEInw",277,0.996403,21,278,1,277,1,1,0,1,1,134,133,144,144,34
"3088",87,"[21]goIoHcoxHnJHGqKCmEInw",275,0.996377,21,276,1,275,1,1,0,1,1,136,135,140,140,34
"3089",88,"[21]goIoHcoxHnJHGqKCmEInw",280,0.996441,21,281,1,280,1,1,0,1,1,124,123,157,157,34
"3090",89,"[21]goIoHcoxHnJHGqKCmEInw",284,0.996491,21,285,1,284,1,1,0,1,1,147,146,138,138,34
"3091",90,"[21]goIoHcoxHnJHGqKCmEInw",280,0.996441,21,281,1,280,1,1,0,1,1,160,159,121,121,34
"3092",91,"[21]goIoHcoxHnJHGqKCmEInw",276,0.99639,21,277,1,276,1,1,0,1,1,140,139,137,137,34
"3093",92,"[21]goIoHcoxHnJHGqKCmEInw",278,0.996416,21,279,1,278,1,1,0,1,1,128,127,151,151,34
"3094",93,"[21]goIoHcoxHnJHGqKCmEInw",289,0.996552,21,290,1,289,1,1,0,1,1,149,148,141,141,34
"3095",94,"[21]goIoHcoxHnJHGqKCmEInw",282,0.996466,21,283,1,282,1,1,0,1,1,152,151,131,131,34
"3096",95,"[21]goIoHcoxHnJHGqKCmEInw",270,0.99631,21,271,1,270,1,1,0,1,1,110,109,161,161,34
"3097",96,"[21]goIoHcoxHnJHGqKCmEInw",288,0.99654,21,289,1,288,1,1,0,1,1,144,143,145,145,34
"3098",97,"[21]goIoHcoxHnJHGqKCmEInw",280,0.996441,21,281,1,280,1,1,0,1,1,152,151,129,129,34
"3099",98,"[21]goIoHcoxHnJHGqKCmEInw",285,0.996503,21,286,1,285,1,1,0,1,1,138,137,148,148,34
"3100",99,"[21]goIoHcoxHnJHGqKCmEInw",283,0.996479,21,284,1,283,1,1,0,1,1,124,123,160,160,34
"3101",0,"[25]loIoHcovHnJHGqKCusnCEEreJ",273,0.99635,25,274,1,273,1,1,0,1,1,125,124,149,149,35
"3102",1,"[25]loIoHcovHnJHGqKCusnCEEreJ",279,0.996429,25,280,1,279,1,1,0,1,1,151,150,129,129,35
"3103",2,"[25]loIoHcovHnJHGqKCusnCEEreJ",286,0.996516,25,287,1,286,1,1,0,1,1,129,128,158,158,35
"3104",3,"[25]loIoHcovHnJHGqKCusnCEEreJ",287,0.996528,25,288,1,287,1,1,0,1,1,149,148,139,139,35
"3105",4,"[25]loIoHcovHnJHGqKCusnCEEreJ",282,0.996466,25,283,1,282,1,1,0,1,1,150,149,133,133,35
"3106",5,"[25]loIoHcovHnJHGqKCusnCEEreJ",281,0.996454,25,282,1,281,1,1,0,1,1,129,128,153,153,35
"3107",6,"[25]loIoHcovHnJHGqKCusnCEEreJ",282,0.996466,25,283,1,282,1,1,0,1,1,151,150,132,132,35
"3108",7,"[25]loIoHcovHnJHGqKCusnCEEreJ",279,0.996429,25,280,1,279,1,1,0,1,1,139,138,141,141,35
"3109",8,"[25]loIoHcovHnJHGqKCusnCEEreJ",277,0.996403,25,278,1,277,1,1,0,1,1,139,138,139,139,35
"3110",9,"[25]loIoHcovHnJHGqKCusnCEEreJ",289,0.996552,25,290,1,289,1,1,0,1,1,149,148,141,141,35
"3111",10,"[25]loIoHcovHnJHGqKCusnCEEreJ",277,0.996403,25,278,1,277,1,1,0,1,1,158,157,120,120,35
"3112",11,"[25]loIoHcovHnJHGqKCusnCEEreJ",278,0.996416,25,279,1,278,1,1,0,1,1,127,126,152,152,35
"3113",12,"[25]loIoHcovHnJHGqKCusnCEEreJ",274,0.996364,25,275,1,274,1,1,0,1,1,122,121,153,153,35
"3114",13,"[25]loIoHcovHnJHGqKCusnCEEreJ",280,0.996441,25,281,1,280,1,1,0,1,1,138,137,143,143,35
"3115",14,"[25]loIoHcovHnJHGqKCusnCEEreJ",280,0.996441,25,281,1,280,1,1,0,1,1,126,125,155,155,35
"3116",15,"[25]loIoHcovHnJHGqKCusnCEEreJ",289,0.996552,25,290,1,289,1,1,0,1,1,155,154,135,135,35
"3117",16,"[25]loIoHcovHnJHGqKCusnCEEreJ",273,0.99635,25,274,1,273,1,1,0,1,1,131,130,143,143,35
"3118",17,"[25]loIoHcovHnJHGqKCusnCEEreJ",279,0.996429,25,280,1,279,1,1,0,1,1,148,147,132,132,35
"3119",18,"[25]loIoHcovHnJHGqKCusnCEEreJ",280,0.996441,25,281,1,280,1,1,0,1,1,130,129,151,151,35
"3120",19,"[25]loIoHcovHnJHGqKCusnCEEreJ",280,0.996441,25,281,1,280,1,1,0,1,1,151,150,130,130,35
"3121",20,"[25]loIoHcovHnJHGqKCusnCEEreJ",275,0.996377,25,276,1,275,1,1,0,1,1,135,134,141,141,35
"3122",21,"[25]loIoHcovHnJHGqKCusnCEEreJ",279,0.996429,25,280,1,279,1,1,0,1,1,156,155,124,124,35
"3123",22,"[25]loIoHcovHnJHGqKCusnCEEreJ",286,0.996516,25,287,1,286,1,1,0,1,1,159,158,128,128,35
"3124",23,"[25]loIoHcovHnJHGqKCusnCEEreJ",277,0.996403,25,278,1,277,1,1,0,1,1,149,148,129,129,35
"3125",24,"[25]loIoHcovHnJHGqKCusnCEEreJ",280,0.996441,25,281,1,280,1,1,0,1,1,138,137,143,143,35
"3126",25,"[25]loIoHcovHnJHGqKCusnCEEreJ",283,0.996479,25,284,1,283,1,1,0,1,1,154,153,130,130,35
"3127",26,"[25]loIoHcovHnJHGqKCusnCEEreJ",287,0.996528,25,288,1,287,1,1,0,1,1,142,141,146,146,35
"3128",27,"[25]loIoHcovHnJHGqKCusnCEEreJ",278,0.996416,25,279,1,278,1,1,0,1,1,141,140,138,138,35
"3129",28,"[25]loIoHcovHnJHGqKCusnCEEreJ",283,0.996479,25,284,1,283,1,1,0,1,1,150,149,134,134,35
"3130",29,"[25]loIoHcovHnJHGqKCusnCEEreJ",287,0.996528,25,288,1,287,1,1,0,1,1,152,151,136,136,35
"3131",30,"[25]loIoHcovHnJHGqKCusnCEEreJ",284,0.996491,25,285,1,284,1,1,0,1,1,149,148,136,136,35
"3132",31,"[25]loIoHcovHnJHGqKCusnCEEreJ",279,0.996429,25,280,1,279,1,1,0,1,1,147,146,133,133,35
"3133",32,"[25]loIoHcovHnJHGqKCusnCEEreJ",282,0.996466,25,283,1,282,1,1,0,1,1,130,129,153,153,35
"3134",33,"[25]loIoHcovHnJHGqKCusnCEEreJ",288,0.99654,25,289,1,288,1,1,0,1,1,151,150,138,138,35
"3135",34,"[25]loIoHcovHnJHGqKCusnCEEreJ",284,0.996491,25,285,1,284,1,1,0,1,1,154,153,131,131,35
"3136",35,"[25]loIoHcovHnJHGqKCusnCEEreJ",276,0.99639,25,277,1,276,1,1,0,1,1,149,148,128,128,35
"3137",36,"[25]loIoHcovHnJHGqKCusnCEEreJ",277,0.996403,25,278,1,277,1,1,0,1,1,143,142,135,135,35
"3138",37,"[25]loIoHcovHnJHGqKCusnCEEreJ",277,0.996403,25,278,1,277,1,1,0,1,1,128,127,150,150,35
"3139",38,"[25]loIoHcovHnJHGqKCusnCEEreJ",280,0.996441,25,281,1,280,1,1,0,1,1,132,131,149,149,35
"3140",39,"[25]loIoHcovHnJHGqKCusnCEEreJ",280,0.996441,25,281,1,280,1,1,0,1,1,129,128,152,152,35
"3141",40,"[25]loIoHcovHnJHGqKCusnCEEreJ",279,0.996429,25,280,1,279,1,1,0,1,1,147,146,133,133,35
"3142",41,"[25]loIoHcovHnJHGqKCusnCEEreJ",280,0.996441,25,281,1,280,1,1,0,1,1,139,138,142,142,35
"3143",42,"[25]loIoHcovHnJHGqKCusnCEEreJ",281,0.996454,25,282,1,281,1,1,0,1,1,137,136,145,145,35
"3144",43,"[25]loIoHcovHnJHGqKCusnCEEreJ",279,0.996429,25,280,1,279,1,1,0,1,1,133,132,147,147,35
"3145",44,"[25]loIoHcovHnJHGqKCusnCEEreJ",289,0.996552,25,290,1,289,1,1,0,1,1,147,146,143,143,35
"3146",45,"[25]loIoHcovHnJHGqKCusnCEEreJ",287,0.996528,25,288,1,287,1,1,0,1,1,137,136,151,151,35
"3147",46,"[25]loIoHcovHnJHGqKCusnCEEreJ",286,0.996516,25,287,1,286,1,1,0,1,1,131,130,156,156,35
"3148",47,"[25]loIoHcovHnJHGqKCusnCEEreJ",275,0.996377,25,276,1,275,1,1,0,1,1,116,115,160,160,35
"3149",48,"[25]loIoHcovHnJHGqKCusnCEEreJ",281,0.996454,25,282,1,281,1,1,0,1,1,147,146,135,135,35
"3150",49,"[25]loIoHcovHnJHGqKCusnCEEreJ",280,0.996441,25,281,1,280,1,1,0,1,1,137,136,144,144,35
"3151",50,"[25]loIoHcovHnJHGqKCusnCEEreJ",282,0.996466,25,283,1,282,1,1,0,1,1,148,147,135,135,35
"3152",51,"[25]loIoHcovHnJHGqKCusnCEEreJ",277,0.996403,25,278,1,277,1,1,0,1,1,131,130,147,147,35
"3153",52,"[25]loIoHcovHnJHGqKCusnCEEreJ",283,0.996479,25,284,1,283,1,1,0,1,1,150,149,134,134,35
"3154",53,"[25]loIoHcovHnJHGqKCusnCEEreJ",279,0.996429,25,280,1,279,1,1,0,1,1,144,143,136,136,35
"3155",54,"[25]loIoHcovHnJHGqKCusnCEEreJ",278,0.996416,25,279,1,278,1,1,0,1,1,130,129,149,149,35
"3156",55,"[25]loIoHcovHnJHGqKCusnCEEreJ",287,0.996528,25,288,1,287,1,1,0,1,1,138,137,150,150,35
"3157",56,"[25]loIoHcovHnJHGqKCusnCEEreJ",283,0.996479,25,284,1,283,1,1,0,1,1,145,144,139,139,35
"3158",57,"[25]loIoHcovHnJHGqKCusnCEEreJ",282,0.996466,25,283,1,282,1,1,0,1,1,152,151,131,131,35
"3159",58,"[25]loIoHcovHnJHGqKCusnCEEreJ",291,0.996575,25,292,1,291,1,1,0,1,1,160,159,132,132,35
"3160",59,"[25]loIoHcovHnJHGqKCusnCEEreJ",283,0.996479,25,284,1,283,1,1,0,1,1,140,139,144,144,35
"3161",60,"[25]loIoHcovHnJHGqKCusnCEEreJ",278,0.996416,25,279,1,278,1,1,0,1,1,138,137,141,141,35
"3162",61,"[25]loIoHcovHnJHGqKCusnCEEreJ",283,0.996479,25,284,1,283,1,1,0,1,1,143,142,141,141,35
"3163",62,"[25]loIoHcovHnJHGqKCusnCEEreJ",277,0.996403,25,278,1,277,1,1,0,1,1,123,122,155,155,35
"3164",63,"[25]loIoHcovHnJHGqKCusnCEEreJ",285,0.996503,25,286,1,285,1,1,0,1,1,152,151,134,134,35
"3165",64,"[25]loIoHcovHnJHGqKCusnCEEreJ",278,0.996416,25,279,1,278,1,1,0,1,1,141,140,138,138,35
"3166",65,"[25]loIoHcovHnJHGqKCusnCEEreJ",292,0.996587,25,293,1,292,1,1,0,1,1,162,161,131,131,35
"3167",66,"[25]loIoHcovHnJHGqKCusnCEEreJ",286,0.996516,25,287,1,286,1,1,0,1,1,154,153,133,133,35
"3168",67,"[25]loIoHcovHnJHGqKCusnCEEreJ",282,0.996466,25,283,1,282,1,1,0,1,1,146,145,137,137,35
"3169",68,"[25]loIoHcovHnJHGqKCusnCEEreJ",274,0.996364,25,275,1,274,1,1,0,1,1,142,141,133,133,35
"3170",69,"[25]loIoHcovHnJHGqKCusnCEEreJ",282,0.996466,25,283,1,282,1,1,0,1,1,147,146,136,136,35
"3171",70,"[25]loIoHcovHnJHGqKCusnCEEreJ",277,0.996403,25,278,1,277,1,1,0,1,1,133,132,145,145,35
"3172",71,"[25]loIoHcovHnJHGqKCusnCEEreJ",286,0.996516,25,287,1,286,1,1,0,1,1,144,143,143,143,35
"3173",72,"[25]loIoHcovHnJHGqKCusnCEEreJ",280,0.996441,25,281,1,280,1,1,0,1,1,136,135,145,145,35
"3174",73,"[25]loIoHcovHnJHGqKCusnCEEreJ",287,0.996528,25,288,1,287,1,1,0,1,1,141,140,147,147,35
"3175",74,"[25]loIoHcovHnJHGqKCusnCEEreJ",275,0.996377,25,276,1,275,1,1,0,1,1,132,131,144,144,35
"3176",75,"[25]loIoHcovHnJHGqKCusnCEEreJ",280,0.996441,25,281,1,280,1,1,0,1,1,135,134,146,146,35
"3177",76,"[25]loIoHcovHnJHGqKCusnCEEreJ",283,0.996479,25,284,1,283,1,1,0,1,1,153,152,131,131,35
"3178",77,"[25]loIoHcovHnJHGqKCusnCEEreJ",273,0.99635,25,274,1,273,1,1,0,1,1,132,131,142,142,35
"3179",78,"[25]loIoHcovHnJHGqKCusnCEEreJ",286,0.996516,25,287,1,286,1,1,0,1,1,143,142,144,144,35
"3180",79,"[25]loIoHcovHnJHGqKCusnCEEreJ",279,0.996429,25,280,1,279,1,1,0,1,1,139,138,141,141,35
"3181",80,"[25]loIoHcovHnJHGqKCusnCEEreJ",287,0.996528,25,288,1,287,1,1,0,1,1,152,151,136,136,35
"3182",81,"[25]loIoHcovHnJHGqKCusnCEEreJ",280,0.996441,25,281,1,280,1,1,0,1,1,157,156,124,124,35
"3183",82,"[25]loIoHcovHnJHGqKCusnCEEreJ",276,0.99639,25,277,1,276,1,1,0,1,1,145,144,132,132,35
"3184",83,"[25]loIoHcovHnJHGqKCusnCEEreJ",280,0.996441,25,281,1,280,1,1,0,1,1,134,133,147,147,35
"3185",84,"[25]loIoHcovHnJHGqKCusnCEEreJ",290,0.996564,25,291,1,290,1,1,0,1,1,146,145,145,145,35
"3186",85,"[25]loIoHcovHnJHGqKCusnCEEreJ",285,0.996503,25,286,1,285,1,1,0,1,1,136,135,150,150,35
"3187",86,"[25]loIoHcovHnJHGqKCusnCEEreJ",276,0.99639,25,277,1,276,1,1,0,1,1,125,124,152,152,35
"3188",87,"[25]loIoHcovHnJHGqKCusnCEEreJ",280,0.996441,25,281,1,280,1,1,0,1,1,148,147,133,133,35
"3189",88,"[25]loIoHcovHnJHGqKCusnCEEreJ",279,0.996429,25,280,1,279,1,1,0,1,1,128,127,152,152,35
"3190",89,"[25]loIoHcovHnJHGqKCusnCEEreJ",284,0.996491,25,285,1,284,1,1,0,1,1,133,132,152,152,35
"3191",90,"[25]loIoHcovHnJHGqKCusnCEEreJ",287,0.996528,25,288,1,287,1,1,0,1,1,143,142,145,145,35
"3192",91,"[25]loIoHcovHnJHGqKCusnCEEreJ",288,0.99654,25,289,1,288,1,1,0,1,1,151,150,138,138,35
"3193",92,"[25]loIoHcovHnJHGqKCusnCEEreJ",284,0.996491,25,285,1,284,1,1,0,1,1,151,150,134,134,35
"3194",93,"[25]loIoHcovHnJHGqKCusnCEEreJ",289,0.996552,25,290,1,289,1,1,0,1,1,156,155,134,134,35
"3195",94,"[25]loIoHcovHnJHGqKCusnCEEreJ",280,0.996441,25,281,1,280,1,1,0,1,1,149,148,132,132,35
"3196",95,"[25]loIoHcovHnJHGqKCusnCEEreJ",286,0.996516,25,287,1,286,1,1,0,1,1,140,139,147,147,35
"3197",96,"[25]loIoHcovHnJHGqKCusnCEEreJ",271,0.996324,25,272,1,271,1,1,0,1,1,124,123,148,148,35
"3198",97,"[25]loIoHcovHnJHGqKCusnCEEreJ",277,0.996403,25,278,1,277,1,1,0,1,1,141,140,137,137,35
"3199",98,"[25]loIoHcovHnJHGqKCusnCEEreJ",280,0.996441,25,281,1,280,1,1,0,1,1,163,162,118,118,35
"3200",99,"[25]loIoHcovHnJHGqKCusnCEEreJ",281,0.996454,25,282,1,281,1,1,0,1,1,133,132,149,149,35
"3201",0,"[26]tkHoIFoHcoxHnJHGqKCgetJilq",286,0.996516,26,287,1,286,1,1,0,1,1,153,152,134,134,36
"3202",1,"[26]tkHoIFoHcoxHnJHGqKCgetJilq",273,0.99635,26,274,1,273,1,1,0,1,1,127,126,147,147,36
"3203",2,"[26]tkHoIFoHcoxHnJHGqKCgetJilq",275,0.996377,26,276,1,275,1,1,0,1,1,133,132,143,143,36
"3204",3,"[26]tkHoIFoHcoxHnJHGqKCgetJilq",276,0.99639,26,277,1,276,1,1,0,1,1,128,127,149,149,36
"3205",4,"[26]tkHoIFoHcoxHnJHGqKCgetJilq",280,0.996441,26,281,1,280,1,1,0,1,1,126,125,155,155,36
"3206",5,"[26]tkHoIFoHcoxHnJHGqKCgetJilq",288,0.99654,26,289,1,288,1,1,0,1,1,142,141,147,147,36
"3207",6,"[26]tkHoIFoHcoxHnJHGqKCgetJilq",286,0.996516,26,287,1,286,1,1,0,1,1,161,160,126,126,36
"3208",7,"[26]tkHoIFoHcoxHnJHGqKCgetJilq",278,0.996416,26,279,1,278,1,1,0,1,1,127,126,152,152,36
"3209",8,"[26]tkHoIFoHcoxHnJHGqKCgetJilq",276,0.99639,26,277,1,276,1,1,0,1,1,141,140,136,136,36
"3210",9,"[26]tkHoIFoHcoxHnJHGqKCgetJilq",279,0.996429,26,280,1,279,1,1,0,1,1,149,148,131,131,36
"3211",10,"[26]tkHoIFoHcoxHnJHGqKCgetJilq",283,0.996479,26,284,1,283,1,1,0,1,1,146,145,138,138,36
"3212",11,"[26]tkHoIFoHcoxHnJHGqKCgetJilq",277,0.996403,26,278,1,277,1,1,0,1,1,137,136,141,141,36
"3213",12,"[26]tkHoIFoHcoxHnJHGqKCgetJilq",279,0.996429,26,280,1,279,1,1,0,1,1,124,123,156,156,36
"3214",13,"[26]tkHoIFoHcoxHnJHGqKCgetJilq",284,0.996491,26,285,1,284,1,1,0,1,1,132,131,153,153,36
"3215",14,"[26]tkHoIFoHcoxHnJHGqKCgetJilq",281,0.996454,26,282,1,281,1,1,0,1,1,149,148,133,133,36
"3216",15,"[26]tkHoIFoHcoxHnJHGqKCgetJilq",283,0.996479,26,284,1,283,1,1,0,1,1,140,139,144,144,36
"3217",16,"[26]tkHoIFoHcoxHnJHGqKCgetJilq",283,0.996479,26,284,1,283,1,1,0,1,1,146,145,138,138,36
"3218",17,"[26]tkHoIFoHcoxHnJHGqKCgetJilq",282,0.996466,26,283,1,282,1,1,0,1,1,146,145,137,137,36
"3219",18,"[26]tkHoIFoHcoxHnJHGqKCgetJilq",281,0.996454,26,282,1,281,1,1,0,1,1,143,142,139,139,36
"3220",19,"[26]tkHoIFoHcoxHnJHGqKCgetJilq",284,0.996491,26,285,1,284,1,1,0,1,1,149,148,136,136,36
"3221",20,"[26]tkHoIFoHcoxHnJHGqKCgetJilq",281,0.996454,26,282,1,281,1,1,0,1,1,153,152,129,129,36
"3222",21,"[26]tkHoIFoHcoxHnJHGqKCgetJilq",278,0.996416,26,279,1,278,1,1,0,1,1,130,129,149,149,36
"3223",22,"[26]tkHoIFoHcoxHnJHGqKCgetJilq",288,0.99654,26,289,1,288,1,1,0,1,1,141,140,148,148,36
"3224",23,"[26]tkHoIFoHcoxHnJHGqKCgetJilq",270,0.99631,26,271,1,270,1,1,0,1,1,144,143,127,127,36
"3225",24,"[26]tkHoIFoHcoxHnJHGqKCgetJilq",291,0.996575,26,292,1,291,1,1,0,1,1,151,150,141,141,36
"3226",25,"[26]tkHoIFoHcoxHnJHGqKCgetJilq",286,0.996516,26,287,1,286,1,1,0,1,1,144,143,143,143,36
"3227",26,"[26]tkHoIFoHcoxHnJHGqKCgetJilq",277,0.996403,26,278,1,277,1,1,0,1,1,163,162,115,115,36
"3228",27,"[26]tkHoIFoHcoxHnJHGqKCgetJilq",283,0.996479,26,284,1,283,1,1,0,1,1,141,140,143,143,36
"3229",28,"[26]tkHoIFoHcoxHnJHGqKCgetJilq",290,0.996564,26,291,1,290,1,1,0,1,1,148,147,143,143,36
"3230",29,"[26]tkHoIFoHcoxHnJHGqKCgetJilq",274,0.996364,26,275,1,274,1,1,0,1,1,128,127,147,147,36
"3231",30,"[26]tkHoIFoHcoxHnJHGqKCgetJilq",279,0.996429,26,280,1,279,1,1,0,1,1,139,138,141,141,36
"3232",31,"[26]tkHoIFoHcoxHnJHGqKCgetJilq",279,0.996429,26,280,1,279,1,1,0,1,1,133,132,147,147,36
"3233",32,"[26]tkHoIFoHcoxHnJHGqKCgetJilq",281,0.996454,26,282,1,281,1,1,0,1,1,147,146,135,135,36
"3234",33,"[26]tkHoIFoHcoxHnJHGqKCgetJilq",287,0.996528,26,288,1,287,1,1,0,1,1,160,159,128,128,36
"3235",34,"[26]tkHoIFoHcoxHnJHGqKCgetJilq",285,0.996503,26,286,1,285,1,1,0,1,1,142,141,144,144,36
"3236",35,"[26]tkHoIFoHcoxHnJHGqKCgetJilq",281,0.996454,26,282,1,281,1,1,0,1,1,154,153,128,128,36
"3237",36,"[26]tkHoIFoHcoxHnJHGqKCgetJilq",280,0.996441,26,281,1,280,1,1,0,1,1,139,138,142,142,36
"3238",37,"[26]tkHoIFoHcoxHnJHGqKCgetJilq",282,0.996466,26,283,1,282,1,1,0,1,1,149,148,134,134,36
"3239",38,"[26]tkHoIFoHcoxHnJHGqKCgetJilq",277,0.996403,26,278,1,277,1,1,0,1,1,141,140,137,137,36
"3240",39,"[26]tkHoIFoHcoxHnJHGqKCgetJilq",279,0.996429,26,280,1,279,1,1,0,1,1,137,136,143,143,36
"3241",40,"[26]tkHoIFoHcoxHnJHGqKCgetJilq",279,0.996429,26,280,1,279,1,1,0,1,1,126,125,154,154,36
"3242",41,"[26]tkHoIFoHcoxHnJHGqKCgetJilq",282,0.996466,26,283,1,282,1,1,0,1,1,139,138,144,144,36
"3243",42,"[26]tkHoIFoHcoxHnJHGqKCgetJilq",284,0.996491,26,285,1,284,1,1,0,1,1,152,151,133,133,36
"3244",43,"[26]tkHoIFoHcoxHnJHGqKCgetJilq",281,0.996454,26,282,1,281,1,1,0,1,1,135,134,147,147,36
"3245",44,"[26]tkHoIFoHcoxHnJHGqKCgetJilq",282,0.996466,26,283,1,282,1,1,0,1,1,136,135,147,147,36
"3246",45,"[26]tkHoIFoHcoxHnJHGqKCgetJilq",276,0.99639,26,277,1,276,1,1,0,1,1,133,132,144,144,36
"3247",46,"[26]tkHoIFoHcoxHnJHGqKCgetJilq",274,0.996364,26,275,1,274,1,1,0,1,1,149,148,126,126,36
"3248",47,"[26]tkHoIFoHcoxHnJHGqKCgetJilq",276,0.99639,26,277,1,276,1,1,0,1,1,133,132,144,144,36
"3249",48,"[26]tkHoIFoHcoxHnJHGqKCgetJilq",285,0.996503,26,286,1,285,1,1,0,1,1,162,161,124,124,36
"3250",49,"[26]tkHoIFoHcoxHnJHGqKCgetJilq",274,0.996364,26,275,1,274,1,1,0,1,1,138,137,137,137,36
"3251",50,"[26]tkHoIFoHcoxHnJHGqKCgetJilq",277,0.996403,26,278,1,277,1,1,0,1,1,130,129,148,148,36
"3252",51,"[26]tkHoIFoHcoxHnJHGqKCgetJilq",283,0.996479,26,284,1,283,1,1,0,1,1,143,142,141,141,36
"3253",52,"[26]tkHoIFoHcoxHnJHGqKCgetJilq",282,0.996466,26,283,1,282,1,1,0,1,1,145,144,138,138,36
"3254",53,"[26]tkHoIFoHcoxHnJHGqKCgetJilq",290,0.996564,26,291,1,290,1,1,0,1,1,141,140,150,150,36
"3255",54,"[26]tkHoIFoHcoxHnJHGqKCgetJilq",276,0.99639,26,277,1,276,1,1,0,1,1,128,127,149,149,36
"3256",55,"[26]tkHoIFoHcoxHnJHGqKCgetJilq",280,0.996441,26,281,1,280,1,1,0,1,1,146,145,135,135,36
"3257",56,"[26]tkHoIFoHcoxHnJHGqKCgetJilq",281,0.996454,26,282,1,281,1,1,0,1,1,152,151,130,130,36
"3258",57,"[26]tkHoIFoHcoxHnJHGqKCgetJilq",281,0.996454,26,282,1,281,1,1,0,1,1,138,137,144,144,36
"3259",58,"[26]tkHoIFoHcoxHnJHGqKCgetJilq",285,0.996503,26,286,1,285,1,1,0,1,1,149,148,137,137,36
"3260",59,"[26]tkHoIFoHcoxHnJHGqKCgetJilq",282,0.996466,26,283,1,282,1,1,0,1,1,149,148,134,134,36
"3261",60,"[26]tkHoIFoHcoxHnJHGqKCgetJilq",275,0.996377,26,276,1,275,1,1,0,1,1,151,150,125,125,36
"3262",61,"[26]tkHoIFoHcoxHnJHGqKCgetJilq",288,0.99654,26,289,1,288,1,1,0,1,1,147,146,142,142,36
"3263",62,"[26]tkHoIFoHcoxHnJHGqKCgetJilq",288,0.99654,26,289,1,288,1,1,0,1,1,148,147,141,141,36
"3264",63,"[26]tkHoIFoHcoxHnJHGqKCgetJilq",278,0.996416,26,279,1,278,1,1,0,1,1,114,113,165,165,36
"3265",64,"[26]tkHoIFoHcoxHnJHGqKCgetJilq",277,0.996403,26,278,1,277,1,1,0,1,1,144,143,134,134,36
"3266",65,"[26]tkHoIFoHcoxHnJHGqKCgetJilq",277,0.996403,26,278,1,277,1,1,0,1,1,124,123,154,154,36
"3267",66,"[26]tkHoIFoHcoxHnJHGqKCgetJilq",283,0.996479,26,284,1,283,1,1,0,1,1,142,141,142,142,36
"3268",67,"[26]tkHoIFoHcoxHnJHGqKCgetJilq",275,0.996377,26,276,1,275,1,1,0,1,1,139,138,137,137,36
"3269",68,"[26]tkHoIFoHcoxHnJHGqKCgetJilq",280,0.996441,26,281,1,280,1,1,0,1,1,131,130,150,150,36
"3270",69,"[26]tkHoIFoHcoxHnJHGqKCgetJilq",279,0.996429,26,280,1,279,1,1,0,1,1,139,138,141,141,36
"3271",70,"[26]tkHoIFoHcoxHnJHGqKCgetJilq",284,0.996491,26,285,1,284,1,1,0,1,1,147,146,138,138,36
"3272",71,"[26]tkHoIFoHcoxHnJHGqKCgetJilq",282,0.996466,26,283,1,282,1,1,0,1,1,138,137,145,145,36
"3273",72,"[26]tkHoIFoHcoxHnJHGqKCgetJilq",280,0.996441,26,281,1,280,1,1,0,1,1,136,135,145,145,36
"3274",73,"[26]tkHoIFoHcoxHnJHGqKCgetJilq",285,0.996503,26,286,1,285,1,1,0,1,1,156,155,130,130,36
"3275",74,"[26]tkHoIFoHcoxHnJHGqKCgetJilq",279,0.996429,26,280,1,279,1,1,0,1,1,142,141,138,138,36
"3276",75,"[26]tkHoIFoHcoxHnJHGqKCgetJilq",281,0.996454,26,282,1,281,1,1,0,1,1,139,138,143,143,36
"3277",76,"[26]tkHoIFoHcoxHnJHGqKCgetJilq",278,0.996416,26,279,1,278,1,1,0,1,1,137,136,142,142,36
"3278",77,"[26]tkHoIFoHcoxHnJHGqKCgetJilq",284,0.996491,26,285,1,284,1,1,0,1,1,153,152,132,132,36
"3279",78,"[26]tkHoIFoHcoxHnJHGqKCgetJilq",280,0.996441,26,281,1,280,1,1,0,1,1,135,134,146,146,36
"3280",79,"[26]tkHoIFoHcoxHnJHGqKCgetJilq",278,0.996416,26,279,1,278,1,1,0,1,1,132,131,147,147,36
"3281",80,"[26]tkHoIFoHcoxHnJHGqKCgetJilq",274,0.996364,26,275,1,274,1,1,0,1,1,121,120,154,154,36
"3282",81,"[26]tkHoIFoHcoxHnJHGqKCgetJilq",285,0.996503,26,286,1,285,1,1,0,1,1,140,139,146,146,36
"3283",82,"[26]tkHoIFoHcoxHnJHGqKCgetJilq",279,0.996429,26,280,1,279,1,1,0,1,1,141,140,139,139,36
"3284",83,"[26]tkHoIFoHcoxHnJHGqKCgetJilq",281,0.996454,26,282,1,281,1,1,0,1,1,137,136,145,145,36
"3285",84,"[26]tkHoIFoHcoxHnJHGqKCgetJilq",286,0.996516,26,287,1,286,1,1,0,1,1,168,167,119,119,36
"3286",85,"[26]tkHoIFoHcoxHnJHGqKCgetJilq",279,0.996429,26,280,1,279,1,1,0,1,1,143,142,137,137,36
"3287",86,"[26]tkHoIFoHcoxHnJHGqKCgetJilq",284,0.996491,26,285,1,284,1,1,0,1,1,141,140,144,144,36
"3288",87,"[26]tkHoIFoHcoxHnJHGqKCgetJilq",279,0.996429,26,280,1,279,1,1,0,1,1,152,151,128,128,36
"3289",88,"[26]tkHoIFoHcoxHnJHGqKCgetJilq",282,0.996466,26,283,1,282,1,1,0,1,1,140,139,143,143,36
"3290",89,"[26]tkHoIFoHcoxHnJHGqKCgetJilq",275,0.996377,26,276,1,275,1,1,0,1,1,150,149,126,126,36
"3291",90,"[26]tkHoIFoHcoxHnJHGqKCgetJilq",276,0.99639,26,277,1,276,1,1,0,1,1,145,144,132,132,36
"3292",91,"[26]tkHoIFoHcoxHnJHGqKCgetJilq",277,0.996403,26,278,1,277,1,1,0,1,1,139,138,139,139,36
"3293",92,"[26]tkHoIFoHcoxHnJHGqKCgetJilq",272,0.996337,26,273,1,272,1,1,0,1,1,144,143,129,129,36
"3294",93,"[26]tkHoIFoHcoxHnJHGqKCgetJilq",283,0.996479,26,284,1,283,1,1,0,1,1,142,141,142,142,36
"3295",94,"[26]tkHoIFoHcoxHnJHGqKCgetJilq",280,0.996441,26,281,1,280,1,1,0,1,1,147,146,134,134,36
"3296",95,"[26]tkHoIFoHcoxHnJHGqKCgetJilq",276,0.99639,26,277,1,276,1,1,0,1,1,145,144,132,132,36
"3297",96,"[26]tkHoIFoHcoxHnJHGqKCgetJilq",282,0.996466,26,283,1,282,1,1,0,1,1,140,139,143,143,36
"3298",97,"[26]tkHoIFoHcoxHnJHGqKCgetJilq",278,0.996416,26,279,1,278,1,1,0,1,1,142,141,137,137,36
"3299",98,"[26]tkHoIFoHcoxHnJHGqKCgetJilq",280,0.996441,26,281,1,280,1,1,0,1,1,154,153,127,127,36
"3300",99,"[26]tkHoIFoHcoxHnJHGqKCgetJilq",285,0.996503,26,286,1,285,1,1,0,1,1,153,152,133,133,36
"3301",0,"[26]goIAGoHcovHnJHGqKCovppqKzf",287,0.996528,26,288,1,287,1,1,0,1,1,154,153,134,134,37
"3302",1,"[26]goIAGoHcovHnJHGqKCovppqKzf",276,0.99639,26,277,1,276,1,1,0,1,1,139,138,138,138,37
"3303",2,"[26]goIAGoHcovHnJHGqKCovppqKzf",279,0.996429,26,280,1,279,1,1,0,1,1,141,140,139,139,37
"3304",3,"[26]goIAGoHcovHnJHGqKCovppqKzf",285,0.996503,26,286,1,285,1,1,0,1,1,146,145,140,140,37
"3305",4,"[26]goIAGoHcovHnJHGqKCovppqKzf",285,0.996503,26,286,1,285,1,1,0,1,1,145,144,141,141,37
"3306",5,"[26]goIAGoHcovHnJHGqKCovppqKzf",284,0.996491,26,285,1,284,1,1,0,1,1,149,148,136,136,37
"3307",6,"[26]goIAGoHcovHnJHGqKCovppqKzf",276,0.99639,26,277,1,276,1,1,0,1,1,147,146,130,130,37
"3308",7,"[26]goIAGoHcovHnJHGqKCovppqKzf",275,0.996377,26,276,1,275,1,1,0,1,1,139,138,137,137,37
"3309",8,"[26]goIAGoHcovHnJHGqKCovppqKzf",278,0.996416,26,279,1,278,1,1,0,1,1,149,148,130,130,37
"3310",9,"[26]goIAGoHcovHnJHGqKCovppqKzf",280,0.996441,26,281,1,280,1,1,0,1,1,154,153,127,127,37
"3311",10,"[26]goIAGoHcovHnJHGqKCovppqKzf",280,0.996441,26,281,1,280,1,1,0,1,1,132,131,149,149,37
"3312",11,"[26]goIAGoHcovHnJHGqKCovppqKzf",280,0.996441,26,281,1,280,1,1,0,1,1,149,148,132,132,37
"3313",12,"[26]goIAGoHcovHnJHGqKCovppqKzf",278,0.996416,26,279,1,278,1,1,0,1,1,127,126,152,152,37
"3314",13,"[26]goIAGoHcovHnJHGqKCovppqKzf",282,0.996466,26,283,1,282,1,1,0,1,1,130,129,153,153,37
"3315",14,"[26]goIAGoHcovHnJHGqKCovppqKzf",279,0.996429,26,280,1,279,1,1,0,1,1,136,135,144,144,37
"3316",15,"[26]goIAGoHcovHnJHGqKCovppqKzf",273,0.99635,26,274,1,273,1,1,0,1,1,127,126,147,147,37
"3317",16,"[26]goIAGoHcovHnJHGqKCovppqKzf",281,0.996454,26,282,1,281,1,1,0,1,1,134,133,148,148,37
"3318",17,"[26]goIAGoHcovHnJHGqKCovppqKzf",290,0.996564,26,291,1,290,1,1,0,1,1,166,165,125,125,37
"3319",18,"[26]goIAGoHcovHnJHGqKCovppqKzf",274,0.996364,26,275,1,274,1,1,0,1,1,127,126,148,148,37
"3320",19,"[26]goIAGoHcovHnJHGqKCovppqKzf",283,0.996479,26,284,1,283,1,1,0,1,1,146,145,138,138,37
"3321",20,"[26]goIAGoHcovHnJHGqKCovppqKzf",281,0.996454,26,282,1,281,1,1,0,1,1,135,134,147,147,37
"3322",21,"[26]goIAGoHcovHnJHGqKCovppqKzf",275,0.996377,26,276,1,275,1,1,0,1,1,132,131,144,144,37
"3323",22,"[26]goIAGoHcovHnJHGqKCovppqKzf",292,0.996587,26,293,1,292,1,1,0,1,1,140,139,153,153,37
"3324",23,"[26]goIAGoHcovHnJHGqKCovppqKzf",285,0.996503,26,286,1,285,1,1,0,1,1,130,129,156,156,37
"3325",24,"[26]goIAGoHcovHnJHGqKCovppqKzf",271,0.996324,26,272,1,271,1,1,0,1,1,135,134,137,137,37
"3326",25,"[26]goIAGoHcovHnJHGqKCovppqKzf",282,0.996466,26,283,1,282,1,1,0,1,1,140,139,143,143,37
"3327",26,"[26]goIAGoHcovHnJHGqKCovppqKzf",281,0.996454,26,282,1,281,1,1,0,1,1,141,140,141,141,37
"3328",27,"[26]goIAGoHcovHnJHGqKCovppqKzf",279,0.996429,26,280,1,279,1,1,0,1,1,140,139,140,140,37
"3329",28,"[26]goIAGoHcovHnJHGqKCovppqKzf",278,0.996416,26,279,1,278,1,1,0,1,1,146,145,133,133,37
"3330",29,"[26]goIAGoHcovHnJHGqKCovppqKzf",287,0.996528,26,288,1,287,1,1,0,1,1,149,148,139,139,37
"3331",30,"[26]goIAGoHcovHnJHGqKCovppqKzf",271,0.996324,26,272,1,271,1,1,0,1,1,124,123,148,148,37
"3332",31,"[26]goIAGoHcovHnJHGqKCovppqKzf",280,0.996441,26,281,1,280,1,1,0,1,1,141,140,140,140,37
"3333",32,"[26]goIAGoHcovHnJHGqKCovppqKzf",280,0.996441,26,281,1,280,1,1,0,1,1,150,149,131,131,37
"3334",33,"[26]goIAGoHcovHnJHGqKCovppqKzf",279,0.996429,26,280,1,279,1,1,0,1,1,147,146,133,133,37
"3335",34,"[26]goIAGoHcovHnJHGqKCovppqKzf",277,0.996403,26,278,1,277,1,1,0,1,1,140,139,138,138,37
"3336",35,"[26]goIAGoHcovHnJHGqKCovppqKzf",282,0.996466,26,283,1,282,1,1,0,1,1,142,141,141,141,37
"3337",36,"[26]goIAGoHcovHnJHGqKCovppqKzf",283,0.996479,26,284,1,283,1,1,0,1,1,129,128,155,155,37
"3338",37,"[26]goIAGoHcovHnJHGqKCovppqKzf",282,0.996466,26,283,1,282,1,1,0,1,1,127,126,156,156,37
"3339",38,"[26]goIAGoHcovHnJHGqKCovppqKzf",287,0.996528,26,288,1,287,1,1,0,1,1,158,157,130,130,37
"3340",39,"[26]goIAGoHcovHnJHGqKCovppqKzf",278,0.996416,26,279,1,278,1,1,0,1,1,128,127,151,151,37
"3341",40,"[26]goIAGoHcovHnJHGqKCovppqKzf",282,0.996466,26,283,1,282,1,1,0,1,1,135,134,148,148,37
"3342",41,"[26]goIAGoHcovHnJHGqKCovppqKzf",279,0.996429,26,280,1,279,1,1,0,1,1,137,136,143,143,37
"3343",42,"[26]goIAGoHcovHnJHGqKCovppqKzf",287,0.996528,26,288,1,287,1,1,0,1,1,146,145,142,142,37
"3344",43,"[26]goIAGoHcovHnJHGqKCovppqKzf",276,0.99639,26,277,1,276,1,1,0,1,1,144,143,133,133,37
"3345",44,"[26]goIAGoHcovHnJHGqKCovppqKzf",283,0.996479,26,284,1,283,1,1,0,1,1,147,146,137,137,37
"3346",45,"[26]goIAGoHcovHnJHGqKCovppqKzf",278,0.996416,26,279,1,278,1,1,0,1,1,134,133,145,145,37
"3347",46,"[26]goIAGoHcovHnJHGqKCovppqKzf",271,0.996324,26,272,1,271,1,1,0,1,1,152,151,120,120,37
"3348",47,"[26]goIAGoHcovHnJHGqKCovppqKzf",276,0.99639,26,277,1,276,1,1,0,1,1,148,147,129,129,37
"3349",48,"[26]goIAGoHcovHnJHGqKCovppqKzf",276,0.99639,26,277,1,276,1,1,0,1,1,144,143,133,133,37
"3350",49,"[26]goIAGoHcovHnJHGqKCovppqKzf",285,0.996503,26,286,1,285,1,1,0,1,1,144,143,142,142,37
"3351",50,"[26]goIAGoHcovHnJHGqKCovppqKzf",275,0.996377,26,276,1,275,1,1,0,1,1,124,123,152,152,37
"3352",51,"[26]goIAGoHcovHnJHGqKCovppqKzf",288,0.99654,26,289,1,288,1,1,0,1,1,152,151,137,137,37
"3353",52,"[26]goIAGoHcovHnJHGqKCovppqKzf",287,0.996528,26,288,1,287,1,1,0,1,1,145,144,143,143,37
"3354",53,"[26]goIAGoHcovHnJHGqKCovppqKzf",273,0.99635,26,274,1,273,1,1,0,1,1,129,128,145,145,37
"3355",54,"[26]goIAGoHcovHnJHGqKCovppqKzf",285,0.996503,26,286,1,285,1,1,0,1,1,145,144,141,141,37
"3356",55,"[26]goIAGoHcovHnJHGqKCovppqKzf",282,0.996466,26,283,1,282,1,1,0,1,1,150,149,133,133,37
"3357",56,"[26]goIAGoHcovHnJHGqKCovppqKzf",282,0.996466,26,283,1,282,1,1,0,1,1,133,132,150,150,37
"3358",57,"[26]goIAGoHcovHnJHGqKCovppqKzf",271,0.996324,26,272,1,271,1,1,0,1,1,140,139,132,132,37
"3359",58,"[26]goIAGoHcovHnJHGqKCovppqKzf",276,0.99639,26,277,1,276,1,1,0,1,1,140,139,137,137,37
"3360",59,"[26]goIAGoHcovHnJHGqKCovppqKzf",273,0.99635,26,274,1,273,1,1,0,1,1,122,121,152,152,37
"3361",60,"[26]goIAGoHcovHnJHGqKCovppqKzf",287,0.996528,26,288,1,287,1,1,0,1,1,151,150,137,137,37
"3362",61,"[26]goIAGoHcovHnJHGqKCovppqKzf",286,0.996516,26,287,1,286,1,1,0,1,1,137,136,150,150,37
"3363",62,"[26]goIAGoHcovHnJHGqKCovppqKzf",279,0.996429,26,280,1,279,1,1,0,1,1,136,135,144,144,37
"3364",63,"[26]goIAGoHcovHnJHGqKCovppqKzf",275,0.996377,26,276,1,275,1,1,0,1,1,139,138,137,137,37
"3365",64,"[26]goIAGoHcovHnJHGqKCovppqKzf",283,0.996479,26,284,1,283,1,1,0,1,1,157,156,127,127,37
"3366",65,"[26]goIAGoHcovHnJHGqKCovppqKzf",281,0.996454,26,282,1,281,1,1,0,1,1,136,135,146,146,37
"3367",66,"[26]goIAGoHcovHnJHGqKCovppqKzf",282,0.996466,26,283,1,282,1,1,0,1,1,138,137,145,145,37
"3368",67,"[26]goIAGoHcovHnJHGqKCovppqKzf",278,0.996416,26,279,1,278,1,1,0,1,1,133,132,146,146,37
"3369",68,"[26]goIAGoHcovHnJHGqKCovppqKzf",267,0.996269,26,268,1,267,1,1,0,1,1,131,130,137,137,37
"3370",69,"[26]goIAGoHcovHnJHGqKCovppqKzf",283,0.996479,26,284,1,283,1,1,0,1,1,151,150,133,133,37
"3371",70,"[26]goIAGoHcovHnJHGqKCovppqKzf",274,0.996364,26,275,1,274,1,1,0,1,1,128,127,147,147,37
"3372",71,"[26]goIAGoHcovHnJHGqKCovppqKzf",283,0.996479,26,284,1,283,1,1,0,1,1,134,133,150,150,37
"3373",72,"[26]goIAGoHcovHnJHGqKCovppqKzf",279,0.996429,26,280,1,279,1,1,0,1,1,152,151,128,128,37
"3374",73,"[26]goIAGoHcovHnJHGqKCovppqKzf",283,0.996479,26,284,1,283,1,1,0,1,1,140,139,144,144,37
"3375",74,"[26]goIAGoHcovHnJHGqKCovppqKzf",279,0.996429,26,280,1,279,1,1,0,1,1,141,140,139,139,37
"3376",75,"[26]goIAGoHcovHnJHGqKCovppqKzf",284,0.996491,26,285,1,284,1,1,0,1,1,142,141,143,143,37
"3377",76,"[26]goIAGoHcovHnJHGqKCovppqKzf",283,0.996479,26,284,1,283,1,1,0,1,1,148,147,136,136,37
"3378",77,"[26]goIAGoHcovHnJHGqKCovppqKzf",285,0.996503,26,286,1,285,1,1,0,1,1,144,143,142,142,37
"3379",78,"[26]goIAGoHcovHnJHGqKCovppqKzf",278,0.996416,26,279,1,278,1,1,0,1,1,122,121,157,157,37
"3380",79,"[26]goIAGoHcovHnJHGqKCovppqKzf",285,0.996503,26,286,1,285,1,1,0,1,1,140,139,146,146,37
"3381",80,"[26]goIAGoHcovHnJHGqKCovppqKzf",284,0.996491,26,285,1,284,1,1,0,1,1,143,142,142,142,37
"3382",81,"[26]goIAGoHcovHnJHGqKCovppqKzf",281,0.996454,26,282,1,281,1,1,0,1,1,143,142,139,139,37
"3383",82,"[26]goIAGoHcovHnJHGqKCovppqKzf",276,0.99639,26,277,1,276,1,1,0,1,1,129,128,148,148,37
"3384",83,"[26]goIAGoHcovHnJHGqKCovppqKzf",283,0.996479,26,284,1,283,1,1,0,1,1,144,143,140,140,37
"3385",84,"[26]goIAGoHcovHnJHGqKCovppqKzf",278,0.996416,26,279,1,278,1,1,0,1,1,139,138,140,140,37
"3386",85,"[26]goIAGoHcovHnJHGqKCovppqKzf",273,0.99635,26,274,1,273,1,1,0,1,1,129,128,145,145,37
"3387",86,"[26]goIAGoHcovHnJHGqKCovppqKzf",275,0.996377,26,276,1,275,1,1,0,1,1,143,142,133,133,37
"3388",87,"[26]goIAGoHcovHnJHGqKCovppqKzf",282,0.996466,26,283,1,282,1,1,0,1,1,136,135,147,147,37
"3389",88,"[26]goIAGoHcovHnJHGqKCovppqKzf",276,0.99639,26,277,1,276,1,1,0,1,1,135,134,142,142,37
"3390",89,"[26]goIAGoHcovHnJHGqKCovppqKzf",287,0.996528,26,288,1,287,1,1,0,1,1,150,149,138,138,37
"3391",90,"[26]goIAGoHcovHnJHGqKCovppqKzf",273,0.99635,26,274,1,273,1,1,0,1,1,144,143,130,130,37
"3392",91,"[26]goIAGoHcovHnJHGqKCovppqKzf",280,0.996441,26,281,1,280,1,1,0,1,1,143,142,138,138,37
"3393",92,"[26]goIAGoHcovHnJHGqKCovppqKzf",276,0.99639,26,277,1,276,1,1,0,1,1,131,130,146,146,37
"3394",93,"[26]goIAGoHcovHnJHGqKCovppqKzf",275,0.996377,26,276,1,275,1,1,0,1,1,133,132,143,143,37
"3395",94,"[26]goIAGoHcovHnJHGqKCovppqKzf",284,0.996491,26,285,1,284,1,1,0,1,1,149,148,136,136,37
"3396",95,"[26]goIAGoHcovHnJHGqKCovppqKzf",273,0.99635,26,274,1,273,1,1,0,1,1,123,122,151,151,37
"3397",96,"[26]goIAGoHcovHnJHGqKCovppqKzf",282,0.996466,26,283,1,282,1,1,0,1,1,137,136,146,146,37
"3398",97,"[26]goIAGoHcovHnJHGqKCovppqKzf",274,0.996364,26,275,1,274,1,1,0,1,1,144,143,131,131,37
"3399",98,"[26]goIAGoHcovHnJHGqKCovppqKzf",284,0.996491,26,285,1,284,1,1,0,1,1,138,137,147,147,37
"3400",99,"[26]goIAGoHcovHnJHGqKCovppqKzf",281,0.996454,26,282,1,281,1,1,0,1,1,140,139,142,142,37
"3401",0,"[23]bgoIoHcotHnJHGqKCaDtBJp",281,0.996454,23,282,1,281,1,1,0,1,1,146,145,136,136,38
"3402",1,"[23]bgoIoHcotHnJHGqKCaDtBJp",280,0.996441,23,281,1,280,1,1,0,1,1,145,144,136,136,38
"3403",2,"[23]bgoIoHcotHnJHGqKCaDtBJp",279,0.996429,23,280,1,279,1,1,0,1,1,142,141,138,138,38
"3404",3,"[23]bgoIoHcotHnJHGqKCaDtBJp",280,0.996441,23,281,1,280,1,1,0,1,1,144,143,137,137,38
"3405",4,"[23]bgoIoHcotHnJHGqKCaDtBJp",288,0.99654,23,289,1,288,1,1,0,1,1,148,147,141,141,38
"3406",5,"[23]bgoIoHcotHnJHGqKCaDtBJp",279,0.996429,23,280,1,279,1,1,0,1,1,148,147,132,132,38
"3407",6,"[23]bgoIoHcotHnJHGqKCaDtBJp",275,0.996377,23,276,1,275,1,1,0,1,1,126,125,150,150,38
"3408",7,"[23]bgoIoHcotHnJHGqKCaDtBJp",286,0.996516,23,287,1,286,1,1,0,1,1,148,147,139,139,38
"3409",8,"[23]bgoIoHcotHnJHGqKCaDtBJp",280,0.996441,23,281,1,280,1,1,0,1,1,128,127,153,153,38
"3410",9,"[23]bgoIoHcotHnJHGqKCaDtBJp",284,0.996491,23,285,1,284,1,1,0,1,1,144,143,141,141,38
"3411",10,"[23]bgoIoHcotHnJHGqKCaDtBJp",282,0.996466,23,283,1,282,1,1,0,1,1,138,137,145,145,38
"3412",11,"[23]bgoIoHcotHnJHGqKCaDtBJp",280,0.996441,23,281,1,280,1,1,0,1,1,141,140,140,140,38
"3413",12,"[23]bgoIoHcotHnJHGqKCaDtBJp",283,0.996479,23,284,1,283,1,1,0,1,1,142,141,142,142,38
"3414",13,"[23]bgoIoHcotHnJHGqKCaDtBJp",281,0.996454,23,282,1,281,1,1,0,1,1,150,149,132,132,38
"3415",14,"[23]bgoIoHcotHnJHGqKCaDtBJp",284,0.996491,23,285,1,284,1,1,0,1,1,142,141,143,143,38
"3416",15,"[23]bgoIoHcotHnJHGqKCaDtBJp",280,0.996441,23,281,1,280,1,1,0,1,1,139,138,142,142,38
"3417",16,"[23]bgoIoHcotHnJHGqKCaDtBJp",274,0.996364,23,275,1,274,1,1,0,1,1,140,139,135,135,38
"3418",17,"[23]bgoIoHcotHnJHGqKCaDtBJp",280,0.996441,23,281,1,280,1,1,0,1,1,142,141,139,139,38
"3419",18,"[23]bgoIoHcotHnJHGqKCaDtBJp",280,0.996441,23,281,1,280,1,1,0,1,1,133,132,148,148,38
"3420",19,"[23]bgoIoHcotHnJHGqKCaDtBJp",282,0.996466,23,283,1,282,1,1,0,1,1,150,149,133,133,38
"3421",20,"[23]bgoIoHcotHnJHGqKCaDtBJp",281,0.996454,23,282,1,281,1,1,0,1,1,151,150,131,131,38
"3422",21,"[23]bgoIoHcotHnJHGqKCaDtBJp",281,0.996454,23,282,1,281,1,1,0,1,1,144,143,138,138,38
"3423",22,"[23]bgoIoHcotHnJHGqKCaDtBJp",284,0.996491,23,285,1,284,1,1,0,1,1,149,148,136,136,38
"3424",23,"[23]bgoIoHcotHnJHGqKCaDtBJp",282,0.996466,23,283,1,282,1,1,0,1,1,140,139,143,143,38
"3425",24,"[23]bgoIoHcotHnJHGqKCaDtBJp",280,0.996441,23,281,1,280,1,1,0,1,1,139,138,142,142,38
"3426",25,"[23]bgoIoHcotHnJHGqKCaDtBJp",282,0.996466,23,283,1,282,1,1,0,1,1,142,141,141,141,38
"3427",26,"[23]bgoIoHcotHnJHGqKCaDtBJp",284,0.996491,23,285,1,284,1,1,0,1,1,137,136,148,148,38
"3428",27,"[23]bgoIoHcotHnJHGqKCaDtBJp",280,0.996441,23,281,1,280,1,1,0,1,1,134,133,147,147,38
"3429",28,"[23]bgoIoHcotHnJHGqKCaDtBJp",282,0.996466,23,283,1,282,1,1,0,1,1,136,135,147,147,38
"3430",29,"[23]bgoIoHcotHnJHGqKCaDtBJp",273,0.99635,23,274,1,273,1,1,0,1,1,138,137,136,136,38
"3431",30,"[23]bgoIoHcotHnJHGqKCaDtBJp",283,0.996479,23,284,1,283,1,1,0,1,1,140,139,144,144,38
"3432",31,"[23]bgoIoHcotHnJHGqKCaDtBJp",284,0.996491,23,285,1,284,1,1,0,1,1,161,160,124,124,38
"3433",32,"[23]bgoIoHcotHnJHGqKCaDtBJp",284,0.996491,23,285,1,284,1,1,0,1,1,140,139,145,145,38
"3434",33,"[23]bgoIoHcotHnJHGqKCaDtBJp",275,0.996377,23,276,1,275,1,1,0,1,1,126,125,150,150,38
"3435",34,"[23]bgoIoHcotHnJHGqKCaDtBJp",276,0.99639,23,277,1,276,1,1,0,1,1,137,136,140,140,38
"3436",35,"[23]bgoIoHcotHnJHGqKCaDtBJp",286,0.996516,23,287,1,286,1,1,0,1,1,145,144,142,142,38
"3437",36,"[23]bgoIoHcotHnJHGqKCaDtBJp",275,0.996377,23,276,1,275,1,1,0,1,1,137,136,139,139,38
"3438",37,"[23]bgoIoHcotHnJHGqKCaDtBJp",284,0.996491,23,285,1,284,1,1,0,1,1,142,141,143,143,38
"3439",38,"[23]bgoIoHcotHnJHGqKCaDtBJp",281,0.996454,23,282,1,281,1,1,0,1,1,136,135,146,146,38
"3440",39,"[23]bgoIoHcotHnJHGqKCaDtBJp",277,0.996403,23,278,1,277,1,1,0,1,1,132,131,146,146,38
"3441",40,"[23]bgoIoHcotHnJHGqKCaDtBJp",286,0.996516,23,287,1,286,1,1,0,1,1,143,142,144,144,38
"3442",41,"[23]bgoIoHcotHnJHGqKCaDtBJp",281,0.996454,23,282,1,281,1,1,0,1,1,150,149,132,132,38
"3443",42,"[23]bgoIoHcotHnJHGqKCaDtBJp",275,0.996377,23,276,1,275,1,1,0,1,1,129,128,147,147,38
"3444",43,"[23]bgoIoHcotHnJHGqKCaDtBJp",266,0.996255,23,267,1,266,1,1,0,1,1,145,144,122,122,38
"3445",44,"[23]bgoIoHcotHnJHGqKCaDtBJp",282,0.996466,23,283,1,282,1,1,0,1,1,138,137,145,145,38
"3446",45,"[23]bgoIoHcotHnJHGqKCaDtBJp",279,0.996429,23,280,1,279,1,1,0,1,1,157,156,123,123,38
"3447",46,"[23]bgoIoHcotHnJHGqKCaDtBJp",277,0.996403,23,278,1,277,1,1,0,1,1,132,131,146,146,38
"3448",47,"[23]bgoIoHcotHnJHGqKCaDtBJp",278,0.996416,23,279,1,278,1,1,0,1,1,154,153,125,125,38
"3449",48,"[23]bgoIoHcotHnJHGqKCaDtBJp",279,0.996429,23,280,1,279,1,1,0,1,1,153,152,127,127,38
"3450",49,"[23]bgoIoHcotHnJHGqKCaDtBJp",277,0.996403,23,278,1,277,1,1,0,1,1,147,146,131,131,38
"3451",50,"[23]bgoIoHcotHnJHGqKCaDtBJp",276,0.99639,23,277,1,276,1,1,0,1,1,134,133,143,143,38
"3452",51,"[23]bgoIoHcotHnJHGqKCaDtBJp",278,0.996416,23,279,1,278,1,1,0,1,1,134,133,145,145,38
"3453",52,"[23]bgoIoHcotHnJHGqKCaDtBJp",281,0.996454,23,282,1,281,1,1,0,1,1,129,128,153,153,38
"3454",53,"[23]bgoIoHcotHnJHGqKCaDtBJp",286,0.996516,23,287,1,286,1,1,0,1,1,146,145,141,141,38
"3455",54,"[23]bgoIoHcotHnJHGqKCaDtBJp",278,0.996416,23,279,1,278,1,1,0,1,1,147,146,132,132,38
"3456",55,"[23]bgoIoHcotHnJHGqKCaDtBJp",279,0.996429,23,280,1,279,1,1,0,1,1,131,130,149,149,38
"3457",56,"[23]bgoIoHcotHnJHGqKCaDtBJp",284,0.996491,23,285,1,284,1,1,0,1,1,142,141,143,143,38
"3458",57,"[23]bgoIoHcotHnJHGqKCaDtBJp",271,0.996324,23,272,1,271,1,1,0,1,1,120,119,152,152,38
"3459",58,"[23]bgoIoHcotHnJHGqKCaDtBJp",287,0.996528,23,288,1,287,1,1,0,1,1,145,144,143,143,38
"3460",59,"[23]bgoIoHcotHnJHGqKCaDtBJp",275,0.996377,23,276,1,275,1,1,0,1,1,127,126,149,149,38
"3461",60,"[23]bgoIoHcotHnJHGqKCaDtBJp",282,0.996466,23,283,1,282,1,1,0,1,1,144,143,139,139,38
"3462",61,"[23]bgoIoHcotHnJHGqKCaDtBJp",283,0.996479,23,284,1,283,1,1,0,1,1,143,142,141,141,38
"3463",62,"[23]bgoIoHcotHnJHGqKCaDtBJp",276,0.99639,23,277,1,276,1,1,0,1,1,130,129,147,147,38
"3464",63,"[23]bgoIoHcotHnJHGqKCaDtBJp",288,0.99654,23,289,1,288,1,1,0,1,1,144,143,145,145,38
"3465",64,"[23]bgoIoHcotHnJHGqKCaDtBJp",284,0.996491,23,285,1,284,1,1,0,1,1,152,151,133,133,38
"3466",65,"[23]bgoIoHcotHnJHGqKCaDtBJp",276,0.99639,23,277,1,276,1,1,0,1,1,139,138,138,138,38
"3467",66,"[23]bgoIoHcotHnJHGqKCaDtBJp",276,0.99639,23,277,1,276,1,1,0,1,1,130,129,147,147,38
"3468",67,"[23]bgoIoHcotHnJHGqKCaDtBJp",272,0.996337,23,273,1,272,1,1,0,1,1,135,134,138,138,38
"3469",68,"[23]bgoIoHcotHnJHGqKCaDtBJp",283,0.996479,23,284,1,283,1,1,0,1,1,144,143,140,140,38
"3470",69,"[23]bgoIoHcotHnJHGqKCaDtBJp",275,0.996377,23,276,1,275,1,1,0,1,1,119,118,157,157,38
"3471",70,"[23]bgoIoHcotHnJHGqKCaDtBJp",281,0.996454,23,282,1,281,1,1,0,1,1,144,143,138,138,38
"3472",71,"[23]bgoIoHcotHnJHGqKCaDtBJp",283,0.996479,23,284,1,283,1,1,0,1,1,135,134,149,149,38
"3473",72,"[23]bgoIoHcotHnJHGqKCaDtBJp",280,0.996441,23,281,1,280,1,1,0,1,1,132,131,149,149,38
"3474",73,"[23]bgoIoHcotHnJHGqKCaDtBJp",278,0.996416,23,279,1,278,1,1,0,1,1,133,132,146,146,38
"3475",74,"[23]bgoIoHcotHnJHGqKCaDtBJp",286,0.996516,23,287,1,286,1,1,0,1,1,136,135,151,151,38
"3476",75,"[23]bgoIoHcotHnJHGqKCaDtBJp",288,0.99654,23,289,1,288,1,1,0,1,1,138,137,151,151,38
"3477",76,"[23]bgoIoHcotHnJHGqKCaDtBJp",277,0.996403,23,278,1,277,1,1,0,1,1,131,130,147,147,38
"3478",77,"[23]bgoIoHcotHnJHGqKCaDtBJp",280,0.996441,23,281,1,280,1,1,0,1,1,143,142,138,138,38
"3479",78,"[23]bgoIoHcotHnJHGqKCaDtBJp",282,0.996466,23,283,1,282,1,1,0,1,1,147,146,136,136,38
"3480",79,"[23]bgoIoHcotHnJHGqKCaDtBJp",279,0.996429,23,280,1,279,1,1,0,1,1,130,129,150,150,38
"3481",80,"[23]bgoIoHcotHnJHGqKCaDtBJp",283,0.996479,23,284,1,283,1,1,0,1,1,141,140,143,143,38
"3482",81,"[23]bgoIoHcotHnJHGqKCaDtBJp",284,0.996491,23,285,1,284,1,1,0,1,1,143,142,142,142,38
"3483",82,"[23]bgoIoHcotHnJHGqKCaDtBJp",280,0.996441,23,281,1,280,1,1,0,1,1,149,148,132,132,38
"3484",83,"[23]bgoIoHcotHnJHGqKCaDtBJp",282,0.996466,23,283,1,282,1,1,0,1,1,145,144,138,138,38
"3485",84,"[23]bgoIoHcotHnJHGqKCaDtBJp",283,0.996479,23,284,1,283,1,1,0,1,1,156,155,128,128,38
"3486",85,"[23]bgoIoHcotHnJHGqKCaDtBJp",282,0.996466,23,283,1,282,1,1,0,1,1,135,134,148,148,38
"3487",86,"[23]bgoIoHcotHnJHGqKCaDtBJp",286,0.996516,23,287,1,286,1,1,0,1,1,153,152,134,134,38
"3488",87,"[23]bgoIoHcotHnJHGqKCaDtBJp",282,0.996466,23,283,1,282,1,1,0,1,1,146,145,137,137,38
"3489",88,"[23]bgoIoHcotHnJHGqKCaDtBJp",282,0.996466,23,283,1,282,1,1,0,1,1,151,150,132,132,38
"3490",89,"[23]bgoIoHcotHnJHGqKCaDtBJp",285,0.996503,23,286,1,285,1,1,0,1,1,159,158,127,127,38
"3491",90,"[23]bgoIoHcotHnJHGqKCaDtBJp",282,0.996466,23,283,1,282,1,1,0,1,1,144,143,139,139,38
"3492",91,"[23]bgoIoHcotHnJHGqKCaDtBJp",276,0.99639,23,277,1,276,1,1,0,1,1,138,137,139,139,38
"3493",92,"[23]bgoIoHcotHnJHGqKCaDtBJp",281,0.996454,23,282,1,281,1,1,0,1,1,140,139,142,142,38
"3494",93,"[23]bgoIoHcotHnJHGqKCaDtBJp",283,0.996479,23,284,1,283,1,1,0,1,1,133,132,151,151,38
"3495",94,"[23]bgoIoHcotHnJHGqKCaDtBJp",286,0.996516,23,287,1,286,1,1,0,1,1,149,148,138,138,38
"3496",95,"[23]bgoIoHcotHnJHGqKCaDtBJp",289,0.996552,23,290,1,289,1,1,0,1,1,155,154,135,135,38
"3497",96,"[23]bgoIoHcotHnJHGqKCaDtBJp",281,0.996454,23,282,1,281,1,1,0,1,1,142,141,140,140,38
"3498",97,"[23]bgoIoHcotHnJHGqKCaDtBJp",284,0.996491,23,285,1,284,1,1,0,1,1,146,145,139,139,38
"3499",98,"[23]bgoIoHcotHnJHGqKCaDtBJp",277,0.996403,23,278,1,277,1,1,0,1,1,137,136,141,141,38
"3500",99,"[23]bgoIoHcotHnJHGqKCaDtBJp",284,0.996491,23,285,1,284,1,1,0,1,1,142,141,143,143,38
"3501",0,"[30]yBFHoIGoHcouHnJqGKCIkBkhcIBIdh",292,0.996587,30,293,1,292,1,1,0,1,1,140,139,153,153,39
"3502",1,"[30]yBFHoIGoHcouHnJqGKCIkBkhcIBIdh",300,0.996678,30,301,1,300,1,1,0,1,1,164,163,137,137,39
"3503",2,"[30]yBFHoIGoHcouHnJqGKCIkBkhcIBIdh",292,0.996587,30,293,1,292,1,1,0,1,1,135,134,158,158,39
"3504",3,"[30]yBFHoIGoHcouHnJqGKCIkBkhcIBIdh",299,0.996667,30,300,1,299,1,1,0,1,1,155,154,145,145,39
"3505",4,"[30]yBFHoIGoHcouHnJqGKCIkBkhcIBIdh",289,0.996552,30,290,1,289,1,1,0,1,1,130,129,160,160,39
"3506",5,"[30]yBFHoIGoHcouHnJqGKCIkBkhcIBIdh",294,0.99661,30,295,1,294,1,1,0,1,1,149,148,146,146,39
"3507",6,"[30]yBFHoIGoHcouHnJqGKCIkBkhcIBIdh",297,0.996644,30,298,1,297,1,1,0,1,1,153,152,145,145,39
"3508",7,"[30]yBFHoIGoHcouHnJqGKCIkBkhcIBIdh",294,0.99661,30,295,1,294,1,1,0,1,1,134,133,161,161,39
"3509",8,"[30]yBFHoIGoHcouHnJqGKCIkBkhcIBIdh",290,0.996564,30,291,1,290,1,1,0,1,1,140,139,151,151,39
"3510",9,"[30]yBFHoIGoHcouHnJqGKCIkBkhcIBIdh",294,0.99661,30,295,1,294,1,1,0,1,1,148,147,147,147,39
"3511",10,"[30]yBFHoIGoHcouHnJqGKCIkBkhcIBIdh",293,0.996599,30,294,1,293,1,1,0,1,1,149,148,145,145,39
"3512",11,"[30]yBFHoIGoHcouHnJqGKCIkBkhcIBIdh",294,0.99661,30,295,1,294,1,1,0,1,1,146,145,149,149,39
"3513",12,"[30]yBFHoIGoHcouHnJqGKCIkBkhcIBIdh",292,0.996587,30,293,1,292,1,1,0,1,1,140,139,153,153,39
"3514",13,"[30]yBFHoIGoHcouHnJqGKCIkBkhcIBIdh",291,0.996575,30,292,1,291,1,1,0,1,1,145,144,147,147,39
"3515",14,"[30]yBFHoIGoHcouHnJqGKCIkBkhcIBIdh",293,0.996599,30,294,1,293,1,1,0,1,1,142,141,152,152,39
"3516",15,"[30]yBFHoIGoHcouHnJqGKCIkBkhcIBIdh",294,0.99661,30,295,1,294,1,1,0,1,1,146,145,149,149,39
"3517",16,"[30]yBFHoIGoHcouHnJqGKCIkBkhcIBIdh",290,0.996564,30,291,1,290,1,1,0,1,1,142,141,149,149,39
"3518",17,"[30]yBFHoIGoHcouHnJqGKCIkBkhcIBIdh",296,0.996633,30,297,1,296,1,1,0,1,1,155,154,142,142,39
"3519",18,"[30]yBFHoIGoHcouHnJqGKCIkBkhcIBIdh",294,0.99661,30,295,1,294,1,1,0,1,1,144,143,151,151,39
"3520",19,"[30]yBFHoIGoHcouHnJqGKCIkBkhcIBIdh",292,0.996587,30,293,1,292,1,1,0,1,1,139,138,154,154,39
"3521",20,"[30]yBFHoIGoHcouHnJqGKCIkBkhcIBIdh",287,0.996528,30,288,1,287,1,1,0,1,1,152,151,136,136,39
"3522",21,"[30]yBFHoIGoHcouHnJqGKCIkBkhcIBIdh",292,0.996587,30,293,1,292,1,1,0,1,1,139,138,154,154,39
"3523",22,"[30]yBFHoIGoHcouHnJqGKCIkBkhcIBIdh",295,0.996622,30,296,1,295,1,1,0,1,1,148,147,148,148,39
"3524",23,"[30]yBFHoIGoHcouHnJqGKCIkBkhcIBIdh",292,0.996587,30,293,1,292,1,1,0,1,1,139,138,154,154,39
"3525",24,"[30]yBFHoIGoHcouHnJqGKCIkBkhcIBIdh",299,0.996667,30,300,1,299,1,1,0,1,1,154,153,146,146,39
"3526",25,"[30]yBFHoIGoHcouHnJqGKCIkBkhcIBIdh",292,0.996587,30,293,1,292,1,1,0,1,1,141,140,152,152,39
"3527",26,"[30]yBFHoIGoHcouHnJqGKCIkBkhcIBIdh",292,0.996587,30,293,1,292,1,1,0,1,1,138,137,155,155,39
"3528",27,"[30]yBFHoIGoHcouHnJqGKCIkBkhcIBIdh",294,0.99661,30,295,1,294,1,1,0,1,1,149,148,146,146,39
"3529",28,"[30]yBFHoIGoHcouHnJqGKCIkBkhcIBIdh",302,0.9967,30,303,1,302,1,1,0,1,1,153,152,150,150,39
"3530",29,"[30]yBFHoIGoHcouHnJqGKCIkBkhcIBIdh",293,0.996599,30,294,1,293,1,1,0,1,1,142,141,152,152,39
"3531",30,"[30]yBFHoIGoHcouHnJqGKCIkBkhcIBIdh",294,0.99661,30,295,1,294,1,1,0,1,1,145,144,150,150,39
"3532",31,"[30]yBFHoIGoHcouHnJqGKCIkBkhcIBIdh",297,0.996644,30,298,1,297,1,1,0,1,1,153,152,145,145,39
"3533",32,"[30]yBFHoIGoHcouHnJqGKCIkBkhcIBIdh",297,0.996644,30,298,1,297,1,1,0,1,1,155,154,143,143,39
"3534",33,"[30]yBFHoIGoHcouHnJqGKCIkBkhcIBIdh",299,0.996667,30,300,1,299,1,1,0,1,1,160,159,140,140,39
"3535",34,"[30]yBFHoIGoHcouHnJqGKCIkBkhcIBIdh",299,0.996667,30,300,1,299,1,1,0,1,1,163,162,137,137,39
"3536",35,"[30]yBFHoIGoHcouHnJqGKCIkBkhcIBIdh",295,0.996622,30,296,1,295,1,1,0,1,1,146,145,150,150,39
"3537",36,"[30]yBFHoIGoHcouHnJqGKCIkBkhcIBIdh",297,0.996644,30,298,1,297,1,1,0,1,1,159,158,139,139,39
"3538",37,"[30]yBFHoIGoHcouHnJqGKCIkBkhcIBIdh",289,0.996552,30,290,1,289,1,1,0,1,1,131,130,159,159,39
"3539",38,"[30]yBFHoIGoHcouHnJqGKCIkBkhcIBIdh",298,0.996656,30,299,1,298,1,1,0,1,1,157,156,142,142,39
"3540",39,"[30]yBFHoIGoHcouHnJqGKCIkBkhcIBIdh",299,0.996667,30,300,1,299,1,1,0,1,1,159,158,141,141,39
"3541",40,"[30]yBFHoIGoHcouHnJqGKCIkBkhcIBIdh",298,0.996656,30,299,1,298,1,1,0,1,1,154,153,145,145,39
"3542",41,"[30]yBFHoIGoHcouHnJqGKCIkBkhcIBIdh",296,0.996633,30,297,1,296,1,1,0,1,1,152,151,145,145,39
"3543",42,"[30]yBFHoIGoHcouHnJqGKCIkBkhcIBIdh",295,0.996622,30,296,1,295,1,1,0,1,1,145,144,151,151,39
"3544",43,"[30]yBFHoIGoHcouHnJqGKCIkBkhcIBIdh",297,0.996644,30,298,1,297,1,1,0,1,1,158,157,140,140,39
"3545",44,"[30]yBFHoIGoHcouHnJqGKCIkBkhcIBIdh",298,0.996656,30,299,1,298,1,1,0,1,1,144,143,155,155,39
"3546",45,"[30]yBFHoIGoHcouHnJqGKCIkBkhcIBIdh",290,0.996564,30,291,1,290,1,1,0,1,1,135,134,156,156,39
"3547",46,"[30]yBFHoIGoHcouHnJqGKCIkBkhcIBIdh",295,0.996622,30,296,1,295,1,1,0,1,1,150,149,146,146,39
"3548",47,"[30]yBFHoIGoHcouHnJqGKCIkBkhcIBIdh",293,0.996599,30,294,1,293,1,1,0,1,1,166,165,128,128,39
"3549",48,"[30]yBFHoIGoHcouHnJqGKCIkBkhcIBIdh",295,0.996622,30,296,1,295,1,1,0,1,1,147,146,149,149,39
"3550",49,"[30]yBFHoIGoHcouHnJqGKCIkBkhcIBIdh",291,0.996575,30,292,1,291,1,1,0,1,1,147,146,145,145,39
"3551",50,"[30]yBFHoIGoHcouHnJqGKCIkBkhcIBIdh",299,0.996667,30,300,1,299,1,1,0,1,1,157,156,143,143,39
"3552",51,"[30]yBFHoIGoHcouHnJqGKCIkBkhcIBIdh",296,0.996633,30,297,1,296,1,1,0,1,1,157,156,140,140,39
"3553",52,"[30]yBFHoIGoHcouHnJqGKCIkBkhcIBIdh",302,0.9967,30,303,1,302,1,1,0,1,1,165,164,138,138,39
"3554",53,"[30]yBFHoIGoHcouHnJqGKCIkBkhcIBIdh",295,0.996622,30,296,1,295,1,1,0,1,1,150,149,146,146,39
"3555",54,"[30]yBFHoIGoHcouHnJqGKCIkBkhcIBIdh",298,0.996656,30,299,1,298,1,1,0,1,1,158,157,141,141,39
"3556",55,"[30]yBFHoIGoHcouHnJqGKCIkBkhcIBIdh",295,0.996622,30,296,1,295,1,1,0,1,1,146,145,150,150,39
"3557",56,"[30]yBFHoIGoHcouHnJqGKCIkBkhcIBIdh",295,0.996622,30,296,1,295,1,1,0,1,1,158,157,138,138,39
"3558",57,"[30]yBFHoIGoHcouHnJqGKCIkBkhcIBIdh",292,0.996587,30,293,1,292,1,1,0,1,1,143,142,150,150,39
"3559",58,"[30]yBFHoIGoHcouHnJqGKCIkBkhcIBIdh",292,0.996587,30,293,1,292,1,1,0,1,1,140,139,153,153,39
"3560",59,"[30]yBFHoIGoHcouHnJqGKCIkBkhcIBIdh",301,0.996689,30,302,1,301,1,1,0,1,1,174,173,128,128,39
"3561",60,"[30]yBFHoIGoHcouHnJqGKCIkBkhcIBIdh",295,0.996622,30,296,1,295,1,1,0,1,1,143,142,153,153,39
"3562",61,"[30]yBFHoIGoHcouHnJqGKCIkBkhcIBIdh",293,0.996599,30,294,1,293,1,1,0,1,1,142,141,152,152,39
"3563",62,"[30]yBFHoIGoHcouHnJqGKCIkBkhcIBIdh",296,0.996633,30,297,1,296,1,1,0,1,1,158,157,139,139,39
"3564",63,"[30]yBFHoIGoHcouHnJqGKCIkBkhcIBIdh",294,0.99661,30,295,1,294,1,1,0,1,1,148,147,147,147,39
"3565",64,"[30]yBFHoIGoHcouHnJqGKCIkBkhcIBIdh",298,0.996656,30,299,1,298,1,1,0,1,1,154,153,145,145,39
"3566",65,"[30]yBFHoIGoHcouHnJqGKCIkBkhcIBIdh",296,0.996633,30,297,1,296,1,1,0,1,1,154,153,143,143,39
"3567",66,"[30]yBFHoIGoHcouHnJqGKCIkBkhcIBIdh",293,0.996599,30,294,1,293,1,1,0,1,1,152,151,142,142,39
"3568",67,"[30]yBFHoIGoHcouHnJqGKCIkBkhcIBIdh",294,0.99661,30,295,1,294,1,1,0,1,1,148,147,147,147,39
"3569",68,"[30]yBFHoIGoHcouHnJqGKCIkBkhcIBIdh",289,0.996552,30,290,1,289,1,1,0,1,1,146,145,144,144,39
"3570",69,"[30]yBFHoIGoHcouHnJqGKCIkBkhcIBIdh",294,0.99661,30,295,1,294,1,1,0,1,1,148,147,147,147,39
"3571",70,"[30]yBFHoIGoHcouHnJqGKCIkBkhcIBIdh",291,0.996575,30,292,1,291,1,1,0,1,1,146,145,146,146,39
"3572",71,"[30]yBFHoIGoHcouHnJqGKCIkBkhcIBIdh",297,0.996644,30,298,1,297,1,1,0,1,1,146,145,152,152,39
"3573",72,"[30]yBFHoIGoHcouHnJqGKCIkBkhcIBIdh",297,0.996644,30,298,1,297,1,1,0,1,1,159,158,139,139,39
"3574",73,"[30]yBFHoIGoHcouHnJqGKCIkBkhcIBIdh",281,0.996454,30,282,1,281,1,1,0,1,1,135,134,147,147,39
"3575",74,"[30]yBFHoIGoHcouHnJqGKCIkBkhcIBIdh",296,0.996633,30,297,1,296,1,1,0,1,1,154,153,143,143,39
"3576",75,"[30]yBFHoIGoHcouHnJqGKCIkBkhcIBIdh",294,0.99661,30,295,1,294,1,1,0,1,1,148,147,147,147,39
"3577",76,"[30]yBFHoIGoHcouHnJqGKCIkBkhcIBIdh",298,0.996656,30,299,1,298,1,1,0,1,1,158,157,141,141,39
"3578",77,"[30]yBFHoIGoHcouHnJqGKCIkBkhcIBIdh",302,0.9967,30,303,1,302,1,1,0,1,1,173,172,130,130,39
"3579",78,"[30]yBFHoIGoHcouHnJqGKCIkBkhcIBIdh",299,0.996667,30,300,1,299,1,1,0,1,1,161,160,139,139,39
"3580",79,"[30]yBFHoIGoHcouHnJqGKCIkBkhcIBIdh",296,0.996633,30,297,1,296,1,1,0,1,1,147,146,150,150,39
"3581",80,"[30]yBFHoIGoHcouHnJqGKCIkBkhcIBIdh",290,0.996564,30,291,1,290,1,1,0,1,1,135,134,156,156,39
"3582",81,"[30]yBFHoIGoHcouHnJqGKCIkBkhcIBIdh",288,0.99654,30,289,1,288,1,1,0,1,1,131,130,158,158,39
"3583",82,"[30]yBFHoIGoHcouHnJqGKCIkBkhcIBIdh",298,0.996656,30,299,1,298,1,1,0,1,1,159,158,140,140,39
"3584",83,"[30]yBFHoIGoHcouHnJqGKCIkBkhcIBIdh",297,0.996644,30,298,1,297,1,1,0,1,1,152,151,146,146,39
"3585",84,"[30]yBFHoIGoHcouHnJqGKCIkBkhcIBIdh",294,0.99661,30,295,1,294,1,1,0,1,1,160,159,135,135,39
"3586",85,"[30]yBFHoIGoHcouHnJqGKCIkBkhcIBIdh",295,0.996622,30,296,1,295,1,1,0,1,1,140,139,156,156,39
"3587",86,"[30]yBFHoIGoHcouHnJqGKCIkBkhcIBIdh",298,0.996656,30,299,1,298,1,1,0,1,1,162,161,137,137,39
"3588",87,"[30]yBFHoIGoHcouHnJqGKCIkBkhcIBIdh",292,0.996587,30,293,1,292,1,1,0,1,1,137,136,156,156,39
"3589",88,"[30]yBFHoIGoHcouHnJqGKCIkBkhcIBIdh",294,0.99661,30,295,1,294,1,1,0,1,1,141,140,154,154,39
"3590",89,"[30]yBFHoIGoHcouHnJqGKCIkBkhcIBIdh",294,0.99661,30,295,1,294,1,1,0,1,1,151,150,144,144,39
"3591",90,"[30]yBFHoIGoHcouHnJqGKCIkBkhcIBIdh",291,0.996575,30,292,1,291,1,1,0,1,1,135,134,157,157,39
"3592",91,"[30]yBFHoIGoHcouHnJqGKCIkBkhcIBIdh",295,0.996622,30,296,1,295,1,1,0,1,1,153,152,143,143,39
"3593",92,"[30]yBFHoIGoHcouHnJqGKCIkBkhcIBIdh",304,0.996721,30,305,1,304,1,1,0,1,1,163,162,142,142,39
"3594",93,"[30]yBFHoIGoHcouHnJqGKCIkBkhcIBIdh",294,0.99661,30,295,1,294,1,1,0,1,1,145,144,150,150,39
"3595",94,"[30]yBFHoIGoHcouHnJqGKCIkBkhcIBIdh",297,0.996644,30,298,1,297,1,1,0,1,1,149,148,149,149,39
"3596",95,"[30]yBFHoIGoHcouHnJqGKCIkBkhcIBIdh",294,0.99661,30,295,1,294,1,1,0,1,1,150,149,145,145,39
"3597",96,"[30]yBFHoIGoHcouHnJqGKCIkBkhcIBIdh",292,0.996587,30,293,1,292,1,1,0,1,1,147,146,146,146,39
"3598",97,"[30]yBFHoIGoHcouHnJqGKCIkBkhcIBIdh",297,0.996644,30,298,1,297,1,1,0,1,1,148,147,150,150,39
"3599",98,"[30]yBFHoIGoHcouHnJqGKCIkBkhcIBIdh",298,0.996656,30,299,1,298,1,1,0,1,1,153,152,146,146,39
"3600",99,"[30]yBFHoIGoHcouHnJqGKCIkBkhcIBIdh",295,0.996622,30,296,1,295,1,1,0,1,1,149,148,147,147,39
"3601",0,"[26]pJHoIqazHctsuxHnJHGqKCnisj",282,0.996466,26,283,1,282,1,1,0,1,1,148,147,135,135,40
"3602",1,"[26]pJHoIqazHctsuxHnJHGqKCnisj",282,0.996466,26,283,1,282,1,1,0,1,1,134,133,149,149,40
"3603",2,"[26]pJHoIqazHctsuxHnJHGqKCnisj",278,0.996416,26,279,1,278,1,1,0,1,1,134,133,145,145,40
"3604",3,"[26]pJHoIqazHctsuxHnJHGqKCnisj",286,0.996516,26,287,1,286,1,1,0,1,1,146,145,141,141,40
"3605",4,"[26]pJHoIqazHctsuxHnJHGqKCnisj",281,0.996454,26,282,1,281,1,1,0,1,1,152,151,130,130,40
"3606",5,"[26]pJHoIqazHctsuxHnJHGqKCnisj",292,0.996587,26,293,1,292,1,1,0,1,1,151,150,142,142,40
"3607",6,"[26]pJHoIqazHctsuxHnJHGqKCnisj",284,0.996491,26,285,1,284,1,1,0,1,1,130,129,155,155,40
"3608",7,"[26]pJHoIqazHctsuxHnJHGqKCnisj",282,0.996466,26,283,1,282,1,1,0,1,1,139,138,144,144,40
"3609",8,"[26]pJHoIqazHctsuxHnJHGqKCnisj",289,0.996552,26,290,1,289,1,1,0,1,1,147,146,143,143,40
"3610",9,"[26]pJHoIqazHctsuxHnJHGqKCnisj",286,0.996516,26,287,1,286,1,1,0,1,1,136,135,151,151,40
"3611",10,"[26]pJHoIqazHctsuxHnJHGqKCnisj",288,0.99654,26,289,1,288,1,1,0,1,1,154,153,135,135,40
"3612",11,"[26]pJHoIqazHctsuxHnJHGqKCnisj",279,0.996429,26,280,1,279,1,1,0,1,1,153,152,127,127,40
"3613",12,"[26]pJHoIqazHctsuxHnJHGqKCnisj",279,0.996429,26,280,1,279,1,1,0,1,1,110,109,170,170,40
"3614",13,"[26]pJHoIqazHctsuxHnJHGqKCnisj",276,0.99639,26,277,1,276,1,1,0,1,1,132,131,145,145,40
"3615",14,"[26]pJHoIqazHctsuxHnJHGqKCnisj",284,0.996491,26,285,1,284,1,1,0,1,1,136,135,149,149,40
"3616",15,"[26]pJHoIqazHctsuxHnJHGqKCnisj",296,0.996633,26,297,1,296,1,1,0,1,1,164,163,133,133,40
"3617",16,"[26]pJHoIqazHctsuxHnJHGqKCnisj",279,0.996429,26,280,1,279,1,1,0,1,1,150,149,130,130,40
"3618",17,"[26]pJHoIqazHctsuxHnJHGqKCnisj",279,0.996429,26,280,1,279,1,1,0,1,1,136,135,144,144,40
"3619",18,"[26]pJHoIqazHctsuxHnJHGqKCnisj",285,0.996503,26,286,1,285,1,1,0,1,1,152,151,134,134,40
"3620",19,"[26]pJHoIqazHctsuxHnJHGqKCnisj",288,0.99654,26,289,1,288,1,1,0,1,1,136,135,153,153,40
"3621",20,"[26]pJHoIqazHctsuxHnJHGqKCnisj",275,0.996377,26,276,1,275,1,1,0,1,1,127,126,149,149,40
"3622",21,"[26]pJHoIqazHctsuxHnJHGqKCnisj",283,0.996479,26,284,1,283,1,1,0,1,1,165,164,119,119,40
"3623",22,"[26]pJHoIqazHctsuxHnJHGqKCnisj",282,0.996466,26,283,1,282,1,1,0,1,1,141,140,142,142,40
"3624",23,"[26]pJHoIqazHctsuxHnJHGqKCnisj",285,0.996503,26,286,1,285,1,1,0,1,1,149,148,137,137,40
"3625",24,"[26]pJHoIqazHctsuxHnJHGqKCnisj",288,0.99654,26,289,1,288,1,1,0,1,1,155,154,134,134,40
"3626",25,"[26]pJHoIqazHctsuxHnJHGqKCnisj",281,0.996454,26,282,1,281,1,1,0,1,1,132,131,150,150,40
"3627",26,"[26]pJHoIqazHctsuxHnJHGqKCnisj",281,0.996454,26,282,1,281,1,1,0,1,1,137,136,145,145,40
"3628",27,"[26]pJHoIqazHctsuxHnJHGqKCnisj",285,0.996503,26,286,1,285,1,1,0,1,1,150,149,136,136,40
"3629",28,"[26]pJHoIqazHctsuxHnJHGqKCnisj",285,0.996503,26,286,1,285,1,1,0,1,1,140,139,146,146,40
"3630",29,"[26]pJHoIqazHctsuxHnJHGqKCnisj",290,0.996564,26,291,1,290,1,1,0,1,1,155,154,136,136,40
"3631",30,"[26]pJHoIqazHctsuxHnJHGqKCnisj",281,0.996454,26,282,1,281,1,1,0,1,1,131,130,151,151,40
"3632",31,"[26]pJHoIqazHctsuxHnJHGqKCnisj",281,0.996454,26,282,1,281,1,1,0,1,1,146,145,136,136,40
"3633",32,"[26]pJHoIqazHctsuxHnJHGqKCnisj",284,0.996491,26,285,1,284,1,1,0,1,1,143,142,142,142,40
"3634",33,"[26]pJHoIqazHctsuxHnJHGqKCnisj",284,0.996491,26,285,1,284,1,1,0,1,1,135,134,150,150,40
"3635",34,"[26]pJHoIqazHctsuxHnJHGqKCnisj",280,0.996441,26,281,1,280,1,1,0,1,1,135,134,146,146,40
"3636",35,"[26]pJHoIqazHctsuxHnJHGqKCnisj",280,0.996441,26,281,1,280,1,1,0,1,1,132,131,149,149,40
"3637",36,"[26]pJHoIqazHctsuxHnJHGqKCnisj",277,0.996403,26,278,1,277,1,1,0,1,1,145,144,133,133,40
"3638",37,"[26]pJHoIqazHctsuxHnJHGqKCnisj",287,0.996528,26,288,1,287,1,1,0,1,1,143,142,145,145,40
"3639",38,"[26]pJHoIqazHctsuxHnJHGqKCnisj",284,0.996491,26,285,1,284,1,1,0,1,1,149,148,136,136,40
"3640",39,"[26]pJHoIqazHctsuxHnJHGqKCnisj",287,0.996528,26,288,1,287,1,1,0,1,1,129,128,159,159,40
"3641",40,"[26]pJHoIqazHctsuxHnJHGqKCnisj",283,0.996479,26,284,1,283,1,1,0,1,1,152,151,132,132,40
"3642",41,"[26]pJHoIqazHctsuxHnJHGqKCnisj",281,0.996454,26,282,1,281,1,1,0,1,1,147,146,135,135,40
"3643",42,"[26]pJHoIqazHctsuxHnJHGqKCnisj",285,0.996503,26,286,1,285,1,1,0,1,1,143,142,143,143,40
"3644",43,"[26]pJHoIqazHctsuxHnJHGqKCnisj",291,0.996575,26,292,1,291,1,1,0,1,1,161,160,131,131,40
"3645",44,"[26]pJHoIqazHctsuxHnJHGqKCnisj",280,0.996441,26,281,1,280,1,1,0,1,1,135,134,146,146,40
"3646",45,"[26]pJHoIqazHctsuxHnJHGqKCnisj",280,0.996441,26,281,1,280,1,1,0,1,1,126,125,155,155,40
"3647",46,"[26]pJHoIqazHctsuxHnJHGqKCnisj",283,0.996479,26,284,1,283,1,1,0,1,1,133,132,151,151,40
"3648",47,"[26]pJHoIqazHctsuxHnJHGqKCnisj",277,0.996403,26,278,1,277,1,1,0,1,1,125,124,153,153,40
"3649",48,"[26]pJHoIqazHctsuxHnJHGqKCnisj",281,0.996454,26,282,1,281,1,1,0,1,1,136,135,146,146,40
"3650",49,"[26]pJHoIqazHctsuxHnJHGqKCnisj",278,0.996416,26,279,1,278,1,1,0,1,1,146,145,133,133,40
"3651",50,"[26]pJHoIqazHctsuxHnJHGqKCnisj",285,0.996503,26,286,1,285,1,1,0,1,1,146,145,140,140,40
"3652",51,"[26]pJHoIqazHctsuxHnJHGqKCnisj",275,0.996377,26,276,1,275,1,1,0,1,1,149,148,127,127,40
"3653",52,"[26]pJHoIqazHctsuxHnJHGqKCnisj",287,0.996528,26,288,1,287,1,1,0,1,1,149,148,139,139,40
"3654",53,"[26]pJHoIqazHctsuxHnJHGqKCnisj",281,0.996454,26,282,1,281,1,1,0,1,1,135,134,147,147,40
"3655",54,"[26]pJHoIqazHctsuxHnJHGqKCnisj",286,0.996516,26,287,1,286,1,1,0,1,1,150,149,137,137,40
"3656",55,"[26]pJHoIqazHctsuxHnJHGqKCnisj",283,0.996479,26,284,1,283,1,1,0,1,1,135,134,149,149,40
"3657",56,"[26]pJHoIqazHctsuxHnJHGqKCnisj",284,0.996491,26,285,1,284,1,1,0,1,1,136,135,149,149,40
"3658",57,"[26]pJHoIqazHctsuxHnJHGqKCnisj",280,0.996441,26,281,1,280,1,1,0,1,1,139,138,142,142,40
"3659",58,"[26]pJHoIqazHctsuxHnJHGqKCnisj",277,0.996403,26,278,1,277,1,1,0,1,1,150,149,128,128,40
"3660",59,"[26]pJHoIqazHctsuxHnJHGqKCnisj",287,0.996528,26,288,1,287,1,1,0,1,1,151,150,137,137,40
"3661",60,"[26]pJHoIqazHctsuxHnJHGqKCnisj",279,0.996429,26,280,1,279,1,1,0,1,1,142,141,138,138,40
"3662",61,"[26]pJHoIqazHctsuxHnJHGqKCnisj",273,0.99635,26,274,1,273,1,1,0,1,1,121,120,153,153,40
"3663",62,"[26]pJHoIqazHctsuxHnJHGqKCnisj",271,0.996324,26,272,1,271,1,1,0,1,1,128,127,144,144,40
"3664",63,"[26]pJHoIqazHctsuxHnJHGqKCnisj",279,0.996429,26,280,1,279,1,1,0,1,1,139,138,141,141,40
"3665",64,"[26]pJHoIqazHctsuxHnJHGqKCnisj",281,0.996454,26,282,1,281,1,1,0,1,1,143,142,139,139,40
"3666",65,"[26]pJHoIqazHctsuxHnJHGqKCnisj",288,0.99654,26,289,1,288,1,1,0,1,1,144,143,145,145,40
"3667",66,"[26]pJHoIqazHctsuxHnJHGqKCnisj",283,0.996479,26,284,1,283,1,1,0,1,1,150,149,134,134,40
"3668",67,"[26]pJHoIqazHctsuxHnJHGqKCnisj",278,0.996416,26,279,1,278,1,1,0,1,1,150,149,129,129,40
"3669",68,"[26]pJHoIqazHctsuxHnJHGqKCnisj",278,0.996416,26,279,1,278,1,1,0,1,1,141,140,138,138,40
"3670",69,"[26]pJHoIqazHctsuxHnJHGqKCnisj",283,0.996479,26,284,1,283,1,1,0,1,1,150,149,134,134,40
"3671",70,"[26]pJHoIqazHctsuxHnJHGqKCnisj",277,0.996403,26,278,1,277,1,1,0,1,1,138,137,140,140,40
"3672",71,"[26]pJHoIqazHctsuxHnJHGqKCnisj",294,0.99661,26,295,1,294,1,1,0,1,1,150,149,145,145,40
"3673",72,"[26]pJHoIqazHctsuxHnJHGqKCnisj",283,0.996479,26,284,1,283,1,1,0,1,1,132,131,152,152,40
"3674",73,"[26]pJHoIqazHctsuxHnJHGqKCnisj",277,0.996403,26,278,1,277,1,1,0,1,1,141,140,137,137,40
"3675",74,"[26]pJHoIqazHctsuxHnJHGqKCnisj",283,0.996479,26,284,1,283,1,1,0,1,1,144,143,140,140,40
"3676",75,"[26]pJHoIqazHctsuxHnJHGqKCnisj",279,0.996429,26,280,1,279,1,1,0,1,1,137,136,143,143,40
"3677",76,"[26]pJHoIqazHctsuxHnJHGqKCnisj",290,0.996564,26,291,1,290,1,1,0,1,1,151,150,140,140,40
"3678",77,"[26]pJHoIqazHctsuxHnJHGqKCnisj",286,0.996516,26,287,1,286,1,1,0,1,1,148,147,139,139,40
"3679",78,"[26]pJHoIqazHctsuxHnJHGqKCnisj",286,0.996516,26,287,1,286,1,1,0,1,1,141,140,146,146,40
"3680",79,"[26]pJHoIqazHctsuxHnJHGqKCnisj",283,0.996479,26,284,1,283,1,1,0,1,1,141,140,143,143,40
"3681",80,"[26]pJHoIqazHctsuxHnJHGqKCnisj",285,0.996503,26,286,1,285,1,1,0,1,1,154,153,132,132,40
"3682",81,"[26]pJHoIqazHctsuxHnJHGqKCnisj",285,0.996503,26,286,1,285,1,1,0,1,1,149,148,137,137,40
"3683",82,"[26]pJHoIqazHctsuxHnJHGqKCnisj",283,0.996479,26,284,1,283,1,1,0,1,1,147,146,137,137,40
"3684",83,"[26]pJHoIqazHctsuxHnJHGqKCnisj",285,0.996503,26,286,1,285,1,1,0,1,1,151,150,135,135,40
"3685",84,"[26]pJHoIqazHctsuxHnJHGqKCnisj",283,0.996479,26,284,1,283,1,1,0,1,1,134,133,150,150,40
"3686",85,"[26]pJHoIqazHctsuxHnJHGqKCnisj",274,0.996364,26,275,1,274,1,1,0,1,1,126,125,149,149,40
"3687",86,"[26]pJHoIqazHctsuxHnJHGqKCnisj",283,0.996479,26,284,1,283,1,1,0,1,1,152,151,132,132,40
"3688",87,"[26]pJHoIqazHctsuxHnJHGqKCnisj",282,0.996466,26,283,1,282,1,1,0,1,1,145,144,138,138,40
"3689",88,"[26]pJHoIqazHctsuxHnJHGqKCnisj",279,0.996429,26,280,1,279,1,1,0,1,1,134,133,146,146,40
"3690",89,"[26]pJHoIqazHctsuxHnJHGqKCnisj",280,0.996441,26,281,1,280,1,1,0,1,1,139,138,142,142,40
"3691",90,"[26]pJHoIqazHctsuxHnJHGqKCnisj",276,0.99639,26,277,1,276,1,1,0,1,1,135,134,142,142,40
"3692",91,"[26]pJHoIqazHctsuxHnJHGqKCnisj",282,0.996466,26,283,1,282,1,1,0,1,1,136,135,147,147,40
"3693",92,"[26]pJHoIqazHctsuxHnJHGqKCnisj",282,0.996466,26,283,1,282,1,1,0,1,1,137,136,146,146,40
"3694",93,"[26]pJHoIqazHctsuxHnJHGqKCnisj",281,0.996454,26,282,1,281,1,1,0,1,1,146,145,136,136,40
"3695",94,"[26]pJHoIqazHctsuxHnJHGqKCnisj",287,0.996528,26,288,1,287,1,1,0,1,1,152,151,136,136,40
"3696",95,"[26]pJHoIqazHctsuxHnJHGqKCnisj",276,0.99639,26,277,1,276,1,1,0,1,1,130,129,147,147,40
"3697",96,"[26]pJHoIqazHctsuxHnJHGqKCnisj",278,0.996416,26,279,1,278,1,1,0,1,1,146,145,133,133,40
"3698",97,"[26]pJHoIqazHctsuxHnJHGqKCnisj",277,0.996403,26,278,1,277,1,1,0,1,1,141,140,137,137,40
"3699",98,"[26]pJHoIqazHctsuxHnJHGqKCnisj",279,0.996429,26,280,1,279,1,1,0,1,1,129,128,151,151,40
"3700",99,"[26]pJHoIqazHctsuxHnJHGqKCnisj",279,0.996429,26,280,1,279,1,1,0,1,1,121,120,159,159,40
"3701",0,"[23]CFHoIoHcowHnJHGqKCzpnxI",272,0.996337,23,273,1,272,1,1,0,1,1,123,122,150,150,42
"3702",1,"[23]CFHoIoHcowHnJHGqKCzpnxI",283,0.996479,23,284,1,283,1,1,0,1,1,145,144,139,139,42
"3703",2,"[23]CFHoIoHcowHnJHGqKCzpnxI",283,0.996479,23,284,1,283,1,1,0,1,1,139,138,145,145,42
"3704",3,"[23]CFHoIoHcowHnJHGqKCzpnxI",277,0.996403,23,278,1,277,1,1,0,1,1,141,140,137,137,42
"3705",4,"[23]CFHoIoHcowHnJHGqKCzpnxI",279,0.996429,23,280,1,279,1,1,0,1,1,133,132,147,147,42
"3706",5,"[23]CFHoIoHcowHnJHGqKCzpnxI",288,0.99654,23,289,1,288,1,1,0,1,1,158,157,131,131,42
"3707",6,"[23]CFHoIoHcowHnJHGqKCzpnxI",283,0.996479,23,284,1,283,1,1,0,1,1,140,139,144,144,42
"3708",7,"[23]CFHoIoHcowHnJHGqKCzpnxI",278,0.996416,23,279,1,278,1,1,0,1,1,135,134,144,144,42
"3709",8,"[23]CFHoIoHcowHnJHGqKCzpnxI",284,0.996491,23,285,1,284,1,1,0,1,1,155,154,130,130,42
"3710",9,"[23]CFHoIoHcowHnJHGqKCzpnxI",287,0.996528,23,288,1,287,1,1,0,1,1,146,145,142,142,42
"3711",10,"[23]CFHoIoHcowHnJHGqKCzpnxI",281,0.996454,23,282,1,281,1,1,0,1,1,128,127,154,154,42
"3712",11,"[23]CFHoIoHcowHnJHGqKCzpnxI",279,0.996429,23,280,1,279,1,1,0,1,1,128,127,152,152,42
"3713",12,"[23]CFHoIoHcowHnJHGqKCzpnxI",280,0.996441,23,281,1,280,1,1,0,1,1,147,146,134,134,42
"3714",13,"[23]CFHoIoHcowHnJHGqKCzpnxI",278,0.996416,23,279,1,278,1,1,0,1,1,128,127,151,151,42
"3715",14,"[23]CFHoIoHcowHnJHGqKCzpnxI",272,0.996337,23,273,1,272,1,1,0,1,1,128,127,145,145,42
"3716",15,"[23]CFHoIoHcowHnJHGqKCzpnxI",285,0.996503,23,286,1,285,1,1,0,1,1,144,143,142,142,42
"3717",16,"[23]CFHoIoHcowHnJHGqKCzpnxI",285,0.996503,23,286,1,285,1,1,0,1,1,144,143,142,142,42
"3718",17,"[23]CFHoIoHcowHnJHGqKCzpnxI",286,0.996516,23,287,1,286,1,1,0,1,1,153,152,134,134,42
"3719",18,"[23]CFHoIoHcowHnJHGqKCzpnxI",282,0.996466,23,283,1,282,1,1,0,1,1,158,157,125,125,42
"3720",19,"[23]CFHoIoHcowHnJHGqKCzpnxI",281,0.996454,23,282,1,281,1,1,0,1,1,148,147,134,134,42
"3721",20,"[23]CFHoIoHcowHnJHGqKCzpnxI",283,0.996479,23,284,1,283,1,1,0,1,1,139,138,145,145,42
"3722",21,"[23]CFHoIoHcowHnJHGqKCzpnxI",286,0.996516,23,287,1,286,1,1,0,1,1,143,142,144,144,42
"3723",22,"[23]CFHoIoHcowHnJHGqKCzpnxI",276,0.99639,23,277,1,276,1,1,0,1,1,127,126,150,150,42
"3724",23,"[23]CFHoIoHcowHnJHGqKCzpnxI",274,0.996364,23,275,1,274,1,1,0,1,1,137,136,138,138,42
"3725",24,"[23]CFHoIoHcowHnJHGqKCzpnxI",285,0.996503,23,286,1,285,1,1,0,1,1,139,138,147,147,42
"3726",25,"[23]CFHoIoHcowHnJHGqKCzpnxI",287,0.996528,23,288,1,287,1,1,0,1,1,156,155,132,132,42
"3727",26,"[23]CFHoIoHcowHnJHGqKCzpnxI",280,0.996441,23,281,1,280,1,1,0,1,1,138,137,143,143,42
"3728",27,"[23]CFHoIoHcowHnJHGqKCzpnxI",280,0.996441,23,281,1,280,1,1,0,1,1,149,148,132,132,42
"3729",28,"[23]CFHoIoHcowHnJHGqKCzpnxI",280,0.996441,23,281,1,280,1,1,0,1,1,136,135,145,145,42
"3730",29,"[23]CFHoIoHcowHnJHGqKCzpnxI",282,0.996466,23,283,1,282,1,1,0,1,1,134,133,149,149,42
"3731",30,"[23]CFHoIoHcowHnJHGqKCzpnxI",277,0.996403,23,278,1,277,1,1,0,1,1,136,135,142,142,42
"3732",31,"[23]CFHoIoHcowHnJHGqKCzpnxI",288,0.99654,23,289,1,288,1,1,0,1,1,163,162,126,126,42
"3733",32,"[23]CFHoIoHcowHnJHGqKCzpnxI",285,0.996503,23,286,1,285,1,1,0,1,1,150,149,136,136,42
"3734",33,"[23]CFHoIoHcowHnJHGqKCzpnxI",280,0.996441,23,281,1,280,1,1,0,1,1,137,136,144,144,42
"3735",34,"[23]CFHoIoHcowHnJHGqKCzpnxI",283,0.996479,23,284,1,283,1,1,0,1,1,154,153,130,130,42
"3736",35,"[23]CFHoIoHcowHnJHGqKCzpnxI",287,0.996528,23,288,1,287,1,1,0,1,1,147,146,141,141,42
"3737",36,"[23]CFHoIoHcowHnJHGqKCzpnxI",292,0.996587,23,293,1,292,1,1,0,1,1,155,154,138,138,42
"3738",37,"[23]CFHoIoHcowHnJHGqKCzpnxI",285,0.996503,23,286,1,285,1,1,0,1,1,133,132,153,153,42
"3739",38,"[23]CFHoIoHcowHnJHGqKCzpnxI",279,0.996429,23,280,1,279,1,1,0,1,1,152,151,128,128,42
"3740",39,"[23]CFHoIoHcowHnJHGqKCzpnxI",288,0.99654,23,289,1,288,1,1,0,1,1,146,145,143,143,42
"3741",40,"[23]CFHoIoHcowHnJHGqKCzpnxI",283,0.996479,23,284,1,283,1,1,0,1,1,143,142,141,141,42
"3742",41,"[23]CFHoIoHcowHnJHGqKCzpnxI",276,0.99639,23,277,1,276,1,1,0,1,1,139,138,138,138,42
"3743",42,"[23]CFHoIoHcowHnJHGqKCzpnxI",279,0.996429,23,280,1,279,1,1,0,1,1,159,158,121,121,42
"3744",43,"[23]CFHoIoHcowHnJHGqKCzpnxI",287,0.996528,23,288,1,287,1,1,0,1,1,154,153,134,134,42
"3745",44,"[23]CFHoIoHcowHnJHGqKCzpnxI",285,0.996503,23,286,1,285,1,1,0,1,1,142,141,144,144,42
"3746",45,"[23]CFHoIoHcowHnJHGqKCzpnxI",287,0.996528,23,288,1,287,1,1,0,1,1,147,146,141,141,42
"3747",46,"[23]CFHoIoHcowHnJHGqKCzpnxI",275,0.996377,23,276,1,275,1,1,0,1,1,127,126,149,149,42
"3748",47,"[23]CFHoIoHcowHnJHGqKCzpnxI",287,0.996528,23,288,1,287,1,1,0,1,1,142,141,146,146,42
"3749",48,"[23]CFHoIoHcowHnJHGqKCzpnxI",291,0.996575,23,292,1,291,1,1,0,1,1,152,151,140,140,42
"3750",49,"[23]CFHoIoHcowHnJHGqKCzpnxI",281,0.996454,23,282,1,281,1,1,0,1,1,150,149,132,132,42
"3751",50,"[23]CFHoIoHcowHnJHGqKCzpnxI",277,0.996403,23,278,1,277,1,1,0,1,1,139,138,139,139,42
"3752",51,"[23]CFHoIoHcowHnJHGqKCzpnxI",286,0.996516,23,287,1,286,1,1,0,1,1,137,136,150,150,42
"3753",52,"[23]CFHoIoHcowHnJHGqKCzpnxI",279,0.996429,23,280,1,279,1,1,0,1,1,147,146,133,133,42
"3754",53,"[23]CFHoIoHcowHnJHGqKCzpnxI",286,0.996516,23,287,1,286,1,1,0,1,1,146,145,141,141,42
"3755",54,"[23]CFHoIoHcowHnJHGqKCzpnxI",281,0.996454,23,282,1,281,1,1,0,1,1,146,145,136,136,42
"3756",55,"[23]CFHoIoHcowHnJHGqKCzpnxI",278,0.996416,23,279,1,278,1,1,0,1,1,137,136,142,142,42
"3757",56,"[23]CFHoIoHcowHnJHGqKCzpnxI",283,0.996479,23,284,1,283,1,1,0,1,1,152,151,132,132,42
"3758",57,"[23]CFHoIoHcowHnJHGqKCzpnxI",276,0.99639,23,277,1,276,1,1,0,1,1,147,146,130,130,42
"3759",58,"[23]CFHoIoHcowHnJHGqKCzpnxI",277,0.996403,23,278,1,277,1,1,0,1,1,134,133,144,144,42
"3760",59,"[23]CFHoIoHcowHnJHGqKCzpnxI",286,0.996516,23,287,1,286,1,1,0,1,1,146,145,141,141,42
"3761",60,"[23]CFHoIoHcowHnJHGqKCzpnxI",284,0.996491,23,285,1,284,1,1,0,1,1,141,140,144,144,42
"3762",61,"[23]CFHoIoHcowHnJHGqKCzpnxI",278,0.996416,23,279,1,278,1,1,0,1,1,152,151,127,127,42
"3763",62,"[23]CFHoIoHcowHnJHGqKCzpnxI",283,0.996479,23,284,1,283,1,1,0,1,1,139,138,145,145,42
"3764",63,"[23]CFHoIoHcowHnJHGqKCzpnxI",278,0.996416,23,279,1,278,1,1,0,1,1,133,132,146,146,42
"3765",64,"[23]CFHoIoHcowHnJHGqKCzpnxI",282,0.996466,23,283,1,282,1,1,0,1,1,149,148,134,134,42
"3766",65,"[23]CFHoIoHcowHnJHGqKCzpnxI",275,0.996377,23,276,1,275,1,1,0,1,1,133,132,143,143,42
"3767",66,"[23]CFHoIoHcowHnJHGqKCzpnxI",273,0.99635,23,274,1,273,1,1,0,1,1,136,135,138,138,42
"3768",67,"[23]CFHoIoHcowHnJHGqKCzpnxI",281,0.996454,23,282,1,281,1,1,0,1,1,144,143,138,138,42
"3769",68,"[23]CFHoIoHcowHnJHGqKCzpnxI",284,0.996491,23,285,1,284,1,1,0,1,1,162,161,123,123,42
"3770",69,"[23]CFHoIoHcowHnJHGqKCzpnxI",280,0.996441,23,281,1,280,1,1,0,1,1,139,138,142,142,42
"3771",70,"[23]CFHoIoHcowHnJHGqKCzpnxI",275,0.996377,23,276,1,275,1,1,0,1,1,127,126,149,149,42
"3772",71,"[23]CFHoIoHcowHnJHGqKCzpnxI",281,0.996454,23,282,1,281,1,1,0,1,1,138,137,144,144,42
"3773",72,"[23]CFHoIoHcowHnJHGqKCzpnxI",285,0.996503,23,286,1,285,1,1,0,1,1,144,143,142,142,42
"3774",73,"[23]CFHoIoHcowHnJHGqKCzpnxI",281,0.996454,23,282,1,281,1,1,0,1,1,129,128,153,153,42
"3775",74,"[23]CFHoIoHcowHnJHGqKCzpnxI",286,0.996516,23,287,1,286,1,1,0,1,1,146,145,141,141,42
"3776",75,"[23]CFHoIoHcowHnJHGqKCzpnxI",274,0.996364,23,275,1,274,1,1,0,1,1,136,135,139,139,42
"3777",76,"[23]CFHoIoHcowHnJHGqKCzpnxI",283,0.996479,23,284,1,283,1,1,0,1,1,140,139,144,144,42
"3778",77,"[23]CFHoIoHcowHnJHGqKCzpnxI",289,0.996552,23,290,1,289,1,1,0,1,1,152,151,138,138,42
"3779",78,"[23]CFHoIoHcowHnJHGqKCzpnxI",279,0.996429,23,280,1,279,1,1,0,1,1,134,133,146,146,42
"3780",79,"[23]CFHoIoHcowHnJHGqKCzpnxI",276,0.99639,23,277,1,276,1,1,0,1,1,133,132,144,144,42
"3781",80,"[23]CFHoIoHcowHnJHGqKCzpnxI",279,0.996429,23,280,1,279,1,1,0,1,1,144,143,136,136,42
"3782",81,"[23]CFHoIoHcowHnJHGqKCzpnxI",282,0.996466,23,283,1,282,1,1,0,1,1,144,143,139,139,42
"3783",82,"[23]CFHoIoHcowHnJHGqKCzpnxI",280,0.996441,23,281,1,280,1,1,0,1,1,127,126,154,154,42
"3784",83,"[23]CFHoIoHcowHnJHGqKCzpnxI",285,0.996503,23,286,1,285,1,1,0,1,1,133,132,153,153,42
"3785",84,"[23]CFHoIoHcowHnJHGqKCzpnxI",279,0.996429,23,280,1,279,1,1,0,1,1,142,141,138,138,42
"3786",85,"[23]CFHoIoHcowHnJHGqKCzpnxI",283,0.996479,23,284,1,283,1,1,0,1,1,145,144,139,139,42
"3787",86,"[23]CFHoIoHcowHnJHGqKCzpnxI",284,0.996491,23,285,1,284,1,1,0,1,1,151,150,134,134,42
"3788",87,"[23]CFHoIoHcowHnJHGqKCzpnxI",284,0.996491,23,285,1,284,1,1,0,1,1,144,143,141,141,42
"3789",88,"[23]CFHoIoHcowHnJHGqKCzpnxI",287,0.996528,23,288,1,287,1,1,0,1,1,148,147,140,140,42
"3790",89,"[23]CFHoIoHcowHnJHGqKCzpnxI",280,0.996441,23,281,1,280,1,1,0,1,1,132,131,149,149,42
"3791",90,"[23]CFHoIoHcowHnJHGqKCzpnxI",287,0.996528,23,288,1,287,1,1,0,1,1,150,149,138,138,42
"3792",91,"[23]CFHoIoHcowHnJHGqKCzpnxI",277,0.996403,23,278,1,277,1,1,0,1,1,149,148,129,129,42
"3793",92,"[23]CFHoIoHcowHnJHGqKCzpnxI",274,0.996364,23,275,1,274,1,1,0,1,1,129,128,146,146,42
"3794",93,"[23]CFHoIoHcowHnJHGqKCzpnxI",278,0.996416,23,279,1,278,1,1,0,1,1,142,141,137,137,42
"3795",94,"[23]CFHoIoHcowHnJHGqKCzpnxI",283,0.996479,23,284,1,283,1,1,0,1,1,144,143,140,140,42
"3796",95,"[23]CFHoIoHcowHnJHGqKCzpnxI",285,0.996503,23,286,1,285,1,1,0,1,1,156,155,130,130,42
"3797",96,"[23]CFHoIoHcowHnJHGqKCzpnxI",287,0.996528,23,288,1,287,1,1,0,1,1,142,141,146,146,42
"3798",97,"[23]CFHoIoHcowHnJHGqKCzpnxI",278,0.996416,23,279,1,278,1,1,0,1,1,139,138,140,140,42
"3799",98,"[23]CFHoIoHcowHnJHGqKCzpnxI",281,0.996454,23,282,1,281,1,1,0,1,1,140,139,142,142,42
"3800",99,"[23]CFHoIoHcowHnJHGqKCzpnxI",286,0.996516,23,287,1,286,1,1,0,1,1,153,152,134,134,42
"3801",0,"[22]tloIoHcotHnJHGqKCsoAoF",279,0.996429,22,280,1,279,1,1,0,1,1,134,133,146,146,43
"3802",1,"[22]tloIoHcotHnJHGqKCsoAoF",282,0.996466,22,283,1,282,1,1,0,1,1,138,137,145,145,43
"3803",2,"[22]tloIoHcotHnJHGqKCsoAoF",284,0.996491,22,285,1,284,1,1,0,1,1,135,134,150,150,43
"3804",3,"[22]tloIoHcotHnJHGqKCsoAoF",277,0.996403,22,278,1,277,1,1,0,1,1,126,125,152,152,43
"3805",4,"[22]tloIoHcotHnJHGqKCsoAoF",281,0.996454,22,282,1,281,1,1,0,1,1,131,130,151,151,43
"3806",5,"[22]tloIoHcotHnJHGqKCsoAoF",276,0.99639,22,277,1,276,1,1,0,1,1,146,145,131,131,43
"3807",6,"[22]tloIoHcotHnJHGqKCsoAoF",280,0.996441,22,281,1,280,1,1,0,1,1,148,147,133,133,43
"3808",7,"[22]tloIoHcotHnJHGqKCsoAoF",278,0.996416,22,279,1,278,1,1,0,1,1,149,148,130,130,43
"3809",8,"[22]tloIoHcotHnJHGqKCsoAoF",286,0.996516,22,287,1,286,1,1,0,1,1,133,132,154,154,43
"3810",9,"[22]tloIoHcotHnJHGqKCsoAoF",276,0.99639,22,277,1,276,1,1,0,1,1,135,134,142,142,43
"3811",10,"[22]tloIoHcotHnJHGqKCsoAoF",273,0.99635,22,274,1,273,1,1,0,1,1,126,125,148,148,43
"3812",11,"[22]tloIoHcotHnJHGqKCsoAoF",278,0.996416,22,279,1,278,1,1,0,1,1,140,139,139,139,43
"3813",12,"[22]tloIoHcotHnJHGqKCsoAoF",289,0.996552,22,290,1,289,1,1,0,1,1,167,166,123,123,43
"3814",13,"[22]tloIoHcotHnJHGqKCsoAoF",284,0.996491,22,285,1,284,1,1,0,1,1,147,146,138,138,43
"3815",14,"[22]tloIoHcotHnJHGqKCsoAoF",283,0.996479,22,284,1,283,1,1,0,1,1,143,142,141,141,43
"3816",15,"[22]tloIoHcotHnJHGqKCsoAoF",279,0.996429,22,280,1,279,1,1,0,1,1,137,136,143,143,43
"3817",16,"[22]tloIoHcotHnJHGqKCsoAoF",285,0.996503,22,286,1,285,1,1,0,1,1,144,143,142,142,43
"3818",17,"[22]tloIoHcotHnJHGqKCsoAoF",280,0.996441,22,281,1,280,1,1,0,1,1,153,152,128,128,43
"3819",18,"[22]tloIoHcotHnJHGqKCsoAoF",282,0.996466,22,283,1,282,1,1,0,1,1,160,159,123,123,43
"3820",19,"[22]tloIoHcotHnJHGqKCsoAoF",280,0.996441,22,281,1,280,1,1,0,1,1,148,147,133,133,43
"3821",20,"[22]tloIoHcotHnJHGqKCsoAoF",273,0.99635,22,274,1,273,1,1,0,1,1,145,144,129,129,43
"3822",21,"[22]tloIoHcotHnJHGqKCsoAoF",279,0.996429,22,280,1,279,1,1,0,1,1,125,124,155,155,43
"3823",22,"[22]tloIoHcotHnJHGqKCsoAoF",267,0.996269,22,268,1,267,1,1,0,1,1,137,136,131,131,43
"3824",23,"[22]tloIoHcotHnJHGqKCsoAoF",280,0.996441,22,281,1,280,1,1,0,1,1,132,131,149,149,43
"3825",24,"[22]tloIoHcotHnJHGqKCsoAoF",279,0.996429,22,280,1,279,1,1,0,1,1,122,121,158,158,43
"3826",25,"[22]tloIoHcotHnJHGqKCsoAoF",287,0.996528,22,288,1,287,1,1,0,1,1,145,144,143,143,43
"3827",26,"[22]tloIoHcotHnJHGqKCsoAoF",281,0.996454,22,282,1,281,1,1,0,1,1,151,150,131,131,43
"3828",27,"[22]tloIoHcotHnJHGqKCsoAoF",284,0.996491,22,285,1,284,1,1,0,1,1,141,140,144,144,43
"3829",28,"[22]tloIoHcotHnJHGqKCsoAoF",275,0.996377,22,276,1,275,1,1,0,1,1,121,120,155,155,43
"3830",29,"[22]tloIoHcotHnJHGqKCsoAoF",280,0.996441,22,281,1,280,1,1,0,1,1,150,149,131,131,43
"3831",30,"[22]tloIoHcotHnJHGqKCsoAoF",283,0.996479,22,284,1,283,1,1,0,1,1,143,142,141,141,43
"3832",31,"[22]tloIoHcotHnJHGqKCsoAoF",289,0.996552,22,290,1,289,1,1,0,1,1,159,158,131,131,43
"3833",32,"[22]tloIoHcotHnJHGqKCsoAoF",282,0.996466,22,283,1,282,1,1,0,1,1,148,147,135,135,43
"3834",33,"[22]tloIoHcotHnJHGqKCsoAoF",283,0.996479,22,284,1,283,1,1,0,1,1,158,157,126,126,43
"3835",34,"[22]tloIoHcotHnJHGqKCsoAoF",280,0.996441,22,281,1,280,1,1,0,1,1,123,122,158,158,43
"3836",35,"[22]tloIoHcotHnJHGqKCsoAoF",288,0.99654,22,289,1,288,1,1,0,1,1,163,162,126,126,43
"3837",36,"[22]tloIoHcotHnJHGqKCsoAoF",279,0.996429,22,280,1,279,1,1,0,1,1,133,132,147,147,43
"3838",37,"[22]tloIoHcotHnJHGqKCsoAoF",279,0.996429,22,280,1,279,1,1,0,1,1,125,124,155,155,43
"3839",38,"[22]tloIoHcotHnJHGqKCsoAoF",282,0.996466,22,283,1,282,1,1,0,1,1,131,130,152,152,43
"3840",39,"[22]tloIoHcotHnJHGqKCsoAoF",274,0.996364,22,275,1,274,1,1,0,1,1,116,115,159,159,43
"3841",40,"[22]tloIoHcotHnJHGqKCsoAoF",277,0.996403,22,278,1,277,1,1,0,1,1,125,124,153,153,43
"3842",41,"[22]tloIoHcotHnJHGqKCsoAoF",273,0.99635,22,274,1,273,1,1,0,1,1,125,124,149,149,43
"3843",42,"[22]tloIoHcotHnJHGqKCsoAoF",285,0.996503,22,286,1,285,1,1,0,1,1,144,143,142,142,43
"3844",43,"[22]tloIoHcotHnJHGqKCsoAoF",281,0.996454,22,282,1,281,1,1,0,1,1,149,148,133,133,43
"3845",44,"[22]tloIoHcotHnJHGqKCsoAoF",272,0.996337,22,273,1,272,1,1,0,1,1,137,136,136,136,43
"3846",45,"[22]tloIoHcotHnJHGqKCsoAoF",277,0.996403,22,278,1,277,1,1,0,1,1,136,135,142,142,43
"3847",46,"[22]tloIoHcotHnJHGqKCsoAoF",279,0.996429,22,280,1,279,1,1,0,1,1,147,146,133,133,43
"3848",47,"[22]tloIoHcotHnJHGqKCsoAoF",291,0.996575,22,292,1,291,1,1,0,1,1,158,157,134,134,43
"3849",48,"[22]tloIoHcotHnJHGqKCsoAoF",283,0.996479,22,284,1,283,1,1,0,1,1,148,147,136,136,43
"3850",49,"[22]tloIoHcotHnJHGqKCsoAoF",284,0.996491,22,285,1,284,1,1,0,1,1,139,138,146,146,43
"3851",50,"[22]tloIoHcotHnJHGqKCsoAoF",284,0.996491,22,285,1,284,1,1,0,1,1,146,145,139,139,43
"3852",51,"[22]tloIoHcotHnJHGqKCsoAoF",282,0.996466,22,283,1,282,1,1,0,1,1,138,137,145,145,43
"3853",52,"[22]tloIoHcotHnJHGqKCsoAoF",279,0.996429,22,280,1,279,1,1,0,1,1,142,141,138,138,43
"3854",53,"[22]tloIoHcotHnJHGqKCsoAoF",279,0.996429,22,280,1,279,1,1,0,1,1,132,131,148,148,43
"3855",54,"[22]tloIoHcotHnJHGqKCsoAoF",284,0.996491,22,285,1,284,1,1,0,1,1,157,156,128,128,43
"3856",55,"[22]tloIoHcotHnJHGqKCsoAoF",285,0.996503,22,286,1,285,1,1,0,1,1,128,127,158,158,43
"3857",56,"[22]tloIoHcotHnJHGqKCsoAoF",284,0.996491,22,285,1,284,1,1,0,1,1,149,148,136,136,43
"3858",57,"[22]tloIoHcotHnJHGqKCsoAoF",275,0.996377,22,276,1,275,1,1,0,1,1,120,119,156,156,43
"3859",58,"[22]tloIoHcotHnJHGqKCsoAoF",280,0.996441,22,281,1,280,1,1,0,1,1,145,144,136,136,43
"3860",59,"[22]tloIoHcotHnJHGqKCsoAoF",286,0.996516,22,287,1,286,1,1,0,1,1,145,144,142,142,43
"3861",60,"[22]tloIoHcotHnJHGqKCsoAoF",276,0.99639,22,277,1,276,1,1,0,1,1,136,135,141,141,43
"3862",61,"[22]tloIoHcotHnJHGqKCsoAoF",282,0.996466,22,283,1,282,1,1,0,1,1,161,160,122,122,43
"3863",62,"[22]tloIoHcotHnJHGqKCsoAoF",282,0.996466,22,283,1,282,1,1,0,1,1,140,139,143,143,43
"3864",63,"[22]tloIoHcotHnJHGqKCsoAoF",277,0.996403,22,278,1,277,1,1,0,1,1,130,129,148,148,43
"3865",64,"[22]tloIoHcotHnJHGqKCsoAoF",283,0.996479,22,284,1,283,1,1,0,1,1,139,138,145,145,43
"3866",65,"[22]tloIoHcotHnJHGqKCsoAoF",285,0.996503,22,286,1,285,1,1,0,1,1,144,143,142,142,43
"3867",66,"[22]tloIoHcotHnJHGqKCsoAoF",283,0.996479,22,284,1,283,1,1,0,1,1,144,143,140,140,43
"3868",67,"[22]tloIoHcotHnJHGqKCsoAoF",288,0.99654,22,289,1,288,1,1,0,1,1,154,153,135,135,43
"3869",68,"[22]tloIoHcotHnJHGqKCsoAoF",285,0.996503,22,286,1,285,1,1,0,1,1,159,158,127,127,43
"3870",69,"[22]tloIoHcotHnJHGqKCsoAoF",288,0.99654,22,289,1,288,1,1,0,1,1,154,153,135,135,43
"3871",70,"[22]tloIoHcotHnJHGqKCsoAoF",272,0.996337,22,273,1,272,1,1,0,1,1,136,135,137,137,43
"3872",71,"[22]tloIoHcotHnJHGqKCsoAoF",285,0.996503,22,286,1,285,1,1,0,1,1,143,142,143,143,43
"3873",72,"[22]tloIoHcotHnJHGqKCsoAoF",275,0.996377,22,276,1,275,1,1,0,1,1,139,138,137,137,43
"3874",73,"[22]tloIoHcotHnJHGqKCsoAoF",288,0.99654,22,289,1,288,1,1,0,1,1,143,142,146,146,43
"3875",74,"[22]tloIoHcotHnJHGqKCsoAoF",282,0.996466,22,283,1,282,1,1,0,1,1,142,141,141,141,43
"3876",75,"[22]tloIoHcotHnJHGqKCsoAoF",285,0.996503,22,286,1,285,1,1,0,1,1,157,156,129,129,43
"3877",76,"[22]tloIoHcotHnJHGqKCsoAoF",287,0.996528,22,288,1,287,1,1,0,1,1,150,149,138,138,43
"3878",77,"[22]tloIoHcotHnJHGqKCsoAoF",275,0.996377,22,276,1,275,1,1,0,1,1,129,128,147,147,43
"3879",78,"[22]tloIoHcotHnJHGqKCsoAoF",283,0.996479,22,284,1,283,1,1,0,1,1,145,144,139,139,43
"3880",79,"[22]tloIoHcotHnJHGqKCsoAoF",284,0.996491,22,285,1,284,1,1,0,1,1,161,160,124,124,43
"3881",80,"[22]tloIoHcotHnJHGqKCsoAoF",292,0.996587,22,293,1,292,1,1,0,1,1,168,167,125,125,43
"3882",81,"[22]tloIoHcotHnJHGqKCsoAoF",278,0.996416,22,279,1,278,1,1,0,1,1,128,127,151,151,43
"3883",82,"[22]tloIoHcotHnJHGqKCsoAoF",286,0.996516,22,287,1,286,1,1,0,1,1,130,129,157,157,43
"3884",83,"[22]tloIoHcotHnJHGqKCsoAoF",283,0.996479,22,284,1,283,1,1,0,1,1,141,140,143,143,43
"3885",84,"[22]tloIoHcotHnJHGqKCsoAoF",274,0.996364,22,275,1,274,1,1,0,1,1,132,131,143,143,43
"3886",85,"[22]tloIoHcotHnJHGqKCsoAoF",284,0.996491,22,285,1,284,1,1,0,1,1,141,140,144,144,43
"3887",86,"[22]tloIoHcotHnJHGqKCsoAoF",281,0.996454,22,282,1,281,1,1,0,1,1,145,144,137,137,43
"3888",87,"[22]tloIoHcotHnJHGqKCsoAoF",281,0.996454,22,282,1,281,1,1,0,1,1,151,150,131,131,43
"3889",88,"[22]tloIoHcotHnJHGqKCsoAoF",278,0.996416,22,279,1,278,1,1,0,1,1,145,144,134,134,43
"3890",89,"[22]tloIoHcotHnJHGqKCsoAoF",276,0.99639,22,277,1,276,1,1,0,1,1,142,141,135,135,43
"3891",90,"[22]tloIoHcotHnJHGqKCsoAoF",276,0.99639,22,277,1,276,1,1,0,1,1,146,145,131,131,43
"3892",91,"[22]tloIoHcotHnJHGqKCsoAoF",277,0.996403,22,278,1,277,1,1,0,1,1,131,130,147,147,43
"3893",92,"[22]tloIoHcotHnJHGqKCsoAoF",286,0.996516,22,287,1,286,1,1,0,1,1,138,137,149,149,43
"3894",93,"[22]tloIoHcotHnJHGqKCsoAoF",279,0.996429,22,280,1,279,1,1,0,1,1,145,144,135,135,43
"3895",94,"[22]tloIoHcotHnJHGqKCsoAoF",275,0.996377,22,276,1,275,1,1,0,1,1,128,127,148,148,43
"3896",95,"[22]tloIoHcotHnJHGqKCsoAoF",278,0.996416,22,279,1,278,1,1,0,1,1,139,138,140,140,43
"3897",96,"[22]tloIoHcotHnJHGqKCsoAoF",281,0.996454,22,282,1,281,1,1,0,1,1,146,145,136,136,43
"3898",97,"[22]tloIoHcotHnJHGqKCsoAoF",276,0.99639,22,277,1,276,1,1,0,1,1,119,118,158,158,43
"3899",98,"[22]tloIoHcotHnJHGqKCsoAoF",278,0.996416,22,279,1,278,1,1,0,1,1,148,147,131,131,43
"3900",99,"[22]tloIoHcotHnJHGqKCsoAoF",282,0.996466,22,283,1,282,1,1,0,1,1,148,147,135,135,43
"3901",0,"[25]BFoIoHcovHnJHGqKCiysxspfJ",279,0.996429,25,280,1,279,1,1,0,1,1,151,150,129,129,44
"3902",1,"[25]BFoIoHcovHnJHGqKCiysxspfJ",281,0.996454,25,282,1,281,1,1,0,1,1,130,129,152,152,44
"3903",2,"[25]BFoIoHcovHnJHGqKCiysxspfJ",292,0.996587,25,293,1,292,1,1,0,1,1,147,146,146,146,44
"3904",3,"[25]BFoIoHcovHnJHGqKCiysxspfJ",281,0.996454,25,282,1,281,1,1,0,1,1,135,134,147,147,44
"3905",4,"[25]BFoIoHcovHnJHGqKCiysxspfJ",281,0.996454,25,282,1,281,1,1,0,1,1,137,136,145,145,44
"3906",5,"[25]BFoIoHcovHnJHGqKCiysxspfJ",285,0.996503,25,286,1,285,1,1,0,1,1,143,142,143,143,44
"3907",6,"[25]BFoIoHcovHnJHGqKCiysxspfJ",285,0.996503,25,286,1,285,1,1,0,1,1,146,145,140,140,44
"3908",7,"[25]BFoIoHcovHnJHGqKCiysxspfJ",282,0.996466,25,283,1,282,1,1,0,1,1,144,143,139,139,44
"3909",8,"[25]BFoIoHcovHnJHGqKCiysxspfJ",273,0.99635,25,274,1,273,1,1,0,1,1,130,129,144,144,44
"3910",9,"[25]BFoIoHcovHnJHGqKCiysxspfJ",282,0.996466,25,283,1,282,1,1,0,1,1,154,153,129,129,44
"3911",10,"[25]BFoIoHcovHnJHGqKCiysxspfJ",275,0.996377,25,276,1,275,1,1,0,1,1,134,133,142,142,44
"3912",11,"[25]BFoIoHcovHnJHGqKCiysxspfJ",282,0.996466,25,283,1,282,1,1,0,1,1,154,153,129,129,44
"3913",12,"[25]BFoIoHcovHnJHGqKCiysxspfJ",281,0.996454,25,282,1,281,1,1,0,1,1,157,156,125,125,44
"3914",13,"[25]BFoIoHcovHnJHGqKCiysxspfJ",279,0.996429,25,280,1,279,1,1,0,1,1,131,130,149,149,44
"3915",14,"[25]BFoIoHcovHnJHGqKCiysxspfJ",285,0.996503,25,286,1,285,1,1,0,1,1,148,147,138,138,44
"3916",15,"[25]BFoIoHcovHnJHGqKCiysxspfJ",276,0.99639,25,277,1,276,1,1,0,1,1,138,137,139,139,44
"3917",16,"[25]BFoIoHcovHnJHGqKCiysxspfJ",280,0.996441,25,281,1,280,1,1,0,1,1,138,137,143,143,44
"3918",17,"[25]BFoIoHcovHnJHGqKCiysxspfJ",278,0.996416,25,279,1,278,1,1,0,1,1,141,140,138,138,44
"3919",18,"[25]BFoIoHcovHnJHGqKCiysxspfJ",284,0.996491,25,285,1,284,1,1,0,1,1,138,137,147,147,44
"3920",19,"[25]BFoIoHcovHnJHGqKCiysxspfJ",284,0.996491,25,285,1,284,1,1,0,1,1,172,171,113,113,44
"3921",20,"[25]BFoIoHcovHnJHGqKCiysxspfJ",283,0.996479,25,284,1,283,1,1,0,1,1,149,148,135,135,44
"3922",21,"[25]BFoIoHcovHnJHGqKCiysxspfJ",280,0.996441,25,281,1,280,1,1,0,1,1,133,132,148,148,44
"3923",22,"[25]BFoIoHcovHnJHGqKCiysxspfJ",283,0.996479,25,284,1,283,1,1,0,1,1,138,137,146,146,44
"3924",23,"[25]BFoIoHcovHnJHGqKCiysxspfJ",284,0.996491,25,285,1,284,1,1,0,1,1,148,147,137,137,44
"3925",24,"[25]BFoIoHcovHnJHGqKCiysxspfJ",275,0.996377,25,276,1,275,1,1,0,1,1,152,151,124,124,44
"3926",25,"[25]BFoIoHcovHnJHGqKCiysxspfJ",289,0.996552,25,290,1,289,1,1,0,1,1,156,155,134,134,44
"3927",26,"[25]BFoIoHcovHnJHGqKCiysxspfJ",283,0.996479,25,284,1,283,1,1,0,1,1,147,146,137,137,44
"3928",27,"[25]BFoIoHcovHnJHGqKCiysxspfJ",279,0.996429,25,280,1,279,1,1,0,1,1,129,128,151,151,44
"3929",28,"[25]BFoIoHcovHnJHGqKCiysxspfJ",277,0.996403,25,278,1,277,1,1,0,1,1,130,129,148,148,44
"3930",29,"[25]BFoIoHcovHnJHGqKCiysxspfJ",283,0.996479,25,284,1,283,1,1,0,1,1,154,153,130,130,44
"3931",30,"[25]BFoIoHcovHnJHGqKCiysxspfJ",280,0.996441,25,281,1,280,1,1,0,1,1,125,124,156,156,44
"3932",31,"[25]BFoIoHcovHnJHGqKCiysxspfJ",273,0.99635,25,274,1,273,1,1,0,1,1,139,138,135,135,44
"3933",32,"[25]BFoIoHcovHnJHGqKCiysxspfJ",281,0.996454,25,282,1,281,1,1,0,1,1,145,144,137,137,44
"3934",33,"[25]BFoIoHcovHnJHGqKCiysxspfJ",279,0.996429,25,280,1,279,1,1,0,1,1,135,134,145,145,44
"3935",34,"[25]BFoIoHcovHnJHGqKCiysxspfJ",284,0.996491,25,285,1,284,1,1,0,1,1,149,148,136,136,44
"3936",35,"[25]BFoIoHcovHnJHGqKCiysxspfJ",284,0.996491,25,285,1,284,1,1,0,1,1,138,137,147,147,44
"3937",36,"[25]BFoIoHcovHnJHGqKCiysxspfJ",279,0.996429,25,280,1,279,1,1,0,1,1,134,133,146,146,44
"3938",37,"[25]BFoIoHcovHnJHGqKCiysxspfJ",274,0.996364,25,275,1,274,1,1,0,1,1,131,130,144,144,44
"3939",38,"[25]BFoIoHcovHnJHGqKCiysxspfJ",285,0.996503,25,286,1,285,1,1,0,1,1,147,146,139,139,44
"3940",39,"[25]BFoIoHcovHnJHGqKCiysxspfJ",277,0.996403,25,278,1,277,1,1,0,1,1,126,125,152,152,44
"3941",40,"[25]BFoIoHcovHnJHGqKCiysxspfJ",274,0.996364,25,275,1,274,1,1,0,1,1,136,135,139,139,44
"3942",41,"[25]BFoIoHcovHnJHGqKCiysxspfJ",287,0.996528,25,288,1,287,1,1,0,1,1,150,149,138,138,44
"3943",42,"[25]BFoIoHcovHnJHGqKCiysxspfJ",288,0.99654,25,289,1,288,1,1,0,1,1,151,150,138,138,44
"3944",43,"[25]BFoIoHcovHnJHGqKCiysxspfJ",280,0.996441,25,281,1,280,1,1,0,1,1,139,138,142,142,44
"3945",44,"[25]BFoIoHcovHnJHGqKCiysxspfJ",284,0.996491,25,285,1,284,1,1,0,1,1,144,143,141,141,44
"3946",45,"[25]BFoIoHcovHnJHGqKCiysxspfJ",277,0.996403,25,278,1,277,1,1,0,1,1,137,136,141,141,44
"3947",46,"[25]BFoIoHcovHnJHGqKCiysxspfJ",290,0.996564,25,291,1,290,1,1,0,1,1,146,145,145,145,44
"3948",47,"[25]BFoIoHcovHnJHGqKCiysxspfJ",273,0.99635,25,274,1,273,1,1,0,1,1,134,133,140,140,44
"3949",48,"[25]BFoIoHcovHnJHGqKCiysxspfJ",284,0.996491,25,285,1,284,1,1,0,1,1,166,165,119,119,44
"3950",49,"[25]BFoIoHcovHnJHGqKCiysxspfJ",286,0.996516,25,287,1,286,1,1,0,1,1,158,157,129,129,44
"3951",50,"[25]BFoIoHcovHnJHGqKCiysxspfJ",283,0.996479,25,284,1,283,1,1,0,1,1,137,136,147,147,44
"3952",51,"[25]BFoIoHcovHnJHGqKCiysxspfJ",287,0.996528,25,288,1,287,1,1,0,1,1,144,143,144,144,44
"3953",52,"[25]BFoIoHcovHnJHGqKCiysxspfJ",281,0.996454,25,282,1,281,1,1,0,1,1,137,136,145,145,44
"3954",53,"[25]BFoIoHcovHnJHGqKCiysxspfJ",283,0.996479,25,284,1,283,1,1,0,1,1,145,144,139,139,44
"3955",54,"[25]BFoIoHcovHnJHGqKCiysxspfJ",281,0.996454,25,282,1,281,1,1,0,1,1,147,146,135,135,44
"3956",55,"[25]BFoIoHcovHnJHGqKCiysxspfJ",279,0.996429,25,280,1,279,1,1,0,1,1,136,135,144,144,44
"3957",56,"[25]BFoIoHcovHnJHGqKCiysxspfJ",284,0.996491,25,285,1,284,1,1,0,1,1,148,147,137,137,44
"3958",57,"[25]BFoIoHcovHnJHGqKCiysxspfJ",278,0.996416,25,279,1,278,1,1,0,1,1,142,141,137,137,44
"3959",58,"[25]BFoIoHcovHnJHGqKCiysxspfJ",284,0.996491,25,285,1,284,1,1,0,1,1,136,135,149,149,44
"3960",59,"[25]BFoIoHcovHnJHGqKCiysxspfJ",289,0.996552,25,290,1,289,1,1,0,1,1,140,139,150,150,44
"3961",60,"[25]BFoIoHcovHnJHGqKCiysxspfJ",274,0.996364,25,275,1,274,1,1,0,1,1,130,129,145,145,44
"3962",61,"[25]BFoIoHcovHnJHGqKCiysxspfJ",275,0.996377,25,276,1,275,1,1,0,1,1,147,146,129,129,44
"3963",62,"[25]BFoIoHcovHnJHGqKCiysxspfJ",282,0.996466,25,283,1,282,1,1,0,1,1,136,135,147,147,44
"3964",63,"[25]BFoIoHcovHnJHGqKCiysxspfJ",283,0.996479,25,284,1,283,1,1,0,1,1,139,138,145,145,44
"3965",64,"[25]BFoIoHcovHnJHGqKCiysxspfJ",285,0.996503,25,286,1,285,1,1,0,1,1,161,160,125,125,44
"3966",65,"[25]BFoIoHcovHnJHGqKCiysxspfJ",283,0.996479,25,284,1,283,1,1,0,1,1,144,143,140,140,44
"3967",66,"[25]BFoIoHcovHnJHGqKCiysxspfJ",296,0.996633,25,297,1,296,1,1,0,1,1,152,151,145,145,44
"3968",67,"[25]BFoIoHcovHnJHGqKCiysxspfJ",274,0.996364,25,275,1,274,1,1,0,1,1,140,139,135,135,44
"3969",68,"[25]BFoIoHcovHnJHGqKCiysxspfJ",283,0.996479,25,284,1,283,1,1,0,1,1,132,131,152,152,44
"3970",69,"[25]BFoIoHcovHnJHGqKCiysxspfJ",282,0.996466,25,283,1,282,1,1,0,1,1,148,147,135,135,44
"3971",70,"[25]BFoIoHcovHnJHGqKCiysxspfJ",284,0.996491,25,285,1,284,1,1,0,1,1,149,148,136,136,44
"3972",71,"[25]BFoIoHcovHnJHGqKCiysxspfJ",286,0.996516,25,287,1,286,1,1,0,1,1,160,159,127,127,44
"3973",72,"[25]BFoIoHcovHnJHGqKCiysxspfJ",282,0.996466,25,283,1,282,1,1,0,1,1,148,147,135,135,44
"3974",73,"[25]BFoIoHcovHnJHGqKCiysxspfJ",280,0.996441,25,281,1,280,1,1,0,1,1,141,140,140,140,44
"3975",74,"[25]BFoIoHcovHnJHGqKCiysxspfJ",278,0.996416,25,279,1,278,1,1,0,1,1,133,132,146,146,44
"3976",75,"[25]BFoIoHcovHnJHGqKCiysxspfJ",291,0.996575,25,292,1,291,1,1,0,1,1,148,147,144,144,44
"3977",76,"[25]BFoIoHcovHnJHGqKCiysxspfJ",278,0.996416,25,279,1,278,1,1,0,1,1,129,128,150,150,44
"3978",77,"[25]BFoIoHcovHnJHGqKCiysxspfJ",280,0.996441,25,281,1,280,1,1,0,1,1,139,138,142,142,44
"3979",78,"[25]BFoIoHcovHnJHGqKCiysxspfJ",273,0.99635,25,274,1,273,1,1,0,1,1,128,127,146,146,44
"3980",79,"[25]BFoIoHcovHnJHGqKCiysxspfJ",279,0.996429,25,280,1,279,1,1,0,1,1,142,141,138,138,44
"3981",80,"[25]BFoIoHcovHnJHGqKCiysxspfJ",276,0.99639,25,277,1,276,1,1,0,1,1,137,136,140,140,44
"3982",81,"[25]BFoIoHcovHnJHGqKCiysxspfJ",274,0.996364,25,275,1,274,1,1,0,1,1,132,131,143,143,44
"3983",82,"[25]BFoIoHcovHnJHGqKCiysxspfJ",277,0.996403,25,278,1,277,1,1,0,1,1,145,144,133,133,44
"3984",83,"[25]BFoIoHcovHnJHGqKCiysxspfJ",288,0.99654,25,289,1,288,1,1,0,1,1,151,150,138,138,44
"3985",84,"[25]BFoIoHcovHnJHGqKCiysxspfJ",293,0.996599,25,294,1,293,1,1,0,1,1,154,153,140,140,44
"3986",85,"[25]BFoIoHcovHnJHGqKCiysxspfJ",285,0.996503,25,286,1,285,1,1,0,1,1,147,146,139,139,44
"3987",86,"[25]BFoIoHcovHnJHGqKCiysxspfJ",279,0.996429,25,280,1,279,1,1,0,1,1,135,134,145,145,44
"3988",87,"[25]BFoIoHcovHnJHGqKCiysxspfJ",275,0.996377,25,276,1,275,1,1,0,1,1,141,140,135,135,44
"3989",88,"[25]BFoIoHcovHnJHGqKCiysxspfJ",278,0.996416,25,279,1,278,1,1,0,1,1,139,138,140,140,44
"3990",89,"[25]BFoIoHcovHnJHGqKCiysxspfJ",285,0.996503,25,286,1,285,1,1,0,1,1,139,138,147,147,44
"3991",90,"[25]BFoIoHcovHnJHGqKCiysxspfJ",282,0.996466,25,283,1,282,1,1,0,1,1,135,134,148,148,44
"3992",91,"[25]BFoIoHcovHnJHGqKCiysxspfJ",277,0.996403,25,278,1,277,1,1,0,1,1,143,142,135,135,44
"3993",92,"[25]BFoIoHcovHnJHGqKCiysxspfJ",288,0.99654,25,289,1,288,1,1,0,1,1,164,163,125,125,44
"3994",93,"[25]BFoIoHcovHnJHGqKCiysxspfJ",283,0.996479,25,284,1,283,1,1,0,1,1,141,140,143,143,44
"3995",94,"[25]BFoIoHcovHnJHGqKCiysxspfJ",285,0.996503,25,286,1,285,1,1,0,1,1,147,146,139,139,44
"3996",95,"[25]BFoIoHcovHnJHGqKCiysxspfJ",285,0.996503,25,286,1,285,1,1,0,1,1,142,141,144,144,44
"3997",96,"[25]BFoIoHcovHnJHGqKCiysxspfJ",290,0.996564,25,291,1,290,1,1,0,1,1,148,147,143,143,44
"3998",97,"[25]BFoIoHcovHnJHGqKCiysxspfJ",276,0.99639,25,277,1,276,1,1,0,1,1,130,129,147,147,44
"3999",98,"[25]BFoIoHcovHnJHGqKCiysxspfJ",278,0.996416,25,279,1,278,1,1,0,1,1,129,128,150,150,44
"4000",99,"[25]BFoIoHcovHnJHGqKCiysxspfJ",286,0.996516,25,287,1,286,1,1,0,1,1,151,150,136,136,44
"4001",0,"[20]ioIoHcosHnJHGqKClisj",281,0.996454,20,282,1,281,1,1,0,1,1,142,141,140,140,45
"4002",1,"[20]ioIoHcosHnJHGqKClisj",281,0.996454,20,282,1,281,1,1,0,1,1,142,141,140,140,45
"4003",2,"[20]ioIoHcosHnJHGqKClisj",291,0.996575,20,292,1,291,1,1,0,1,1,149,148,143,143,45
"4004",3,"[20]ioIoHcosHnJHGqKClisj",286,0.996516,20,287,1,286,1,1,0,1,1,157,156,130,130,45
"4005",4,"[20]ioIoHcosHnJHGqKClisj",286,0.996516,20,287,1,286,1,1,0,1,1,145,144,142,142,45
"4006",5,"[20]ioIoHcosHnJHGqKClisj",283,0.996479,20,284,1,283,1,1,0,1,1,154,153,130,130,45
"4007",6,"[20]ioIoHcosHnJHGqKClisj",277,0.996403,20,278,1,277,1,1,0,1,1,131,130,147,147,45
"4008",7,"[20]ioIoHcosHnJHGqKClisj",281,0.996454,20,282,1,281,1,1,0,1,1,141,140,141,141,45
"4009",8,"[20]ioIoHcosHnJHGqKClisj",282,0.996466,20,283,1,282,1,1,0,1,1,144,143,139,139,45
"4010",9,"[20]ioIoHcosHnJHGqKClisj",279,0.996429,20,280,1,279,1,1,0,1,1,139,138,141,141,45
"4011",10,"[20]ioIoHcosHnJHGqKClisj",279,0.996429,20,280,1,279,1,1,0,1,1,138,137,142,142,45
"4012",11,"[20]ioIoHcosHnJHGqKClisj",282,0.996466,20,283,1,282,1,1,0,1,1,152,151,131,131,45
"4013",12,"[20]ioIoHcosHnJHGqKClisj",283,0.996479,20,284,1,283,1,1,0,1,1,142,141,142,142,45
"4014",13,"[20]ioIoHcosHnJHGqKClisj",277,0.996403,20,278,1,277,1,1,0,1,1,147,146,131,131,45
"4015",14,"[20]ioIoHcosHnJHGqKClisj",274,0.996364,20,275,1,274,1,1,0,1,1,126,125,149,149,45
"4016",15,"[20]ioIoHcosHnJHGqKClisj",276,0.99639,20,277,1,276,1,1,0,1,1,129,128,148,148,45
"4017",16,"[20]ioIoHcosHnJHGqKClisj",279,0.996429,20,280,1,279,1,1,0,1,1,139,138,141,141,45
"4018",17,"[20]ioIoHcosHnJHGqKClisj",284,0.996491,20,285,1,284,1,1,0,1,1,154,153,131,131,45
"4019",18,"[20]ioIoHcosHnJHGqKClisj",280,0.996441,20,281,1,280,1,1,0,1,1,155,154,126,126,45
"4020",19,"[20]ioIoHcosHnJHGqKClisj",287,0.996528,20,288,1,287,1,1,0,1,1,157,156,131,131,45
"4021",20,"[20]ioIoHcosHnJHGqKClisj",284,0.996491,20,285,1,284,1,1,0,1,1,136,135,149,149,45
"4022",21,"[20]ioIoHcosHnJHGqKClisj",286,0.996516,20,287,1,286,1,1,0,1,1,144,143,143,143,45
"4023",22,"[20]ioIoHcosHnJHGqKClisj",282,0.996466,20,283,1,282,1,1,0,1,1,148,147,135,135,45
"4024",23,"[20]ioIoHcosHnJHGqKClisj",281,0.996454,20,282,1,281,1,1,0,1,1,140,139,142,142,45
"4025",24,"[20]ioIoHcosHnJHGqKClisj",282,0.996466,20,283,1,282,1,1,0,1,1,147,146,136,136,45
"4026",25,"[20]ioIoHcosHnJHGqKClisj",278,0.996416,20,279,1,278,1,1,0,1,1,150,149,129,129,45
"4027",26,"[20]ioIoHcosHnJHGqKClisj",281,0.996454,20,282,1,281,1,1,0,1,1,128,127,154,154,45
"4028",27,"[20]ioIoHcosHnJHGqKClisj",282,0.996466,20,283,1,282,1,1,0,1,1,147,146,136,136,45
"4029",28,"[20]ioIoHcosHnJHGqKClisj",280,0.996441,20,281,1,280,1,1,0,1,1,153,152,128,128,45
"4030",29,"[20]ioIoHcosHnJHGqKClisj",284,0.996491,20,285,1,284,1,1,0,1,1,145,144,140,140,45
"4031",30,"[20]ioIoHcosHnJHGqKClisj",283,0.996479,20,284,1,283,1,1,0,1,1,159,158,125,125,45
"4032",31,"[20]ioIoHcosHnJHGqKClisj",275,0.996377,20,276,1,275,1,1,0,1,1,135,134,141,141,45
"4033",32,"[20]ioIoHcosHnJHGqKClisj",277,0.996403,20,278,1,277,1,1,0,1,1,137,136,141,141,45
"4034",33,"[20]ioIoHcosHnJHGqKClisj",287,0.996528,20,288,1,287,1,1,0,1,1,140,139,148,148,45
"4035",34,"[20]ioIoHcosHnJHGqKClisj",283,0.996479,20,284,1,283,1,1,0,1,1,151,150,133,133,45
"4036",35,"[20]ioIoHcosHnJHGqKClisj",286,0.996516,20,287,1,286,1,1,0,1,1,144,143,143,143,45
"4037",36,"[20]ioIoHcosHnJHGqKClisj",282,0.996466,20,283,1,282,1,1,0,1,1,141,140,142,142,45
"4038",37,"[20]ioIoHcosHnJHGqKClisj",272,0.996337,20,273,1,272,1,1,0,1,1,133,132,140,140,45
"4039",38,"[20]ioIoHcosHnJHGqKClisj",282,0.996466,20,283,1,282,1,1,0,1,1,149,148,134,134,45
"4040",39,"[20]ioIoHcosHnJHGqKClisj",288,0.99654,20,289,1,288,1,1,0,1,1,149,148,140,140,45
"4041",40,"[20]ioIoHcosHnJHGqKClisj",276,0.99639,20,277,1,276,1,1,0,1,1,127,126,150,150,45
"4042",41,"[20]ioIoHcosHnJHGqKClisj",280,0.996441,20,281,1,280,1,1,0,1,1,135,134,146,146,45
"4043",42,"[20]ioIoHcosHnJHGqKClisj",286,0.996516,20,287,1,286,1,1,0,1,1,149,148,138,138,45
"4044",43,"[20]ioIoHcosHnJHGqKClisj",276,0.99639,20,277,1,276,1,1,0,1,1,136,135,141,141,45
"4045",44,"[20]ioIoHcosHnJHGqKClisj",287,0.996528,20,288,1,287,1,1,0,1,1,153,152,135,135,45
"4046",45,"[20]ioIoHcosHnJHGqKClisj",292,0.996587,20,293,1,292,1,1,0,1,1,163,162,130,130,45
"4047",46,"[20]ioIoHcosHnJHGqKClisj",274,0.996364,20,275,1,274,1,1,0,1,1,142,141,133,133,45
"4048",47,"[20]ioIoHcosHnJHGqKClisj",272,0.996337,20,273,1,272,1,1,0,1,1,117,116,156,156,45
"4049",48,"[20]ioIoHcosHnJHGqKClisj",284,0.996491,20,285,1,284,1,1,0,1,1,132,131,153,153,45
"4050",49,"[20]ioIoHcosHnJHGqKClisj",291,0.996575,20,292,1,291,1,1,0,1,1,142,141,150,150,45
"4051",50,"[20]ioIoHcosHnJHGqKClisj",283,0.996479,20,284,1,283,1,1,0,1,1,145,144,139,139,45
"4052",51,"[20]ioIoHcosHnJHGqKClisj",285,0.996503,20,286,1,285,1,1,0,1,1,133,132,153,153,45
"4053",52,"[20]ioIoHcosHnJHGqKClisj",281,0.996454,20,282,1,281,1,1,0,1,1,136,135,146,146,45
"4054",53,"[20]ioIoHcosHnJHGqKClisj",293,0.996599,20,294,1,293,1,1,0,1,1,150,149,144,144,45
"4055",54,"[20]ioIoHcosHnJHGqKClisj",290,0.996564,20,291,1,290,1,1,0,1,1,147,146,144,144,45
"4056",55,"[20]ioIoHcosHnJHGqKClisj",282,0.996466,20,283,1,282,1,1,0,1,1,135,134,148,148,45
"4057",56,"[20]ioIoHcosHnJHGqKClisj",285,0.996503,20,286,1,285,1,1,0,1,1,147,146,139,139,45
"4058",57,"[20]ioIoHcosHnJHGqKClisj",280,0.996441,20,281,1,280,1,1,0,1,1,140,139,141,141,45
"4059",58,"[20]ioIoHcosHnJHGqKClisj",289,0.996552,20,290,1,289,1,1,0,1,1,140,139,150,150,45
"4060",59,"[20]ioIoHcosHnJHGqKClisj",277,0.996403,20,278,1,277,1,1,0,1,1,148,147,130,130,45
"4061",60,"[20]ioIoHcosHnJHGqKClisj",282,0.996466,20,283,1,282,1,1,0,1,1,156,155,127,127,45
"4062",61,"[20]ioIoHcosHnJHGqKClisj",277,0.996403,20,278,1,277,1,1,0,1,1,150,149,128,128,45
"4063",62,"[20]ioIoHcosHnJHGqKClisj",280,0.996441,20,281,1,280,1,1,0,1,1,137,136,144,144,45
"4064",63,"[20]ioIoHcosHnJHGqKClisj",281,0.996454,20,282,1,281,1,1,0,1,1,146,145,136,136,45
"4065",64,"[20]ioIoHcosHnJHGqKClisj",269,0.996296,20,270,1,269,1,1,0,1,1,129,128,141,141,45
"4066",65,"[20]ioIoHcosHnJHGqKClisj",283,0.996479,20,284,1,283,1,1,0,1,1,135,134,149,149,45
"4067",66,"[20]ioIoHcosHnJHGqKClisj",275,0.996377,20,276,1,275,1,1,0,1,1,141,140,135,135,45
"4068",67,"[20]ioIoHcosHnJHGqKClisj",278,0.996416,20,279,1,278,1,1,0,1,1,150,149,129,129,45
"4069",68,"[20]ioIoHcosHnJHGqKClisj",279,0.996429,20,280,1,279,1,1,0,1,1,141,140,139,139,45
"4070",69,"[20]ioIoHcosHnJHGqKClisj",279,0.996429,20,280,1,279,1,1,0,1,1,136,135,144,144,45
"4071",70,"[20]ioIoHcosHnJHGqKClisj",273,0.99635,20,274,1,273,1,1,0,1,1,133,132,141,141,45
"4072",71,"[20]ioIoHcosHnJHGqKClisj",283,0.996479,20,284,1,283,1,1,0,1,1,133,132,151,151,45
"4073",72,"[20]ioIoHcosHnJHGqKClisj",280,0.996441,20,281,1,280,1,1,0,1,1,137,136,144,144,45
"4074",73,"[20]ioIoHcosHnJHGqKClisj",276,0.99639,20,277,1,276,1,1,0,1,1,155,154,122,122,45
"4075",74,"[20]ioIoHcosHnJHGqKClisj",276,0.99639,20,277,1,276,1,1,0,1,1,135,134,142,142,45
"4076",75,"[20]ioIoHcosHnJHGqKClisj",283,0.996479,20,284,1,283,1,1,0,1,1,148,147,136,136,45
"4077",76,"[20]ioIoHcosHnJHGqKClisj",275,0.996377,20,276,1,275,1,1,0,1,1,131,130,145,145,45
"4078",77,"[20]ioIoHcosHnJHGqKClisj",286,0.996516,20,287,1,286,1,1,0,1,1,139,138,148,148,45
"4079",78,"[20]ioIoHcosHnJHGqKClisj",282,0.996466,20,283,1,282,1,1,0,1,1,139,138,144,144,45
"4080",79,"[20]ioIoHcosHnJHGqKClisj",284,0.996491,20,285,1,284,1,1,0,1,1,144,143,141,141,45
"4081",80,"[20]ioIoHcosHnJHGqKClisj",278,0.996416,20,279,1,278,1,1,0,1,1,127,126,152,152,45
"4082",81,"[20]ioIoHcosHnJHGqKClisj",282,0.996466,20,283,1,282,1,1,0,1,1,150,149,133,133,45
"4083",82,"[20]ioIoHcosHnJHGqKClisj",277,0.996403,20,278,1,277,1,1,0,1,1,139,138,139,139,45
"4084",83,"[20]ioIoHcosHnJHGqKClisj",285,0.996503,20,286,1,285,1,1,0,1,1,153,152,133,133,45
"4085",84,"[20]ioIoHcosHnJHGqKClisj",284,0.996491,20,285,1,284,1,1,0,1,1,149,148,136,136,45
"4086",85,"[20]ioIoHcosHnJHGqKClisj",283,0.996479,20,284,1,283,1,1,0,1,1,136,135,148,148,45
"4087",86,"[20]ioIoHcosHnJHGqKClisj",282,0.996466,20,283,1,282,1,1,0,1,1,138,137,145,145,45
"4088",87,"[20]ioIoHcosHnJHGqKClisj",276,0.99639,20,277,1,276,1,1,0,1,1,126,125,151,151,45
"4089",88,"[20]ioIoHcosHnJHGqKClisj",280,0.996441,20,281,1,280,1,1,0,1,1,141,140,140,140,45
"4090",89,"[20]ioIoHcosHnJHGqKClisj",277,0.996403,20,278,1,277,1,1,0,1,1,124,123,154,154,45
"4091",90,"[20]ioIoHcosHnJHGqKClisj",288,0.99654,20,289,1,288,1,1,0,1,1,153,152,136,136,45
"4092",91,"[20]ioIoHcosHnJHGqKClisj",276,0.99639,20,277,1,276,1,1,0,1,1,133,132,144,144,45
"4093",92,"[20]ioIoHcosHnJHGqKClisj",280,0.996441,20,281,1,280,1,1,0,1,1,137,136,144,144,45
"4094",93,"[20]ioIoHcosHnJHGqKClisj",276,0.99639,20,277,1,276,1,1,0,1,1,124,123,153,153,45
"4095",94,"[20]ioIoHcosHnJHGqKClisj",286,0.996516,20,287,1,286,1,1,0,1,1,138,137,149,149,45
"4096",95,"[20]ioIoHcosHnJHGqKClisj",282,0.996466,20,283,1,282,1,1,0,1,1,139,138,144,144,45
"4097",96,"[20]ioIoHcosHnJHGqKClisj",286,0.996516,20,287,1,286,1,1,0,1,1,149,148,138,138,45
"4098",97,"[20]ioIoHcosHnJHGqKClisj",280,0.996441,20,281,1,280,1,1,0,1,1,148,147,133,133,45
"4099",98,"[20]ioIoHcosHnJHGqKClisj",283,0.996479,20,284,1,283,1,1,0,1,1,137,136,147,147,45
"4100",99,"[20]ioIoHcosHnJHGqKClisj",283,0.996479,20,284,1,283,1,1,0,1,1,135,134,149,149,45
"4101",0,"[26]aHoIpKoHcoxHnJqGKClJrvsvdm",299,0.996667,26,300,1,299,1,1,0,1,1,155,154,145,145,46
"4102",1,"[26]aHoIpKoHcoxHnJqGKClJrvsvdm",293,0.996599,26,294,1,293,1,1,0,1,1,141,140,153,153,46
"4103",2,"[26]aHoIpKoHcoxHnJqGKClJrvsvdm",295,0.996622,26,296,1,295,1,1,0,1,1,153,152,143,143,46
"4104",3,"[26]aHoIpKoHcoxHnJqGKClJrvsvdm",292,0.996587,26,293,1,292,1,1,0,1,1,133,132,160,160,46
"4105",4,"[26]aHoIpKoHcoxHnJqGKClJrvsvdm",297,0.996644,26,298,1,297,1,1,0,1,1,152,151,146,146,46
"4106",5,"[26]aHoIpKoHcoxHnJqGKClJrvsvdm",293,0.996599,26,294,1,293,1,1,0,1,1,154,153,140,140,46
"4107",6,"[26]aHoIpKoHcoxHnJqGKClJrvsvdm",293,0.996599,26,294,1,293,1,1,0,1,1,138,137,156,156,46
"4108",7,"[26]aHoIpKoHcoxHnJqGKClJrvsvdm",293,0.996599,26,294,1,293,1,1,0,1,1,144,143,150,150,46
"4109",8,"[26]aHoIpKoHcoxHnJqGKClJrvsvdm",291,0.996575,26,292,1,291,1,1,0,1,1,138,137,154,154,46
"4110",9,"[26]aHoIpKoHcoxHnJqGKClJrvsvdm",297,0.996644,26,298,1,297,1,1,0,1,1,154,153,144,144,46
"4111",10,"[26]aHoIpKoHcoxHnJqGKClJrvsvdm",295,0.996622,26,296,1,295,1,1,0,1,1,146,145,150,150,46
"4112",11,"[26]aHoIpKoHcoxHnJqGKClJrvsvdm",294,0.99661,26,295,1,294,1,1,0,1,1,143,142,152,152,46
"4113",12,"[26]aHoIpKoHcoxHnJqGKClJrvsvdm",294,0.99661,26,295,1,294,1,1,0,1,1,145,144,150,150,46
"4114",13,"[26]aHoIpKoHcoxHnJqGKClJrvsvdm",288,0.99654,26,289,1,288,1,1,0,1,1,140,139,149,149,46
"4115",14,"[26]aHoIpKoHcoxHnJqGKClJrvsvdm",296,0.996633,26,297,1,296,1,1,0,1,1,149,148,148,148,46
"4116",15,"[26]aHoIpKoHcoxHnJqGKClJrvsvdm",298,0.996656,26,299,1,298,1,1,0,1,1,154,153,145,145,46
"4117",16,"[26]aHoIpKoHcoxHnJqGKClJrvsvdm",294,0.99661,26,295,1,294,1,1,0,1,1,144,143,151,151,46
"4118",17,"[26]aHoIpKoHcoxHnJqGKClJrvsvdm",301,0.996689,26,302,1,301,1,1,0,1,1,153,152,149,149,46
"4119",18,"[26]aHoIpKoHcoxHnJqGKClJrvsvdm",292,0.996587,26,293,1,292,1,1,0,1,1,146,145,147,147,46
"4120",19,"[26]aHoIpKoHcoxHnJqGKClJrvsvdm",285,0.996503,26,286,1,285,1,1,0,1,1,144,143,142,142,46
"4121",20,"[26]aHoIpKoHcoxHnJqGKClJrvsvdm",298,0.996656,26,299,1,298,1,1,0,1,1,155,154,144,144,46
"4122",21,"[26]aHoIpKoHcoxHnJqGKClJrvsvdm",293,0.996599,26,294,1,293,1,1,0,1,1,144,143,150,150,46
"4123",22,"[26]aHoIpKoHcoxHnJqGKClJrvsvdm",290,0.996564,26,291,1,290,1,1,0,1,1,135,134,156,156,46
"4124",23,"[26]aHoIpKoHcoxHnJqGKClJrvsvdm",293,0.996599,26,294,1,293,1,1,0,1,1,141,140,153,153,46
"4125",24,"[26]aHoIpKoHcoxHnJqGKClJrvsvdm",293,0.996599,26,294,1,293,1,1,0,1,1,147,146,147,147,46
"4126",25,"[26]aHoIpKoHcoxHnJqGKClJrvsvdm",293,0.996599,26,294,1,293,1,1,0,1,1,152,151,142,142,46
"4127",26,"[26]aHoIpKoHcoxHnJqGKClJrvsvdm",296,0.996633,26,297,1,296,1,1,0,1,1,155,154,142,142,46
"4128",27,"[26]aHoIpKoHcoxHnJqGKClJrvsvdm",298,0.996656,26,299,1,298,1,1,0,1,1,159,158,140,140,46
"4129",28,"[26]aHoIpKoHcoxHnJqGKClJrvsvdm",297,0.996644,26,298,1,297,1,1,0,1,1,151,150,147,147,46
"4130",29,"[26]aHoIpKoHcoxHnJqGKClJrvsvdm",296,0.996633,26,297,1,296,1,1,0,1,1,154,153,143,143,46
"4131",30,"[26]aHoIpKoHcoxHnJqGKClJrvsvdm",296,0.996633,26,297,1,296,1,1,0,1,1,150,149,147,147,46
"4132",31,"[26]aHoIpKoHcoxHnJqGKClJrvsvdm",288,0.99654,26,289,1,288,1,1,0,1,1,141,140,148,148,46
"4133",32,"[26]aHoIpKoHcoxHnJqGKClJrvsvdm",292,0.996587,26,293,1,292,1,1,0,1,1,137,136,156,156,46
"4134",33,"[26]aHoIpKoHcoxHnJqGKClJrvsvdm",291,0.996575,26,292,1,291,1,1,0,1,1,144,143,148,148,46
"4135",34,"[26]aHoIpKoHcoxHnJqGKClJrvsvdm",292,0.996587,26,293,1,292,1,1,0,1,1,142,141,151,151,46
"4136",35,"[26]aHoIpKoHcoxHnJqGKClJrvsvdm",294,0.99661,26,295,1,294,1,1,0,1,1,143,142,152,152,46
"4137",36,"[26]aHoIpKoHcoxHnJqGKClJrvsvdm",295,0.996622,26,296,1,295,1,1,0,1,1,151,150,145,145,46
"4138",37,"[26]aHoIpKoHcoxHnJqGKClJrvsvdm",293,0.996599,26,294,1,293,1,1,0,1,1,143,142,151,151,46
"4139",38,"[26]aHoIpKoHcoxHnJqGKClJrvsvdm",298,0.996656,26,299,1,298,1,1,0,1,1,165,164,134,134,46
"4140",39,"[26]aHoIpKoHcoxHnJqGKClJrvsvdm",300,0.996678,26,301,1,300,1,1,0,1,1,161,160,140,140,46
"4141",40,"[26]aHoIpKoHcoxHnJqGKClJrvsvdm",290,0.996564,26,291,1,290,1,1,0,1,1,144,143,147,147,46
"4142",41,"[26]aHoIpKoHcoxHnJqGKClJrvsvdm",297,0.996644,26,298,1,297,1,1,0,1,1,148,147,150,150,46
"4143",42,"[26]aHoIpKoHcoxHnJqGKClJrvsvdm",294,0.99661,26,295,1,294,1,1,0,1,1,146,145,149,149,46
"4144",43,"[26]aHoIpKoHcoxHnJqGKClJrvsvdm",297,0.996644,26,298,1,297,1,1,0,1,1,155,154,143,143,46
"4145",44,"[26]aHoIpKoHcoxHnJqGKClJrvsvdm",295,0.996622,26,296,1,295,1,1,0,1,1,144,143,152,152,46
"4146",45,"[26]aHoIpKoHcoxHnJqGKClJrvsvdm",295,0.996622,26,296,1,295,1,1,0,1,1,146,145,150,150,46
"4147",46,"[26]aHoIpKoHcoxHnJqGKClJrvsvdm",295,0.996622,26,296,1,295,1,1,0,1,1,149,148,147,147,46
"4148",47,"[26]aHoIpKoHcoxHnJqGKClJrvsvdm",299,0.996667,26,300,1,299,1,1,0,1,1,155,154,145,145,46
"4149",48,"[26]aHoIpKoHcoxHnJqGKClJrvsvdm",296,0.996633,26,297,1,296,1,1,0,1,1,155,154,142,142,46
"4150",49,"[26]aHoIpKoHcoxHnJqGKClJrvsvdm",302,0.9967,26,303,1,302,1,1,0,1,1,164,163,139,139,46
"4151",50,"[26]aHoIpKoHcoxHnJqGKClJrvsvdm",296,0.996633,26,297,1,296,1,1,0,1,1,147,146,150,150,46
"4152",51,"[26]aHoIpKoHcoxHnJqGKClJrvsvdm",295,0.996622,26,296,1,295,1,1,0,1,1,148,147,148,148,46
"4153",52,"[26]aHoIpKoHcoxHnJqGKClJrvsvdm",296,0.996633,26,297,1,296,1,1,0,1,1,161,160,136,136,46
"4154",53,"[26]aHoIpKoHcoxHnJqGKClJrvsvdm",295,0.996622,26,296,1,295,1,1,0,1,1,147,146,149,149,46
"4155",54,"[26]aHoIpKoHcoxHnJqGKClJrvsvdm",292,0.996587,26,293,1,292,1,1,0,1,1,141,140,152,152,46
"4156",55,"[26]aHoIpKoHcoxHnJqGKClJrvsvdm",302,0.9967,26,303,1,302,1,1,0,1,1,159,158,144,144,46
"4157",56,"[26]aHoIpKoHcoxHnJqGKClJrvsvdm",288,0.99654,26,289,1,288,1,1,0,1,1,128,127,161,161,46
"4158",57,"[26]aHoIpKoHcoxHnJqGKClJrvsvdm",302,0.9967,26,303,1,302,1,1,0,1,1,168,167,135,135,46
"4159",58,"[26]aHoIpKoHcoxHnJqGKClJrvsvdm",292,0.996587,26,293,1,292,1,1,0,1,1,137,136,156,156,46
"4160",59,"[26]aHoIpKoHcoxHnJqGKClJrvsvdm",303,0.996711,26,304,1,303,1,1,0,1,1,159,158,145,145,46
"4161",60,"[26]aHoIpKoHcoxHnJqGKClJrvsvdm",293,0.996599,26,294,1,293,1,1,0,1,1,148,147,146,146,46
"4162",61,"[26]aHoIpKoHcoxHnJqGKClJrvsvdm",291,0.996575,26,292,1,291,1,1,0,1,1,138,137,154,154,46
"4163",62,"[26]aHoIpKoHcoxHnJqGKClJrvsvdm",294,0.99661,26,295,1,294,1,1,0,1,1,142,141,153,153,46
"4164",63,"[26]aHoIpKoHcoxHnJqGKClJrvsvdm",293,0.996599,26,294,1,293,1,1,0,1,1,142,141,152,152,46
"4165",64,"[26]aHoIpKoHcoxHnJqGKClJrvsvdm",295,0.996622,26,296,1,295,1,1,0,1,1,146,145,150,150,46
"4166",65,"[26]aHoIpKoHcoxHnJqGKClJrvsvdm",297,0.996644,26,298,1,297,1,1,0,1,1,148,147,150,150,46
"4167",66,"[26]aHoIpKoHcoxHnJqGKClJrvsvdm",300,0.996678,26,301,1,300,1,1,0,1,1,145,144,156,156,46
"4168",67,"[26]aHoIpKoHcoxHnJqGKClJrvsvdm",303,0.996711,26,304,1,303,1,1,0,1,1,169,168,135,135,46
"4169",68,"[26]aHoIpKoHcoxHnJqGKClJrvsvdm",297,0.996644,26,298,1,297,1,1,0,1,1,156,155,142,142,46
"4170",69,"[26]aHoIpKoHcoxHnJqGKClJrvsvdm",295,0.996622,26,296,1,295,1,1,0,1,1,157,156,139,139,46
"4171",70,"[26]aHoIpKoHcoxHnJqGKClJrvsvdm",294,0.99661,26,295,1,294,1,1,0,1,1,138,137,157,157,46
"4172",71,"[26]aHoIpKoHcoxHnJqGKClJrvsvdm",296,0.996633,26,297,1,296,1,1,0,1,1,150,149,147,147,46
"4173",72,"[26]aHoIpKoHcoxHnJqGKClJrvsvdm",298,0.996656,26,299,1,298,1,1,0,1,1,150,149,149,149,46
"4174",73,"[26]aHoIpKoHcoxHnJqGKClJrvsvdm",296,0.996633,26,297,1,296,1,1,0,1,1,147,146,150,150,46
"4175",74,"[26]aHoIpKoHcoxHnJqGKClJrvsvdm",292,0.996587,26,293,1,292,1,1,0,1,1,136,135,157,157,46
"4176",75,"[26]aHoIpKoHcoxHnJqGKClJrvsvdm",295,0.996622,26,296,1,295,1,1,0,1,1,153,152,143,143,46
"4177",76,"[26]aHoIpKoHcoxHnJqGKClJrvsvdm",296,0.996633,26,297,1,296,1,1,0,1,1,149,148,148,148,46
"4178",77,"[26]aHoIpKoHcoxHnJqGKClJrvsvdm",298,0.996656,26,299,1,298,1,1,0,1,1,154,153,145,145,46
"4179",78,"[26]aHoIpKoHcoxHnJqGKClJrvsvdm",297,0.996644,26,298,1,297,1,1,0,1,1,149,148,149,149,46
"4180",79,"[26]aHoIpKoHcoxHnJqGKClJrvsvdm",293,0.996599,26,294,1,293,1,1,0,1,1,143,142,151,151,46
"4181",80,"[26]aHoIpKoHcoxHnJqGKClJrvsvdm",290,0.996564,26,291,1,290,1,1,0,1,1,131,130,160,160,46
"4182",81,"[26]aHoIpKoHcoxHnJqGKClJrvsvdm",293,0.996599,26,294,1,293,1,1,0,1,1,144,143,150,150,46
"4183",82,"[26]aHoIpKoHcoxHnJqGKClJrvsvdm",297,0.996644,26,298,1,297,1,1,0,1,1,155,154,143,143,46
"4184",83,"[26]aHoIpKoHcoxHnJqGKClJrvsvdm",297,0.996644,26,298,1,297,1,1,0,1,1,155,154,143,143,46
"4185",84,"[26]aHoIpKoHcoxHnJqGKClJrvsvdm",297,0.996644,26,298,1,297,1,1,0,1,1,155,154,143,143,46
"4186",85,"[26]aHoIpKoHcoxHnJqGKClJrvsvdm",297,0.996644,26,298,1,297,1,1,0,1,1,152,151,146,146,46
"4187",86,"[26]aHoIpKoHcoxHnJqGKClJrvsvdm",290,0.996564,26,291,1,290,1,1,0,1,1,131,130,160,160,46
"4188",87,"[26]aHoIpKoHcoxHnJqGKClJrvsvdm",299,0.996667,26,300,1,299,1,1,0,1,1,163,162,137,137,46
"4189",88,"[26]aHoIpKoHcoxHnJqGKClJrvsvdm",290,0.996564,26,291,1,290,1,1,0,1,1,135,134,156,156,46
"4190",89,"[26]aHoIpKoHcoxHnJqGKClJrvsvdm",298,0.996656,26,299,1,298,1,1,0,1,1,155,154,144,144,46
"4191",90,"[26]aHoIpKoHcoxHnJqGKClJrvsvdm",297,0.996644,26,298,1,297,1,1,0,1,1,150,149,148,148,46
"4192",91,"[26]aHoIpKoHcoxHnJqGKClJrvsvdm",286,0.996516,26,287,1,286,1,1,0,1,1,128,127,159,159,46
"4193",92,"[26]aHoIpKoHcoxHnJqGKClJrvsvdm",292,0.996587,26,293,1,292,1,1,0,1,1,141,140,152,152,46
"4194",93,"[26]aHoIpKoHcoxHnJqGKClJrvsvdm",293,0.996599,26,294,1,293,1,1,0,1,1,147,146,147,147,46
"4195",94,"[26]aHoIpKoHcoxHnJqGKClJrvsvdm",297,0.996644,26,298,1,297,1,1,0,1,1,151,150,147,147,46
"4196",95,"[26]aHoIpKoHcoxHnJqGKClJrvsvdm",296,0.996633,26,297,1,296,1,1,0,1,1,148,147,149,149,46
"4197",96,"[26]aHoIpKoHcoxHnJqGKClJrvsvdm",298,0.996656,26,299,1,298,1,1,0,1,1,156,155,143,143,46
"4198",97,"[26]aHoIpKoHcoxHnJqGKClJrvsvdm",298,0.996656,26,299,1,298,1,1,0,1,1,161,160,138,138,46
"4199",98,"[26]aHoIpKoHcoxHnJqGKClJrvsvdm",293,0.996599,26,294,1,293,1,1,0,1,1,137,136,157,157,46
"4200",99,"[26]aHoIpKoHcoxHnJqGKClJrvsvdm",296,0.996633,26,297,1,296,1,1,0,1,1,152,151,145,145,46
"4201",0,"[21]joIloHcoxHnJHGqKCmrmm",278,0.996416,21,279,1,278,1,1,0,1,1,129,128,150,150,47
"4202",1,"[21]joIloHcoxHnJHGqKCmrmm",278,0.996416,21,279,1,278,1,1,0,1,1,145,144,134,134,47
"4203",2,"[21]joIloHcoxHnJHGqKCmrmm",282,0.996466,21,283,1,282,1,1,0,1,1,141,140,142,142,47
"4204",3,"[21]joIloHcoxHnJHGqKCmrmm",275,0.996377,21,276,1,275,1,1,0,1,1,134,133,142,142,47
"4205",4,"[21]joIloHcoxHnJHGqKCmrmm",282,0.996466,21,283,1,282,1,1,0,1,1,150,149,133,133,47
"4206",5,"[21]joIloHcoxHnJHGqKCmrmm",281,0.996454,21,282,1,281,1,1,0,1,1,140,139,142,142,47
"4207",6,"[21]joIloHcoxHnJHGqKCmrmm",270,0.99631,21,271,1,270,1,1,0,1,1,134,133,137,137,47
"4208",7,"[21]joIloHcoxHnJHGqKCmrmm",276,0.99639,21,277,1,276,1,1,0,1,1,123,122,154,154,47
"4209",8,"[21]joIloHcoxHnJHGqKCmrmm",281,0.996454,21,282,1,281,1,1,0,1,1,138,137,144,144,47
"4210",9,"[21]joIloHcoxHnJHGqKCmrmm",281,0.996454,21,282,1,281,1,1,0,1,1,143,142,139,139,47
"4211",10,"[21]joIloHcoxHnJHGqKCmrmm",284,0.996491,21,285,1,284,1,1,0,1,1,146,145,139,139,47
"4212",11,"[21]joIloHcoxHnJHGqKCmrmm",278,0.996416,21,279,1,278,1,1,0,1,1,144,143,135,135,47
"4213",12,"[21]joIloHcoxHnJHGqKCmrmm",279,0.996429,21,280,1,279,1,1,0,1,1,148,147,132,132,47
"4214",13,"[21]joIloHcoxHnJHGqKCmrmm",283,0.996479,21,284,1,283,1,1,0,1,1,149,148,135,135,47
"4215",14,"[21]joIloHcoxHnJHGqKCmrmm",281,0.996454,21,282,1,281,1,1,0,1,1,143,142,139,139,47
"4216",15,"[21]joIloHcoxHnJHGqKCmrmm",275,0.996377,21,276,1,275,1,1,0,1,1,143,142,133,133,47
"4217",16,"[21]joIloHcoxHnJHGqKCmrmm",280,0.996441,21,281,1,280,1,1,0,1,1,130,129,151,151,47
"4218",17,"[21]joIloHcoxHnJHGqKCmrmm",286,0.996516,21,287,1,286,1,1,0,1,1,147,146,140,140,47
"4219",18,"[21]joIloHcoxHnJHGqKCmrmm",282,0.996466,21,283,1,282,1,1,0,1,1,148,147,135,135,47
"4220",19,"[21]joIloHcoxHnJHGqKCmrmm",282,0.996466,21,283,1,282,1,1,0,1,1,145,144,138,138,47
"4221",20,"[21]joIloHcoxHnJHGqKCmrmm",279,0.996429,21,280,1,279,1,1,0,1,1,142,141,138,138,47
"4222",21,"[21]joIloHcoxHnJHGqKCmrmm",281,0.996454,21,282,1,281,1,1,0,1,1,136,135,146,146,47
"4223",22,"[21]joIloHcoxHnJHGqKCmrmm",281,0.996454,21,282,1,281,1,1,0,1,1,137,136,145,145,47
"4224",23,"[21]joIloHcoxHnJHGqKCmrmm",281,0.996454,21,282,1,281,1,1,0,1,1,151,150,131,131,47
"4225",24,"[21]joIloHcoxHnJHGqKCmrmm",285,0.996503,21,286,1,285,1,1,0,1,1,138,137,148,148,47
"4226",25,"[21]joIloHcoxHnJHGqKCmrmm",275,0.996377,21,276,1,275,1,1,0,1,1,131,130,145,145,47
"4227",26,"[21]joIloHcoxHnJHGqKCmrmm",296,0.996633,21,297,1,296,1,1,0,1,1,151,150,146,146,47
"4228",27,"[21]joIloHcoxHnJHGqKCmrmm",284,0.996491,21,285,1,284,1,1,0,1,1,134,133,151,151,47
"4229",28,"[21]joIloHcoxHnJHGqKCmrmm",279,0.996429,21,280,1,279,1,1,0,1,1,132,131,148,148,47
"4230",29,"[21]joIloHcoxHnJHGqKCmrmm",286,0.996516,21,287,1,286,1,1,0,1,1,140,139,147,147,47
"4231",30,"[21]joIloHcoxHnJHGqKCmrmm",286,0.996516,21,287,1,286,1,1,0,1,1,156,155,131,131,47
"4232",31,"[21]joIloHcoxHnJHGqKCmrmm",281,0.996454,21,282,1,281,1,1,0,1,1,145,144,137,137,47
"4233",32,"[21]joIloHcoxHnJHGqKCmrmm",275,0.996377,21,276,1,275,1,1,0,1,1,134,133,142,142,47
"4234",33,"[21]joIloHcoxHnJHGqKCmrmm",277,0.996403,21,278,1,277,1,1,0,1,1,128,127,150,150,47
"4235",34,"[21]joIloHcoxHnJHGqKCmrmm",283,0.996479,21,284,1,283,1,1,0,1,1,130,129,154,154,47
"4236",35,"[21]joIloHcoxHnJHGqKCmrmm",279,0.996429,21,280,1,279,1,1,0,1,1,136,135,144,144,47
"4237",36,"[21]joIloHcoxHnJHGqKCmrmm",274,0.996364,21,275,1,274,1,1,0,1,1,139,138,136,136,47
"4238",37,"[21]joIloHcoxHnJHGqKCmrmm",289,0.996552,21,290,1,289,1,1,0,1,1,150,149,140,140,47
"4239",38,"[21]joIloHcoxHnJHGqKCmrmm",283,0.996479,21,284,1,283,1,1,0,1,1,148,147,136,136,47
"4240",39,"[21]joIloHcoxHnJHGqKCmrmm",282,0.996466,21,283,1,282,1,1,0,1,1,153,152,130,130,47
"4241",40,"[21]joIloHcoxHnJHGqKCmrmm",279,0.996429,21,280,1,279,1,1,0,1,1,144,143,136,136,47
"4242",41,"[21]joIloHcoxHnJHGqKCmrmm",282,0.996466,21,283,1,282,1,1,0,1,1,137,136,146,146,47
"4243",42,"[21]joIloHcoxHnJHGqKCmrmm",290,0.996564,21,291,1,290,1,1,0,1,1,136,135,155,155,47
"4244",43,"[21]joIloHcoxHnJHGqKCmrmm",278,0.996416,21,279,1,278,1,1,0,1,1,145,144,134,134,47
"4245",44,"[21]joIloHcoxHnJHGqKCmrmm",286,0.996516,21,287,1,286,1,1,0,1,1,150,149,137,137,47
"4246",45,"[21]joIloHcoxHnJHGqKCmrmm",282,0.996466,21,283,1,282,1,1,0,1,1,132,131,151,151,47
"4247",46,"[21]joIloHcoxHnJHGqKCmrmm",276,0.99639,21,277,1,276,1,1,0,1,1,151,150,126,126,47
"4248",47,"[21]joIloHcoxHnJHGqKCmrmm",274,0.996364,21,275,1,274,1,1,0,1,1,135,134,140,140,47
"4249",48,"[21]joIloHcoxHnJHGqKCmrmm",276,0.99639,21,277,1,276,1,1,0,1,1,138,137,139,139,47
"4250",49,"[21]joIloHcoxHnJHGqKCmrmm",285,0.996503,21,286,1,285,1,1,0,1,1,157,156,129,129,47
"4251",50,"[21]joIloHcoxHnJHGqKCmrmm",279,0.996429,21,280,1,279,1,1,0,1,1,148,147,132,132,47
"4252",51,"[21]joIloHcoxHnJHGqKCmrmm",281,0.996454,21,282,1,281,1,1,0,1,1,137,136,145,145,47
"4253",52,"[21]joIloHcoxHnJHGqKCmrmm",284,0.996491,21,285,1,284,1,1,0,1,1,152,151,133,133,47
"4254",53,"[21]joIloHcoxHnJHGqKCmrmm",267,0.996269,21,268,1,267,1,1,0,1,1,127,126,141,141,47
"4255",54,"[21]joIloHcoxHnJHGqKCmrmm",280,0.996441,21,281,1,280,1,1,0,1,1,139,138,142,142,47
"4256",55,"[21]joIloHcoxHnJHGqKCmrmm",282,0.996466,21,283,1,282,1,1,0,1,1,138,137,145,145,47
"4257",56,"[21]joIloHcoxHnJHGqKCmrmm",284,0.996491,21,285,1,284,1,1,0,1,1,155,154,130,130,47
"4258",57,"[21]joIloHcoxHnJHGqKCmrmm",279,0.996429,21,280,1,279,1,1,0,1,1,139,138,141,141,47
"4259",58,"[21]joIloHcoxHnJHGqKCmrmm",277,0.996403,21,278,1,277,1,1,0,1,1,124,123,154,154,47
"4260",59,"[21]joIloHcoxHnJHGqKCmrmm",286,0.996516,21,287,1,286,1,1,0,1,1,144,143,143,143,47
"4261",60,"[21]joIloHcoxHnJHGqKCmrmm",276,0.99639,21,277,1,276,1,1,0,1,1,143,142,134,134,47
"4262",61,"[21]joIloHcoxHnJHGqKCmrmm",284,0.996491,21,285,1,284,1,1,0,1,1,147,146,138,138,47
"4263",62,"[21]joIloHcoxHnJHGqKCmrmm",277,0.996403,21,278,1,277,1,1,0,1,1,136,135,142,142,47
"4264",63,"[21]joIloHcoxHnJHGqKCmrmm",276,0.99639,21,277,1,276,1,1,0,1,1,130,129,147,147,47
"4265",64,"[21]joIloHcoxHnJHGqKCmrmm",278,0.996416,21,279,1,278,1,1,0,1,1,135,134,144,144,47
"4266",65,"[21]joIloHcoxHnJHGqKCmrmm",280,0.996441,21,281,1,280,1,1,0,1,1,136,135,145,145,47
"4267",66,"[21]joIloHcoxHnJHGqKCmrmm",277,0.996403,21,278,1,277,1,1,0,1,1,143,142,135,135,47
"4268",67,"[21]joIloHcoxHnJHGqKCmrmm",281,0.996454,21,282,1,281,1,1,0,1,1,127,126,155,155,47
"4269",68,"[21]joIloHcoxHnJHGqKCmrmm",285,0.996503,21,286,1,285,1,1,0,1,1,142,141,144,144,47
"4270",69,"[21]joIloHcoxHnJHGqKCmrmm",277,0.996403,21,278,1,277,1,1,0,1,1,141,140,137,137,47
"4271",70,"[21]joIloHcoxHnJHGqKCmrmm",289,0.996552,21,290,1,289,1,1,0,1,1,156,155,134,134,47
"4272",71,"[21]joIloHcoxHnJHGqKCmrmm",270,0.99631,21,271,1,270,1,1,0,1,1,118,117,153,153,47
"4273",72,"[21]joIloHcoxHnJHGqKCmrmm",277,0.996403,21,278,1,277,1,1,0,1,1,142,141,136,136,47
"4274",73,"[21]joIloHcoxHnJHGqKCmrmm",284,0.996491,21,285,1,284,1,1,0,1,1,142,141,143,143,47
"4275",74,"[21]joIloHcoxHnJHGqKCmrmm",279,0.996429,21,280,1,279,1,1,0,1,1,140,139,140,140,47
"4276",75,"[21]joIloHcoxHnJHGqKCmrmm",289,0.996552,21,290,1,289,1,1,0,1,1,152,151,138,138,47
"4277",76,"[21]joIloHcoxHnJHGqKCmrmm",290,0.996564,21,291,1,290,1,1,0,1,1,138,137,153,153,47
"4278",77,"[21]joIloHcoxHnJHGqKCmrmm",280,0.996441,21,281,1,280,1,1,0,1,1,139,138,142,142,47
"4279",78,"[21]joIloHcoxHnJHGqKCmrmm",269,0.996296,21,270,1,269,1,1,0,1,1,140,139,130,130,47
"4280",79,"[21]joIloHcoxHnJHGqKCmrmm",279,0.996429,21,280,1,279,1,1,0,1,1,132,131,148,148,47
"4281",80,"[21]joIloHcoxHnJHGqKCmrmm",284,0.996491,21,285,1,284,1,1,0,1,1,160,159,125,125,47
"4282",81,"[21]joIloHcoxHnJHGqKCmrmm",277,0.996403,21,278,1,277,1,1,0,1,1,143,142,135,135,47
"4283",82,"[21]joIloHcoxHnJHGqKCmrmm",282,0.996466,21,283,1,282,1,1,0,1,1,142,141,141,141,47
"4284",83,"[21]joIloHcoxHnJHGqKCmrmm",280,0.996441,21,281,1,280,1,1,0,1,1,143,142,138,138,47
"4285",84,"[21]joIloHcoxHnJHGqKCmrmm",283,0.996479,21,284,1,283,1,1,0,1,1,149,148,135,135,47
"4286",85,"[21]joIloHcoxHnJHGqKCmrmm",278,0.996416,21,279,1,278,1,1,0,1,1,140,139,139,139,47
"4287",86,"[21]joIloHcoxHnJHGqKCmrmm",279,0.996429,21,280,1,279,1,1,0,1,1,136,135,144,144,47
"4288",87,"[21]joIloHcoxHnJHGqKCmrmm",273,0.99635,21,274,1,273,1,1,0,1,1,135,134,139,139,47
"4289",88,"[21]joIloHcoxHnJHGqKCmrmm",273,0.99635,21,274,1,273,1,1,0,1,1,119,118,155,155,47
"4290",89,"[21]joIloHcoxHnJHGqKCmrmm",279,0.996429,21,280,1,279,1,1,0,1,1,130,129,150,150,47
"4291",90,"[21]joIloHcoxHnJHGqKCmrmm",279,0.996429,21,280,1,279,1,1,0,1,1,140,139,140,140,47
"4292",91,"[21]joIloHcoxHnJHGqKCmrmm",282,0.996466,21,283,1,282,1,1,0,1,1,152,151,131,131,47
"4293",92,"[21]joIloHcoxHnJHGqKCmrmm",288,0.99654,21,289,1,288,1,1,0,1,1,148,147,141,141,47
"4294",93,"[21]joIloHcoxHnJHGqKCmrmm",284,0.996491,21,285,1,284,1,1,0,1,1,147,146,138,138,47
"4295",94,"[21]joIloHcoxHnJHGqKCmrmm",280,0.996441,21,281,1,280,1,1,0,1,1,138,137,143,143,47
"4296",95,"[21]joIloHcoxHnJHGqKCmrmm",282,0.996466,21,283,1,282,1,1,0,1,1,122,121,161,161,47
"4297",96,"[21]joIloHcoxHnJHGqKCmrmm",291,0.996575,21,292,1,291,1,1,0,1,1,139,138,153,153,47
"4298",97,"[21]joIloHcoxHnJHGqKCmrmm",282,0.996466,21,283,1,282,1,1,0,1,1,147,146,136,136,47
"4299",98,"[21]joIloHcoxHnJHGqKCmrmm",271,0.996324,21,272,1,271,1,1,0,1,1,131,130,141,141,47
"4300",99,"[21]joIloHcoxHnJHGqKCmrmm",280,0.996441,21,281,1,280,1,1,0,1,1,124,123,157,157,47
"4301",0,"[32]HwoIbzAoHcovHnJHGqKCsKvCmgHpaJfH",277,0.996403,32,278,1,277,1,1,0,1,1,137,136,141,141,49
"4302",1,"[32]HwoIbzAoHcovHnJHGqKCsKvCmgHpaJfH",278,0.996416,32,279,1,278,1,1,0,1,1,138,137,141,141,49
"4303",2,"[32]HwoIbzAoHcovHnJHGqKCsKvCmgHpaJfH",274,0.996364,32,275,1,274,1,1,0,1,1,142,141,133,133,49
"4304",3,"[32]HwoIbzAoHcovHnJHGqKCsKvCmgHpaJfH",285,0.996503,32,286,1,285,1,1,0,1,1,144,143,142,142,49
"4305",4,"[32]HwoIbzAoHcovHnJHGqKCsKvCmgHpaJfH",280,0.996441,32,281,1,280,1,1,0,1,1,143,142,138,138,49
"4306",5,"[32]HwoIbzAoHcovHnJHGqKCsKvCmgHpaJfH",280,0.996441,32,281,1,280,1,1,0,1,1,149,148,132,132,49
"4307",6,"[32]HwoIbzAoHcovHnJHGqKCsKvCmgHpaJfH",284,0.996491,32,285,1,284,1,1,0,1,1,143,142,142,142,49
"4308",7,"[32]HwoIbzAoHcovHnJHGqKCsKvCmgHpaJfH",267,0.996269,32,268,1,267,1,1,0,1,1,110,109,158,158,49
"4309",8,"[32]HwoIbzAoHcovHnJHGqKCsKvCmgHpaJfH",280,0.996441,32,281,1,280,1,1,0,1,1,138,137,143,143,49
"4310",9,"[32]HwoIbzAoHcovHnJHGqKCsKvCmgHpaJfH",285,0.996503,32,286,1,285,1,1,0,1,1,143,142,143,143,49
"4311",10,"[32]HwoIbzAoHcovHnJHGqKCsKvCmgHpaJfH",273,0.99635,32,274,1,273,1,1,0,1,1,148,147,126,126,49
"4312",11,"[32]HwoIbzAoHcovHnJHGqKCsKvCmgHpaJfH",277,0.996403,32,278,1,277,1,1,0,1,1,139,138,139,139,49
"4313",12,"[32]HwoIbzAoHcovHnJHGqKCsKvCmgHpaJfH",284,0.996491,32,285,1,284,1,1,0,1,1,149,148,136,136,49
"4314",13,"[32]HwoIbzAoHcovHnJHGqKCsKvCmgHpaJfH",275,0.996377,32,276,1,275,1,1,0,1,1,138,137,138,138,49
"4315",14,"[32]HwoIbzAoHcovHnJHGqKCsKvCmgHpaJfH",277,0.996403,32,278,1,277,1,1,0,1,1,138,137,140,140,49
"4316",15,"[32]HwoIbzAoHcovHnJHGqKCsKvCmgHpaJfH",287,0.996528,32,288,1,287,1,1,0,1,1,144,143,144,144,49
"4317",16,"[32]HwoIbzAoHcovHnJHGqKCsKvCmgHpaJfH",280,0.996441,32,281,1,280,1,1,0,1,1,139,138,142,142,49
"4318",17,"[32]HwoIbzAoHcovHnJHGqKCsKvCmgHpaJfH",282,0.996466,32,283,1,282,1,1,0,1,1,145,144,138,138,49
"4319",18,"[32]HwoIbzAoHcovHnJHGqKCsKvCmgHpaJfH",284,0.996491,32,285,1,284,1,1,0,1,1,160,159,125,125,49
"4320",19,"[32]HwoIbzAoHcovHnJHGqKCsKvCmgHpaJfH",275,0.996377,32,276,1,275,1,1,0,1,1,139,138,137,137,49
"4321",20,"[32]HwoIbzAoHcovHnJHGqKCsKvCmgHpaJfH",276,0.99639,32,277,1,276,1,1,0,1,1,132,131,145,145,49
"4322",21,"[32]HwoIbzAoHcovHnJHGqKCsKvCmgHpaJfH",281,0.996454,32,282,1,281,1,1,0,1,1,136,135,146,146,49
"4323",22,"[32]HwoIbzAoHcovHnJHGqKCsKvCmgHpaJfH",287,0.996528,32,288,1,287,1,1,0,1,1,148,147,140,140,49
"4324",23,"[32]HwoIbzAoHcovHnJHGqKCsKvCmgHpaJfH",282,0.996466,32,283,1,282,1,1,0,1,1,137,136,146,146,49
"4325",24,"[32]HwoIbzAoHcovHnJHGqKCsKvCmgHpaJfH",286,0.996516,32,287,1,286,1,1,0,1,1,136,135,151,151,49
"4326",25,"[32]HwoIbzAoHcovHnJHGqKCsKvCmgHpaJfH",283,0.996479,32,284,1,283,1,1,0,1,1,142,141,142,142,49
"4327",26,"[32]HwoIbzAoHcovHnJHGqKCsKvCmgHpaJfH",275,0.996377,32,276,1,275,1,1,0,1,1,139,138,137,137,49
"4328",27,"[32]HwoIbzAoHcovHnJHGqKCsKvCmgHpaJfH",285,0.996503,32,286,1,285,1,1,0,1,1,142,141,144,144,49
"4329",28,"[32]HwoIbzAoHcovHnJHGqKCsKvCmgHpaJfH",288,0.99654,32,289,1,288,1,1,0,1,1,145,144,144,144,49
"4330",29,"[32]HwoIbzAoHcovHnJHGqKCsKvCmgHpaJfH",280,0.996441,32,281,1,280,1,1,0,1,1,135,134,146,146,49
"4331",30,"[32]HwoIbzAoHcovHnJHGqKCsKvCmgHpaJfH",286,0.996516,32,287,1,286,1,1,0,1,1,152,151,135,135,49
"4332",31,"[32]HwoIbzAoHcovHnJHGqKCsKvCmgHpaJfH",286,0.996516,32,287,1,286,1,1,0,1,1,143,142,144,144,49
"4333",32,"[32]HwoIbzAoHcovHnJHGqKCsKvCmgHpaJfH",285,0.996503,32,286,1,285,1,1,0,1,1,161,160,125,125,49
"4334",33,"[32]HwoIbzAoHcovHnJHGqKCsKvCmgHpaJfH",289,0.996552,32,290,1,289,1,1,0,1,1,142,141,148,148,49
"4335",34,"[32]HwoIbzAoHcovHnJHGqKCsKvCmgHpaJfH",291,0.996575,32,292,1,291,1,1,0,1,1,155,154,137,137,49
"4336",35,"[32]HwoIbzAoHcovHnJHGqKCsKvCmgHpaJfH",284,0.996491,32,285,1,284,1,1,0,1,1,137,136,148,148,49
"4337",36,"[32]HwoIbzAoHcovHnJHGqKCsKvCmgHpaJfH",271,0.996324,32,272,1,271,1,1,0,1,1,121,120,151,151,49
"4338",37,"[32]HwoIbzAoHcovHnJHGqKCsKvCmgHpaJfH",287,0.996528,32,288,1,287,1,1,0,1,1,149,148,139,139,49
"4339",38,"[32]HwoIbzAoHcovHnJHGqKCsKvCmgHpaJfH",288,0.99654,32,289,1,288,1,1,0,1,1,157,156,132,132,49
"4340",39,"[32]HwoIbzAoHcovHnJHGqKCsKvCmgHpaJfH",276,0.99639,32,277,1,276,1,1,0,1,1,126,125,151,151,49
"4341",40,"[32]HwoIbzAoHcovHnJHGqKCsKvCmgHpaJfH",283,0.996479,32,284,1,283,1,1,0,1,1,148,147,136,136,49
"4342",41,"[32]HwoIbzAoHcovHnJHGqKCsKvCmgHpaJfH",282,0.996466,32,283,1,282,1,1,0,1,1,150,149,133,133,49
"4343",42,"[32]HwoIbzAoHcovHnJHGqKCsKvCmgHpaJfH",278,0.996416,32,279,1,278,1,1,0,1,1,143,142,136,136,49
"4344",43,"[32]HwoIbzAoHcovHnJHGqKCsKvCmgHpaJfH",275,0.996377,32,276,1,275,1,1,0,1,1,128,127,148,148,49
"4345",44,"[32]HwoIbzAoHcovHnJHGqKCsKvCmgHpaJfH",279,0.996429,32,280,1,279,1,1,0,1,1,141,140,139,139,49
"4346",45,"[32]HwoIbzAoHcovHnJHGqKCsKvCmgHpaJfH",281,0.996454,32,282,1,281,1,1,0,1,1,148,147,134,134,49
"4347",46,"[32]HwoIbzAoHcovHnJHGqKCsKvCmgHpaJfH",285,0.996503,32,286,1,285,1,1,0,1,1,141,140,145,145,49
"4348",47,"[32]HwoIbzAoHcovHnJHGqKCsKvCmgHpaJfH",284,0.996491,32,285,1,284,1,1,0,1,1,159,158,126,126,49
"4349",48,"[32]HwoIbzAoHcovHnJHGqKCsKvCmgHpaJfH",279,0.996429,32,280,1,279,1,1,0,1,1,122,121,158,158,49
"4350",49,"[32]HwoIbzAoHcovHnJHGqKCsKvCmgHpaJfH",276,0.99639,32,277,1,276,1,1,0,1,1,129,128,148,148,49
"4351",50,"[32]HwoIbzAoHcovHnJHGqKCsKvCmgHpaJfH",281,0.996454,32,282,1,281,1,1,0,1,1,133,132,149,149,49
"4352",51,"[32]HwoIbzAoHcovHnJHGqKCsKvCmgHpaJfH",276,0.99639,32,277,1,276,1,1,0,1,1,132,131,145,145,49
"4353",52,"[32]HwoIbzAoHcovHnJHGqKCsKvCmgHpaJfH",281,0.996454,32,282,1,281,1,1,0,1,1,148,147,134,134,49
"4354",53,"[32]HwoIbzAoHcovHnJHGqKCsKvCmgHpaJfH",281,0.996454,32,282,1,281,1,1,0,1,1,134,133,148,148,49
"4355",54,"[32]HwoIbzAoHcovHnJHGqKCsKvCmgHpaJfH",278,0.996416,32,279,1,278,1,1,0,1,1,139,138,140,140,49
"4356",55,"[32]HwoIbzAoHcovHnJHGqKCsKvCmgHpaJfH",270,0.99631,32,271,1,270,1,1,0,1,1,136,135,135,135,49
"4357",56,"[32]HwoIbzAoHcovHnJHGqKCsKvCmgHpaJfH",283,0.996479,32,284,1,283,1,1,0,1,1,145,144,139,139,49
"4358",57,"[32]HwoIbzAoHcovHnJHGqKCsKvCmgHpaJfH",272,0.996337,32,273,1,272,1,1,0,1,1,129,128,144,144,49
"4359",58,"[32]HwoIbzAoHcovHnJHGqKCsKvCmgHpaJfH",271,0.996324,32,272,1,271,1,1,0,1,1,139,138,133,133,49
"4360",59,"[32]HwoIbzAoHcovHnJHGqKCsKvCmgHpaJfH",271,0.996324,32,272,1,271,1,1,0,1,1,140,139,132,132,49
"4361",60,"[32]HwoIbzAoHcovHnJHGqKCsKvCmgHpaJfH",279,0.996429,32,280,1,279,1,1,0,1,1,146,145,134,134,49
"4362",61,"[32]HwoIbzAoHcovHnJHGqKCsKvCmgHpaJfH",277,0.996403,32,278,1,277,1,1,0,1,1,130,129,148,148,49
"4363",62,"[32]HwoIbzAoHcovHnJHGqKCsKvCmgHpaJfH",288,0.99654,32,289,1,288,1,1,0,1,1,157,156,132,132,49
"4364",63,"[32]HwoIbzAoHcovHnJHGqKCsKvCmgHpaJfH",274,0.996364,32,275,1,274,1,1,0,1,1,134,133,141,141,49
"4365",64,"[32]HwoIbzAoHcovHnJHGqKCsKvCmgHpaJfH",284,0.996491,32,285,1,284,1,1,0,1,1,146,145,139,139,49
"4366",65,"[32]HwoIbzAoHcovHnJHGqKCsKvCmgHpaJfH",276,0.99639,32,277,1,276,1,1,0,1,1,133,132,144,144,49
"4367",66,"[32]HwoIbzAoHcovHnJHGqKCsKvCmgHpaJfH",282,0.996466,32,283,1,282,1,1,0,1,1,142,141,141,141,49
"4368",67,"[32]HwoIbzAoHcovHnJHGqKCsKvCmgHpaJfH",289,0.996552,32,290,1,289,1,1,0,1,1,159,158,131,131,49
"4369",68,"[32]HwoIbzAoHcovHnJHGqKCsKvCmgHpaJfH",276,0.99639,32,277,1,276,1,1,0,1,1,146,145,131,131,49
"4370",69,"[32]HwoIbzAoHcovHnJHGqKCsKvCmgHpaJfH",279,0.996429,32,280,1,279,1,1,0,1,1,126,125,154,154,49
"4371",70,"[32]HwoIbzAoHcovHnJHGqKCsKvCmgHpaJfH",282,0.996466,32,283,1,282,1,1,0,1,1,153,152,130,130,49
"4372",71,"[32]HwoIbzAoHcovHnJHGqKCsKvCmgHpaJfH",276,0.99639,32,277,1,276,1,1,0,1,1,156,155,121,121,49
"4373",72,"[32]HwoIbzAoHcovHnJHGqKCsKvCmgHpaJfH",279,0.996429,32,280,1,279,1,1,0,1,1,139,138,141,141,49
"4374",73,"[32]HwoIbzAoHcovHnJHGqKCsKvCmgHpaJfH",273,0.99635,32,274,1,273,1,1,0,1,1,152,151,122,122,49
"4375",74,"[32]HwoIbzAoHcovHnJHGqKCsKvCmgHpaJfH",281,0.996454,32,282,1,281,1,1,0,1,1,136,135,146,146,49
"4376",75,"[32]HwoIbzAoHcovHnJHGqKCsKvCmgHpaJfH",278,0.996416,32,279,1,278,1,1,0,1,1,138,137,141,141,49
"4377",76,"[32]HwoIbzAoHcovHnJHGqKCsKvCmgHpaJfH",280,0.996441,32,281,1,280,1,1,0,1,1,148,147,133,133,49
"4378",77,"[32]HwoIbzAoHcovHnJHGqKCsKvCmgHpaJfH",276,0.99639,32,277,1,276,1,1,0,1,1,150,149,127,127,49
"4379",78,"[32]HwoIbzAoHcovHnJHGqKCsKvCmgHpaJfH",280,0.996441,32,281,1,280,1,1,0,1,1,142,141,139,139,49
"4380",79,"[32]HwoIbzAoHcovHnJHGqKCsKvCmgHpaJfH",280,0.996441,32,281,1,280,1,1,0,1,1,147,146,134,134,49
"4381",80,"[32]HwoIbzAoHcovHnJHGqKCsKvCmgHpaJfH",281,0.996454,32,282,1,281,1,1,0,1,1,150,149,132,132,49
"4382",81,"[32]HwoIbzAoHcovHnJHGqKCsKvCmgHpaJfH",282,0.996466,32,283,1,282,1,1,0,1,1,149,148,134,134,49
"4383",82,"[32]HwoIbzAoHcovHnJHGqKCsKvCmgHpaJfH",282,0.996466,32,283,1,282,1,1,0,1,1,154,153,129,129,49
"4384",83,"[32]HwoIbzAoHcovHnJHGqKCsKvCmgHpaJfH",279,0.996429,32,280,1,279,1,1,0,1,1,152,151,128,128,49
"4385",84,"[32]HwoIbzAoHcovHnJHGqKCsKvCmgHpaJfH",280,0.996441,32,281,1,280,1,1,0,1,1,135,134,146,146,49
"4386",85,"[32]HwoIbzAoHcovHnJHGqKCsKvCmgHpaJfH",283,0.996479,32,284,1,283,1,1,0,1,1,153,152,131,131,49
"4387",86,"[32]HwoIbzAoHcovHnJHGqKCsKvCmgHpaJfH",284,0.996491,32,285,1,284,1,1,0,1,1,146,145,139,139,49
"4388",87,"[32]HwoIbzAoHcovHnJHGqKCsKvCmgHpaJfH",277,0.996403,32,278,1,277,1,1,0,1,1,150,149,128,128,49
"4389",88,"[32]HwoIbzAoHcovHnJHGqKCsKvCmgHpaJfH",281,0.996454,32,282,1,281,1,1,0,1,1,140,139,142,142,49
"4390",89,"[32]HwoIbzAoHcovHnJHGqKCsKvCmgHpaJfH",273,0.99635,32,274,1,273,1,1,0,1,1,147,146,127,127,49
"4391",90,"[32]HwoIbzAoHcovHnJHGqKCsKvCmgHpaJfH",283,0.996479,32,284,1,283,1,1,0,1,1,141,140,143,143,49
"4392",91,"[32]HwoIbzAoHcovHnJHGqKCsKvCmgHpaJfH",275,0.996377,32,276,1,275,1,1,0,1,1,141,140,135,135,49
"4393",92,"[32]HwoIbzAoHcovHnJHGqKCsKvCmgHpaJfH",280,0.996441,32,281,1,280,1,1,0,1,1,130,129,151,151,49
"4394",93,"[32]HwoIbzAoHcovHnJHGqKCsKvCmgHpaJfH",283,0.996479,32,284,1,283,1,1,0,1,1,156,155,128,128,49
"4395",94,"[32]HwoIbzAoHcovHnJHGqKCsKvCmgHpaJfH",275,0.996377,32,276,1,275,1,1,0,1,1,144,143,132,132,49
"4396",95,"[32]HwoIbzAoHcovHnJHGqKCsKvCmgHpaJfH",280,0.996441,32,281,1,280,1,1,0,1,1,147,146,134,134,49
"4397",96,"[32]HwoIbzAoHcovHnJHGqKCsKvCmgHpaJfH",278,0.996416,32,279,1,278,1,1,0,1,1,150,149,129,129,49
"4398",97,"[32]HwoIbzAoHcovHnJHGqKCsKvCmgHpaJfH",279,0.996429,32,280,1,279,1,1,0,1,1,136,135,144,144,49
"4399",98,"[32]HwoIbzAoHcovHnJHGqKCsKvCmgHpaJfH",278,0.996416,32,279,1,278,1,1,0,1,1,124,123,155,155,49
"4400",99,"[32]HwoIbzAoHcovHnJHGqKCsKvCmgHpaJfH",277,0.996403,32,278,1,277,1,1,0,1,1,132,131,146,146,49
"4401",0,"[24]loIoHcoxHnJHGqKCiuCxIibB",281,0.996454,24,282,1,281,1,1,0,1,1,126,125,156,156,50
"4402",1,"[24]loIoHcoxHnJHGqKCiuCxIibB",278,0.996416,24,279,1,278,1,1,0,1,1,144,143,135,135,50
"4403",2,"[24]loIoHcoxHnJHGqKCiuCxIibB",278,0.996416,24,279,1,278,1,1,0,1,1,134,133,145,145,50
"4404",3,"[24]loIoHcoxHnJHGqKCiuCxIibB",282,0.996466,24,283,1,282,1,1,0,1,1,153,152,130,130,50
"4405",4,"[24]loIoHcoxHnJHGqKCiuCxIibB",277,0.996403,24,278,1,277,1,1,0,1,1,130,129,148,148,50
"4406",5,"[24]loIoHcoxHnJHGqKCiuCxIibB",283,0.996479,24,284,1,283,1,1,0,1,1,137,136,147,147,50
"4407",6,"[24]loIoHcoxHnJHGqKCiuCxIibB",287,0.996528,24,288,1,287,1,1,0,1,1,152,151,136,136,50
"4408",7,"[24]loIoHcoxHnJHGqKCiuCxIibB",277,0.996403,24,278,1,277,1,1,0,1,1,137,136,141,141,50
"4409",8,"[24]loIoHcoxHnJHGqKCiuCxIibB",284,0.996491,24,285,1,284,1,1,0,1,1,156,155,129,129,50
"4410",9,"[24]loIoHcoxHnJHGqKCiuCxIibB",289,0.996552,24,290,1,289,1,1,0,1,1,153,152,137,137,50
"4411",10,"[24]loIoHcoxHnJHGqKCiuCxIibB",289,0.996552,24,290,1,289,1,1,0,1,1,159,158,131,131,50
"4412",11,"[24]loIoHcoxHnJHGqKCiuCxIibB",274,0.996364,24,275,1,274,1,1,0,1,1,140,139,135,135,50
"4413",12,"[24]loIoHcoxHnJHGqKCiuCxIibB",279,0.996429,24,280,1,279,1,1,0,1,1,152,151,128,128,50
"4414",13,"[24]loIoHcoxHnJHGqKCiuCxIibB",282,0.996466,24,283,1,282,1,1,0,1,1,147,146,136,136,50
"4415",14,"[24]loIoHcoxHnJHGqKCiuCxIibB",275,0.996377,24,276,1,275,1,1,0,1,1,126,125,150,150,50
"4416",15,"[24]loIoHcoxHnJHGqKCiuCxIibB",289,0.996552,24,290,1,289,1,1,0,1,1,160,159,130,130,50
"4417",16,"[24]loIoHcoxHnJHGqKCiuCxIibB",280,0.996441,24,281,1,280,1,1,0,1,1,138,137,143,143,50
"4418",17,"[24]loIoHcoxHnJHGqKCiuCxIibB",280,0.996441,24,281,1,280,1,1,0,1,1,153,152,128,128,50
"4419",18,"[24]loIoHcoxHnJHGqKCiuCxIibB",275,0.996377,24,276,1,275,1,1,0,1,1,126,125,150,150,50
"4420",19,"[24]loIoHcoxHnJHGqKCiuCxIibB",283,0.996479,24,284,1,283,1,1,0,1,1,159,158,125,125,50
"4421",20,"[24]loIoHcoxHnJHGqKCiuCxIibB",277,0.996403,24,278,1,277,1,1,0,1,1,127,126,151,151,50
"4422",21,"[24]loIoHcoxHnJHGqKCiuCxIibB",279,0.996429,24,280,1,279,1,1,0,1,1,154,153,126,126,50
"4423",22,"[24]loIoHcoxHnJHGqKCiuCxIibB",274,0.996364,24,275,1,274,1,1,0,1,1,136,135,139,139,50
"4424",23,"[24]loIoHcoxHnJHGqKCiuCxIibB",273,0.99635,24,274,1,273,1,1,0,1,1,138,137,136,136,50
"4425",24,"[24]loIoHcoxHnJHGqKCiuCxIibB",273,0.99635,24,274,1,273,1,1,0,1,1,132,131,142,142,50
"4426",25,"[24]loIoHcoxHnJHGqKCiuCxIibB",284,0.996491,24,285,1,284,1,1,0,1,1,137,136,148,148,50
"4427",26,"[24]loIoHcoxHnJHGqKCiuCxIibB",280,0.996441,24,281,1,280,1,1,0,1,1,148,147,133,133,50
"4428",27,"[24]loIoHcoxHnJHGqKCiuCxIibB",283,0.996479,24,284,1,283,1,1,0,1,1,129,128,155,155,50
"4429",28,"[24]loIoHcoxHnJHGqKCiuCxIibB",281,0.996454,24,282,1,281,1,1,0,1,1,146,145,136,136,50
"4430",29,"[24]loIoHcoxHnJHGqKCiuCxIibB",280,0.996441,24,281,1,280,1,1,0,1,1,145,144,136,136,50
"4431",30,"[24]loIoHcoxHnJHGqKCiuCxIibB",278,0.996416,24,279,1,278,1,1,0,1,1,150,149,129,129,50
"4432",31,"[24]loIoHcoxHnJHGqKCiuCxIibB",278,0.996416,24,279,1,278,1,1,0,1,1,132,131,147,147,50
"4433",32,"[24]loIoHcoxHnJHGqKCiuCxIibB",286,0.996516,24,287,1,286,1,1,0,1,1,154,153,133,133,50
"4434",33,"[24]loIoHcoxHnJHGqKCiuCxIibB",276,0.99639,24,277,1,276,1,1,0,1,1,147,146,130,130,50
"4435",34,"[24]loIoHcoxHnJHGqKCiuCxIibB",284,0.996491,24,285,1,284,1,1,0,1,1,140,139,145,145,50
"4436",35,"[24]loIoHcoxHnJHGqKCiuCxIibB",287,0.996528,24,288,1,287,1,1,0,1,1,164,163,124,124,50
"4437",36,"[24]loIoHcoxHnJHGqKCiuCxIibB",284,0.996491,24,285,1,284,1,1,0,1,1,142,141,143,143,50
"4438",37,"[24]loIoHcoxHnJHGqKCiuCxIibB",283,0.996479,24,284,1,283,1,1,0,1,1,140,139,144,144,50
"4439",38,"[24]loIoHcoxHnJHGqKCiuCxIibB",274,0.996364,24,275,1,274,1,1,0,1,1,134,133,141,141,50
"4440",39,"[24]loIoHcoxHnJHGqKCiuCxIibB",281,0.996454,24,282,1,281,1,1,0,1,1,138,137,144,144,50
"4441",40,"[24]loIoHcoxHnJHGqKCiuCxIibB",285,0.996503,24,286,1,285,1,1,0,1,1,150,149,136,136,50
"4442",41,"[24]loIoHcoxHnJHGqKCiuCxIibB",285,0.996503,24,286,1,285,1,1,0,1,1,157,156,129,129,50
"4443",42,"[24]loIoHcoxHnJHGqKCiuCxIibB",275,0.996377,24,276,1,275,1,1,0,1,1,139,138,137,137,50
"4444",43,"[24]loIoHcoxHnJHGqKCiuCxIibB",280,0.996441,24,281,1,280,1,1,0,1,1,145,144,136,136,50
"4445",44,"[24]loIoHcoxHnJHGqKCiuCxIibB",286,0.996516,24,287,1,286,1,1,0,1,1,143,142,144,144,50
"4446",45,"[24]loIoHcoxHnJHGqKCiuCxIibB",279,0.996429,24,280,1,279,1,1,0,1,1,131,130,149,149,50
"4447",46,"[24]loIoHcoxHnJHGqKCiuCxIibB",286,0.996516,24,287,1,286,1,1,0,1,1,145,144,142,142,50
"4448",47,"[24]loIoHcoxHnJHGqKCiuCxIibB",287,0.996528,24,288,1,287,1,1,0,1,1,144,143,144,144,50
"4449",48,"[24]loIoHcoxHnJHGqKCiuCxIibB",285,0.996503,24,286,1,285,1,1,0,1,1,145,144,141,141,50
"4450",49,"[24]loIoHcoxHnJHGqKCiuCxIibB",281,0.996454,24,282,1,281,1,1,0,1,1,140,139,142,142,50
"4451",50,"[24]loIoHcoxHnJHGqKCiuCxIibB",279,0.996429,24,280,1,279,1,1,0,1,1,131,130,149,149,50
"4452",51,"[24]loIoHcoxHnJHGqKCiuCxIibB",280,0.996441,24,281,1,280,1,1,0,1,1,146,145,135,135,50
"4453",52,"[24]loIoHcoxHnJHGqKCiuCxIibB",272,0.996337,24,273,1,272,1,1,0,1,1,125,124,148,148,50
"4454",53,"[24]loIoHcoxHnJHGqKCiuCxIibB",281,0.996454,24,282,1,281,1,1,0,1,1,136,135,146,146,50
"4455",54,"[24]loIoHcoxHnJHGqKCiuCxIibB",285,0.996503,24,286,1,285,1,1,0,1,1,140,139,146,146,50
"4456",55,"[24]loIoHcoxHnJHGqKCiuCxIibB",281,0.996454,24,282,1,281,1,1,0,1,1,133,132,149,149,50
"4457",56,"[24]loIoHcoxHnJHGqKCiuCxIibB",280,0.996441,24,281,1,280,1,1,0,1,1,135,134,146,146,50
"4458",57,"[24]loIoHcoxHnJHGqKCiuCxIibB",277,0.996403,24,278,1,277,1,1,0,1,1,144,143,134,134,50
"4459",58,"[24]loIoHcoxHnJHGqKCiuCxIibB",286,0.996516,24,287,1,286,1,1,0,1,1,159,158,128,128,50
"4460",59,"[24]loIoHcoxHnJHGqKCiuCxIibB",282,0.996466,24,283,1,282,1,1,0,1,1,142,141,141,141,50
"4461",60,"[24]loIoHcoxHnJHGqKCiuCxIibB",282,0.996466,24,283,1,282,1,1,0,1,1,146,145,137,137,50
"4462",61,"[24]loIoHcoxHnJHGqKCiuCxIibB",284,0.996491,24,285,1,284,1,1,0,1,1,144,143,141,141,50
"4463",62,"[24]loIoHcoxHnJHGqKCiuCxIibB",283,0.996479,24,284,1,283,1,1,0,1,1,151,150,133,133,50
"4464",63,"[24]loIoHcoxHnJHGqKCiuCxIibB",282,0.996466,24,283,1,282,1,1,0,1,1,135,134,148,148,50
"4465",64,"[24]loIoHcoxHnJHGqKCiuCxIibB",281,0.996454,24,282,1,281,1,1,0,1,1,141,140,141,141,50
"4466",65,"[24]loIoHcoxHnJHGqKCiuCxIibB",283,0.996479,24,284,1,283,1,1,0,1,1,144,143,140,140,50
"4467",66,"[24]loIoHcoxHnJHGqKCiuCxIibB",277,0.996403,24,278,1,277,1,1,0,1,1,136,135,142,142,50
"4468",67,"[24]loIoHcoxHnJHGqKCiuCxIibB",282,0.996466,24,283,1,282,1,1,0,1,1,146,145,137,137,50
"4469",68,"[24]loIoHcoxHnJHGqKCiuCxIibB",280,0.996441,24,281,1,280,1,1,0,1,1,130,129,151,151,50
"4470",69,"[24]loIoHcoxHnJHGqKCiuCxIibB",290,0.996564,24,291,1,290,1,1,0,1,1,156,155,135,135,50
"4471",70,"[24]loIoHcoxHnJHGqKCiuCxIibB",275,0.996377,24,276,1,275,1,1,0,1,1,127,126,149,149,50
"4472",71,"[24]loIoHcoxHnJHGqKCiuCxIibB",284,0.996491,24,285,1,284,1,1,0,1,1,155,154,130,130,50
"4473",72,"[24]loIoHcoxHnJHGqKCiuCxIibB",278,0.996416,24,279,1,278,1,1,0,1,1,130,129,149,149,50
"4474",73,"[24]loIoHcoxHnJHGqKCiuCxIibB",280,0.996441,24,281,1,280,1,1,0,1,1,145,144,136,136,50
"4475",74,"[24]loIoHcoxHnJHGqKCiuCxIibB",282,0.996466,24,283,1,282,1,1,0,1,1,149,148,134,134,50
"4476",75,"[24]loIoHcoxHnJHGqKCiuCxIibB",283,0.996479,24,284,1,283,1,1,0,1,1,142,141,142,142,50
"4477",76,"[24]loIoHcoxHnJHGqKCiuCxIibB",282,0.996466,24,283,1,282,1,1,0,1,1,144,143,139,139,50
"4478",77,"[24]loIoHcoxHnJHGqKCiuCxIibB",277,0.996403,24,278,1,277,1,1,0,1,1,138,137,140,140,50
"4479",78,"[24]loIoHcoxHnJHGqKCiuCxIibB",280,0.996441,24,281,1,280,1,1,0,1,1,131,130,150,150,50
"4480",79,"[24]loIoHcoxHnJHGqKCiuCxIibB",281,0.996454,24,282,1,281,1,1,0,1,1,134,133,148,148,50
"4481",80,"[24]loIoHcoxHnJHGqKCiuCxIibB",282,0.996466,24,283,1,282,1,1,0,1,1,154,153,129,129,50
"4482",81,"[24]loIoHcoxHnJHGqKCiuCxIibB",280,0.996441,24,281,1,280,1,1,0,1,1,127,126,154,154,50
"4483",82,"[24]loIoHcoxHnJHGqKCiuCxIibB",283,0.996479,24,284,1,283,1,1,0,1,1,140,139,144,144,50
"4484",83,"[24]loIoHcoxHnJHGqKCiuCxIibB",279,0.996429,24,280,1,279,1,1,0,1,1,135,134,145,145,50
"4485",84,"[24]loIoHcoxHnJHGqKCiuCxIibB",285,0.996503,24,286,1,285,1,1,0,1,1,143,142,143,143,50
"4486",85,"[24]loIoHcoxHnJHGqKCiuCxIibB",286,0.996516,24,287,1,286,1,1,0,1,1,142,141,145,145,50
"4487",86,"[24]loIoHcoxHnJHGqKCiuCxIibB",279,0.996429,24,280,1,279,1,1,0,1,1,133,132,147,147,50
"4488",87,"[24]loIoHcoxHnJHGqKCiuCxIibB",281,0.996454,24,282,1,281,1,1,0,1,1,151,150,131,131,50
"4489",88,"[24]loIoHcoxHnJHGqKCiuCxIibB",285,0.996503,24,286,1,285,1,1,0,1,1,166,165,120,120,50
"4490",89,"[24]loIoHcoxHnJHGqKCiuCxIibB",273,0.99635,24,274,1,273,1,1,0,1,1,116,115,158,158,50
"4491",90,"[24]loIoHcoxHnJHGqKCiuCxIibB",288,0.99654,24,289,1,288,1,1,0,1,1,138,137,151,151,50
"4492",91,"[24]loIoHcoxHnJHGqKCiuCxIibB",279,0.996429,24,280,1,279,1,1,0,1,1,139,138,141,141,50
"4493",92,"[24]loIoHcoxHnJHGqKCiuCxIibB",275,0.996377,24,276,1,275,1,1,0,1,1,136,135,140,140,50
"4494",93,"[24]loIoHcoxHnJHGqKCiuCxIibB",280,0.996441,24,281,1,280,1,1,0,1,1,141,140,140,140,50
"4495",94,"[24]loIoHcoxHnJHGqKCiuCxIibB",277,0.996403,24,278,1,277,1,1,0,1,1,143,142,135,135,50
"4496",95,"[24]loIoHcoxHnJHGqKCiuCxIibB",279,0.996429,24,280,1,279,1,1,0,1,1,146,145,134,134,50
"4497",96,"[24]loIoHcoxHnJHGqKCiuCxIibB",290,0.996564,24,291,1,290,1,1,0,1,1,141,140,150,150,50
"4498",97,"[24]loIoHcoxHnJHGqKCiuCxIibB",280,0.996441,24,281,1,280,1,1,0,1,1,132,131,149,149,50
"4499",98,"[24]loIoHcoxHnJHGqKCiuCxIibB",283,0.996479,24,284,1,283,1,1,0,1,1,148,147,136,136,50
"4500",99,"[24]loIoHcoxHnJHGqKCiuCxIibB",286,0.996516,24,287,1,286,1,1,0,1,1,136,135,151,151,50
"4501",0,"[24]JHoIoHcotHnJqGKCqBBsDyrF",298,0.996656,24,299,1,298,1,1,0,1,1,151,150,148,148,51
"4502",1,"[24]JHoIoHcotHnJqGKCqBBsDyrF",294,0.99661,24,295,1,294,1,1,0,1,1,138,137,157,157,51
"4503",2,"[24]JHoIoHcotHnJqGKCqBBsDyrF",295,0.996622,24,296,1,295,1,1,0,1,1,141,140,155,155,51
"4504",3,"[24]JHoIoHcotHnJqGKCqBBsDyrF",302,0.9967,24,303,1,302,1,1,0,1,1,165,164,138,138,51
"4505",4,"[24]JHoIoHcotHnJqGKCqBBsDyrF",303,0.996711,24,304,1,303,1,1,0,1,1,165,164,139,139,51
"4506",5,"[24]JHoIoHcotHnJqGKCqBBsDyrF",295,0.996622,24,296,1,295,1,1,0,1,1,142,141,154,154,51
"4507",6,"[24]JHoIoHcotHnJqGKCqBBsDyrF",298,0.996656,24,299,1,298,1,1,0,1,1,155,154,144,144,51
"4508",7,"[24]JHoIoHcotHnJqGKCqBBsDyrF",297,0.996644,24,298,1,297,1,1,0,1,1,149,148,149,149,51
"4509",8,"[24]JHoIoHcotHnJqGKCqBBsDyrF",302,0.9967,24,303,1,302,1,1,0,1,1,158,157,145,145,51
"4510",9,"[24]JHoIoHcotHnJqGKCqBBsDyrF",297,0.996644,24,298,1,297,1,1,0,1,1,148,147,150,150,51
"4511",10,"[24]JHoIoHcotHnJqGKCqBBsDyrF",292,0.996587,24,293,1,292,1,1,0,1,1,128,127,165,165,51
"4512",11,"[24]JHoIoHcotHnJqGKCqBBsDyrF",297,0.996644,24,298,1,297,1,1,0,1,1,149,148,149,149,51
"4513",12,"[24]JHoIoHcotHnJqGKCqBBsDyrF",302,0.9967,24,303,1,302,1,1,0,1,1,168,167,135,135,51
"4514",13,"[24]JHoIoHcotHnJqGKCqBBsDyrF",299,0.996667,24,300,1,299,1,1,0,1,1,151,150,149,149,51
"4515",14,"[24]JHoIoHcotHnJqGKCqBBsDyrF",298,0.996656,24,299,1,298,1,1,0,1,1,153,152,146,146,51
"4516",15,"[24]JHoIoHcotHnJqGKCqBBsDyrF",296,0.996633,24,297,1,296,1,1,0,1,1,149,148,148,148,51
"4517",16,"[24]JHoIoHcotHnJqGKCqBBsDyrF",305,0.996732,24,306,1,305,1,1,0,1,1,166,165,140,140,51
"4518",17,"[24]JHoIoHcotHnJqGKCqBBsDyrF",299,0.996667,24,300,1,299,1,1,0,1,1,153,152,147,147,51
"4519",18,"[24]JHoIoHcotHnJqGKCqBBsDyrF",291,0.996575,24,292,1,291,1,1,0,1,1,138,137,154,154,51
"4520",19,"[24]JHoIoHcotHnJqGKCqBBsDyrF",300,0.996678,24,301,1,300,1,1,0,1,1,157,156,144,144,51
"4521",20,"[24]JHoIoHcotHnJqGKCqBBsDyrF",303,0.996711,24,304,1,303,1,1,0,1,1,165,164,139,139,51
"4522",21,"[24]JHoIoHcotHnJqGKCqBBsDyrF",300,0.996678,24,301,1,300,1,1,0,1,1,156,155,145,145,51
"4523",22,"[24]JHoIoHcotHnJqGKCqBBsDyrF",297,0.996644,24,298,1,297,1,1,0,1,1,158,157,140,140,51
"4524",23,"[24]JHoIoHcotHnJqGKCqBBsDyrF",296,0.996633,24,297,1,296,1,1,0,1,1,143,142,154,154,51
"4525",24,"[24]JHoIoHcotHnJqGKCqBBsDyrF",294,0.99661,24,295,1,294,1,1,0,1,1,137,136,158,158,51
"4526",25,"[24]JHoIoHcotHnJqGKCqBBsDyrF",292,0.996587,24,293,1,292,1,1,0,1,1,138,137,155,155,51
"4527",26,"[24]JHoIoHcotHnJqGKCqBBsDyrF",305,0.996732,24,306,1,305,1,1,0,1,1,168,167,138,138,51
"4528",27,"[24]JHoIoHcotHnJqGKCqBBsDyrF",295,0.996622,24,296,1,295,1,1,0,1,1,141,140,155,155,51
"4529",28,"[24]JHoIoHcotHnJqGKCqBBsDyrF",295,0.996622,24,296,1,295,1,1,0,1,1,144,143,152,152,51
"4530",29,"[24]JHoIoHcotHnJqGKCqBBsDyrF",305,0.996732,24,306,1,305,1,1,0,1,1,164,163,142,142,51
"4531",30,"[24]JHoIoHcotHnJqGKCqBBsDyrF",297,0.996644,24,298,1,297,1,1,0,1,1,150,149,148,148,51
"4532",31,"[24]JHoIoHcotHnJqGKCqBBsDyrF",298,0.996656,24,299,1,298,1,1,0,1,1,151,150,148,148,51
"4533",32,"[24]JHoIoHcotHnJqGKCqBBsDyrF",297,0.996644,24,298,1,297,1,1,0,1,1,145,144,153,153,51
"4534",33,"[24]JHoIoHcotHnJqGKCqBBsDyrF",295,0.996622,24,296,1,295,1,1,0,1,1,142,141,154,154,51
"4535",34,"[24]JHoIoHcotHnJqGKCqBBsDyrF",298,0.996656,24,299,1,298,1,1,0,1,1,147,146,152,152,51
"4536",35,"[24]JHoIoHcotHnJqGKCqBBsDyrF",298,0.996656,24,299,1,298,1,1,0,1,1,150,149,149,149,51
"4537",36,"[24]JHoIoHcotHnJqGKCqBBsDyrF",299,0.996667,24,300,1,299,1,1,0,1,1,154,153,146,146,51
"4538",37,"[24]JHoIoHcotHnJqGKCqBBsDyrF",298,0.996656,24,299,1,298,1,1,0,1,1,153,152,146,146,51
"4539",38,"[24]JHoIoHcotHnJqGKCqBBsDyrF",295,0.996622,24,296,1,295,1,1,0,1,1,145,144,151,151,51
"4540",39,"[24]JHoIoHcotHnJqGKCqBBsDyrF",294,0.99661,24,295,1,294,1,1,0,1,1,141,140,154,154,51
"4541",40,"[24]JHoIoHcotHnJqGKCqBBsDyrF",299,0.996667,24,300,1,299,1,1,0,1,1,152,151,148,148,51
"4542",41,"[24]JHoIoHcotHnJqGKCqBBsDyrF",300,0.996678,24,301,1,300,1,1,0,1,1,154,153,147,147,51
"4543",42,"[24]JHoIoHcotHnJqGKCqBBsDyrF",297,0.996644,24,298,1,297,1,1,0,1,1,146,145,152,152,51
"4544",43,"[24]JHoIoHcotHnJqGKCqBBsDyrF",297,0.996644,24,298,1,297,1,1,0,1,1,145,144,153,153,51
"4545",44,"[24]JHoIoHcotHnJqGKCqBBsDyrF",303,0.996711,24,304,1,303,1,1,0,1,1,162,161,142,142,51
"4546",45,"[24]JHoIoHcotHnJqGKCqBBsDyrF",296,0.996633,24,297,1,296,1,1,0,1,1,145,144,152,152,51
"4547",46,"[24]JHoIoHcotHnJqGKCqBBsDyrF",304,0.996721,24,305,1,304,1,1,0,1,1,162,161,143,143,51
"4548",47,"[24]JHoIoHcotHnJqGKCqBBsDyrF",296,0.996633,24,297,1,296,1,1,0,1,1,143,142,154,154,51
"4549",48,"[24]JHoIoHcotHnJqGKCqBBsDyrF",297,0.996644,24,298,1,297,1,1,0,1,1,144,143,154,154,51
"4550",49,"[24]JHoIoHcotHnJqGKCqBBsDyrF",301,0.996689,24,302,1,301,1,1,0,1,1,160,159,142,142,51
"4551",50,"[24]JHoIoHcotHnJqGKCqBBsDyrF",298,0.996656,24,299,1,298,1,1,0,1,1,150,149,149,149,51
"4552",51,"[24]JHoIoHcotHnJqGKCqBBsDyrF",303,0.996711,24,304,1,303,1,1,0,1,1,166,165,138,138,51
"4553",52,"[24]JHoIoHcotHnJqGKCqBBsDyrF",307,0.996753,24,308,1,307,1,1,0,1,1,172,171,136,136,51
"4554",53,"[24]JHoIoHcotHnJqGKCqBBsDyrF",294,0.99661,24,295,1,294,1,1,0,1,1,142,141,153,153,51
"4555",54,"[24]JHoIoHcotHnJqGKCqBBsDyrF",303,0.996711,24,304,1,303,1,1,0,1,1,162,161,142,142,51
"4556",55,"[24]JHoIoHcotHnJqGKCqBBsDyrF",304,0.996721,24,305,1,304,1,1,0,1,1,165,164,140,140,51
"4557",56,"[24]JHoIoHcotHnJqGKCqBBsDyrF",298,0.996656,24,299,1,298,1,1,0,1,1,151,150,148,148,51
"4558",57,"[24]JHoIoHcotHnJqGKCqBBsDyrF",294,0.99661,24,295,1,294,1,1,0,1,1,145,144,150,150,51
"4559",58,"[24]JHoIoHcotHnJqGKCqBBsDyrF",299,0.996667,24,300,1,299,1,1,0,1,1,156,155,144,144,51
"4560",59,"[24]JHoIoHcotHnJqGKCqBBsDyrF",296,0.996633,24,297,1,296,1,1,0,1,1,145,144,152,152,51
"4561",60,"[24]JHoIoHcotHnJqGKCqBBsDyrF",300,0.996678,24,301,1,300,1,1,0,1,1,162,161,139,139,51
"4562",61,"[24]JHoIoHcotHnJqGKCqBBsDyrF",302,0.9967,24,303,1,302,1,1,0,1,1,157,156,146,146,51
"4563",62,"[24]JHoIoHcotHnJqGKCqBBsDyrF",297,0.996644,24,298,1,297,1,1,0,1,1,148,147,150,150,51
"4564",63,"[24]JHoIoHcotHnJqGKCqBBsDyrF",297,0.996644,24,298,1,297,1,1,0,1,1,147,146,151,151,51
"4565",64,"[24]JHoIoHcotHnJqGKCqBBsDyrF",296,0.996633,24,297,1,296,1,1,0,1,1,146,145,151,151,51
"4566",65,"[24]JHoIoHcotHnJqGKCqBBsDyrF",299,0.996667,24,300,1,299,1,1,0,1,1,154,153,146,146,51
"4567",66,"[24]JHoIoHcotHnJqGKCqBBsDyrF",299,0.996667,24,300,1,299,1,1,0,1,1,152,151,148,148,51
"4568",67,"[24]JHoIoHcotHnJqGKCqBBsDyrF",300,0.996678,24,301,1,300,1,1,0,1,1,155,154,146,146,51
"4569",68,"[24]JHoIoHcotHnJqGKCqBBsDyrF",294,0.99661,24,295,1,294,1,1,0,1,1,143,142,152,152,51
"4570",69,"[24]JHoIoHcotHnJqGKCqBBsDyrF",295,0.996622,24,296,1,295,1,1,0,1,1,144,143,152,152,51
"4571",70,"[24]JHoIoHcotHnJqGKCqBBsDyrF",297,0.996644,24,298,1,297,1,1,0,1,1,150,149,148,148,51
"4572",71,"[24]JHoIoHcotHnJqGKCqBBsDyrF",297,0.996644,24,298,1,297,1,1,0,1,1,140,139,158,158,51
"4573",72,"[24]JHoIoHcotHnJqGKCqBBsDyrF",296,0.996633,24,297,1,296,1,1,0,1,1,143,142,154,154,51
"4574",73,"[24]JHoIoHcotHnJqGKCqBBsDyrF",301,0.996689,24,302,1,301,1,1,0,1,1,154,153,148,148,51
"4575",74,"[24]JHoIoHcotHnJqGKCqBBsDyrF",293,0.996599,24,294,1,293,1,1,0,1,1,141,140,153,153,51
"4576",75,"[24]JHoIoHcotHnJqGKCqBBsDyrF",299,0.996667,24,300,1,299,1,1,0,1,1,161,160,139,139,51
"4577",76,"[24]JHoIoHcotHnJqGKCqBBsDyrF",303,0.996711,24,304,1,303,1,1,0,1,1,161,160,143,143,51
"4578",77,"[24]JHoIoHcotHnJqGKCqBBsDyrF",301,0.996689,24,302,1,301,1,1,0,1,1,156,155,146,146,51
"4579",78,"[24]JHoIoHcotHnJqGKCqBBsDyrF",298,0.996656,24,299,1,298,1,1,0,1,1,149,148,150,150,51
"4580",79,"[24]JHoIoHcotHnJqGKCqBBsDyrF",297,0.996644,24,298,1,297,1,1,0,1,1,157,156,141,141,51
"4581",80,"[24]JHoIoHcotHnJqGKCqBBsDyrF",296,0.996633,24,297,1,296,1,1,0,1,1,148,147,149,149,51
"4582",81,"[24]JHoIoHcotHnJqGKCqBBsDyrF",301,0.996689,24,302,1,301,1,1,0,1,1,160,159,142,142,51
"4583",82,"[24]JHoIoHcotHnJqGKCqBBsDyrF",296,0.996633,24,297,1,296,1,1,0,1,1,139,138,158,158,51
"4584",83,"[24]JHoIoHcotHnJqGKCqBBsDyrF",294,0.99661,24,295,1,294,1,1,0,1,1,136,135,159,159,51
"4585",84,"[24]JHoIoHcotHnJqGKCqBBsDyrF",297,0.996644,24,298,1,297,1,1,0,1,1,151,150,147,147,51
"4586",85,"[24]JHoIoHcotHnJqGKCqBBsDyrF",299,0.996667,24,300,1,299,1,1,0,1,1,154,153,146,146,51
"4587",86,"[24]JHoIoHcotHnJqGKCqBBsDyrF",298,0.996656,24,299,1,298,1,1,0,1,1,151,150,148,148,51
"4588",87,"[24]JHoIoHcotHnJqGKCqBBsDyrF",293,0.996599,24,294,1,293,1,1,0,1,1,143,142,151,151,51
"4589",88,"[24]JHoIoHcotHnJqGKCqBBsDyrF",289,0.996552,24,290,1,289,1,1,0,1,1,120,119,170,170,51
"4590",89,"[24]JHoIoHcotHnJqGKCqBBsDyrF",294,0.99661,24,295,1,294,1,1,0,1,1,138,137,157,157,51
"4591",90,"[24]JHoIoHcotHnJqGKCqBBsDyrF",294,0.99661,24,295,1,294,1,1,0,1,1,135,134,160,160,51
"4592",91,"[24]JHoIoHcotHnJqGKCqBBsDyrF",287,0.996528,24,288,1,287,1,1,0,1,1,130,129,158,158,51
"4593",92,"[24]JHoIoHcotHnJqGKCqBBsDyrF",302,0.9967,24,303,1,302,1,1,0,1,1,161,160,142,142,51
"4594",93,"[24]JHoIoHcotHnJqGKCqBBsDyrF",302,0.9967,24,303,1,302,1,1,0,1,1,165,164,138,138,51
"4595",94,"[24]JHoIoHcotHnJqGKCqBBsDyrF",299,0.996667,24,300,1,299,1,1,0,1,1,153,152,147,147,51
"4596",95,"[24]JHoIoHcotHnJqGKCqBBsDyrF",295,0.996622,24,296,1,295,1,1,0,1,1,144,143,152,152,51
"4597",96,"[24]JHoIoHcotHnJqGKCqBBsDyrF",294,0.99661,24,295,1,294,1,1,0,1,1,141,140,154,154,51
"4598",97,"[24]JHoIoHcotHnJqGKCqBBsDyrF",304,0.996721,24,305,1,304,1,1,0,1,1,159,158,146,146,51
"4599",98,"[24]JHoIoHcotHnJqGKCqBBsDyrF",304,0.996721,24,305,1,304,1,1,0,1,1,168,167,137,137,51
"4600",99,"[24]JHoIoHcotHnJqGKCqBBsDyrF",299,0.996667,24,300,1,299,1,1,0,1,1,152,151,148,148,51
"4601",0,"[25]goIoHcovHnJHGqKCjxsKlnJeG",279,0.996429,25,280,1,279,1,1,0,1,1,132,131,148,148,52
"4602",1,"[25]goIoHcovHnJHGqKCjxsKlnJeG",284,0.996491,25,285,1,284,1,1,0,1,1,136,135,149,149,52
"4603",2,"[25]goIoHcovHnJHGqKCjxsKlnJeG",286,0.996516,25,287,1,286,1,1,0,1,1,161,160,126,126,52
"4604",3,"[25]goIoHcovHnJHGqKCjxsKlnJeG",275,0.996377,25,276,1,275,1,1,0,1,1,137,136,139,139,52
"4605",4,"[25]goIoHcovHnJHGqKCjxsKlnJeG",280,0.996441,25,281,1,280,1,1,0,1,1,141,140,140,140,52
"4606",5,"[25]goIoHcovHnJHGqKCjxsKlnJeG",279,0.996429,25,280,1,279,1,1,0,1,1,135,134,145,145,52
"4607",6,"[25]goIoHcovHnJHGqKCjxsKlnJeG",284,0.996491,25,285,1,284,1,1,0,1,1,136,135,149,149,52
"4608",7,"[25]goIoHcovHnJHGqKCjxsKlnJeG",283,0.996479,25,284,1,283,1,1,0,1,1,131,130,153,153,52
"4609",8,"[25]goIoHcovHnJHGqKCjxsKlnJeG",285,0.996503,25,286,1,285,1,1,0,1,1,162,161,124,124,52
"4610",9,"[25]goIoHcovHnJHGqKCjxsKlnJeG",282,0.996466,25,283,1,282,1,1,0,1,1,150,149,133,133,52
"4611",10,"[25]goIoHcovHnJHGqKCjxsKlnJeG",289,0.996552,25,290,1,289,1,1,0,1,1,152,151,138,138,52
"4612",11,"[25]goIoHcovHnJHGqKCjxsKlnJeG",278,0.996416,25,279,1,278,1,1,0,1,1,149,148,130,130,52
"4613",12,"[25]goIoHcovHnJHGqKCjxsKlnJeG",279,0.996429,25,280,1,279,1,1,0,1,1,144,143,136,136,52
"4614",13,"[25]goIoHcovHnJHGqKCjxsKlnJeG",288,0.99654,25,289,1,288,1,1,0,1,1,141,140,148,148,52
"4615",14,"[25]goIoHcovHnJHGqKCjxsKlnJeG",283,0.996479,25,284,1,283,1,1,0,1,1,150,149,134,134,52
"4616",15,"[25]goIoHcovHnJHGqKCjxsKlnJeG",278,0.996416,25,279,1,278,1,1,0,1,1,149,148,130,130,52
"4617",16,"[25]goIoHcovHnJHGqKCjxsKlnJeG",282,0.996466,25,283,1,282,1,1,0,1,1,145,144,138,138,52
"4618",17,"[25]goIoHcovHnJHGqKCjxsKlnJeG",279,0.996429,25,280,1,279,1,1,0,1,1,132,131,148,148,52
"4619",18,"[25]goIoHcovHnJHGqKCjxsKlnJeG",283,0.996479,25,284,1,283,1,1,0,1,1,132,131,152,152,52
"4620",19,"[25]goIoHcovHnJHGqKCjxsKlnJeG",278,0.996416,25,279,1,278,1,1,0,1,1,150,149,129,129,52
"4621",20,"[25]goIoHcovHnJHGqKCjxsKlnJeG",280,0.996441,25,281,1,280,1,1,0,1,1,155,154,126,126,52
"4622",21,"[25]goIoHcovHnJHGqKCjxsKlnJeG",271,0.996324,25,272,1,271,1,1,0,1,1,134,133,138,138,52
"4623",22,"[25]goIoHcovHnJHGqKCjxsKlnJeG",275,0.996377,25,276,1,275,1,1,0,1,1,125,124,151,151,52
"4624",23,"[25]goIoHcovHnJHGqKCjxsKlnJeG",274,0.996364,25,275,1,274,1,1,0,1,1,114,113,161,161,52
"4625",24,"[25]goIoHcovHnJHGqKCjxsKlnJeG",286,0.996516,25,287,1,286,1,1,0,1,1,135,134,152,152,52
"4626",25,"[25]goIoHcovHnJHGqKCjxsKlnJeG",283,0.996479,25,284,1,283,1,1,0,1,1,136,135,148,148,52
"4627",26,"[25]goIoHcovHnJHGqKCjxsKlnJeG",274,0.996364,25,275,1,274,1,1,0,1,1,129,128,146,146,52
"4628",27,"[25]goIoHcovHnJHGqKCjxsKlnJeG",287,0.996528,25,288,1,287,1,1,0,1,1,143,142,145,145,52
"4629",28,"[25]goIoHcovHnJHGqKCjxsKlnJeG",275,0.996377,25,276,1,275,1,1,0,1,1,127,126,149,149,52
"4630",29,"[25]goIoHcovHnJHGqKCjxsKlnJeG",284,0.996491,25,285,1,284,1,1,0,1,1,142,141,143,143,52
"4631",30,"[25]goIoHcovHnJHGqKCjxsKlnJeG",287,0.996528,25,288,1,287,1,1,0,1,1,152,151,136,136,52
"4632",31,"[25]goIoHcovHnJHGqKCjxsKlnJeG",284,0.996491,25,285,1,284,1,1,0,1,1,146,145,139,139,52
"4633",32,"[25]goIoHcovHnJHGqKCjxsKlnJeG",281,0.996454,25,282,1,281,1,1,0,1,1,127,126,155,155,52
"4634",33,"[25]goIoHcovHnJHGqKCjxsKlnJeG",283,0.996479,25,284,1,283,1,1,0,1,1,143,142,141,141,52
"4635",34,"[25]goIoHcovHnJHGqKCjxsKlnJeG",290,0.996564,25,291,1,290,1,1,0,1,1,155,154,136,136,52
"4636",35,"[25]goIoHcovHnJHGqKCjxsKlnJeG",280,0.996441,25,281,1,280,1,1,0,1,1,130,129,151,151,52
"4637",36,"[25]goIoHcovHnJHGqKCjxsKlnJeG",280,0.996441,25,281,1,280,1,1,0,1,1,129,128,152,152,52
"4638",37,"[25]goIoHcovHnJHGqKCjxsKlnJeG",287,0.996528,25,288,1,287,1,1,0,1,1,140,139,148,148,52
"4639",38,"[25]goIoHcovHnJHGqKCjxsKlnJeG",283,0.996479,25,284,1,283,1,1,0,1,1,138,137,146,146,52
"4640",39,"[25]goIoHcovHnJHGqKCjxsKlnJeG",284,0.996491,25,285,1,284,1,1,0,1,1,162,161,123,123,52
"4641",40,"[25]goIoHcovHnJHGqKCjxsKlnJeG",281,0.996454,25,282,1,281,1,1,0,1,1,147,146,135,135,52
"4642",41,"[25]goIoHcovHnJHGqKCjxsKlnJeG",282,0.996466,25,283,1,282,1,1,0,1,1,155,154,128,128,52
"4643",42,"[25]goIoHcovHnJHGqKCjxsKlnJeG",280,0.996441,25,281,1,280,1,1,0,1,1,146,145,135,135,52
"4644",43,"[25]goIoHcovHnJHGqKCjxsKlnJeG",282,0.996466,25,283,1,282,1,1,0,1,1,143,142,140,140,52
"4645",44,"[25]goIoHcovHnJHGqKCjxsKlnJeG",279,0.996429,25,280,1,279,1,1,0,1,1,139,138,141,141,52
"4646",45,"[25]goIoHcovHnJHGqKCjxsKlnJeG",278,0.996416,25,279,1,278,1,1,0,1,1,151,150,128,128,52
"4647",46,"[25]goIoHcovHnJHGqKCjxsKlnJeG",288,0.99654,25,289,1,288,1,1,0,1,1,144,143,145,145,52
"4648",47,"[25]goIoHcovHnJHGqKCjxsKlnJeG",279,0.996429,25,280,1,279,1,1,0,1,1,135,134,145,145,52
"4649",48,"[25]goIoHcovHnJHGqKCjxsKlnJeG",279,0.996429,25,280,1,279,1,1,0,1,1,143,142,137,137,52
"4650",49,"[25]goIoHcovHnJHGqKCjxsKlnJeG",280,0.996441,25,281,1,280,1,1,0,1,1,137,136,144,144,52
"4651",50,"[25]goIoHcovHnJHGqKCjxsKlnJeG",287,0.996528,25,288,1,287,1,1,0,1,1,143,142,145,145,52
"4652",51,"[25]goIoHcovHnJHGqKCjxsKlnJeG",289,0.996552,25,290,1,289,1,1,0,1,1,139,138,151,151,52
"4653",52,"[25]goIoHcovHnJHGqKCjxsKlnJeG",278,0.996416,25,279,1,278,1,1,0,1,1,155,154,124,124,52
"4654",53,"[25]goIoHcovHnJHGqKCjxsKlnJeG",278,0.996416,25,279,1,278,1,1,0,1,1,128,127,151,151,52
"4655",54,"[25]goIoHcovHnJHGqKCjxsKlnJeG",282,0.996466,25,283,1,282,1,1,0,1,1,162,161,121,121,52
"4656",55,"[25]goIoHcovHnJHGqKCjxsKlnJeG",279,0.996429,25,280,1,279,1,1,0,1,1,124,123,156,156,52
"4657",56,"[25]goIoHcovHnJHGqKCjxsKlnJeG",276,0.99639,25,277,1,276,1,1,0,1,1,124,123,153,153,52
"4658",57,"[25]goIoHcovHnJHGqKCjxsKlnJeG",280,0.996441,25,281,1,280,1,1,0,1,1,157,156,124,124,52
"4659",58,"[25]goIoHcovHnJHGqKCjxsKlnJeG",284,0.996491,25,285,1,284,1,1,0,1,1,152,151,133,133,52
"4660",59,"[25]goIoHcovHnJHGqKCjxsKlnJeG",286,0.996516,25,287,1,286,1,1,0,1,1,156,155,131,131,52
"4661",60,"[25]goIoHcovHnJHGqKCjxsKlnJeG",282,0.996466,25,283,1,282,1,1,0,1,1,142,141,141,141,52
"4662",61,"[25]goIoHcovHnJHGqKCjxsKlnJeG",281,0.996454,25,282,1,281,1,1,0,1,1,147,146,135,135,52
"4663",62,"[25]goIoHcovHnJHGqKCjxsKlnJeG",276,0.99639,25,277,1,276,1,1,0,1,1,157,156,120,120,52
"4664",63,"[25]goIoHcovHnJHGqKCjxsKlnJeG",280,0.996441,25,281,1,280,1,1,0,1,1,139,138,142,142,52
"4665",64,"[25]goIoHcovHnJHGqKCjxsKlnJeG",282,0.996466,25,283,1,282,1,1,0,1,1,144,143,139,139,52
"4666",65,"[25]goIoHcovHnJHGqKCjxsKlnJeG",288,0.99654,25,289,1,288,1,1,0,1,1,154,153,135,135,52
"4667",66,"[25]goIoHcovHnJHGqKCjxsKlnJeG",275,0.996377,25,276,1,275,1,1,0,1,1,126,125,150,150,52
"4668",67,"[25]goIoHcovHnJHGqKCjxsKlnJeG",287,0.996528,25,288,1,287,1,1,0,1,1,152,151,136,136,52
"4669",68,"[25]goIoHcovHnJHGqKCjxsKlnJeG",285,0.996503,25,286,1,285,1,1,0,1,1,156,155,130,130,52
"4670",69,"[25]goIoHcovHnJHGqKCjxsKlnJeG",280,0.996441,25,281,1,280,1,1,0,1,1,145,144,136,136,52
"4671",70,"[25]goIoHcovHnJHGqKCjxsKlnJeG",275,0.996377,25,276,1,275,1,1,0,1,1,148,147,128,128,52
"4672",71,"[25]goIoHcovHnJHGqKCjxsKlnJeG",287,0.996528,25,288,1,287,1,1,0,1,1,144,143,144,144,52
"4673",72,"[25]goIoHcovHnJHGqKCjxsKlnJeG",288,0.99654,25,289,1,288,1,1,0,1,1,160,159,129,129,52
"4674",73,"[25]goIoHcovHnJHGqKCjxsKlnJeG",285,0.996503,25,286,1,285,1,1,0,1,1,155,154,131,131,52
"4675",74,"[25]goIoHcovHnJHGqKCjxsKlnJeG",284,0.996491,25,285,1,284,1,1,0,1,1,147,146,138,138,52
"4676",75,"[25]goIoHcovHnJHGqKCjxsKlnJeG",285,0.996503,25,286,1,285,1,1,0,1,1,128,127,158,158,52
"4677",76,"[25]goIoHcovHnJHGqKCjxsKlnJeG",285,0.996503,25,286,1,285,1,1,0,1,1,137,136,149,149,52
"4678",77,"[25]goIoHcovHnJHGqKCjxsKlnJeG",285,0.996503,25,286,1,285,1,1,0,1,1,155,154,131,131,52
"4679",78,"[25]goIoHcovHnJHGqKCjxsKlnJeG",278,0.996416,25,279,1,278,1,1,0,1,1,140,139,139,139,52
"4680",79,"[25]goIoHcovHnJHGqKCjxsKlnJeG",272,0.996337,25,273,1,272,1,1,0,1,1,114,113,159,159,52
"4681",80,"[25]goIoHcovHnJHGqKCjxsKlnJeG",278,0.996416,25,279,1,278,1,1,0,1,1,135,134,144,144,52
"4682",81,"[25]goIoHcovHnJHGqKCjxsKlnJeG",278,0.996416,25,279,1,278,1,1,0,1,1,142,141,137,137,52
"4683",82,"[25]goIoHcovHnJHGqKCjxsKlnJeG",281,0.996454,25,282,1,281,1,1,0,1,1,135,134,147,147,52
"4684",83,"[25]goIoHcovHnJHGqKCjxsKlnJeG",278,0.996416,25,279,1,278,1,1,0,1,1,136,135,143,143,52
"4685",84,"[25]goIoHcovHnJHGqKCjxsKlnJeG",281,0.996454,25,282,1,281,1,1,0,1,1,159,158,123,123,52
"4686",85,"[25]goIoHcovHnJHGqKCjxsKlnJeG",284,0.996491,25,285,1,284,1,1,0,1,1,163,162,122,122,52
"4687",86,"[25]goIoHcovHnJHGqKCjxsKlnJeG",287,0.996528,25,288,1,287,1,1,0,1,1,141,140,147,147,52
"4688",87,"[25]goIoHcovHnJHGqKCjxsKlnJeG",280,0.996441,25,281,1,280,1,1,0,1,1,133,132,148,148,52
"4689",88,"[25]goIoHcovHnJHGqKCjxsKlnJeG",293,0.996599,25,294,1,293,1,1,0,1,1,153,152,141,141,52
"4690",89,"[25]goIoHcovHnJHGqKCjxsKlnJeG",271,0.996324,25,272,1,271,1,1,0,1,1,136,135,136,136,52
"4691",90,"[25]goIoHcovHnJHGqKCjxsKlnJeG",284,0.996491,25,285,1,284,1,1,0,1,1,140,139,145,145,52
"4692",91,"[25]goIoHcovHnJHGqKCjxsKlnJeG",290,0.996564,25,291,1,290,1,1,0,1,1,150,149,141,141,52
"4693",92,"[25]goIoHcovHnJHGqKCjxsKlnJeG",281,0.996454,25,282,1,281,1,1,0,1,1,138,137,144,144,52
"4694",93,"[25]goIoHcovHnJHGqKCjxsKlnJeG",279,0.996429,25,280,1,279,1,1,0,1,1,132,131,148,148,52
"4695",94,"[25]goIoHcovHnJHGqKCjxsKlnJeG",283,0.996479,25,284,1,283,1,1,0,1,1,147,146,137,137,52
"4696",95,"[25]goIoHcovHnJHGqKCjxsKlnJeG",285,0.996503,25,286,1,285,1,1,0,1,1,137,136,149,149,52
"4697",96,"[25]goIoHcovHnJHGqKCjxsKlnJeG",279,0.996429,25,280,1,279,1,1,0,1,1,133,132,147,147,52
"4698",97,"[25]goIoHcovHnJHGqKCjxsKlnJeG",281,0.996454,25,282,1,281,1,1,0,1,1,147,146,135,135,52
"4699",98,"[25]goIoHcovHnJHGqKCjxsKlnJeG",282,0.996466,25,283,1,282,1,1,0,1,1,144,143,139,139,52
"4700",99,"[25]goIoHcovHnJHGqKCjxsKlnJeG",276,0.99639,25,277,1,276,1,1,0,1,1,147,146,130,130,52
"4701",0,"[24]iAoIoHcovHnJHGqKCFfezesh",283,0.996479,24,284,1,283,1,1,0,1,1,143,142,141,141,53
"4702",1,"[24]iAoIoHcovHnJHGqKCFfezesh",279,0.996429,24,280,1,279,1,1,0,1,1,147,146,133,133,53
"4703",2,"[24]iAoIoHcovHnJHGqKCFfezesh",287,0.996528,24,288,1,287,1,1,0,1,1,147,146,141,141,53
"4704",3,"[24]iAoIoHcovHnJHGqKCFfezesh",281,0.996454,24,282,1,281,1,1,0,1,1,136,135,146,146,53
"4705",4,"[24]iAoIoHcovHnJHGqKCFfezesh",282,0.996466,24,283,1,282,1,1,0,1,1,145,144,138,138,53
"4706",5,"[24]iAoIoHcovHnJHGqKCFfezesh",266,0.996255,24,267,1,266,1,1,0,1,1,122,121,145,145,53
"4707",6,"[24]iAoIoHcovHnJHGqKCFfezesh",282,0.996466,24,283,1,282,1,1,0,1,1,138,137,145,145,53
"4708",7,"[24]iAoIoHcovHnJHGqKCFfezesh",276,0.99639,24,277,1,276,1,1,0,1,1,134,133,143,143,53
"4709",8,"[24]iAoIoHcovHnJHGqKCFfezesh",284,0.996491,24,285,1,284,1,1,0,1,1,156,155,129,129,53
"4710",9,"[24]iAoIoHcovHnJHGqKCFfezesh",284,0.996491,24,285,1,284,1,1,0,1,1,131,130,154,154,53
"4711",10,"[24]iAoIoHcovHnJHGqKCFfezesh",276,0.99639,24,277,1,276,1,1,0,1,1,129,128,148,148,53
"4712",11,"[24]iAoIoHcovHnJHGqKCFfezesh",279,0.996429,24,280,1,279,1,1,0,1,1,139,138,141,141,53
"4713",12,"[24]iAoIoHcovHnJHGqKCFfezesh",286,0.996516,24,287,1,286,1,1,0,1,1,138,137,149,149,53
"4714",13,"[24]iAoIoHcovHnJHGqKCFfezesh",287,0.996528,24,288,1,287,1,1,0,1,1,148,147,140,140,53
"4715",14,"[24]iAoIoHcovHnJHGqKCFfezesh",274,0.996364,24,275,1,274,1,1,0,1,1,141,140,134,134,53
"4716",15,"[24]iAoIoHcovHnJHGqKCFfezesh",278,0.996416,24,279,1,278,1,1,0,1,1,134,133,145,145,53
"4717",16,"[24]iAoIoHcovHnJHGqKCFfezesh",278,0.996416,24,279,1,278,1,1,0,1,1,135,134,144,144,53
"4718",17,"[24]iAoIoHcovHnJHGqKCFfezesh",277,0.996403,24,278,1,277,1,1,0,1,1,132,131,146,146,53
"4719",18,"[24]iAoIoHcovHnJHGqKCFfezesh",282,0.996466,24,283,1,282,1,1,0,1,1,128,127,155,155,53
"4720",19,"[24]iAoIoHcovHnJHGqKCFfezesh",280,0.996441,24,281,1,280,1,1,0,1,1,148,147,133,133,53
"4721",20,"[24]iAoIoHcovHnJHGqKCFfezesh",278,0.996416,24,279,1,278,1,1,0,1,1,135,134,144,144,53
"4722",21,"[24]iAoIoHcovHnJHGqKCFfezesh",277,0.996403,24,278,1,277,1,1,0,1,1,156,155,122,122,53
"4723",22,"[24]iAoIoHcovHnJHGqKCFfezesh",284,0.996491,24,285,1,284,1,1,0,1,1,141,140,144,144,53
"4724",23,"[24]iAoIoHcovHnJHGqKCFfezesh",282,0.996466,24,283,1,282,1,1,0,1,1,138,137,145,145,53
"4725",24,"[24]iAoIoHcovHnJHGqKCFfezesh",279,0.996429,24,280,1,279,1,1,0,1,1,150,149,130,130,53
"4726",25,"[24]iAoIoHcovHnJHGqKCFfezesh",283,0.996479,24,284,1,283,1,1,0,1,1,138,137,146,146,53
"4727",26,"[24]iAoIoHcovHnJHGqKCFfezesh",284,0.996491,24,285,1,284,1,1,0,1,1,147,146,138,138,53
"4728",27,"[24]iAoIoHcovHnJHGqKCFfezesh",279,0.996429,24,280,1,279,1,1,0,1,1,131,130,149,149,53
"4729",28,"[24]iAoIoHcovHnJHGqKCFfezesh",281,0.996454,24,282,1,281,1,1,0,1,1,142,141,140,140,53
"4730",29,"[24]iAoIoHcovHnJHGqKCFfezesh",278,0.996416,24,279,1,278,1,1,0,1,1,134,133,145,145,53
"4731",30,"[24]iAoIoHcovHnJHGqKCFfezesh",278,0.996416,24,279,1,278,1,1,0,1,1,148,147,131,131,53
"4732",31,"[24]iAoIoHcovHnJHGqKCFfezesh",286,0.996516,24,287,1,286,1,1,0,1,1,141,140,146,146,53
"4733",32,"[24]iAoIoHcovHnJHGqKCFfezesh",276,0.99639,24,277,1,276,1,1,0,1,1,140,139,137,137,53
"4734",33,"[24]iAoIoHcovHnJHGqKCFfezesh",276,0.99639,24,277,1,276,1,1,0,1,1,131,130,146,146,53
"4735",34,"[24]iAoIoHcovHnJHGqKCFfezesh",277,0.996403,24,278,1,277,1,1,0,1,1,133,132,145,145,53
"4736",35,"[24]iAoIoHcovHnJHGqKCFfezesh",283,0.996479,24,284,1,283,1,1,0,1,1,130,129,154,154,53
"4737",36,"[24]iAoIoHcovHnJHGqKCFfezesh",283,0.996479,24,284,1,283,1,1,0,1,1,159,158,125,125,53
"4738",37,"[24]iAoIoHcovHnJHGqKCFfezesh",281,0.996454,24,282,1,281,1,1,0,1,1,146,145,136,136,53
"4739",38,"[24]iAoIoHcovHnJHGqKCFfezesh",287,0.996528,24,288,1,287,1,1,0,1,1,142,141,146,146,53
"4740",39,"[24]iAoIoHcovHnJHGqKCFfezesh",284,0.996491,24,285,1,284,1,1,0,1,1,150,149,135,135,53
"4741",40,"[24]iAoIoHcovHnJHGqKCFfezesh",281,0.996454,24,282,1,281,1,1,0,1,1,139,138,143,143,53
"4742",41,"[24]iAoIoHcovHnJHGqKCFfezesh",273,0.99635,24,274,1,273,1,1,0,1,1,126,125,148,148,53
"4743",42,"[24]iAoIoHcovHnJHGqKCFfezesh",276,0.99639,24,277,1,276,1,1,0,1,1,130,129,147,147,53
"4744",43,"[24]iAoIoHcovHnJHGqKCFfezesh",286,0.996516,24,287,1,286,1,1,0,1,1,140,139,147,147,53
"4745",44,"[24]iAoIoHcovHnJHGqKCFfezesh",282,0.996466,24,283,1,282,1,1,0,1,1,145,144,138,138,53
"4746",45,"[24]iAoIoHcovHnJHGqKCFfezesh",277,0.996403,24,278,1,277,1,1,0,1,1,132,131,146,146,53
"4747",46,"[24]iAoIoHcovHnJHGqKCFfezesh",277,0.996403,24,278,1,277,1,1,0,1,1,138,137,140,140,53
"4748",47,"[24]iAoIoHcovHnJHGqKCFfezesh",280,0.996441,24,281,1,280,1,1,0,1,1,135,134,146,146,53
"4749",48,"[24]iAoIoHcovHnJHGqKCFfezesh",283,0.996479,24,284,1,283,1,1,0,1,1,148,147,136,136,53
"4750",49,"[24]iAoIoHcovHnJHGqKCFfezesh",285,0.996503,24,286,1,285,1,1,0,1,1,147,146,139,139,53
"4751",50,"[24]iAoIoHcovHnJHGqKCFfezesh",280,0.996441,24,281,1,280,1,1,0,1,1,150,149,131,131,53
"4752",51,"[24]iAoIoHcovHnJHGqKCFfezesh",289,0.996552,24,290,1,289,1,1,0,1,1,154,153,136,136,53
"4753",52,"[24]iAoIoHcovHnJHGqKCFfezesh",282,0.996466,24,283,1,282,1,1,0,1,1,156,155,127,127,53
"4754",53,"[24]iAoIoHcovHnJHGqKCFfezesh",282,0.996466,24,283,1,282,1,1,0,1,1,156,155,127,127,53
"4755",54,"[24]iAoIoHcovHnJHGqKCFfezesh",277,0.996403,24,278,1,277,1,1,0,1,1,147,146,131,131,53
"4756",55,"[24]iAoIoHcovHnJHGqKCFfezesh",281,0.996454,24,282,1,281,1,1,0,1,1,145,144,137,137,53
"4757",56,"[24]iAoIoHcovHnJHGqKCFfezesh",289,0.996552,24,290,1,289,1,1,0,1,1,155,154,135,135,53
"4758",57,"[24]iAoIoHcovHnJHGqKCFfezesh",281,0.996454,24,282,1,281,1,1,0,1,1,137,136,145,145,53
"4759",58,"[24]iAoIoHcovHnJHGqKCFfezesh",282,0.996466,24,283,1,282,1,1,0,1,1,147,146,136,136,53
"4760",59,"[24]iAoIoHcovHnJHGqKCFfezesh",289,0.996552,24,290,1,289,1,1,0,1,1,142,141,148,148,53
"4761",60,"[24]iAoIoHcovHnJHGqKCFfezesh",287,0.996528,24,288,1,287,1,1,0,1,1,157,156,131,131,53
"4762",61,"[24]iAoIoHcovHnJHGqKCFfezesh",282,0.996466,24,283,1,282,1,1,0,1,1,127,126,156,156,53
"4763",62,"[24]iAoIoHcovHnJHGqKCFfezesh",279,0.996429,24,280,1,279,1,1,0,1,1,136,135,144,144,53
"4764",63,"[24]iAoIoHcovHnJHGqKCFfezesh",286,0.996516,24,287,1,286,1,1,0,1,1,153,152,134,134,53
"4765",64,"[24]iAoIoHcovHnJHGqKCFfezesh",274,0.996364,24,275,1,274,1,1,0,1,1,132,131,143,143,53
"4766",65,"[24]iAoIoHcovHnJHGqKCFfezesh",283,0.996479,24,284,1,283,1,1,0,1,1,148,147,136,136,53
"4767",66,"[24]iAoIoHcovHnJHGqKCFfezesh",282,0.996466,24,283,1,282,1,1,0,1,1,132,131,151,151,53
"4768",67,"[24]iAoIoHcovHnJHGqKCFfezesh",285,0.996503,24,286,1,285,1,1,0,1,1,155,154,131,131,53
"4769",68,"[24]iAoIoHcovHnJHGqKCFfezesh",289,0.996552,24,290,1,289,1,1,0,1,1,151,150,139,139,53
"4770",69,"[24]iAoIoHcovHnJHGqKCFfezesh",286,0.996516,24,287,1,286,1,1,0,1,1,151,150,136,136,53
"4771",70,"[24]iAoIoHcovHnJHGqKCFfezesh",290,0.996564,24,291,1,290,1,1,0,1,1,149,148,142,142,53
"4772",71,"[24]iAoIoHcovHnJHGqKCFfezesh",277,0.996403,24,278,1,277,1,1,0,1,1,143,142,135,135,53
"4773",72,"[24]iAoIoHcovHnJHGqKCFfezesh",281,0.996454,24,282,1,281,1,1,0,1,1,150,149,132,132,53
"4774",73,"[24]iAoIoHcovHnJHGqKCFfezesh",290,0.996564,24,291,1,290,1,1,0,1,1,138,137,153,153,53
"4775",74,"[24]iAoIoHcovHnJHGqKCFfezesh",281,0.996454,24,282,1,281,1,1,0,1,1,144,143,138,138,53
"4776",75,"[24]iAoIoHcovHnJHGqKCFfezesh",282,0.996466,24,283,1,282,1,1,0,1,1,133,132,150,150,53
"4777",76,"[24]iAoIoHcovHnJHGqKCFfezesh",275,0.996377,24,276,1,275,1,1,0,1,1,134,133,142,142,53
"4778",77,"[24]iAoIoHcovHnJHGqKCFfezesh",270,0.99631,24,271,1,270,1,1,0,1,1,126,125,145,145,53
"4779",78,"[24]iAoIoHcovHnJHGqKCFfezesh",279,0.996429,24,280,1,279,1,1,0,1,1,145,144,135,135,53
"4780",79,"[24]iAoIoHcovHnJHGqKCFfezesh",282,0.996466,24,283,1,282,1,1,0,1,1,150,149,133,133,53
"4781",80,"[24]iAoIoHcovHnJHGqKCFfezesh",289,0.996552,24,290,1,289,1,1,0,1,1,149,148,141,141,53
"4782",81,"[24]iAoIoHcovHnJHGqKCFfezesh",275,0.996377,24,276,1,275,1,1,0,1,1,152,151,124,124,53
"4783",82,"[24]iAoIoHcovHnJHGqKCFfezesh",290,0.996564,24,291,1,290,1,1,0,1,1,149,148,142,142,53
"4784",83,"[24]iAoIoHcovHnJHGqKCFfezesh",281,0.996454,24,282,1,281,1,1,0,1,1,161,160,121,121,53
"4785",84,"[24]iAoIoHcovHnJHGqKCFfezesh",284,0.996491,24,285,1,284,1,1,0,1,1,138,137,147,147,53
"4786",85,"[24]iAoIoHcovHnJHGqKCFfezesh",278,0.996416,24,279,1,278,1,1,0,1,1,137,136,142,142,53
"4787",86,"[24]iAoIoHcovHnJHGqKCFfezesh",279,0.996429,24,280,1,279,1,1,0,1,1,131,130,149,149,53
"4788",87,"[24]iAoIoHcovHnJHGqKCFfezesh",281,0.996454,24,282,1,281,1,1,0,1,1,154,153,128,128,53
"4789",88,"[24]iAoIoHcovHnJHGqKCFfezesh",286,0.996516,24,287,1,286,1,1,0,1,1,136,135,151,151,53
"4790",89,"[24]iAoIoHcovHnJHGqKCFfezesh",284,0.996491,24,285,1,284,1,1,0,1,1,140,139,145,145,53
"4791",90,"[24]iAoIoHcovHnJHGqKCFfezesh",276,0.99639,24,277,1,276,1,1,0,1,1,136,135,141,141,53
"4792",91,"[24]iAoIoHcovHnJHGqKCFfezesh",277,0.996403,24,278,1,277,1,1,0,1,1,144,143,134,134,53
"4793",92,"[24]iAoIoHcovHnJHGqKCFfezesh",283,0.996479,24,284,1,283,1,1,0,1,1,125,124,159,159,53
"4794",93,"[24]iAoIoHcovHnJHGqKCFfezesh",279,0.996429,24,280,1,279,1,1,0,1,1,133,132,147,147,53
"4795",94,"[24]iAoIoHcovHnJHGqKCFfezesh",276,0.99639,24,277,1,276,1,1,0,1,1,134,133,143,143,53
"4796",95,"[24]iAoIoHcovHnJHGqKCFfezesh",288,0.99654,24,289,1,288,1,1,0,1,1,149,148,140,140,53
"4797",96,"[24]iAoIoHcovHnJHGqKCFfezesh",275,0.996377,24,276,1,275,1,1,0,1,1,146,145,130,130,53
"4798",97,"[24]iAoIoHcovHnJHGqKCFfezesh",274,0.996364,24,275,1,274,1,1,0,1,1,121,120,154,154,53
"4799",98,"[24]iAoIoHcovHnJHGqKCFfezesh",283,0.996479,24,284,1,283,1,1,0,1,1,156,155,128,128,53
"4800",99,"[24]iAoIoHcovHnJHGqKCFfezesh",286,0.996516,24,287,1,286,1,1,0,1,1,161,160,126,126,53
"4801",0,"[30]GyHoIroHcotHnJHGqKCoFGBaloxxGo",285,0.996503,30,286,1,285,1,1,0,1,1,146,145,140,140,54
"4802",1,"[30]GyHoIroHcotHnJHGqKCoFGBaloxxGo",286,0.996516,30,287,1,286,1,1,0,1,1,143,142,144,144,54
"4803",2,"[30]GyHoIroHcotHnJHGqKCoFGBaloxxGo",284,0.996491,30,285,1,284,1,1,0,1,1,139,138,146,146,54
"4804",3,"[30]GyHoIroHcotHnJHGqKCoFGBaloxxGo",278,0.996416,30,279,1,278,1,1,0,1,1,139,138,140,140,54
"4805",4,"[30]GyHoIroHcotHnJHGqKCoFGBaloxxGo",276,0.99639,30,277,1,276,1,1,0,1,1,134,133,143,143,54
"4806",5,"[30]GyHoIroHcotHnJHGqKCoFGBaloxxGo",280,0.996441,30,281,1,280,1,1,0,1,1,143,142,138,138,54
"4807",6,"[30]GyHoIroHcotHnJHGqKCoFGBaloxxGo",272,0.996337,30,273,1,272,1,1,0,1,1,128,127,145,145,54
"4808",7,"[30]GyHoIroHcotHnJHGqKCoFGBaloxxGo",275,0.996377,30,276,1,275,1,1,0,1,1,142,141,134,134,54
"4809",8,"[30]GyHoIroHcotHnJHGqKCoFGBaloxxGo",284,0.996491,30,285,1,284,1,1,0,1,1,148,147,137,137,54
"4810",9,"[30]GyHoIroHcotHnJHGqKCoFGBaloxxGo",273,0.99635,30,274,1,273,1,1,0,1,1,141,140,133,133,54
"4811",10,"[30]GyHoIroHcotHnJHGqKCoFGBaloxxGo",274,0.996364,30,275,1,274,1,1,0,1,1,131,130,144,144,54
"4812",11,"[30]GyHoIroHcotHnJHGqKCoFGBaloxxGo",288,0.99654,30,289,1,288,1,1,0,1,1,149,148,140,140,54
"4813",12,"[30]GyHoIroHcotHnJHGqKCoFGBaloxxGo",282,0.996466,30,283,1,282,1,1,0,1,1,137,136,146,146,54
"4814",13,"[30]GyHoIroHcotHnJHGqKCoFGBaloxxGo",275,0.996377,30,276,1,275,1,1,0,1,1,134,133,142,142,54
"4815",14,"[30]GyHoIroHcotHnJHGqKCoFGBaloxxGo",282,0.996466,30,283,1,282,1,1,0,1,1,129,128,154,154,54
"4816",15,"[30]GyHoIroHcotHnJHGqKCoFGBaloxxGo",283,0.996479,30,284,1,283,1,1,0,1,1,140,139,144,144,54
"4817",16,"[30]GyHoIroHcotHnJHGqKCoFGBaloxxGo",283,0.996479,30,284,1,283,1,1,0,1,1,138,137,146,146,54
"4818",17,"[30]GyHoIroHcotHnJHGqKCoFGBaloxxGo",283,0.996479,30,284,1,283,1,1,0,1,1,143,142,141,141,54
"4819",18,"[30]GyHoIroHcotHnJHGqKCoFGBaloxxGo",278,0.996416,30,279,1,278,1,1,0,1,1,161,160,118,118,54
"4820",19,"[30]GyHoIroHcotHnJHGqKCoFGBaloxxGo",288,0.99654,30,289,1,288,1,1,0,1,1,159,158,130,130,54
"4821",20,"[30]GyHoIroHcotHnJHGqKCoFGBaloxxGo",278,0.996416,30,279,1,278,1,1,0,1,1,128,127,151,151,54
"4822",21,"[30]GyHoIroHcotHnJHGqKCoFGBaloxxGo",288,0.99654,30,289,1,288,1,1,0,1,1,159,158,130,130,54
"4823",22,"[30]GyHoIroHcotHnJHGqKCoFGBaloxxGo",287,0.996528,30,288,1,287,1,1,0,1,1,151,150,137,137,54
"4824",23,"[30]GyHoIroHcotHnJHGqKCoFGBaloxxGo",286,0.996516,30,287,1,286,1,1,0,1,1,141,140,146,146,54
"4825",24,"[30]GyHoIroHcotHnJHGqKCoFGBaloxxGo",280,0.996441,30,281,1,280,1,1,0,1,1,153,152,128,128,54
"4826",25,"[30]GyHoIroHcotHnJHGqKCoFGBaloxxGo",277,0.996403,30,278,1,277,1,1,0,1,1,121,120,157,157,54
"4827",26,"[30]GyHoIroHcotHnJHGqKCoFGBaloxxGo",282,0.996466,30,283,1,282,1,1,0,1,1,142,141,141,141,54
"4828",27,"[30]GyHoIroHcotHnJHGqKCoFGBaloxxGo",284,0.996491,30,285,1,284,1,1,0,1,1,137,136,148,148,54
"4829",28,"[30]GyHoIroHcotHnJHGqKCoFGBaloxxGo",284,0.996491,30,285,1,284,1,1,0,1,1,138,137,147,147,54
"4830",29,"[30]GyHoIroHcotHnJHGqKCoFGBaloxxGo",276,0.99639,30,277,1,276,1,1,0,1,1,151,150,126,126,54
"4831",30,"[30]GyHoIroHcotHnJHGqKCoFGBaloxxGo",287,0.996528,30,288,1,287,1,1,0,1,1,149,148,139,139,54
"4832",31,"[30]GyHoIroHcotHnJHGqKCoFGBaloxxGo",272,0.996337,30,273,1,272,1,1,0,1,1,127,126,146,146,54
"4833",32,"[30]GyHoIroHcotHnJHGqKCoFGBaloxxGo",273,0.99635,30,274,1,273,1,1,0,1,1,134,133,140,140,54
"4834",33,"[30]GyHoIroHcotHnJHGqKCoFGBaloxxGo",280,0.996441,30,281,1,280,1,1,0,1,1,135,134,146,146,54
"4835",34,"[30]GyHoIroHcotHnJHGqKCoFGBaloxxGo",278,0.996416,30,279,1,278,1,1,0,1,1,140,139,139,139,54
"4836",35,"[30]GyHoIroHcotHnJHGqKCoFGBaloxxGo",281,0.996454,30,282,1,281,1,1,0,1,1,145,144,137,137,54
"4837",36,"[30]GyHoIroHcotHnJHGqKCoFGBaloxxGo",284,0.996491,30,285,1,284,1,1,0,1,1,151,150,134,134,54
"4838",37,"[30]GyHoIroHcotHnJHGqKCoFGBaloxxGo",276,0.99639,30,277,1,276,1,1,0,1,1,133,132,144,144,54
"4839",38,"[30]GyHoIroHcotHnJHGqKCoFGBaloxxGo",283,0.996479,30,284,1,283,1,1,0,1,1,142,141,142,142,54
"4840",39,"[30]GyHoIroHcotHnJHGqKCoFGBaloxxGo",286,0.996516,30,287,1,286,1,1,0,1,1,134,133,153,153,54
"4841",40,"[30]GyHoIroHcotHnJHGqKCoFGBaloxxGo",275,0.996377,30,276,1,275,1,1,0,1,1,131,130,145,145,54
"4842",41,"[30]GyHoIroHcotHnJHGqKCoFGBaloxxGo",278,0.996416,30,279,1,278,1,1,0,1,1,139,138,140,140,54
"4843",42,"[30]GyHoIroHcotHnJHGqKCoFGBaloxxGo",283,0.996479,30,284,1,283,1,1,0,1,1,155,154,129,129,54
"4844",43,"[30]GyHoIroHcotHnJHGqKCoFGBaloxxGo",279,0.996429,30,280,1,279,1,1,0,1,1,143,142,137,137,54
"4845",44,"[30]GyHoIroHcotHnJHGqKCoFGBaloxxGo",278,0.996416,30,279,1,278,1,1,0,1,1,153,152,126,126,54
"4846",45,"[30]GyHoIroHcotHnJHGqKCoFGBaloxxGo",279,0.996429,30,280,1,279,1,1,0,1,1,146,145,134,134,54
"4847",46,"[30]GyHoIroHcotHnJHGqKCoFGBaloxxGo",274,0.996364,30,275,1,274,1,1,0,1,1,136,135,139,139,54
"4848",47,"[30]GyHoIroHcotHnJHGqKCoFGBaloxxGo",279,0.996429,30,280,1,279,1,1,0,1,1,131,130,149,149,54
"4849",48,"[30]GyHoIroHcotHnJHGqKCoFGBaloxxGo",277,0.996403,30,278,1,277,1,1,0,1,1,133,132,145,145,54
"4850",49,"[30]GyHoIroHcotHnJHGqKCoFGBaloxxGo",284,0.996491,30,285,1,284,1,1,0,1,1,162,161,123,123,54
"4851",50,"[30]GyHoIroHcotHnJHGqKCoFGBaloxxGo",275,0.996377,30,276,1,275,1,1,0,1,1,129,128,147,147,54
"4852",51,"[30]GyHoIroHcotHnJHGqKCoFGBaloxxGo",290,0.996564,30,291,1,290,1,1,0,1,1,156,155,135,135,54
"4853",52,"[30]GyHoIroHcotHnJHGqKCoFGBaloxxGo",279,0.996429,30,280,1,279,1,1,0,1,1,140,139,140,140,54
"4854",53,"[30]GyHoIroHcotHnJHGqKCoFGBaloxxGo",274,0.996364,30,275,1,274,1,1,0,1,1,132,131,143,143,54
"4855",54,"[30]GyHoIroHcotHnJHGqKCoFGBaloxxGo",277,0.996403,30,278,1,277,1,1,0,1,1,142,141,136,136,54
"4856",55,"[30]GyHoIroHcotHnJHGqKCoFGBaloxxGo",278,0.996416,30,279,1,278,1,1,0,1,1,137,136,142,142,54
"4857",56,"[30]GyHoIroHcotHnJHGqKCoFGBaloxxGo",285,0.996503,30,286,1,285,1,1,0,1,1,149,148,137,137,54
"4858",57,"[30]GyHoIroHcotHnJHGqKCoFGBaloxxGo",284,0.996491,30,285,1,284,1,1,0,1,1,150,149,135,135,54
"4859",58,"[30]GyHoIroHcotHnJHGqKCoFGBaloxxGo",278,0.996416,30,279,1,278,1,1,0,1,1,132,131,147,147,54
"4860",59,"[30]GyHoIroHcotHnJHGqKCoFGBaloxxGo",282,0.996466,30,283,1,282,1,1,0,1,1,145,144,138,138,54
"4861",60,"[30]GyHoIroHcotHnJHGqKCoFGBaloxxGo",282,0.996466,30,283,1,282,1,1,0,1,1,144,143,139,139,54
"4862",61,"[30]GyHoIroHcotHnJHGqKCoFGBaloxxGo",286,0.996516,30,287,1,286,1,1,0,1,1,162,161,125,125,54
"4863",62,"[30]GyHoIroHcotHnJHGqKCoFGBaloxxGo",271,0.996324,30,272,1,271,1,1,0,1,1,123,122,149,149,54
"4864",63,"[30]GyHoIroHcotHnJHGqKCoFGBaloxxGo",285,0.996503,30,286,1,285,1,1,0,1,1,152,151,134,134,54
"4865",64,"[30]GyHoIroHcotHnJHGqKCoFGBaloxxGo",282,0.996466,30,283,1,282,1,1,0,1,1,145,144,138,138,54
"4866",65,"[30]GyHoIroHcotHnJHGqKCoFGBaloxxGo",279,0.996429,30,280,1,279,1,1,0,1,1,132,131,148,148,54
"4867",66,"[30]GyHoIroHcotHnJHGqKCoFGBaloxxGo",280,0.996441,30,281,1,280,1,1,0,1,1,144,143,137,137,54
"4868",67,"[30]GyHoIroHcotHnJHGqKCoFGBaloxxGo",276,0.99639,30,277,1,276,1,1,0,1,1,148,147,129,129,54
"4869",68,"[30]GyHoIroHcotHnJHGqKCoFGBaloxxGo",275,0.996377,30,276,1,275,1,1,0,1,1,132,131,144,144,54
"4870",69,"[30]GyHoIroHcotHnJHGqKCoFGBaloxxGo",289,0.996552,30,290,1,289,1,1,0,1,1,150,149,140,140,54
"4871",70,"[30]GyHoIroHcotHnJHGqKCoFGBaloxxGo",284,0.996491,30,285,1,284,1,1,0,1,1,148,147,137,137,54
"4872",71,"[30]GyHoIroHcotHnJHGqKCoFGBaloxxGo",280,0.996441,30,281,1,280,1,1,0,1,1,157,156,124,124,54
"4873",72,"[30]GyHoIroHcotHnJHGqKCoFGBaloxxGo",282,0.996466,30,283,1,282,1,1,0,1,1,132,131,151,151,54
"4874",73,"[30]GyHoIroHcotHnJHGqKCoFGBaloxxGo",273,0.99635,30,274,1,273,1,1,0,1,1,121,120,153,153,54
"4875",74,"[30]GyHoIroHcotHnJHGqKCoFGBaloxxGo",275,0.996377,30,276,1,275,1,1,0,1,1,143,142,133,133,54
"4876",75,"[30]GyHoIroHcotHnJHGqKCoFGBaloxxGo",283,0.996479,30,284,1,283,1,1,0,1,1,144,143,140,140,54
"4877",76,"[30]GyHoIroHcotHnJHGqKCoFGBaloxxGo",287,0.996528,30,288,1,287,1,1,0,1,1,141,140,147,147,54
"4878",77,"[30]GyHoIroHcotHnJHGqKCoFGBaloxxGo",284,0.996491,30,285,1,284,1,1,0,1,1,144,143,141,141,54
"4879",78,"[30]GyHoIroHcotHnJHGqKCoFGBaloxxGo",282,0.996466,30,283,1,282,1,1,0,1,1,153,152,130,130,54
"4880",79,"[30]GyHoIroHcotHnJHGqKCoFGBaloxxGo",277,0.996403,30,278,1,277,1,1,0,1,1,127,126,151,151,54
"4881",80,"[30]GyHoIroHcotHnJHGqKCoFGBaloxxGo",276,0.99639,30,277,1,276,1,1,0,1,1,132,131,145,145,54
"4882",81,"[30]GyHoIroHcotHnJHGqKCoFGBaloxxGo",290,0.996564,30,291,1,290,1,1,0,1,1,156,155,135,135,54
"4883",82,"[30]GyHoIroHcotHnJHGqKCoFGBaloxxGo",281,0.996454,30,282,1,281,1,1,0,1,1,137,136,145,145,54
"4884",83,"[30]GyHoIroHcotHnJHGqKCoFGBaloxxGo",279,0.996429,30,280,1,279,1,1,0,1,1,141,140,139,139,54
"4885",84,"[30]GyHoIroHcotHnJHGqKCoFGBaloxxGo",280,0.996441,30,281,1,280,1,1,0,1,1,133,132,148,148,54
"4886",85,"[30]GyHoIroHcotHnJHGqKCoFGBaloxxGo",283,0.996479,30,284,1,283,1,1,0,1,1,153,152,131,131,54
"4887",86,"[30]GyHoIroHcotHnJHGqKCoFGBaloxxGo",277,0.996403,30,278,1,277,1,1,0,1,1,136,135,142,142,54
"4888",87,"[30]GyHoIroHcotHnJHGqKCoFGBaloxxGo",289,0.996552,30,290,1,289,1,1,0,1,1,146,145,144,144,54
"4889",88,"[30]GyHoIroHcotHnJHGqKCoFGBaloxxGo",283,0.996479,30,284,1,283,1,1,0,1,1,135,134,149,149,54
"4890",89,"[30]GyHoIroHcotHnJHGqKCoFGBaloxxGo",283,0.996479,30,284,1,283,1,1,0,1,1,136,135,148,148,54
"4891",90,"[30]GyHoIroHcotHnJHGqKCoFGBaloxxGo",275,0.996377,30,276,1,275,1,1,0,1,1,152,151,124,124,54
"4892",91,"[30]GyHoIroHcotHnJHGqKCoFGBaloxxGo",283,0.996479,30,284,1,283,1,1,0,1,1,130,129,154,154,54
"4893",92,"[30]GyHoIroHcotHnJHGqKCoFGBaloxxGo",276,0.99639,30,277,1,276,1,1,0,1,1,143,142,134,134,54
"4894",93,"[30]GyHoIroHcotHnJHGqKCoFGBaloxxGo",280,0.996441,30,281,1,280,1,1,0,1,1,129,128,152,152,54
"4895",94,"[30]GyHoIroHcotHnJHGqKCoFGBaloxxGo",282,0.996466,30,283,1,282,1,1,0,1,1,142,141,141,141,54
"4896",95,"[30]GyHoIroHcotHnJHGqKCoFGBaloxxGo",280,0.996441,30,281,1,280,1,1,0,1,1,143,142,138,138,54
"4897",96,"[30]GyHoIroHcotHnJHGqKCoFGBaloxxGo",284,0.996491,30,285,1,284,1,1,0,1,1,136,135,149,149,54
"4898",97,"[30]GyHoIroHcotHnJHGqKCoFGBaloxxGo",283,0.996479,30,284,1,283,1,1,0,1,1,138,137,146,146,54
"4899",98,"[30]GyHoIroHcotHnJHGqKCoFGBaloxxGo",286,0.996516,30,287,1,286,1,1,0,1,1,144,143,143,143,54
"4900",99,"[30]GyHoIroHcotHnJHGqKCoFGBaloxxGo",270,0.99631,30,271,1,270,1,1,0,1,1,128,127,143,143,54
"4901",0,"[24]qewHoIoHcotHnJHGqKCrIaIj",280,0.996441,24,281,1,280,1,1,0,1,1,141,140,140,140,55
"4902",1,"[24]qewHoIoHcotHnJHGqKCrIaIj",282,0.996466,24,283,1,282,1,1,0,1,1,141,140,142,142,55
"4903",2,"[24]qewHoIoHcotHnJHGqKCrIaIj",281,0.996454,24,282,1,281,1,1,0,1,1,155,154,127,127,55
"4904",3,"[24]qewHoIoHcotHnJHGqKCrIaIj",285,0.996503,24,286,1,285,1,1,0,1,1,139,138,147,147,55
"4905",4,"[24]qewHoIoHcotHnJHGqKCrIaIj",275,0.996377,24,276,1,275,1,1,0,1,1,128,127,148,148,55
"4906",5,"[24]qewHoIoHcotHnJHGqKCrIaIj",282,0.996466,24,283,1,282,1,1,0,1,1,138,137,145,145,55
"4907",6,"[24]qewHoIoHcotHnJHGqKCrIaIj",282,0.996466,24,283,1,282,1,1,0,1,1,132,131,151,151,55
"4908",7,"[24]qewHoIoHcotHnJHGqKCrIaIj",286,0.996516,24,287,1,286,1,1,0,1,1,149,148,138,138,55
"4909",8,"[24]qewHoIoHcotHnJHGqKCrIaIj",280,0.996441,24,281,1,280,1,1,0,1,1,141,140,140,140,55
"4910",9,"[24]qewHoIoHcotHnJHGqKCrIaIj",273,0.99635,24,274,1,273,1,1,0,1,1,132,131,142,142,55
"4911",10,"[24]qewHoIoHcotHnJHGqKCrIaIj",280,0.996441,24,281,1,280,1,1,0,1,1,148,147,133,133,55
"4912",11,"[24]qewHoIoHcotHnJHGqKCrIaIj",284,0.996491,24,285,1,284,1,1,0,1,1,151,150,134,134,55
"4913",12,"[24]qewHoIoHcotHnJHGqKCrIaIj",286,0.996516,24,287,1,286,1,1,0,1,1,154,153,133,133,55
"4914",13,"[24]qewHoIoHcotHnJHGqKCrIaIj",286,0.996516,24,287,1,286,1,1,0,1,1,146,145,141,141,55
"4915",14,"[24]qewHoIoHcotHnJHGqKCrIaIj",278,0.996416,24,279,1,278,1,1,0,1,1,142,141,137,137,55
"4916",15,"[24]qewHoIoHcotHnJHGqKCrIaIj",283,0.996479,24,284,1,283,1,1,0,1,1,143,142,141,141,55
"4917",16,"[24]qewHoIoHcotHnJHGqKCrIaIj",283,0.996479,24,284,1,283,1,1,0,1,1,147,146,137,137,55
"4918",17,"[24]qewHoIoHcotHnJHGqKCrIaIj",276,0.99639,24,277,1,276,1,1,0,1,1,138,137,139,139,55
"4919",18,"[24]qewHoIoHcotHnJHGqKCrIaIj",287,0.996528,24,288,1,287,1,1,0,1,1,140,139,148,148,55
"4920",19,"[24]qewHoIoHcotHnJHGqKCrIaIj",276,0.99639,24,277,1,276,1,1,0,1,1,128,127,149,149,55
"4921",20,"[24]qewHoIoHcotHnJHGqKCrIaIj",279,0.996429,24,280,1,279,1,1,0,1,1,149,148,131,131,55
"4922",21,"[24]qewHoIoHcotHnJHGqKCrIaIj",281,0.996454,24,282,1,281,1,1,0,1,1,136,135,146,146,55
"4923",22,"[24]qewHoIoHcotHnJHGqKCrIaIj",281,0.996454,24,282,1,281,1,1,0,1,1,134,133,148,148,55
"4924",23,"[24]qewHoIoHcotHnJHGqKCrIaIj",284,0.996491,24,285,1,284,1,1,0,1,1,131,130,154,154,55
"4925",24,"[24]qewHoIoHcotHnJHGqKCrIaIj",282,0.996466,24,283,1,282,1,1,0,1,1,140,139,143,143,55
"4926",25,"[24]qewHoIoHcotHnJHGqKCrIaIj",279,0.996429,24,280,1,279,1,1,0,1,1,140,139,140,140,55
"4927",26,"[24]qewHoIoHcotHnJHGqKCrIaIj",288,0.99654,24,289,1,288,1,1,0,1,1,141,140,148,148,55
"4928",27,"[24]qewHoIoHcotHnJHGqKCrIaIj",286,0.996516,24,287,1,286,1,1,0,1,1,155,154,132,132,55
"4929",28,"[24]qewHoIoHcotHnJHGqKCrIaIj",274,0.996364,24,275,1,274,1,1,0,1,1,146,145,129,129,55
"4930",29,"[24]qewHoIoHcotHnJHGqKCrIaIj",279,0.996429,24,280,1,279,1,1,0,1,1,127,126,153,153,55
"4931",30,"[24]qewHoIoHcotHnJHGqKCrIaIj",290,0.996564,24,291,1,290,1,1,0,1,1,159,158,132,132,55
"4932",31,"[24]qewHoIoHcotHnJHGqKCrIaIj",277,0.996403,24,278,1,277,1,1,0,1,1,125,124,153,153,55
"4933",32,"[24]qewHoIoHcotHnJHGqKCrIaIj",278,0.996416,24,279,1,278,1,1,0,1,1,126,125,153,153,55
"4934",33,"[24]qewHoIoHcotHnJHGqKCrIaIj",291,0.996575,24,292,1,291,1,1,0,1,1,150,149,142,142,55
"4935",34,"[24]qewHoIoHcotHnJHGqKCrIaIj",286,0.996516,24,287,1,286,1,1,0,1,1,139,138,148,148,55
"4936",35,"[24]qewHoIoHcotHnJHGqKCrIaIj",286,0.996516,24,287,1,286,1,1,0,1,1,138,137,149,149,55
"4937",36,"[24]qewHoIoHcotHnJHGqKCrIaIj",285,0.996503,24,286,1,285,1,1,0,1,1,151,150,135,135,55
"4938",37,"[24]qewHoIoHcotHnJHGqKCrIaIj",280,0.996441,24,281,1,280,1,1,0,1,1,133,132,148,148,55
"4939",38,"[24]qewHoIoHcotHnJHGqKCrIaIj",279,0.996429,24,280,1,279,1,1,0,1,1,139,138,141,141,55
"4940",39,"[24]qewHoIoHcotHnJHGqKCrIaIj",286,0.996516,24,287,1,286,1,1,0,1,1,155,154,132,132,55
"4941",40,"[24]qewHoIoHcotHnJHGqKCrIaIj",284,0.996491,24,285,1,284,1,1,0,1,1,148,147,137,137,55
"4942",41,"[24]qewHoIoHcotHnJHGqKCrIaIj",280,0.996441,24,281,1,280,1,1,0,1,1,135,134,146,146,55
"4943",42,"[24]qewHoIoHcotHnJHGqKCrIaIj",284,0.996491,24,285,1,284,1,1,0,1,1,139,138,146,146,55
"4944",43,"[24]qewHoIoHcotHnJHGqKCrIaIj",287,0.996528,24,288,1,287,1,1,0,1,1,153,152,135,135,55
"4945",44,"[24]qewHoIoHcotHnJHGqKCrIaIj",284,0.996491,24,285,1,284,1,1,0,1,1,147,146,138,138,55
"4946",45,"[24]qewHoIoHcotHnJHGqKCrIaIj",282,0.996466,24,283,1,282,1,1,0,1,1,134,133,149,149,55
"4947",46,"[24]qewHoIoHcotHnJHGqKCrIaIj",275,0.996377,24,276,1,275,1,1,0,1,1,136,135,140,140,55
"4948",47,"[24]qewHoIoHcotHnJHGqKCrIaIj",281,0.996454,24,282,1,281,1,1,0,1,1,155,154,127,127,55
"4949",48,"[24]qewHoIoHcotHnJHGqKCrIaIj",273,0.99635,24,274,1,273,1,1,0,1,1,115,114,159,159,55
"4950",49,"[24]qewHoIoHcotHnJHGqKCrIaIj",277,0.996403,24,278,1,277,1,1,0,1,1,141,140,137,137,55
"4951",50,"[24]qewHoIoHcotHnJHGqKCrIaIj",285,0.996503,24,286,1,285,1,1,0,1,1,159,158,127,127,55
"4952",51,"[24]qewHoIoHcotHnJHGqKCrIaIj",278,0.996416,24,279,1,278,1,1,0,1,1,127,126,152,152,55
"4953",52,"[24]qewHoIoHcotHnJHGqKCrIaIj",281,0.996454,24,282,1,281,1,1,0,1,1,136,135,146,146,55
"4954",53,"[24]qewHoIoHcotHnJHGqKCrIaIj",281,0.996454,24,282,1,281,1,1,0,1,1,141,140,141,141,55
"4955",54,"[24]qewHoIoHcotHnJHGqKCrIaIj",277,0.996403,24,278,1,277,1,1,0,1,1,124,123,154,154,55
"4956",55,"[24]qewHoIoHcotHnJHGqKCrIaIj",282,0.996466,24,283,1,282,1,1,0,1,1,134,133,149,149,55
"4957",56,"[24]qewHoIoHcotHnJHGqKCrIaIj",289,0.996552,24,290,1,289,1,1,0,1,1,152,151,138,138,55
"4958",57,"[24]qewHoIoHcotHnJHGqKCrIaIj",276,0.99639,24,277,1,276,1,1,0,1,1,127,126,150,150,55
"4959",58,"[24]qewHoIoHcotHnJHGqKCrIaIj",281,0.996454,24,282,1,281,1,1,0,1,1,143,142,139,139,55
"4960",59,"[24]qewHoIoHcotHnJHGqKCrIaIj",279,0.996429,24,280,1,279,1,1,0,1,1,138,137,142,142,55
"4961",60,"[24]qewHoIoHcotHnJHGqKCrIaIj",279,0.996429,24,280,1,279,1,1,0,1,1,127,126,153,153,55
"4962",61,"[24]qewHoIoHcotHnJHGqKCrIaIj",280,0.996441,24,281,1,280,1,1,0,1,1,137,136,144,144,55
"4963",62,"[24]qewHoIoHcotHnJHGqKCrIaIj",289,0.996552,24,290,1,289,1,1,0,1,1,149,148,141,141,55
"4964",63,"[24]qewHoIoHcotHnJHGqKCrIaIj",272,0.996337,24,273,1,272,1,1,0,1,1,140,139,133,133,55
"4965",64,"[24]qewHoIoHcotHnJHGqKCrIaIj",281,0.996454,24,282,1,281,1,1,0,1,1,129,128,153,153,55
"4966",65,"[24]qewHoIoHcotHnJHGqKCrIaIj",281,0.996454,24,282,1,281,1,1,0,1,1,144,143,138,138,55
"4967",66,"[24]qewHoIoHcotHnJHGqKCrIaIj",275,0.996377,24,276,1,275,1,1,0,1,1,141,140,135,135,55
"4968",67,"[24]qewHoIoHcotHnJHGqKCrIaIj",271,0.996324,24,272,1,271,1,1,0,1,1,129,128,143,143,55
"4969",68,"[24]qewHoIoHcotHnJHGqKCrIaIj",282,0.996466,24,283,1,282,1,1,0,1,1,150,149,133,133,55
"4970",69,"[24]qewHoIoHcotHnJHGqKCrIaIj",286,0.996516,24,287,1,286,1,1,0,1,1,147,146,140,140,55
"4971",70,"[24]qewHoIoHcotHnJHGqKCrIaIj",283,0.996479,24,284,1,283,1,1,0,1,1,141,140,143,143,55
"4972",71,"[24]qewHoIoHcotHnJHGqKCrIaIj",282,0.996466,24,283,1,282,1,1,0,1,1,149,148,134,134,55
"4973",72,"[24]qewHoIoHcotHnJHGqKCrIaIj",277,0.996403,24,278,1,277,1,1,0,1,1,137,136,141,141,55
"4974",73,"[24]qewHoIoHcotHnJHGqKCrIaIj",281,0.996454,24,282,1,281,1,1,0,1,1,148,147,134,134,55
"4975",74,"[24]qewHoIoHcotHnJHGqKCrIaIj",280,0.996441,24,281,1,280,1,1,0,1,1,139,138,142,142,55
"4976",75,"[24]qewHoIoHcotHnJHGqKCrIaIj",271,0.996324,24,272,1,271,1,1,0,1,1,128,127,144,144,55
"4977",76,"[24]qewHoIoHcotHnJHGqKCrIaIj",278,0.996416,24,279,1,278,1,1,0,1,1,131,130,148,148,55
"4978",77,"[24]qewHoIoHcotHnJHGqKCrIaIj",280,0.996441,24,281,1,280,1,1,0,1,1,155,154,126,126,55
"4979",78,"[24]qewHoIoHcotHnJHGqKCrIaIj",284,0.996491,24,285,1,284,1,1,0,1,1,147,146,138,138,55
"4980",79,"[24]qewHoIoHcotHnJHGqKCrIaIj",280,0.996441,24,281,1,280,1,1,0,1,1,152,151,129,129,55
"4981",80,"[24]qewHoIoHcotHnJHGqKCrIaIj",280,0.996441,24,281,1,280,1,1,0,1,1,136,135,145,145,55
"4982",81,"[24]qewHoIoHcotHnJHGqKCrIaIj",283,0.996479,24,284,1,283,1,1,0,1,1,152,151,132,132,55
"4983",82,"[24]qewHoIoHcotHnJHGqKCrIaIj",279,0.996429,24,280,1,279,1,1,0,1,1,135,134,145,145,55
"4984",83,"[24]qewHoIoHcotHnJHGqKCrIaIj",275,0.996377,24,276,1,275,1,1,0,1,1,131,130,145,145,55
"4985",84,"[24]qewHoIoHcotHnJHGqKCrIaIj",284,0.996491,24,285,1,284,1,1,0,1,1,140,139,145,145,55
"4986",85,"[24]qewHoIoHcotHnJHGqKCrIaIj",284,0.996491,24,285,1,284,1,1,0,1,1,142,141,143,143,55
"4987",86,"[24]qewHoIoHcotHnJHGqKCrIaIj",282,0.996466,24,283,1,282,1,1,0,1,1,147,146,136,136,55
"4988",87,"[24]qewHoIoHcotHnJHGqKCrIaIj",277,0.996403,24,278,1,277,1,1,0,1,1,148,147,130,130,55
"4989",88,"[24]qewHoIoHcotHnJHGqKCrIaIj",278,0.996416,24,279,1,278,1,1,0,1,1,138,137,141,141,55
"4990",89,"[24]qewHoIoHcotHnJHGqKCrIaIj",277,0.996403,24,278,1,277,1,1,0,1,1,133,132,145,145,55
"4991",90,"[24]qewHoIoHcotHnJHGqKCrIaIj",283,0.996479,24,284,1,283,1,1,0,1,1,146,145,138,138,55
"4992",91,"[24]qewHoIoHcotHnJHGqKCrIaIj",288,0.99654,24,289,1,288,1,1,0,1,1,142,141,147,147,55
"4993",92,"[24]qewHoIoHcotHnJHGqKCrIaIj",286,0.996516,24,287,1,286,1,1,0,1,1,155,154,132,132,55
"4994",93,"[24]qewHoIoHcotHnJHGqKCrIaIj",282,0.996466,24,283,1,282,1,1,0,1,1,148,147,135,135,55
"4995",94,"[24]qewHoIoHcotHnJHGqKCrIaIj",278,0.996416,24,279,1,278,1,1,0,1,1,132,131,147,147,55
"4996",95,"[24]qewHoIoHcotHnJHGqKCrIaIj",286,0.996516,24,287,1,286,1,1,0,1,1,168,167,119,119,55
"4997",96,"[24]qewHoIoHcotHnJHGqKCrIaIj",282,0.996466,24,283,1,282,1,1,0,1,1,144,143,139,139,55
"4998",97,"[24]qewHoIoHcotHnJHGqKCrIaIj",286,0.996516,24,287,1,286,1,1,0,1,1,153,152,134,134,55
"4999",98,"[24]qewHoIoHcotHnJHGqKCrIaIj",284,0.996491,24,285,1,284,1,1,0,1,1,139,138,146,146,55
"5000",99,"[24]qewHoIoHcotHnJHGqKCrIaIj",277,0.996403,24,278,1,277,1,1,0,1,1,140,139,138,138,55
"5001",0,"[26]koIzoHcotHnJHGqKCqHfwIcGGq",282,0.996466,26,283,1,282,1,1,0,1,1,152,151,131,131,56
"5002",1,"[26]koIzoHcotHnJHGqKCqHfwIcGGq",285,0.996503,26,286,1,285,1,1,0,1,1,152,151,134,134,56
"5003",2,"[26]koIzoHcotHnJHGqKCqHfwIcGGq",283,0.996479,26,284,1,283,1,1,0,1,1,159,158,125,125,56
"5004",3,"[26]koIzoHcotHnJHGqKCqHfwIcGGq",275,0.996377,26,276,1,275,1,1,0,1,1,136,135,140,140,56
"5005",4,"[26]koIzoHcotHnJHGqKCqHfwIcGGq",277,0.996403,26,278,1,277,1,1,0,1,1,145,144,133,133,56
"5006",5,"[26]koIzoHcotHnJHGqKCqHfwIcGGq",285,0.996503,26,286,1,285,1,1,0,1,1,139,138,147,147,56
"5007",6,"[26]koIzoHcotHnJHGqKCqHfwIcGGq",279,0.996429,26,280,1,279,1,1,0,1,1,129,128,151,151,56
"5008",7,"[26]koIzoHcotHnJHGqKCqHfwIcGGq",282,0.996466,26,283,1,282,1,1,0,1,1,145,144,138,138,56
"5009",8,"[26]koIzoHcotHnJHGqKCqHfwIcGGq",284,0.996491,26,285,1,284,1,1,0,1,1,160,159,125,125,56
"5010",9,"[26]koIzoHcotHnJHGqKCqHfwIcGGq",284,0.996491,26,285,1,284,1,1,0,1,1,149,148,136,136,56
"5011",10,"[26]koIzoHcotHnJHGqKCqHfwIcGGq",284,0.996491,26,285,1,284,1,1,0,1,1,152,151,133,133,56
"5012",11,"[26]koIzoHcotHnJHGqKCqHfwIcGGq",294,0.99661,26,295,1,294,1,1,0,1,1,165,164,130,130,56
"5013",12,"[26]koIzoHcotHnJHGqKCqHfwIcGGq",277,0.996403,26,278,1,277,1,1,0,1,1,149,148,129,129,56
"5014",13,"[26]koIzoHcotHnJHGqKCqHfwIcGGq",287,0.996528,26,288,1,287,1,1,0,1,1,142,141,146,146,56
"5015",14,"[26]koIzoHcotHnJHGqKCqHfwIcGGq",270,0.99631,26,271,1,270,1,1,0,1,1,130,129,141,141,56
"5016",15,"[26]koIzoHcotHnJHGqKCqHfwIcGGq",283,0.996479,26,284,1,283,1,1,0,1,1,140,139,144,144,56
"5017",16,"[26]koIzoHcotHnJHGqKCqHfwIcGGq",282,0.996466,26,283,1,282,1,1,0,1,1,143,142,140,140,56
"5018",17,"[26]koIzoHcotHnJHGqKCqHfwIcGGq",281,0.996454,26,282,1,281,1,1,0,1,1,142,141,140,140,56
"5019",18,"[26]koIzoHcotHnJHGqKCqHfwIcGGq",286,0.996516,26,287,1,286,1,1,0,1,1,146,145,141,141,56
"5020",19,"[26]koIzoHcotHnJHGqKCqHfwIcGGq",287,0.996528,26,288,1,287,1,1,0,1,1,152,151,136,136,56
"5021",20,"[26]koIzoHcotHnJHGqKCqHfwIcGGq",287,0.996528,26,288,1,287,1,1,0,1,1,168,167,120,120,56
"5022",21,"[26]koIzoHcotHnJHGqKCqHfwIcGGq",279,0.996429,26,280,1,279,1,1,0,1,1,131,130,149,149,56
"5023",22,"[26]koIzoHcotHnJHGqKCqHfwIcGGq",277,0.996403,26,278,1,277,1,1,0,1,1,138,137,140,140,56
"5024",23,"[26]koIzoHcotHnJHGqKCqHfwIcGGq",288,0.99654,26,289,1,288,1,1,0,1,1,166,165,123,123,56
"5025",24,"[26]koIzoHcotHnJHGqKCqHfwIcGGq",280,0.996441,26,281,1,280,1,1,0,1,1,129,128,152,152,56
"5026",25,"[26]koIzoHcotHnJHGqKCqHfwIcGGq",283,0.996479,26,284,1,283,1,1,0,1,1,153,152,131,131,56
"5027",26,"[26]koIzoHcotHnJHGqKCqHfwIcGGq",277,0.996403,26,278,1,277,1,1,0,1,1,136,135,142,142,56
"5028",27,"[26]koIzoHcotHnJHGqKCqHfwIcGGq",284,0.996491,26,285,1,284,1,1,0,1,1,134,133,151,151,56
"5029",28,"[26]koIzoHcotHnJHGqKCqHfwIcGGq",277,0.996403,26,278,1,277,1,1,0,1,1,136,135,142,142,56
"5030",29,"[26]koIzoHcotHnJHGqKCqHfwIcGGq",285,0.996503,26,286,1,285,1,1,0,1,1,156,155,130,130,56
"5031",30,"[26]koIzoHcotHnJHGqKCqHfwIcGGq",285,0.996503,26,286,1,285,1,1,0,1,1,149,148,137,137,56
"5032",31,"[26]koIzoHcotHnJHGqKCqHfwIcGGq",281,0.996454,26,282,1,281,1,1,0,1,1,132,131,150,150,56
"5033",32,"[26]koIzoHcotHnJHGqKCqHfwIcGGq",283,0.996479,26,284,1,283,1,1,0,1,1,133,132,151,151,56
"5034",33,"[26]koIzoHcotHnJHGqKCqHfwIcGGq",283,0.996479,26,284,1,283,1,1,0,1,1,149,148,135,135,56
"5035",34,"[26]koIzoHcotHnJHGqKCqHfwIcGGq",275,0.996377,26,276,1,275,1,1,0,1,1,130,129,146,146,56
"5036",35,"[26]koIzoHcotHnJHGqKCqHfwIcGGq",275,0.996377,26,276,1,275,1,1,0,1,1,154,153,122,122,56
"5037",36,"[26]koIzoHcotHnJHGqKCqHfwIcGGq",276,0.99639,26,277,1,276,1,1,0,1,1,130,129,147,147,56
"5038",37,"[26]koIzoHcotHnJHGqKCqHfwIcGGq",286,0.996516,26,287,1,286,1,1,0,1,1,146,145,141,141,56
"5039",38,"[26]koIzoHcotHnJHGqKCqHfwIcGGq",286,0.996516,26,287,1,286,1,1,0,1,1,137,136,150,150,56
"5040",39,"[26]koIzoHcotHnJHGqKCqHfwIcGGq",289,0.996552,26,290,1,289,1,1,0,1,1,145,144,145,145,56
"5041",40,"[26]koIzoHcotHnJHGqKCqHfwIcGGq",276,0.99639,26,277,1,276,1,1,0,1,1,131,130,146,146,56
"5042",41,"[26]koIzoHcotHnJHGqKCqHfwIcGGq",284,0.996491,26,285,1,284,1,1,0,1,1,145,144,140,140,56
"5043",42,"[26]koIzoHcotHnJHGqKCqHfwIcGGq",273,0.99635,26,274,1,273,1,1,0,1,1,134,133,140,140,56
"5044",43,"[26]koIzoHcotHnJHGqKCqHfwIcGGq",286,0.996516,26,287,1,286,1,1,0,1,1,148,147,139,139,56
"5045",44,"[26]koIzoHcotHnJHGqKCqHfwIcGGq",279,0.996429,26,280,1,279,1,1,0,1,1,148,147,132,132,56
"5046",45,"[26]koIzoHcotHnJHGqKCqHfwIcGGq",285,0.996503,26,286,1,285,1,1,0,1,1,133,132,153,153,56
"5047",46,"[26]koIzoHcotHnJHGqKCqHfwIcGGq",281,0.996454,26,282,1,281,1,1,0,1,1,145,144,137,137,56
"5048",47,"[26]koIzoHcotHnJHGqKCqHfwIcGGq",284,0.996491,26,285,1,284,1,1,0,1,1,152,151,133,133,56
"5049",48,"[26]koIzoHcotHnJHGqKCqHfwIcGGq",280,0.996441,26,281,1,280,1,1,0,1,1,144,143,137,137,56
"5050",49,"[26]koIzoHcotHnJHGqKCqHfwIcGGq",277,0.996403,26,278,1,277,1,1,0,1,1,128,127,150,150,56
"5051",50,"[26]koIzoHcotHnJHGqKCqHfwIcGGq",286,0.996516,26,287,1,286,1,1,0,1,1,133,132,154,154,56
"5052",51,"[26]koIzoHcotHnJHGqKCqHfwIcGGq",274,0.996364,26,275,1,274,1,1,0,1,1,131,130,144,144,56
"5053",52,"[26]koIzoHcotHnJHGqKCqHfwIcGGq",279,0.996429,26,280,1,279,1,1,0,1,1,136,135,144,144,56
"5054",53,"[26]koIzoHcotHnJHGqKCqHfwIcGGq",288,0.99654,26,289,1,288,1,1,0,1,1,151,150,138,138,56
"5055",54,"[26]koIzoHcotHnJHGqKCqHfwIcGGq",262,0.996198,26,263,1,262,1,1,0,1,1,146,145,117,117,56
"5056",55,"[26]koIzoHcotHnJHGqKCqHfwIcGGq",284,0.996491,26,285,1,284,1,1,0,1,1,148,147,137,137,56
"5057",56,"[26]koIzoHcotHnJHGqKCqHfwIcGGq",277,0.996403,26,278,1,277,1,1,0,1,1,132,131,146,146,56
"5058",57,"[26]koIzoHcotHnJHGqKCqHfwIcGGq",275,0.996377,26,276,1,275,1,1,0,1,1,141,140,135,135,56
"5059",58,"[26]koIzoHcotHnJHGqKCqHfwIcGGq",280,0.996441,26,281,1,280,1,1,0,1,1,153,152,128,128,56
"5060",59,"[26]koIzoHcotHnJHGqKCqHfwIcGGq",280,0.996441,26,281,1,280,1,1,0,1,1,138,137,143,143,56
"5061",60,"[26]koIzoHcotHnJHGqKCqHfwIcGGq",274,0.996364,26,275,1,274,1,1,0,1,1,138,137,137,137,56
"5062",61,"[26]koIzoHcotHnJHGqKCqHfwIcGGq",286,0.996516,26,287,1,286,1,1,0,1,1,132,131,155,155,56
"5063",62,"[26]koIzoHcotHnJHGqKCqHfwIcGGq",279,0.996429,26,280,1,279,1,1,0,1,1,139,138,141,141,56
"5064",63,"[26]koIzoHcotHnJHGqKCqHfwIcGGq",284,0.996491,26,285,1,284,1,1,0,1,1,142,141,143,143,56
"5065",64,"[26]koIzoHcotHnJHGqKCqHfwIcGGq",279,0.996429,26,280,1,279,1,1,0,1,1,150,149,130,130,56
"5066",65,"[26]koIzoHcotHnJHGqKCqHfwIcGGq",279,0.996429,26,280,1,279,1,1,0,1,1,148,147,132,132,56
"5067",66,"[26]koIzoHcotHnJHGqKCqHfwIcGGq",281,0.996454,26,282,1,281,1,1,0,1,1,144,143,138,138,56
"5068",67,"[26]koIzoHcotHnJHGqKCqHfwIcGGq",287,0.996528,26,288,1,287,1,1,0,1,1,151,150,137,137,56
"5069",68,"[26]koIzoHcotHnJHGqKCqHfwIcGGq",282,0.996466,26,283,1,282,1,1,0,1,1,124,123,159,159,56
"5070",69,"[26]koIzoHcotHnJHGqKCqHfwIcGGq",283,0.996479,26,284,1,283,1,1,0,1,1,134,133,150,150,56
"5071",70,"[26]koIzoHcotHnJHGqKCqHfwIcGGq",282,0.996466,26,283,1,282,1,1,0,1,1,152,151,131,131,56
"5072",71,"[26]koIzoHcotHnJHGqKCqHfwIcGGq",284,0.996491,26,285,1,284,1,1,0,1,1,154,153,131,131,56
"5073",72,"[26]koIzoHcotHnJHGqKCqHfwIcGGq",284,0.996491,26,285,1,284,1,1,0,1,1,155,154,130,130,56
"5074",73,"[26]koIzoHcotHnJHGqKCqHfwIcGGq",286,0.996516,26,287,1,286,1,1,0,1,1,138,137,149,149,56
"5075",74,"[26]koIzoHcotHnJHGqKCqHfwIcGGq",274,0.996364,26,275,1,274,1,1,0,1,1,120,119,155,155,56
"5076",75,"[26]koIzoHcotHnJHGqKCqHfwIcGGq",274,0.996364,26,275,1,274,1,1,0,1,1,124,123,151,151,56
"5077",76,"[26]koIzoHcotHnJHGqKCqHfwIcGGq",280,0.996441,26,281,1,280,1,1,0,1,1,144,143,137,137,56
"5078",77,"[26]koIzoHcotHnJHGqKCqHfwIcGGq",282,0.996466,26,283,1,282,1,1,0,1,1,149,148,134,134,56
"5079",78,"[26]koIzoHcotHnJHGqKCqHfwIcGGq",270,0.99631,26,271,1,270,1,1,0,1,1,125,124,146,146,56
"5080",79,"[26]koIzoHcotHnJHGqKCqHfwIcGGq",277,0.996403,26,278,1,277,1,1,0,1,1,147,146,131,131,56
"5081",80,"[26]koIzoHcotHnJHGqKCqHfwIcGGq",272,0.996337,26,273,1,272,1,1,0,1,1,144,143,129,129,56
"5082",81,"[26]koIzoHcotHnJHGqKCqHfwIcGGq",281,0.996454,26,282,1,281,1,1,0,1,1,137,136,145,145,56
"5083",82,"[26]koIzoHcotHnJHGqKCqHfwIcGGq",278,0.996416,26,279,1,278,1,1,0,1,1,147,146,132,132,56
"5084",83,"[26]koIzoHcotHnJHGqKCqHfwIcGGq",271,0.996324,26,272,1,271,1,1,0,1,1,130,129,142,142,56
"5085",84,"[26]koIzoHcotHnJHGqKCqHfwIcGGq",282,0.996466,26,283,1,282,1,1,0,1,1,129,128,154,154,56
"5086",85,"[26]koIzoHcotHnJHGqKCqHfwIcGGq",278,0.996416,26,279,1,278,1,1,0,1,1,140,139,139,139,56
"5087",86,"[26]koIzoHcotHnJHGqKCqHfwIcGGq",277,0.996403,26,278,1,277,1,1,0,1,1,133,132,145,145,56
"5088",87,"[26]koIzoHcotHnJHGqKCqHfwIcGGq",290,0.996564,26,291,1,290,1,1,0,1,1,157,156,134,134,56
"5089",88,"[26]koIzoHcotHnJHGqKCqHfwIcGGq",283,0.996479,26,284,1,283,1,1,0,1,1,130,129,154,154,56
"5090",89,"[26]koIzoHcotHnJHGqKCqHfwIcGGq",288,0.99654,26,289,1,288,1,1,0,1,1,153,152,136,136,56
"5091",90,"[26]koIzoHcotHnJHGqKCqHfwIcGGq",285,0.996503,26,286,1,285,1,1,0,1,1,144,143,142,142,56
"5092",91,"[26]koIzoHcotHnJHGqKCqHfwIcGGq",280,0.996441,26,281,1,280,1,1,0,1,1,138,137,143,143,56
"5093",92,"[26]koIzoHcotHnJHGqKCqHfwIcGGq",278,0.996416,26,279,1,278,1,1,0,1,1,132,131,147,147,56
"5094",93,"[26]koIzoHcotHnJHGqKCqHfwIcGGq",278,0.996416,26,279,1,278,1,1,0,1,1,149,148,130,130,56
"5095",94,"[26]koIzoHcotHnJHGqKCqHfwIcGGq",281,0.996454,26,282,1,281,1,1,0,1,1,131,130,151,151,56
"5096",95,"[26]koIzoHcotHnJHGqKCqHfwIcGGq",288,0.99654,26,289,1,288,1,1,0,1,1,141,140,148,148,56
"5097",96,"[26]koIzoHcotHnJHGqKCqHfwIcGGq",282,0.996466,26,283,1,282,1,1,0,1,1,127,126,156,156,56
"5098",97,"[26]koIzoHcotHnJHGqKCqHfwIcGGq",290,0.996564,26,291,1,290,1,1,0,1,1,143,142,148,148,56
"5099",98,"[26]koIzoHcotHnJHGqKCqHfwIcGGq",282,0.996466,26,283,1,282,1,1,0,1,1,148,147,135,135,56
"5100",99,"[26]koIzoHcotHnJHGqKCqHfwIcGGq",283,0.996479,26,284,1,283,1,1,0,1,1,147,146,137,137,56
"5101",0,"[31]jwHoIoHcoxHnJqGKCrBeEqJHsrrrlys",295,0.996622,31,296,1,295,1,1,0,1,1,145,144,151,151,57
"5102",1,"[31]jwHoIoHcoxHnJqGKCrBeEqJHsrrrlys",293,0.996599,31,294,1,293,1,1,0,1,1,147,146,147,147,57
"5103",2,"[31]jwHoIoHcoxHnJqGKCrBeEqJHsrrrlys",294,0.99661,31,295,1,294,1,1,0,1,1,142,141,153,153,57
"5104",3,"[31]jwHoIoHcoxHnJqGKCrBeEqJHsrrrlys",294,0.99661,31,295,1,294,1,1,0,1,1,156,155,139,139,57
"5105",4,"[31]jwHoIoHcoxHnJqGKCrBeEqJHsrrrlys",303,0.996711,31,304,1,303,1,1,0,1,1,165,164,139,139,57
"5106",5,"[31]jwHoIoHcoxHnJqGKCrBeEqJHsrrrlys",300,0.996678,31,301,1,300,1,1,0,1,1,159,158,142,142,57
"5107",6,"[31]jwHoIoHcoxHnJqGKCrBeEqJHsrrrlys",297,0.996644,31,298,1,297,1,1,0,1,1,149,148,149,149,57
"5108",7,"[31]jwHoIoHcoxHnJqGKCrBeEqJHsrrrlys",295,0.996622,31,296,1,295,1,1,0,1,1,146,145,150,150,57
"5109",8,"[31]jwHoIoHcoxHnJqGKCrBeEqJHsrrrlys",303,0.996711,31,304,1,303,1,1,0,1,1,179,178,125,125,57
"5110",9,"[31]jwHoIoHcoxHnJqGKCrBeEqJHsrrrlys",296,0.996633,31,297,1,296,1,1,0,1,1,150,149,147,147,57
"5111",10,"[31]jwHoIoHcoxHnJqGKCrBeEqJHsrrrlys",292,0.996587,31,293,1,292,1,1,0,1,1,139,138,154,154,57
"5112",11,"[31]jwHoIoHcoxHnJqGKCrBeEqJHsrrrlys",292,0.996587,31,293,1,292,1,1,0,1,1,136,135,157,157,57
"5113",12,"[31]jwHoIoHcoxHnJqGKCrBeEqJHsrrrlys",302,0.9967,31,303,1,302,1,1,0,1,1,168,167,135,135,57
"5114",13,"[31]jwHoIoHcoxHnJqGKCrBeEqJHsrrrlys",296,0.996633,31,297,1,296,1,1,0,1,1,148,147,149,149,57
"5115",14,"[31]jwHoIoHcoxHnJqGKCrBeEqJHsrrrlys",292,0.996587,31,293,1,292,1,1,0,1,1,143,142,150,150,57
"5116",15,"[31]jwHoIoHcoxHnJqGKCrBeEqJHsrrrlys",295,0.996622,31,296,1,295,1,1,0,1,1,145,144,151,151,57
"5117",16,"[31]jwHoIoHcoxHnJqGKCrBeEqJHsrrrlys",298,0.996656,31,299,1,298,1,1,0,1,1,154,153,145,145,57
"5118",17,"[31]jwHoIoHcoxHnJqGKCrBeEqJHsrrrlys",299,0.996667,31,300,1,299,1,1,0,1,1,158,157,142,142,57
"5119",18,"[31]jwHoIoHcoxHnJqGKCrBeEqJHsrrrlys",295,0.996622,31,296,1,295,1,1,0,1,1,146,145,150,150,57
"5120",19,"[31]jwHoIoHcoxHnJqGKCrBeEqJHsrrrlys",296,0.996633,31,297,1,296,1,1,0,1,1,161,160,136,136,57
"5121",20,"[31]jwHoIoHcoxHnJqGKCrBeEqJHsrrrlys",292,0.996587,31,293,1,292,1,1,0,1,1,143,142,150,150,57
"5122",21,"[31]jwHoIoHcoxHnJqGKCrBeEqJHsrrrlys",300,0.996678,31,301,1,300,1,1,0,1,1,161,160,140,140,57
"5123",22,"[31]jwHoIoHcoxHnJqGKCrBeEqJHsrrrlys",293,0.996599,31,294,1,293,1,1,0,1,1,146,145,148,148,57
"5124",23,"[31]jwHoIoHcoxHnJqGKCrBeEqJHsrrrlys",287,0.996528,31,288,1,287,1,1,0,1,1,123,122,165,165,57
"5125",24,"[31]jwHoIoHcoxHnJqGKCrBeEqJHsrrrlys",292,0.996587,31,293,1,292,1,1,0,1,1,145,144,148,148,57
"5126",25,"[31]jwHoIoHcoxHnJqGKCrBeEqJHsrrrlys",294,0.99661,31,295,1,294,1,1,0,1,1,138,137,157,157,57
"5127",26,"[31]jwHoIoHcoxHnJqGKCrBeEqJHsrrrlys",289,0.996552,31,290,1,289,1,1,0,1,1,141,140,149,149,57
"5128",27,"[31]jwHoIoHcoxHnJqGKCrBeEqJHsrrrlys",289,0.996552,31,290,1,289,1,1,0,1,1,132,131,158,158,57
"5129",28,"[31]jwHoIoHcoxHnJqGKCrBeEqJHsrrrlys",295,0.996622,31,296,1,295,1,1,0,1,1,149,148,147,147,57
"5130",29,"[31]jwHoIoHcoxHnJqGKCrBeEqJHsrrrlys",302,0.9967,31,303,1,302,1,1,0,1,1,167,166,136,136,57
"5131",30,"[31]jwHoIoHcoxHnJqGKCrBeEqJHsrrrlys",291,0.996575,31,292,1,291,1,1,0,1,1,139,138,153,153,57
"5132",31,"[31]jwHoIoHcoxHnJqGKCrBeEqJHsrrrlys",290,0.996564,31,291,1,290,1,1,0,1,1,132,131,159,159,57
"5133",32,"[31]jwHoIoHcoxHnJqGKCrBeEqJHsrrrlys",293,0.996599,31,294,1,293,1,1,0,1,1,147,146,147,147,57
"5134",33,"[31]jwHoIoHcoxHnJqGKCrBeEqJHsrrrlys",287,0.996528,31,288,1,287,1,1,0,1,1,122,121,166,166,57
"5135",34,"[31]jwHoIoHcoxHnJqGKCrBeEqJHsrrrlys",296,0.996633,31,297,1,296,1,1,0,1,1,149,148,148,148,57
"5136",35,"[31]jwHoIoHcoxHnJqGKCrBeEqJHsrrrlys",297,0.996644,31,298,1,297,1,1,0,1,1,157,156,141,141,57
"5137",36,"[31]jwHoIoHcoxHnJqGKCrBeEqJHsrrrlys",293,0.996599,31,294,1,293,1,1,0,1,1,141,140,153,153,57
"5138",37,"[31]jwHoIoHcoxHnJqGKCrBeEqJHsrrrlys",297,0.996644,31,298,1,297,1,1,0,1,1,164,163,134,134,57
"5139",38,"[31]jwHoIoHcoxHnJqGKCrBeEqJHsrrrlys",299,0.996667,31,300,1,299,1,1,0,1,1,156,155,144,144,57
"5140",39,"[31]jwHoIoHcoxHnJqGKCrBeEqJHsrrrlys",299,0.996667,31,300,1,299,1,1,0,1,1,151,150,149,149,57
"5141",40,"[31]jwHoIoHcoxHnJqGKCrBeEqJHsrrrlys",291,0.996575,31,292,1,291,1,1,0,1,1,134,133,158,158,57
"5142",41,"[31]jwHoIoHcoxHnJqGKCrBeEqJHsrrrlys",300,0.996678,31,301,1,300,1,1,0,1,1,156,155,145,145,57
"5143",42,"[31]jwHoIoHcoxHnJqGKCrBeEqJHsrrrlys",295,0.996622,31,296,1,295,1,1,0,1,1,151,150,145,145,57
"5144",43,"[31]jwHoIoHcoxHnJqGKCrBeEqJHsrrrlys",295,0.996622,31,296,1,295,1,1,0,1,1,144,143,152,152,57
"5145",44,"[31]jwHoIoHcoxHnJqGKCrBeEqJHsrrrlys",290,0.996564,31,291,1,290,1,1,0,1,1,131,130,160,160,57
"5146",45,"[31]jwHoIoHcoxHnJqGKCrBeEqJHsrrrlys",299,0.996667,31,300,1,299,1,1,0,1,1,157,156,143,143,57
"5147",46,"[31]jwHoIoHcoxHnJqGKCrBeEqJHsrrrlys",293,0.996599,31,294,1,293,1,1,0,1,1,142,141,152,152,57
"5148",47,"[31]jwHoIoHcoxHnJqGKCrBeEqJHsrrrlys",296,0.996633,31,297,1,296,1,1,0,1,1,154,153,143,143,57
"5149",48,"[31]jwHoIoHcoxHnJqGKCrBeEqJHsrrrlys",298,0.996656,31,299,1,298,1,1,0,1,1,151,150,148,148,57
"5150",49,"[31]jwHoIoHcoxHnJqGKCrBeEqJHsrrrlys",293,0.996599,31,294,1,293,1,1,0,1,1,142,141,152,152,57
"5151",50,"[31]jwHoIoHcoxHnJqGKCrBeEqJHsrrrlys",291,0.996575,31,292,1,291,1,1,0,1,1,134,133,158,158,57
"5152",51,"[31]jwHoIoHcoxHnJqGKCrBeEqJHsrrrlys",301,0.996689,31,302,1,301,1,1,0,1,1,159,158,143,143,57
"5153",52,"[31]jwHoIoHcoxHnJqGKCrBeEqJHsrrrlys",301,0.996689,31,302,1,301,1,1,0,1,1,170,169,132,132,57
"5154",53,"[31]jwHoIoHcoxHnJqGKCrBeEqJHsrrrlys",303,0.996711,31,304,1,303,1,1,0,1,1,168,167,136,136,57
"5155",54,"[31]jwHoIoHcoxHnJqGKCrBeEqJHsrrrlys",295,0.996622,31,296,1,295,1,1,0,1,1,150,149,146,146,57
"5156",55,"[31]jwHoIoHcoxHnJqGKCrBeEqJHsrrrlys",293,0.996599,31,294,1,293,1,1,0,1,1,144,143,150,150,57
"5157",56,"[31]jwHoIoHcoxHnJqGKCrBeEqJHsrrrlys",296,0.996633,31,297,1,296,1,1,0,1,1,148,147,149,149,57
"5158",57,"[31]jwHoIoHcoxHnJqGKCrBeEqJHsrrrlys",296,0.996633,31,297,1,296,1,1,0,1,1,147,146,150,150,57
"5159",58,"[31]jwHoIoHcoxHnJqGKCrBeEqJHsrrrlys",291,0.996575,31,292,1,291,1,1,0,1,1,140,139,152,152,57
"5160",59,"[31]jwHoIoHcoxHnJqGKCrBeEqJHsrrrlys",296,0.996633,31,297,1,296,1,1,0,1,1,149,148,148,148,57
"5161",60,"[31]jwHoIoHcoxHnJqGKCrBeEqJHsrrrlys",301,0.996689,31,302,1,301,1,1,0,1,1,156,155,146,146,57
"5162",61,"[31]jwHoIoHcoxHnJqGKCrBeEqJHsrrrlys",304,0.996721,31,305,1,304,1,1,0,1,1,177,176,128,128,57
"5163",62,"[31]jwHoIoHcoxHnJqGKCrBeEqJHsrrrlys",299,0.996667,31,300,1,299,1,1,0,1,1,160,159,140,140,57
"5164",63,"[31]jwHoIoHcoxHnJqGKCrBeEqJHsrrrlys",307,0.996753,31,308,1,307,1,1,0,1,1,179,178,129,129,57
"5165",64,"[31]jwHoIoHcoxHnJqGKCrBeEqJHsrrrlys",297,0.996644,31,298,1,297,1,1,0,1,1,166,165,132,132,57
"5166",65,"[31]jwHoIoHcoxHnJqGKCrBeEqJHsrrrlys",294,0.99661,31,295,1,294,1,1,0,1,1,137,136,158,158,57
"5167",66,"[31]jwHoIoHcoxHnJqGKCrBeEqJHsrrrlys",293,0.996599,31,294,1,293,1,1,0,1,1,140,139,154,154,57
"5168",67,"[31]jwHoIoHcoxHnJqGKCrBeEqJHsrrrlys",292,0.996587,31,293,1,292,1,1,0,1,1,134,133,159,159,57
"5169",68,"[31]jwHoIoHcoxHnJqGKCrBeEqJHsrrrlys",299,0.996667,31,300,1,299,1,1,0,1,1,155,154,145,145,57
"5170",69,"[31]jwHoIoHcoxHnJqGKCrBeEqJHsrrrlys",289,0.996552,31,290,1,289,1,1,0,1,1,129,128,161,161,57
"5171",70,"[31]jwHoIoHcoxHnJqGKCrBeEqJHsrrrlys",298,0.996656,31,299,1,298,1,1,0,1,1,149,148,150,150,57
"5172",71,"[31]jwHoIoHcoxHnJqGKCrBeEqJHsrrrlys",291,0.996575,31,292,1,291,1,1,0,1,1,131,130,161,161,57
"5173",72,"[31]jwHoIoHcoxHnJqGKCrBeEqJHsrrrlys",297,0.996644,31,298,1,297,1,1,0,1,1,148,147,150,150,57
"5174",73,"[31]jwHoIoHcoxHnJqGKCrBeEqJHsrrrlys",301,0.996689,31,302,1,301,1,1,0,1,1,163,162,139,139,57
"5175",74,"[31]jwHoIoHcoxHnJqGKCrBeEqJHsrrrlys",294,0.99661,31,295,1,294,1,1,0,1,1,151,150,144,144,57
"5176",75,"[31]jwHoIoHcoxHnJqGKCrBeEqJHsrrrlys",299,0.996667,31,300,1,299,1,1,0,1,1,160,159,140,140,57
"5177",76,"[31]jwHoIoHcoxHnJqGKCrBeEqJHsrrrlys",290,0.996564,31,291,1,290,1,1,0,1,1,132,131,159,159,57
"5178",77,"[31]jwHoIoHcoxHnJqGKCrBeEqJHsrrrlys",295,0.996622,31,296,1,295,1,1,0,1,1,158,157,138,138,57
"5179",78,"[31]jwHoIoHcoxHnJqGKCrBeEqJHsrrrlys",292,0.996587,31,293,1,292,1,1,0,1,1,155,154,138,138,57
"5180",79,"[31]jwHoIoHcoxHnJqGKCrBeEqJHsrrrlys",296,0.996633,31,297,1,296,1,1,0,1,1,148,147,149,149,57
"5181",80,"[31]jwHoIoHcoxHnJqGKCrBeEqJHsrrrlys",298,0.996656,31,299,1,298,1,1,0,1,1,154,153,145,145,57
"5182",81,"[31]jwHoIoHcoxHnJqGKCrBeEqJHsrrrlys",293,0.996599,31,294,1,293,1,1,0,1,1,141,140,153,153,57
"5183",82,"[31]jwHoIoHcoxHnJqGKCrBeEqJHsrrrlys",293,0.996599,31,294,1,293,1,1,0,1,1,137,136,157,157,57
"5184",83,"[31]jwHoIoHcoxHnJqGKCrBeEqJHsrrrlys",294,0.99661,31,295,1,294,1,1,0,1,1,150,149,145,145,57
"5185",84,"[31]jwHoIoHcoxHnJqGKCrBeEqJHsrrrlys",300,0.996678,31,301,1,300,1,1,0,1,1,159,158,142,142,57
"5186",85,"[31]jwHoIoHcoxHnJqGKCrBeEqJHsrrrlys",293,0.996599,31,294,1,293,1,1,0,1,1,145,144,149,149,57
"5187",86,"[31]jwHoIoHcoxHnJqGKCrBeEqJHsrrrlys",300,0.996678,31,301,1,300,1,1,0,1,1,161,160,140,140,57
"5188",87,"[31]jwHoIoHcoxHnJqGKCrBeEqJHsrrrlys",293,0.996599,31,294,1,293,1,1,0,1,1,144,143,150,150,57
"5189",88,"[31]jwHoIoHcoxHnJqGKCrBeEqJHsrrrlys",300,0.996678,31,301,1,300,1,1,0,1,1,160,159,141,141,57
"5190",89,"[31]jwHoIoHcoxHnJqGKCrBeEqJHsrrrlys",292,0.996587,31,293,1,292,1,1,0,1,1,149,148,144,144,57
"5191",90,"[31]jwHoIoHcoxHnJqGKCrBeEqJHsrrrlys",297,0.996644,31,298,1,297,1,1,0,1,1,154,153,144,144,57
"5192",91,"[31]jwHoIoHcoxHnJqGKCrBeEqJHsrrrlys",297,0.996644,31,298,1,297,1,1,0,1,1,147,146,151,151,57
"5193",92,"[31]jwHoIoHcoxHnJqGKCrBeEqJHsrrrlys",293,0.996599,31,294,1,293,1,1,0,1,1,147,146,147,147,57
"5194",93,"[31]jwHoIoHcoxHnJqGKCrBeEqJHsrrrlys",300,0.996678,31,301,1,300,1,1,0,1,1,160,159,141,141,57
"5195",94,"[31]jwHoIoHcoxHnJqGKCrBeEqJHsrrrlys",297,0.996644,31,298,1,297,1,1,0,1,1,153,152,145,145,57
"5196",95,"[31]jwHoIoHcoxHnJqGKCrBeEqJHsrrrlys",293,0.996599,31,294,1,293,1,1,0,1,1,141,140,153,153,57
"5197",96,"[31]jwHoIoHcoxHnJqGKCrBeEqJHsrrrlys",301,0.996689,31,302,1,301,1,1,0,1,1,165,164,137,137,57
"5198",97,"[31]jwHoIoHcoxHnJqGKCrBeEqJHsrrrlys",291,0.996575,31,292,1,291,1,1,0,1,1,145,144,147,147,57
"5199",98,"[31]jwHoIoHcoxHnJqGKCrBeEqJHsrrrlys",294,0.99661,31,295,1,294,1,1,0,1,1,143,142,152,152,57
"5200",99,"[31]jwHoIoHcoxHnJqGKCrBeEqJHsrrrlys",296,0.996633,31,297,1,296,1,1,0,1,1,148,147,149,149,57
"5201",0,"[26]aoHoIgoHcoxHnJHGqKCGuqbCeg",285,0.996503,26,286,1,285,1,1,0,1,1,138,137,148,148,58
"5202",1,"[26]aoHoIgoHcoxHnJHGqKCGuqbCeg",273,0.99635,26,274,1,273,1,1,0,1,1,141,140,133,133,58
"5203",2,"[26]aoHoIgoHcoxHnJHGqKCGuqbCeg",284,0.996491,26,285,1,284,1,1,0,1,1,152,151,133,133,58
"5204",3,"[26]aoHoIgoHcoxHnJHGqKCGuqbCeg",279,0.996429,26,280,1,279,1,1,0,1,1,139,138,141,141,58
"5205",4,"[26]aoHoIgoHcoxHnJHGqKCGuqbCeg",279,0.996429,26,280,1,279,1,1,0,1,1,151,150,129,129,58
"5206",5,"[26]aoHoIgoHcoxHnJHGqKCGuqbCeg",285,0.996503,26,286,1,285,1,1,0,1,1,160,159,126,126,58
"5207",6,"[26]aoHoIgoHcoxHnJHGqKCGuqbCeg",285,0.996503,26,286,1,285,1,1,0,1,1,149,148,137,137,58
"5208",7,"[26]aoHoIgoHcoxHnJHGqKCGuqbCeg",269,0.996296,26,270,1,269,1,1,0,1,1,111,110,159,159,58
"5209",8,"[26]aoHoIgoHcoxHnJHGqKCGuqbCeg",282,0.996466,26,283,1,282,1,1,0,1,1,137,136,146,146,58
"5210",9,"[26]aoHoIgoHcoxHnJHGqKCGuqbCeg",283,0.996479,26,284,1,283,1,1,0,1,1,145,144,139,139,58
"5211",10,"[26]aoHoIgoHcoxHnJHGqKCGuqbCeg",274,0.996364,26,275,1,274,1,1,0,1,1,133,132,142,142,58
"5212",11,"[26]aoHoIgoHcoxHnJHGqKCGuqbCeg",276,0.99639,26,277,1,276,1,1,0,1,1,133,132,144,144,58
"5213",12,"[26]aoHoIgoHcoxHnJHGqKCGuqbCeg",282,0.996466,26,283,1,282,1,1,0,1,1,147,146,136,136,58
"5214",13,"[26]aoHoIgoHcoxHnJHGqKCGuqbCeg",285,0.996503,26,286,1,285,1,1,0,1,1,157,156,129,129,58
"5215",14,"[26]aoHoIgoHcoxHnJHGqKCGuqbCeg",282,0.996466,26,283,1,282,1,1,0,1,1,140,139,143,143,58
"5216",15,"[26]aoHoIgoHcoxHnJHGqKCGuqbCeg",284,0.996491,26,285,1,284,1,1,0,1,1,157,156,128,128,58
"5217",16,"[26]aoHoIgoHcoxHnJHGqKCGuqbCeg",288,0.99654,26,289,1,288,1,1,0,1,1,162,161,127,127,58
"5218",17,"[26]aoHoIgoHcoxHnJHGqKCGuqbCeg",276,0.99639,26,277,1,276,1,1,0,1,1,146,145,131,131,58
"5219",18,"[26]aoHoIgoHcoxHnJHGqKCGuqbCeg",274,0.996364,26,275,1,274,1,1,0,1,1,138,137,137,137,58
"5220",19,"[26]aoHoIgoHcoxHnJHGqKCGuqbCeg",277,0.996403,26,278,1,277,1,1,0,1,1,151,150,127,127,58
"5221",20,"[26]aoHoIgoHcoxHnJHGqKCGuqbCeg",277,0.996403,26,278,1,277,1,1,0,1,1,143,142,135,135,58
"5222",21,"[26]aoHoIgoHcoxHnJHGqKCGuqbCeg",282,0.996466,26,283,1,282,1,1,0,1,1,135,134,148,148,58
"5223",22,"[26]aoHoIgoHcoxHnJHGqKCGuqbCeg",275,0.996377,26,276,1,275,1,1,0,1,1,127,126,149,149,58
"5224",23,"[26]aoHoIgoHcoxHnJHGqKCGuqbCeg",280,0.996441,26,281,1,280,1,1,0,1,1,153,152,128,128,58
"5225",24,"[26]aoHoIgoHcoxHnJHGqKCGuqbCeg",280,0.996441,26,281,1,280,1,1,0,1,1,143,142,138,138,58
"5226",25,"[26]aoHoIgoHcoxHnJHGqKCGuqbCeg",271,0.996324,26,272,1,271,1,1,0,1,1,127,126,145,145,58
"5227",26,"[26]aoHoIgoHcoxHnJHGqKCGuqbCeg",277,0.996403,26,278,1,277,1,1,0,1,1,134,133,144,144,58
"5228",27,"[26]aoHoIgoHcoxHnJHGqKCGuqbCeg",274,0.996364,26,275,1,274,1,1,0,1,1,130,129,145,145,58
"5229",28,"[26]aoHoIgoHcoxHnJHGqKCGuqbCeg",281,0.996454,26,282,1,281,1,1,0,1,1,135,134,147,147,58
"5230",29,"[26]aoHoIgoHcoxHnJHGqKCGuqbCeg",281,0.996454,26,282,1,281,1,1,0,1,1,150,149,132,132,58
"5231",30,"[26]aoHoIgoHcoxHnJHGqKCGuqbCeg",285,0.996503,26,286,1,285,1,1,0,1,1,148,147,138,138,58
"5232",31,"[26]aoHoIgoHcoxHnJHGqKCGuqbCeg",270,0.99631,26,271,1,270,1,1,0,1,1,134,133,137,137,58
"5233",32,"[26]aoHoIgoHcoxHnJHGqKCGuqbCeg",285,0.996503,26,286,1,285,1,1,0,1,1,150,149,136,136,58
"5234",33,"[26]aoHoIgoHcoxHnJHGqKCGuqbCeg",282,0.996466,26,283,1,282,1,1,0,1,1,136,135,147,147,58
"5235",34,"[26]aoHoIgoHcoxHnJHGqKCGuqbCeg",277,0.996403,26,278,1,277,1,1,0,1,1,144,143,134,134,58
"5236",35,"[26]aoHoIgoHcoxHnJHGqKCGuqbCeg",279,0.996429,26,280,1,279,1,1,0,1,1,133,132,147,147,58
"5237",36,"[26]aoHoIgoHcoxHnJHGqKCGuqbCeg",275,0.996377,26,276,1,275,1,1,0,1,1,142,141,134,134,58
"5238",37,"[26]aoHoIgoHcoxHnJHGqKCGuqbCeg",275,0.996377,26,276,1,275,1,1,0,1,1,145,144,131,131,58
"5239",38,"[26]aoHoIgoHcoxHnJHGqKCGuqbCeg",283,0.996479,26,284,1,283,1,1,0,1,1,144,143,140,140,58
"5240",39,"[26]aoHoIgoHcoxHnJHGqKCGuqbCeg",288,0.99654,26,289,1,288,1,1,0,1,1,142,141,147,147,58
"5241",40,"[26]aoHoIgoHcoxHnJHGqKCGuqbCeg",275,0.996377,26,276,1,275,1,1,0,1,1,141,140,135,135,58
"5242",41,"[26]aoHoIgoHcoxHnJHGqKCGuqbCeg",281,0.996454,26,282,1,281,1,1,0,1,1,134,133,148,148,58
"5243",42,"[26]aoHoIgoHcoxHnJHGqKCGuqbCeg",279,0.996429,26,280,1,279,1,1,0,1,1,142,141,138,138,58
"5244",43,"[26]aoHoIgoHcoxHnJHGqKCGuqbCeg",285,0.996503,26,286,1,285,1,1,0,1,1,148,147,138,138,58
"5245",44,"[26]aoHoIgoHcoxHnJHGqKCGuqbCeg",288,0.99654,26,289,1,288,1,1,0,1,1,143,142,146,146,58
"5246",45,"[26]aoHoIgoHcoxHnJHGqKCGuqbCeg",285,0.996503,26,286,1,285,1,1,0,1,1,132,131,154,154,58
"5247",46,"[26]aoHoIgoHcoxHnJHGqKCGuqbCeg",276,0.99639,26,277,1,276,1,1,0,1,1,130,129,147,147,58
"5248",47,"[26]aoHoIgoHcoxHnJHGqKCGuqbCeg",275,0.996377,26,276,1,275,1,1,0,1,1,129,128,147,147,58
"5249",48,"[26]aoHoIgoHcoxHnJHGqKCGuqbCeg",281,0.996454,26,282,1,281,1,1,0,1,1,120,119,162,162,58
"5250",49,"[26]aoHoIgoHcoxHnJHGqKCGuqbCeg",284,0.996491,26,285,1,284,1,1,0,1,1,151,150,134,134,58
"5251",50,"[26]aoHoIgoHcoxHnJHGqKCGuqbCeg",286,0.996516,26,287,1,286,1,1,0,1,1,152,151,135,135,58
"5252",51,"[26]aoHoIgoHcoxHnJHGqKCGuqbCeg",274,0.996364,26,275,1,274,1,1,0,1,1,128,127,147,147,58
"5253",52,"[26]aoHoIgoHcoxHnJHGqKCGuqbCeg",285,0.996503,26,286,1,285,1,1,0,1,1,139,138,147,147,58
"5254",53,"[26]aoHoIgoHcoxHnJHGqKCGuqbCeg",287,0.996528,26,288,1,287,1,1,0,1,1,142,141,146,146,58
"5255",54,"[26]aoHoIgoHcoxHnJHGqKCGuqbCeg",280,0.996441,26,281,1,280,1,1,0,1,1,143,142,138,138,58
"5256",55,"[26]aoHoIgoHcoxHnJHGqKCGuqbCeg",277,0.996403,26,278,1,277,1,1,0,1,1,152,151,126,126,58
"5257",56,"[26]aoHoIgoHcoxHnJHGqKCGuqbCeg",274,0.996364,26,275,1,274,1,1,0,1,1,130,129,145,145,58
"5258",57,"[26]aoHoIgoHcoxHnJHGqKCGuqbCeg",286,0.996516,26,287,1,286,1,1,0,1,1,136,135,151,151,58
"5259",58,"[26]aoHoIgoHcoxHnJHGqKCGuqbCeg",280,0.996441,26,281,1,280,1,1,0,1,1,140,139,141,141,58
"5260",59,"[26]aoHoIgoHcoxHnJHGqKCGuqbCeg",288,0.99654,26,289,1,288,1,1,0,1,1,152,151,137,137,58
"5261",60,"[26]aoHoIgoHcoxHnJHGqKCGuqbCeg",281,0.996454,26,282,1,281,1,1,0,1,1,135,134,147,147,58
"5262",61,"[26]aoHoIgoHcoxHnJHGqKCGuqbCeg",278,0.996416,26,279,1,278,1,1,0,1,1,147,146,132,132,58
"5263",62,"[26]aoHoIgoHcoxHnJHGqKCGuqbCeg",279,0.996429,26,280,1,279,1,1,0,1,1,138,137,142,142,58
"5264",63,"[26]aoHoIgoHcoxHnJHGqKCGuqbCeg",286,0.996516,26,287,1,286,1,1,0,1,1,138,137,149,149,58
"5265",64,"[26]aoHoIgoHcoxHnJHGqKCGuqbCeg",286,0.996516,26,287,1,286,1,1,0,1,1,155,154,132,132,58
"5266",65,"[26]aoHoIgoHcoxHnJHGqKCGuqbCeg",287,0.996528,26,288,1,287,1,1,0,1,1,149,148,139,139,58
"5267",66,"[26]aoHoIgoHcoxHnJHGqKCGuqbCeg",272,0.996337,26,273,1,272,1,1,0,1,1,139,138,134,134,58
"5268",67,"[26]aoHoIgoHcoxHnJHGqKCGuqbCeg",274,0.996364,26,275,1,274,1,1,0,1,1,106,105,169,169,58
"5269",68,"[26]aoHoIgoHcoxHnJHGqKCGuqbCeg",275,0.996377,26,276,1,275,1,1,0,1,1,128,127,148,148,58
"5270",69,"[26]aoHoIgoHcoxHnJHGqKCGuqbCeg",283,0.996479,26,284,1,283,1,1,0,1,1,156,155,128,128,58
"5271",70,"[26]aoHoIgoHcoxHnJHGqKCGuqbCeg",274,0.996364,26,275,1,274,1,1,0,1,1,132,131,143,143,58
"5272",71,"[26]aoHoIgoHcoxHnJHGqKCGuqbCeg",272,0.996337,26,273,1,272,1,1,0,1,1,138,137,135,135,58
"5273",72,"[26]aoHoIgoHcoxHnJHGqKCGuqbCeg",280,0.996441,26,281,1,280,1,1,0,1,1,129,128,152,152,58
"5274",73,"[26]aoHoIgoHcoxHnJHGqKCGuqbCeg",274,0.996364,26,275,1,274,1,1,0,1,1,134,133,141,141,58
"5275",74,"[26]aoHoIgoHcoxHnJHGqKCGuqbCeg",272,0.996337,26,273,1,272,1,1,0,1,1,119,118,154,154,58
"5276",75,"[26]aoHoIgoHcoxHnJHGqKCGuqbCeg",279,0.996429,26,280,1,279,1,1,0,1,1,148,147,132,132,58
"5277",76,"[26]aoHoIgoHcoxHnJHGqKCGuqbCeg",281,0.996454,26,282,1,281,1,1,0,1,1,150,149,132,132,58
"5278",77,"[26]aoHoIgoHcoxHnJHGqKCGuqbCeg",281,0.996454,26,282,1,281,1,1,0,1,1,153,152,129,129,58
"5279",78,"[26]aoHoIgoHcoxHnJHGqKCGuqbCeg",278,0.996416,26,279,1,278,1,1,0,1,1,126,125,153,153,58
"5280",79,"[26]aoHoIgoHcoxHnJHGqKCGuqbCeg",274,0.996364,26,275,1,274,1,1,0,1,1,126,125,149,149,58
"5281",80,"[26]aoHoIgoHcoxHnJHGqKCGuqbCeg",288,0.99654,26,289,1,288,1,1,0,1,1,169,168,120,120,58
"5282",81,"[26]aoHoIgoHcoxHnJHGqKCGuqbCeg",276,0.99639,26,277,1,276,1,1,0,1,1,142,141,135,135,58
"5283",82,"[26]aoHoIgoHcoxHnJHGqKCGuqbCeg",283,0.996479,26,284,1,283,1,1,0,1,1,135,134,149,149,58
"5284",83,"[26]aoHoIgoHcoxHnJHGqKCGuqbCeg",280,0.996441,26,281,1,280,1,1,0,1,1,151,150,130,130,58
"5285",84,"[26]aoHoIgoHcoxHnJHGqKCGuqbCeg",282,0.996466,26,283,1,282,1,1,0,1,1,141,140,142,142,58
"5286",85,"[26]aoHoIgoHcoxHnJHGqKCGuqbCeg",278,0.996416,26,279,1,278,1,1,0,1,1,127,126,152,152,58
"5287",86,"[26]aoHoIgoHcoxHnJHGqKCGuqbCeg",278,0.996416,26,279,1,278,1,1,0,1,1,124,123,155,155,58
"5288",87,"[26]aoHoIgoHcoxHnJHGqKCGuqbCeg",286,0.996516,26,287,1,286,1,1,0,1,1,142,141,145,145,58
"5289",88,"[26]aoHoIgoHcoxHnJHGqKCGuqbCeg",284,0.996491,26,285,1,284,1,1,0,1,1,144,143,141,141,58
"5290",89,"[26]aoHoIgoHcoxHnJHGqKCGuqbCeg",284,0.996491,26,285,1,284,1,1,0,1,1,164,163,121,121,58
"5291",90,"[26]aoHoIgoHcoxHnJHGqKCGuqbCeg",282,0.996466,26,283,1,282,1,1,0,1,1,142,141,141,141,58
"5292",91,"[26]aoHoIgoHcoxHnJHGqKCGuqbCeg",281,0.996454,26,282,1,281,1,1,0,1,1,143,142,139,139,58
"5293",92,"[26]aoHoIgoHcoxHnJHGqKCGuqbCeg",276,0.99639,26,277,1,276,1,1,0,1,1,139,138,138,138,58
"5294",93,"[26]aoHoIgoHcoxHnJHGqKCGuqbCeg",279,0.996429,26,280,1,279,1,1,0,1,1,129,128,151,151,58
"5295",94,"[26]aoHoIgoHcoxHnJHGqKCGuqbCeg",275,0.996377,26,276,1,275,1,1,0,1,1,136,135,140,140,58
"5296",95,"[26]aoHoIgoHcoxHnJHGqKCGuqbCeg",284,0.996491,26,285,1,284,1,1,0,1,1,145,144,140,140,58
"5297",96,"[26]aoHoIgoHcoxHnJHGqKCGuqbCeg",286,0.996516,26,287,1,286,1,1,0,1,1,147,146,140,140,58
"5298",97,"[26]aoHoIgoHcoxHnJHGqKCGuqbCeg",269,0.996296,26,270,1,269,1,1,0,1,1,115,114,155,155,58
"5299",98,"[26]aoHoIgoHcoxHnJHGqKCGuqbCeg",278,0.996416,26,279,1,278,1,1,0,1,1,149,148,130,130,58
"5300",99,"[26]aoHoIgoHcoxHnJHGqKCGuqbCeg",273,0.99635,26,274,1,273,1,1,0,1,1,141,140,133,133,58
"5301",0,"[26]HoIloHcovHnJHGqKCsgbqIqGkA",282,0.996466,26,283,1,282,1,1,0,1,1,146,145,137,137,59
"5302",1,"[26]HoIloHcovHnJHGqKCsgbqIqGkA",282,0.996466,26,283,1,282,1,1,0,1,1,143,142,140,140,59
"5303",2,"[26]HoIloHcovHnJHGqKCsgbqIqGkA",281,0.996454,26,282,1,281,1,1,0,1,1,143,142,139,139,59
"5304",3,"[26]HoIloHcovHnJHGqKCsgbqIqGkA",283,0.996479,26,284,1,283,1,1,0,1,1,141,140,143,143,59
"5305",4,"[26]HoIloHcovHnJHGqKCsgbqIqGkA",271,0.996324,26,272,1,271,1,1,0,1,1,113,112,159,159,59
"5306",5,"[26]HoIloHcovHnJHGqKCsgbqIqGkA",284,0.996491,26,285,1,284,1,1,0,1,1,141,140,144,144,59
"5307",6,"[26]HoIloHcovHnJHGqKCsgbqIqGkA",286,0.996516,26,287,1,286,1,1,0,1,1,144,143,143,143,59
"5308",7,"[26]HoIloHcovHnJHGqKCsgbqIqGkA",279,0.996429,26,280,1,279,1,1,0,1,1,131,130,149,149,59
"5309",8,"[26]HoIloHcovHnJHGqKCsgbqIqGkA",275,0.996377,26,276,1,275,1,1,0,1,1,140,139,136,136,59
"5310",9,"[26]HoIloHcovHnJHGqKCsgbqIqGkA",277,0.996403,26,278,1,277,1,1,0,1,1,138,137,140,140,59
"5311",10,"[26]HoIloHcovHnJHGqKCsgbqIqGkA",284,0.996491,26,285,1,284,1,1,0,1,1,139,138,146,146,59
"5312",11,"[26]HoIloHcovHnJHGqKCsgbqIqGkA",282,0.996466,26,283,1,282,1,1,0,1,1,142,141,141,141,59
"5313",12,"[26]HoIloHcovHnJHGqKCsgbqIqGkA",283,0.996479,26,284,1,283,1,1,0,1,1,149,148,135,135,59
"5314",13,"[26]HoIloHcovHnJHGqKCsgbqIqGkA",279,0.996429,26,280,1,279,1,1,0,1,1,126,125,154,154,59
"5315",14,"[26]HoIloHcovHnJHGqKCsgbqIqGkA",282,0.996466,26,283,1,282,1,1,0,1,1,135,134,148,148,59
"5316",15,"[26]HoIloHcovHnJHGqKCsgbqIqGkA",290,0.996564,26,291,1,290,1,1,0,1,1,158,157,133,133,59
"5317",16,"[26]HoIloHcovHnJHGqKCsgbqIqGkA",283,0.996479,26,284,1,283,1,1,0,1,1,155,154,129,129,59
"5318",17,"[26]HoIloHcovHnJHGqKCsgbqIqGkA",274,0.996364,26,275,1,274,1,1,0,1,1,147,146,128,128,59
"5319",18,"[26]HoIloHcovHnJHGqKCsgbqIqGkA",282,0.996466,26,283,1,282,1,1,0,1,1,143,142,140,140,59
"5320",19,"[26]HoIloHcovHnJHGqKCsgbqIqGkA",282,0.996466,26,283,1,282,1,1,0,1,1,144,143,139,139,59
"5321",20,"[26]HoIloHcovHnJHGqKCsgbqIqGkA",278,0.996416,26,279,1,278,1,1,0,1,1,146,145,133,133,59
"5322",21,"[26]HoIloHcovHnJHGqKCsgbqIqGkA",279,0.996429,26,280,1,279,1,1,0,1,1,135,134,145,145,59
"5323",22,"[26]HoIloHcovHnJHGqKCsgbqIqGkA",283,0.996479,26,284,1,283,1,1,0,1,1,154,153,130,130,59
"5324",23,"[26]HoIloHcovHnJHGqKCsgbqIqGkA",266,0.996255,26,267,1,266,1,1,0,1,1,126,125,141,141,59
"5325",24,"[26]HoIloHcovHnJHGqKCsgbqIqGkA",283,0.996479,26,284,1,283,1,1,0,1,1,149,148,135,135,59
"5326",25,"[26]HoIloHcovHnJHGqKCsgbqIqGkA",287,0.996528,26,288,1,287,1,1,0,1,1,153,152,135,135,59
"5327",26,"[26]HoIloHcovHnJHGqKCsgbqIqGkA",275,0.996377,26,276,1,275,1,1,0,1,1,144,143,132,132,59
"5328",27,"[26]HoIloHcovHnJHGqKCsgbqIqGkA",279,0.996429,26,280,1,279,1,1,0,1,1,143,142,137,137,59
"5329",28,"[26]HoIloHcovHnJHGqKCsgbqIqGkA",277,0.996403,26,278,1,277,1,1,0,1,1,150,149,128,128,59
"5330",29,"[26]HoIloHcovHnJHGqKCsgbqIqGkA",281,0.996454,26,282,1,281,1,1,0,1,1,143,142,139,139,59
"5331",30,"[26]HoIloHcovHnJHGqKCsgbqIqGkA",280,0.996441,26,281,1,280,1,1,0,1,1,144,143,137,137,59
"5332",31,"[26]HoIloHcovHnJHGqKCsgbqIqGkA",283,0.996479,26,284,1,283,1,1,0,1,1,148,147,136,136,59
"5333",32,"[26]HoIloHcovHnJHGqKCsgbqIqGkA",279,0.996429,26,280,1,279,1,1,0,1,1,156,155,124,124,59
"5334",33,"[26]HoIloHcovHnJHGqKCsgbqIqGkA",283,0.996479,26,284,1,283,1,1,0,1,1,146,145,138,138,59
"5335",34,"[26]HoIloHcovHnJHGqKCsgbqIqGkA",288,0.99654,26,289,1,288,1,1,0,1,1,145,144,144,144,59
"5336",35,"[26]HoIloHcovHnJHGqKCsgbqIqGkA",283,0.996479,26,284,1,283,1,1,0,1,1,138,137,146,146,59
"5337",36,"[26]HoIloHcovHnJHGqKCsgbqIqGkA",283,0.996479,26,284,1,283,1,1,0,1,1,141,140,143,143,59
"5338",37,"[26]HoIloHcovHnJHGqKCsgbqIqGkA",281,0.996454,26,282,1,281,1,1,0,1,1,141,140,141,141,59
"5339",38,"[26]HoIloHcovHnJHGqKCsgbqIqGkA",279,0.996429,26,280,1,279,1,1,0,1,1,128,127,152,152,59
"5340",39,"[26]HoIloHcovHnJHGqKCsgbqIqGkA",281,0.996454,26,282,1,281,1,1,0,1,1,141,140,141,141,59
"5341",40,"[26]HoIloHcovHnJHGqKCsgbqIqGkA",269,0.996296,26,270,1,269,1,1,0,1,1,131,130,139,139,59
"5342",41,"[26]HoIloHcovHnJHGqKCsgbqIqGkA",277,0.996403,26,278,1,277,1,1,0,1,1,133,132,145,145,59
"5343",42,"[26]HoIloHcovHnJHGqKCsgbqIqGkA",276,0.99639,26,277,1,276,1,1,0,1,1,143,142,134,134,59
"5344",43,"[26]HoIloHcovHnJHGqKCsgbqIqGkA",277,0.996403,26,278,1,277,1,1,0,1,1,141,140,137,137,59
"5345",44,"[26]HoIloHcovHnJHGqKCsgbqIqGkA",282,0.996466,26,283,1,282,1,1,0,1,1,140,139,143,143,59
"5346",45,"[26]HoIloHcovHnJHGqKCsgbqIqGkA",286,0.996516,26,287,1,286,1,1,0,1,1,140,139,147,147,59
"5347",46,"[26]HoIloHcovHnJHGqKCsgbqIqGkA",280,0.996441,26,281,1,280,1,1,0,1,1,148,147,133,133,59
"5348",47,"[26]HoIloHcovHnJHGqKCsgbqIqGkA",277,0.996403,26,278,1,277,1,1,0,1,1,116,115,162,162,59
"5349",48,"[26]HoIloHcovHnJHGqKCsgbqIqGkA",279,0.996429,26,280,1,279,1,1,0,1,1,129,128,151,151,59
"5350",49,"[26]HoIloHcovHnJHGqKCsgbqIqGkA",280,0.996441,26,281,1,280,1,1,0,1,1,140,139,141,141,59
"5351",50,"[26]HoIloHcovHnJHGqKCsgbqIqGkA",283,0.996479,26,284,1,283,1,1,0,1,1,129,128,155,155,59
"5352",51,"[26]HoIloHcovHnJHGqKCsgbqIqGkA",282,0.996466,26,283,1,282,1,1,0,1,1,149,148,134,134,59
"5353",52,"[26]HoIloHcovHnJHGqKCsgbqIqGkA",278,0.996416,26,279,1,278,1,1,0,1,1,151,150,128,128,59
"5354",53,"[26]HoIloHcovHnJHGqKCsgbqIqGkA",284,0.996491,26,285,1,284,1,1,0,1,1,149,148,136,136,59
"5355",54,"[26]HoIloHcovHnJHGqKCsgbqIqGkA",275,0.996377,26,276,1,275,1,1,0,1,1,133,132,143,143,59
"5356",55,"[26]HoIloHcovHnJHGqKCsgbqIqGkA",284,0.996491,26,285,1,284,1,1,0,1,1,136,135,149,149,59
"5357",56,"[26]HoIloHcovHnJHGqKCsgbqIqGkA",281,0.996454,26,282,1,281,1,1,0,1,1,135,134,147,147,59
"5358",57,"[26]HoIloHcovHnJHGqKCsgbqIqGkA",271,0.996324,26,272,1,271,1,1,0,1,1,149,148,123,123,59
"5359",58,"[26]HoIloHcovHnJHGqKCsgbqIqGkA",278,0.996416,26,279,1,278,1,1,0,1,1,135,134,144,144,59
"5360",59,"[26]HoIloHcovHnJHGqKCsgbqIqGkA",288,0.99654,26,289,1,288,1,1,0,1,1,150,149,139,139,59
"5361",60,"[26]HoIloHcovHnJHGqKCsgbqIqGkA",280,0.996441,26,281,1,280,1,1,0,1,1,139,138,142,142,59
"5362",61,"[26]HoIloHcovHnJHGqKCsgbqIqGkA",277,0.996403,26,278,1,277,1,1,0,1,1,133,132,145,145,59
"5363",62,"[26]HoIloHcovHnJHGqKCsgbqIqGkA",276,0.99639,26,277,1,276,1,1,0,1,1,140,139,137,137,59
"5364",63,"[26]HoIloHcovHnJHGqKCsgbqIqGkA",278,0.996416,26,279,1,278,1,1,0,1,1,148,147,131,131,59
"5365",64,"[26]HoIloHcovHnJHGqKCsgbqIqGkA",285,0.996503,26,286,1,285,1,1,0,1,1,153,152,133,133,59
"5366",65,"[26]HoIloHcovHnJHGqKCsgbqIqGkA",291,0.996575,26,292,1,291,1,1,0,1,1,143,142,149,149,59
"5367",66,"[26]HoIloHcovHnJHGqKCsgbqIqGkA",279,0.996429,26,280,1,279,1,1,0,1,1,144,143,136,136,59
"5368",67,"[26]HoIloHcovHnJHGqKCsgbqIqGkA",287,0.996528,26,288,1,287,1,1,0,1,1,155,154,133,133,59
"5369",68,"[26]HoIloHcovHnJHGqKCsgbqIqGkA",282,0.996466,26,283,1,282,1,1,0,1,1,147,146,136,136,59
"5370",69,"[26]HoIloHcovHnJHGqKCsgbqIqGkA",281,0.996454,26,282,1,281,1,1,0,1,1,134,133,148,148,59
"5371",70,"[26]HoIloHcovHnJHGqKCsgbqIqGkA",287,0.996528,26,288,1,287,1,1,0,1,1,147,146,141,141,59
"5372",71,"[26]HoIloHcovHnJHGqKCsgbqIqGkA",280,0.996441,26,281,1,280,1,1,0,1,1,130,129,151,151,59
"5373",72,"[26]HoIloHcovHnJHGqKCsgbqIqGkA",282,0.996466,26,283,1,282,1,1,0,1,1,144,143,139,139,59
"5374",73,"[26]HoIloHcovHnJHGqKCsgbqIqGkA",278,0.996416,26,279,1,278,1,1,0,1,1,130,129,149,149,59
"5375",74,"[26]HoIloHcovHnJHGqKCsgbqIqGkA",278,0.996416,26,279,1,278,1,1,0,1,1,148,147,131,131,59
"5376",75,"[26]HoIloHcovHnJHGqKCsgbqIqGkA",271,0.996324,26,272,1,271,1,1,0,1,1,150,149,122,122,59
"5377",76,"[26]HoIloHcovHnJHGqKCsgbqIqGkA",279,0.996429,26,280,1,279,1,1,0,1,1,147,146,133,133,59
"5378",77,"[26]HoIloHcovHnJHGqKCsgbqIqGkA",273,0.99635,26,274,1,273,1,1,0,1,1,129,128,145,145,59
"5379",78,"[26]HoIloHcovHnJHGqKCsgbqIqGkA",282,0.996466,26,283,1,282,1,1,0,1,1,141,140,142,142,59
"5380",79,"[26]HoIloHcovHnJHGqKCsgbqIqGkA",285,0.996503,26,286,1,285,1,1,0,1,1,131,130,155,155,59
"5381",80,"[26]HoIloHcovHnJHGqKCsgbqIqGkA",282,0.996466,26,283,1,282,1,1,0,1,1,137,136,146,146,59
"5382",81,"[26]HoIloHcovHnJHGqKCsgbqIqGkA",269,0.996296,26,270,1,269,1,1,0,1,1,107,106,163,163,59
"5383",82,"[26]HoIloHcovHnJHGqKCsgbqIqGkA",279,0.996429,26,280,1,279,1,1,0,1,1,143,142,137,137,59
"5384",83,"[26]HoIloHcovHnJHGqKCsgbqIqGkA",287,0.996528,26,288,1,287,1,1,0,1,1,136,135,152,152,59
"5385",84,"[26]HoIloHcovHnJHGqKCsgbqIqGkA",283,0.996479,26,284,1,283,1,1,0,1,1,136,135,148,148,59
"5386",85,"[26]HoIloHcovHnJHGqKCsgbqIqGkA",278,0.996416,26,279,1,278,1,1,0,1,1,133,132,146,146,59
"5387",86,"[26]HoIloHcovHnJHGqKCsgbqIqGkA",286,0.996516,26,287,1,286,1,1,0,1,1,155,154,132,132,59
"5388",87,"[26]HoIloHcovHnJHGqKCsgbqIqGkA",279,0.996429,26,280,1,279,1,1,0,1,1,137,136,143,143,59
"5389",88,"[26]HoIloHcovHnJHGqKCsgbqIqGkA",284,0.996491,26,285,1,284,1,1,0,1,1,140,139,145,145,59
"5390",89,"[26]HoIloHcovHnJHGqKCsgbqIqGkA",282,0.996466,26,283,1,282,1,1,0,1,1,143,142,140,140,59
"5391",90,"[26]HoIloHcovHnJHGqKCsgbqIqGkA",275,0.996377,26,276,1,275,1,1,0,1,1,141,140,135,135,59
"5392",91,"[26]HoIloHcovHnJHGqKCsgbqIqGkA",272,0.996337,26,273,1,272,1,1,0,1,1,142,141,131,131,59
"5393",92,"[26]HoIloHcovHnJHGqKCsgbqIqGkA",285,0.996503,26,286,1,285,1,1,0,1,1,150,149,136,136,59
"5394",93,"[26]HoIloHcovHnJHGqKCsgbqIqGkA",288,0.99654,26,289,1,288,1,1,0,1,1,148,147,141,141,59
"5395",94,"[26]HoIloHcovHnJHGqKCsgbqIqGkA",278,0.996416,26,279,1,278,1,1,0,1,1,140,139,139,139,59
"5396",95,"[26]HoIloHcovHnJHGqKCsgbqIqGkA",283,0.996479,26,284,1,283,1,1,0,1,1,156,155,128,128,59
"5397",96,"[26]HoIloHcovHnJHGqKCsgbqIqGkA",282,0.996466,26,283,1,282,1,1,0,1,1,137,136,146,146,59
"5398",97,"[26]HoIloHcovHnJHGqKCsgbqIqGkA",283,0.996479,26,284,1,283,1,1,0,1,1,149,148,135,135,59
"5399",98,"[26]HoIloHcovHnJHGqKCsgbqIqGkA",278,0.996416,26,279,1,278,1,1,0,1,1,145,144,134,134,59
"5400",99,"[26]HoIloHcovHnJHGqKCsgbqIqGkA",276,0.99639,26,277,1,276,1,1,0,1,1,136,135,141,141,59
"5401",0,"[23]zgoIoHcovHnJHGqKCJgjFlo",282,0.996466,23,283,1,282,1,1,0,1,1,139,138,144,144,60
"5402",1,"[23]zgoIoHcovHnJHGqKCJgjFlo",279,0.996429,23,280,1,279,1,1,0,1,1,142,141,138,138,60
"5403",2,"[23]zgoIoHcovHnJHGqKCJgjFlo",264,0.996226,23,265,1,264,1,1,0,1,1,133,132,132,132,60
"5404",3,"[23]zgoIoHcovHnJHGqKCJgjFlo",278,0.996416,23,279,1,278,1,1,0,1,1,140,139,139,139,60
"5405",4,"[23]zgoIoHcovHnJHGqKCJgjFlo",277,0.996403,23,278,1,277,1,1,0,1,1,148,147,130,130,60
"5406",5,"[23]zgoIoHcovHnJHGqKCJgjFlo",288,0.99654,23,289,1,288,1,1,0,1,1,148,147,141,141,60
"5407",6,"[23]zgoIoHcovHnJHGqKCJgjFlo",281,0.996454,23,282,1,281,1,1,0,1,1,149,148,133,133,60
"5408",7,"[23]zgoIoHcovHnJHGqKCJgjFlo",288,0.99654,23,289,1,288,1,1,0,1,1,151,150,138,138,60
"5409",8,"[23]zgoIoHcovHnJHGqKCJgjFlo",290,0.996564,23,291,1,290,1,1,0,1,1,148,147,143,143,60
"5410",9,"[23]zgoIoHcovHnJHGqKCJgjFlo",281,0.996454,23,282,1,281,1,1,0,1,1,136,135,146,146,60
"5411",10,"[23]zgoIoHcovHnJHGqKCJgjFlo",289,0.996552,23,290,1,289,1,1,0,1,1,145,144,145,145,60
"5412",11,"[23]zgoIoHcovHnJHGqKCJgjFlo",287,0.996528,23,288,1,287,1,1,0,1,1,145,144,143,143,60
"5413",12,"[23]zgoIoHcovHnJHGqKCJgjFlo",274,0.996364,23,275,1,274,1,1,0,1,1,137,136,138,138,60
"5414",13,"[23]zgoIoHcovHnJHGqKCJgjFlo",278,0.996416,23,279,1,278,1,1,0,1,1,153,152,126,126,60
"5415",14,"[23]zgoIoHcovHnJHGqKCJgjFlo",279,0.996429,23,280,1,279,1,1,0,1,1,130,129,150,150,60
"5416",15,"[23]zgoIoHcovHnJHGqKCJgjFlo",285,0.996503,23,286,1,285,1,1,0,1,1,139,138,147,147,60
"5417",16,"[23]zgoIoHcovHnJHGqKCJgjFlo",284,0.996491,23,285,1,284,1,1,0,1,1,140,139,145,145,60
"5418",17,"[23]zgoIoHcovHnJHGqKCJgjFlo",279,0.996429,23,280,1,279,1,1,0,1,1,136,135,144,144,60
"5419",18,"[23]zgoIoHcovHnJHGqKCJgjFlo",285,0.996503,23,286,1,285,1,1,0,1,1,142,141,144,144,60
"5420",19,"[23]zgoIoHcovHnJHGqKCJgjFlo",277,0.996403,23,278,1,277,1,1,0,1,1,131,130,147,147,60
"5421",20,"[23]zgoIoHcovHnJHGqKCJgjFlo",283,0.996479,23,284,1,283,1,1,0,1,1,137,136,147,147,60
"5422",21,"[23]zgoIoHcovHnJHGqKCJgjFlo",281,0.996454,23,282,1,281,1,1,0,1,1,144,143,138,138,60
"5423",22,"[23]zgoIoHcovHnJHGqKCJgjFlo",287,0.996528,23,288,1,287,1,1,0,1,1,142,141,146,146,60
"5424",23,"[23]zgoIoHcovHnJHGqKCJgjFlo",283,0.996479,23,284,1,283,1,1,0,1,1,154,153,130,130,60
"5425",24,"[23]zgoIoHcovHnJHGqKCJgjFlo",284,0.996491,23,285,1,284,1,1,0,1,1,137,136,148,148,60
"5426",25,"[23]zgoIoHcovHnJHGqKCJgjFlo",286,0.996516,23,287,1,286,1,1,0,1,1,142,141,145,145,60
"5427",26,"[23]zgoIoHcovHnJHGqKCJgjFlo",280,0.996441,23,281,1,280,1,1,0,1,1,135,134,146,146,60
"5428",27,"[23]zgoIoHcovHnJHGqKCJgjFlo",278,0.996416,23,279,1,278,1,1,0,1,1,139,138,140,140,60
"5429",28,"[23]zgoIoHcovHnJHGqKCJgjFlo",285,0.996503,23,286,1,285,1,1,0,1,1,148,147,138,138,60
"5430",29,"[23]zgoIoHcovHnJHGqKCJgjFlo",284,0.996491,23,285,1,284,1,1,0,1,1,159,158,126,126,60
"5431",30,"[23]zgoIoHcovHnJHGqKCJgjFlo",277,0.996403,23,278,1,277,1,1,0,1,1,146,145,132,132,60
"5432",31,"[23]zgoIoHcovHnJHGqKCJgjFlo",275,0.996377,23,276,1,275,1,1,0,1,1,127,126,149,149,60
"5433",32,"[23]zgoIoHcovHnJHGqKCJgjFlo",272,0.996337,23,273,1,272,1,1,0,1,1,129,128,144,144,60
"5434",33,"[23]zgoIoHcovHnJHGqKCJgjFlo",284,0.996491,23,285,1,284,1,1,0,1,1,152,151,133,133,60
"5435",34,"[23]zgoIoHcovHnJHGqKCJgjFlo",279,0.996429,23,280,1,279,1,1,0,1,1,143,142,137,137,60
"5436",35,"[23]zgoIoHcovHnJHGqKCJgjFlo",280,0.996441,23,281,1,280,1,1,0,1,1,147,146,134,134,60
"5437",36,"[23]zgoIoHcovHnJHGqKCJgjFlo",289,0.996552,23,290,1,289,1,1,0,1,1,161,160,129,129,60
"5438",37,"[23]zgoIoHcovHnJHGqKCJgjFlo",279,0.996429,23,280,1,279,1,1,0,1,1,131,130,149,149,60
"5439",38,"[23]zgoIoHcovHnJHGqKCJgjFlo",279,0.996429,23,280,1,279,1,1,0,1,1,147,146,133,133,60
"5440",39,"[23]zgoIoHcovHnJHGqKCJgjFlo",284,0.996491,23,285,1,284,1,1,0,1,1,132,131,153,153,60
"5441",40,"[23]zgoIoHcovHnJHGqKCJgjFlo",284,0.996491,23,285,1,284,1,1,0,1,1,154,153,131,131,60
"5442",41,"[23]zgoIoHcovHnJHGqKCJgjFlo",290,0.996564,23,291,1,290,1,1,0,1,1,153,152,138,138,60
"5443",42,"[23]zgoIoHcovHnJHGqKCJgjFlo",280,0.996441,23,281,1,280,1,1,0,1,1,152,151,129,129,60
"5444",43,"[23]zgoIoHcovHnJHGqKCJgjFlo",282,0.996466,23,283,1,282,1,1,0,1,1,143,142,140,140,60
"5445",44,"[23]zgoIoHcovHnJHGqKCJgjFlo",283,0.996479,23,284,1,283,1,1,0,1,1,150,149,134,134,60
"5446",45,"[23]zgoIoHcovHnJHGqKCJgjFlo",276,0.99639,23,277,1,276,1,1,0,1,1,141,140,136,136,60
"5447",46,"[23]zgoIoHcovHnJHGqKCJgjFlo",279,0.996429,23,280,1,279,1,1,0,1,1,132,131,148,148,60
"5448",47,"[23]zgoIoHcovHnJHGqKCJgjFlo",275,0.996377,23,276,1,275,1,1,0,1,1,143,142,133,133,60
"5449",48,"[23]zgoIoHcovHnJHGqKCJgjFlo",280,0.996441,23,281,1,280,1,1,0,1,1,142,141,139,139,60
"5450",49,"[23]zgoIoHcovHnJHGqKCJgjFlo",273,0.99635,23,274,1,273,1,1,0,1,1,142,141,132,132,60
"5451",50,"[23]zgoIoHcovHnJHGqKCJgjFlo",284,0.996491,23,285,1,284,1,1,0,1,1,141,140,144,144,60
"5452",51,"[23]zgoIoHcovHnJHGqKCJgjFlo",283,0.996479,23,284,1,283,1,1,0,1,1,147,146,137,137,60
"5453",52,"[23]zgoIoHcovHnJHGqKCJgjFlo",282,0.996466,23,283,1,282,1,1,0,1,1,139,138,144,144,60
"5454",53,"[23]zgoIoHcovHnJHGqKCJgjFlo",281,0.996454,23,282,1,281,1,1,0,1,1,130,129,152,152,60
"5455",54,"[23]zgoIoHcovHnJHGqKCJgjFlo",277,0.996403,23,278,1,277,1,1,0,1,1,140,139,138,138,60
"5456",55,"[23]zgoIoHcovHnJHGqKCJgjFlo",279,0.996429,23,280,1,279,1,1,0,1,1,149,148,131,131,60
"5457",56,"[23]zgoIoHcovHnJHGqKCJgjFlo",278,0.996416,23,279,1,278,1,1,0,1,1,139,138,140,140,60
"5458",57,"[23]zgoIoHcovHnJHGqKCJgjFlo",288,0.99654,23,289,1,288,1,1,0,1,1,154,153,135,135,60
"5459",58,"[23]zgoIoHcovHnJHGqKCJgjFlo",287,0.996528,23,288,1,287,1,1,0,1,1,154,153,134,134,60
"5460",59,"[23]zgoIoHcovHnJHGqKCJgjFlo",285,0.996503,23,286,1,285,1,1,0,1,1,152,151,134,134,60
"5461",60,"[23]zgoIoHcovHnJHGqKCJgjFlo",285,0.996503,23,286,1,285,1,1,0,1,1,152,151,134,134,60
"5462",61,"[23]zgoIoHcovHnJHGqKCJgjFlo",284,0.996491,23,285,1,284,1,1,0,1,1,140,139,145,145,60
"5463",62,"[23]zgoIoHcovHnJHGqKCJgjFlo",282,0.996466,23,283,1,282,1,1,0,1,1,153,152,130,130,60
"5464",63,"[23]zgoIoHcovHnJHGqKCJgjFlo",287,0.996528,23,288,1,287,1,1,0,1,1,153,152,135,135,60
"5465",64,"[23]zgoIoHcovHnJHGqKCJgjFlo",283,0.996479,23,284,1,283,1,1,0,1,1,140,139,144,144,60
"5466",65,"[23]zgoIoHcovHnJHGqKCJgjFlo",282,0.996466,23,283,1,282,1,1,0,1,1,154,153,129,129,60
"5467",66,"[23]zgoIoHcovHnJHGqKCJgjFlo",278,0.996416,23,279,1,278,1,1,0,1,1,141,140,138,138,60
"5468",67,"[23]zgoIoHcovHnJHGqKCJgjFlo",280,0.996441,23,281,1,280,1,1,0,1,1,138,137,143,143,60
"5469",68,"[23]zgoIoHcovHnJHGqKCJgjFlo",290,0.996564,23,291,1,290,1,1,0,1,1,152,151,139,139,60
"5470",69,"[23]zgoIoHcovHnJHGqKCJgjFlo",274,0.996364,23,275,1,274,1,1,0,1,1,135,134,140,140,60
"5471",70,"[23]zgoIoHcovHnJHGqKCJgjFlo",287,0.996528,23,288,1,287,1,1,0,1,1,151,150,137,137,60
"5472",71,"[23]zgoIoHcovHnJHGqKCJgjFlo",282,0.996466,23,283,1,282,1,1,0,1,1,126,125,157,157,60
"5473",72,"[23]zgoIoHcovHnJHGqKCJgjFlo",289,0.996552,23,290,1,289,1,1,0,1,1,152,151,138,138,60
"5474",73,"[23]zgoIoHcovHnJHGqKCJgjFlo",279,0.996429,23,280,1,279,1,1,0,1,1,136,135,144,144,60
"5475",74,"[23]zgoIoHcovHnJHGqKCJgjFlo",278,0.996416,23,279,1,278,1,1,0,1,1,134,133,145,145,60
"5476",75,"[23]zgoIoHcovHnJHGqKCJgjFlo",278,0.996416,23,279,1,278,1,1,0,1,1,128,127,151,151,60
"5477",76,"[23]zgoIoHcovHnJHGqKCJgjFlo",280,0.996441,23,281,1,280,1,1,0,1,1,144,143,137,137,60
"5478",77,"[23]zgoIoHcovHnJHGqKCJgjFlo",279,0.996429,23,280,1,279,1,1,0,1,1,136,135,144,144,60
"5479",78,"[23]zgoIoHcovHnJHGqKCJgjFlo",284,0.996491,23,285,1,284,1,1,0,1,1,150,149,135,135,60
"5480",79,"[23]zgoIoHcovHnJHGqKCJgjFlo",285,0.996503,23,286,1,285,1,1,0,1,1,137,136,149,149,60
"5481",80,"[23]zgoIoHcovHnJHGqKCJgjFlo",281,0.996454,23,282,1,281,1,1,0,1,1,141,140,141,141,60
"5482",81,"[23]zgoIoHcovHnJHGqKCJgjFlo",289,0.996552,23,290,1,289,1,1,0,1,1,152,151,138,138,60
"5483",82,"[23]zgoIoHcovHnJHGqKCJgjFlo",272,0.996337,23,273,1,272,1,1,0,1,1,148,147,125,125,60
"5484",83,"[23]zgoIoHcovHnJHGqKCJgjFlo",283,0.996479,23,284,1,283,1,1,0,1,1,139,138,145,145,60
"5485",84,"[23]zgoIoHcovHnJHGqKCJgjFlo",279,0.996429,23,280,1,279,1,1,0,1,1,140,139,140,140,60
"5486",85,"[23]zgoIoHcovHnJHGqKCJgjFlo",289,0.996552,23,290,1,289,1,1,0,1,1,159,158,131,131,60
"5487",86,"[23]zgoIoHcovHnJHGqKCJgjFlo",279,0.996429,23,280,1,279,1,1,0,1,1,132,131,148,148,60
"5488",87,"[23]zgoIoHcovHnJHGqKCJgjFlo",282,0.996466,23,283,1,282,1,1,0,1,1,143,142,140,140,60
"5489",88,"[23]zgoIoHcovHnJHGqKCJgjFlo",284,0.996491,23,285,1,284,1,1,0,1,1,155,154,130,130,60
"5490",89,"[23]zgoIoHcovHnJHGqKCJgjFlo",275,0.996377,23,276,1,275,1,1,0,1,1,131,130,145,145,60
"5491",90,"[23]zgoIoHcovHnJHGqKCJgjFlo",282,0.996466,23,283,1,282,1,1,0,1,1,135,134,148,148,60
"5492",91,"[23]zgoIoHcovHnJHGqKCJgjFlo",287,0.996528,23,288,1,287,1,1,0,1,1,141,140,147,147,60
"5493",92,"[23]zgoIoHcovHnJHGqKCJgjFlo",272,0.996337,23,273,1,272,1,1,0,1,1,138,137,135,135,60
"5494",93,"[23]zgoIoHcovHnJHGqKCJgjFlo",279,0.996429,23,280,1,279,1,1,0,1,1,122,121,158,158,60
"5495",94,"[23]zgoIoHcovHnJHGqKCJgjFlo",281,0.996454,23,282,1,281,1,1,0,1,1,140,139,142,142,60
"5496",95,"[23]zgoIoHcovHnJHGqKCJgjFlo",283,0.996479,23,284,1,283,1,1,0,1,1,152,151,132,132,60
"5497",96,"[23]zgoIoHcovHnJHGqKCJgjFlo",290,0.996564,23,291,1,290,1,1,0,1,1,133,132,158,158,60
"5498",97,"[23]zgoIoHcovHnJHGqKCJgjFlo",279,0.996429,23,280,1,279,1,1,0,1,1,137,136,143,143,60
"5499",98,"[23]zgoIoHcovHnJHGqKCJgjFlo",286,0.996516,23,287,1,286,1,1,0,1,1,140,139,147,147,60
"5500",99,"[23]zgoIoHcovHnJHGqKCJgjFlo",280,0.996441,23,281,1,280,1,1,0,1,1,159,158,122,122,60
"5501",0,"[24]lnsoIGoHcosHnJHGqKCDkaKt",284,0.996491,24,285,1,284,1,1,0,1,1,145,144,140,140,61
"5502",1,"[24]lnsoIGoHcosHnJHGqKCDkaKt",284,0.996491,24,285,1,284,1,1,0,1,1,145,144,140,140,61
"5503",2,"[24]lnsoIGoHcosHnJHGqKCDkaKt",283,0.996479,24,284,1,283,1,1,0,1,1,151,150,133,133,61
"5504",3,"[24]lnsoIGoHcosHnJHGqKCDkaKt",286,0.996516,24,287,1,286,1,1,0,1,1,158,157,129,129,61
"5505",4,"[24]lnsoIGoHcosHnJHGqKCDkaKt",285,0.996503,24,286,1,285,1,1,0,1,1,154,153,132,132,61
"5506",5,"[24]lnsoIGoHcosHnJHGqKCDkaKt",285,0.996503,24,286,1,285,1,1,0,1,1,150,149,136,136,61
"5507",6,"[24]lnsoIGoHcosHnJHGqKCDkaKt",265,0.996241,24,266,1,265,1,1,0,1,1,133,132,133,133,61
"5508",7,"[24]lnsoIGoHcosHnJHGqKCDkaKt",284,0.996491,24,285,1,284,1,1,0,1,1,140,139,145,145,61
"5509",8,"[24]lnsoIGoHcosHnJHGqKCDkaKt",285,0.996503,24,286,1,285,1,1,0,1,1,146,145,140,140,61
"5510",9,"[24]lnsoIGoHcosHnJHGqKCDkaKt",280,0.996441,24,281,1,280,1,1,0,1,1,153,152,128,128,61
"5511",10,"[24]lnsoIGoHcosHnJHGqKCDkaKt",279,0.996429,24,280,1,279,1,1,0,1,1,142,141,138,138,61
"5512",11,"[24]lnsoIGoHcosHnJHGqKCDkaKt",286,0.996516,24,287,1,286,1,1,0,1,1,146,145,141,141,61
"5513",12,"[24]lnsoIGoHcosHnJHGqKCDkaKt",281,0.996454,24,282,1,281,1,1,0,1,1,132,131,150,150,61
"5514",13,"[24]lnsoIGoHcosHnJHGqKCDkaKt",280,0.996441,24,281,1,280,1,1,0,1,1,151,150,130,130,61
"5515",14,"[24]lnsoIGoHcosHnJHGqKCDkaKt",281,0.996454,24,282,1,281,1,1,0,1,1,136,135,146,146,61
"5516",15,"[24]lnsoIGoHcosHnJHGqKCDkaKt",281,0.996454,24,282,1,281,1,1,0,1,1,154,153,128,128,61
"5517",16,"[24]lnsoIGoHcosHnJHGqKCDkaKt",277,0.996403,24,278,1,277,1,1,0,1,1,144,143,134,134,61
"5518",17,"[24]lnsoIGoHcosHnJHGqKCDkaKt",286,0.996516,24,287,1,286,1,1,0,1,1,151,150,136,136,61
"5519",18,"[24]lnsoIGoHcosHnJHGqKCDkaKt",287,0.996528,24,288,1,287,1,1,0,1,1,153,152,135,135,61
"5520",19,"[24]lnsoIGoHcosHnJHGqKCDkaKt",285,0.996503,24,286,1,285,1,1,0,1,1,141,140,145,145,61
"5521",20,"[24]lnsoIGoHcosHnJHGqKCDkaKt",281,0.996454,24,282,1,281,1,1,0,1,1,144,143,138,138,61
"5522",21,"[24]lnsoIGoHcosHnJHGqKCDkaKt",284,0.996491,24,285,1,284,1,1,0,1,1,145,144,140,140,61
"5523",22,"[24]lnsoIGoHcosHnJHGqKCDkaKt",279,0.996429,24,280,1,279,1,1,0,1,1,132,131,148,148,61
"5524",23,"[24]lnsoIGoHcosHnJHGqKCDkaKt",281,0.996454,24,282,1,281,1,1,0,1,1,148,147,134,134,61
"5525",24,"[24]lnsoIGoHcosHnJHGqKCDkaKt",274,0.996364,24,275,1,274,1,1,0,1,1,118,117,157,157,61
"5526",25,"[24]lnsoIGoHcosHnJHGqKCDkaKt",275,0.996377,24,276,1,275,1,1,0,1,1,132,131,144,144,61
"5527",26,"[24]lnsoIGoHcosHnJHGqKCDkaKt",285,0.996503,24,286,1,285,1,1,0,1,1,148,147,138,138,61
"5528",27,"[24]lnsoIGoHcosHnJHGqKCDkaKt",281,0.996454,24,282,1,281,1,1,0,1,1,120,119,162,162,61
"5529",28,"[24]lnsoIGoHcosHnJHGqKCDkaKt",292,0.996587,24,293,1,292,1,1,0,1,1,156,155,137,137,61
"5530",29,"[24]lnsoIGoHcosHnJHGqKCDkaKt",283,0.996479,24,284,1,283,1,1,0,1,1,155,154,129,129,61
"5531",30,"[24]lnsoIGoHcosHnJHGqKCDkaKt",274,0.996364,24,275,1,274,1,1,0,1,1,143,142,132,132,61
"5532",31,"[24]lnsoIGoHcosHnJHGqKCDkaKt",287,0.996528,24,288,1,287,1,1,0,1,1,153,152,135,135,61
"5533",32,"[24]lnsoIGoHcosHnJHGqKCDkaKt",271,0.996324,24,272,1,271,1,1,0,1,1,155,154,117,117,61
"5534",33,"[24]lnsoIGoHcosHnJHGqKCDkaKt",285,0.996503,24,286,1,285,1,1,0,1,1,147,146,139,139,61
"5535",34,"[24]lnsoIGoHcosHnJHGqKCDkaKt",279,0.996429,24,280,1,279,1,1,0,1,1,131,130,149,149,61
"5536",35,"[24]lnsoIGoHcosHnJHGqKCDkaKt",285,0.996503,24,286,1,285,1,1,0,1,1,139,138,147,147,61
"5537",36,"[24]lnsoIGoHcosHnJHGqKCDkaKt",276,0.99639,24,277,1,276,1,1,0,1,1,118,117,159,159,61
"5538",37,"[24]lnsoIGoHcosHnJHGqKCDkaKt",283,0.996479,24,284,1,283,1,1,0,1,1,138,137,146,146,61
"5539",38,"[24]lnsoIGoHcosHnJHGqKCDkaKt",282,0.996466,24,283,1,282,1,1,0,1,1,130,129,153,153,61
"5540",39,"[24]lnsoIGoHcosHnJHGqKCDkaKt",279,0.996429,24,280,1,279,1,1,0,1,1,140,139,140,140,61
"5541",40,"[24]lnsoIGoHcosHnJHGqKCDkaKt",285,0.996503,24,286,1,285,1,1,0,1,1,159,158,127,127,61
"5542",41,"[24]lnsoIGoHcosHnJHGqKCDkaKt",284,0.996491,24,285,1,284,1,1,0,1,1,143,142,142,142,61
"5543",42,"[24]lnsoIGoHcosHnJHGqKCDkaKt",275,0.996377,24,276,1,275,1,1,0,1,1,122,121,154,154,61
"5544",43,"[24]lnsoIGoHcosHnJHGqKCDkaKt",285,0.996503,24,286,1,285,1,1,0,1,1,138,137,148,148,61
"5545",44,"[24]lnsoIGoHcosHnJHGqKCDkaKt",281,0.996454,24,282,1,281,1,1,0,1,1,144,143,138,138,61
"5546",45,"[24]lnsoIGoHcosHnJHGqKCDkaKt",278,0.996416,24,279,1,278,1,1,0,1,1,145,144,134,134,61
"5547",46,"[24]lnsoIGoHcosHnJHGqKCDkaKt",283,0.996479,24,284,1,283,1,1,0,1,1,154,153,130,130,61
"5548",47,"[24]lnsoIGoHcosHnJHGqKCDkaKt",280,0.996441,24,281,1,280,1,1,0,1,1,160,159,121,121,61
"5549",48,"[24]lnsoIGoHcosHnJHGqKCDkaKt",280,0.996441,24,281,1,280,1,1,0,1,1,129,128,152,152,61
"5550",49,"[24]lnsoIGoHcosHnJHGqKCDkaKt",278,0.996416,24,279,1,278,1,1,0,1,1,137,136,142,142,61
"5551",50,"[24]lnsoIGoHcosHnJHGqKCDkaKt",274,0.996364,24,275,1,274,1,1,0,1,1,140,139,135,135,61
"5552",51,"[24]lnsoIGoHcosHnJHGqKCDkaKt",282,0.996466,24,283,1,282,1,1,0,1,1,142,141,141,141,61
"5553",52,"[24]lnsoIGoHcosHnJHGqKCDkaKt",285,0.996503,24,286,1,285,1,1,0,1,1,136,135,150,150,61
"5554",53,"[24]lnsoIGoHcosHnJHGqKCDkaKt",270,0.99631,24,271,1,270,1,1,0,1,1,121,120,150,150,61
"5555",54,"[24]lnsoIGoHcosHnJHGqKCDkaKt",280,0.996441,24,281,1,280,1,1,0,1,1,151,150,130,130,61
"5556",55,"[24]lnsoIGoHcosHnJHGqKCDkaKt",280,0.996441,24,281,1,280,1,1,0,1,1,153,152,128,128,61
"5557",56,"[24]lnsoIGoHcosHnJHGqKCDkaKt",279,0.996429,24,280,1,279,1,1,0,1,1,133,132,147,147,61
"5558",57,"[24]lnsoIGoHcosHnJHGqKCDkaKt",273,0.99635,24,274,1,273,1,1,0,1,1,146,145,128,128,61
"5559",58,"[24]lnsoIGoHcosHnJHGqKCDkaKt",279,0.996429,24,280,1,279,1,1,0,1,1,143,142,137,137,61
"5560",59,"[24]lnsoIGoHcosHnJHGqKCDkaKt",268,0.996283,24,269,1,268,1,1,0,1,1,131,130,138,138,61
"5561",60,"[24]lnsoIGoHcosHnJHGqKCDkaKt",282,0.996466,24,283,1,282,1,1,0,1,1,151,150,132,132,61
"5562",61,"[24]lnsoIGoHcosHnJHGqKCDkaKt",269,0.996296,24,270,1,269,1,1,0,1,1,130,129,140,140,61
"5563",62,"[24]lnsoIGoHcosHnJHGqKCDkaKt",288,0.99654,24,289,1,288,1,1,0,1,1,141,140,148,148,61
"5564",63,"[24]lnsoIGoHcosHnJHGqKCDkaKt",279,0.996429,24,280,1,279,1,1,0,1,1,136,135,144,144,61
"5565",64,"[24]lnsoIGoHcosHnJHGqKCDkaKt",283,0.996479,24,284,1,283,1,1,0,1,1,143,142,141,141,61
"5566",65,"[24]lnsoIGoHcosHnJHGqKCDkaKt",282,0.996466,24,283,1,282,1,1,0,1,1,133,132,150,150,61
"5567",66,"[24]lnsoIGoHcosHnJHGqKCDkaKt",277,0.996403,24,278,1,277,1,1,0,1,1,145,144,133,133,61
"5568",67,"[24]lnsoIGoHcosHnJHGqKCDkaKt",280,0.996441,24,281,1,280,1,1,0,1,1,143,142,138,138,61
"5569",68,"[24]lnsoIGoHcosHnJHGqKCDkaKt",275,0.996377,24,276,1,275,1,1,0,1,1,140,139,136,136,61
"5570",69,"[24]lnsoIGoHcosHnJHGqKCDkaKt",279,0.996429,24,280,1,279,1,1,0,1,1,128,127,152,152,61
"5571",70,"[24]lnsoIGoHcosHnJHGqKCDkaKt",291,0.996575,24,292,1,291,1,1,0,1,1,157,156,135,135,61
"5572",71,"[24]lnsoIGoHcosHnJHGqKCDkaKt",279,0.996429,24,280,1,279,1,1,0,1,1,126,125,154,154,61
"5573",72,"[24]lnsoIGoHcosHnJHGqKCDkaKt",283,0.996479,24,284,1,283,1,1,0,1,1,143,142,141,141,61
"5574",73,"[24]lnsoIGoHcosHnJHGqKCDkaKt",286,0.996516,24,287,1,286,1,1,0,1,1,152,151,135,135,61
"5575",74,"[24]lnsoIGoHcosHnJHGqKCDkaKt",281,0.996454,24,282,1,281,1,1,0,1,1,129,128,153,153,61
"5576",75,"[24]lnsoIGoHcosHnJHGqKCDkaKt",280,0.996441,24,281,1,280,1,1,0,1,1,143,142,138,138,61
"5577",76,"[24]lnsoIGoHcosHnJHGqKCDkaKt",280,0.996441,24,281,1,280,1,1,0,1,1,158,157,123,123,61
"5578",77,"[24]lnsoIGoHcosHnJHGqKCDkaKt",280,0.996441,24,281,1,280,1,1,0,1,1,145,144,136,136,61
"5579",78,"[24]lnsoIGoHcosHnJHGqKCDkaKt",279,0.996429,24,280,1,279,1,1,0,1,1,143,142,137,137,61
"5580",79,"[24]lnsoIGoHcosHnJHGqKCDkaKt",284,0.996491,24,285,1,284,1,1,0,1,1,142,141,143,143,61
"5581",80,"[24]lnsoIGoHcosHnJHGqKCDkaKt",279,0.996429,24,280,1,279,1,1,0,1,1,147,146,133,133,61
"5582",81,"[24]lnsoIGoHcosHnJHGqKCDkaKt",283,0.996479,24,284,1,283,1,1,0,1,1,137,136,147,147,61
"5583",82,"[24]lnsoIGoHcosHnJHGqKCDkaKt",279,0.996429,24,280,1,279,1,1,0,1,1,142,141,138,138,61
"5584",83,"[24]lnsoIGoHcosHnJHGqKCDkaKt",279,0.996429,24,280,1,279,1,1,0,1,1,125,124,155,155,61
"5585",84,"[24]lnsoIGoHcosHnJHGqKCDkaKt",276,0.99639,24,277,1,276,1,1,0,1,1,139,138,138,138,61
"5586",85,"[24]lnsoIGoHcosHnJHGqKCDkaKt",274,0.996364,24,275,1,274,1,1,0,1,1,148,147,127,127,61
"5587",86,"[24]lnsoIGoHcosHnJHGqKCDkaKt",290,0.996564,24,291,1,290,1,1,0,1,1,157,156,134,134,61
"5588",87,"[24]lnsoIGoHcosHnJHGqKCDkaKt",284,0.996491,24,285,1,284,1,1,0,1,1,130,129,155,155,61
"5589",88,"[24]lnsoIGoHcosHnJHGqKCDkaKt",285,0.996503,24,286,1,285,1,1,0,1,1,164,163,122,122,61
"5590",89,"[24]lnsoIGoHcosHnJHGqKCDkaKt",282,0.996466,24,283,1,282,1,1,0,1,1,136,135,147,147,61
"5591",90,"[24]lnsoIGoHcosHnJHGqKCDkaKt",280,0.996441,24,281,1,280,1,1,0,1,1,140,139,141,141,61
"5592",91,"[24]lnsoIGoHcosHnJHGqKCDkaKt",278,0.996416,24,279,1,278,1,1,0,1,1,127,126,152,152,61
"5593",92,"[24]lnsoIGoHcosHnJHGqKCDkaKt",282,0.996466,24,283,1,282,1,1,0,1,1,148,147,135,135,61
"5594",93,"[24]lnsoIGoHcosHnJHGqKCDkaKt",278,0.996416,24,279,1,278,1,1,0,1,1,131,130,148,148,61
"5595",94,"[24]lnsoIGoHcosHnJHGqKCDkaKt",273,0.99635,24,274,1,273,1,1,0,1,1,133,132,141,141,61
"5596",95,"[24]lnsoIGoHcosHnJHGqKCDkaKt",279,0.996429,24,280,1,279,1,1,0,1,1,127,126,153,153,61
"5597",96,"[24]lnsoIGoHcosHnJHGqKCDkaKt",280,0.996441,24,281,1,280,1,1,0,1,1,150,149,131,131,61
"5598",97,"[24]lnsoIGoHcosHnJHGqKCDkaKt",284,0.996491,24,285,1,284,1,1,0,1,1,130,129,155,155,61
"5599",98,"[24]lnsoIGoHcosHnJHGqKCDkaKt",278,0.996416,24,279,1,278,1,1,0,1,1,151,150,128,128,61
"5600",99,"[24]lnsoIGoHcosHnJHGqKCDkaKt",282,0.996466,24,283,1,282,1,1,0,1,1,141,140,142,142,61
"5601",0,"[23]loIoHcowHnJHGqKCBBsKgIw",273,0.99635,23,274,1,273,1,1,0,1,1,139,138,135,135,62
"5602",1,"[23]loIoHcowHnJHGqKCBBsKgIw",276,0.99639,23,277,1,276,1,1,0,1,1,136,135,141,141,62
"5603",2,"[23]loIoHcowHnJHGqKCBBsKgIw",289,0.996552,23,290,1,289,1,1,0,1,1,151,150,139,139,62
"5604",3,"[23]loIoHcowHnJHGqKCBBsKgIw",275,0.996377,23,276,1,275,1,1,0,1,1,135,134,141,141,62
"5605",4,"[23]loIoHcowHnJHGqKCBBsKgIw",277,0.996403,23,278,1,277,1,1,0,1,1,143,142,135,135,62
"5606",5,"[23]loIoHcowHnJHGqKCBBsKgIw",275,0.996377,23,276,1,275,1,1,0,1,1,131,130,145,145,62
"5607",6,"[23]loIoHcowHnJHGqKCBBsKgIw",285,0.996503,23,286,1,285,1,1,0,1,1,148,147,138,138,62
"5608",7,"[23]loIoHcowHnJHGqKCBBsKgIw",284,0.996491,23,285,1,284,1,1,0,1,1,162,161,123,123,62
"5609",8,"[23]loIoHcowHnJHGqKCBBsKgIw",287,0.996528,23,288,1,287,1,1,0,1,1,150,149,138,138,62
"5610",9,"[23]loIoHcowHnJHGqKCBBsKgIw",282,0.996466,23,283,1,282,1,1,0,1,1,141,140,142,142,62
"5611",10,"[23]loIoHcowHnJHGqKCBBsKgIw",280,0.996441,23,281,1,280,1,1,0,1,1,149,148,132,132,62
"5612",11,"[23]loIoHcowHnJHGqKCBBsKgIw",285,0.996503,23,286,1,285,1,1,0,1,1,155,154,131,131,62
"5613",12,"[23]loIoHcowHnJHGqKCBBsKgIw",279,0.996429,23,280,1,279,1,1,0,1,1,144,143,136,136,62
"5614",13,"[23]loIoHcowHnJHGqKCBBsKgIw",280,0.996441,23,281,1,280,1,1,0,1,1,146,145,135,135,62
"5615",14,"[23]loIoHcowHnJHGqKCBBsKgIw",277,0.996403,23,278,1,277,1,1,0,1,1,121,120,157,157,62
"5616",15,"[23]loIoHcowHnJHGqKCBBsKgIw",278,0.996416,23,279,1,278,1,1,0,1,1,144,143,135,135,62
"5617",16,"[23]loIoHcowHnJHGqKCBBsKgIw",281,0.996454,23,282,1,281,1,1,0,1,1,147,146,135,135,62
"5618",17,"[23]loIoHcowHnJHGqKCBBsKgIw",288,0.99654,23,289,1,288,1,1,0,1,1,147,146,142,142,62
"5619",18,"[23]loIoHcowHnJHGqKCBBsKgIw",277,0.996403,23,278,1,277,1,1,0,1,1,145,144,133,133,62
"5620",19,"[23]loIoHcowHnJHGqKCBBsKgIw",281,0.996454,23,282,1,281,1,1,0,1,1,137,136,145,145,62
"5621",20,"[23]loIoHcowHnJHGqKCBBsKgIw",281,0.996454,23,282,1,281,1,1,0,1,1,136,135,146,146,62
"5622",21,"[23]loIoHcowHnJHGqKCBBsKgIw",278,0.996416,23,279,1,278,1,1,0,1,1,124,123,155,155,62
"5623",22,"[23]loIoHcowHnJHGqKCBBsKgIw",284,0.996491,23,285,1,284,1,1,0,1,1,130,129,155,155,62
"5624",23,"[23]loIoHcowHnJHGqKCBBsKgIw",283,0.996479,23,284,1,283,1,1,0,1,1,160,159,124,124,62
"5625",24,"[23]loIoHcowHnJHGqKCBBsKgIw",284,0.996491,23,285,1,284,1,1,0,1,1,147,146,138,138,62
"5626",25,"[23]loIoHcowHnJHGqKCBBsKgIw",276,0.99639,23,277,1,276,1,1,0,1,1,128,127,149,149,62
"5627",26,"[23]loIoHcowHnJHGqKCBBsKgIw",286,0.996516,23,287,1,286,1,1,0,1,1,150,149,137,137,62
"5628",27,"[23]loIoHcowHnJHGqKCBBsKgIw",278,0.996416,23,279,1,278,1,1,0,1,1,134,133,145,145,62
"5629",28,"[23]loIoHcowHnJHGqKCBBsKgIw",278,0.996416,23,279,1,278,1,1,0,1,1,141,140,138,138,62
"5630",29,"[23]loIoHcowHnJHGqKCBBsKgIw",278,0.996416,23,279,1,278,1,1,0,1,1,147,146,132,132,62
"5631",30,"[23]loIoHcowHnJHGqKCBBsKgIw",285,0.996503,23,286,1,285,1,1,0,1,1,139,138,147,147,62
"5632",31,"[23]loIoHcowHnJHGqKCBBsKgIw",279,0.996429,23,280,1,279,1,1,0,1,1,139,138,141,141,62
"5633",32,"[23]loIoHcowHnJHGqKCBBsKgIw",274,0.996364,23,275,1,274,1,1,0,1,1,132,131,143,143,62
"5634",33,"[23]loIoHcowHnJHGqKCBBsKgIw",286,0.996516,23,287,1,286,1,1,0,1,1,143,142,144,144,62
"5635",34,"[23]loIoHcowHnJHGqKCBBsKgIw",284,0.996491,23,285,1,284,1,1,0,1,1,146,145,139,139,62
"5636",35,"[23]loIoHcowHnJHGqKCBBsKgIw",283,0.996479,23,284,1,283,1,1,0,1,1,140,139,144,144,62
"5637",36,"[23]loIoHcowHnJHGqKCBBsKgIw",286,0.996516,23,287,1,286,1,1,0,1,1,154,153,133,133,62
"5638",37,"[23]loIoHcowHnJHGqKCBBsKgIw",282,0.996466,23,283,1,282,1,1,0,1,1,145,144,138,138,62
"5639",38,"[23]loIoHcowHnJHGqKCBBsKgIw",284,0.996491,23,285,1,284,1,1,0,1,1,144,143,141,141,62
"5640",39,"[23]loIoHcowHnJHGqKCBBsKgIw",284,0.996491,23,285,1,284,1,1,0,1,1,139,138,146,146,62
"5641",40,"[23]loIoHcowHnJHGqKCBBsKgIw",280,0.996441,23,281,1,280,1,1,0,1,1,160,159,121,121,62
"5642",41,"[23]loIoHcowHnJHGqKCBBsKgIw",280,0.996441,23,281,1,280,1,1,0,1,1,120,119,161,161,62
"5643",42,"[23]loIoHcowHnJHGqKCBBsKgIw",284,0.996491,23,285,1,284,1,1,0,1,1,136,135,149,149,62
"5644",43,"[23]loIoHcowHnJHGqKCBBsKgIw",281,0.996454,23,282,1,281,1,1,0,1,1,133,132,149,149,62
"5645",44,"[23]loIoHcowHnJHGqKCBBsKgIw",280,0.996441,23,281,1,280,1,1,0,1,1,140,139,141,141,62
"5646",45,"[23]loIoHcowHnJHGqKCBBsKgIw",278,0.996416,23,279,1,278,1,1,0,1,1,147,146,132,132,62
"5647",46,"[23]loIoHcowHnJHGqKCBBsKgIw",280,0.996441,23,281,1,280,1,1,0,1,1,139,138,142,142,62
"5648",47,"[23]loIoHcowHnJHGqKCBBsKgIw",281,0.996454,23,282,1,281,1,1,0,1,1,152,151,130,130,62
"5649",48,"[23]loIoHcowHnJHGqKCBBsKgIw",286,0.996516,23,287,1,286,1,1,0,1,1,141,140,146,146,62
"5650",49,"[23]loIoHcowHnJHGqKCBBsKgIw",285,0.996503,23,286,1,285,1,1,0,1,1,148,147,138,138,62
"5651",50,"[23]loIoHcowHnJHGqKCBBsKgIw",285,0.996503,23,286,1,285,1,1,0,1,1,136,135,150,150,62
"5652",51,"[23]loIoHcowHnJHGqKCBBsKgIw",285,0.996503,23,286,1,285,1,1,0,1,1,148,147,138,138,62
"5653",52,"[23]loIoHcowHnJHGqKCBBsKgIw",280,0.996441,23,281,1,280,1,1,0,1,1,127,126,154,154,62
"5654",53,"[23]loIoHcowHnJHGqKCBBsKgIw",277,0.996403,23,278,1,277,1,1,0,1,1,133,132,145,145,62
"5655",54,"[23]loIoHcowHnJHGqKCBBsKgIw",279,0.996429,23,280,1,279,1,1,0,1,1,127,126,153,153,62
"5656",55,"[23]loIoHcowHnJHGqKCBBsKgIw",280,0.996441,23,281,1,280,1,1,0,1,1,127,126,154,154,62
"5657",56,"[23]loIoHcowHnJHGqKCBBsKgIw",279,0.996429,23,280,1,279,1,1,0,1,1,136,135,144,144,62
"5658",57,"[23]loIoHcowHnJHGqKCBBsKgIw",288,0.99654,23,289,1,288,1,1,0,1,1,157,156,132,132,62
"5659",58,"[23]loIoHcowHnJHGqKCBBsKgIw",282,0.996466,23,283,1,282,1,1,0,1,1,139,138,144,144,62
"5660",59,"[23]loIoHcowHnJHGqKCBBsKgIw",273,0.99635,23,274,1,273,1,1,0,1,1,126,125,148,148,62
"5661",60,"[23]loIoHcowHnJHGqKCBBsKgIw",279,0.996429,23,280,1,279,1,1,0,1,1,141,140,139,139,62
"5662",61,"[23]loIoHcowHnJHGqKCBBsKgIw",282,0.996466,23,283,1,282,1,1,0,1,1,129,128,154,154,62
"5663",62,"[23]loIoHcowHnJHGqKCBBsKgIw",278,0.996416,23,279,1,278,1,1,0,1,1,126,125,153,153,62
"5664",63,"[23]loIoHcowHnJHGqKCBBsKgIw",282,0.996466,23,283,1,282,1,1,0,1,1,133,132,150,150,62
"5665",64,"[23]loIoHcowHnJHGqKCBBsKgIw",280,0.996441,23,281,1,280,1,1,0,1,1,138,137,143,143,62
"5666",65,"[23]loIoHcowHnJHGqKCBBsKgIw",281,0.996454,23,282,1,281,1,1,0,1,1,136,135,146,146,62
"5667",66,"[23]loIoHcowHnJHGqKCBBsKgIw",288,0.99654,23,289,1,288,1,1,0,1,1,147,146,142,142,62
"5668",67,"[23]loIoHcowHnJHGqKCBBsKgIw",283,0.996479,23,284,1,283,1,1,0,1,1,142,141,142,142,62
"5669",68,"[23]loIoHcowHnJHGqKCBBsKgIw",280,0.996441,23,281,1,280,1,1,0,1,1,135,134,146,146,62
"5670",69,"[23]loIoHcowHnJHGqKCBBsKgIw",281,0.996454,23,282,1,281,1,1,0,1,1,143,142,139,139,62
"5671",70,"[23]loIoHcowHnJHGqKCBBsKgIw",283,0.996479,23,284,1,283,1,1,0,1,1,140,139,144,144,62
"5672",71,"[23]loIoHcowHnJHGqKCBBsKgIw",279,0.996429,23,280,1,279,1,1,0,1,1,139,138,141,141,62
"5673",72,"[23]loIoHcowHnJHGqKCBBsKgIw",282,0.996466,23,283,1,282,1,1,0,1,1,143,142,140,140,62
"5674",73,"[23]loIoHcowHnJHGqKCBBsKgIw",280,0.996441,23,281,1,280,1,1,0,1,1,141,140,140,140,62
"5675",74,"[23]loIoHcowHnJHGqKCBBsKgIw",286,0.996516,23,287,1,286,1,1,0,1,1,145,144,142,142,62
"5676",75,"[23]loIoHcowHnJHGqKCBBsKgIw",279,0.996429,23,280,1,279,1,1,0,1,1,135,134,145,145,62
"5677",76,"[23]loIoHcowHnJHGqKCBBsKgIw",278,0.996416,23,279,1,278,1,1,0,1,1,126,125,153,153,62
"5678",77,"[23]loIoHcowHnJHGqKCBBsKgIw",280,0.996441,23,281,1,280,1,1,0,1,1,129,128,152,152,62
"5679",78,"[23]loIoHcowHnJHGqKCBBsKgIw",284,0.996491,23,285,1,284,1,1,0,1,1,150,149,135,135,62
"5680",79,"[23]loIoHcowHnJHGqKCBBsKgIw",280,0.996441,23,281,1,280,1,1,0,1,1,139,138,142,142,62
"5681",80,"[23]loIoHcowHnJHGqKCBBsKgIw",279,0.996429,23,280,1,279,1,1,0,1,1,143,142,137,137,62
"5682",81,"[23]loIoHcowHnJHGqKCBBsKgIw",278,0.996416,23,279,1,278,1,1,0,1,1,131,130,148,148,62
"5683",82,"[23]loIoHcowHnJHGqKCBBsKgIw",286,0.996516,23,287,1,286,1,1,0,1,1,139,138,148,148,62
"5684",83,"[23]loIoHcowHnJHGqKCBBsKgIw",279,0.996429,23,280,1,279,1,1,0,1,1,141,140,139,139,62
"5685",84,"[23]loIoHcowHnJHGqKCBBsKgIw",282,0.996466,23,283,1,282,1,1,0,1,1,139,138,144,144,62
"5686",85,"[23]loIoHcowHnJHGqKCBBsKgIw",277,0.996403,23,278,1,277,1,1,0,1,1,136,135,142,142,62
"5687",86,"[23]loIoHcowHnJHGqKCBBsKgIw",287,0.996528,23,288,1,287,1,1,0,1,1,159,158,129,129,62
"5688",87,"[23]loIoHcowHnJHGqKCBBsKgIw",286,0.996516,23,287,1,286,1,1,0,1,1,145,144,142,142,62
"5689",88,"[23]loIoHcowHnJHGqKCBBsKgIw",280,0.996441,23,281,1,280,1,1,0,1,1,132,131,149,149,62
"5690",89,"[23]loIoHcowHnJHGqKCBBsKgIw",285,0.996503,23,286,1,285,1,1,0,1,1,156,155,130,130,62
"5691",90,"[23]loIoHcowHnJHGqKCBBsKgIw",281,0.996454,23,282,1,281,1,1,0,1,1,151,150,131,131,62
"5692",91,"[23]loIoHcowHnJHGqKCBBsKgIw",280,0.996441,23,281,1,280,1,1,0,1,1,135,134,146,146,62
"5693",92,"[23]loIoHcowHnJHGqKCBBsKgIw",285,0.996503,23,286,1,285,1,1,0,1,1,157,156,129,129,62
"5694",93,"[23]loIoHcowHnJHGqKCBBsKgIw",276,0.99639,23,277,1,276,1,1,0,1,1,136,135,141,141,62
"5695",94,"[23]loIoHcowHnJHGqKCBBsKgIw",284,0.996491,23,285,1,284,1,1,0,1,1,153,152,132,132,62
"5696",95,"[23]loIoHcowHnJHGqKCBBsKgIw",280,0.996441,23,281,1,280,1,1,0,1,1,145,144,136,136,62
"5697",96,"[23]loIoHcowHnJHGqKCBBsKgIw",283,0.996479,23,284,1,283,1,1,0,1,1,151,150,133,133,62
"5698",97,"[23]loIoHcowHnJHGqKCBBsKgIw",285,0.996503,23,286,1,285,1,1,0,1,1,160,159,126,126,62
"5699",98,"[23]loIoHcowHnJHGqKCBBsKgIw",279,0.996429,23,280,1,279,1,1,0,1,1,140,139,140,140,62
"5700",99,"[23]loIoHcowHnJHGqKCBBsKgIw",276,0.99639,23,277,1,276,1,1,0,1,1,127,126,150,150,62
"5701",0,"[17]BoIoHcosHnJHGqKCE",282,0.996466,17,283,1,282,1,1,0,1,1,139,138,144,144,64
"5702",1,"[17]BoIoHcosHnJHGqKCE",284,0.996491,17,285,1,284,1,1,0,1,1,148,147,137,137,64
"5703",2,"[17]BoIoHcosHnJHGqKCE",278,0.996416,17,279,1,278,1,1,0,1,1,140,139,139,139,64
"5704",3,"[17]BoIoHcosHnJHGqKCE",279,0.996429,17,280,1,279,1,1,0,1,1,138,137,142,142,64
"5705",4,"[17]BoIoHcosHnJHGqKCE",275,0.996377,17,276,1,275,1,1,0,1,1,139,138,137,137,64
"5706",5,"[17]BoIoHcosHnJHGqKCE",287,0.996528,17,288,1,287,1,1,0,1,1,147,146,141,141,64
"5707",6,"[17]BoIoHcosHnJHGqKCE",282,0.996466,17,283,1,282,1,1,0,1,1,133,132,150,150,64
"5708",7,"[17]BoIoHcosHnJHGqKCE",287,0.996528,17,288,1,287,1,1,0,1,1,151,150,137,137,64
"5709",8,"[17]BoIoHcosHnJHGqKCE",273,0.99635,17,274,1,273,1,1,0,1,1,141,140,133,133,64
"5710",9,"[17]BoIoHcosHnJHGqKCE",278,0.996416,17,279,1,278,1,1,0,1,1,142,141,137,137,64
"5711",10,"[17]BoIoHcosHnJHGqKCE",275,0.996377,17,276,1,275,1,1,0,1,1,131,130,145,145,64
"5712",11,"[17]BoIoHcosHnJHGqKCE",279,0.996429,17,280,1,279,1,1,0,1,1,141,140,139,139,64
"5713",12,"[17]BoIoHcosHnJHGqKCE",279,0.996429,17,280,1,279,1,1,0,1,1,143,142,137,137,64
"5714",13,"[17]BoIoHcosHnJHGqKCE",286,0.996516,17,287,1,286,1,1,0,1,1,157,156,130,130,64
"5715",14,"[17]BoIoHcosHnJHGqKCE",282,0.996466,17,283,1,282,1,1,0,1,1,116,115,167,167,64
"5716",15,"[17]BoIoHcosHnJHGqKCE",278,0.996416,17,279,1,278,1,1,0,1,1,142,141,137,137,64
"5717",16,"[17]BoIoHcosHnJHGqKCE",288,0.99654,17,289,1,288,1,1,0,1,1,154,153,135,135,64
"5718",17,"[17]BoIoHcosHnJHGqKCE",278,0.996416,17,279,1,278,1,1,0,1,1,136,135,143,143,64
"5719",18,"[17]BoIoHcosHnJHGqKCE",277,0.996403,17,278,1,277,1,1,0,1,1,131,130,147,147,64
"5720",19,"[17]BoIoHcosHnJHGqKCE",282,0.996466,17,283,1,282,1,1,0,1,1,141,140,142,142,64
"5721",20,"[17]BoIoHcosHnJHGqKCE",280,0.996441,17,281,1,280,1,1,0,1,1,145,144,136,136,64
"5722",21,"[17]BoIoHcosHnJHGqKCE",285,0.996503,17,286,1,285,1,1,0,1,1,140,139,146,146,64
"5723",22,"[17]BoIoHcosHnJHGqKCE",285,0.996503,17,286,1,285,1,1,0,1,1,152,151,134,134,64
"5724",23,"[17]BoIoHcosHnJHGqKCE",285,0.996503,17,286,1,285,1,1,0,1,1,136,135,150,150,64
"5725",24,"[17]BoIoHcosHnJHGqKCE",287,0.996528,17,288,1,287,1,1,0,1,1,126,125,162,162,64
"5726",25,"[17]BoIoHcosHnJHGqKCE",276,0.99639,17,277,1,276,1,1,0,1,1,121,120,156,156,64
"5727",26,"[17]BoIoHcosHnJHGqKCE",290,0.996564,17,291,1,290,1,1,0,1,1,135,134,156,156,64
"5728",27,"[17]BoIoHcosHnJHGqKCE",284,0.996491,17,285,1,284,1,1,0,1,1,150,149,135,135,64
"5729",28,"[17]BoIoHcosHnJHGqKCE",277,0.996403,17,278,1,277,1,1,0,1,1,135,134,143,143,64
"5730",29,"[17]BoIoHcosHnJHGqKCE",279,0.996429,17,280,1,279,1,1,0,1,1,130,129,150,150,64
"5731",30,"[17]BoIoHcosHnJHGqKCE",282,0.996466,17,283,1,282,1,1,0,1,1,133,132,150,150,64
"5732",31,"[17]BoIoHcosHnJHGqKCE",273,0.99635,17,274,1,273,1,1,0,1,1,136,135,138,138,64
"5733",32,"[17]BoIoHcosHnJHGqKCE",276,0.99639,17,277,1,276,1,1,0,1,1,142,141,135,135,64
"5734",33,"[17]BoIoHcosHnJHGqKCE",274,0.996364,17,275,1,274,1,1,0,1,1,131,130,144,144,64
"5735",34,"[17]BoIoHcosHnJHGqKCE",285,0.996503,17,286,1,285,1,1,0,1,1,146,145,140,140,64
"5736",35,"[17]BoIoHcosHnJHGqKCE",284,0.996491,17,285,1,284,1,1,0,1,1,147,146,138,138,64
"5737",36,"[17]BoIoHcosHnJHGqKCE",279,0.996429,17,280,1,279,1,1,0,1,1,136,135,144,144,64
"5738",37,"[17]BoIoHcosHnJHGqKCE",289,0.996552,17,290,1,289,1,1,0,1,1,136,135,154,154,64
"5739",38,"[17]BoIoHcosHnJHGqKCE",284,0.996491,17,285,1,284,1,1,0,1,1,137,136,148,148,64
"5740",39,"[17]BoIoHcosHnJHGqKCE",281,0.996454,17,282,1,281,1,1,0,1,1,132,131,150,150,64
"5741",40,"[17]BoIoHcosHnJHGqKCE",284,0.996491,17,285,1,284,1,1,0,1,1,135,134,150,150,64
"5742",41,"[17]BoIoHcosHnJHGqKCE",283,0.996479,17,284,1,283,1,1,0,1,1,148,147,136,136,64
"5743",42,"[17]BoIoHcosHnJHGqKCE",278,0.996416,17,279,1,278,1,1,0,1,1,143,142,136,136,64
"5744",43,"[17]BoIoHcosHnJHGqKCE",280,0.996441,17,281,1,280,1,1,0,1,1,151,150,130,130,64
"5745",44,"[17]BoIoHcosHnJHGqKCE",284,0.996491,17,285,1,284,1,1,0,1,1,140,139,145,145,64
"5746",45,"[17]BoIoHcosHnJHGqKCE",282,0.996466,17,283,1,282,1,1,0,1,1,134,133,149,149,64
"5747",46,"[17]BoIoHcosHnJHGqKCE",283,0.996479,17,284,1,283,1,1,0,1,1,161,160,123,123,64
"5748",47,"[17]BoIoHcosHnJHGqKCE",280,0.996441,17,281,1,280,1,1,0,1,1,146,145,135,135,64
"5749",48,"[17]BoIoHcosHnJHGqKCE",282,0.996466,17,283,1,282,1,1,0,1,1,143,142,140,140,64
"5750",49,"[17]BoIoHcosHnJHGqKCE",286,0.996516,17,287,1,286,1,1,0,1,1,149,148,138,138,64
"5751",50,"[17]BoIoHcosHnJHGqKCE",282,0.996466,17,283,1,282,1,1,0,1,1,138,137,145,145,64
"5752",51,"[17]BoIoHcosHnJHGqKCE",286,0.996516,17,287,1,286,1,1,0,1,1,142,141,145,145,64
"5753",52,"[17]BoIoHcosHnJHGqKCE",287,0.996528,17,288,1,287,1,1,0,1,1,140,139,148,148,64
"5754",53,"[17]BoIoHcosHnJHGqKCE",285,0.996503,17,286,1,285,1,1,0,1,1,154,153,132,132,64
"5755",54,"[17]BoIoHcosHnJHGqKCE",282,0.996466,17,283,1,282,1,1,0,1,1,150,149,133,133,64
"5756",55,"[17]BoIoHcosHnJHGqKCE",276,0.99639,17,277,1,276,1,1,0,1,1,127,126,150,150,64
"5757",56,"[17]BoIoHcosHnJHGqKCE",278,0.996416,17,279,1,278,1,1,0,1,1,146,145,133,133,64
"5758",57,"[17]BoIoHcosHnJHGqKCE",280,0.996441,17,281,1,280,1,1,0,1,1,142,141,139,139,64
"5759",58,"[17]BoIoHcosHnJHGqKCE",279,0.996429,17,280,1,279,1,1,0,1,1,147,146,133,133,64
"5760",59,"[17]BoIoHcosHnJHGqKCE",282,0.996466,17,283,1,282,1,1,0,1,1,137,136,146,146,64
"5761",60,"[17]BoIoHcosHnJHGqKCE",284,0.996491,17,285,1,284,1,1,0,1,1,155,154,130,130,64
"5762",61,"[17]BoIoHcosHnJHGqKCE",289,0.996552,17,290,1,289,1,1,0,1,1,146,145,144,144,64
"5763",62,"[17]BoIoHcosHnJHGqKCE",286,0.996516,17,287,1,286,1,1,0,1,1,147,146,140,140,64
"5764",63,"[17]BoIoHcosHnJHGqKCE",293,0.996599,17,294,1,293,1,1,0,1,1,148,147,146,146,64
"5765",64,"[17]BoIoHcosHnJHGqKCE",283,0.996479,17,284,1,283,1,1,0,1,1,135,134,149,149,64
"5766",65,"[17]BoIoHcosHnJHGqKCE",285,0.996503,17,286,1,285,1,1,0,1,1,144,143,142,142,64
"5767",66,"[17]BoIoHcosHnJHGqKCE",277,0.996403,17,278,1,277,1,1,0,1,1,127,126,151,151,64
"5768",67,"[17]BoIoHcosHnJHGqKCE",285,0.996503,17,286,1,285,1,1,0,1,1,140,139,146,146,64
"5769",68,"[17]BoIoHcosHnJHGqKCE",285,0.996503,17,286,1,285,1,1,0,1,1,152,151,134,134,64
"5770",69,"[17]BoIoHcosHnJHGqKCE",278,0.996416,17,279,1,278,1,1,0,1,1,131,130,148,148,64
"5771",70,"[17]BoIoHcosHnJHGqKCE",286,0.996516,17,287,1,286,1,1,0,1,1,144,143,143,143,64
"5772",71,"[17]BoIoHcosHnJHGqKCE",284,0.996491,17,285,1,284,1,1,0,1,1,147,146,138,138,64
"5773",72,"[17]BoIoHcosHnJHGqKCE",278,0.996416,17,279,1,278,1,1,0,1,1,129,128,150,150,64
"5774",73,"[17]BoIoHcosHnJHGqKCE",282,0.996466,17,283,1,282,1,1,0,1,1,146,145,137,137,64
"5775",74,"[17]BoIoHcosHnJHGqKCE",278,0.996416,17,279,1,278,1,1,0,1,1,134,133,145,145,64
"5776",75,"[17]BoIoHcosHnJHGqKCE",285,0.996503,17,286,1,285,1,1,0,1,1,155,154,131,131,64
"5777",76,"[17]BoIoHcosHnJHGqKCE",282,0.996466,17,283,1,282,1,1,0,1,1,153,152,130,130,64
"5778",77,"[17]BoIoHcosHnJHGqKCE",285,0.996503,17,286,1,285,1,1,0,1,1,140,139,146,146,64
"5779",78,"[17]BoIoHcosHnJHGqKCE",279,0.996429,17,280,1,279,1,1,0,1,1,143,142,137,137,64
"5780",79,"[17]BoIoHcosHnJHGqKCE",278,0.996416,17,279,1,278,1,1,0,1,1,127,126,152,152,64
"5781",80,"[17]BoIoHcosHnJHGqKCE",282,0.996466,17,283,1,282,1,1,0,1,1,154,153,129,129,64
"5782",81,"[17]BoIoHcosHnJHGqKCE",275,0.996377,17,276,1,275,1,1,0,1,1,136,135,140,140,64
"5783",82,"[17]BoIoHcosHnJHGqKCE",292,0.996587,17,293,1,292,1,1,0,1,1,162,161,131,131,64
"5784",83,"[17]BoIoHcosHnJHGqKCE",271,0.996324,17,272,1,271,1,1,0,1,1,142,141,130,130,64
"5785",84,"[17]BoIoHcosHnJHGqKCE",275,0.996377,17,276,1,275,1,1,0,1,1,139,138,137,137,64
"5786",85,"[17]BoIoHcosHnJHGqKCE",284,0.996491,17,285,1,284,1,1,0,1,1,143,142,142,142,64
"5787",86,"[17]BoIoHcosHnJHGqKCE",281,0.996454,17,282,1,281,1,1,0,1,1,133,132,149,149,64
"5788",87,"[17]BoIoHcosHnJHGqKCE",276,0.99639,17,277,1,276,1,1,0,1,1,133,132,144,144,64
"5789",88,"[17]BoIoHcosHnJHGqKCE",281,0.996454,17,282,1,281,1,1,0,1,1,136,135,146,146,64
"5790",89,"[17]BoIoHcosHnJHGqKCE",276,0.99639,17,277,1,276,1,1,0,1,1,141,140,136,136,64
"5791",90,"[17]BoIoHcosHnJHGqKCE",280,0.996441,17,281,1,280,1,1,0,1,1,144,143,137,137,64
"5792",91,"[17]BoIoHcosHnJHGqKCE",287,0.996528,17,288,1,287,1,1,0,1,1,136,135,152,152,64
"5793",92,"[17]BoIoHcosHnJHGqKCE",285,0.996503,17,286,1,285,1,1,0,1,1,148,147,138,138,64
"5794",93,"[17]BoIoHcosHnJHGqKCE",280,0.996441,17,281,1,280,1,1,0,1,1,142,141,139,139,64
"5795",94,"[17]BoIoHcosHnJHGqKCE",279,0.996429,17,280,1,279,1,1,0,1,1,141,140,139,139,64
"5796",95,"[17]BoIoHcosHnJHGqKCE",283,0.996479,17,284,1,283,1,1,0,1,1,162,161,122,122,64
"5797",96,"[17]BoIoHcosHnJHGqKCE",280,0.996441,17,281,1,280,1,1,0,1,1,155,154,126,126,64
"5798",97,"[17]BoIoHcosHnJHGqKCE",280,0.996441,17,281,1,280,1,1,0,1,1,156,155,125,125,64
"5799",98,"[17]BoIoHcosHnJHGqKCE",285,0.996503,17,286,1,285,1,1,0,1,1,143,142,143,143,64
"5800",99,"[17]BoIoHcosHnJHGqKCE",276,0.99639,17,277,1,276,1,1,0,1,1,139,138,138,138,64
"5801",0,"[27]HAFHoIoHcouHnJHGqKCBuDFkAyD",278,0.996416,27,279,1,278,1,1,0,1,1,146,145,133,133,66
"5802",1,"[27]HAFHoIoHcouHnJHGqKCBuDFkAyD",290,0.996564,27,291,1,290,1,1,0,1,1,151,150,140,140,66
"5803",2,"[27]HAFHoIoHcouHnJHGqKCBuDFkAyD",288,0.99654,27,289,1,288,1,1,0,1,1,155,154,134,134,66
"5804",3,"[27]HAFHoIoHcouHnJHGqKCBuDFkAyD",281,0.996454,27,282,1,281,1,1,0,1,1,137,136,145,145,66
"5805",4,"[27]HAFHoIoHcouHnJHGqKCBuDFkAyD",287,0.996528,27,288,1,287,1,1,0,1,1,144,143,144,144,66
"5806",5,"[27]HAFHoIoHcouHnJHGqKCBuDFkAyD",272,0.996337,27,273,1,272,1,1,0,1,1,125,124,148,148,66
"5807",6,"[27]HAFHoIoHcouHnJHGqKCBuDFkAyD",277,0.996403,27,278,1,277,1,1,0,1,1,146,145,132,132,66
"5808",7,"[27]HAFHoIoHcouHnJHGqKCBuDFkAyD",287,0.996528,27,288,1,287,1,1,0,1,1,156,155,132,132,66
"5809",8,"[27]HAFHoIoHcouHnJHGqKCBuDFkAyD",277,0.996403,27,278,1,277,1,1,0,1,1,138,137,140,140,66
"5810",9,"[27]HAFHoIoHcouHnJHGqKCBuDFkAyD",284,0.996491,27,285,1,284,1,1,0,1,1,139,138,146,146,66
"5811",10,"[27]HAFHoIoHcouHnJHGqKCBuDFkAyD",271,0.996324,27,272,1,271,1,1,0,1,1,123,122,149,149,66
"5812",11,"[27]HAFHoIoHcouHnJHGqKCBuDFkAyD",274,0.996364,27,275,1,274,1,1,0,1,1,133,132,142,142,66
"5813",12,"[27]HAFHoIoHcouHnJHGqKCBuDFkAyD",278,0.996416,27,279,1,278,1,1,0,1,1,129,128,150,150,66
"5814",13,"[27]HAFHoIoHcouHnJHGqKCBuDFkAyD",276,0.99639,27,277,1,276,1,1,0,1,1,135,134,142,142,66
"5815",14,"[27]HAFHoIoHcouHnJHGqKCBuDFkAyD",284,0.996491,27,285,1,284,1,1,0,1,1,138,137,147,147,66
"5816",15,"[27]HAFHoIoHcouHnJHGqKCBuDFkAyD",281,0.996454,27,282,1,281,1,1,0,1,1,140,139,142,142,66
"5817",16,"[27]HAFHoIoHcouHnJHGqKCBuDFkAyD",274,0.996364,27,275,1,274,1,1,0,1,1,123,122,152,152,66
"5818",17,"[27]HAFHoIoHcouHnJHGqKCBuDFkAyD",277,0.996403,27,278,1,277,1,1,0,1,1,144,143,134,134,66
"5819",18,"[27]HAFHoIoHcouHnJHGqKCBuDFkAyD",281,0.996454,27,282,1,281,1,1,0,1,1,134,133,148,148,66
"5820",19,"[27]HAFHoIoHcouHnJHGqKCBuDFkAyD",286,0.996516,27,287,1,286,1,1,0,1,1,152,151,135,135,66
"5821",20,"[27]HAFHoIoHcouHnJHGqKCBuDFkAyD",283,0.996479,27,284,1,283,1,1,0,1,1,137,136,147,147,66
"5822",21,"[27]HAFHoIoHcouHnJHGqKCBuDFkAyD",281,0.996454,27,282,1,281,1,1,0,1,1,139,138,143,143,66
"5823",22,"[27]HAFHoIoHcouHnJHGqKCBuDFkAyD",285,0.996503,27,286,1,285,1,1,0,1,1,137,136,149,149,66
"5824",23,"[27]HAFHoIoHcouHnJHGqKCBuDFkAyD",280,0.996441,27,281,1,280,1,1,0,1,1,155,154,126,126,66
"5825",24,"[27]HAFHoIoHcouHnJHGqKCBuDFkAyD",270,0.99631,27,271,1,270,1,1,0,1,1,119,118,152,152,66
"5826",25,"[27]HAFHoIoHcouHnJHGqKCBuDFkAyD",281,0.996454,27,282,1,281,1,1,0,1,1,150,149,132,132,66
"5827",26,"[27]HAFHoIoHcouHnJHGqKCBuDFkAyD",279,0.996429,27,280,1,279,1,1,0,1,1,144,143,136,136,66
"5828",27,"[27]HAFHoIoHcouHnJHGqKCBuDFkAyD",277,0.996403,27,278,1,277,1,1,0,1,1,140,139,138,138,66
"5829",28,"[27]HAFHoIoHcouHnJHGqKCBuDFkAyD",274,0.996364,27,275,1,274,1,1,0,1,1,144,143,131,131,66
"5830",29,"[27]HAFHoIoHcouHnJHGqKCBuDFkAyD",282,0.996466,27,283,1,282,1,1,0,1,1,147,146,136,136,66
"5831",30,"[27]HAFHoIoHcouHnJHGqKCBuDFkAyD",281,0.996454,27,282,1,281,1,1,0,1,1,157,156,125,125,66
"5832",31,"[27]HAFHoIoHcouHnJHGqKCBuDFkAyD",275,0.996377,27,276,1,275,1,1,0,1,1,136,135,140,140,66
"5833",32,"[27]HAFHoIoHcouHnJHGqKCBuDFkAyD",278,0.996416,27,279,1,278,1,1,0,1,1,139,138,140,140,66
"5834",33,"[27]HAFHoIoHcouHnJHGqKCBuDFkAyD",277,0.996403,27,278,1,277,1,1,0,1,1,125,124,153,153,66
"5835",34,"[27]HAFHoIoHcouHnJHGqKCBuDFkAyD",271,0.996324,27,272,1,271,1,1,0,1,1,128,127,144,144,66
"5836",35,"[27]HAFHoIoHcouHnJHGqKCBuDFkAyD",277,0.996403,27,278,1,277,1,1,0,1,1,125,124,153,153,66
"5837",36,"[27]HAFHoIoHcouHnJHGqKCBuDFkAyD",280,0.996441,27,281,1,280,1,1,0,1,1,150,149,131,131,66
"5838",37,"[27]HAFHoIoHcouHnJHGqKCBuDFkAyD",286,0.996516,27,287,1,286,1,1,0,1,1,153,152,134,134,66
"5839",38,"[27]HAFHoIoHcouHnJHGqKCBuDFkAyD",277,0.996403,27,278,1,277,1,1,0,1,1,145,144,133,133,66
"5840",39,"[27]HAFHoIoHcouHnJHGqKCBuDFkAyD",278,0.996416,27,279,1,278,1,1,0,1,1,137,136,142,142,66
"5841",40,"[27]HAFHoIoHcouHnJHGqKCBuDFkAyD",284,0.996491,27,285,1,284,1,1,0,1,1,135,134,150,150,66
"5842",41,"[27]HAFHoIoHcouHnJHGqKCBuDFkAyD",275,0.996377,27,276,1,275,1,1,0,1,1,130,129,146,146,66
"5843",42,"[27]HAFHoIoHcouHnJHGqKCBuDFkAyD",273,0.99635,27,274,1,273,1,1,0,1,1,132,131,142,142,66
"5844",43,"[27]HAFHoIoHcouHnJHGqKCBuDFkAyD",277,0.996403,27,278,1,277,1,1,0,1,1,140,139,138,138,66
"5845",44,"[27]HAFHoIoHcouHnJHGqKCBuDFkAyD",282,0.996466,27,283,1,282,1,1,0,1,1,150,149,133,133,66
"5846",45,"[27]HAFHoIoHcouHnJHGqKCBuDFkAyD",281,0.996454,27,282,1,281,1,1,0,1,1,140,139,142,142,66
"5847",46,"[27]HAFHoIoHcouHnJHGqKCBuDFkAyD",283,0.996479,27,284,1,283,1,1,0,1,1,146,145,138,138,66
"5848",47,"[27]HAFHoIoHcouHnJHGqKCBuDFkAyD",285,0.996503,27,286,1,285,1,1,0,1,1,157,156,129,129,66
"5849",48,"[27]HAFHoIoHcouHnJHGqKCBuDFkAyD",282,0.996466,27,283,1,282,1,1,0,1,1,131,130,152,152,66
"5850",49,"[27]HAFHoIoHcouHnJHGqKCBuDFkAyD",280,0.996441,27,281,1,280,1,1,0,1,1,143,142,138,138,66
"5851",50,"[27]HAFHoIoHcouHnJHGqKCBuDFkAyD",280,0.996441,27,281,1,280,1,1,0,1,1,145,144,136,136,66
"5852",51,"[27]HAFHoIoHcouHnJHGqKCBuDFkAyD",274,0.996364,27,275,1,274,1,1,0,1,1,137,136,138,138,66
"5853",52,"[27]HAFHoIoHcouHnJHGqKCBuDFkAyD",286,0.996516,27,287,1,286,1,1,0,1,1,140,139,147,147,66
"5854",53,"[27]HAFHoIoHcouHnJHGqKCBuDFkAyD",276,0.99639,27,277,1,276,1,1,0,1,1,131,130,146,146,66
"5855",54,"[27]HAFHoIoHcouHnJHGqKCBuDFkAyD",281,0.996454,27,282,1,281,1,1,0,1,1,155,154,127,127,66
"5856",55,"[27]HAFHoIoHcouHnJHGqKCBuDFkAyD",280,0.996441,27,281,1,280,1,1,0,1,1,135,134,146,146,66
"5857",56,"[27]HAFHoIoHcouHnJHGqKCBuDFkAyD",275,0.996377,27,276,1,275,1,1,0,1,1,127,126,149,149,66
"5858",57,"[27]HAFHoIoHcouHnJHGqKCBuDFkAyD",277,0.996403,27,278,1,277,1,1,0,1,1,145,144,133,133,66
"5859",58,"[27]HAFHoIoHcouHnJHGqKCBuDFkAyD",280,0.996441,27,281,1,280,1,1,0,1,1,141,140,140,140,66
"5860",59,"[27]HAFHoIoHcouHnJHGqKCBuDFkAyD",286,0.996516,27,287,1,286,1,1,0,1,1,147,146,140,140,66
"5861",60,"[27]HAFHoIoHcouHnJHGqKCBuDFkAyD",288,0.99654,27,289,1,288,1,1,0,1,1,147,146,142,142,66
"5862",61,"[27]HAFHoIoHcouHnJHGqKCBuDFkAyD",285,0.996503,27,286,1,285,1,1,0,1,1,139,138,147,147,66
"5863",62,"[27]HAFHoIoHcouHnJHGqKCBuDFkAyD",280,0.996441,27,281,1,280,1,1,0,1,1,140,139,141,141,66
"5864",63,"[27]HAFHoIoHcouHnJHGqKCBuDFkAyD",281,0.996454,27,282,1,281,1,1,0,1,1,142,141,140,140,66
"5865",64,"[27]HAFHoIoHcouHnJHGqKCBuDFkAyD",284,0.996491,27,285,1,284,1,1,0,1,1,139,138,146,146,66
"5866",65,"[27]HAFHoIoHcouHnJHGqKCBuDFkAyD",282,0.996466,27,283,1,282,1,1,0,1,1,140,139,143,143,66
"5867",66,"[27]HAFHoIoHcouHnJHGqKCBuDFkAyD",288,0.99654,27,289,1,288,1,1,0,1,1,144,143,145,145,66
"5868",67,"[27]HAFHoIoHcouHnJHGqKCBuDFkAyD",287,0.996528,27,288,1,287,1,1,0,1,1,154,153,134,134,66
"5869",68,"[27]HAFHoIoHcouHnJHGqKCBuDFkAyD",275,0.996377,27,276,1,275,1,1,0,1,1,135,134,141,141,66
"5870",69,"[27]HAFHoIoHcouHnJHGqKCBuDFkAyD",280,0.996441,27,281,1,280,1,1,0,1,1,134,133,147,147,66
"5871",70,"[27]HAFHoIoHcouHnJHGqKCBuDFkAyD",279,0.996429,27,280,1,279,1,1,0,1,1,142,141,138,138,66
"5872",71,"[27]HAFHoIoHcouHnJHGqKCBuDFkAyD",280,0.996441,27,281,1,280,1,1,0,1,1,141,140,140,140,66
"5873",72,"[27]HAFHoIoHcouHnJHGqKCBuDFkAyD",282,0.996466,27,283,1,282,1,1,0,1,1,140,139,143,143,66
"5874",73,"[27]HAFHoIoHcouHnJHGqKCBuDFkAyD",275,0.996377,27,276,1,275,1,1,0,1,1,133,132,143,143,66
"5875",74,"[27]HAFHoIoHcouHnJHGqKCBuDFkAyD",272,0.996337,27,273,1,272,1,1,0,1,1,127,126,146,146,66
"5876",75,"[27]HAFHoIoHcouHnJHGqKCBuDFkAyD",284,0.996491,27,285,1,284,1,1,0,1,1,154,153,131,131,66
"5877",76,"[27]HAFHoIoHcouHnJHGqKCBuDFkAyD",288,0.99654,27,289,1,288,1,1,0,1,1,148,147,141,141,66
"5878",77,"[27]HAFHoIoHcouHnJHGqKCBuDFkAyD",285,0.996503,27,286,1,285,1,1,0,1,1,146,145,140,140,66
"5879",78,"[27]HAFHoIoHcouHnJHGqKCBuDFkAyD",282,0.996466,27,283,1,282,1,1,0,1,1,149,148,134,134,66
"5880",79,"[27]HAFHoIoHcouHnJHGqKCBuDFkAyD",277,0.996403,27,278,1,277,1,1,0,1,1,150,149,128,128,66
"5881",80,"[27]HAFHoIoHcouHnJHGqKCBuDFkAyD",281,0.996454,27,282,1,281,1,1,0,1,1,142,141,140,140,66
"5882",81,"[27]HAFHoIoHcouHnJHGqKCBuDFkAyD",287,0.996528,27,288,1,287,1,1,0,1,1,135,134,153,153,66
"5883",82,"[27]HAFHoIoHcouHnJHGqKCBuDFkAyD",273,0.99635,27,274,1,273,1,1,0,1,1,136,135,138,138,66
"5884",83,"[27]HAFHoIoHcouHnJHGqKCBuDFkAyD",281,0.996454,27,282,1,281,1,1,0,1,1,153,152,129,129,66
"5885",84,"[27]HAFHoIoHcouHnJHGqKCBuDFkAyD",276,0.99639,27,277,1,276,1,1,0,1,1,137,136,140,140,66
"5886",85,"[27]HAFHoIoHcouHnJHGqKCBuDFkAyD",285,0.996503,27,286,1,285,1,1,0,1,1,145,144,141,141,66
"5887",86,"[27]HAFHoIoHcouHnJHGqKCBuDFkAyD",289,0.996552,27,290,1,289,1,1,0,1,1,158,157,132,132,66
"5888",87,"[27]HAFHoIoHcouHnJHGqKCBuDFkAyD",285,0.996503,27,286,1,285,1,1,0,1,1,140,139,146,146,66
"5889",88,"[27]HAFHoIoHcouHnJHGqKCBuDFkAyD",285,0.996503,27,286,1,285,1,1,0,1,1,145,144,141,141,66
"5890",89,"[27]HAFHoIoHcouHnJHGqKCBuDFkAyD",279,0.996429,27,280,1,279,1,1,0,1,1,140,139,140,140,66
"5891",90,"[27]HAFHoIoHcouHnJHGqKCBuDFkAyD",289,0.996552,27,290,1,289,1,1,0,1,1,144,143,146,146,66
"5892",91,"[27]HAFHoIoHcouHnJHGqKCBuDFkAyD",282,0.996466,27,283,1,282,1,1,0,1,1,145,144,138,138,66
"5893",92,"[27]HAFHoIoHcouHnJHGqKCBuDFkAyD",281,0.996454,27,282,1,281,1,1,0,1,1,136,135,146,146,66
"5894",93,"[27]HAFHoIoHcouHnJHGqKCBuDFkAyD",283,0.996479,27,284,1,283,1,1,0,1,1,151,150,133,133,66
"5895",94,"[27]HAFHoIoHcouHnJHGqKCBuDFkAyD",280,0.996441,27,281,1,280,1,1,0,1,1,138,137,143,143,66
"5896",95,"[27]HAFHoIoHcouHnJHGqKCBuDFkAyD",279,0.996429,27,280,1,279,1,1,0,1,1,143,142,137,137,66
"5897",96,"[27]HAFHoIoHcouHnJHGqKCBuDFkAyD",278,0.996416,27,279,1,278,1,1,0,1,1,138,137,141,141,66
"5898",97,"[27]HAFHoIoHcouHnJHGqKCBuDFkAyD",283,0.996479,27,284,1,283,1,1,0,1,1,139,138,145,145,66
"5899",98,"[27]HAFHoIoHcouHnJHGqKCBuDFkAyD",278,0.996416,27,279,1,278,1,1,0,1,1,142,141,137,137,66
"5900",99,"[27]HAFHoIoHcouHnJHGqKCBuDFkAyD",282,0.996466,27,283,1,282,1,1,0,1,1,144,143,139,139,66
"5901",0,"[23]koIpioHcosHnJHGqKCznJgu",278,0.996416,23,279,1,278,1,1,0,1,1,130,129,149,149,67
"5902",1,"[23]koIpioHcosHnJHGqKCznJgu",281,0.996454,23,282,1,281,1,1,0,1,1,151,150,131,131,67
"5903",2,"[23]koIpioHcosHnJHGqKCznJgu",285,0.996503,23,286,1,285,1,1,0,1,1,145,144,141,141,67
"5904",3,"[23]koIpioHcosHnJHGqKCznJgu",277,0.996403,23,278,1,277,1,1,0,1,1,138,137,140,140,67
"5905",4,"[23]koIpioHcosHnJHGqKCznJgu",283,0.996479,23,284,1,283,1,1,0,1,1,148,147,136,136,67
"5906",5,"[23]koIpioHcosHnJHGqKCznJgu",277,0.996403,23,278,1,277,1,1,0,1,1,146,145,132,132,67
"5907",6,"[23]koIpioHcosHnJHGqKCznJgu",277,0.996403,23,278,1,277,1,1,0,1,1,129,128,149,149,67
"5908",7,"[23]koIpioHcosHnJHGqKCznJgu",282,0.996466,23,283,1,282,1,1,0,1,1,143,142,140,140,67
"5909",8,"[23]koIpioHcosHnJHGqKCznJgu",282,0.996466,23,283,1,282,1,1,0,1,1,155,154,128,128,67
"5910",9,"[23]koIpioHcosHnJHGqKCznJgu",280,0.996441,23,281,1,280,1,1,0,1,1,147,146,134,134,67
"5911",10,"[23]koIpioHcosHnJHGqKCznJgu",282,0.996466,23,283,1,282,1,1,0,1,1,154,153,129,129,67
"5912",11,"[23]koIpioHcosHnJHGqKCznJgu",273,0.99635,23,274,1,273,1,1,0,1,1,125,124,149,149,67
"5913",12,"[23]koIpioHcosHnJHGqKCznJgu",277,0.996403,23,278,1,277,1,1,0,1,1,148,147,130,130,67
"5914",13,"[23]koIpioHcosHnJHGqKCznJgu",280,0.996441,23,281,1,280,1,1,0,1,1,139,138,142,142,67
"5915",14,"[23]koIpioHcosHnJHGqKCznJgu",291,0.996575,23,292,1,291,1,1,0,1,1,140,139,152,152,67
"5916",15,"[23]koIpioHcosHnJHGqKCznJgu",282,0.996466,23,283,1,282,1,1,0,1,1,140,139,143,143,67
"5917",16,"[23]koIpioHcosHnJHGqKCznJgu",285,0.996503,23,286,1,285,1,1,0,1,1,148,147,138,138,67
"5918",17,"[23]koIpioHcosHnJHGqKCznJgu",287,0.996528,23,288,1,287,1,1,0,1,1,146,145,142,142,67
"5919",18,"[23]koIpioHcosHnJHGqKCznJgu",284,0.996491,23,285,1,284,1,1,0,1,1,150,149,135,135,67
"5920",19,"[23]koIpioHcosHnJHGqKCznJgu",281,0.996454,23,282,1,281,1,1,0,1,1,151,150,131,131,67
"5921",20,"[23]koIpioHcosHnJHGqKCznJgu",283,0.996479,23,284,1,283,1,1,0,1,1,146,145,138,138,67
"5922",21,"[23]koIpioHcosHnJHGqKCznJgu",281,0.996454,23,282,1,281,1,1,0,1,1,153,152,129,129,67
"5923",22,"[23]koIpioHcosHnJHGqKCznJgu",284,0.996491,23,285,1,284,1,1,0,1,1,158,157,127,127,67
"5924",23,"[23]koIpioHcosHnJHGqKCznJgu",277,0.996403,23,278,1,277,1,1,0,1,1,137,136,141,141,67
"5925",24,"[23]koIpioHcosHnJHGqKCznJgu",286,0.996516,23,287,1,286,1,1,0,1,1,144,143,143,143,67
"5926",25,"[23]koIpioHcosHnJHGqKCznJgu",281,0.996454,23,282,1,281,1,1,0,1,1,140,139,142,142,67
"5927",26,"[23]koIpioHcosHnJHGqKCznJgu",289,0.996552,23,290,1,289,1,1,0,1,1,142,141,148,148,67
"5928",27,"[23]koIpioHcosHnJHGqKCznJgu",284,0.996491,23,285,1,284,1,1,0,1,1,136,135,149,149,67
"5929",28,"[23]koIpioHcosHnJHGqKCznJgu",284,0.996491,23,285,1,284,1,1,0,1,1,139,138,146,146,67
"5930",29,"[23]koIpioHcosHnJHGqKCznJgu",284,0.996491,23,285,1,284,1,1,0,1,1,141,140,144,144,67
"5931",30,"[23]koIpioHcosHnJHGqKCznJgu",279,0.996429,23,280,1,279,1,1,0,1,1,136,135,144,144,67
"5932",31,"[23]koIpioHcosHnJHGqKCznJgu",287,0.996528,23,288,1,287,1,1,0,1,1,158,157,130,130,67
"5933",32,"[23]koIpioHcosHnJHGqKCznJgu",281,0.996454,23,282,1,281,1,1,0,1,1,144,143,138,138,67
"5934",33,"[23]koIpioHcosHnJHGqKCznJgu",285,0.996503,23,286,1,285,1,1,0,1,1,153,152,133,133,67
"5935",34,"[23]koIpioHcosHnJHGqKCznJgu",289,0.996552,23,290,1,289,1,1,0,1,1,156,155,134,134,67
"5936",35,"[23]koIpioHcosHnJHGqKCznJgu",284,0.996491,23,285,1,284,1,1,0,1,1,137,136,148,148,67
"5937",36,"[23]koIpioHcosHnJHGqKCznJgu",286,0.996516,23,287,1,286,1,1,0,1,1,146,145,141,141,67
"5938",37,"[23]koIpioHcosHnJHGqKCznJgu",282,0.996466,23,283,1,282,1,1,0,1,1,137,136,146,146,67
"5939",38,"[23]koIpioHcosHnJHGqKCznJgu",281,0.996454,23,282,1,281,1,1,0,1,1,131,130,151,151,67
"5940",39,"[23]koIpioHcosHnJHGqKCznJgu",279,0.996429,23,280,1,279,1,1,0,1,1,138,137,142,142,67
"5941",40,"[23]koIpioHcosHnJHGqKCznJgu",283,0.996479,23,284,1,283,1,1,0,1,1,143,142,141,141,67
"5942",41,"[23]koIpioHcosHnJHGqKCznJgu",277,0.996403,23,278,1,277,1,1,0,1,1,140,139,138,138,67
"5943",42,"[23]koIpioHcosHnJHGqKCznJgu",282,0.996466,23,283,1,282,1,1,0,1,1,135,134,148,148,67
"5944",43,"[23]koIpioHcosHnJHGqKCznJgu",282,0.996466,23,283,1,282,1,1,0,1,1,133,132,150,150,67
"5945",44,"[23]koIpioHcosHnJHGqKCznJgu",281,0.996454,23,282,1,281,1,1,0,1,1,140,139,142,142,67
"5946",45,"[23]koIpioHcosHnJHGqKCznJgu",283,0.996479,23,284,1,283,1,1,0,1,1,138,137,146,146,67
"5947",46,"[23]koIpioHcosHnJHGqKCznJgu",270,0.99631,23,271,1,270,1,1,0,1,1,118,117,153,153,67
"5948",47,"[23]koIpioHcosHnJHGqKCznJgu",280,0.996441,23,281,1,280,1,1,0,1,1,146,145,135,135,67
"5949",48,"[23]koIpioHcosHnJHGqKCznJgu",280,0.996441,23,281,1,280,1,1,0,1,1,138,137,143,143,67
"5950",49,"[23]koIpioHcosHnJHGqKCznJgu",280,0.996441,23,281,1,280,1,1,0,1,1,133,132,148,148,67
"5951",50,"[23]koIpioHcosHnJHGqKCznJgu",269,0.996296,23,270,1,269,1,1,0,1,1,116,115,154,154,67
"5952",51,"[23]koIpioHcosHnJHGqKCznJgu",281,0.996454,23,282,1,281,1,1,0,1,1,130,129,152,152,67
"5953",52,"[23]koIpioHcosHnJHGqKCznJgu",277,0.996403,23,278,1,277,1,1,0,1,1,140,139,138,138,67
"5954",53,"[23]koIpioHcosHnJHGqKCznJgu",275,0.996377,23,276,1,275,1,1,0,1,1,139,138,137,137,67
"5955",54,"[23]koIpioHcosHnJHGqKCznJgu",275,0.996377,23,276,1,275,1,1,0,1,1,122,121,154,154,67
"5956",55,"[23]koIpioHcosHnJHGqKCznJgu",279,0.996429,23,280,1,279,1,1,0,1,1,135,134,145,145,67
"5957",56,"[23]koIpioHcosHnJHGqKCznJgu",286,0.996516,23,287,1,286,1,1,0,1,1,152,151,135,135,67
"5958",57,"[23]koIpioHcosHnJHGqKCznJgu",284,0.996491,23,285,1,284,1,1,0,1,1,152,151,133,133,67
"5959",58,"[23]koIpioHcosHnJHGqKCznJgu",278,0.996416,23,279,1,278,1,1,0,1,1,131,130,148,148,67
"5960",59,"[23]koIpioHcosHnJHGqKCznJgu",280,0.996441,23,281,1,280,1,1,0,1,1,133,132,148,148,67
"5961",60,"[23]koIpioHcosHnJHGqKCznJgu",284,0.996491,23,285,1,284,1,1,0,1,1,142,141,143,143,67
"5962",61,"[23]koIpioHcosHnJHGqKCznJgu",272,0.996337,23,273,1,272,1,1,0,1,1,130,129,143,143,67
"5963",62,"[23]koIpioHcosHnJHGqKCznJgu",282,0.996466,23,283,1,282,1,1,0,1,1,144,143,139,139,67
"5964",63,"[23]koIpioHcosHnJHGqKCznJgu",277,0.996403,23,278,1,277,1,1,0,1,1,138,137,140,140,67
"5965",64,"[23]koIpioHcosHnJHGqKCznJgu",279,0.996429,23,280,1,279,1,1,0,1,1,135,134,145,145,67
"5966",65,"[23]koIpioHcosHnJHGqKCznJgu",279,0.996429,23,280,1,279,1,1,0,1,1,142,141,138,138,67
"5967",66,"[23]koIpioHcosHnJHGqKCznJgu",279,0.996429,23,280,1,279,1,1,0,1,1,136,135,144,144,67
"5968",67,"[23]koIpioHcosHnJHGqKCznJgu",284,0.996491,23,285,1,284,1,1,0,1,1,135,134,150,150,67
"5969",68,"[23]koIpioHcosHnJHGqKCznJgu",281,0.996454,23,282,1,281,1,1,0,1,1,141,140,141,141,67
"5970",69,"[23]koIpioHcosHnJHGqKCznJgu",280,0.996441,23,281,1,280,1,1,0,1,1,133,132,148,148,67
"5971",70,"[23]koIpioHcosHnJHGqKCznJgu",285,0.996503,23,286,1,285,1,1,0,1,1,140,139,146,146,67
"5972",71,"[23]koIpioHcosHnJHGqKCznJgu",278,0.996416,23,279,1,278,1,1,0,1,1,144,143,135,135,67
"5973",72,"[23]koIpioHcosHnJHGqKCznJgu",286,0.996516,23,287,1,286,1,1,0,1,1,144,143,143,143,67
"5974",73,"[23]koIpioHcosHnJHGqKCznJgu",272,0.996337,23,273,1,272,1,1,0,1,1,134,133,139,139,67
"5975",74,"[23]koIpioHcosHnJHGqKCznJgu",282,0.996466,23,283,1,282,1,1,0,1,1,137,136,146,146,67
"5976",75,"[23]koIpioHcosHnJHGqKCznJgu",277,0.996403,23,278,1,277,1,1,0,1,1,145,144,133,133,67
"5977",76,"[23]koIpioHcosHnJHGqKCznJgu",281,0.996454,23,282,1,281,1,1,0,1,1,143,142,139,139,67
"5978",77,"[23]koIpioHcosHnJHGqKCznJgu",273,0.99635,23,274,1,273,1,1,0,1,1,150,149,124,124,67
"5979",78,"[23]koIpioHcosHnJHGqKCznJgu",277,0.996403,23,278,1,277,1,1,0,1,1,133,132,145,145,67
"5980",79,"[23]koIpioHcosHnJHGqKCznJgu",279,0.996429,23,280,1,279,1,1,0,1,1,138,137,142,142,67
"5981",80,"[23]koIpioHcosHnJHGqKCznJgu",286,0.996516,23,287,1,286,1,1,0,1,1,152,151,135,135,67
"5982",81,"[23]koIpioHcosHnJHGqKCznJgu",285,0.996503,23,286,1,285,1,1,0,1,1,146,145,140,140,67
"5983",82,"[23]koIpioHcosHnJHGqKCznJgu",280,0.996441,23,281,1,280,1,1,0,1,1,124,123,157,157,67
"5984",83,"[23]koIpioHcosHnJHGqKCznJgu",279,0.996429,23,280,1,279,1,1,0,1,1,151,150,129,129,67
"5985",84,"[23]koIpioHcosHnJHGqKCznJgu",279,0.996429,23,280,1,279,1,1,0,1,1,146,145,134,134,67
"5986",85,"[23]koIpioHcosHnJHGqKCznJgu",283,0.996479,23,284,1,283,1,1,0,1,1,155,154,129,129,67
"5987",86,"[23]koIpioHcosHnJHGqKCznJgu",279,0.996429,23,280,1,279,1,1,0,1,1,154,153,126,126,67
"5988",87,"[23]koIpioHcosHnJHGqKCznJgu",285,0.996503,23,286,1,285,1,1,0,1,1,152,151,134,134,67
"5989",88,"[23]koIpioHcosHnJHGqKCznJgu",281,0.996454,23,282,1,281,1,1,0,1,1,143,142,139,139,67
"5990",89,"[23]koIpioHcosHnJHGqKCznJgu",288,0.99654,23,289,1,288,1,1,0,1,1,151,150,138,138,67
"5991",90,"[23]koIpioHcosHnJHGqKCznJgu",280,0.996441,23,281,1,280,1,1,0,1,1,134,133,147,147,67
"5992",91,"[23]koIpioHcosHnJHGqKCznJgu",278,0.996416,23,279,1,278,1,1,0,1,1,134,133,145,145,67
"5993",92,"[23]koIpioHcosHnJHGqKCznJgu",291,0.996575,23,292,1,291,1,1,0,1,1,159,158,133,133,67
"5994",93,"[23]koIpioHcosHnJHGqKCznJgu",281,0.996454,23,282,1,281,1,1,0,1,1,141,140,141,141,67
"5995",94,"[23]koIpioHcosHnJHGqKCznJgu",276,0.99639,23,277,1,276,1,1,0,1,1,121,120,156,156,67
"5996",95,"[23]koIpioHcosHnJHGqKCznJgu",275,0.996377,23,276,1,275,1,1,0,1,1,125,124,151,151,67
"5997",96,"[23]koIpioHcosHnJHGqKCznJgu",284,0.996491,23,285,1,284,1,1,0,1,1,146,145,139,139,67
"5998",97,"[23]koIpioHcosHnJHGqKCznJgu",279,0.996429,23,280,1,279,1,1,0,1,1,137,136,143,143,67
"5999",98,"[23]koIpioHcosHnJHGqKCznJgu",280,0.996441,23,281,1,280,1,1,0,1,1,124,123,157,157,67
"6000",99,"[23]koIpioHcosHnJHGqKCznJgu",290,0.996564,23,291,1,290,1,1,0,1,1,154,153,137,137,67
"6001",0,"[21]xHoIoHcosHnJqGKChyxta",294,0.99661,21,295,1,294,1,1,0,1,1,142,141,153,153,68
"6002",1,"[21]xHoIoHcosHnJqGKChyxta",302,0.9967,21,303,1,302,1,1,0,1,1,166,165,137,137,68
"6003",2,"[21]xHoIoHcosHnJqGKChyxta",297,0.996644,21,298,1,297,1,1,0,1,1,151,150,147,147,68
"6004",3,"[21]xHoIoHcosHnJqGKChyxta",297,0.996644,21,298,1,297,1,1,0,1,1,148,147,150,150,68
"6005",4,"[21]xHoIoHcosHnJqGKChyxta",295,0.996622,21,296,1,295,1,1,0,1,1,144,143,152,152,68
"6006",5,"[21]xHoIoHcosHnJqGKChyxta",303,0.996711,21,304,1,303,1,1,0,1,1,174,173,130,130,68
"6007",6,"[21]xHoIoHcosHnJqGKChyxta",291,0.996575,21,292,1,291,1,1,0,1,1,147,146,145,145,68
"6008",7,"[21]xHoIoHcosHnJqGKChyxta",298,0.996656,21,299,1,298,1,1,0,1,1,155,154,144,144,68
"6009",8,"[21]xHoIoHcosHnJqGKChyxta",306,0.996743,21,307,1,306,1,1,0,1,1,172,171,135,135,68
"6010",9,"[21]xHoIoHcosHnJqGKChyxta",295,0.996622,21,296,1,295,1,1,0,1,1,144,143,152,152,68
"6011",10,"[21]xHoIoHcosHnJqGKChyxta",303,0.996711,21,304,1,303,1,1,0,1,1,170,169,134,134,68
"6012",11,"[21]xHoIoHcosHnJqGKChyxta",299,0.996667,21,300,1,299,1,1,0,1,1,156,155,144,144,68
"6013",12,"[21]xHoIoHcosHnJqGKChyxta",291,0.996575,21,292,1,291,1,1,0,1,1,134,133,158,158,68
"6014",13,"[21]xHoIoHcosHnJqGKChyxta",301,0.996689,21,302,1,301,1,1,0,1,1,160,159,142,142,68
"6015",14,"[21]xHoIoHcosHnJqGKChyxta",306,0.996743,21,307,1,306,1,1,0,1,1,173,172,134,134,68
"6016",15,"[21]xHoIoHcosHnJqGKChyxta",295,0.996622,21,296,1,295,1,1,0,1,1,148,147,148,148,68
"6017",16,"[21]xHoIoHcosHnJqGKChyxta",293,0.996599,21,294,1,293,1,1,0,1,1,148,147,146,146,68
"6018",17,"[21]xHoIoHcosHnJqGKChyxta",297,0.996644,21,298,1,297,1,1,0,1,1,153,152,145,145,68
"6019",18,"[21]xHoIoHcosHnJqGKChyxta",300,0.996678,21,301,1,300,1,1,0,1,1,156,155,145,145,68
"6020",19,"[21]xHoIoHcosHnJqGKChyxta",297,0.996644,21,298,1,297,1,1,0,1,1,152,151,146,146,68
"6021",20,"[21]xHoIoHcosHnJqGKChyxta",289,0.996552,21,290,1,289,1,1,0,1,1,132,131,158,158,68
"6022",21,"[21]xHoIoHcosHnJqGKChyxta",302,0.9967,21,303,1,302,1,1,0,1,1,154,153,149,149,68
"6023",22,"[21]xHoIoHcosHnJqGKChyxta",293,0.996599,21,294,1,293,1,1,0,1,1,143,142,151,151,68
"6024",23,"[21]xHoIoHcosHnJqGKChyxta",293,0.996599,21,294,1,293,1,1,0,1,1,153,152,141,141,68
"6025",24,"[21]xHoIoHcosHnJqGKChyxta",303,0.996711,21,304,1,303,1,1,0,1,1,165,164,139,139,68
"6026",25,"[21]xHoIoHcosHnJqGKChyxta",295,0.996622,21,296,1,295,1,1,0,1,1,143,142,153,153,68
"6027",26,"[21]xHoIoHcosHnJqGKChyxta",300,0.996678,21,301,1,300,1,1,0,1,1,162,161,139,139,68
"6028",27,"[21]xHoIoHcosHnJqGKChyxta",304,0.996721,21,305,1,304,1,1,0,1,1,171,170,134,134,68
"6029",28,"[21]xHoIoHcosHnJqGKChyxta",298,0.996656,21,299,1,298,1,1,0,1,1,158,157,141,141,68
"6030",29,"[21]xHoIoHcosHnJqGKChyxta",295,0.996622,21,296,1,295,1,1,0,1,1,153,152,143,143,68
"6031",30,"[21]xHoIoHcosHnJqGKChyxta",294,0.99661,21,295,1,294,1,1,0,1,1,141,140,154,154,68
"6032",31,"[21]xHoIoHcosHnJqGKChyxta",293,0.996599,21,294,1,293,1,1,0,1,1,150,149,144,144,68
"6033",32,"[21]xHoIoHcosHnJqGKChyxta",296,0.996633,21,297,1,296,1,1,0,1,1,151,150,146,146,68
"6034",33,"[21]xHoIoHcosHnJqGKChyxta",303,0.996711,21,304,1,303,1,1,0,1,1,169,168,135,135,68
"6035",34,"[21]xHoIoHcosHnJqGKChyxta",294,0.99661,21,295,1,294,1,1,0,1,1,141,140,154,154,68
"6036",35,"[21]xHoIoHcosHnJqGKChyxta",296,0.996633,21,297,1,296,1,1,0,1,1,154,153,143,143,68
"6037",36,"[21]xHoIoHcosHnJqGKChyxta",297,0.996644,21,298,1,297,1,1,0,1,1,152,151,146,146,68
"6038",37,"[21]xHoIoHcosHnJqGKChyxta",298,0.996656,21,299,1,298,1,1,0,1,1,148,147,151,151,68
"6039",38,"[21]xHoIoHcosHnJqGKChyxta",294,0.99661,21,295,1,294,1,1,0,1,1,144,143,151,151,68
"6040",39,"[21]xHoIoHcosHnJqGKChyxta",291,0.996575,21,292,1,291,1,1,0,1,1,137,136,155,155,68
"6041",40,"[21]xHoIoHcosHnJqGKChyxta",300,0.996678,21,301,1,300,1,1,0,1,1,171,170,130,130,68
"6042",41,"[21]xHoIoHcosHnJqGKChyxta",299,0.996667,21,300,1,299,1,1,0,1,1,152,151,148,148,68
"6043",42,"[21]xHoIoHcosHnJqGKChyxta",299,0.996667,21,300,1,299,1,1,0,1,1,157,156,143,143,68
"6044",43,"[21]xHoIoHcosHnJqGKChyxta",295,0.996622,21,296,1,295,1,1,0,1,1,144,143,152,152,68
"6045",44,"[21]xHoIoHcosHnJqGKChyxta",287,0.996528,21,288,1,287,1,1,0,1,1,141,140,147,147,68
"6046",45,"[21]xHoIoHcosHnJqGKChyxta",292,0.996587,21,293,1,292,1,1,0,1,1,142,141,151,151,68
"6047",46,"[21]xHoIoHcosHnJqGKChyxta",299,0.996667,21,300,1,299,1,1,0,1,1,159,158,141,141,68
"6048",47,"[21]xHoIoHcosHnJqGKChyxta",298,0.996656,21,299,1,298,1,1,0,1,1,154,153,145,145,68
"6049",48,"[21]xHoIoHcosHnJqGKChyxta",299,0.996667,21,300,1,299,1,1,0,1,1,159,158,141,141,68
"6050",49,"[21]xHoIoHcosHnJqGKChyxta",301,0.996689,21,302,1,301,1,1,0,1,1,167,166,135,135,68
"6051",50,"[21]xHoIoHcosHnJqGKChyxta",298,0.996656,21,299,1,298,1,1,0,1,1,158,157,141,141,68
"6052",51,"[21]xHoIoHcosHnJqGKChyxta",296,0.996633,21,297,1,296,1,1,0,1,1,150,149,147,147,68
"6053",52,"[21]xHoIoHcosHnJqGKChyxta",295,0.996622,21,296,1,295,1,1,0,1,1,140,139,156,156,68
"6054",53,"[21]xHoIoHcosHnJqGKChyxta",296,0.996633,21,297,1,296,1,1,0,1,1,153,152,144,144,68
"6055",54,"[21]xHoIoHcosHnJqGKChyxta",294,0.99661,21,295,1,294,1,1,0,1,1,141,140,154,154,68
"6056",55,"[21]xHoIoHcosHnJqGKChyxta",299,0.996667,21,300,1,299,1,1,0,1,1,157,156,143,143,68
"6057",56,"[21]xHoIoHcosHnJqGKChyxta",292,0.996587,21,293,1,292,1,1,0,1,1,135,134,158,158,68
"6058",57,"[21]xHoIoHcosHnJqGKChyxta",290,0.996564,21,291,1,290,1,1,0,1,1,141,140,150,150,68
"6059",58,"[21]xHoIoHcosHnJqGKChyxta",298,0.996656,21,299,1,298,1,1,0,1,1,154,153,145,145,68
"6060",59,"[21]xHoIoHcosHnJqGKChyxta",301,0.996689,21,302,1,301,1,1,0,1,1,162,161,140,140,68
"6061",60,"[21]xHoIoHcosHnJqGKChyxta",297,0.996644,21,298,1,297,1,1,0,1,1,149,148,149,149,68
"6062",61,"[21]xHoIoHcosHnJqGKChyxta",294,0.99661,21,295,1,294,1,1,0,1,1,142,141,153,153,68
"6063",62,"[21]xHoIoHcosHnJqGKChyxta",293,0.996599,21,294,1,293,1,1,0,1,1,140,139,154,154,68
"6064",63,"[21]xHoIoHcosHnJqGKChyxta",293,0.996599,21,294,1,293,1,1,0,1,1,139,138,155,155,68
"6065",64,"[21]xHoIoHcosHnJqGKChyxta",301,0.996689,21,302,1,301,1,1,0,1,1,160,159,142,142,68
"6066",65,"[21]xHoIoHcosHnJqGKChyxta",292,0.996587,21,293,1,292,1,1,0,1,1,131,130,162,162,68
"6067",66,"[21]xHoIoHcosHnJqGKChyxta",300,0.996678,21,301,1,300,1,1,0,1,1,160,159,141,141,68
"6068",67,"[21]xHoIoHcosHnJqGKChyxta",304,0.996721,21,305,1,304,1,1,0,1,1,169,168,136,136,68
"6069",68,"[21]xHoIoHcosHnJqGKChyxta",298,0.996656,21,299,1,298,1,1,0,1,1,156,155,143,143,68
"6070",69,"[21]xHoIoHcosHnJqGKChyxta",291,0.996575,21,292,1,291,1,1,0,1,1,143,142,149,149,68
"6071",70,"[21]xHoIoHcosHnJqGKChyxta",292,0.996587,21,293,1,292,1,1,0,1,1,139,138,154,154,68
"6072",71,"[21]xHoIoHcosHnJqGKChyxta",294,0.99661,21,295,1,294,1,1,0,1,1,142,141,153,153,68
"6073",72,"[21]xHoIoHcosHnJqGKChyxta",293,0.996599,21,294,1,293,1,1,0,1,1,139,138,155,155,68
"6074",73,"[21]xHoIoHcosHnJqGKChyxta",297,0.996644,21,298,1,297,1,1,0,1,1,149,148,149,149,68
"6075",74,"[21]xHoIoHcosHnJqGKChyxta",295,0.996622,21,296,1,295,1,1,0,1,1,144,143,152,152,68
"6076",75,"[21]xHoIoHcosHnJqGKChyxta",293,0.996599,21,294,1,293,1,1,0,1,1,139,138,155,155,68
"6077",76,"[21]xHoIoHcosHnJqGKChyxta",301,0.996689,21,302,1,301,1,1,0,1,1,157,156,145,145,68
"6078",77,"[21]xHoIoHcosHnJqGKChyxta",295,0.996622,21,296,1,295,1,1,0,1,1,143,142,153,153,68
"6079",78,"[21]xHoIoHcosHnJqGKChyxta",298,0.996656,21,299,1,298,1,1,0,1,1,156,155,143,143,68
"6080",79,"[21]xHoIoHcosHnJqGKChyxta",300,0.996678,21,301,1,300,1,1,0,1,1,158,157,143,143,68
"6081",80,"[21]xHoIoHcosHnJqGKChyxta",296,0.996633,21,297,1,296,1,1,0,1,1,147,146,150,150,68
"6082",81,"[21]xHoIoHcosHnJqGKChyxta",296,0.996633,21,297,1,296,1,1,0,1,1,144,143,153,153,68
"6083",82,"[21]xHoIoHcosHnJqGKChyxta",295,0.996622,21,296,1,295,1,1,0,1,1,149,148,147,147,68
"6084",83,"[21]xHoIoHcosHnJqGKChyxta",299,0.996667,21,300,1,299,1,1,0,1,1,157,156,143,143,68
"6085",84,"[21]xHoIoHcosHnJqGKChyxta",298,0.996656,21,299,1,298,1,1,0,1,1,149,148,150,150,68
"6086",85,"[21]xHoIoHcosHnJqGKChyxta",299,0.996667,21,300,1,299,1,1,0,1,1,153,152,147,147,68
"6087",86,"[21]xHoIoHcosHnJqGKChyxta",296,0.996633,21,297,1,296,1,1,0,1,1,146,145,151,151,68
"6088",87,"[21]xHoIoHcosHnJqGKChyxta",296,0.996633,21,297,1,296,1,1,0,1,1,154,153,143,143,68
"6089",88,"[21]xHoIoHcosHnJqGKChyxta",288,0.99654,21,289,1,288,1,1,0,1,1,125,124,164,164,68
"6090",89,"[21]xHoIoHcosHnJqGKChyxta",299,0.996667,21,300,1,299,1,1,0,1,1,157,156,143,143,68
"6091",90,"[21]xHoIoHcosHnJqGKChyxta",297,0.996644,21,298,1,297,1,1,0,1,1,150,149,148,148,68
"6092",91,"[21]xHoIoHcosHnJqGKChyxta",290,0.996564,21,291,1,290,1,1,0,1,1,131,130,160,160,68
"6093",92,"[21]xHoIoHcosHnJqGKChyxta",301,0.996689,21,302,1,301,1,1,0,1,1,160,159,142,142,68
"6094",93,"[21]xHoIoHcosHnJqGKChyxta",299,0.996667,21,300,1,299,1,1,0,1,1,151,150,149,149,68
"6095",94,"[21]xHoIoHcosHnJqGKChyxta",294,0.99661,21,295,1,294,1,1,0,1,1,153,152,142,142,68
"6096",95,"[21]xHoIoHcosHnJqGKChyxta",296,0.996633,21,297,1,296,1,1,0,1,1,149,148,148,148,68
"6097",96,"[21]xHoIoHcosHnJqGKChyxta",296,0.996633,21,297,1,296,1,1,0,1,1,147,146,150,150,68
"6098",97,"[21]xHoIoHcosHnJqGKChyxta",303,0.996711,21,304,1,303,1,1,0,1,1,171,170,133,133,68
"6099",98,"[21]xHoIoHcosHnJqGKChyxta",295,0.996622,21,296,1,295,1,1,0,1,1,143,142,153,153,68
"6100",99,"[21]xHoIoHcosHnJqGKChyxta",294,0.99661,21,295,1,294,1,1,0,1,1,141,140,154,154,68
"6101",0,"[24]HoIoHcouHnJHGqKCjozcijFC",292,0.996587,24,293,1,292,1,1,0,1,1,165,164,128,128,69
"6102",1,"[24]HoIoHcouHnJHGqKCjozcijFC",276,0.99639,24,277,1,276,1,1,0,1,1,130,129,147,147,69
"6103",2,"[24]HoIoHcouHnJHGqKCjozcijFC",285,0.996503,24,286,1,285,1,1,0,1,1,165,164,121,121,69
"6104",3,"[24]HoIoHcouHnJHGqKCjozcijFC",275,0.996377,24,276,1,275,1,1,0,1,1,128,127,148,148,69
"6105",4,"[24]HoIoHcouHnJHGqKCjozcijFC",287,0.996528,24,288,1,287,1,1,0,1,1,143,142,145,145,69
"6106",5,"[24]HoIoHcouHnJHGqKCjozcijFC",279,0.996429,24,280,1,279,1,1,0,1,1,135,134,145,145,69
"6107",6,"[24]HoIoHcouHnJHGqKCjozcijFC",278,0.996416,24,279,1,278,1,1,0,1,1,136,135,143,143,69
"6108",7,"[24]HoIoHcouHnJHGqKCjozcijFC",279,0.996429,24,280,1,279,1,1,0,1,1,144,143,136,136,69
"6109",8,"[24]HoIoHcouHnJHGqKCjozcijFC",281,0.996454,24,282,1,281,1,1,0,1,1,133,132,149,149,69
"6110",9,"[24]HoIoHcouHnJHGqKCjozcijFC",280,0.996441,24,281,1,280,1,1,0,1,1,136,135,145,145,69
"6111",10,"[24]HoIoHcouHnJHGqKCjozcijFC",281,0.996454,24,282,1,281,1,1,0,1,1,138,137,144,144,69
"6112",11,"[24]HoIoHcouHnJHGqKCjozcijFC",284,0.996491,24,285,1,284,1,1,0,1,1,161,160,124,124,69
"6113",12,"[24]HoIoHcouHnJHGqKCjozcijFC",284,0.996491,24,285,1,284,1,1,0,1,1,154,153,131,131,69
"6114",13,"[24]HoIoHcouHnJHGqKCjozcijFC",285,0.996503,24,286,1,285,1,1,0,1,1,158,157,128,128,69
"6115",14,"[24]HoIoHcouHnJHGqKCjozcijFC",278,0.996416,24,279,1,278,1,1,0,1,1,132,131,147,147,69
"6116",15,"[24]HoIoHcouHnJHGqKCjozcijFC",283,0.996479,24,284,1,283,1,1,0,1,1,136,135,148,148,69
"6117",16,"[24]HoIoHcouHnJHGqKCjozcijFC",282,0.996466,24,283,1,282,1,1,0,1,1,161,160,122,122,69
"6118",17,"[24]HoIoHcouHnJHGqKCjozcijFC",281,0.996454,24,282,1,281,1,1,0,1,1,161,160,121,121,69
"6119",18,"[24]HoIoHcouHnJHGqKCjozcijFC",280,0.996441,24,281,1,280,1,1,0,1,1,147,146,134,134,69
"6120",19,"[24]HoIoHcouHnJHGqKCjozcijFC",279,0.996429,24,280,1,279,1,1,0,1,1,138,137,142,142,69
"6121",20,"[24]HoIoHcouHnJHGqKCjozcijFC",282,0.996466,24,283,1,282,1,1,0,1,1,131,130,152,152,69
"6122",21,"[24]HoIoHcouHnJHGqKCjozcijFC",275,0.996377,24,276,1,275,1,1,0,1,1,131,130,145,145,69
"6123",22,"[24]HoIoHcouHnJHGqKCjozcijFC",280,0.996441,24,281,1,280,1,1,0,1,1,139,138,142,142,69
"6124",23,"[24]HoIoHcouHnJHGqKCjozcijFC",280,0.996441,24,281,1,280,1,1,0,1,1,141,140,140,140,69
"6125",24,"[24]HoIoHcouHnJHGqKCjozcijFC",280,0.996441,24,281,1,280,1,1,0,1,1,158,157,123,123,69
"6126",25,"[24]HoIoHcouHnJHGqKCjozcijFC",287,0.996528,24,288,1,287,1,1,0,1,1,145,144,143,143,69
"6127",26,"[24]HoIoHcouHnJHGqKCjozcijFC",278,0.996416,24,279,1,278,1,1,0,1,1,130,129,149,149,69
"6128",27,"[24]HoIoHcouHnJHGqKCjozcijFC",276,0.99639,24,277,1,276,1,1,0,1,1,129,128,148,148,69
"6129",28,"[24]HoIoHcouHnJHGqKCjozcijFC",280,0.996441,24,281,1,280,1,1,0,1,1,143,142,138,138,69
"6130",29,"[24]HoIoHcouHnJHGqKCjozcijFC",281,0.996454,24,282,1,281,1,1,0,1,1,137,136,145,145,69
"6131",30,"[24]HoIoHcouHnJHGqKCjozcijFC",283,0.996479,24,284,1,283,1,1,0,1,1,126,125,158,158,69
"6132",31,"[24]HoIoHcouHnJHGqKCjozcijFC",282,0.996466,24,283,1,282,1,1,0,1,1,145,144,138,138,69
"6133",32,"[24]HoIoHcouHnJHGqKCjozcijFC",278,0.996416,24,279,1,278,1,1,0,1,1,141,140,138,138,69
"6134",33,"[24]HoIoHcouHnJHGqKCjozcijFC",277,0.996403,24,278,1,277,1,1,0,1,1,130,129,148,148,69
"6135",34,"[24]HoIoHcouHnJHGqKCjozcijFC",283,0.996479,24,284,1,283,1,1,0,1,1,155,154,129,129,69
"6136",35,"[24]HoIoHcouHnJHGqKCjozcijFC",274,0.996364,24,275,1,274,1,1,0,1,1,134,133,141,141,69
"6137",36,"[24]HoIoHcouHnJHGqKCjozcijFC",280,0.996441,24,281,1,280,1,1,0,1,1,145,144,136,136,69
"6138",37,"[24]HoIoHcouHnJHGqKCjozcijFC",285,0.996503,24,286,1,285,1,1,0,1,1,156,155,130,130,69
"6139",38,"[24]HoIoHcouHnJHGqKCjozcijFC",272,0.996337,24,273,1,272,1,1,0,1,1,128,127,145,145,69
"6140",39,"[24]HoIoHcouHnJHGqKCjozcijFC",282,0.996466,24,283,1,282,1,1,0,1,1,159,158,124,124,69
"6141",40,"[24]HoIoHcouHnJHGqKCjozcijFC",291,0.996575,24,292,1,291,1,1,0,1,1,148,147,144,144,69
"6142",41,"[24]HoIoHcouHnJHGqKCjozcijFC",281,0.996454,24,282,1,281,1,1,0,1,1,140,139,142,142,69
"6143",42,"[24]HoIoHcouHnJHGqKCjozcijFC",286,0.996516,24,287,1,286,1,1,0,1,1,161,160,126,126,69
"6144",43,"[24]HoIoHcouHnJHGqKCjozcijFC",281,0.996454,24,282,1,281,1,1,0,1,1,142,141,140,140,69
"6145",44,"[24]HoIoHcouHnJHGqKCjozcijFC",283,0.996479,24,284,1,283,1,1,0,1,1,144,143,140,140,69
"6146",45,"[24]HoIoHcouHnJHGqKCjozcijFC",274,0.996364,24,275,1,274,1,1,0,1,1,141,140,134,134,69
"6147",46,"[24]HoIoHcouHnJHGqKCjozcijFC",276,0.99639,24,277,1,276,1,1,0,1,1,156,155,121,121,69
"6148",47,"[24]HoIoHcouHnJHGqKCjozcijFC",284,0.996491,24,285,1,284,1,1,0,1,1,140,139,145,145,69
"6149",48,"[24]HoIoHcouHnJHGqKCjozcijFC",280,0.996441,24,281,1,280,1,1,0,1,1,137,136,144,144,69
"6150",49,"[24]HoIoHcouHnJHGqKCjozcijFC",280,0.996441,24,281,1,280,1,1,0,1,1,150,149,131,131,69
"6151",50,"[24]HoIoHcouHnJHGqKCjozcijFC",292,0.996587,24,293,1,292,1,1,0,1,1,161,160,132,132,69
"6152",51,"[24]HoIoHcouHnJHGqKCjozcijFC",282,0.996466,24,283,1,282,1,1,0,1,1,138,137,145,145,69
"6153",52,"[24]HoIoHcouHnJHGqKCjozcijFC",290,0.996564,24,291,1,290,1,1,0,1,1,145,144,146,146,69
"6154",53,"[24]HoIoHcouHnJHGqKCjozcijFC",272,0.996337,24,273,1,272,1,1,0,1,1,119,118,154,154,69
"6155",54,"[24]HoIoHcouHnJHGqKCjozcijFC",278,0.996416,24,279,1,278,1,1,0,1,1,135,134,144,144,69
"6156",55,"[24]HoIoHcouHnJHGqKCjozcijFC",280,0.996441,24,281,1,280,1,1,0,1,1,143,142,138,138,69
"6157",56,"[24]HoIoHcouHnJHGqKCjozcijFC",282,0.996466,24,283,1,282,1,1,0,1,1,128,127,155,155,69
"6158",57,"[24]HoIoHcouHnJHGqKCjozcijFC",289,0.996552,24,290,1,289,1,1,0,1,1,163,162,127,127,69
"6159",58,"[24]HoIoHcouHnJHGqKCjozcijFC",282,0.996466,24,283,1,282,1,1,0,1,1,145,144,138,138,69
"6160",59,"[24]HoIoHcouHnJHGqKCjozcijFC",282,0.996466,24,283,1,282,1,1,0,1,1,140,139,143,143,69
"6161",60,"[24]HoIoHcouHnJHGqKCjozcijFC",274,0.996364,24,275,1,274,1,1,0,1,1,133,132,142,142,69
"6162",61,"[24]HoIoHcouHnJHGqKCjozcijFC",281,0.996454,24,282,1,281,1,1,0,1,1,136,135,146,146,69
"6163",62,"[24]HoIoHcouHnJHGqKCjozcijFC",282,0.996466,24,283,1,282,1,1,0,1,1,137,136,146,146,69
"6164",63,"[24]HoIoHcouHnJHGqKCjozcijFC",276,0.99639,24,277,1,276,1,1,0,1,1,142,141,135,135,69
"6165",64,"[24]HoIoHcouHnJHGqKCjozcijFC",286,0.996516,24,287,1,286,1,1,0,1,1,149,148,138,138,69
"6166",65,"[24]HoIoHcouHnJHGqKCjozcijFC",283,0.996479,24,284,1,283,1,1,0,1,1,143,142,141,141,69
"6167",66,"[24]HoIoHcouHnJHGqKCjozcijFC",286,0.996516,24,287,1,286,1,1,0,1,1,151,150,136,136,69
"6168",67,"[24]HoIoHcouHnJHGqKCjozcijFC",279,0.996429,24,280,1,279,1,1,0,1,1,143,142,137,137,69
"6169",68,"[24]HoIoHcouHnJHGqKCjozcijFC",278,0.996416,24,279,1,278,1,1,0,1,1,135,134,144,144,69
"6170",69,"[24]HoIoHcouHnJHGqKCjozcijFC",272,0.996337,24,273,1,272,1,1,0,1,1,129,128,144,144,69
"6171",70,"[24]HoIoHcouHnJHGqKCjozcijFC",277,0.996403,24,278,1,277,1,1,0,1,1,130,129,148,148,69
"6172",71,"[24]HoIoHcouHnJHGqKCjozcijFC",284,0.996491,24,285,1,284,1,1,0,1,1,139,138,146,146,69
"6173",72,"[24]HoIoHcouHnJHGqKCjozcijFC",278,0.996416,24,279,1,278,1,1,0,1,1,129,128,150,150,69
"6174",73,"[24]HoIoHcouHnJHGqKCjozcijFC",286,0.996516,24,287,1,286,1,1,0,1,1,139,138,148,148,69
"6175",74,"[24]HoIoHcouHnJHGqKCjozcijFC",285,0.996503,24,286,1,285,1,1,0,1,1,140,139,146,146,69
"6176",75,"[24]HoIoHcouHnJHGqKCjozcijFC",283,0.996479,24,284,1,283,1,1,0,1,1,135,134,149,149,69
"6177",76,"[24]HoIoHcouHnJHGqKCjozcijFC",279,0.996429,24,280,1,279,1,1,0,1,1,139,138,141,141,69
"6178",77,"[24]HoIoHcouHnJHGqKCjozcijFC",280,0.996441,24,281,1,280,1,1,0,1,1,133,132,148,148,69
"6179",78,"[24]HoIoHcouHnJHGqKCjozcijFC",279,0.996429,24,280,1,279,1,1,0,1,1,148,147,132,132,69
"6180",79,"[24]HoIoHcouHnJHGqKCjozcijFC",279,0.996429,24,280,1,279,1,1,0,1,1,131,130,149,149,69
"6181",80,"[24]HoIoHcouHnJHGqKCjozcijFC",287,0.996528,24,288,1,287,1,1,0,1,1,161,160,127,127,69
"6182",81,"[24]HoIoHcouHnJHGqKCjozcijFC",284,0.996491,24,285,1,284,1,1,0,1,1,145,144,140,140,69
"6183",82,"[24]HoIoHcouHnJHGqKCjozcijFC",280,0.996441,24,281,1,280,1,1,0,1,1,143,142,138,138,69
"6184",83,"[24]HoIoHcouHnJHGqKCjozcijFC",286,0.996516,24,287,1,286,1,1,0,1,1,141,140,146,146,69
"6185",84,"[24]HoIoHcouHnJHGqKCjozcijFC",284,0.996491,24,285,1,284,1,1,0,1,1,149,148,136,136,69
"6186",85,"[24]HoIoHcouHnJHGqKCjozcijFC",284,0.996491,24,285,1,284,1,1,0,1,1,138,137,147,147,69
"6187",86,"[24]HoIoHcouHnJHGqKCjozcijFC",279,0.996429,24,280,1,279,1,1,0,1,1,146,145,134,134,69
"6188",87,"[24]HoIoHcouHnJHGqKCjozcijFC",286,0.996516,24,287,1,286,1,1,0,1,1,151,150,136,136,69
"6189",88,"[24]HoIoHcouHnJHGqKCjozcijFC",283,0.996479,24,284,1,283,1,1,0,1,1,133,132,151,151,69
"6190",89,"[24]HoIoHcouHnJHGqKCjozcijFC",281,0.996454,24,282,1,281,1,1,0,1,1,133,132,149,149,69
"6191",90,"[24]HoIoHcouHnJHGqKCjozcijFC",279,0.996429,24,280,1,279,1,1,0,1,1,137,136,143,143,69
"6192",91,"[24]HoIoHcouHnJHGqKCjozcijFC",283,0.996479,24,284,1,283,1,1,0,1,1,132,131,152,152,69
"6193",92,"[24]HoIoHcouHnJHGqKCjozcijFC",279,0.996429,24,280,1,279,1,1,0,1,1,157,156,123,123,69
"6194",93,"[24]HoIoHcouHnJHGqKCjozcijFC",286,0.996516,24,287,1,286,1,1,0,1,1,147,146,140,140,69
"6195",94,"[24]HoIoHcouHnJHGqKCjozcijFC",279,0.996429,24,280,1,279,1,1,0,1,1,136,135,144,144,69
"6196",95,"[24]HoIoHcouHnJHGqKCjozcijFC",280,0.996441,24,281,1,280,1,1,0,1,1,152,151,129,129,69
"6197",96,"[24]HoIoHcouHnJHGqKCjozcijFC",284,0.996491,24,285,1,284,1,1,0,1,1,144,143,141,141,69
"6198",97,"[24]HoIoHcouHnJHGqKCjozcijFC",278,0.996416,24,279,1,278,1,1,0,1,1,139,138,140,140,69
"6199",98,"[24]HoIoHcouHnJHGqKCjozcijFC",286,0.996516,24,287,1,286,1,1,0,1,1,144,143,143,143,69
"6200",99,"[24]HoIoHcouHnJHGqKCjozcijFC",287,0.996528,24,288,1,287,1,1,0,1,1,148,147,140,140,69
"6201",0,"[20]rHoIoHcouHnJqGKCzwnF",295,0.996622,20,296,1,295,1,1,0,1,1,145,144,151,151,70
"6202",1,"[20]rHoIoHcouHnJqGKCzwnF",294,0.99661,20,295,1,294,1,1,0,1,1,145,144,150,150,70
"6203",2,"[20]rHoIoHcouHnJqGKCzwnF",295,0.996622,20,296,1,295,1,1,0,1,1,146,145,150,150,70
"6204",3,"[20]rHoIoHcouHnJqGKCzwnF",298,0.996656,20,299,1,298,1,1,0,1,1,155,154,144,144,70
"6205",4,"[20]rHoIoHcouHnJqGKCzwnF",295,0.996622,20,296,1,295,1,1,0,1,1,149,148,147,147,70
"6206",5,"[20]rHoIoHcouHnJqGKCzwnF",291,0.996575,20,292,1,291,1,1,0,1,1,132,131,160,160,70
"6207",6,"[20]rHoIoHcouHnJqGKCzwnF",301,0.996689,20,302,1,301,1,1,0,1,1,159,158,143,143,70
"6208",7,"[20]rHoIoHcouHnJqGKCzwnF",295,0.996622,20,296,1,295,1,1,0,1,1,143,142,153,153,70
"6209",8,"[20]rHoIoHcouHnJqGKCzwnF",298,0.996656,20,299,1,298,1,1,0,1,1,156,155,143,143,70
"6210",9,"[20]rHoIoHcouHnJqGKCzwnF",295,0.996622,20,296,1,295,1,1,0,1,1,147,146,149,149,70
"6211",10,"[20]rHoIoHcouHnJqGKCzwnF",298,0.996656,20,299,1,298,1,1,0,1,1,154,153,145,145,70
"6212",11,"[20]rHoIoHcouHnJqGKCzwnF",299,0.996667,20,300,1,299,1,1,0,1,1,157,156,143,143,70
"6213",12,"[20]rHoIoHcouHnJqGKCzwnF",297,0.996644,20,298,1,297,1,1,0,1,1,151,150,147,147,70
"6214",13,"[20]rHoIoHcouHnJqGKCzwnF",299,0.996667,20,300,1,299,1,1,0,1,1,154,153,146,146,70
"6215",14,"[20]rHoIoHcouHnJqGKCzwnF",295,0.996622,20,296,1,295,1,1,0,1,1,143,142,153,153,70
"6216",15,"[20]rHoIoHcouHnJqGKCzwnF",299,0.996667,20,300,1,299,1,1,0,1,1,150,149,150,150,70
"6217",16,"[20]rHoIoHcouHnJqGKCzwnF",293,0.996599,20,294,1,293,1,1,0,1,1,139,138,155,155,70
"6218",17,"[20]rHoIoHcouHnJqGKCzwnF",294,0.99661,20,295,1,294,1,1,0,1,1,148,147,147,147,70
"6219",18,"[20]rHoIoHcouHnJqGKCzwnF",298,0.996656,20,299,1,298,1,1,0,1,1,148,147,151,151,70
"6220",19,"[20]rHoIoHcouHnJqGKCzwnF",295,0.996622,20,296,1,295,1,1,0,1,1,147,146,149,149,70
"6221",20,"[20]rHoIoHcouHnJqGKCzwnF",298,0.996656,20,299,1,298,1,1,0,1,1,153,152,146,146,70
"6222",21,"[20]rHoIoHcouHnJqGKCzwnF",300,0.996678,20,301,1,300,1,1,0,1,1,164,163,137,137,70
"6223",22,"[20]rHoIoHcouHnJqGKCzwnF",296,0.996633,20,297,1,296,1,1,0,1,1,152,151,145,145,70
"6224",23,"[20]rHoIoHcouHnJqGKCzwnF",304,0.996721,20,305,1,304,1,1,0,1,1,165,164,140,140,70
"6225",24,"[20]rHoIoHcouHnJqGKCzwnF",291,0.996575,20,292,1,291,1,1,0,1,1,137,136,155,155,70
"6226",25,"[20]rHoIoHcouHnJqGKCzwnF",292,0.996587,20,293,1,292,1,1,0,1,1,137,136,156,156,70
"6227",26,"[20]rHoIoHcouHnJqGKCzwnF",296,0.996633,20,297,1,296,1,1,0,1,1,145,144,152,152,70
"6228",27,"[20]rHoIoHcouHnJqGKCzwnF",300,0.996678,20,301,1,300,1,1,0,1,1,161,160,140,140,70
"6229",28,"[20]rHoIoHcouHnJqGKCzwnF",295,0.996622,20,296,1,295,1,1,0,1,1,145,144,151,151,70
"6230",29,"[20]rHoIoHcouHnJqGKCzwnF",296,0.996633,20,297,1,296,1,1,0,1,1,146,145,151,151,70
"6231",30,"[20]rHoIoHcouHnJqGKCzwnF",298,0.996656,20,299,1,298,1,1,0,1,1,155,154,144,144,70
"6232",31,"[20]rHoIoHcouHnJqGKCzwnF",299,0.996667,20,300,1,299,1,1,0,1,1,157,156,143,143,70
"6233",32,"[20]rHoIoHcouHnJqGKCzwnF",290,0.996564,20,291,1,290,1,1,0,1,1,135,134,156,156,70
"6234",33,"[20]rHoIoHcouHnJqGKCzwnF",296,0.996633,20,297,1,296,1,1,0,1,1,154,153,143,143,70
"6235",34,"[20]rHoIoHcouHnJqGKCzwnF",296,0.996633,20,297,1,296,1,1,0,1,1,149,148,148,148,70
"6236",35,"[20]rHoIoHcouHnJqGKCzwnF",292,0.996587,20,293,1,292,1,1,0,1,1,138,137,155,155,70
"6237",36,"[20]rHoIoHcouHnJqGKCzwnF",302,0.9967,20,303,1,302,1,1,0,1,1,160,159,143,143,70
"6238",37,"[20]rHoIoHcouHnJqGKCzwnF",295,0.996622,20,296,1,295,1,1,0,1,1,144,143,152,152,70
"6239",38,"[20]rHoIoHcouHnJqGKCzwnF",301,0.996689,20,302,1,301,1,1,0,1,1,163,162,139,139,70
"6240",39,"[20]rHoIoHcouHnJqGKCzwnF",299,0.996667,20,300,1,299,1,1,0,1,1,159,158,141,141,70
"6241",40,"[20]rHoIoHcouHnJqGKCzwnF",295,0.996622,20,296,1,295,1,1,0,1,1,144,143,152,152,70
"6242",41,"[20]rHoIoHcouHnJqGKCzwnF",299,0.996667,20,300,1,299,1,1,0,1,1,162,161,138,138,70
"6243",42,"[20]rHoIoHcouHnJqGKCzwnF",301,0.996689,20,302,1,301,1,1,0,1,1,159,158,143,143,70
"6244",43,"[20]rHoIoHcouHnJqGKCzwnF",296,0.996633,20,297,1,296,1,1,0,1,1,149,148,148,148,70
"6245",44,"[20]rHoIoHcouHnJqGKCzwnF",289,0.996552,20,290,1,289,1,1,0,1,1,127,126,163,163,70
"6246",45,"[20]rHoIoHcouHnJqGKCzwnF",293,0.996599,20,294,1,293,1,1,0,1,1,139,138,155,155,70
"6247",46,"[20]rHoIoHcouHnJqGKCzwnF",292,0.996587,20,293,1,292,1,1,0,1,1,138,137,155,155,70
"6248",47,"[20]rHoIoHcouHnJqGKCzwnF",294,0.99661,20,295,1,294,1,1,0,1,1,144,143,151,151,70
"6249",48,"[20]rHoIoHcouHnJqGKCzwnF",295,0.996622,20,296,1,295,1,1,0,1,1,146,145,150,150,70
"6250",49,"[20]rHoIoHcouHnJqGKCzwnF",294,0.99661,20,295,1,294,1,1,0,1,1,136,135,159,159,70
"6251",50,"[20]rHoIoHcouHnJqGKCzwnF",294,0.99661,20,295,1,294,1,1,0,1,1,141,140,154,154,70
"6252",51,"[20]rHoIoHcouHnJqGKCzwnF",298,0.996656,20,299,1,298,1,1,0,1,1,156,155,143,143,70
"6253",52,"[20]rHoIoHcouHnJqGKCzwnF",299,0.996667,20,300,1,299,1,1,0,1,1,159,158,141,141,70
"6254",53,"[20]rHoIoHcouHnJqGKCzwnF",297,0.996644,20,298,1,297,1,1,0,1,1,147,146,151,151,70
"6255",54,"[20]rHoIoHcouHnJqGKCzwnF",296,0.996633,20,297,1,296,1,1,0,1,1,143,142,154,154,70
"6256",55,"[20]rHoIoHcouHnJqGKCzwnF",300,0.996678,20,301,1,300,1,1,0,1,1,159,158,142,142,70
"6257",56,"[20]rHoIoHcouHnJqGKCzwnF",297,0.996644,20,298,1,297,1,1,0,1,1,150,149,148,148,70
"6258",57,"[20]rHoIoHcouHnJqGKCzwnF",299,0.996667,20,300,1,299,1,1,0,1,1,155,154,145,145,70
"6259",58,"[20]rHoIoHcouHnJqGKCzwnF",297,0.996644,20,298,1,297,1,1,0,1,1,154,153,144,144,70
"6260",59,"[20]rHoIoHcouHnJqGKCzwnF",300,0.996678,20,301,1,300,1,1,0,1,1,168,167,133,133,70
"6261",60,"[20]rHoIoHcouHnJqGKCzwnF",301,0.996689,20,302,1,301,1,1,0,1,1,163,162,139,139,70
"6262",61,"[20]rHoIoHcouHnJqGKCzwnF",297,0.996644,20,298,1,297,1,1,0,1,1,146,145,152,152,70
"6263",62,"[20]rHoIoHcouHnJqGKCzwnF",299,0.996667,20,300,1,299,1,1,0,1,1,156,155,144,144,70
"6264",63,"[20]rHoIoHcouHnJqGKCzwnF",298,0.996656,20,299,1,298,1,1,0,1,1,152,151,147,147,70
"6265",64,"[20]rHoIoHcouHnJqGKCzwnF",295,0.996622,20,296,1,295,1,1,0,1,1,155,154,141,141,70
"6266",65,"[20]rHoIoHcouHnJqGKCzwnF",294,0.99661,20,295,1,294,1,1,0,1,1,144,143,151,151,70
"6267",66,"[20]rHoIoHcouHnJqGKCzwnF",295,0.996622,20,296,1,295,1,1,0,1,1,144,143,152,152,70
"6268",67,"[20]rHoIoHcouHnJqGKCzwnF",293,0.996599,20,294,1,293,1,1,0,1,1,138,137,156,156,70
"6269",68,"[20]rHoIoHcouHnJqGKCzwnF",292,0.996587,20,293,1,292,1,1,0,1,1,142,141,151,151,70
"6270",69,"[20]rHoIoHcouHnJqGKCzwnF",298,0.996656,20,299,1,298,1,1,0,1,1,157,156,142,142,70
"6271",70,"[20]rHoIoHcouHnJqGKCzwnF",290,0.996564,20,291,1,290,1,1,0,1,1,131,130,160,160,70
"6272",71,"[20]rHoIoHcouHnJqGKCzwnF",289,0.996552,20,290,1,289,1,1,0,1,1,134,133,156,156,70
"6273",72,"[20]rHoIoHcouHnJqGKCzwnF",299,0.996667,20,300,1,299,1,1,0,1,1,165,164,135,135,70
"6274",73,"[20]rHoIoHcouHnJqGKCzwnF",297,0.996644,20,298,1,297,1,1,0,1,1,155,154,143,143,70
"6275",74,"[20]rHoIoHcouHnJqGKCzwnF",299,0.996667,20,300,1,299,1,1,0,1,1,155,154,145,145,70
"6276",75,"[20]rHoIoHcouHnJqGKCzwnF",295,0.996622,20,296,1,295,1,1,0,1,1,139,138,157,157,70
"6277",76,"[20]rHoIoHcouHnJqGKCzwnF",295,0.996622,20,296,1,295,1,1,0,1,1,147,146,149,149,70
"6278",77,"[20]rHoIoHcouHnJqGKCzwnF",293,0.996599,20,294,1,293,1,1,0,1,1,138,137,156,156,70
"6279",78,"[20]rHoIoHcouHnJqGKCzwnF",295,0.996622,20,296,1,295,1,1,0,1,1,150,149,146,146,70
"6280",79,"[20]rHoIoHcouHnJqGKCzwnF",292,0.996587,20,293,1,292,1,1,0,1,1,145,144,148,148,70
"6281",80,"[20]rHoIoHcouHnJqGKCzwnF",294,0.99661,20,295,1,294,1,1,0,1,1,142,141,153,153,70
"6282",81,"[20]rHoIoHcouHnJqGKCzwnF",297,0.996644,20,298,1,297,1,1,0,1,1,150,149,148,148,70
"6283",82,"[20]rHoIoHcouHnJqGKCzwnF",297,0.996644,20,298,1,297,1,1,0,1,1,146,145,152,152,70
"6284",83,"[20]rHoIoHcouHnJqGKCzwnF",293,0.996599,20,294,1,293,1,1,0,1,1,138,137,156,156,70
"6285",84,"[20]rHoIoHcouHnJqGKCzwnF",297,0.996644,20,298,1,297,1,1,0,1,1,157,156,141,141,70
"6286",85,"[20]rHoIoHcouHnJqGKCzwnF",298,0.996656,20,299,1,298,1,1,0,1,1,158,157,141,141,70
"6287",86,"[20]rHoIoHcouHnJqGKCzwnF",295,0.996622,20,296,1,295,1,1,0,1,1,151,150,145,145,70
"6288",87,"[20]rHoIoHcouHnJqGKCzwnF",307,0.996753,20,308,1,307,1,1,0,1,1,178,177,130,130,70
"6289",88,"[20]rHoIoHcouHnJqGKCzwnF",291,0.996575,20,292,1,291,1,1,0,1,1,143,142,149,149,70
"6290",89,"[20]rHoIoHcouHnJqGKCzwnF",300,0.996678,20,301,1,300,1,1,0,1,1,155,154,146,146,70
"6291",90,"[20]rHoIoHcouHnJqGKCzwnF",290,0.996564,20,291,1,290,1,1,0,1,1,129,128,162,162,70
"6292",91,"[20]rHoIoHcouHnJqGKCzwnF",297,0.996644,20,298,1,297,1,1,0,1,1,152,151,146,146,70
"6293",92,"[20]rHoIoHcouHnJqGKCzwnF",301,0.996689,20,302,1,301,1,1,0,1,1,160,159,142,142,70
"6294",93,"[20]rHoIoHcouHnJqGKCzwnF",287,0.996528,20,288,1,287,1,1,0,1,1,135,134,153,153,70
"6295",94,"[20]rHoIoHcouHnJqGKCzwnF",295,0.996622,20,296,1,295,1,1,0,1,1,145,144,151,151,70
"6296",95,"[20]rHoIoHcouHnJqGKCzwnF",291,0.996575,20,292,1,291,1,1,0,1,1,132,131,160,160,70
"6297",96,"[20]rHoIoHcouHnJqGKCzwnF",294,0.99661,20,295,1,294,1,1,0,1,1,141,140,154,154,70
"6298",97,"[20]rHoIoHcouHnJqGKCzwnF",292,0.996587,20,293,1,292,1,1,0,1,1,148,147,145,145,70
"6299",98,"[20]rHoIoHcouHnJqGKCzwnF",294,0.99661,20,295,1,294,1,1,0,1,1,137,136,158,158,70
"6300",99,"[20]rHoIoHcouHnJqGKCzwnF",302,0.9967,20,303,1,302,1,1,0,1,1,161,160,142,142,70
"6301",0,"[27]uHoIoHcovHnJHGqKCKiApsyFtpH",280,0.996441,27,281,1,280,1,1,0,1,1,153,152,128,128,71
"6302",1,"[27]uHoIoHcovHnJHGqKCKiApsyFtpH",277,0.996403,27,278,1,277,1,1,0,1,1,145,144,133,133,71
"6303",2,"[27]uHoIoHcovHnJHGqKCKiApsyFtpH",279,0.996429,27,280,1,279,1,1,0,1,1,141,140,139,139,71
"6304",3,"[27]uHoIoHcovHnJHGqKCKiApsyFtpH",278,0.996416,27,279,1,278,1,1,0,1,1,146,145,133,133,71
"6305",4,"[27]uHoIoHcovHnJHGqKCKiApsyFtpH",275,0.996377,27,276,1,275,1,1,0,1,1,136,135,140,140,71
"6306",5,"[27]uHoIoHcovHnJHGqKCKiApsyFtpH",278,0.996416,27,279,1,278,1,1,0,1,1,143,142,136,136,71
"6307",6,"[27]uHoIoHcovHnJHGqKCKiApsyFtpH",273,0.99635,27,274,1,273,1,1,0,1,1,127,126,147,147,71
"6308",7,"[27]uHoIoHcovHnJHGqKCKiApsyFtpH",283,0.996479,27,284,1,283,1,1,0,1,1,148,147,136,136,71
"6309",8,"[27]uHoIoHcovHnJHGqKCKiApsyFtpH",281,0.996454,27,282,1,281,1,1,0,1,1,155,154,127,127,71
"6310",9,"[27]uHoIoHcovHnJHGqKCKiApsyFtpH",279,0.996429,27,280,1,279,1,1,0,1,1,146,145,134,134,71
"6311",10,"[27]uHoIoHcovHnJHGqKCKiApsyFtpH",278,0.996416,27,279,1,278,1,1,0,1,1,152,151,127,127,71
"6312",11,"[27]uHoIoHcovHnJHGqKCKiApsyFtpH",275,0.996377,27,276,1,275,1,1,0,1,1,131,130,145,145,71
"6313",12,"[27]uHoIoHcovHnJHGqKCKiApsyFtpH",280,0.996441,27,281,1,280,1,1,0,1,1,139,138,142,142,71
"6314",13,"[27]uHoIoHcovHnJHGqKCKiApsyFtpH",275,0.996377,27,276,1,275,1,1,0,1,1,129,128,147,147,71
"6315",14,"[27]uHoIoHcovHnJHGqKCKiApsyFtpH",277,0.996403,27,278,1,277,1,1,0,1,1,138,137,140,140,71
"6316",15,"[27]uHoIoHcovHnJHGqKCKiApsyFtpH",284,0.996491,27,285,1,284,1,1,0,1,1,147,146,138,138,71
"6317",16,"[27]uHoIoHcovHnJHGqKCKiApsyFtpH",283,0.996479,27,284,1,283,1,1,0,1,1,140,139,144,144,71
"6318",17,"[27]uHoIoHcovHnJHGqKCKiApsyFtpH",271,0.996324,27,272,1,271,1,1,0,1,1,136,135,136,136,71
"6319",18,"[27]uHoIoHcovHnJHGqKCKiApsyFtpH",276,0.99639,27,277,1,276,1,1,0,1,1,131,130,146,146,71
"6320",19,"[27]uHoIoHcovHnJHGqKCKiApsyFtpH",281,0.996454,27,282,1,281,1,1,0,1,1,136,135,146,146,71
"6321",20,"[27]uHoIoHcovHnJHGqKCKiApsyFtpH",281,0.996454,27,282,1,281,1,1,0,1,1,150,149,132,132,71
"6322",21,"[27]uHoIoHcovHnJHGqKCKiApsyFtpH",279,0.996429,27,280,1,279,1,1,0,1,1,141,140,139,139,71
"6323",22,"[27]uHoIoHcovHnJHGqKCKiApsyFtpH",279,0.996429,27,280,1,279,1,1,0,1,1,139,138,141,141,71
"6324",23,"[27]uHoIoHcovHnJHGqKCKiApsyFtpH",281,0.996454,27,282,1,281,1,1,0,1,1,150,149,132,132,71
"6325",24,"[27]uHoIoHcovHnJHGqKCKiApsyFtpH",279,0.996429,27,280,1,279,1,1,0,1,1,135,134,145,145,71
"6326",25,"[27]uHoIoHcovHnJHGqKCKiApsyFtpH",279,0.996429,27,280,1,279,1,1,0,1,1,142,141,138,138,71
"6327",26,"[27]uHoIoHcovHnJHGqKCKiApsyFtpH",280,0.996441,27,281,1,280,1,1,0,1,1,128,127,153,153,71
"6328",27,"[27]uHoIoHcovHnJHGqKCKiApsyFtpH",278,0.996416,27,279,1,278,1,1,0,1,1,137,136,142,142,71
"6329",28,"[27]uHoIoHcovHnJHGqKCKiApsyFtpH",278,0.996416,27,279,1,278,1,1,0,1,1,143,142,136,136,71
"6330",29,"[27]uHoIoHcovHnJHGqKCKiApsyFtpH",280,0.996441,27,281,1,280,1,1,0,1,1,149,148,132,132,71
"6331",30,"[27]uHoIoHcovHnJHGqKCKiApsyFtpH",275,0.996377,27,276,1,275,1,1,0,1,1,132,131,144,144,71
"6332",31,"[27]uHoIoHcovHnJHGqKCKiApsyFtpH",280,0.996441,27,281,1,280,1,1,0,1,1,144,143,137,137,71
"6333",32,"[27]uHoIoHcovHnJHGqKCKiApsyFtpH",271,0.996324,27,272,1,271,1,1,0,1,1,121,120,151,151,71
"6334",33,"[27]uHoIoHcovHnJHGqKCKiApsyFtpH",287,0.996528,27,288,1,287,1,1,0,1,1,153,152,135,135,71
"6335",34,"[27]uHoIoHcovHnJHGqKCKiApsyFtpH",276,0.99639,27,277,1,276,1,1,0,1,1,137,136,140,140,71
"6336",35,"[27]uHoIoHcovHnJHGqKCKiApsyFtpH",285,0.996503,27,286,1,285,1,1,0,1,1,144,143,142,142,71
"6337",36,"[27]uHoIoHcovHnJHGqKCKiApsyFtpH",278,0.996416,27,279,1,278,1,1,0,1,1,139,138,140,140,71
"6338",37,"[27]uHoIoHcovHnJHGqKCKiApsyFtpH",285,0.996503,27,286,1,285,1,1,0,1,1,146,145,140,140,71
"6339",38,"[27]uHoIoHcovHnJHGqKCKiApsyFtpH",285,0.996503,27,286,1,285,1,1,0,1,1,149,148,137,137,71
"6340",39,"[27]uHoIoHcovHnJHGqKCKiApsyFtpH",282,0.996466,27,283,1,282,1,1,0,1,1,142,141,141,141,71
"6341",40,"[27]uHoIoHcovHnJHGqKCKiApsyFtpH",272,0.996337,27,273,1,272,1,1,0,1,1,125,124,148,148,71
"6342",41,"[27]uHoIoHcovHnJHGqKCKiApsyFtpH",275,0.996377,27,276,1,275,1,1,0,1,1,128,127,148,148,71
"6343",42,"[27]uHoIoHcovHnJHGqKCKiApsyFtpH",274,0.996364,27,275,1,274,1,1,0,1,1,132,131,143,143,71
"6344",43,"[27]uHoIoHcovHnJHGqKCKiApsyFtpH",282,0.996466,27,283,1,282,1,1,0,1,1,129,128,154,154,71
"6345",44,"[27]uHoIoHcovHnJHGqKCKiApsyFtpH",283,0.996479,27,284,1,283,1,1,0,1,1,147,146,137,137,71
"6346",45,"[27]uHoIoHcovHnJHGqKCKiApsyFtpH",279,0.996429,27,280,1,279,1,1,0,1,1,139,138,141,141,71
"6347",46,"[27]uHoIoHcovHnJHGqKCKiApsyFtpH",281,0.996454,27,282,1,281,1,1,0,1,1,133,132,149,149,71
"6348",47,"[27]uHoIoHcovHnJHGqKCKiApsyFtpH",281,0.996454,27,282,1,281,1,1,0,1,1,133,132,149,149,71
"6349",48,"[27]uHoIoHcovHnJHGqKCKiApsyFtpH",277,0.996403,27,278,1,277,1,1,0,1,1,138,137,140,140,71
"6350",49,"[27]uHoIoHcovHnJHGqKCKiApsyFtpH",272,0.996337,27,273,1,272,1,1,0,1,1,138,137,135,135,71
"6351",50,"[27]uHoIoHcovHnJHGqKCKiApsyFtpH",280,0.996441,27,281,1,280,1,1,0,1,1,147,146,134,134,71
"6352",51,"[27]uHoIoHcovHnJHGqKCKiApsyFtpH",276,0.99639,27,277,1,276,1,1,0,1,1,146,145,131,131,71
"6353",52,"[27]uHoIoHcovHnJHGqKCKiApsyFtpH",276,0.99639,27,277,1,276,1,1,0,1,1,151,150,126,126,71
"6354",53,"[27]uHoIoHcovHnJHGqKCKiApsyFtpH",287,0.996528,27,288,1,287,1,1,0,1,1,141,140,147,147,71
"6355",54,"[27]uHoIoHcovHnJHGqKCKiApsyFtpH",282,0.996466,27,283,1,282,1,1,0,1,1,153,152,130,130,71
"6356",55,"[27]uHoIoHcovHnJHGqKCKiApsyFtpH",272,0.996337,27,273,1,272,1,1,0,1,1,138,137,135,135,71
"6357",56,"[27]uHoIoHcovHnJHGqKCKiApsyFtpH",288,0.99654,27,289,1,288,1,1,0,1,1,156,155,133,133,71
"6358",57,"[27]uHoIoHcovHnJHGqKCKiApsyFtpH",280,0.996441,27,281,1,280,1,1,0,1,1,139,138,142,142,71
"6359",58,"[27]uHoIoHcovHnJHGqKCKiApsyFtpH",282,0.996466,27,283,1,282,1,1,0,1,1,129,128,154,154,71
"6360",59,"[27]uHoIoHcovHnJHGqKCKiApsyFtpH",280,0.996441,27,281,1,280,1,1,0,1,1,148,147,133,133,71
"6361",60,"[27]uHoIoHcovHnJHGqKCKiApsyFtpH",285,0.996503,27,286,1,285,1,1,0,1,1,148,147,138,138,71
"6362",61,"[27]uHoIoHcovHnJHGqKCKiApsyFtpH",284,0.996491,27,285,1,284,1,1,0,1,1,162,161,123,123,71
"6363",62,"[27]uHoIoHcovHnJHGqKCKiApsyFtpH",288,0.99654,27,289,1,288,1,1,0,1,1,148,147,141,141,71
"6364",63,"[27]uHoIoHcovHnJHGqKCKiApsyFtpH",288,0.99654,27,289,1,288,1,1,0,1,1,149,148,140,140,71
"6365",64,"[27]uHoIoHcovHnJHGqKCKiApsyFtpH",282,0.996466,27,283,1,282,1,1,0,1,1,153,152,130,130,71
"6366",65,"[27]uHoIoHcovHnJHGqKCKiApsyFtpH",282,0.996466,27,283,1,282,1,1,0,1,1,137,136,146,146,71
"6367",66,"[27]uHoIoHcovHnJHGqKCKiApsyFtpH",279,0.996429,27,280,1,279,1,1,0,1,1,150,149,130,130,71
"6368",67,"[27]uHoIoHcovHnJHGqKCKiApsyFtpH",272,0.996337,27,273,1,272,1,1,0,1,1,139,138,134,134,71
"6369",68,"[27]uHoIoHcovHnJHGqKCKiApsyFtpH",286,0.996516,27,287,1,286,1,1,0,1,1,146,145,141,141,71
"6370",69,"[27]uHoIoHcovHnJHGqKCKiApsyFtpH",277,0.996403,27,278,1,277,1,1,0,1,1,157,156,121,121,71
"6371",70,"[27]uHoIoHcovHnJHGqKCKiApsyFtpH",288,0.99654,27,289,1,288,1,1,0,1,1,155,154,134,134,71
"6372",71,"[27]uHoIoHcovHnJHGqKCKiApsyFtpH",291,0.996575,27,292,1,291,1,1,0,1,1,156,155,136,136,71
"6373",72,"[27]uHoIoHcovHnJHGqKCKiApsyFtpH",270,0.99631,27,271,1,270,1,1,0,1,1,136,135,135,135,71
"6374",73,"[27]uHoIoHcovHnJHGqKCKiApsyFtpH",278,0.996416,27,279,1,278,1,1,0,1,1,129,128,150,150,71
"6375",74,"[27]uHoIoHcovHnJHGqKCKiApsyFtpH",287,0.996528,27,288,1,287,1,1,0,1,1,148,147,140,140,71
"6376",75,"[27]uHoIoHcovHnJHGqKCKiApsyFtpH",290,0.996564,27,291,1,290,1,1,0,1,1,139,138,152,152,71
"6377",76,"[27]uHoIoHcovHnJHGqKCKiApsyFtpH",285,0.996503,27,286,1,285,1,1,0,1,1,142,141,144,144,71
"6378",77,"[27]uHoIoHcovHnJHGqKCKiApsyFtpH",274,0.996364,27,275,1,274,1,1,0,1,1,121,120,154,154,71
"6379",78,"[27]uHoIoHcovHnJHGqKCKiApsyFtpH",277,0.996403,27,278,1,277,1,1,0,1,1,141,140,137,137,71
"6380",79,"[27]uHoIoHcovHnJHGqKCKiApsyFtpH",289,0.996552,27,290,1,289,1,1,0,1,1,164,163,126,126,71
"6381",80,"[27]uHoIoHcovHnJHGqKCKiApsyFtpH",277,0.996403,27,278,1,277,1,1,0,1,1,135,134,143,143,71
"6382",81,"[27]uHoIoHcovHnJHGqKCKiApsyFtpH",280,0.996441,27,281,1,280,1,1,0,1,1,135,134,146,146,71
"6383",82,"[27]uHoIoHcovHnJHGqKCKiApsyFtpH",275,0.996377,27,276,1,275,1,1,0,1,1,143,142,133,133,71
"6384",83,"[27]uHoIoHcovHnJHGqKCKiApsyFtpH",283,0.996479,27,284,1,283,1,1,0,1,1,136,135,148,148,71
"6385",84,"[27]uHoIoHcovHnJHGqKCKiApsyFtpH",278,0.996416,27,279,1,278,1,1,0,1,1,150,149,129,129,71
"6386",85,"[27]uHoIoHcovHnJHGqKCKiApsyFtpH",281,0.996454,27,282,1,281,1,1,0,1,1,148,147,134,134,71
"6387",86,"[27]uHoIoHcovHnJHGqKCKiApsyFtpH",284,0.996491,27,285,1,284,1,1,0,1,1,138,137,147,147,71
"6388",87,"[27]uHoIoHcovHnJHGqKCKiApsyFtpH",274,0.996364,27,275,1,274,1,1,0,1,1,132,131,143,143,71
"6389",88,"[27]uHoIoHcovHnJHGqKCKiApsyFtpH",284,0.996491,27,285,1,284,1,1,0,1,1,163,162,122,122,71
"6390",89,"[27]uHoIoHcovHnJHGqKCKiApsyFtpH",290,0.996564,27,291,1,290,1,1,0,1,1,151,150,140,140,71
"6391",90,"[27]uHoIoHcovHnJHGqKCKiApsyFtpH",279,0.996429,27,280,1,279,1,1,0,1,1,148,147,132,132,71
"6392",91,"[27]uHoIoHcovHnJHGqKCKiApsyFtpH",277,0.996403,27,278,1,277,1,1,0,1,1,133,132,145,145,71
"6393",92,"[27]uHoIoHcovHnJHGqKCKiApsyFtpH",279,0.996429,27,280,1,279,1,1,0,1,1,126,125,154,154,71
"6394",93,"[27]uHoIoHcovHnJHGqKCKiApsyFtpH",277,0.996403,27,278,1,277,1,1,0,1,1,142,141,136,136,71
"6395",94,"[27]uHoIoHcovHnJHGqKCKiApsyFtpH",274,0.996364,27,275,1,274,1,1,0,1,1,144,143,131,131,71
"6396",95,"[27]uHoIoHcovHnJHGqKCKiApsyFtpH",286,0.996516,27,287,1,286,1,1,0,1,1,155,154,132,132,71
"6397",96,"[27]uHoIoHcovHnJHGqKCKiApsyFtpH",276,0.99639,27,277,1,276,1,1,0,1,1,144,143,133,133,71
"6398",97,"[27]uHoIoHcovHnJHGqKCKiApsyFtpH",288,0.99654,27,289,1,288,1,1,0,1,1,157,156,132,132,71
"6399",98,"[27]uHoIoHcovHnJHGqKCKiApsyFtpH",282,0.996466,27,283,1,282,1,1,0,1,1,143,142,140,140,71
"6400",99,"[27]uHoIoHcovHnJHGqKCKiApsyFtpH",280,0.996441,27,281,1,280,1,1,0,1,1,133,132,148,148,71
"6401",0,"[28]JHEoIloHcowHnJHGqKCAhjqmftKn",280,0.996441,28,281,1,280,1,1,0,1,1,147,146,134,134,72
"6402",1,"[28]JHEoIloHcowHnJHGqKCAhjqmftKn",286,0.996516,28,287,1,286,1,1,0,1,1,143,142,144,144,72
"6403",2,"[28]JHEoIloHcowHnJHGqKCAhjqmftKn",275,0.996377,28,276,1,275,1,1,0,1,1,137,136,139,139,72
"6404",3,"[28]JHEoIloHcowHnJHGqKCAhjqmftKn",283,0.996479,28,284,1,283,1,1,0,1,1,136,135,148,148,72
"6405",4,"[28]JHEoIloHcowHnJHGqKCAhjqmftKn",280,0.996441,28,281,1,280,1,1,0,1,1,135,134,146,146,72
"6406",5,"[28]JHEoIloHcowHnJHGqKCAhjqmftKn",292,0.996587,28,293,1,292,1,1,0,1,1,156,155,137,137,72
"6407",6,"[28]JHEoIloHcowHnJHGqKCAhjqmftKn",282,0.996466,28,283,1,282,1,1,0,1,1,142,141,141,141,72
"6408",7,"[28]JHEoIloHcowHnJHGqKCAhjqmftKn",278,0.996416,28,279,1,278,1,1,0,1,1,138,137,141,141,72
"6409",8,"[28]JHEoIloHcowHnJHGqKCAhjqmftKn",278,0.996416,28,279,1,278,1,1,0,1,1,128,127,151,151,72
"6410",9,"[28]JHEoIloHcowHnJHGqKCAhjqmftKn",283,0.996479,28,284,1,283,1,1,0,1,1,141,140,143,143,72
"6411",10,"[28]JHEoIloHcowHnJHGqKCAhjqmftKn",287,0.996528,28,288,1,287,1,1,0,1,1,130,129,158,158,72
"6412",11,"[28]JHEoIloHcowHnJHGqKCAhjqmftKn",276,0.99639,28,277,1,276,1,1,0,1,1,123,122,154,154,72
"6413",12,"[28]JHEoIloHcowHnJHGqKCAhjqmftKn",285,0.996503,28,286,1,285,1,1,0,1,1,127,126,159,159,72
"6414",13,"[28]JHEoIloHcowHnJHGqKCAhjqmftKn",283,0.996479,28,284,1,283,1,1,0,1,1,131,130,153,153,72
"6415",14,"[28]JHEoIloHcowHnJHGqKCAhjqmftKn",281,0.996454,28,282,1,281,1,1,0,1,1,147,146,135,135,72
"6416",15,"[28]JHEoIloHcowHnJHGqKCAhjqmftKn",288,0.99654,28,289,1,288,1,1,0,1,1,147,146,142,142,72
"6417",16,"[28]JHEoIloHcowHnJHGqKCAhjqmftKn",279,0.996429,28,280,1,279,1,1,0,1,1,144,143,136,136,72
"6418",17,"[28]JHEoIloHcowHnJHGqKCAhjqmftKn",289,0.996552,28,290,1,289,1,1,0,1,1,154,153,136,136,72
"6419",18,"[28]JHEoIloHcowHnJHGqKCAhjqmftKn",279,0.996429,28,280,1,279,1,1,0,1,1,131,130,149,149,72
"6420",19,"[28]JHEoIloHcowHnJHGqKCAhjqmftKn",277,0.996403,28,278,1,277,1,1,0,1,1,131,130,147,147,72
"6421",20,"[28]JHEoIloHcowHnJHGqKCAhjqmftKn",278,0.996416,28,279,1,278,1,1,0,1,1,133,132,146,146,72
"6422",21,"[28]JHEoIloHcowHnJHGqKCAhjqmftKn",281,0.996454,28,282,1,281,1,1,0,1,1,158,157,124,124,72
"6423",22,"[28]JHEoIloHcowHnJHGqKCAhjqmftKn",288,0.99654,28,289,1,288,1,1,0,1,1,146,145,143,143,72
"6424",23,"[28]JHEoIloHcowHnJHGqKCAhjqmftKn",286,0.996516,28,287,1,286,1,1,0,1,1,149,148,138,138,72
"6425",24,"[28]JHEoIloHcowHnJHGqKCAhjqmftKn",276,0.99639,28,277,1,276,1,1,0,1,1,133,132,144,144,72
"6426",25,"[28]JHEoIloHcowHnJHGqKCAhjqmftKn",276,0.99639,28,277,1,276,1,1,0,1,1,132,131,145,145,72
"6427",26,"[28]JHEoIloHcowHnJHGqKCAhjqmftKn",278,0.996416,28,279,1,278,1,1,0,1,1,133,132,146,146,72
"6428",27,"[28]JHEoIloHcowHnJHGqKCAhjqmftKn",291,0.996575,28,292,1,291,1,1,0,1,1,159,158,133,133,72
"6429",28,"[28]JHEoIloHcowHnJHGqKCAhjqmftKn",284,0.996491,28,285,1,284,1,1,0,1,1,139,138,146,146,72
"6430",29,"[28]JHEoIloHcowHnJHGqKCAhjqmftKn",285,0.996503,28,286,1,285,1,1,0,1,1,154,153,132,132,72
"6431",30,"[28]JHEoIloHcowHnJHGqKCAhjqmftKn",274,0.996364,28,275,1,274,1,1,0,1,1,143,142,132,132,72
"6432",31,"[28]JHEoIloHcowHnJHGqKCAhjqmftKn",285,0.996503,28,286,1,285,1,1,0,1,1,144,143,142,142,72
"6433",32,"[28]JHEoIloHcowHnJHGqKCAhjqmftKn",273,0.99635,28,274,1,273,1,1,0,1,1,126,125,148,148,72
"6434",33,"[28]JHEoIloHcowHnJHGqKCAhjqmftKn",283,0.996479,28,284,1,283,1,1,0,1,1,143,142,141,141,72
"6435",34,"[28]JHEoIloHcowHnJHGqKCAhjqmftKn",277,0.996403,28,278,1,277,1,1,0,1,1,130,129,148,148,72
"6436",35,"[28]JHEoIloHcowHnJHGqKCAhjqmftKn",276,0.99639,28,277,1,276,1,1,0,1,1,140,139,137,137,72
"6437",36,"[28]JHEoIloHcowHnJHGqKCAhjqmftKn",285,0.996503,28,286,1,285,1,1,0,1,1,147,146,139,139,72
"6438",37,"[28]JHEoIloHcowHnJHGqKCAhjqmftKn",286,0.996516,28,287,1,286,1,1,0,1,1,145,144,142,142,72
"6439",38,"[28]JHEoIloHcowHnJHGqKCAhjqmftKn",283,0.996479,28,284,1,283,1,1,0,1,1,160,159,124,124,72
"6440",39,"[28]JHEoIloHcowHnJHGqKCAhjqmftKn",286,0.996516,28,287,1,286,1,1,0,1,1,159,158,128,128,72
"6441",40,"[28]JHEoIloHcowHnJHGqKCAhjqmftKn",287,0.996528,28,288,1,287,1,1,0,1,1,152,151,136,136,72
"6442",41,"[28]JHEoIloHcowHnJHGqKCAhjqmftKn",285,0.996503,28,286,1,285,1,1,0,1,1,146,145,140,140,72
"6443",42,"[28]JHEoIloHcowHnJHGqKCAhjqmftKn",274,0.996364,28,275,1,274,1,1,0,1,1,131,130,144,144,72
"6444",43,"[28]JHEoIloHcowHnJHGqKCAhjqmftKn",276,0.99639,28,277,1,276,1,1,0,1,1,125,124,152,152,72
"6445",44,"[28]JHEoIloHcowHnJHGqKCAhjqmftKn",284,0.996491,28,285,1,284,1,1,0,1,1,153,152,132,132,72
"6446",45,"[28]JHEoIloHcowHnJHGqKCAhjqmftKn",284,0.996491,28,285,1,284,1,1,0,1,1,139,138,146,146,72
"6447",46,"[28]JHEoIloHcowHnJHGqKCAhjqmftKn",290,0.996564,28,291,1,290,1,1,0,1,1,142,141,149,149,72
"6448",47,"[28]JHEoIloHcowHnJHGqKCAhjqmftKn",280,0.996441,28,281,1,280,1,1,0,1,1,134,133,147,147,72
"6449",48,"[28]JHEoIloHcowHnJHGqKCAhjqmftKn",288,0.99654,28,289,1,288,1,1,0,1,1,159,158,130,130,72
"6450",49,"[28]JHEoIloHcowHnJHGqKCAhjqmftKn",289,0.996552,28,290,1,289,1,1,0,1,1,139,138,151,151,72
"6451",50,"[28]JHEoIloHcowHnJHGqKCAhjqmftKn",282,0.996466,28,283,1,282,1,1,0,1,1,137,136,146,146,72
"6452",51,"[28]JHEoIloHcowHnJHGqKCAhjqmftKn",282,0.996466,28,283,1,282,1,1,0,1,1,143,142,140,140,72
"6453",52,"[28]JHEoIloHcowHnJHGqKCAhjqmftKn",286,0.996516,28,287,1,286,1,1,0,1,1,147,146,140,140,72
"6454",53,"[28]JHEoIloHcowHnJHGqKCAhjqmftKn",280,0.996441,28,281,1,280,1,1,0,1,1,141,140,140,140,72
"6455",54,"[28]JHEoIloHcowHnJHGqKCAhjqmftKn",290,0.996564,28,291,1,290,1,1,0,1,1,161,160,130,130,72
"6456",55,"[28]JHEoIloHcowHnJHGqKCAhjqmftKn",281,0.996454,28,282,1,281,1,1,0,1,1,160,159,122,122,72
"6457",56,"[28]JHEoIloHcowHnJHGqKCAhjqmftKn",283,0.996479,28,284,1,283,1,1,0,1,1,138,137,146,146,72
"6458",57,"[28]JHEoIloHcowHnJHGqKCAhjqmftKn",283,0.996479,28,284,1,283,1,1,0,1,1,138,137,146,146,72
"6459",58,"[28]JHEoIloHcowHnJHGqKCAhjqmftKn",279,0.996429,28,280,1,279,1,1,0,1,1,140,139,140,140,72
"6460",59,"[28]JHEoIloHcowHnJHGqKCAhjqmftKn",287,0.996528,28,288,1,287,1,1,0,1,1,143,142,145,145,72
"6461",60,"[28]JHEoIloHcowHnJHGqKCAhjqmftKn",282,0.996466,28,283,1,282,1,1,0,1,1,142,141,141,141,72
"6462",61,"[28]JHEoIloHcowHnJHGqKCAhjqmftKn",277,0.996403,28,278,1,277,1,1,0,1,1,141,140,137,137,72
"6463",62,"[28]JHEoIloHcowHnJHGqKCAhjqmftKn",276,0.99639,28,277,1,276,1,1,0,1,1,144,143,133,133,72
"6464",63,"[28]JHEoIloHcowHnJHGqKCAhjqmftKn",282,0.996466,28,283,1,282,1,1,0,1,1,157,156,126,126,72
"6465",64,"[28]JHEoIloHcowHnJHGqKCAhjqmftKn",289,0.996552,28,290,1,289,1,1,0,1,1,153,152,137,137,72
"6466",65,"[28]JHEoIloHcowHnJHGqKCAhjqmftKn",284,0.996491,28,285,1,284,1,1,0,1,1,146,145,139,139,72
"6467",66,"[28]JHEoIloHcowHnJHGqKCAhjqmftKn",286,0.996516,28,287,1,286,1,1,0,1,1,144,143,143,143,72
"6468",67,"[28]JHEoIloHcowHnJHGqKCAhjqmftKn",282,0.996466,28,283,1,282,1,1,0,1,1,143,142,140,140,72
"6469",68,"[28]JHEoIloHcowHnJHGqKCAhjqmftKn",285,0.996503,28,286,1,285,1,1,0,1,1,149,148,137,137,72
"6470",69,"[28]JHEoIloHcowHnJHGqKCAhjqmftKn",283,0.996479,28,284,1,283,1,1,0,1,1,145,144,139,139,72
"6471",70,"[28]JHEoIloHcowHnJHGqKCAhjqmftKn",289,0.996552,28,290,1,289,1,1,0,1,1,165,164,125,125,72
"6472",71,"[28]JHEoIloHcowHnJHGqKCAhjqmftKn",279,0.996429,28,280,1,279,1,1,0,1,1,134,133,146,146,72
"6473",72,"[28]JHEoIloHcowHnJHGqKCAhjqmftKn",278,0.996416,28,279,1,278,1,1,0,1,1,128,127,151,151,72
"6474",73,"[28]JHEoIloHcowHnJHGqKCAhjqmftKn",284,0.996491,28,285,1,284,1,1,0,1,1,135,134,150,150,72
"6475",74,"[28]JHEoIloHcowHnJHGqKCAhjqmftKn",278,0.996416,28,279,1,278,1,1,0,1,1,133,132,146,146,72
"6476",75,"[28]JHEoIloHcowHnJHGqKCAhjqmftKn",280,0.996441,28,281,1,280,1,1,0,1,1,140,139,141,141,72
"6477",76,"[28]JHEoIloHcowHnJHGqKCAhjqmftKn",272,0.996337,28,273,1,272,1,1,0,1,1,123,122,150,150,72
"6478",77,"[28]JHEoIloHcowHnJHGqKCAhjqmftKn",274,0.996364,28,275,1,274,1,1,0,1,1,154,153,121,121,72
"6479",78,"[28]JHEoIloHcowHnJHGqKCAhjqmftKn",281,0.996454,28,282,1,281,1,1,0,1,1,142,141,140,140,72
"6480",79,"[28]JHEoIloHcowHnJHGqKCAhjqmftKn",285,0.996503,28,286,1,285,1,1,0,1,1,141,140,145,145,72
"6481",80,"[28]JHEoIloHcowHnJHGqKCAhjqmftKn",289,0.996552,28,290,1,289,1,1,0,1,1,139,138,151,151,72
"6482",81,"[28]JHEoIloHcowHnJHGqKCAhjqmftKn",284,0.996491,28,285,1,284,1,1,0,1,1,140,139,145,145,72
"6483",82,"[28]JHEoIloHcowHnJHGqKCAhjqmftKn",282,0.996466,28,283,1,282,1,1,0,1,1,146,145,137,137,72
"6484",83,"[28]JHEoIloHcowHnJHGqKCAhjqmftKn",284,0.996491,28,285,1,284,1,1,0,1,1,132,131,153,153,72
"6485",84,"[28]JHEoIloHcowHnJHGqKCAhjqmftKn",282,0.996466,28,283,1,282,1,1,0,1,1,137,136,146,146,72
"6486",85,"[28]JHEoIloHcowHnJHGqKCAhjqmftKn",274,0.996364,28,275,1,274,1,1,0,1,1,125,124,150,150,72
"6487",86,"[28]JHEoIloHcowHnJHGqKCAhjqmftKn",284,0.996491,28,285,1,284,1,1,0,1,1,137,136,148,148,72
"6488",87,"[28]JHEoIloHcowHnJHGqKCAhjqmftKn",277,0.996403,28,278,1,277,1,1,0,1,1,139,138,139,139,72
"6489",88,"[28]JHEoIloHcowHnJHGqKCAhjqmftKn",278,0.996416,28,279,1,278,1,1,0,1,1,127,126,152,152,72
"6490",89,"[28]JHEoIloHcowHnJHGqKCAhjqmftKn",286,0.996516,28,287,1,286,1,1,0,1,1,149,148,138,138,72
"6491",90,"[28]JHEoIloHcowHnJHGqKCAhjqmftKn",289,0.996552,28,290,1,289,1,1,0,1,1,142,141,148,148,72
"6492",91,"[28]JHEoIloHcowHnJHGqKCAhjqmftKn",282,0.996466,28,283,1,282,1,1,0,1,1,157,156,126,126,72
"6493",92,"[28]JHEoIloHcowHnJHGqKCAhjqmftKn",283,0.996479,28,284,1,283,1,1,0,1,1,136,135,148,148,72
"6494",93,"[28]JHEoIloHcowHnJHGqKCAhjqmftKn",283,0.996479,28,284,1,283,1,1,0,1,1,139,138,145,145,72
"6495",94,"[28]JHEoIloHcowHnJHGqKCAhjqmftKn",273,0.99635,28,274,1,273,1,1,0,1,1,115,114,159,159,72
"6496",95,"[28]JHEoIloHcowHnJHGqKCAhjqmftKn",284,0.996491,28,285,1,284,1,1,0,1,1,144,143,141,141,72
"6497",96,"[28]JHEoIloHcowHnJHGqKCAhjqmftKn",285,0.996503,28,286,1,285,1,1,0,1,1,142,141,144,144,72
"6498",97,"[28]JHEoIloHcowHnJHGqKCAhjqmftKn",282,0.996466,28,283,1,282,1,1,0,1,1,148,147,135,135,72
"6499",98,"[28]JHEoIloHcowHnJHGqKCAhjqmftKn",278,0.996416,28,279,1,278,1,1,0,1,1,135,134,144,144,72
"6500",99,"[28]JHEoIloHcowHnJHGqKCAhjqmftKn",288,0.99654,28,289,1,288,1,1,0,1,1,145,144,144,144,72
"6501",0,"[23]EEoIoHcosHnJHGqKCKAecvf",275,0.996377,23,276,1,275,1,1,0,1,1,131,130,145,145,73
"6502",1,"[23]EEoIoHcosHnJHGqKCKAecvf",280,0.996441,23,281,1,280,1,1,0,1,1,152,151,129,129,73
"6503",2,"[23]EEoIoHcosHnJHGqKCKAecvf",277,0.996403,23,278,1,277,1,1,0,1,1,136,135,142,142,73
"6504",3,"[23]EEoIoHcosHnJHGqKCKAecvf",281,0.996454,23,282,1,281,1,1,0,1,1,144,143,138,138,73
"6505",4,"[23]EEoIoHcosHnJHGqKCKAecvf",277,0.996403,23,278,1,277,1,1,0,1,1,121,120,157,157,73
"6506",5,"[23]EEoIoHcosHnJHGqKCKAecvf",288,0.99654,23,289,1,288,1,1,0,1,1,148,147,141,141,73
"6507",6,"[23]EEoIoHcosHnJHGqKCKAecvf",275,0.996377,23,276,1,275,1,1,0,1,1,129,128,147,147,73
"6508",7,"[23]EEoIoHcosHnJHGqKCKAecvf",284,0.996491,23,285,1,284,1,1,0,1,1,145,144,140,140,73
"6509",8,"[23]EEoIoHcosHnJHGqKCKAecvf",275,0.996377,23,276,1,275,1,1,0,1,1,133,132,143,143,73
"6510",9,"[23]EEoIoHcosHnJHGqKCKAecvf",279,0.996429,23,280,1,279,1,1,0,1,1,140,139,140,140,73
"6511",10,"[23]EEoIoHcosHnJHGqKCKAecvf",278,0.996416,23,279,1,278,1,1,0,1,1,139,138,140,140,73
"6512",11,"[23]EEoIoHcosHnJHGqKCKAecvf",280,0.996441,23,281,1,280,1,1,0,1,1,143,142,138,138,73
"6513",12,"[23]EEoIoHcosHnJHGqKCKAecvf",279,0.996429,23,280,1,279,1,1,0,1,1,134,133,146,146,73
"6514",13,"[23]EEoIoHcosHnJHGqKCKAecvf",280,0.996441,23,281,1,280,1,1,0,1,1,140,139,141,141,73
"6515",14,"[23]EEoIoHcosHnJHGqKCKAecvf",283,0.996479,23,284,1,283,1,1,0,1,1,139,138,145,145,73
"6516",15,"[23]EEoIoHcosHnJHGqKCKAecvf",277,0.996403,23,278,1,277,1,1,0,1,1,139,138,139,139,73
"6517",16,"[23]EEoIoHcosHnJHGqKCKAecvf",287,0.996528,23,288,1,287,1,1,0,1,1,165,164,123,123,73
"6518",17,"[23]EEoIoHcosHnJHGqKCKAecvf",287,0.996528,23,288,1,287,1,1,0,1,1,147,146,141,141,73
"6519",18,"[23]EEoIoHcosHnJHGqKCKAecvf",279,0.996429,23,280,1,279,1,1,0,1,1,141,140,139,139,73
"6520",19,"[23]EEoIoHcosHnJHGqKCKAecvf",276,0.99639,23,277,1,276,1,1,0,1,1,136,135,141,141,73
"6521",20,"[23]EEoIoHcosHnJHGqKCKAecvf",279,0.996429,23,280,1,279,1,1,0,1,1,154,153,126,126,73
"6522",21,"[23]EEoIoHcosHnJHGqKCKAecvf",292,0.996587,23,293,1,292,1,1,0,1,1,150,149,143,143,73
"6523",22,"[23]EEoIoHcosHnJHGqKCKAecvf",280,0.996441,23,281,1,280,1,1,0,1,1,127,126,154,154,73
"6524",23,"[23]EEoIoHcosHnJHGqKCKAecvf",275,0.996377,23,276,1,275,1,1,0,1,1,128,127,148,148,73
"6525",24,"[23]EEoIoHcosHnJHGqKCKAecvf",279,0.996429,23,280,1,279,1,1,0,1,1,132,131,148,148,73
"6526",25,"[23]EEoIoHcosHnJHGqKCKAecvf",283,0.996479,23,284,1,283,1,1,0,1,1,143,142,141,141,73
"6527",26,"[23]EEoIoHcosHnJHGqKCKAecvf",284,0.996491,23,285,1,284,1,1,0,1,1,135,134,150,150,73
"6528",27,"[23]EEoIoHcosHnJHGqKCKAecvf",279,0.996429,23,280,1,279,1,1,0,1,1,152,151,128,128,73
"6529",28,"[23]EEoIoHcosHnJHGqKCKAecvf",278,0.996416,23,279,1,278,1,1,0,1,1,131,130,148,148,73
"6530",29,"[23]EEoIoHcosHnJHGqKCKAecvf",294,0.99661,23,295,1,294,1,1,0,1,1,159,158,136,136,73
"6531",30,"[23]EEoIoHcosHnJHGqKCKAecvf",276,0.99639,23,277,1,276,1,1,0,1,1,149,148,128,128,73
"6532",31,"[23]EEoIoHcosHnJHGqKCKAecvf",278,0.996416,23,279,1,278,1,1,0,1,1,139,138,140,140,73
"6533",32,"[23]EEoIoHcosHnJHGqKCKAecvf",280,0.996441,23,281,1,280,1,1,0,1,1,148,147,133,133,73
"6534",33,"[23]EEoIoHcosHnJHGqKCKAecvf",283,0.996479,23,284,1,283,1,1,0,1,1,142,141,142,142,73
"6535",34,"[23]EEoIoHcosHnJHGqKCKAecvf",278,0.996416,23,279,1,278,1,1,0,1,1,143,142,136,136,73
"6536",35,"[23]EEoIoHcosHnJHGqKCKAecvf",289,0.996552,23,290,1,289,1,1,0,1,1,147,146,143,143,73
"6537",36,"[23]EEoIoHcosHnJHGqKCKAecvf",280,0.996441,23,281,1,280,1,1,0,1,1,160,159,121,121,73
"6538",37,"[23]EEoIoHcosHnJHGqKCKAecvf",281,0.996454,23,282,1,281,1,1,0,1,1,151,150,131,131,73
"6539",38,"[23]EEoIoHcosHnJHGqKCKAecvf",281,0.996454,23,282,1,281,1,1,0,1,1,136,135,146,146,73
"6540",39,"[23]EEoIoHcosHnJHGqKCKAecvf",280,0.996441,23,281,1,280,1,1,0,1,1,135,134,146,146,73
"6541",40,"[23]EEoIoHcosHnJHGqKCKAecvf",284,0.996491,23,285,1,284,1,1,0,1,1,142,141,143,143,73
"6542",41,"[23]EEoIoHcosHnJHGqKCKAecvf",280,0.996441,23,281,1,280,1,1,0,1,1,136,135,145,145,73
"6543",42,"[23]EEoIoHcosHnJHGqKCKAecvf",280,0.996441,23,281,1,280,1,1,0,1,1,126,125,155,155,73
"6544",43,"[23]EEoIoHcosHnJHGqKCKAecvf",291,0.996575,23,292,1,291,1,1,0,1,1,148,147,144,144,73
"6545",44,"[23]EEoIoHcosHnJHGqKCKAecvf",285,0.996503,23,286,1,285,1,1,0,1,1,152,151,134,134,73
"6546",45,"[23]EEoIoHcosHnJHGqKCKAecvf",275,0.996377,23,276,1,275,1,1,0,1,1,130,129,146,146,73
"6547",46,"[23]EEoIoHcosHnJHGqKCKAecvf",277,0.996403,23,278,1,277,1,1,0,1,1,130,129,148,148,73
"6548",47,"[23]EEoIoHcosHnJHGqKCKAecvf",284,0.996491,23,285,1,284,1,1,0,1,1,141,140,144,144,73
"6549",48,"[23]EEoIoHcosHnJHGqKCKAecvf",281,0.996454,23,282,1,281,1,1,0,1,1,138,137,144,144,73
"6550",49,"[23]EEoIoHcosHnJHGqKCKAecvf",282,0.996466,23,283,1,282,1,1,0,1,1,142,141,141,141,73
"6551",50,"[23]EEoIoHcosHnJHGqKCKAecvf",275,0.996377,23,276,1,275,1,1,0,1,1,127,126,149,149,73
"6552",51,"[23]EEoIoHcosHnJHGqKCKAecvf",275,0.996377,23,276,1,275,1,1,0,1,1,126,125,150,150,73
"6553",52,"[23]EEoIoHcosHnJHGqKCKAecvf",282,0.996466,23,283,1,282,1,1,0,1,1,137,136,146,146,73
"6554",53,"[23]EEoIoHcosHnJHGqKCKAecvf",283,0.996479,23,284,1,283,1,1,0,1,1,135,134,149,149,73
"6555",54,"[23]EEoIoHcosHnJHGqKCKAecvf",282,0.996466,23,283,1,282,1,1,0,1,1,135,134,148,148,73
"6556",55,"[23]EEoIoHcosHnJHGqKCKAecvf",283,0.996479,23,284,1,283,1,1,0,1,1,149,148,135,135,73
"6557",56,"[23]EEoIoHcosHnJHGqKCKAecvf",289,0.996552,23,290,1,289,1,1,0,1,1,161,160,129,129,73
"6558",57,"[23]EEoIoHcosHnJHGqKCKAecvf",284,0.996491,23,285,1,284,1,1,0,1,1,147,146,138,138,73
"6559",58,"[23]EEoIoHcosHnJHGqKCKAecvf",284,0.996491,23,285,1,284,1,1,0,1,1,152,151,133,133,73
"6560",59,"[23]EEoIoHcosHnJHGqKCKAecvf",277,0.996403,23,278,1,277,1,1,0,1,1,137,136,141,141,73
"6561",60,"[23]EEoIoHcosHnJHGqKCKAecvf",287,0.996528,23,288,1,287,1,1,0,1,1,155,154,133,133,73
"6562",61,"[23]EEoIoHcosHnJHGqKCKAecvf",275,0.996377,23,276,1,275,1,1,0,1,1,137,136,139,139,73
"6563",62,"[23]EEoIoHcosHnJHGqKCKAecvf",283,0.996479,23,284,1,283,1,1,0,1,1,137,136,147,147,73
"6564",63,"[23]EEoIoHcosHnJHGqKCKAecvf",272,0.996337,23,273,1,272,1,1,0,1,1,139,138,134,134,73
"6565",64,"[23]EEoIoHcosHnJHGqKCKAecvf",276,0.99639,23,277,1,276,1,1,0,1,1,138,137,139,139,73
"6566",65,"[23]EEoIoHcosHnJHGqKCKAecvf",286,0.996516,23,287,1,286,1,1,0,1,1,139,138,148,148,73
"6567",66,"[23]EEoIoHcosHnJHGqKCKAecvf",278,0.996416,23,279,1,278,1,1,0,1,1,145,144,134,134,73
"6568",67,"[23]EEoIoHcosHnJHGqKCKAecvf",280,0.996441,23,281,1,280,1,1,0,1,1,149,148,132,132,73
"6569",68,"[23]EEoIoHcosHnJHGqKCKAecvf",280,0.996441,23,281,1,280,1,1,0,1,1,134,133,147,147,73
"6570",69,"[23]EEoIoHcosHnJHGqKCKAecvf",283,0.996479,23,284,1,283,1,1,0,1,1,146,145,138,138,73
"6571",70,"[23]EEoIoHcosHnJHGqKCKAecvf",275,0.996377,23,276,1,275,1,1,0,1,1,128,127,148,148,73
"6572",71,"[23]EEoIoHcosHnJHGqKCKAecvf",289,0.996552,23,290,1,289,1,1,0,1,1,153,152,137,137,73
"6573",72,"[23]EEoIoHcosHnJHGqKCKAecvf",276,0.99639,23,277,1,276,1,1,0,1,1,134,133,143,143,73
"6574",73,"[23]EEoIoHcosHnJHGqKCKAecvf",278,0.996416,23,279,1,278,1,1,0,1,1,150,149,129,129,73
"6575",74,"[23]EEoIoHcosHnJHGqKCKAecvf",281,0.996454,23,282,1,281,1,1,0,1,1,150,149,132,132,73
"6576",75,"[23]EEoIoHcosHnJHGqKCKAecvf",290,0.996564,23,291,1,290,1,1,0,1,1,145,144,146,146,73
"6577",76,"[23]EEoIoHcosHnJHGqKCKAecvf",272,0.996337,23,273,1,272,1,1,0,1,1,110,109,163,163,73
"6578",77,"[23]EEoIoHcosHnJHGqKCKAecvf",287,0.996528,23,288,1,287,1,1,0,1,1,149,148,139,139,73
"6579",78,"[23]EEoIoHcosHnJHGqKCKAecvf",284,0.996491,23,285,1,284,1,1,0,1,1,150,149,135,135,73
"6580",79,"[23]EEoIoHcosHnJHGqKCKAecvf",279,0.996429,23,280,1,279,1,1,0,1,1,152,151,128,128,73
"6581",80,"[23]EEoIoHcosHnJHGqKCKAecvf",287,0.996528,23,288,1,287,1,1,0,1,1,152,151,136,136,73
"6582",81,"[23]EEoIoHcosHnJHGqKCKAecvf",281,0.996454,23,282,1,281,1,1,0,1,1,151,150,131,131,73
"6583",82,"[23]EEoIoHcosHnJHGqKCKAecvf",277,0.996403,23,278,1,277,1,1,0,1,1,148,147,130,130,73
"6584",83,"[23]EEoIoHcosHnJHGqKCKAecvf",290,0.996564,23,291,1,290,1,1,0,1,1,155,154,136,136,73
"6585",84,"[23]EEoIoHcosHnJHGqKCKAecvf",280,0.996441,23,281,1,280,1,1,0,1,1,144,143,137,137,73
"6586",85,"[23]EEoIoHcosHnJHGqKCKAecvf",279,0.996429,23,280,1,279,1,1,0,1,1,146,145,134,134,73
"6587",86,"[23]EEoIoHcosHnJHGqKCKAecvf",279,0.996429,23,280,1,279,1,1,0,1,1,141,140,139,139,73
"6588",87,"[23]EEoIoHcosHnJHGqKCKAecvf",281,0.996454,23,282,1,281,1,1,0,1,1,133,132,149,149,73
"6589",88,"[23]EEoIoHcosHnJHGqKCKAecvf",276,0.99639,23,277,1,276,1,1,0,1,1,144,143,133,133,73
"6590",89,"[23]EEoIoHcosHnJHGqKCKAecvf",280,0.996441,23,281,1,280,1,1,0,1,1,158,157,123,123,73
"6591",90,"[23]EEoIoHcosHnJHGqKCKAecvf",285,0.996503,23,286,1,285,1,1,0,1,1,133,132,153,153,73
"6592",91,"[23]EEoIoHcosHnJHGqKCKAecvf",283,0.996479,23,284,1,283,1,1,0,1,1,149,148,135,135,73
"6593",92,"[23]EEoIoHcosHnJHGqKCKAecvf",282,0.996466,23,283,1,282,1,1,0,1,1,143,142,140,140,73
"6594",93,"[23]EEoIoHcosHnJHGqKCKAecvf",283,0.996479,23,284,1,283,1,1,0,1,1,143,142,141,141,73
"6595",94,"[23]EEoIoHcosHnJHGqKCKAecvf",276,0.99639,23,277,1,276,1,1,0,1,1,139,138,138,138,73
"6596",95,"[23]EEoIoHcosHnJHGqKCKAecvf",284,0.996491,23,285,1,284,1,1,0,1,1,140,139,145,145,73
"6597",96,"[23]EEoIoHcosHnJHGqKCKAecvf",285,0.996503,23,286,1,285,1,1,0,1,1,158,157,128,128,73
"6598",97,"[23]EEoIoHcosHnJHGqKCKAecvf",280,0.996441,23,281,1,280,1,1,0,1,1,148,147,133,133,73
"6599",98,"[23]EEoIoHcosHnJHGqKCKAecvf",273,0.99635,23,274,1,273,1,1,0,1,1,141,140,133,133,73
"6600",99,"[23]EEoIoHcosHnJHGqKCKAecvf",282,0.996466,23,283,1,282,1,1,0,1,1,152,151,131,131,73
"6601",0,"[27]JlkHoIwyFoHcowHnJqKGCKDgKmt",295,0.996622,27,296,1,295,1,1,0,1,1,142,141,154,154,74
"6602",1,"[27]JlkHoIwyFoHcowHnJqKGCKDgKmt",299,0.996667,27,300,1,299,1,1,0,1,1,154,153,146,146,74
"6603",2,"[27]JlkHoIwyFoHcowHnJqKGCKDgKmt",293,0.996599,27,294,1,293,1,1,0,1,1,146,145,148,148,74
"6604",3,"[27]JlkHoIwyFoHcowHnJqKGCKDgKmt",294,0.99661,27,295,1,294,1,1,0,1,1,145,144,150,150,74
"6605",4,"[27]JlkHoIwyFoHcowHnJqKGCKDgKmt",299,0.996667,27,300,1,299,1,1,0,1,1,154,153,146,146,74
"6606",5,"[27]JlkHoIwyFoHcowHnJqKGCKDgKmt",296,0.996633,27,297,1,296,1,1,0,1,1,148,147,149,149,74
"6607",6,"[27]JlkHoIwyFoHcowHnJqKGCKDgKmt",298,0.996656,27,299,1,298,1,1,0,1,1,151,150,148,148,74
"6608",7,"[27]JlkHoIwyFoHcowHnJqKGCKDgKmt",300,0.996678,27,301,1,300,1,1,0,1,1,156,155,145,145,74
"6609",8,"[27]JlkHoIwyFoHcowHnJqKGCKDgKmt",294,0.99661,27,295,1,294,1,1,0,1,1,150,149,145,145,74
"6610",9,"[27]JlkHoIwyFoHcowHnJqKGCKDgKmt",300,0.996678,27,301,1,300,1,1,0,1,1,156,155,145,145,74
"6611",10,"[27]JlkHoIwyFoHcowHnJqKGCKDgKmt",295,0.996622,27,296,1,295,1,1,0,1,1,141,140,155,155,74
"6612",11,"[27]JlkHoIwyFoHcowHnJqKGCKDgKmt",295,0.996622,27,296,1,295,1,1,0,1,1,141,140,155,155,74
"6613",12,"[27]JlkHoIwyFoHcowHnJqKGCKDgKmt",297,0.996644,27,298,1,297,1,1,0,1,1,146,145,152,152,74
"6614",13,"[27]JlkHoIwyFoHcowHnJqKGCKDgKmt",300,0.996678,27,301,1,300,1,1,0,1,1,155,154,146,146,74
"6615",14,"[27]JlkHoIwyFoHcowHnJqKGCKDgKmt",298,0.996656,27,299,1,298,1,1,0,1,1,153,152,146,146,74
"6616",15,"[27]JlkHoIwyFoHcowHnJqKGCKDgKmt",296,0.996633,27,297,1,296,1,1,0,1,1,148,147,149,149,74
"6617",16,"[27]JlkHoIwyFoHcowHnJqKGCKDgKmt",299,0.996667,27,300,1,299,1,1,0,1,1,157,156,143,143,74
"6618",17,"[27]JlkHoIwyFoHcowHnJqKGCKDgKmt",300,0.996678,27,301,1,300,1,1,0,1,1,156,155,145,145,74
"6619",18,"[27]JlkHoIwyFoHcowHnJqKGCKDgKmt",299,0.996667,27,300,1,299,1,1,0,1,1,157,156,143,143,74
"6620",19,"[27]JlkHoIwyFoHcowHnJqKGCKDgKmt",297,0.996644,27,298,1,297,1,1,0,1,1,144,143,154,154,74
"6621",20,"[27]JlkHoIwyFoHcowHnJqKGCKDgKmt",300,0.996678,27,301,1,300,1,1,0,1,1,157,156,144,144,74
"6622",21,"[27]JlkHoIwyFoHcowHnJqKGCKDgKmt",301,0.996689,27,302,1,301,1,1,0,1,1,158,157,144,144,74
"6623",22,"[27]JlkHoIwyFoHcowHnJqKGCKDgKmt",299,0.996667,27,300,1,299,1,1,0,1,1,150,149,150,150,74
"6624",23,"[27]JlkHoIwyFoHcowHnJqKGCKDgKmt",297,0.996644,27,298,1,297,1,1,0,1,1,159,158,139,139,74
"6625",24,"[27]JlkHoIwyFoHcowHnJqKGCKDgKmt",299,0.996667,27,300,1,299,1,1,0,1,1,158,157,142,142,74
"6626",25,"[27]JlkHoIwyFoHcowHnJqKGCKDgKmt",296,0.996633,27,297,1,296,1,1,0,1,1,141,140,156,156,74
"6627",26,"[27]JlkHoIwyFoHcowHnJqKGCKDgKmt",295,0.996622,27,296,1,295,1,1,0,1,1,145,144,151,151,74
"6628",27,"[27]JlkHoIwyFoHcowHnJqKGCKDgKmt",300,0.996678,27,301,1,300,1,1,0,1,1,151,150,150,150,74
"6629",28,"[27]JlkHoIwyFoHcowHnJqKGCKDgKmt",301,0.996689,27,302,1,301,1,1,0,1,1,156,155,146,146,74
"6630",29,"[27]JlkHoIwyFoHcowHnJqKGCKDgKmt",297,0.996644,27,298,1,297,1,1,0,1,1,147,146,151,151,74
"6631",30,"[27]JlkHoIwyFoHcowHnJqKGCKDgKmt",294,0.99661,27,295,1,294,1,1,0,1,1,145,144,150,150,74
"6632",31,"[27]JlkHoIwyFoHcowHnJqKGCKDgKmt",299,0.996667,27,300,1,299,1,1,0,1,1,160,159,140,140,74
"6633",32,"[27]JlkHoIwyFoHcowHnJqKGCKDgKmt",299,0.996667,27,300,1,299,1,1,0,1,1,143,142,157,157,74
"6634",33,"[27]JlkHoIwyFoHcowHnJqKGCKDgKmt",305,0.996732,27,306,1,305,1,1,0,1,1,171,170,135,135,74
"6635",34,"[27]JlkHoIwyFoHcowHnJqKGCKDgKmt",295,0.996622,27,296,1,295,1,1,0,1,1,140,139,156,156,74
"6636",35,"[27]JlkHoIwyFoHcowHnJqKGCKDgKmt",282,0.996466,27,283,1,282,1,1,0,1,1,142,141,141,141,74
"6637",36,"[27]JlkHoIwyFoHcowHnJqKGCKDgKmt",292,0.996587,27,293,1,292,1,1,0,1,1,137,136,156,156,74
"6638",37,"[27]JlkHoIwyFoHcowHnJqKGCKDgKmt",300,0.996678,27,301,1,300,1,1,0,1,1,157,156,144,144,74
"6639",38,"[27]JlkHoIwyFoHcowHnJqKGCKDgKmt",299,0.996667,27,300,1,299,1,1,0,1,1,157,156,143,143,74
"6640",39,"[27]JlkHoIwyFoHcowHnJqKGCKDgKmt",298,0.996656,27,299,1,298,1,1,0,1,1,147,146,152,152,74
"6641",40,"[27]JlkHoIwyFoHcowHnJqKGCKDgKmt",298,0.996656,27,299,1,298,1,1,0,1,1,151,150,148,148,74
"6642",41,"[27]JlkHoIwyFoHcowHnJqKGCKDgKmt",300,0.996678,27,301,1,300,1,1,0,1,1,154,153,147,147,74
"6643",42,"[27]JlkHoIwyFoHcowHnJqKGCKDgKmt",301,0.996689,27,302,1,301,1,1,0,1,1,153,152,149,149,74
"6644",43,"[27]JlkHoIwyFoHcowHnJqKGCKDgKmt",298,0.996656,27,299,1,298,1,1,0,1,1,150,149,149,149,74
"6645",44,"[27]JlkHoIwyFoHcowHnJqKGCKDgKmt",299,0.996667,27,300,1,299,1,1,0,1,1,156,155,144,144,74
"6646",45,"[27]JlkHoIwyFoHcowHnJqKGCKDgKmt",304,0.996721,27,305,1,304,1,1,0,1,1,167,166,138,138,74
"6647",46,"[27]JlkHoIwyFoHcowHnJqKGCKDgKmt",287,0.996528,27,288,1,287,1,1,0,1,1,134,133,154,154,74
"6648",47,"[27]JlkHoIwyFoHcowHnJqKGCKDgKmt",297,0.996644,27,298,1,297,1,1,0,1,1,145,144,153,153,74
"6649",48,"[27]JlkHoIwyFoHcowHnJqKGCKDgKmt",297,0.996644,27,298,1,297,1,1,0,1,1,149,148,149,149,74
"6650",49,"[27]JlkHoIwyFoHcowHnJqKGCKDgKmt",297,0.996644,27,298,1,297,1,1,0,1,1,148,147,150,150,74
"6651",50,"[27]JlkHoIwyFoHcowHnJqKGCKDgKmt",297,0.996644,27,298,1,297,1,1,0,1,1,152,151,146,146,74
"6652",51,"[27]JlkHoIwyFoHcowHnJqKGCKDgKmt",299,0.996667,27,300,1,299,1,1,0,1,1,155,154,145,145,74
"6653",52,"[27]JlkHoIwyFoHcowHnJqKGCKDgKmt",296,0.996633,27,297,1,296,1,1,0,1,1,147,146,150,150,74
"6654",53,"[27]JlkHoIwyFoHcowHnJqKGCKDgKmt",298,0.996656,27,299,1,298,1,1,0,1,1,154,153,145,145,74
"6655",54,"[27]JlkHoIwyFoHcowHnJqKGCKDgKmt",301,0.996689,27,302,1,301,1,1,0,1,1,156,155,146,146,74
"6656",55,"[27]JlkHoIwyFoHcowHnJqKGCKDgKmt",303,0.996711,27,304,1,303,1,1,0,1,1,166,165,138,138,74
"6657",56,"[27]JlkHoIwyFoHcowHnJqKGCKDgKmt",300,0.996678,27,301,1,300,1,1,0,1,1,149,148,152,152,74
"6658",57,"[27]JlkHoIwyFoHcowHnJqKGCKDgKmt",305,0.996732,27,306,1,305,1,1,0,1,1,165,164,141,141,74
"6659",58,"[27]JlkHoIwyFoHcowHnJqKGCKDgKmt",293,0.996599,27,294,1,293,1,1,0,1,1,140,139,154,154,74
"6660",59,"[27]JlkHoIwyFoHcowHnJqKGCKDgKmt",287,0.996528,27,288,1,287,1,1,0,1,1,122,121,166,166,74
"6661",60,"[27]JlkHoIwyFoHcowHnJqKGCKDgKmt",294,0.99661,27,295,1,294,1,1,0,1,1,145,144,150,150,74
"6662",61,"[27]JlkHoIwyFoHcowHnJqKGCKDgKmt",289,0.996552,27,290,1,289,1,1,0,1,1,135,134,155,155,74
"6663",62,"[27]JlkHoIwyFoHcowHnJqKGCKDgKmt",295,0.996622,27,296,1,295,1,1,0,1,1,163,162,133,133,74
"6664",63,"[27]JlkHoIwyFoHcowHnJqKGCKDgKmt",300,0.996678,27,301,1,300,1,1,0,1,1,153,152,148,148,74
"6665",64,"[27]JlkHoIwyFoHcowHnJqKGCKDgKmt",297,0.996644,27,298,1,297,1,1,0,1,1,146,145,152,152,74
"6666",65,"[27]JlkHoIwyFoHcowHnJqKGCKDgKmt",303,0.996711,27,304,1,303,1,1,0,1,1,166,165,138,138,74
"6667",66,"[27]JlkHoIwyFoHcowHnJqKGCKDgKmt",300,0.996678,27,301,1,300,1,1,0,1,1,154,153,147,147,74
"6668",67,"[27]JlkHoIwyFoHcowHnJqKGCKDgKmt",292,0.996587,27,293,1,292,1,1,0,1,1,133,132,160,160,74
"6669",68,"[27]JlkHoIwyFoHcowHnJqKGCKDgKmt",296,0.996633,27,297,1,296,1,1,0,1,1,148,147,149,149,74
"6670",69,"[27]JlkHoIwyFoHcowHnJqKGCKDgKmt",301,0.996689,27,302,1,301,1,1,0,1,1,160,159,142,142,74
"6671",70,"[27]JlkHoIwyFoHcowHnJqKGCKDgKmt",292,0.996587,27,293,1,292,1,1,0,1,1,129,128,164,164,74
"6672",71,"[27]JlkHoIwyFoHcowHnJqKGCKDgKmt",298,0.996656,27,299,1,298,1,1,0,1,1,150,149,149,149,74
"6673",72,"[27]JlkHoIwyFoHcowHnJqKGCKDgKmt",292,0.996587,27,293,1,292,1,1,0,1,1,131,130,162,162,74
"6674",73,"[27]JlkHoIwyFoHcowHnJqKGCKDgKmt",306,0.996743,27,307,1,306,1,1,0,1,1,169,168,138,138,74
"6675",74,"[27]JlkHoIwyFoHcowHnJqKGCKDgKmt",297,0.996644,27,298,1,297,1,1,0,1,1,145,144,153,153,74
"6676",75,"[27]JlkHoIwyFoHcowHnJqKGCKDgKmt",297,0.996644,27,298,1,297,1,1,0,1,1,146,145,152,152,74
"6677",76,"[27]JlkHoIwyFoHcowHnJqKGCKDgKmt",299,0.996667,27,300,1,299,1,1,0,1,1,154,153,146,146,74
"6678",77,"[27]JlkHoIwyFoHcowHnJqKGCKDgKmt",302,0.9967,27,303,1,302,1,1,0,1,1,156,155,147,147,74
"6679",78,"[27]JlkHoIwyFoHcowHnJqKGCKDgKmt",304,0.996721,27,305,1,304,1,1,0,1,1,161,160,144,144,74
"6680",79,"[27]JlkHoIwyFoHcowHnJqKGCKDgKmt",298,0.996656,27,299,1,298,1,1,0,1,1,153,152,146,146,74
"6681",80,"[27]JlkHoIwyFoHcowHnJqKGCKDgKmt",291,0.996575,27,292,1,291,1,1,0,1,1,140,139,152,152,74
"6682",81,"[27]JlkHoIwyFoHcowHnJqKGCKDgKmt",298,0.996656,27,299,1,298,1,1,0,1,1,150,149,149,149,74
"6683",82,"[27]JlkHoIwyFoHcowHnJqKGCKDgKmt",293,0.996599,27,294,1,293,1,1,0,1,1,137,136,157,157,74
"6684",83,"[27]JlkHoIwyFoHcowHnJqKGCKDgKmt",295,0.996622,27,296,1,295,1,1,0,1,1,145,144,151,151,74
"6685",84,"[27]JlkHoIwyFoHcowHnJqKGCKDgKmt",305,0.996732,27,306,1,305,1,1,0,1,1,171,170,135,135,74
"6686",85,"[27]JlkHoIwyFoHcowHnJqKGCKDgKmt",305,0.996732,27,306,1,305,1,1,0,1,1,170,169,136,136,74
"6687",86,"[27]JlkHoIwyFoHcowHnJqKGCKDgKmt",298,0.996656,27,299,1,298,1,1,0,1,1,155,154,144,144,74
"6688",87,"[27]JlkHoIwyFoHcowHnJqKGCKDgKmt",289,0.996552,27,290,1,289,1,1,0,1,1,147,146,143,143,74
"6689",88,"[27]JlkHoIwyFoHcowHnJqKGCKDgKmt",287,0.996528,27,288,1,287,1,1,0,1,1,141,140,147,147,74
"6690",89,"[27]JlkHoIwyFoHcowHnJqKGCKDgKmt",294,0.99661,27,295,1,294,1,1,0,1,1,138,137,157,157,74
"6691",90,"[27]JlkHoIwyFoHcowHnJqKGCKDgKmt",295,0.996622,27,296,1,295,1,1,0,1,1,141,140,155,155,74
"6692",91,"[27]JlkHoIwyFoHcowHnJqKGCKDgKmt",298,0.996656,27,299,1,298,1,1,0,1,1,148,147,151,151,74
"6693",92,"[27]JlkHoIwyFoHcowHnJqKGCKDgKmt",296,0.996633,27,297,1,296,1,1,0,1,1,144,143,153,153,74
"6694",93,"[27]JlkHoIwyFoHcowHnJqKGCKDgKmt",303,0.996711,27,304,1,303,1,1,0,1,1,164,163,140,140,74
"6695",94,"[27]JlkHoIwyFoHcowHnJqKGCKDgKmt",291,0.996575,27,292,1,291,1,1,0,1,1,128,127,164,164,74
"6696",95,"[27]JlkHoIwyFoHcowHnJqKGCKDgKmt",291,0.996575,27,292,1,291,1,1,0,1,1,134,133,158,158,74
"6697",96,"[27]JlkHoIwyFoHcowHnJqKGCKDgKmt",296,0.996633,27,297,1,296,1,1,0,1,1,163,162,134,134,74
"6698",97,"[27]JlkHoIwyFoHcowHnJqKGCKDgKmt",300,0.996678,27,301,1,300,1,1,0,1,1,156,155,145,145,74
"6699",98,"[27]JlkHoIwyFoHcowHnJqKGCKDgKmt",294,0.99661,27,295,1,294,1,1,0,1,1,146,145,149,149,74
"6700",99,"[27]JlkHoIwyFoHcowHnJqKGCKDgKmt",298,0.996656,27,299,1,298,1,1,0,1,1,164,163,135,135,74
"6701",0,"[24]GEoIoHcovHnJHGqKCHlahvdf",283,0.996479,24,284,1,283,1,1,0,1,1,133,132,151,151,75
"6702",1,"[24]GEoIoHcovHnJHGqKCHlahvdf",281,0.996454,24,282,1,281,1,1,0,1,1,134,133,148,148,75
"6703",2,"[24]GEoIoHcovHnJHGqKCHlahvdf",281,0.996454,24,282,1,281,1,1,0,1,1,145,144,137,137,75
"6704",3,"[24]GEoIoHcovHnJHGqKCHlahvdf",273,0.99635,24,274,1,273,1,1,0,1,1,140,139,134,134,75
"6705",4,"[24]GEoIoHcovHnJHGqKCHlahvdf",270,0.99631,24,271,1,270,1,1,0,1,1,147,146,124,124,75
"6706",5,"[24]GEoIoHcovHnJHGqKCHlahvdf",283,0.996479,24,284,1,283,1,1,0,1,1,145,144,139,139,75
"6707",6,"[24]GEoIoHcovHnJHGqKCHlahvdf",276,0.99639,24,277,1,276,1,1,0,1,1,127,126,150,150,75
"6708",7,"[24]GEoIoHcovHnJHGqKCHlahvdf",277,0.996403,24,278,1,277,1,1,0,1,1,134,133,144,144,75
"6709",8,"[24]GEoIoHcovHnJHGqKCHlahvdf",275,0.996377,24,276,1,275,1,1,0,1,1,120,119,156,156,75
"6710",9,"[24]GEoIoHcovHnJHGqKCHlahvdf",279,0.996429,24,280,1,279,1,1,0,1,1,154,153,126,126,75
"6711",10,"[24]GEoIoHcovHnJHGqKCHlahvdf",283,0.996479,24,284,1,283,1,1,0,1,1,136,135,148,148,75
"6712",11,"[24]GEoIoHcovHnJHGqKCHlahvdf",281,0.996454,24,282,1,281,1,1,0,1,1,144,143,138,138,75
"6713",12,"[24]GEoIoHcovHnJHGqKCHlahvdf",284,0.996491,24,285,1,284,1,1,0,1,1,132,131,153,153,75
"6714",13,"[24]GEoIoHcovHnJHGqKCHlahvdf",279,0.996429,24,280,1,279,1,1,0,1,1,133,132,147,147,75
"6715",14,"[24]GEoIoHcovHnJHGqKCHlahvdf",279,0.996429,24,280,1,279,1,1,0,1,1,156,155,124,124,75
"6716",15,"[24]GEoIoHcovHnJHGqKCHlahvdf",280,0.996441,24,281,1,280,1,1,0,1,1,138,137,143,143,75
"6717",16,"[24]GEoIoHcovHnJHGqKCHlahvdf",281,0.996454,24,282,1,281,1,1,0,1,1,146,145,136,136,75
"6718",17,"[24]GEoIoHcovHnJHGqKCHlahvdf",279,0.996429,24,280,1,279,1,1,0,1,1,135,134,145,145,75
"6719",18,"[24]GEoIoHcovHnJHGqKCHlahvdf",282,0.996466,24,283,1,282,1,1,0,1,1,137,136,146,146,75
"6720",19,"[24]GEoIoHcovHnJHGqKCHlahvdf",275,0.996377,24,276,1,275,1,1,0,1,1,127,126,149,149,75
"6721",20,"[24]GEoIoHcovHnJHGqKCHlahvdf",282,0.996466,24,283,1,282,1,1,0,1,1,143,142,140,140,75
"6722",21,"[24]GEoIoHcovHnJHGqKCHlahvdf",288,0.99654,24,289,1,288,1,1,0,1,1,152,151,137,137,75
"6723",22,"[24]GEoIoHcovHnJHGqKCHlahvdf",286,0.996516,24,287,1,286,1,1,0,1,1,141,140,146,146,75
"6724",23,"[24]GEoIoHcovHnJHGqKCHlahvdf",288,0.99654,24,289,1,288,1,1,0,1,1,143,142,146,146,75
"6725",24,"[24]GEoIoHcovHnJHGqKCHlahvdf",281,0.996454,24,282,1,281,1,1,0,1,1,146,145,136,136,75
"6726",25,"[24]GEoIoHcovHnJHGqKCHlahvdf",283,0.996479,24,284,1,283,1,1,0,1,1,158,157,126,126,75
"6727",26,"[24]GEoIoHcovHnJHGqKCHlahvdf",284,0.996491,24,285,1,284,1,1,0,1,1,140,139,145,145,75
"6728",27,"[24]GEoIoHcovHnJHGqKCHlahvdf",290,0.996564,24,291,1,290,1,1,0,1,1,158,157,133,133,75
"6729",28,"[24]GEoIoHcovHnJHGqKCHlahvdf",284,0.996491,24,285,1,284,1,1,0,1,1,155,154,130,130,75
"6730",29,"[24]GEoIoHcovHnJHGqKCHlahvdf",286,0.996516,24,287,1,286,1,1,0,1,1,148,147,139,139,75
"6731",30,"[24]GEoIoHcovHnJHGqKCHlahvdf",278,0.996416,24,279,1,278,1,1,0,1,1,152,151,127,127,75
"6732",31,"[24]GEoIoHcovHnJHGqKCHlahvdf",283,0.996479,24,284,1,283,1,1,0,1,1,140,139,144,144,75
"6733",32,"[24]GEoIoHcovHnJHGqKCHlahvdf",282,0.996466,24,283,1,282,1,1,0,1,1,126,125,157,157,75
"6734",33,"[24]GEoIoHcovHnJHGqKCHlahvdf",271,0.996324,24,272,1,271,1,1,0,1,1,131,130,141,141,75
"6735",34,"[24]GEoIoHcovHnJHGqKCHlahvdf",276,0.99639,24,277,1,276,1,1,0,1,1,157,156,120,120,75
"6736",35,"[24]GEoIoHcovHnJHGqKCHlahvdf",282,0.996466,24,283,1,282,1,1,0,1,1,147,146,136,136,75
"6737",36,"[24]GEoIoHcovHnJHGqKCHlahvdf",275,0.996377,24,276,1,275,1,1,0,1,1,130,129,146,146,75
"6738",37,"[24]GEoIoHcovHnJHGqKCHlahvdf",283,0.996479,24,284,1,283,1,1,0,1,1,143,142,141,141,75
"6739",38,"[24]GEoIoHcovHnJHGqKCHlahvdf",276,0.99639,24,277,1,276,1,1,0,1,1,120,119,157,157,75
"6740",39,"[24]GEoIoHcovHnJHGqKCHlahvdf",289,0.996552,24,290,1,289,1,1,0,1,1,151,150,139,139,75
"6741",40,"[24]GEoIoHcovHnJHGqKCHlahvdf",280,0.996441,24,281,1,280,1,1,0,1,1,139,138,142,142,75
"6742",41,"[24]GEoIoHcovHnJHGqKCHlahvdf",283,0.996479,24,284,1,283,1,1,0,1,1,152,151,132,132,75
"6743",42,"[24]GEoIoHcovHnJHGqKCHlahvdf",280,0.996441,24,281,1,280,1,1,0,1,1,141,140,140,140,75
"6744",43,"[24]GEoIoHcovHnJHGqKCHlahvdf",291,0.996575,24,292,1,291,1,1,0,1,1,154,153,138,138,75
"6745",44,"[24]GEoIoHcovHnJHGqKCHlahvdf",278,0.996416,24,279,1,278,1,1,0,1,1,128,127,151,151,75
"6746",45,"[24]GEoIoHcovHnJHGqKCHlahvdf",277,0.996403,24,278,1,277,1,1,0,1,1,122,121,156,156,75
"6747",46,"[24]GEoIoHcovHnJHGqKCHlahvdf",283,0.996479,24,284,1,283,1,1,0,1,1,144,143,140,140,75
"6748",47,"[24]GEoIoHcovHnJHGqKCHlahvdf",275,0.996377,24,276,1,275,1,1,0,1,1,142,141,134,134,75
"6749",48,"[24]GEoIoHcovHnJHGqKCHlahvdf",285,0.996503,24,286,1,285,1,1,0,1,1,133,132,153,153,75
"6750",49,"[24]GEoIoHcovHnJHGqKCHlahvdf",276,0.99639,24,277,1,276,1,1,0,1,1,128,127,149,149,75
"6751",50,"[24]GEoIoHcovHnJHGqKCHlahvdf",284,0.996491,24,285,1,284,1,1,0,1,1,142,141,143,143,75
"6752",51,"[24]GEoIoHcovHnJHGqKCHlahvdf",277,0.996403,24,278,1,277,1,1,0,1,1,150,149,128,128,75
"6753",52,"[24]GEoIoHcovHnJHGqKCHlahvdf",277,0.996403,24,278,1,277,1,1,0,1,1,148,147,130,130,75
"6754",53,"[24]GEoIoHcovHnJHGqKCHlahvdf",287,0.996528,24,288,1,287,1,1,0,1,1,172,171,116,116,75
"6755",54,"[24]GEoIoHcovHnJHGqKCHlahvdf",284,0.996491,24,285,1,284,1,1,0,1,1,154,153,131,131,75
"6756",55,"[24]GEoIoHcovHnJHGqKCHlahvdf",269,0.996296,24,270,1,269,1,1,0,1,1,120,119,150,150,75
"6757",56,"[24]GEoIoHcovHnJHGqKCHlahvdf",289,0.996552,24,290,1,289,1,1,0,1,1,136,135,154,154,75
"6758",57,"[24]GEoIoHcovHnJHGqKCHlahvdf",282,0.996466,24,283,1,282,1,1,0,1,1,147,146,136,136,75
"6759",58,"[24]GEoIoHcovHnJHGqKCHlahvdf",285,0.996503,24,286,1,285,1,1,0,1,1,153,152,133,133,75
"6760",59,"[24]GEoIoHcovHnJHGqKCHlahvdf",282,0.996466,24,283,1,282,1,1,0,1,1,147,146,136,136,75
"6761",60,"[24]GEoIoHcovHnJHGqKCHlahvdf",283,0.996479,24,284,1,283,1,1,0,1,1,148,147,136,136,75
"6762",61,"[24]GEoIoHcovHnJHGqKCHlahvdf",277,0.996403,24,278,1,277,1,1,0,1,1,133,132,145,145,75
"6763",62,"[24]GEoIoHcovHnJHGqKCHlahvdf",281,0.996454,24,282,1,281,1,1,0,1,1,144,143,138,138,75
"6764",63,"[24]GEoIoHcovHnJHGqKCHlahvdf",294,0.99661,24,295,1,294,1,1,0,1,1,143,142,152,152,75
"6765",64,"[24]GEoIoHcovHnJHGqKCHlahvdf",284,0.996491,24,285,1,284,1,1,0,1,1,150,149,135,135,75
"6766",65,"[24]GEoIoHcovHnJHGqKCHlahvdf",278,0.996416,24,279,1,278,1,1,0,1,1,140,139,139,139,75
"6767",66,"[24]GEoIoHcovHnJHGqKCHlahvdf",283,0.996479,24,284,1,283,1,1,0,1,1,146,145,138,138,75
"6768",67,"[24]GEoIoHcovHnJHGqKCHlahvdf",290,0.996564,24,291,1,290,1,1,0,1,1,136,135,155,155,75
"6769",68,"[24]GEoIoHcovHnJHGqKCHlahvdf",282,0.996466,24,283,1,282,1,1,0,1,1,141,140,142,142,75
"6770",69,"[24]GEoIoHcovHnJHGqKCHlahvdf",284,0.996491,24,285,1,284,1,1,0,1,1,137,136,148,148,75
"6771",70,"[24]GEoIoHcovHnJHGqKCHlahvdf",276,0.99639,24,277,1,276,1,1,0,1,1,134,133,143,143,75
"6772",71,"[24]GEoIoHcovHnJHGqKCHlahvdf",283,0.996479,24,284,1,283,1,1,0,1,1,135,134,149,149,75
"6773",72,"[24]GEoIoHcovHnJHGqKCHlahvdf",275,0.996377,24,276,1,275,1,1,0,1,1,129,128,147,147,75
"6774",73,"[24]GEoIoHcovHnJHGqKCHlahvdf",284,0.996491,24,285,1,284,1,1,0,1,1,147,146,138,138,75
"6775",74,"[24]GEoIoHcovHnJHGqKCHlahvdf",284,0.996491,24,285,1,284,1,1,0,1,1,148,147,137,137,75
"6776",75,"[24]GEoIoHcovHnJHGqKCHlahvdf",283,0.996479,24,284,1,283,1,1,0,1,1,143,142,141,141,75
"6777",76,"[24]GEoIoHcovHnJHGqKCHlahvdf",281,0.996454,24,282,1,281,1,1,0,1,1,149,148,133,133,75
"6778",77,"[24]GEoIoHcovHnJHGqKCHlahvdf",286,0.996516,24,287,1,286,1,1,0,1,1,147,146,140,140,75
"6779",78,"[24]GEoIoHcovHnJHGqKCHlahvdf",285,0.996503,24,286,1,285,1,1,0,1,1,144,143,142,142,75
"6780",79,"[24]GEoIoHcovHnJHGqKCHlahvdf",280,0.996441,24,281,1,280,1,1,0,1,1,135,134,146,146,75
"6781",80,"[24]GEoIoHcovHnJHGqKCHlahvdf",284,0.996491,24,285,1,284,1,1,0,1,1,147,146,138,138,75
"6782",81,"[24]GEoIoHcovHnJHGqKCHlahvdf",285,0.996503,24,286,1,285,1,1,0,1,1,159,158,127,127,75
"6783",82,"[24]GEoIoHcovHnJHGqKCHlahvdf",290,0.996564,24,291,1,290,1,1,0,1,1,149,148,142,142,75
"6784",83,"[24]GEoIoHcovHnJHGqKCHlahvdf",277,0.996403,24,278,1,277,1,1,0,1,1,144,143,134,134,75
"6785",84,"[24]GEoIoHcovHnJHGqKCHlahvdf",286,0.996516,24,287,1,286,1,1,0,1,1,145,144,142,142,75
"6786",85,"[24]GEoIoHcovHnJHGqKCHlahvdf",276,0.99639,24,277,1,276,1,1,0,1,1,154,153,123,123,75
"6787",86,"[24]GEoIoHcovHnJHGqKCHlahvdf",273,0.99635,24,274,1,273,1,1,0,1,1,124,123,150,150,75
"6788",87,"[24]GEoIoHcovHnJHGqKCHlahvdf",284,0.996491,24,285,1,284,1,1,0,1,1,155,154,130,130,75
"6789",88,"[24]GEoIoHcovHnJHGqKCHlahvdf",275,0.996377,24,276,1,275,1,1,0,1,1,122,121,154,154,75
"6790",89,"[24]GEoIoHcovHnJHGqKCHlahvdf",275,0.996377,24,276,1,275,1,1,0,1,1,134,133,142,142,75
"6791",90,"[24]GEoIoHcovHnJHGqKCHlahvdf",278,0.996416,24,279,1,278,1,1,0,1,1,133,132,146,146,75
"6792",91,"[24]GEoIoHcovHnJHGqKCHlahvdf",280,0.996441,24,281,1,280,1,1,0,1,1,148,147,133,133,75
"6793",92,"[24]GEoIoHcovHnJHGqKCHlahvdf",280,0.996441,24,281,1,280,1,1,0,1,1,157,156,124,124,75
"6794",93,"[24]GEoIoHcovHnJHGqKCHlahvdf",281,0.996454,24,282,1,281,1,1,0,1,1,152,151,130,130,75
"6795",94,"[24]GEoIoHcovHnJHGqKCHlahvdf",283,0.996479,24,284,1,283,1,1,0,1,1,144,143,140,140,75
"6796",95,"[24]GEoIoHcovHnJHGqKCHlahvdf",281,0.996454,24,282,1,281,1,1,0,1,1,136,135,146,146,75
"6797",96,"[24]GEoIoHcovHnJHGqKCHlahvdf",282,0.996466,24,283,1,282,1,1,0,1,1,127,126,156,156,75
"6798",97,"[24]GEoIoHcovHnJHGqKCHlahvdf",286,0.996516,24,287,1,286,1,1,0,1,1,135,134,152,152,75
"6799",98,"[24]GEoIoHcovHnJHGqKCHlahvdf",284,0.996491,24,285,1,284,1,1,0,1,1,146,145,139,139,75
"6800",99,"[24]GEoIoHcovHnJHGqKCHlahvdf",279,0.996429,24,280,1,279,1,1,0,1,1,122,121,158,158,75
"6801",0,"[24]loIproHcoxHnJHGqKCoutyBl",286,0.996516,24,287,1,286,1,1,0,1,1,138,137,149,149,76
"6802",1,"[24]loIproHcoxHnJHGqKCoutyBl",283,0.996479,24,284,1,283,1,1,0,1,1,142,141,142,142,76
"6803",2,"[24]loIproHcoxHnJHGqKCoutyBl",281,0.996454,24,282,1,281,1,1,0,1,1,135,134,147,147,76
"6804",3,"[24]loIproHcoxHnJHGqKCoutyBl",288,0.99654,24,289,1,288,1,1,0,1,1,149,148,140,140,76
"6805",4,"[24]loIproHcoxHnJHGqKCoutyBl",282,0.996466,24,283,1,282,1,1,0,1,1,142,141,141,141,76
"6806",5,"[24]loIproHcoxHnJHGqKCoutyBl",290,0.996564,24,291,1,290,1,1,0,1,1,148,147,143,143,76
"6807",6,"[24]loIproHcoxHnJHGqKCoutyBl",281,0.996454,24,282,1,281,1,1,0,1,1,127,126,155,155,76
"6808",7,"[24]loIproHcoxHnJHGqKCoutyBl",283,0.996479,24,284,1,283,1,1,0,1,1,141,140,143,143,76
"6809",8,"[24]loIproHcoxHnJHGqKCoutyBl",290,0.996564,24,291,1,290,1,1,0,1,1,158,157,133,133,76
"6810",9,"[24]loIproHcoxHnJHGqKCoutyBl",284,0.996491,24,285,1,284,1,1,0,1,1,145,144,140,140,76
"6811",10,"[24]loIproHcoxHnJHGqKCoutyBl",282,0.996466,24,283,1,282,1,1,0,1,1,146,145,137,137,76
"6812",11,"[24]loIproHcoxHnJHGqKCoutyBl",284,0.996491,24,285,1,284,1,1,0,1,1,142,141,143,143,76
"6813",12,"[24]loIproHcoxHnJHGqKCoutyBl",285,0.996503,24,286,1,285,1,1,0,1,1,143,142,143,143,76
"6814",13,"[24]loIproHcoxHnJHGqKCoutyBl",273,0.99635,24,274,1,273,1,1,0,1,1,131,130,143,143,76
"6815",14,"[24]loIproHcoxHnJHGqKCoutyBl",282,0.996466,24,283,1,282,1,1,0,1,1,155,154,128,128,76
"6816",15,"[24]loIproHcoxHnJHGqKCoutyBl",280,0.996441,24,281,1,280,1,1,0,1,1,135,134,146,146,76
"6817",16,"[24]loIproHcoxHnJHGqKCoutyBl",285,0.996503,24,286,1,285,1,1,0,1,1,134,133,152,152,76
"6818",17,"[24]loIproHcoxHnJHGqKCoutyBl",277,0.996403,24,278,1,277,1,1,0,1,1,144,143,134,134,76
"6819",18,"[24]loIproHcoxHnJHGqKCoutyBl",283,0.996479,24,284,1,283,1,1,0,1,1,145,144,139,139,76
"6820",19,"[24]loIproHcoxHnJHGqKCoutyBl",278,0.996416,24,279,1,278,1,1,0,1,1,138,137,141,141,76
"6821",20,"[24]loIproHcoxHnJHGqKCoutyBl",282,0.996466,24,283,1,282,1,1,0,1,1,135,134,148,148,76
"6822",21,"[24]loIproHcoxHnJHGqKCoutyBl",283,0.996479,24,284,1,283,1,1,0,1,1,164,163,120,120,76
"6823",22,"[24]loIproHcoxHnJHGqKCoutyBl",273,0.99635,24,274,1,273,1,1,0,1,1,141,140,133,133,76
"6824",23,"[24]loIproHcoxHnJHGqKCoutyBl",285,0.996503,24,286,1,285,1,1,0,1,1,138,137,148,148,76
"6825",24,"[24]loIproHcoxHnJHGqKCoutyBl",284,0.996491,24,285,1,284,1,1,0,1,1,139,138,146,146,76
"6826",25,"[24]loIproHcoxHnJHGqKCoutyBl",281,0.996454,24,282,1,281,1,1,0,1,1,143,142,139,139,76
"6827",26,"[24]loIproHcoxHnJHGqKCoutyBl",284,0.996491,24,285,1,284,1,1,0,1,1,145,144,140,140,76
"6828",27,"[24]loIproHcoxHnJHGqKCoutyBl",284,0.996491,24,285,1,284,1,1,0,1,1,146,145,139,139,76
"6829",28,"[24]loIproHcoxHnJHGqKCoutyBl",275,0.996377,24,276,1,275,1,1,0,1,1,139,138,137,137,76
"6830",29,"[24]loIproHcoxHnJHGqKCoutyBl",288,0.99654,24,289,1,288,1,1,0,1,1,156,155,133,133,76
"6831",30,"[24]loIproHcoxHnJHGqKCoutyBl",282,0.996466,24,283,1,282,1,1,0,1,1,142,141,141,141,76
"6832",31,"[24]loIproHcoxHnJHGqKCoutyBl",289,0.996552,24,290,1,289,1,1,0,1,1,152,151,138,138,76
"6833",32,"[24]loIproHcoxHnJHGqKCoutyBl",281,0.996454,24,282,1,281,1,1,0,1,1,141,140,141,141,76
"6834",33,"[24]loIproHcoxHnJHGqKCoutyBl",286,0.996516,24,287,1,286,1,1,0,1,1,141,140,146,146,76
"6835",34,"[24]loIproHcoxHnJHGqKCoutyBl",277,0.996403,24,278,1,277,1,1,0,1,1,142,141,136,136,76
"6836",35,"[24]loIproHcoxHnJHGqKCoutyBl",284,0.996491,24,285,1,284,1,1,0,1,1,157,156,128,128,76
"6837",36,"[24]loIproHcoxHnJHGqKCoutyBl",276,0.99639,24,277,1,276,1,1,0,1,1,123,122,154,154,76
"6838",37,"[24]loIproHcoxHnJHGqKCoutyBl",281,0.996454,24,282,1,281,1,1,0,1,1,133,132,149,149,76
"6839",38,"[24]loIproHcoxHnJHGqKCoutyBl",279,0.996429,24,280,1,279,1,1,0,1,1,139,138,141,141,76
"6840",39,"[24]loIproHcoxHnJHGqKCoutyBl",276,0.99639,24,277,1,276,1,1,0,1,1,130,129,147,147,76
"6841",40,"[24]loIproHcoxHnJHGqKCoutyBl",285,0.996503,24,286,1,285,1,1,0,1,1,138,137,148,148,76
"6842",41,"[24]loIproHcoxHnJHGqKCoutyBl",279,0.996429,24,280,1,279,1,1,0,1,1,149,148,131,131,76
"6843",42,"[24]loIproHcoxHnJHGqKCoutyBl",288,0.99654,24,289,1,288,1,1,0,1,1,159,158,130,130,76
"6844",43,"[24]loIproHcoxHnJHGqKCoutyBl",277,0.996403,24,278,1,277,1,1,0,1,1,129,128,149,149,76
"6845",44,"[24]loIproHcoxHnJHGqKCoutyBl",280,0.996441,24,281,1,280,1,1,0,1,1,142,141,139,139,76
"6846",45,"[24]loIproHcoxHnJHGqKCoutyBl",285,0.996503,24,286,1,285,1,1,0,1,1,157,156,129,129,76
"6847",46,"[24]loIproHcoxHnJHGqKCoutyBl",282,0.996466,24,283,1,282,1,1,0,1,1,147,146,136,136,76
"6848",47,"[24]loIproHcoxHnJHGqKCoutyBl",284,0.996491,24,285,1,284,1,1,0,1,1,143,142,142,142,76
"6849",48,"[24]loIproHcoxHnJHGqKCoutyBl",286,0.996516,24,287,1,286,1,1,0,1,1,139,138,148,148,76
"6850",49,"[24]loIproHcoxHnJHGqKCoutyBl",280,0.996441,24,281,1,280,1,1,0,1,1,134,133,147,147,76
"6851",50,"[24]loIproHcoxHnJHGqKCoutyBl",283,0.996479,24,284,1,283,1,1,0,1,1,139,138,145,145,76
"6852",51,"[24]loIproHcoxHnJHGqKCoutyBl",285,0.996503,24,286,1,285,1,1,0,1,1,145,144,141,141,76
"6853",52,"[24]loIproHcoxHnJHGqKCoutyBl",284,0.996491,24,285,1,284,1,1,0,1,1,138,137,147,147,76
"6854",53,"[24]loIproHcoxHnJHGqKCoutyBl",280,0.996441,24,281,1,280,1,1,0,1,1,142,141,139,139,76
"6855",54,"[24]loIproHcoxHnJHGqKCoutyBl",274,0.996364,24,275,1,274,1,1,0,1,1,152,151,123,123,76
"6856",55,"[24]loIproHcoxHnJHGqKCoutyBl",275,0.996377,24,276,1,275,1,1,0,1,1,144,143,132,132,76
"6857",56,"[24]loIproHcoxHnJHGqKCoutyBl",286,0.996516,24,287,1,286,1,1,0,1,1,150,149,137,137,76
"6858",57,"[24]loIproHcoxHnJHGqKCoutyBl",281,0.996454,24,282,1,281,1,1,0,1,1,136,135,146,146,76
"6859",58,"[24]loIproHcoxHnJHGqKCoutyBl",286,0.996516,24,287,1,286,1,1,0,1,1,142,141,145,145,76
"6860",59,"[24]loIproHcoxHnJHGqKCoutyBl",272,0.996337,24,273,1,272,1,1,0,1,1,128,127,145,145,76
"6861",60,"[24]loIproHcoxHnJHGqKCoutyBl",274,0.996364,24,275,1,274,1,1,0,1,1,133,132,142,142,76
"6862",61,"[24]loIproHcoxHnJHGqKCoutyBl",279,0.996429,24,280,1,279,1,1,0,1,1,143,142,137,137,76
"6863",62,"[24]loIproHcoxHnJHGqKCoutyBl",287,0.996528,24,288,1,287,1,1,0,1,1,162,161,126,126,76
"6864",63,"[24]loIproHcoxHnJHGqKCoutyBl",284,0.996491,24,285,1,284,1,1,0,1,1,152,151,133,133,76
"6865",64,"[24]loIproHcoxHnJHGqKCoutyBl",283,0.996479,24,284,1,283,1,1,0,1,1,137,136,147,147,76
"6866",65,"[24]loIproHcoxHnJHGqKCoutyBl",281,0.996454,24,282,1,281,1,1,0,1,1,150,149,132,132,76
"6867",66,"[24]loIproHcoxHnJHGqKCoutyBl",289,0.996552,24,290,1,289,1,1,0,1,1,157,156,133,133,76
"6868",67,"[24]loIproHcoxHnJHGqKCoutyBl",279,0.996429,24,280,1,279,1,1,0,1,1,137,136,143,143,76
"6869",68,"[24]loIproHcoxHnJHGqKCoutyBl",277,0.996403,24,278,1,277,1,1,0,1,1,148,147,130,130,76
"6870",69,"[24]loIproHcoxHnJHGqKCoutyBl",287,0.996528,24,288,1,287,1,1,0,1,1,155,154,133,133,76
"6871",70,"[24]loIproHcoxHnJHGqKCoutyBl",282,0.996466,24,283,1,282,1,1,0,1,1,149,148,134,134,76
"6872",71,"[24]loIproHcoxHnJHGqKCoutyBl",276,0.99639,24,277,1,276,1,1,0,1,1,146,145,131,131,76
"6873",72,"[24]loIproHcoxHnJHGqKCoutyBl",286,0.996516,24,287,1,286,1,1,0,1,1,134,133,153,153,76
"6874",73,"[24]loIproHcoxHnJHGqKCoutyBl",284,0.996491,24,285,1,284,1,1,0,1,1,142,141,143,143,76
"6875",74,"[24]loIproHcoxHnJHGqKCoutyBl",279,0.996429,24,280,1,279,1,1,0,1,1,140,139,140,140,76
"6876",75,"[24]loIproHcoxHnJHGqKCoutyBl",282,0.996466,24,283,1,282,1,1,0,1,1,148,147,135,135,76
"6877",76,"[24]loIproHcoxHnJHGqKCoutyBl",287,0.996528,24,288,1,287,1,1,0,1,1,140,139,148,148,76
"6878",77,"[24]loIproHcoxHnJHGqKCoutyBl",277,0.996403,24,278,1,277,1,1,0,1,1,142,141,136,136,76
"6879",78,"[24]loIproHcoxHnJHGqKCoutyBl",279,0.996429,24,280,1,279,1,1,0,1,1,148,147,132,132,76
"6880",79,"[24]loIproHcoxHnJHGqKCoutyBl",281,0.996454,24,282,1,281,1,1,0,1,1,158,157,124,124,76
"6881",80,"[24]loIproHcoxHnJHGqKCoutyBl",283,0.996479,24,284,1,283,1,1,0,1,1,154,153,130,130,76
"6882",81,"[24]loIproHcoxHnJHGqKCoutyBl",277,0.996403,24,278,1,277,1,1,0,1,1,146,145,132,132,76
"6883",82,"[24]loIproHcoxHnJHGqKCoutyBl",277,0.996403,24,278,1,277,1,1,0,1,1,133,132,145,145,76
"6884",83,"[24]loIproHcoxHnJHGqKCoutyBl",285,0.996503,24,286,1,285,1,1,0,1,1,154,153,132,132,76
"6885",84,"[24]loIproHcoxHnJHGqKCoutyBl",285,0.996503,24,286,1,285,1,1,0,1,1,153,152,133,133,76
"6886",85,"[24]loIproHcoxHnJHGqKCoutyBl",282,0.996466,24,283,1,282,1,1,0,1,1,147,146,136,136,76
"6887",86,"[24]loIproHcoxHnJHGqKCoutyBl",281,0.996454,24,282,1,281,1,1,0,1,1,140,139,142,142,76
"6888",87,"[24]loIproHcoxHnJHGqKCoutyBl",284,0.996491,24,285,1,284,1,1,0,1,1,142,141,143,143,76
"6889",88,"[24]loIproHcoxHnJHGqKCoutyBl",290,0.996564,24,291,1,290,1,1,0,1,1,151,150,140,140,76
"6890",89,"[24]loIproHcoxHnJHGqKCoutyBl",279,0.996429,24,280,1,279,1,1,0,1,1,151,150,129,129,76
"6891",90,"[24]loIproHcoxHnJHGqKCoutyBl",278,0.996416,24,279,1,278,1,1,0,1,1,128,127,151,151,76
"6892",91,"[24]loIproHcoxHnJHGqKCoutyBl",286,0.996516,24,287,1,286,1,1,0,1,1,157,156,130,130,76
"6893",92,"[24]loIproHcoxHnJHGqKCoutyBl",280,0.996441,24,281,1,280,1,1,0,1,1,125,124,156,156,76
"6894",93,"[24]loIproHcoxHnJHGqKCoutyBl",272,0.996337,24,273,1,272,1,1,0,1,1,139,138,134,134,76
"6895",94,"[24]loIproHcoxHnJHGqKCoutyBl",275,0.996377,24,276,1,275,1,1,0,1,1,131,130,145,145,76
"6896",95,"[24]loIproHcoxHnJHGqKCoutyBl",284,0.996491,24,285,1,284,1,1,0,1,1,155,154,130,130,76
"6897",96,"[24]loIproHcoxHnJHGqKCoutyBl",279,0.996429,24,280,1,279,1,1,0,1,1,142,141,138,138,76
"6898",97,"[24]loIproHcoxHnJHGqKCoutyBl",288,0.99654,24,289,1,288,1,1,0,1,1,155,154,134,134,76
"6899",98,"[24]loIproHcoxHnJHGqKCoutyBl",282,0.996466,24,283,1,282,1,1,0,1,1,135,134,148,148,76
"6900",99,"[24]loIproHcoxHnJHGqKCoutyBl",277,0.996403,24,278,1,277,1,1,0,1,1,138,137,140,140,76
"6901",0,"[27]utHoIoHcosHnJqGKCnoIbEtjkoq",297,0.996644,27,298,1,297,1,1,0,1,1,149,148,149,149,77
"6902",1,"[27]utHoIoHcosHnJqGKCnoIbEtjkoq",300,0.996678,27,301,1,300,1,1,0,1,1,162,161,139,139,77
"6903",2,"[27]utHoIoHcosHnJqGKCnoIbEtjkoq",298,0.996656,27,299,1,298,1,1,0,1,1,154,153,145,145,77
"6904",3,"[27]utHoIoHcosHnJqGKCnoIbEtjkoq",292,0.996587,27,293,1,292,1,1,0,1,1,137,136,156,156,77
"6905",4,"[27]utHoIoHcosHnJqGKCnoIbEtjkoq",296,0.996633,27,297,1,296,1,1,0,1,1,152,151,145,145,77
"6906",5,"[27]utHoIoHcosHnJqGKCnoIbEtjkoq",293,0.996599,27,294,1,293,1,1,0,1,1,141,140,153,153,77
"6907",6,"[27]utHoIoHcosHnJqGKCnoIbEtjkoq",299,0.996667,27,300,1,299,1,1,0,1,1,156,155,144,144,77
"6908",7,"[27]utHoIoHcosHnJqGKCnoIbEtjkoq",291,0.996575,27,292,1,291,1,1,0,1,1,129,128,163,163,77
"6909",8,"[27]utHoIoHcosHnJqGKCnoIbEtjkoq",297,0.996644,27,298,1,297,1,1,0,1,1,153,152,145,145,77
"6910",9,"[27]utHoIoHcosHnJqGKCnoIbEtjkoq",292,0.996587,27,293,1,292,1,1,0,1,1,137,136,156,156,77
"6911",10,"[27]utHoIoHcosHnJqGKCnoIbEtjkoq",294,0.99661,27,295,1,294,1,1,0,1,1,142,141,153,153,77
"6912",11,"[27]utHoIoHcosHnJqGKCnoIbEtjkoq",298,0.996656,27,299,1,298,1,1,0,1,1,158,157,141,141,77
"6913",12,"[27]utHoIoHcosHnJqGKCnoIbEtjkoq",297,0.996644,27,298,1,297,1,1,0,1,1,152,151,146,146,77
"6914",13,"[27]utHoIoHcosHnJqGKCnoIbEtjkoq",301,0.996689,27,302,1,301,1,1,0,1,1,166,165,136,136,77
"6915",14,"[27]utHoIoHcosHnJqGKCnoIbEtjkoq",297,0.996644,27,298,1,297,1,1,0,1,1,149,148,149,149,77
"6916",15,"[27]utHoIoHcosHnJqGKCnoIbEtjkoq",294,0.99661,27,295,1,294,1,1,0,1,1,144,143,151,151,77
"6917",16,"[27]utHoIoHcosHnJqGKCnoIbEtjkoq",297,0.996644,27,298,1,297,1,1,0,1,1,155,154,143,143,77
"6918",17,"[27]utHoIoHcosHnJqGKCnoIbEtjkoq",295,0.996622,27,296,1,295,1,1,0,1,1,145,144,151,151,77
"6919",18,"[27]utHoIoHcosHnJqGKCnoIbEtjkoq",295,0.996622,27,296,1,295,1,1,0,1,1,149,148,147,147,77
"6920",19,"[27]utHoIoHcosHnJqGKCnoIbEtjkoq",298,0.996656,27,299,1,298,1,1,0,1,1,157,156,142,142,77
"6921",20,"[27]utHoIoHcosHnJqGKCnoIbEtjkoq",298,0.996656,27,299,1,298,1,1,0,1,1,164,163,135,135,77
"6922",21,"[27]utHoIoHcosHnJqGKCnoIbEtjkoq",295,0.996622,27,296,1,295,1,1,0,1,1,151,150,145,145,77
"6923",22,"[27]utHoIoHcosHnJqGKCnoIbEtjkoq",290,0.996564,27,291,1,290,1,1,0,1,1,128,127,163,163,77
"6924",23,"[27]utHoIoHcosHnJqGKCnoIbEtjkoq",293,0.996599,27,294,1,293,1,1,0,1,1,145,144,149,149,77
"6925",24,"[27]utHoIoHcosHnJqGKCnoIbEtjkoq",296,0.996633,27,297,1,296,1,1,0,1,1,148,147,149,149,77
"6926",25,"[27]utHoIoHcosHnJqGKCnoIbEtjkoq",294,0.99661,27,295,1,294,1,1,0,1,1,141,140,154,154,77
"6927",26,"[27]utHoIoHcosHnJqGKCnoIbEtjkoq",292,0.996587,27,293,1,292,1,1,0,1,1,132,131,161,161,77
"6928",27,"[27]utHoIoHcosHnJqGKCnoIbEtjkoq",299,0.996667,27,300,1,299,1,1,0,1,1,158,157,142,142,77
"6929",28,"[27]utHoIoHcosHnJqGKCnoIbEtjkoq",292,0.996587,27,293,1,292,1,1,0,1,1,137,136,156,156,77
"6930",29,"[27]utHoIoHcosHnJqGKCnoIbEtjkoq",299,0.996667,27,300,1,299,1,1,0,1,1,159,158,141,141,77
"6931",30,"[27]utHoIoHcosHnJqGKCnoIbEtjkoq",292,0.996587,27,293,1,292,1,1,0,1,1,137,136,156,156,77
"6932",31,"[27]utHoIoHcosHnJqGKCnoIbEtjkoq",294,0.99661,27,295,1,294,1,1,0,1,1,146,145,149,149,77
"6933",32,"[27]utHoIoHcosHnJqGKCnoIbEtjkoq",295,0.996622,27,296,1,295,1,1,0,1,1,148,147,148,148,77
"6934",33,"[27]utHoIoHcosHnJqGKCnoIbEtjkoq",294,0.99661,27,295,1,294,1,1,0,1,1,140,139,155,155,77
"6935",34,"[27]utHoIoHcosHnJqGKCnoIbEtjkoq",292,0.996587,27,293,1,292,1,1,0,1,1,137,136,156,156,77
"6936",35,"[27]utHoIoHcosHnJqGKCnoIbEtjkoq",296,0.996633,27,297,1,296,1,1,0,1,1,143,142,154,154,77
"6937",36,"[27]utHoIoHcosHnJqGKCnoIbEtjkoq",300,0.996678,27,301,1,300,1,1,0,1,1,158,157,143,143,77
"6938",37,"[27]utHoIoHcosHnJqGKCnoIbEtjkoq",288,0.99654,27,289,1,288,1,1,0,1,1,126,125,163,163,77
"6939",38,"[27]utHoIoHcosHnJqGKCnoIbEtjkoq",296,0.996633,27,297,1,296,1,1,0,1,1,146,145,151,151,77
"6940",39,"[27]utHoIoHcosHnJqGKCnoIbEtjkoq",295,0.996622,27,296,1,295,1,1,0,1,1,145,144,151,151,77
"6941",40,"[27]utHoIoHcosHnJqGKCnoIbEtjkoq",294,0.99661,27,295,1,294,1,1,0,1,1,146,145,149,149,77
"6942",41,"[27]utHoIoHcosHnJqGKCnoIbEtjkoq",295,0.996622,27,296,1,295,1,1,0,1,1,154,153,142,142,77
"6943",42,"[27]utHoIoHcosHnJqGKCnoIbEtjkoq",299,0.996667,27,300,1,299,1,1,0,1,1,156,155,144,144,77
"6944",43,"[27]utHoIoHcosHnJqGKCnoIbEtjkoq",296,0.996633,27,297,1,296,1,1,0,1,1,152,151,145,145,77
"6945",44,"[27]utHoIoHcosHnJqGKCnoIbEtjkoq",299,0.996667,27,300,1,299,1,1,0,1,1,157,156,143,143,77
"6946",45,"[27]utHoIoHcosHnJqGKCnoIbEtjkoq",297,0.996644,27,298,1,297,1,1,0,1,1,154,153,144,144,77
"6947",46,"[27]utHoIoHcosHnJqGKCnoIbEtjkoq",297,0.996644,27,298,1,297,1,1,0,1,1,150,149,148,148,77
"6948",47,"[27]utHoIoHcosHnJqGKCnoIbEtjkoq",294,0.99661,27,295,1,294,1,1,0,1,1,142,141,153,153,77
"6949",48,"[27]utHoIoHcosHnJqGKCnoIbEtjkoq",300,0.996678,27,301,1,300,1,1,0,1,1,156,155,145,145,77
"6950",49,"[27]utHoIoHcosHnJqGKCnoIbEtjkoq",298,0.996656,27,299,1,298,1,1,0,1,1,148,147,151,151,77
"6951",50,"[27]utHoIoHcosHnJqGKCnoIbEtjkoq",301,0.996689,27,302,1,301,1,1,0,1,1,177,176,125,125,77
"6952",51,"[27]utHoIoHcosHnJqGKCnoIbEtjkoq",302,0.9967,27,303,1,302,1,1,0,1,1,167,166,136,136,77
"6953",52,"[27]utHoIoHcosHnJqGKCnoIbEtjkoq",299,0.996667,27,300,1,299,1,1,0,1,1,158,157,142,142,77
"6954",53,"[27]utHoIoHcosHnJqGKCnoIbEtjkoq",296,0.996633,27,297,1,296,1,1,0,1,1,156,155,141,141,77
"6955",54,"[27]utHoIoHcosHnJqGKCnoIbEtjkoq",299,0.996667,27,300,1,299,1,1,0,1,1,157,156,143,143,77
"6956",55,"[27]utHoIoHcosHnJqGKCnoIbEtjkoq",296,0.996633,27,297,1,296,1,1,0,1,1,155,154,142,142,77
"6957",56,"[27]utHoIoHcosHnJqGKCnoIbEtjkoq",289,0.996552,27,290,1,289,1,1,0,1,1,129,128,161,161,77
"6958",57,"[27]utHoIoHcosHnJqGKCnoIbEtjkoq",297,0.996644,27,298,1,297,1,1,0,1,1,152,151,146,146,77
"6959",58,"[27]utHoIoHcosHnJqGKCnoIbEtjkoq",300,0.996678,27,301,1,300,1,1,0,1,1,160,159,141,141,77
"6960",59,"[27]utHoIoHcosHnJqGKCnoIbEtjkoq",297,0.996644,27,298,1,297,1,1,0,1,1,153,152,145,145,77
"6961",60,"[27]utHoIoHcosHnJqGKCnoIbEtjkoq",293,0.996599,27,294,1,293,1,1,0,1,1,140,139,154,154,77
"6962",61,"[27]utHoIoHcosHnJqGKCnoIbEtjkoq",294,0.99661,27,295,1,294,1,1,0,1,1,141,140,154,154,77
"6963",62,"[27]utHoIoHcosHnJqGKCnoIbEtjkoq",297,0.996644,27,298,1,297,1,1,0,1,1,163,162,135,135,77
"6964",63,"[27]utHoIoHcosHnJqGKCnoIbEtjkoq",295,0.996622,27,296,1,295,1,1,0,1,1,152,151,144,144,77
"6965",64,"[27]utHoIoHcosHnJqGKCnoIbEtjkoq",297,0.996644,27,298,1,297,1,1,0,1,1,153,152,145,145,77
"6966",65,"[27]utHoIoHcosHnJqGKCnoIbEtjkoq",287,0.996528,27,288,1,287,1,1,0,1,1,128,127,160,160,77
"6967",66,"[27]utHoIoHcosHnJqGKCnoIbEtjkoq",289,0.996552,27,290,1,289,1,1,0,1,1,124,123,166,166,77
"6968",67,"[27]utHoIoHcosHnJqGKCnoIbEtjkoq",298,0.996656,27,299,1,298,1,1,0,1,1,155,154,144,144,77
"6969",68,"[27]utHoIoHcosHnJqGKCnoIbEtjkoq",294,0.99661,27,295,1,294,1,1,0,1,1,143,142,152,152,77
"6970",69,"[27]utHoIoHcosHnJqGKCnoIbEtjkoq",292,0.996587,27,293,1,292,1,1,0,1,1,138,137,155,155,77
"6971",70,"[27]utHoIoHcosHnJqGKCnoIbEtjkoq",296,0.996633,27,297,1,296,1,1,0,1,1,150,149,147,147,77
"6972",71,"[27]utHoIoHcosHnJqGKCnoIbEtjkoq",295,0.996622,27,296,1,295,1,1,0,1,1,146,145,150,150,77
"6973",72,"[27]utHoIoHcosHnJqGKCnoIbEtjkoq",298,0.996656,27,299,1,298,1,1,0,1,1,154,153,145,145,77
"6974",73,"[27]utHoIoHcosHnJqGKCnoIbEtjkoq",292,0.996587,27,293,1,292,1,1,0,1,1,132,131,161,161,77
"6975",74,"[27]utHoIoHcosHnJqGKCnoIbEtjkoq",296,0.996633,27,297,1,296,1,1,0,1,1,149,148,148,148,77
"6976",75,"[27]utHoIoHcosHnJqGKCnoIbEtjkoq",297,0.996644,27,298,1,297,1,1,0,1,1,152,151,146,146,77
"6977",76,"[27]utHoIoHcosHnJqGKCnoIbEtjkoq",299,0.996667,27,300,1,299,1,1,0,1,1,159,158,141,141,77
"6978",77,"[27]utHoIoHcosHnJqGKCnoIbEtjkoq",296,0.996633,27,297,1,296,1,1,0,1,1,155,154,142,142,77
"6979",78,"[27]utHoIoHcosHnJqGKCnoIbEtjkoq",293,0.996599,27,294,1,293,1,1,0,1,1,143,142,151,151,77
"6980",79,"[27]utHoIoHcosHnJqGKCnoIbEtjkoq",295,0.996622,27,296,1,295,1,1,0,1,1,145,144,151,151,77
"6981",80,"[27]utHoIoHcosHnJqGKCnoIbEtjkoq",298,0.996656,27,299,1,298,1,1,0,1,1,155,154,144,144,77
"6982",81,"[27]utHoIoHcosHnJqGKCnoIbEtjkoq",294,0.99661,27,295,1,294,1,1,0,1,1,140,139,155,155,77
"6983",82,"[27]utHoIoHcosHnJqGKCnoIbEtjkoq",298,0.996656,27,299,1,298,1,1,0,1,1,152,151,147,147,77
"6984",83,"[27]utHoIoHcosHnJqGKCnoIbEtjkoq",298,0.996656,27,299,1,298,1,1,0,1,1,154,153,145,145,77
"6985",84,"[27]utHoIoHcosHnJqGKCnoIbEtjkoq",297,0.996644,27,298,1,297,1,1,0,1,1,153,152,145,145,77
"6986",85,"[27]utHoIoHcosHnJqGKCnoIbEtjkoq",300,0.996678,27,301,1,300,1,1,0,1,1,161,160,140,140,77
"6987",86,"[27]utHoIoHcosHnJqGKCnoIbEtjkoq",300,0.996678,27,301,1,300,1,1,0,1,1,162,161,139,139,77
"6988",87,"[27]utHoIoHcosHnJqGKCnoIbEtjkoq",293,0.996599,27,294,1,293,1,1,0,1,1,140,139,154,154,77
"6989",88,"[27]utHoIoHcosHnJqGKCnoIbEtjkoq",295,0.996622,27,296,1,295,1,1,0,1,1,148,147,148,148,77
"6990",89,"[27]utHoIoHcosHnJqGKCnoIbEtjkoq",296,0.996633,27,297,1,296,1,1,0,1,1,149,148,148,148,77
"6991",90,"[27]utHoIoHcosHnJqGKCnoIbEtjkoq",299,0.996667,27,300,1,299,1,1,0,1,1,157,156,143,143,77
"6992",91,"[27]utHoIoHcosHnJqGKCnoIbEtjkoq",303,0.996711,27,304,1,303,1,1,0,1,1,165,164,139,139,77
"6993",92,"[27]utHoIoHcosHnJqGKCnoIbEtjkoq",287,0.996528,27,288,1,287,1,1,0,1,1,122,121,166,166,77
"6994",93,"[27]utHoIoHcosHnJqGKCnoIbEtjkoq",302,0.9967,27,303,1,302,1,1,0,1,1,164,163,139,139,77
"6995",94,"[27]utHoIoHcosHnJqGKCnoIbEtjkoq",300,0.996678,27,301,1,300,1,1,0,1,1,159,158,142,142,77
"6996",95,"[27]utHoIoHcosHnJqGKCnoIbEtjkoq",296,0.996633,27,297,1,296,1,1,0,1,1,149,148,148,148,77
"6997",96,"[27]utHoIoHcosHnJqGKCnoIbEtjkoq",296,0.996633,27,297,1,296,1,1,0,1,1,150,149,147,147,77
"6998",97,"[27]utHoIoHcosHnJqGKCnoIbEtjkoq",298,0.996656,27,299,1,298,1,1,0,1,1,155,154,144,144,77
"6999",98,"[27]utHoIoHcosHnJqGKCnoIbEtjkoq",296,0.996633,27,297,1,296,1,1,0,1,1,146,145,151,151,77
"7000",99,"[27]utHoIoHcosHnJqGKCnoIbEtjkoq",292,0.996587,27,293,1,292,1,1,0,1,1,138,137,155,155,77
"7001",0,"[25]yzHoIoHcowHnJHGqKCnyFgjFy",288,0.99654,25,289,1,288,1,1,0,1,1,147,146,142,142,79
"7002",1,"[25]yzHoIoHcowHnJHGqKCnyFgjFy",273,0.99635,25,274,1,273,1,1,0,1,1,145,144,129,129,79
"7003",2,"[25]yzHoIoHcowHnJHGqKCnyFgjFy",285,0.996503,25,286,1,285,1,1,0,1,1,151,150,135,135,79
"7004",3,"[25]yzHoIoHcowHnJHGqKCnyFgjFy",280,0.996441,25,281,1,280,1,1,0,1,1,135,134,146,146,79
"7005",4,"[25]yzHoIoHcowHnJHGqKCnyFgjFy",283,0.996479,25,284,1,283,1,1,0,1,1,139,138,145,145,79
"7006",5,"[25]yzHoIoHcowHnJHGqKCnyFgjFy",281,0.996454,25,282,1,281,1,1,0,1,1,137,136,145,145,79
"7007",6,"[25]yzHoIoHcowHnJHGqKCnyFgjFy",289,0.996552,25,290,1,289,1,1,0,1,1,144,143,146,146,79
"7008",7,"[25]yzHoIoHcowHnJHGqKCnyFgjFy",285,0.996503,25,286,1,285,1,1,0,1,1,153,152,133,133,79
"7009",8,"[25]yzHoIoHcowHnJHGqKCnyFgjFy",273,0.99635,25,274,1,273,1,1,0,1,1,136,135,138,138,79
"7010",9,"[25]yzHoIoHcowHnJHGqKCnyFgjFy",286,0.996516,25,287,1,286,1,1,0,1,1,148,147,139,139,79
"7011",10,"[25]yzHoIoHcowHnJHGqKCnyFgjFy",288,0.99654,25,289,1,288,1,1,0,1,1,150,149,139,139,79
"7012",11,"[25]yzHoIoHcowHnJHGqKCnyFgjFy",282,0.996466,25,283,1,282,1,1,0,1,1,154,153,129,129,79
"7013",12,"[25]yzHoIoHcowHnJHGqKCnyFgjFy",281,0.996454,25,282,1,281,1,1,0,1,1,146,145,136,136,79
"7014",13,"[25]yzHoIoHcowHnJHGqKCnyFgjFy",275,0.996377,25,276,1,275,1,1,0,1,1,153,152,123,123,79
"7015",14,"[25]yzHoIoHcowHnJHGqKCnyFgjFy",283,0.996479,25,284,1,283,1,1,0,1,1,151,150,133,133,79
"7016",15,"[25]yzHoIoHcowHnJHGqKCnyFgjFy",280,0.996441,25,281,1,280,1,1,0,1,1,130,129,151,151,79
"7017",16,"[25]yzHoIoHcowHnJHGqKCnyFgjFy",281,0.996454,25,282,1,281,1,1,0,1,1,137,136,145,145,79
"7018",17,"[25]yzHoIoHcowHnJHGqKCnyFgjFy",279,0.996429,25,280,1,279,1,1,0,1,1,155,154,125,125,79
"7019",18,"[25]yzHoIoHcowHnJHGqKCnyFgjFy",282,0.996466,25,283,1,282,1,1,0,1,1,145,144,138,138,79
"7020",19,"[25]yzHoIoHcowHnJHGqKCnyFgjFy",284,0.996491,25,285,1,284,1,1,0,1,1,144,143,141,141,79
"7021",20,"[25]yzHoIoHcowHnJHGqKCnyFgjFy",275,0.996377,25,276,1,275,1,1,0,1,1,133,132,143,143,79
"7022",21,"[25]yzHoIoHcowHnJHGqKCnyFgjFy",270,0.99631,25,271,1,270,1,1,0,1,1,122,121,149,149,79
"7023",22,"[25]yzHoIoHcowHnJHGqKCnyFgjFy",289,0.996552,25,290,1,289,1,1,0,1,1,145,144,145,145,79
"7024",23,"[25]yzHoIoHcowHnJHGqKCnyFgjFy",277,0.996403,25,278,1,277,1,1,0,1,1,133,132,145,145,79
"7025",24,"[25]yzHoIoHcowHnJHGqKCnyFgjFy",277,0.996403,25,278,1,277,1,1,0,1,1,137,136,141,141,79
"7026",25,"[25]yzHoIoHcowHnJHGqKCnyFgjFy",280,0.996441,25,281,1,280,1,1,0,1,1,140,139,141,141,79
"7027",26,"[25]yzHoIoHcowHnJHGqKCnyFgjFy",287,0.996528,25,288,1,287,1,1,0,1,1,142,141,146,146,79
"7028",27,"[25]yzHoIoHcowHnJHGqKCnyFgjFy",289,0.996552,25,290,1,289,1,1,0,1,1,171,170,119,119,79
"7029",28,"[25]yzHoIoHcowHnJHGqKCnyFgjFy",284,0.996491,25,285,1,284,1,1,0,1,1,142,141,143,143,79
"7030",29,"[25]yzHoIoHcowHnJHGqKCnyFgjFy",281,0.996454,25,282,1,281,1,1,0,1,1,143,142,139,139,79
"7031",30,"[25]yzHoIoHcowHnJHGqKCnyFgjFy",284,0.996491,25,285,1,284,1,1,0,1,1,149,148,136,136,79
"7032",31,"[25]yzHoIoHcowHnJHGqKCnyFgjFy",281,0.996454,25,282,1,281,1,1,0,1,1,148,147,134,134,79
"7033",32,"[25]yzHoIoHcowHnJHGqKCnyFgjFy",282,0.996466,25,283,1,282,1,1,0,1,1,145,144,138,138,79
"7034",33,"[25]yzHoIoHcowHnJHGqKCnyFgjFy",283,0.996479,25,284,1,283,1,1,0,1,1,135,134,149,149,79
"7035",34,"[25]yzHoIoHcowHnJHGqKCnyFgjFy",292,0.996587,25,293,1,292,1,1,0,1,1,167,166,126,126,79
"7036",35,"[25]yzHoIoHcowHnJHGqKCnyFgjFy",280,0.996441,25,281,1,280,1,1,0,1,1,132,131,149,149,79
"7037",36,"[25]yzHoIoHcowHnJHGqKCnyFgjFy",280,0.996441,25,281,1,280,1,1,0,1,1,140,139,141,141,79
"7038",37,"[25]yzHoIoHcowHnJHGqKCnyFgjFy",278,0.996416,25,279,1,278,1,1,0,1,1,122,121,157,157,79
"7039",38,"[25]yzHoIoHcowHnJHGqKCnyFgjFy",282,0.996466,25,283,1,282,1,1,0,1,1,152,151,131,131,79
"7040",39,"[25]yzHoIoHcowHnJHGqKCnyFgjFy",285,0.996503,25,286,1,285,1,1,0,1,1,161,160,125,125,79
"7041",40,"[25]yzHoIoHcowHnJHGqKCnyFgjFy",287,0.996528,25,288,1,287,1,1,0,1,1,140,139,148,148,79
"7042",41,"[25]yzHoIoHcowHnJHGqKCnyFgjFy",281,0.996454,25,282,1,281,1,1,0,1,1,144,143,138,138,79
"7043",42,"[25]yzHoIoHcowHnJHGqKCnyFgjFy",291,0.996575,25,292,1,291,1,1,0,1,1,146,145,146,146,79
"7044",43,"[25]yzHoIoHcowHnJHGqKCnyFgjFy",281,0.996454,25,282,1,281,1,1,0,1,1,138,137,144,144,79
"7045",44,"[25]yzHoIoHcowHnJHGqKCnyFgjFy",282,0.996466,25,283,1,282,1,1,0,1,1,141,140,142,142,79
"7046",45,"[25]yzHoIoHcowHnJHGqKCnyFgjFy",275,0.996377,25,276,1,275,1,1,0,1,1,151,150,125,125,79
"7047",46,"[25]yzHoIoHcowHnJHGqKCnyFgjFy",290,0.996564,25,291,1,290,1,1,0,1,1,165,164,126,126,79
"7048",47,"[25]yzHoIoHcowHnJHGqKCnyFgjFy",277,0.996403,25,278,1,277,1,1,0,1,1,145,144,133,133,79
"7049",48,"[25]yzHoIoHcowHnJHGqKCnyFgjFy",281,0.996454,25,282,1,281,1,1,0,1,1,143,142,139,139,79
"7050",49,"[25]yzHoIoHcowHnJHGqKCnyFgjFy",278,0.996416,25,279,1,278,1,1,0,1,1,148,147,131,131,79
"7051",50,"[25]yzHoIoHcowHnJHGqKCnyFgjFy",279,0.996429,25,280,1,279,1,1,0,1,1,136,135,144,144,79
"7052",51,"[25]yzHoIoHcowHnJHGqKCnyFgjFy",276,0.99639,25,277,1,276,1,1,0,1,1,132,131,145,145,79
"7053",52,"[25]yzHoIoHcowHnJHGqKCnyFgjFy",281,0.996454,25,282,1,281,1,1,0,1,1,140,139,142,142,79
"7054",53,"[25]yzHoIoHcowHnJHGqKCnyFgjFy",274,0.996364,25,275,1,274,1,1,0,1,1,132,131,143,143,79
"7055",54,"[25]yzHoIoHcowHnJHGqKCnyFgjFy",285,0.996503,25,286,1,285,1,1,0,1,1,146,145,140,140,79
"7056",55,"[25]yzHoIoHcowHnJHGqKCnyFgjFy",276,0.99639,25,277,1,276,1,1,0,1,1,130,129,147,147,79
"7057",56,"[25]yzHoIoHcowHnJHGqKCnyFgjFy",286,0.996516,25,287,1,286,1,1,0,1,1,144,143,143,143,79
"7058",57,"[25]yzHoIoHcowHnJHGqKCnyFgjFy",280,0.996441,25,281,1,280,1,1,0,1,1,153,152,128,128,79
"7059",58,"[25]yzHoIoHcowHnJHGqKCnyFgjFy",279,0.996429,25,280,1,279,1,1,0,1,1,132,131,148,148,79
"7060",59,"[25]yzHoIoHcowHnJHGqKCnyFgjFy",266,0.996255,25,267,1,266,1,1,0,1,1,125,124,142,142,79
"7061",60,"[25]yzHoIoHcowHnJHGqKCnyFgjFy",277,0.996403,25,278,1,277,1,1,0,1,1,160,159,118,118,79
"7062",61,"[25]yzHoIoHcowHnJHGqKCnyFgjFy",283,0.996479,25,284,1,283,1,1,0,1,1,129,128,155,155,79
"7063",62,"[25]yzHoIoHcowHnJHGqKCnyFgjFy",275,0.996377,25,276,1,275,1,1,0,1,1,148,147,128,128,79
"7064",63,"[25]yzHoIoHcowHnJHGqKCnyFgjFy",287,0.996528,25,288,1,287,1,1,0,1,1,149,148,139,139,79
"7065",64,"[25]yzHoIoHcowHnJHGqKCnyFgjFy",281,0.996454,25,282,1,281,1,1,0,1,1,153,152,129,129,79
"7066",65,"[25]yzHoIoHcowHnJHGqKCnyFgjFy",286,0.996516,25,287,1,286,1,1,0,1,1,151,150,136,136,79
"7067",66,"[25]yzHoIoHcowHnJHGqKCnyFgjFy",284,0.996491,25,285,1,284,1,1,0,1,1,156,155,129,129,79
"7068",67,"[25]yzHoIoHcowHnJHGqKCnyFgjFy",279,0.996429,25,280,1,279,1,1,0,1,1,129,128,151,151,79
"7069",68,"[25]yzHoIoHcowHnJHGqKCnyFgjFy",280,0.996441,25,281,1,280,1,1,0,1,1,142,141,139,139,79
"7070",69,"[25]yzHoIoHcowHnJHGqKCnyFgjFy",269,0.996296,25,270,1,269,1,1,0,1,1,124,123,146,146,79
"7071",70,"[25]yzHoIoHcowHnJHGqKCnyFgjFy",288,0.99654,25,289,1,288,1,1,0,1,1,138,137,151,151,79
"7072",71,"[25]yzHoIoHcowHnJHGqKCnyFgjFy",277,0.996403,25,278,1,277,1,1,0,1,1,138,137,140,140,79
"7073",72,"[25]yzHoIoHcowHnJHGqKCnyFgjFy",285,0.996503,25,286,1,285,1,1,0,1,1,140,139,146,146,79
"7074",73,"[25]yzHoIoHcowHnJHGqKCnyFgjFy",282,0.996466,25,283,1,282,1,1,0,1,1,135,134,148,148,79
"7075",74,"[25]yzHoIoHcowHnJHGqKCnyFgjFy",284,0.996491,25,285,1,284,1,1,0,1,1,147,146,138,138,79
"7076",75,"[25]yzHoIoHcowHnJHGqKCnyFgjFy",281,0.996454,25,282,1,281,1,1,0,1,1,142,141,140,140,79
"7077",76,"[25]yzHoIoHcowHnJHGqKCnyFgjFy",277,0.996403,25,278,1,277,1,1,0,1,1,135,134,143,143,79
"7078",77,"[25]yzHoIoHcowHnJHGqKCnyFgjFy",285,0.996503,25,286,1,285,1,1,0,1,1,152,151,134,134,79
"7079",78,"[25]yzHoIoHcowHnJHGqKCnyFgjFy",289,0.996552,25,290,1,289,1,1,0,1,1,142,141,148,148,79
"7080",79,"[25]yzHoIoHcowHnJHGqKCnyFgjFy",288,0.99654,25,289,1,288,1,1,0,1,1,154,153,135,135,79
"7081",80,"[25]yzHoIoHcowHnJHGqKCnyFgjFy",282,0.996466,25,283,1,282,1,1,0,1,1,140,139,143,143,79
"7082",81,"[25]yzHoIoHcowHnJHGqKCnyFgjFy",290,0.996564,25,291,1,290,1,1,0,1,1,163,162,128,128,79
"7083",82,"[25]yzHoIoHcowHnJHGqKCnyFgjFy",289,0.996552,25,290,1,289,1,1,0,1,1,153,152,137,137,79
"7084",83,"[25]yzHoIoHcowHnJHGqKCnyFgjFy",292,0.996587,25,293,1,292,1,1,0,1,1,164,163,129,129,79
"7085",84,"[25]yzHoIoHcowHnJHGqKCnyFgjFy",272,0.996337,25,273,1,272,1,1,0,1,1,146,145,127,127,79
"7086",85,"[25]yzHoIoHcowHnJHGqKCnyFgjFy",275,0.996377,25,276,1,275,1,1,0,1,1,128,127,148,148,79
"7087",86,"[25]yzHoIoHcowHnJHGqKCnyFgjFy",274,0.996364,25,275,1,274,1,1,0,1,1,139,138,136,136,79
"7088",87,"[25]yzHoIoHcowHnJHGqKCnyFgjFy",281,0.996454,25,282,1,281,1,1,0,1,1,141,140,141,141,79
"7089",88,"[25]yzHoIoHcowHnJHGqKCnyFgjFy",280,0.996441,25,281,1,280,1,1,0,1,1,146,145,135,135,79
"7090",89,"[25]yzHoIoHcowHnJHGqKCnyFgjFy",279,0.996429,25,280,1,279,1,1,0,1,1,141,140,139,139,79
"7091",90,"[25]yzHoIoHcowHnJHGqKCnyFgjFy",281,0.996454,25,282,1,281,1,1,0,1,1,139,138,143,143,79
"7092",91,"[25]yzHoIoHcowHnJHGqKCnyFgjFy",276,0.99639,25,277,1,276,1,1,0,1,1,134,133,143,143,79
"7093",92,"[25]yzHoIoHcowHnJHGqKCnyFgjFy",282,0.996466,25,283,1,282,1,1,0,1,1,146,145,137,137,79
"7094",93,"[25]yzHoIoHcowHnJHGqKCnyFgjFy",279,0.996429,25,280,1,279,1,1,0,1,1,130,129,150,150,79
"7095",94,"[25]yzHoIoHcowHnJHGqKCnyFgjFy",278,0.996416,25,279,1,278,1,1,0,1,1,134,133,145,145,79
"7096",95,"[25]yzHoIoHcowHnJHGqKCnyFgjFy",281,0.996454,25,282,1,281,1,1,0,1,1,152,151,130,130,79
"7097",96,"[25]yzHoIoHcowHnJHGqKCnyFgjFy",284,0.996491,25,285,1,284,1,1,0,1,1,147,146,138,138,79
"7098",97,"[25]yzHoIoHcowHnJHGqKCnyFgjFy",275,0.996377,25,276,1,275,1,1,0,1,1,141,140,135,135,79
"7099",98,"[25]yzHoIoHcowHnJHGqKCnyFgjFy",267,0.996269,25,268,1,267,1,1,0,1,1,145,144,123,123,79
"7100",99,"[25]yzHoIoHcowHnJHGqKCnyFgjFy",283,0.996479,25,284,1,283,1,1,0,1,1,152,151,132,132,79
"7101",0,"[27]lxoIboHcbosHnJHGqKChvDaEHvx",277,0.996403,27,278,1,277,1,1,0,1,1,130,129,148,148,80
"7102",1,"[27]lxoIboHcbosHnJHGqKChvDaEHvx",284,0.996491,27,285,1,284,1,1,0,1,1,150,149,135,135,80
"7103",2,"[27]lxoIboHcbosHnJHGqKChvDaEHvx",283,0.996479,27,284,1,283,1,1,0,1,1,140,139,144,144,80
"7104",3,"[27]lxoIboHcbosHnJHGqKChvDaEHvx",279,0.996429,27,280,1,279,1,1,0,1,1,136,135,144,144,80
"7105",4,"[27]lxoIboHcbosHnJHGqKChvDaEHvx",276,0.99639,27,277,1,276,1,1,0,1,1,137,136,140,140,80
"7106",5,"[27]lxoIboHcbosHnJHGqKChvDaEHvx",285,0.996503,27,286,1,285,1,1,0,1,1,154,153,132,132,80
"7107",6,"[27]lxoIboHcbosHnJHGqKChvDaEHvx",280,0.996441,27,281,1,280,1,1,0,1,1,126,125,155,155,80
"7108",7,"[27]lxoIboHcbosHnJHGqKChvDaEHvx",277,0.996403,27,278,1,277,1,1,0,1,1,134,133,144,144,80
"7109",8,"[27]lxoIboHcbosHnJHGqKChvDaEHvx",267,0.996269,27,268,1,267,1,1,0,1,1,138,137,130,130,80
"7110",9,"[27]lxoIboHcbosHnJHGqKChvDaEHvx",274,0.996364,27,275,1,274,1,1,0,1,1,136,135,139,139,80
"7111",10,"[27]lxoIboHcbosHnJHGqKChvDaEHvx",284,0.996491,27,285,1,284,1,1,0,1,1,147,146,138,138,80
"7112",11,"[27]lxoIboHcbosHnJHGqKChvDaEHvx",281,0.996454,27,282,1,281,1,1,0,1,1,150,149,132,132,80
"7113",12,"[27]lxoIboHcbosHnJHGqKChvDaEHvx",275,0.996377,27,276,1,275,1,1,0,1,1,148,147,128,128,80
"7114",13,"[27]lxoIboHcbosHnJHGqKChvDaEHvx",274,0.996364,27,275,1,274,1,1,0,1,1,127,126,148,148,80
"7115",14,"[27]lxoIboHcbosHnJHGqKChvDaEHvx",279,0.996429,27,280,1,279,1,1,0,1,1,147,146,133,133,80
"7116",15,"[27]lxoIboHcbosHnJHGqKChvDaEHvx",283,0.996479,27,284,1,283,1,1,0,1,1,164,163,120,120,80
"7117",16,"[27]lxoIboHcbosHnJHGqKChvDaEHvx",278,0.996416,27,279,1,278,1,1,0,1,1,128,127,151,151,80
"7118",17,"[27]lxoIboHcbosHnJHGqKChvDaEHvx",279,0.996429,27,280,1,279,1,1,0,1,1,141,140,139,139,80
"7119",18,"[27]lxoIboHcbosHnJHGqKChvDaEHvx",281,0.996454,27,282,1,281,1,1,0,1,1,135,134,147,147,80
"7120",19,"[27]lxoIboHcbosHnJHGqKChvDaEHvx",281,0.996454,27,282,1,281,1,1,0,1,1,152,151,130,130,80
"7121",20,"[27]lxoIboHcbosHnJHGqKChvDaEHvx",278,0.996416,27,279,1,278,1,1,0,1,1,148,147,131,131,80
"7122",21,"[27]lxoIboHcbosHnJHGqKChvDaEHvx",287,0.996528,27,288,1,287,1,1,0,1,1,148,147,140,140,80
"7123",22,"[27]lxoIboHcbosHnJHGqKChvDaEHvx",273,0.99635,27,274,1,273,1,1,0,1,1,133,132,141,141,80
"7124",23,"[27]lxoIboHcbosHnJHGqKChvDaEHvx",279,0.996429,27,280,1,279,1,1,0,1,1,140,139,140,140,80
"7125",24,"[27]lxoIboHcbosHnJHGqKChvDaEHvx",280,0.996441,27,281,1,280,1,1,0,1,1,147,146,134,134,80
"7126",25,"[27]lxoIboHcbosHnJHGqKChvDaEHvx",290,0.996564,27,291,1,290,1,1,0,1,1,160,159,131,131,80
"7127",26,"[27]lxoIboHcbosHnJHGqKChvDaEHvx",277,0.996403,27,278,1,277,1,1,0,1,1,144,143,134,134,80
"7128",27,"[27]lxoIboHcbosHnJHGqKChvDaEHvx",285,0.996503,27,286,1,285,1,1,0,1,1,157,156,129,129,80
"7129",28,"[27]lxoIboHcbosHnJHGqKChvDaEHvx",289,0.996552,27,290,1,289,1,1,0,1,1,138,137,152,152,80
"7130",29,"[27]lxoIboHcbosHnJHGqKChvDaEHvx",280,0.996441,27,281,1,280,1,1,0,1,1,135,134,146,146,80
"7131",30,"[27]lxoIboHcbosHnJHGqKChvDaEHvx",282,0.996466,27,283,1,282,1,1,0,1,1,151,150,132,132,80
"7132",31,"[27]lxoIboHcbosHnJHGqKChvDaEHvx",279,0.996429,27,280,1,279,1,1,0,1,1,141,140,139,139,80
"7133",32,"[27]lxoIboHcbosHnJHGqKChvDaEHvx",276,0.99639,27,277,1,276,1,1,0,1,1,146,145,131,131,80
"7134",33,"[27]lxoIboHcbosHnJHGqKChvDaEHvx",282,0.996466,27,283,1,282,1,1,0,1,1,142,141,141,141,80
"7135",34,"[27]lxoIboHcbosHnJHGqKChvDaEHvx",278,0.996416,27,279,1,278,1,1,0,1,1,134,133,145,145,80
"7136",35,"[27]lxoIboHcbosHnJHGqKChvDaEHvx",278,0.996416,27,279,1,278,1,1,0,1,1,139,138,140,140,80
"7137",36,"[27]lxoIboHcbosHnJHGqKChvDaEHvx",282,0.996466,27,283,1,282,1,1,0,1,1,139,138,144,144,80
"7138",37,"[27]lxoIboHcbosHnJHGqKChvDaEHvx",278,0.996416,27,279,1,278,1,1,0,1,1,142,141,137,137,80
"7139",38,"[27]lxoIboHcbosHnJHGqKChvDaEHvx",282,0.996466,27,283,1,282,1,1,0,1,1,141,140,142,142,80
"7140",39,"[27]lxoIboHcbosHnJHGqKChvDaEHvx",278,0.996416,27,279,1,278,1,1,0,1,1,142,141,137,137,80
"7141",40,"[27]lxoIboHcbosHnJHGqKChvDaEHvx",279,0.996429,27,280,1,279,1,1,0,1,1,143,142,137,137,80
"7142",41,"[27]lxoIboHcbosHnJHGqKChvDaEHvx",277,0.996403,27,278,1,277,1,1,0,1,1,140,139,138,138,80
"7143",42,"[27]lxoIboHcbosHnJHGqKChvDaEHvx",279,0.996429,27,280,1,279,1,1,0,1,1,128,127,152,152,80
"7144",43,"[27]lxoIboHcbosHnJHGqKChvDaEHvx",280,0.996441,27,281,1,280,1,1,0,1,1,149,148,132,132,80
"7145",44,"[27]lxoIboHcbosHnJHGqKChvDaEHvx",280,0.996441,27,281,1,280,1,1,0,1,1,141,140,140,140,80
"7146",45,"[27]lxoIboHcbosHnJHGqKChvDaEHvx",280,0.996441,27,281,1,280,1,1,0,1,1,136,135,145,145,80
"7147",46,"[27]lxoIboHcbosHnJHGqKChvDaEHvx",280,0.996441,27,281,1,280,1,1,0,1,1,160,159,121,121,80
"7148",47,"[27]lxoIboHcbosHnJHGqKChvDaEHvx",285,0.996503,27,286,1,285,1,1,0,1,1,128,127,158,158,80
"7149",48,"[27]lxoIboHcbosHnJHGqKChvDaEHvx",280,0.996441,27,281,1,280,1,1,0,1,1,141,140,140,140,80
"7150",49,"[27]lxoIboHcbosHnJHGqKChvDaEHvx",278,0.996416,27,279,1,278,1,1,0,1,1,128,127,151,151,80
"7151",50,"[27]lxoIboHcbosHnJHGqKChvDaEHvx",278,0.996416,27,279,1,278,1,1,0,1,1,144,143,135,135,80
"7152",51,"[27]lxoIboHcbosHnJHGqKChvDaEHvx",285,0.996503,27,286,1,285,1,1,0,1,1,154,153,132,132,80
"7153",52,"[27]lxoIboHcbosHnJHGqKChvDaEHvx",276,0.99639,27,277,1,276,1,1,0,1,1,127,126,150,150,80
"7154",53,"[27]lxoIboHcbosHnJHGqKChvDaEHvx",287,0.996528,27,288,1,287,1,1,0,1,1,155,154,133,133,80
"7155",54,"[27]lxoIboHcbosHnJHGqKChvDaEHvx",286,0.996516,27,287,1,286,1,1,0,1,1,137,136,150,150,80
"7156",55,"[27]lxoIboHcbosHnJHGqKChvDaEHvx",279,0.996429,27,280,1,279,1,1,0,1,1,136,135,144,144,80
"7157",56,"[27]lxoIboHcbosHnJHGqKChvDaEHvx",279,0.996429,27,280,1,279,1,1,0,1,1,146,145,134,134,80
"7158",57,"[27]lxoIboHcbosHnJHGqKChvDaEHvx",285,0.996503,27,286,1,285,1,1,0,1,1,136,135,150,150,80
"7159",58,"[27]lxoIboHcbosHnJHGqKChvDaEHvx",277,0.996403,27,278,1,277,1,1,0,1,1,143,142,135,135,80
"7160",59,"[27]lxoIboHcbosHnJHGqKChvDaEHvx",278,0.996416,27,279,1,278,1,1,0,1,1,119,118,160,160,80
"7161",60,"[27]lxoIboHcbosHnJHGqKChvDaEHvx",285,0.996503,27,286,1,285,1,1,0,1,1,147,146,139,139,80
"7162",61,"[27]lxoIboHcbosHnJHGqKChvDaEHvx",287,0.996528,27,288,1,287,1,1,0,1,1,147,146,141,141,80
"7163",62,"[27]lxoIboHcbosHnJHGqKChvDaEHvx",276,0.99639,27,277,1,276,1,1,0,1,1,139,138,138,138,80
"7164",63,"[27]lxoIboHcbosHnJHGqKChvDaEHvx",275,0.996377,27,276,1,275,1,1,0,1,1,138,137,138,138,80
"7165",64,"[27]lxoIboHcbosHnJHGqKChvDaEHvx",276,0.99639,27,277,1,276,1,1,0,1,1,133,132,144,144,80
"7166",65,"[27]lxoIboHcbosHnJHGqKChvDaEHvx",278,0.996416,27,279,1,278,1,1,0,1,1,138,137,141,141,80
"7167",66,"[27]lxoIboHcbosHnJHGqKChvDaEHvx",284,0.996491,27,285,1,284,1,1,0,1,1,135,134,150,150,80
"7168",67,"[27]lxoIboHcbosHnJHGqKChvDaEHvx",279,0.996429,27,280,1,279,1,1,0,1,1,149,148,131,131,80
"7169",68,"[27]lxoIboHcbosHnJHGqKChvDaEHvx",285,0.996503,27,286,1,285,1,1,0,1,1,151,150,135,135,80
"7170",69,"[27]lxoIboHcbosHnJHGqKChvDaEHvx",284,0.996491,27,285,1,284,1,1,0,1,1,146,145,139,139,80
"7171",70,"[27]lxoIboHcbosHnJHGqKChvDaEHvx",267,0.996269,27,268,1,267,1,1,0,1,1,125,124,143,143,80
"7172",71,"[27]lxoIboHcbosHnJHGqKChvDaEHvx",280,0.996441,27,281,1,280,1,1,0,1,1,155,154,126,126,80
"7173",72,"[27]lxoIboHcbosHnJHGqKChvDaEHvx",275,0.996377,27,276,1,275,1,1,0,1,1,145,144,131,131,80
"7174",73,"[27]lxoIboHcbosHnJHGqKChvDaEHvx",279,0.996429,27,280,1,279,1,1,0,1,1,123,122,157,157,80
"7175",74,"[27]lxoIboHcbosHnJHGqKChvDaEHvx",279,0.996429,27,280,1,279,1,1,0,1,1,134,133,146,146,80
"7176",75,"[27]lxoIboHcbosHnJHGqKChvDaEHvx",272,0.996337,27,273,1,272,1,1,0,1,1,126,125,147,147,80
"7177",76,"[27]lxoIboHcbosHnJHGqKChvDaEHvx",286,0.996516,27,287,1,286,1,1,0,1,1,159,158,128,128,80
"7178",77,"[27]lxoIboHcbosHnJHGqKChvDaEHvx",275,0.996377,27,276,1,275,1,1,0,1,1,127,126,149,149,80
"7179",78,"[27]lxoIboHcbosHnJHGqKChvDaEHvx",279,0.996429,27,280,1,279,1,1,0,1,1,135,134,145,145,80
"7180",79,"[27]lxoIboHcbosHnJHGqKChvDaEHvx",287,0.996528,27,288,1,287,1,1,0,1,1,150,149,138,138,80
"7181",80,"[27]lxoIboHcbosHnJHGqKChvDaEHvx",282,0.996466,27,283,1,282,1,1,0,1,1,152,151,131,131,80
"7182",81,"[27]lxoIboHcbosHnJHGqKChvDaEHvx",291,0.996575,27,292,1,291,1,1,0,1,1,144,143,148,148,80
"7183",82,"[27]lxoIboHcbosHnJHGqKChvDaEHvx",267,0.996269,27,268,1,267,1,1,0,1,1,129,128,139,139,80
"7184",83,"[27]lxoIboHcbosHnJHGqKChvDaEHvx",283,0.996479,27,284,1,283,1,1,0,1,1,160,159,124,124,80
"7185",84,"[27]lxoIboHcbosHnJHGqKChvDaEHvx",282,0.996466,27,283,1,282,1,1,0,1,1,149,148,134,134,80
"7186",85,"[27]lxoIboHcbosHnJHGqKChvDaEHvx",285,0.996503,27,286,1,285,1,1,0,1,1,136,135,150,150,80
"7187",86,"[27]lxoIboHcbosHnJHGqKChvDaEHvx",277,0.996403,27,278,1,277,1,1,0,1,1,125,124,153,153,80
"7188",87,"[27]lxoIboHcbosHnJHGqKChvDaEHvx",282,0.996466,27,283,1,282,1,1,0,1,1,141,140,142,142,80
"7189",88,"[27]lxoIboHcbosHnJHGqKChvDaEHvx",272,0.996337,27,273,1,272,1,1,0,1,1,133,132,140,140,80
"7190",89,"[27]lxoIboHcbosHnJHGqKChvDaEHvx",285,0.996503,27,286,1,285,1,1,0,1,1,151,150,135,135,80
"7191",90,"[27]lxoIboHcbosHnJHGqKChvDaEHvx",283,0.996479,27,284,1,283,1,1,0,1,1,154,153,130,130,80
"7192",91,"[27]lxoIboHcbosHnJHGqKChvDaEHvx",290,0.996564,27,291,1,290,1,1,0,1,1,158,157,133,133,80
"7193",92,"[27]lxoIboHcbosHnJHGqKChvDaEHvx",282,0.996466,27,283,1,282,1,1,0,1,1,143,142,140,140,80
"7194",93,"[27]lxoIboHcbosHnJHGqKChvDaEHvx",280,0.996441,27,281,1,280,1,1,0,1,1,122,121,159,159,80
"7195",94,"[27]lxoIboHcbosHnJHGqKChvDaEHvx",283,0.996479,27,284,1,283,1,1,0,1,1,145,144,139,139,80
"7196",95,"[27]lxoIboHcbosHnJHGqKChvDaEHvx",277,0.996403,27,278,1,277,1,1,0,1,1,132,131,146,146,80
"7197",96,"[27]lxoIboHcbosHnJHGqKChvDaEHvx",274,0.996364,27,275,1,274,1,1,0,1,1,132,131,143,143,80
"7198",97,"[27]lxoIboHcbosHnJHGqKChvDaEHvx",282,0.996466,27,283,1,282,1,1,0,1,1,136,135,147,147,80
"7199",98,"[27]lxoIboHcbosHnJHGqKChvDaEHvx",273,0.99635,27,274,1,273,1,1,0,1,1,139,138,135,135,80
"7200",99,"[27]lxoIboHcbosHnJHGqKChvDaEHvx",278,0.996416,27,279,1,278,1,1,0,1,1,146,145,133,133,80
"7201",0,"[23]JrHoIoHcosHnJHGqKCwFrIa",285,0.996503,23,286,1,285,1,1,0,1,1,153,152,133,133,81
"7202",1,"[23]JrHoIoHcosHnJHGqKCwFrIa",283,0.996479,23,284,1,283,1,1,0,1,1,137,136,147,147,81
"7203",2,"[23]JrHoIoHcosHnJHGqKCwFrIa",278,0.996416,23,279,1,278,1,1,0,1,1,145,144,134,134,81
"7204",3,"[23]JrHoIoHcosHnJHGqKCwFrIa",276,0.99639,23,277,1,276,1,1,0,1,1,135,134,142,142,81
"7205",4,"[23]JrHoIoHcosHnJHGqKCwFrIa",285,0.996503,23,286,1,285,1,1,0,1,1,139,138,147,147,81
"7206",5,"[23]JrHoIoHcosHnJHGqKCwFrIa",277,0.996403,23,278,1,277,1,1,0,1,1,133,132,145,145,81
"7207",6,"[23]JrHoIoHcosHnJHGqKCwFrIa",274,0.996364,23,275,1,274,1,1,0,1,1,128,127,147,147,81
"7208",7,"[23]JrHoIoHcosHnJHGqKCwFrIa",279,0.996429,23,280,1,279,1,1,0,1,1,156,155,124,124,81
"7209",8,"[23]JrHoIoHcosHnJHGqKCwFrIa",285,0.996503,23,286,1,285,1,1,0,1,1,137,136,149,149,81
"7210",9,"[23]JrHoIoHcosHnJHGqKCwFrIa",285,0.996503,23,286,1,285,1,1,0,1,1,140,139,146,146,81
"7211",10,"[23]JrHoIoHcosHnJHGqKCwFrIa",281,0.996454,23,282,1,281,1,1,0,1,1,141,140,141,141,81
"7212",11,"[23]JrHoIoHcosHnJHGqKCwFrIa",283,0.996479,23,284,1,283,1,1,0,1,1,131,130,153,153,81
"7213",12,"[23]JrHoIoHcosHnJHGqKCwFrIa",285,0.996503,23,286,1,285,1,1,0,1,1,151,150,135,135,81
"7214",13,"[23]JrHoIoHcosHnJHGqKCwFrIa",278,0.996416,23,279,1,278,1,1,0,1,1,145,144,134,134,81
"7215",14,"[23]JrHoIoHcosHnJHGqKCwFrIa",274,0.996364,23,275,1,274,1,1,0,1,1,115,114,160,160,81
"7216",15,"[23]JrHoIoHcosHnJHGqKCwFrIa",293,0.996599,23,294,1,293,1,1,0,1,1,138,137,156,156,81
"7217",16,"[23]JrHoIoHcosHnJHGqKCwFrIa",290,0.996564,23,291,1,290,1,1,0,1,1,146,145,145,145,81
"7218",17,"[23]JrHoIoHcosHnJHGqKCwFrIa",287,0.996528,23,288,1,287,1,1,0,1,1,148,147,140,140,81
"7219",18,"[23]JrHoIoHcosHnJHGqKCwFrIa",289,0.996552,23,290,1,289,1,1,0,1,1,157,156,133,133,81
"7220",19,"[23]JrHoIoHcosHnJHGqKCwFrIa",279,0.996429,23,280,1,279,1,1,0,1,1,138,137,142,142,81
"7221",20,"[23]JrHoIoHcosHnJHGqKCwFrIa",282,0.996466,23,283,1,282,1,1,0,1,1,131,130,152,152,81
"7222",21,"[23]JrHoIoHcosHnJHGqKCwFrIa",278,0.996416,23,279,1,278,1,1,0,1,1,134,133,145,145,81
"7223",22,"[23]JrHoIoHcosHnJHGqKCwFrIa",279,0.996429,23,280,1,279,1,1,0,1,1,136,135,144,144,81
"7224",23,"[23]JrHoIoHcosHnJHGqKCwFrIa",292,0.996587,23,293,1,292,1,1,0,1,1,160,159,133,133,81
"7225",24,"[23]JrHoIoHcosHnJHGqKCwFrIa",288,0.99654,23,289,1,288,1,1,0,1,1,150,149,139,139,81
"7226",25,"[23]JrHoIoHcosHnJHGqKCwFrIa",277,0.996403,23,278,1,277,1,1,0,1,1,146,145,132,132,81
"7227",26,"[23]JrHoIoHcosHnJHGqKCwFrIa",279,0.996429,23,280,1,279,1,1,0,1,1,134,133,146,146,81
"7228",27,"[23]JrHoIoHcosHnJHGqKCwFrIa",286,0.996516,23,287,1,286,1,1,0,1,1,163,162,124,124,81
"7229",28,"[23]JrHoIoHcosHnJHGqKCwFrIa",283,0.996479,23,284,1,283,1,1,0,1,1,140,139,144,144,81
"7230",29,"[23]JrHoIoHcosHnJHGqKCwFrIa",280,0.996441,23,281,1,280,1,1,0,1,1,146,145,135,135,81
"7231",30,"[23]JrHoIoHcosHnJHGqKCwFrIa",277,0.996403,23,278,1,277,1,1,0,1,1,135,134,143,143,81
"7232",31,"[23]JrHoIoHcosHnJHGqKCwFrIa",285,0.996503,23,286,1,285,1,1,0,1,1,149,148,137,137,81
"7233",32,"[23]JrHoIoHcosHnJHGqKCwFrIa",274,0.996364,23,275,1,274,1,1,0,1,1,136,135,139,139,81
"7234",33,"[23]JrHoIoHcosHnJHGqKCwFrIa",279,0.996429,23,280,1,279,1,1,0,1,1,136,135,144,144,81
"7235",34,"[23]JrHoIoHcosHnJHGqKCwFrIa",281,0.996454,23,282,1,281,1,1,0,1,1,134,133,148,148,81
"7236",35,"[23]JrHoIoHcosHnJHGqKCwFrIa",288,0.99654,23,289,1,288,1,1,0,1,1,159,158,130,130,81
"7237",36,"[23]JrHoIoHcosHnJHGqKCwFrIa",285,0.996503,23,286,1,285,1,1,0,1,1,143,142,143,143,81
"7238",37,"[23]JrHoIoHcosHnJHGqKCwFrIa",290,0.996564,23,291,1,290,1,1,0,1,1,148,147,143,143,81
"7239",38,"[23]JrHoIoHcosHnJHGqKCwFrIa",289,0.996552,23,290,1,289,1,1,0,1,1,146,145,144,144,81
"7240",39,"[23]JrHoIoHcosHnJHGqKCwFrIa",280,0.996441,23,281,1,280,1,1,0,1,1,145,144,136,136,81
"7241",40,"[23]JrHoIoHcosHnJHGqKCwFrIa",285,0.996503,23,286,1,285,1,1,0,1,1,164,163,122,122,81
"7242",41,"[23]JrHoIoHcosHnJHGqKCwFrIa",282,0.996466,23,283,1,282,1,1,0,1,1,144,143,139,139,81
"7243",42,"[23]JrHoIoHcosHnJHGqKCwFrIa",287,0.996528,23,288,1,287,1,1,0,1,1,143,142,145,145,81
"7244",43,"[23]JrHoIoHcosHnJHGqKCwFrIa",281,0.996454,23,282,1,281,1,1,0,1,1,133,132,149,149,81
"7245",44,"[23]JrHoIoHcosHnJHGqKCwFrIa",281,0.996454,23,282,1,281,1,1,0,1,1,133,132,149,149,81
"7246",45,"[23]JrHoIoHcosHnJHGqKCwFrIa",287,0.996528,23,288,1,287,1,1,0,1,1,151,150,137,137,81
"7247",46,"[23]JrHoIoHcosHnJHGqKCwFrIa",279,0.996429,23,280,1,279,1,1,0,1,1,155,154,125,125,81
"7248",47,"[23]JrHoIoHcosHnJHGqKCwFrIa",281,0.996454,23,282,1,281,1,1,0,1,1,131,130,151,151,81
"7249",48,"[23]JrHoIoHcosHnJHGqKCwFrIa",276,0.99639,23,277,1,276,1,1,0,1,1,141,140,136,136,81
"7250",49,"[23]JrHoIoHcosHnJHGqKCwFrIa",293,0.996599,23,294,1,293,1,1,0,1,1,154,153,140,140,81
"7251",50,"[23]JrHoIoHcosHnJHGqKCwFrIa",287,0.996528,23,288,1,287,1,1,0,1,1,157,156,131,131,81
"7252",51,"[23]JrHoIoHcosHnJHGqKCwFrIa",281,0.996454,23,282,1,281,1,1,0,1,1,137,136,145,145,81
"7253",52,"[23]JrHoIoHcosHnJHGqKCwFrIa",282,0.996466,23,283,1,282,1,1,0,1,1,149,148,134,134,81
"7254",53,"[23]JrHoIoHcosHnJHGqKCwFrIa",278,0.996416,23,279,1,278,1,1,0,1,1,144,143,135,135,81
"7255",54,"[23]JrHoIoHcosHnJHGqKCwFrIa",291,0.996575,23,292,1,291,1,1,0,1,1,139,138,153,153,81
"7256",55,"[23]JrHoIoHcosHnJHGqKCwFrIa",279,0.996429,23,280,1,279,1,1,0,1,1,140,139,140,140,81
"7257",56,"[23]JrHoIoHcosHnJHGqKCwFrIa",286,0.996516,23,287,1,286,1,1,0,1,1,146,145,141,141,81
"7258",57,"[23]JrHoIoHcosHnJHGqKCwFrIa",281,0.996454,23,282,1,281,1,1,0,1,1,130,129,152,152,81
"7259",58,"[23]JrHoIoHcosHnJHGqKCwFrIa",279,0.996429,23,280,1,279,1,1,0,1,1,129,128,151,151,81
"7260",59,"[23]JrHoIoHcosHnJHGqKCwFrIa",281,0.996454,23,282,1,281,1,1,0,1,1,147,146,135,135,81
"7261",60,"[23]JrHoIoHcosHnJHGqKCwFrIa",273,0.99635,23,274,1,273,1,1,0,1,1,142,141,132,132,81
"7262",61,"[23]JrHoIoHcosHnJHGqKCwFrIa",285,0.996503,23,286,1,285,1,1,0,1,1,164,163,122,122,81
"7263",62,"[23]JrHoIoHcosHnJHGqKCwFrIa",290,0.996564,23,291,1,290,1,1,0,1,1,159,158,132,132,81
"7264",63,"[23]JrHoIoHcosHnJHGqKCwFrIa",284,0.996491,23,285,1,284,1,1,0,1,1,140,139,145,145,81
"7265",64,"[23]JrHoIoHcosHnJHGqKCwFrIa",266,0.996255,23,267,1,266,1,1,0,1,1,110,109,157,157,81
"7266",65,"[23]JrHoIoHcosHnJHGqKCwFrIa",275,0.996377,23,276,1,275,1,1,0,1,1,145,144,131,131,81
"7267",66,"[23]JrHoIoHcosHnJHGqKCwFrIa",282,0.996466,23,283,1,282,1,1,0,1,1,138,137,145,145,81
"7268",67,"[23]JrHoIoHcosHnJHGqKCwFrIa",279,0.996429,23,280,1,279,1,1,0,1,1,142,141,138,138,81
"7269",68,"[23]JrHoIoHcosHnJHGqKCwFrIa",287,0.996528,23,288,1,287,1,1,0,1,1,159,158,129,129,81
"7270",69,"[23]JrHoIoHcosHnJHGqKCwFrIa",285,0.996503,23,286,1,285,1,1,0,1,1,129,128,157,157,81
"7271",70,"[23]JrHoIoHcosHnJHGqKCwFrIa",275,0.996377,23,276,1,275,1,1,0,1,1,129,128,147,147,81
"7272",71,"[23]JrHoIoHcosHnJHGqKCwFrIa",277,0.996403,23,278,1,277,1,1,0,1,1,134,133,144,144,81
"7273",72,"[23]JrHoIoHcosHnJHGqKCwFrIa",288,0.99654,23,289,1,288,1,1,0,1,1,147,146,142,142,81
"7274",73,"[23]JrHoIoHcosHnJHGqKCwFrIa",289,0.996552,23,290,1,289,1,1,0,1,1,145,144,145,145,81
"7275",74,"[23]JrHoIoHcosHnJHGqKCwFrIa",284,0.996491,23,285,1,284,1,1,0,1,1,133,132,152,152,81
"7276",75,"[23]JrHoIoHcosHnJHGqKCwFrIa",292,0.996587,23,293,1,292,1,1,0,1,1,139,138,154,154,81
"7277",76,"[23]JrHoIoHcosHnJHGqKCwFrIa",284,0.996491,23,285,1,284,1,1,0,1,1,137,136,148,148,81
"7278",77,"[23]JrHoIoHcosHnJHGqKCwFrIa",284,0.996491,23,285,1,284,1,1,0,1,1,144,143,141,141,81
"7279",78,"[23]JrHoIoHcosHnJHGqKCwFrIa",279,0.996429,23,280,1,279,1,1,0,1,1,130,129,150,150,81
"7280",79,"[23]JrHoIoHcosHnJHGqKCwFrIa",277,0.996403,23,278,1,277,1,1,0,1,1,128,127,150,150,81
"7281",80,"[23]JrHoIoHcosHnJHGqKCwFrIa",288,0.99654,23,289,1,288,1,1,0,1,1,146,145,143,143,81
"7282",81,"[23]JrHoIoHcosHnJHGqKCwFrIa",277,0.996403,23,278,1,277,1,1,0,1,1,124,123,154,154,81
"7283",82,"[23]JrHoIoHcosHnJHGqKCwFrIa",283,0.996479,23,284,1,283,1,1,0,1,1,138,137,146,146,81
"7284",83,"[23]JrHoIoHcosHnJHGqKCwFrIa",288,0.99654,23,289,1,288,1,1,0,1,1,141,140,148,148,81
"7285",84,"[23]JrHoIoHcosHnJHGqKCwFrIa",284,0.996491,23,285,1,284,1,1,0,1,1,152,151,133,133,81
"7286",85,"[23]JrHoIoHcosHnJHGqKCwFrIa",281,0.996454,23,282,1,281,1,1,0,1,1,131,130,151,151,81
"7287",86,"[23]JrHoIoHcosHnJHGqKCwFrIa",278,0.996416,23,279,1,278,1,1,0,1,1,131,130,148,148,81
"7288",87,"[23]JrHoIoHcosHnJHGqKCwFrIa",286,0.996516,23,287,1,286,1,1,0,1,1,137,136,150,150,81
"7289",88,"[23]JrHoIoHcosHnJHGqKCwFrIa",280,0.996441,23,281,1,280,1,1,0,1,1,140,139,141,141,81
"7290",89,"[23]JrHoIoHcosHnJHGqKCwFrIa",282,0.996466,23,283,1,282,1,1,0,1,1,133,132,150,150,81
"7291",90,"[23]JrHoIoHcosHnJHGqKCwFrIa",287,0.996528,23,288,1,287,1,1,0,1,1,149,148,139,139,81
"7292",91,"[23]JrHoIoHcosHnJHGqKCwFrIa",282,0.996466,23,283,1,282,1,1,0,1,1,145,144,138,138,81
"7293",92,"[23]JrHoIoHcosHnJHGqKCwFrIa",280,0.996441,23,281,1,280,1,1,0,1,1,138,137,143,143,81
"7294",93,"[23]JrHoIoHcosHnJHGqKCwFrIa",284,0.996491,23,285,1,284,1,1,0,1,1,147,146,138,138,81
"7295",94,"[23]JrHoIoHcosHnJHGqKCwFrIa",289,0.996552,23,290,1,289,1,1,0,1,1,151,150,139,139,81
"7296",95,"[23]JrHoIoHcosHnJHGqKCwFrIa",280,0.996441,23,281,1,280,1,1,0,1,1,149,148,132,132,81
"7297",96,"[23]JrHoIoHcosHnJHGqKCwFrIa",284,0.996491,23,285,1,284,1,1,0,1,1,141,140,144,144,81
"7298",97,"[23]JrHoIoHcosHnJHGqKCwFrIa",282,0.996466,23,283,1,282,1,1,0,1,1,128,127,155,155,81
"7299",98,"[23]JrHoIoHcosHnJHGqKCwFrIa",284,0.996491,23,285,1,284,1,1,0,1,1,138,137,147,147,81
"7300",99,"[23]JrHoIoHcosHnJHGqKCwFrIa",281,0.996454,23,282,1,281,1,1,0,1,1,148,147,134,134,81
"7301",0,"[22]lloIbgoHcosHnJHqKGCmnI",303,0.996711,22,304,1,303,1,1,0,1,1,163,162,141,141,82
"7302",1,"[22]lloIbgoHcosHnJHqKGCmnI",295,0.996622,22,296,1,295,1,1,0,1,1,157,156,139,139,82
"7303",2,"[22]lloIbgoHcosHnJHqKGCmnI",306,0.996743,22,307,1,306,1,1,0,1,1,146,145,161,161,82
"7304",3,"[22]lloIbgoHcosHnJHqKGCmnI",289,0.996552,22,290,1,289,1,1,0,1,1,136,135,154,154,82
"7305",4,"[22]lloIbgoHcosHnJHqKGCmnI",292,0.996587,22,293,1,292,1,1,0,1,1,145,144,148,148,82
"7306",5,"[22]lloIbgoHcosHnJHqKGCmnI",305,0.996732,22,306,1,305,1,1,0,1,1,159,158,147,147,82
"7307",6,"[22]lloIbgoHcosHnJHqKGCmnI",289,0.996552,22,290,1,289,1,1,0,1,1,152,151,138,138,82
"7308",7,"[22]lloIbgoHcosHnJHqKGCmnI",298,0.996656,22,299,1,298,1,1,0,1,1,149,148,150,150,82
"7309",8,"[22]lloIbgoHcosHnJHqKGCmnI",302,0.9967,22,303,1,302,1,1,0,1,1,149,148,154,154,82
"7310",9,"[22]lloIbgoHcosHnJHqKGCmnI",284,0.996491,22,285,1,284,1,1,0,1,1,137,136,148,148,82
"7311",10,"[22]lloIbgoHcosHnJHqKGCmnI",295,0.996622,22,296,1,295,1,1,0,1,1,156,155,140,140,82
"7312",11,"[22]lloIbgoHcosHnJHqKGCmnI",301,0.996689,22,302,1,301,1,1,0,1,1,160,159,142,142,82
"7313",12,"[22]lloIbgoHcosHnJHqKGCmnI",295,0.996622,22,296,1,295,1,1,0,1,1,147,146,149,149,82
"7314",13,"[22]lloIbgoHcosHnJHqKGCmnI",292,0.996587,22,293,1,292,1,1,0,1,1,139,138,154,154,82
"7315",14,"[22]lloIbgoHcosHnJHqKGCmnI",302,0.9967,22,303,1,302,1,1,0,1,1,151,150,152,152,82
"7316",15,"[22]lloIbgoHcosHnJHqKGCmnI",300,0.996678,22,301,1,300,1,1,0,1,1,165,164,136,136,82
"7317",16,"[22]lloIbgoHcosHnJHqKGCmnI",302,0.9967,22,303,1,302,1,1,0,1,1,153,152,150,150,82
"7318",17,"[22]lloIbgoHcosHnJHqKGCmnI",300,0.996678,22,301,1,300,1,1,0,1,1,161,160,140,140,82
"7319",18,"[22]lloIbgoHcosHnJHqKGCmnI",296,0.996633,22,297,1,296,1,1,0,1,1,145,144,152,152,82
"7320",19,"[22]lloIbgoHcosHnJHqKGCmnI",293,0.996599,22,294,1,293,1,1,0,1,1,143,142,151,151,82
"7321",20,"[22]lloIbgoHcosHnJHqKGCmnI",305,0.996732,22,306,1,305,1,1,0,1,1,171,170,135,135,82
"7322",21,"[22]lloIbgoHcosHnJHqKGCmnI",295,0.996622,22,296,1,295,1,1,0,1,1,142,141,154,154,82
"7323",22,"[22]lloIbgoHcosHnJHqKGCmnI",297,0.996644,22,298,1,297,1,1,0,1,1,148,147,150,150,82
"7324",23,"[22]lloIbgoHcosHnJHqKGCmnI",299,0.996667,22,300,1,299,1,1,0,1,1,158,157,142,142,82
"7325",24,"[22]lloIbgoHcosHnJHqKGCmnI",290,0.996564,22,291,1,290,1,1,0,1,1,143,142,148,148,82
"7326",25,"[22]lloIbgoHcosHnJHqKGCmnI",295,0.996622,22,296,1,295,1,1,0,1,1,145,144,151,151,82
"7327",26,"[22]lloIbgoHcosHnJHqKGCmnI",298,0.996656,22,299,1,298,1,1,0,1,1,158,157,141,141,82
"7328",27,"[22]lloIbgoHcosHnJHqKGCmnI",294,0.99661,22,295,1,294,1,1,0,1,1,140,139,155,155,82
"7329",28,"[22]lloIbgoHcosHnJHqKGCmnI",287,0.996528,22,288,1,287,1,1,0,1,1,142,141,146,146,82
"7330",29,"[22]lloIbgoHcosHnJHqKGCmnI",300,0.996678,22,301,1,300,1,1,0,1,1,158,157,143,143,82
"7331",30,"[22]lloIbgoHcosHnJHqKGCmnI",291,0.996575,22,292,1,291,1,1,0,1,1,140,139,152,152,82
"7332",31,"[22]lloIbgoHcosHnJHqKGCmnI",288,0.99654,22,289,1,288,1,1,0,1,1,143,142,146,146,82
"7333",32,"[22]lloIbgoHcosHnJHqKGCmnI",298,0.996656,22,299,1,298,1,1,0,1,1,160,159,139,139,82
"7334",33,"[22]lloIbgoHcosHnJHqKGCmnI",297,0.996644,22,298,1,297,1,1,0,1,1,143,142,155,155,82
"7335",34,"[22]lloIbgoHcosHnJHqKGCmnI",305,0.996732,22,306,1,305,1,1,0,1,1,169,168,137,137,82
"7336",35,"[22]lloIbgoHcosHnJHqKGCmnI",303,0.996711,22,304,1,303,1,1,0,1,1,151,150,153,153,82
"7337",36,"[22]lloIbgoHcosHnJHqKGCmnI",289,0.996552,22,290,1,289,1,1,0,1,1,131,130,159,159,82
"7338",37,"[22]lloIbgoHcosHnJHqKGCmnI",294,0.99661,22,295,1,294,1,1,0,1,1,140,139,155,155,82
"7339",38,"[22]lloIbgoHcosHnJHqKGCmnI",296,0.996633,22,297,1,296,1,1,0,1,1,152,151,145,145,82
"7340",39,"[22]lloIbgoHcosHnJHqKGCmnI",309,0.996774,22,310,1,309,1,1,0,1,1,167,166,143,143,82
"7341",40,"[22]lloIbgoHcosHnJHqKGCmnI",297,0.996644,22,298,1,297,1,1,0,1,1,148,147,150,150,82
"7342",41,"[22]lloIbgoHcosHnJHqKGCmnI",295,0.996622,22,296,1,295,1,1,0,1,1,149,148,147,147,82
"7343",42,"[22]lloIbgoHcosHnJHqKGCmnI",287,0.996528,22,288,1,287,1,1,0,1,1,137,136,151,151,82
"7344",43,"[22]lloIbgoHcosHnJHqKGCmnI",291,0.996575,22,292,1,291,1,1,0,1,1,139,138,153,153,82
"7345",44,"[22]lloIbgoHcosHnJHqKGCmnI",299,0.996667,22,300,1,299,1,1,0,1,1,150,149,150,150,82
"7346",45,"[22]lloIbgoHcosHnJHqKGCmnI",297,0.996644,22,298,1,297,1,1,0,1,1,150,149,148,148,82
"7347",46,"[22]lloIbgoHcosHnJHqKGCmnI",299,0.996667,22,300,1,299,1,1,0,1,1,148,147,152,152,82
"7348",47,"[22]lloIbgoHcosHnJHqKGCmnI",295,0.996622,22,296,1,295,1,1,0,1,1,144,143,152,152,82
"7349",48,"[22]lloIbgoHcosHnJHqKGCmnI",291,0.996575,22,292,1,291,1,1,0,1,1,129,128,163,163,82
"7350",49,"[22]lloIbgoHcosHnJHqKGCmnI",306,0.996743,22,307,1,306,1,1,0,1,1,169,168,138,138,82
"7351",50,"[22]lloIbgoHcosHnJHqKGCmnI",296,0.996633,22,297,1,296,1,1,0,1,1,157,156,140,140,82
"7352",51,"[22]lloIbgoHcosHnJHqKGCmnI",287,0.996528,22,288,1,287,1,1,0,1,1,136,135,152,152,82
"7353",52,"[22]lloIbgoHcosHnJHqKGCmnI",292,0.996587,22,293,1,292,1,1,0,1,1,141,140,152,152,82
"7354",53,"[22]lloIbgoHcosHnJHqKGCmnI",293,0.996599,22,294,1,293,1,1,0,1,1,147,146,147,147,82
"7355",54,"[22]lloIbgoHcosHnJHqKGCmnI",296,0.996633,22,297,1,296,1,1,0,1,1,149,148,148,148,82
"7356",55,"[22]lloIbgoHcosHnJHqKGCmnI",296,0.996633,22,297,1,296,1,1,0,1,1,138,137,159,159,82
"7357",56,"[22]lloIbgoHcosHnJHqKGCmnI",299,0.996667,22,300,1,299,1,1,0,1,1,142,141,158,158,82
"7358",57,"[22]lloIbgoHcosHnJHqKGCmnI",298,0.996656,22,299,1,298,1,1,0,1,1,149,148,150,150,82
"7359",58,"[22]lloIbgoHcosHnJHqKGCmnI",291,0.996575,22,292,1,291,1,1,0,1,1,151,150,141,141,82
"7360",59,"[22]lloIbgoHcosHnJHqKGCmnI",295,0.996622,22,296,1,295,1,1,0,1,1,140,139,156,156,82
"7361",60,"[22]lloIbgoHcosHnJHqKGCmnI",295,0.996622,22,296,1,295,1,1,0,1,1,160,159,136,136,82
"7362",61,"[22]lloIbgoHcosHnJHqKGCmnI",289,0.996552,22,290,1,289,1,1,0,1,1,147,146,143,143,82
"7363",62,"[22]lloIbgoHcosHnJHqKGCmnI",293,0.996599,22,294,1,293,1,1,0,1,1,137,136,157,157,82
"7364",63,"[22]lloIbgoHcosHnJHqKGCmnI",285,0.996503,22,286,1,285,1,1,0,1,1,139,138,147,147,82
"7365",64,"[22]lloIbgoHcosHnJHqKGCmnI",305,0.996732,22,306,1,305,1,1,0,1,1,164,163,142,142,82
"7366",65,"[22]lloIbgoHcosHnJHqKGCmnI",294,0.99661,22,295,1,294,1,1,0,1,1,154,153,141,141,82
"7367",66,"[22]lloIbgoHcosHnJHqKGCmnI",294,0.99661,22,295,1,294,1,1,0,1,1,156,155,139,139,82
"7368",67,"[22]lloIbgoHcosHnJHqKGCmnI",300,0.996678,22,301,1,300,1,1,0,1,1,169,168,132,132,82
"7369",68,"[22]lloIbgoHcosHnJHqKGCmnI",291,0.996575,22,292,1,291,1,1,0,1,1,141,140,151,151,82
"7370",69,"[22]lloIbgoHcosHnJHqKGCmnI",293,0.996599,22,294,1,293,1,1,0,1,1,148,147,146,146,82
"7371",70,"[22]lloIbgoHcosHnJHqKGCmnI",283,0.996479,22,284,1,283,1,1,0,1,1,142,141,142,142,82
"7372",71,"[22]lloIbgoHcosHnJHqKGCmnI",295,0.996622,22,296,1,295,1,1,0,1,1,146,145,150,150,82
"7373",72,"[22]lloIbgoHcosHnJHqKGCmnI",294,0.99661,22,295,1,294,1,1,0,1,1,144,143,151,151,82
"7374",73,"[22]lloIbgoHcosHnJHqKGCmnI",301,0.996689,22,302,1,301,1,1,0,1,1,155,154,147,147,82
"7375",74,"[22]lloIbgoHcosHnJHqKGCmnI",295,0.996622,22,296,1,295,1,1,0,1,1,149,148,147,147,82
"7376",75,"[22]lloIbgoHcosHnJHqKGCmnI",297,0.996644,22,298,1,297,1,1,0,1,1,154,153,144,144,82
"7377",76,"[22]lloIbgoHcosHnJHqKGCmnI",300,0.996678,22,301,1,300,1,1,0,1,1,163,162,138,138,82
"7378",77,"[22]lloIbgoHcosHnJHqKGCmnI",299,0.996667,22,300,1,299,1,1,0,1,1,148,147,152,152,82
"7379",78,"[22]lloIbgoHcosHnJHqKGCmnI",307,0.996753,22,308,1,307,1,1,0,1,1,176,175,132,132,82
"7380",79,"[22]lloIbgoHcosHnJHqKGCmnI",276,0.99639,22,277,1,276,1,1,0,1,1,122,121,155,155,82
"7381",80,"[22]lloIbgoHcosHnJHqKGCmnI",289,0.996552,22,290,1,289,1,1,0,1,1,139,138,151,151,82
"7382",81,"[22]lloIbgoHcosHnJHqKGCmnI",291,0.996575,22,292,1,291,1,1,0,1,1,128,127,164,164,82
"7383",82,"[22]lloIbgoHcosHnJHqKGCmnI",291,0.996575,22,292,1,291,1,1,0,1,1,139,138,153,153,82
"7384",83,"[22]lloIbgoHcosHnJHqKGCmnI",289,0.996552,22,290,1,289,1,1,0,1,1,156,155,134,134,82
"7385",84,"[22]lloIbgoHcosHnJHqKGCmnI",296,0.996633,22,297,1,296,1,1,0,1,1,142,141,155,155,82
"7386",85,"[22]lloIbgoHcosHnJHqKGCmnI",288,0.99654,22,289,1,288,1,1,0,1,1,143,142,146,146,82
"7387",86,"[22]lloIbgoHcosHnJHqKGCmnI",288,0.99654,22,289,1,288,1,1,0,1,1,134,133,155,155,82
"7388",87,"[22]lloIbgoHcosHnJHqKGCmnI",290,0.996564,22,291,1,290,1,1,0,1,1,141,140,150,150,82
"7389",88,"[22]lloIbgoHcosHnJHqKGCmnI",298,0.996656,22,299,1,298,1,1,0,1,1,154,153,145,145,82
"7390",89,"[22]lloIbgoHcosHnJHqKGCmnI",291,0.996575,22,292,1,291,1,1,0,1,1,142,141,150,150,82
"7391",90,"[22]lloIbgoHcosHnJHqKGCmnI",291,0.996575,22,292,1,291,1,1,0,1,1,153,152,139,139,82
"7392",91,"[22]lloIbgoHcosHnJHqKGCmnI",297,0.996644,22,298,1,297,1,1,0,1,1,141,140,157,157,82
"7393",92,"[22]lloIbgoHcosHnJHqKGCmnI",291,0.996575,22,292,1,291,1,1,0,1,1,153,152,139,139,82
"7394",93,"[22]lloIbgoHcosHnJHqKGCmnI",294,0.99661,22,295,1,294,1,1,0,1,1,141,140,154,154,82
"7395",94,"[22]lloIbgoHcosHnJHqKGCmnI",293,0.996599,22,294,1,293,1,1,0,1,1,136,135,158,158,82
"7396",95,"[22]lloIbgoHcosHnJHqKGCmnI",295,0.996622,22,296,1,295,1,1,0,1,1,145,144,151,151,82
"7397",96,"[22]lloIbgoHcosHnJHqKGCmnI",289,0.996552,22,290,1,289,1,1,0,1,1,137,136,153,153,82
"7398",97,"[22]lloIbgoHcosHnJHqKGCmnI",302,0.9967,22,303,1,302,1,1,0,1,1,171,170,132,132,82
"7399",98,"[22]lloIbgoHcosHnJHqKGCmnI",280,0.996441,22,281,1,280,1,1,0,1,1,132,131,149,149,82
"7400",99,"[22]lloIbgoHcosHnJHqKGCmnI",288,0.99654,22,289,1,288,1,1,0,1,1,139,138,150,150,82
"7401",0,"[23]eHoIoHcouHnJqGKCasdwAkp",299,0.996667,23,300,1,299,1,1,0,1,1,156,155,144,144,83
"7402",1,"[23]eHoIoHcouHnJqGKCasdwAkp",301,0.996689,23,302,1,301,1,1,0,1,1,164,163,138,138,83
"7403",2,"[23]eHoIoHcouHnJqGKCasdwAkp",299,0.996667,23,300,1,299,1,1,0,1,1,158,157,142,142,83
"7404",3,"[23]eHoIoHcouHnJqGKCasdwAkp",307,0.996753,23,308,1,307,1,1,0,1,1,173,172,135,135,83
"7405",4,"[23]eHoIoHcouHnJqGKCasdwAkp",296,0.996633,23,297,1,296,1,1,0,1,1,150,149,147,147,83
"7406",5,"[23]eHoIoHcouHnJqGKCasdwAkp",291,0.996575,23,292,1,291,1,1,0,1,1,134,133,158,158,83
"7407",6,"[23]eHoIoHcouHnJqGKCasdwAkp",296,0.996633,23,297,1,296,1,1,0,1,1,147,146,150,150,83
"7408",7,"[23]eHoIoHcouHnJqGKCasdwAkp",298,0.996656,23,299,1,298,1,1,0,1,1,146,145,153,153,83
"7409",8,"[23]eHoIoHcouHnJqGKCasdwAkp",294,0.99661,23,295,1,294,1,1,0,1,1,145,144,150,150,83
"7410",9,"[23]eHoIoHcouHnJqGKCasdwAkp",291,0.996575,23,292,1,291,1,1,0,1,1,142,141,150,150,83
"7411",10,"[23]eHoIoHcouHnJqGKCasdwAkp",297,0.996644,23,298,1,297,1,1,0,1,1,148,147,150,150,83
"7412",11,"[23]eHoIoHcouHnJqGKCasdwAkp",298,0.996656,23,299,1,298,1,1,0,1,1,155,154,144,144,83
"7413",12,"[23]eHoIoHcouHnJqGKCasdwAkp",294,0.99661,23,295,1,294,1,1,0,1,1,143,142,152,152,83
"7414",13,"[23]eHoIoHcouHnJqGKCasdwAkp",295,0.996622,23,296,1,295,1,1,0,1,1,154,153,142,142,83
"7415",14,"[23]eHoIoHcouHnJqGKCasdwAkp",295,0.996622,23,296,1,295,1,1,0,1,1,141,140,155,155,83
"7416",15,"[23]eHoIoHcouHnJqGKCasdwAkp",295,0.996622,23,296,1,295,1,1,0,1,1,150,149,146,146,83
"7417",16,"[23]eHoIoHcouHnJqGKCasdwAkp",293,0.996599,23,294,1,293,1,1,0,1,1,138,137,156,156,83
"7418",17,"[23]eHoIoHcouHnJqGKCasdwAkp",297,0.996644,23,298,1,297,1,1,0,1,1,152,151,146,146,83
"7419",18,"[23]eHoIoHcouHnJqGKCasdwAkp",303,0.996711,23,304,1,303,1,1,0,1,1,169,168,135,135,83
"7420",19,"[23]eHoIoHcouHnJqGKCasdwAkp",297,0.996644,23,298,1,297,1,1,0,1,1,152,151,146,146,83
"7421",20,"[23]eHoIoHcouHnJqGKCasdwAkp",292,0.996587,23,293,1,292,1,1,0,1,1,143,142,150,150,83
"7422",21,"[23]eHoIoHcouHnJqGKCasdwAkp",293,0.996599,23,294,1,293,1,1,0,1,1,140,139,154,154,83
"7423",22,"[23]eHoIoHcouHnJqGKCasdwAkp",296,0.996633,23,297,1,296,1,1,0,1,1,150,149,147,147,83
"7424",23,"[23]eHoIoHcouHnJqGKCasdwAkp",294,0.99661,23,295,1,294,1,1,0,1,1,141,140,154,154,83
"7425",24,"[23]eHoIoHcouHnJqGKCasdwAkp",297,0.996644,23,298,1,297,1,1,0,1,1,151,150,147,147,83
"7426",25,"[23]eHoIoHcouHnJqGKCasdwAkp",291,0.996575,23,292,1,291,1,1,0,1,1,140,139,152,152,83
"7427",26,"[23]eHoIoHcouHnJqGKCasdwAkp",294,0.99661,23,295,1,294,1,1,0,1,1,149,148,146,146,83
"7428",27,"[23]eHoIoHcouHnJqGKCasdwAkp",299,0.996667,23,300,1,299,1,1,0,1,1,148,147,152,152,83
"7429",28,"[23]eHoIoHcouHnJqGKCasdwAkp",297,0.996644,23,298,1,297,1,1,0,1,1,152,151,146,146,83
"7430",29,"[23]eHoIoHcouHnJqGKCasdwAkp",304,0.996721,23,305,1,304,1,1,0,1,1,173,172,132,132,83
"7431",30,"[23]eHoIoHcouHnJqGKCasdwAkp",297,0.996644,23,298,1,297,1,1,0,1,1,147,146,151,151,83
"7432",31,"[23]eHoIoHcouHnJqGKCasdwAkp",290,0.996564,23,291,1,290,1,1,0,1,1,130,129,161,161,83
"7433",32,"[23]eHoIoHcouHnJqGKCasdwAkp",305,0.996732,23,306,1,305,1,1,0,1,1,166,165,140,140,83
"7434",33,"[23]eHoIoHcouHnJqGKCasdwAkp",300,0.996678,23,301,1,300,1,1,0,1,1,159,158,142,142,83
"7435",34,"[23]eHoIoHcouHnJqGKCasdwAkp",299,0.996667,23,300,1,299,1,1,0,1,1,159,158,141,141,83
"7436",35,"[23]eHoIoHcouHnJqGKCasdwAkp",293,0.996599,23,294,1,293,1,1,0,1,1,137,136,157,157,83
"7437",36,"[23]eHoIoHcouHnJqGKCasdwAkp",304,0.996721,23,305,1,304,1,1,0,1,1,171,170,134,134,83
"7438",37,"[23]eHoIoHcouHnJqGKCasdwAkp",300,0.996678,23,301,1,300,1,1,0,1,1,161,160,140,140,83
"7439",38,"[23]eHoIoHcouHnJqGKCasdwAkp",299,0.996667,23,300,1,299,1,1,0,1,1,155,154,145,145,83
"7440",39,"[23]eHoIoHcouHnJqGKCasdwAkp",294,0.99661,23,295,1,294,1,1,0,1,1,146,145,149,149,83
"7441",40,"[23]eHoIoHcouHnJqGKCasdwAkp",293,0.996599,23,294,1,293,1,1,0,1,1,145,144,149,149,83
"7442",41,"[23]eHoIoHcouHnJqGKCasdwAkp",294,0.99661,23,295,1,294,1,1,0,1,1,141,140,154,154,83
"7443",42,"[23]eHoIoHcouHnJqGKCasdwAkp",297,0.996644,23,298,1,297,1,1,0,1,1,151,150,147,147,83
"7444",43,"[23]eHoIoHcouHnJqGKCasdwAkp",294,0.99661,23,295,1,294,1,1,0,1,1,142,141,153,153,83
"7445",44,"[23]eHoIoHcouHnJqGKCasdwAkp",294,0.99661,23,295,1,294,1,1,0,1,1,146,145,149,149,83
"7446",45,"[23]eHoIoHcouHnJqGKCasdwAkp",294,0.99661,23,295,1,294,1,1,0,1,1,142,141,153,153,83
"7447",46,"[23]eHoIoHcouHnJqGKCasdwAkp",293,0.996599,23,294,1,293,1,1,0,1,1,140,139,154,154,83
"7448",47,"[23]eHoIoHcouHnJqGKCasdwAkp",299,0.996667,23,300,1,299,1,1,0,1,1,156,155,144,144,83
"7449",48,"[23]eHoIoHcouHnJqGKCasdwAkp",297,0.996644,23,298,1,297,1,1,0,1,1,151,150,147,147,83
"7450",49,"[23]eHoIoHcouHnJqGKCasdwAkp",303,0.996711,23,304,1,303,1,1,0,1,1,168,167,136,136,83
"7451",50,"[23]eHoIoHcouHnJqGKCasdwAkp",299,0.996667,23,300,1,299,1,1,0,1,1,154,153,146,146,83
"7452",51,"[23]eHoIoHcouHnJqGKCasdwAkp",293,0.996599,23,294,1,293,1,1,0,1,1,143,142,151,151,83
"7453",52,"[23]eHoIoHcouHnJqGKCasdwAkp",300,0.996678,23,301,1,300,1,1,0,1,1,160,159,141,141,83
"7454",53,"[23]eHoIoHcouHnJqGKCasdwAkp",305,0.996732,23,306,1,305,1,1,0,1,1,177,176,129,129,83
"7455",54,"[23]eHoIoHcouHnJqGKCasdwAkp",296,0.996633,23,297,1,296,1,1,0,1,1,156,155,141,141,83
"7456",55,"[23]eHoIoHcouHnJqGKCasdwAkp",295,0.996622,23,296,1,295,1,1,0,1,1,146,145,150,150,83
"7457",56,"[23]eHoIoHcouHnJqGKCasdwAkp",299,0.996667,23,300,1,299,1,1,0,1,1,156,155,144,144,83
"7458",57,"[23]eHoIoHcouHnJqGKCasdwAkp",298,0.996656,23,299,1,298,1,1,0,1,1,152,151,147,147,83
"7459",58,"[23]eHoIoHcouHnJqGKCasdwAkp",296,0.996633,23,297,1,296,1,1,0,1,1,148,147,149,149,83
"7460",59,"[23]eHoIoHcouHnJqGKCasdwAkp",295,0.996622,23,296,1,295,1,1,0,1,1,149,148,147,147,83
"7461",60,"[23]eHoIoHcouHnJqGKCasdwAkp",300,0.996678,23,301,1,300,1,1,0,1,1,157,156,144,144,83
"7462",61,"[23]eHoIoHcouHnJqGKCasdwAkp",299,0.996667,23,300,1,299,1,1,0,1,1,158,157,142,142,83
"7463",62,"[23]eHoIoHcouHnJqGKCasdwAkp",297,0.996644,23,298,1,297,1,1,0,1,1,152,151,146,146,83
"7464",63,"[23]eHoIoHcouHnJqGKCasdwAkp",299,0.996667,23,300,1,299,1,1,0,1,1,161,160,139,139,83
"7465",64,"[23]eHoIoHcouHnJqGKCasdwAkp",293,0.996599,23,294,1,293,1,1,0,1,1,139,138,155,155,83
"7466",65,"[23]eHoIoHcouHnJqGKCasdwAkp",295,0.996622,23,296,1,295,1,1,0,1,1,145,144,151,151,83
"7467",66,"[23]eHoIoHcouHnJqGKCasdwAkp",297,0.996644,23,298,1,297,1,1,0,1,1,155,154,143,143,83
"7468",67,"[23]eHoIoHcouHnJqGKCasdwAkp",303,0.996711,23,304,1,303,1,1,0,1,1,164,163,140,140,83
"7469",68,"[23]eHoIoHcouHnJqGKCasdwAkp",292,0.996587,23,293,1,292,1,1,0,1,1,142,141,151,151,83
"7470",69,"[23]eHoIoHcouHnJqGKCasdwAkp",289,0.996552,23,290,1,289,1,1,0,1,1,124,123,166,166,83
"7471",70,"[23]eHoIoHcouHnJqGKCasdwAkp",301,0.996689,23,302,1,301,1,1,0,1,1,163,162,139,139,83
"7472",71,"[23]eHoIoHcouHnJqGKCasdwAkp",298,0.996656,23,299,1,298,1,1,0,1,1,154,153,145,145,83
"7473",72,"[23]eHoIoHcouHnJqGKCasdwAkp",299,0.996667,23,300,1,299,1,1,0,1,1,155,154,145,145,83
"7474",73,"[23]eHoIoHcouHnJqGKCasdwAkp",295,0.996622,23,296,1,295,1,1,0,1,1,148,147,148,148,83
"7475",74,"[23]eHoIoHcouHnJqGKCasdwAkp",298,0.996656,23,299,1,298,1,1,0,1,1,152,151,147,147,83
"7476",75,"[23]eHoIoHcouHnJqGKCasdwAkp",298,0.996656,23,299,1,298,1,1,0,1,1,153,152,146,146,83
"7477",76,"[23]eHoIoHcouHnJqGKCasdwAkp",293,0.996599,23,294,1,293,1,1,0,1,1,145,144,149,149,83
"7478",77,"[23]eHoIoHcouHnJqGKCasdwAkp",301,0.996689,23,302,1,301,1,1,0,1,1,160,159,142,142,83
"7479",78,"[23]eHoIoHcouHnJqGKCasdwAkp",301,0.996689,23,302,1,301,1,1,0,1,1,163,162,139,139,83
"7480",79,"[23]eHoIoHcouHnJqGKCasdwAkp",298,0.996656,23,299,1,298,1,1,0,1,1,153,152,146,146,83
"7481",80,"[23]eHoIoHcouHnJqGKCasdwAkp",297,0.996644,23,298,1,297,1,1,0,1,1,147,146,151,151,83
"7482",81,"[23]eHoIoHcouHnJqGKCasdwAkp",308,0.996764,23,309,1,308,1,1,0,1,1,173,172,136,136,83
"7483",82,"[23]eHoIoHcouHnJqGKCasdwAkp",292,0.996587,23,293,1,292,1,1,0,1,1,136,135,157,157,83
"7484",83,"[23]eHoIoHcouHnJqGKCasdwAkp",294,0.99661,23,295,1,294,1,1,0,1,1,143,142,152,152,83
"7485",84,"[23]eHoIoHcouHnJqGKCasdwAkp",296,0.996633,23,297,1,296,1,1,0,1,1,151,150,146,146,83
"7486",85,"[23]eHoIoHcouHnJqGKCasdwAkp",292,0.996587,23,293,1,292,1,1,0,1,1,148,147,145,145,83
"7487",86,"[23]eHoIoHcouHnJqGKCasdwAkp",298,0.996656,23,299,1,298,1,1,0,1,1,158,157,141,141,83
"7488",87,"[23]eHoIoHcouHnJqGKCasdwAkp",293,0.996599,23,294,1,293,1,1,0,1,1,137,136,157,157,83
"7489",88,"[23]eHoIoHcouHnJqGKCasdwAkp",295,0.996622,23,296,1,295,1,1,0,1,1,148,147,148,148,83
"7490",89,"[23]eHoIoHcouHnJqGKCasdwAkp",295,0.996622,23,296,1,295,1,1,0,1,1,140,139,156,156,83
"7491",90,"[23]eHoIoHcouHnJqGKCasdwAkp",294,0.99661,23,295,1,294,1,1,0,1,1,141,140,154,154,83
"7492",91,"[23]eHoIoHcouHnJqGKCasdwAkp",300,0.996678,23,301,1,300,1,1,0,1,1,157,156,144,144,83
"7493",92,"[23]eHoIoHcouHnJqGKCasdwAkp",294,0.99661,23,295,1,294,1,1,0,1,1,145,144,150,150,83
"7494",93,"[23]eHoIoHcouHnJqGKCasdwAkp",295,0.996622,23,296,1,295,1,1,0,1,1,150,149,146,146,83
"7495",94,"[23]eHoIoHcouHnJqGKCasdwAkp",296,0.996633,23,297,1,296,1,1,0,1,1,148,147,149,149,83
"7496",95,"[23]eHoIoHcouHnJqGKCasdwAkp",301,0.996689,23,302,1,301,1,1,0,1,1,156,155,146,146,83
"7497",96,"[23]eHoIoHcouHnJqGKCasdwAkp",300,0.996678,23,301,1,300,1,1,0,1,1,150,149,151,151,83
"7498",97,"[23]eHoIoHcouHnJqGKCasdwAkp",293,0.996599,23,294,1,293,1,1,0,1,1,146,145,148,148,83
"7499",98,"[23]eHoIoHcouHnJqGKCasdwAkp",293,0.996599,23,294,1,293,1,1,0,1,1,145,144,149,149,83
"7500",99,"[23]eHoIoHcouHnJqGKCasdwAkp",293,0.996599,23,294,1,293,1,1,0,1,1,145,144,149,149,83
"7501",0,"[24]ivoIoHcowHnJHGqKCvvhCAcc",282,0.996466,24,283,1,282,1,1,0,1,1,123,122,160,160,84
"7502",1,"[24]ivoIoHcowHnJHGqKCvvhCAcc",278,0.996416,24,279,1,278,1,1,0,1,1,132,131,147,147,84
"7503",2,"[24]ivoIoHcowHnJHGqKCvvhCAcc",284,0.996491,24,285,1,284,1,1,0,1,1,151,150,134,134,84
"7504",3,"[24]ivoIoHcowHnJHGqKCvvhCAcc",281,0.996454,24,282,1,281,1,1,0,1,1,135,134,147,147,84
"7505",4,"[24]ivoIoHcowHnJHGqKCvvhCAcc",287,0.996528,24,288,1,287,1,1,0,1,1,159,158,129,129,84
"7506",5,"[24]ivoIoHcowHnJHGqKCvvhCAcc",274,0.996364,24,275,1,274,1,1,0,1,1,130,129,145,145,84
"7507",6,"[24]ivoIoHcowHnJHGqKCvvhCAcc",275,0.996377,24,276,1,275,1,1,0,1,1,143,142,133,133,84
"7508",7,"[24]ivoIoHcowHnJHGqKCvvhCAcc",290,0.996564,24,291,1,290,1,1,0,1,1,147,146,144,144,84
"7509",8,"[24]ivoIoHcowHnJHGqKCvvhCAcc",277,0.996403,24,278,1,277,1,1,0,1,1,127,126,151,151,84
"7510",9,"[24]ivoIoHcowHnJHGqKCvvhCAcc",285,0.996503,24,286,1,285,1,1,0,1,1,164,163,122,122,84
"7511",10,"[24]ivoIoHcowHnJHGqKCvvhCAcc",283,0.996479,24,284,1,283,1,1,0,1,1,144,143,140,140,84
"7512",11,"[24]ivoIoHcowHnJHGqKCvvhCAcc",281,0.996454,24,282,1,281,1,1,0,1,1,142,141,140,140,84
"7513",12,"[24]ivoIoHcowHnJHGqKCvvhCAcc",288,0.99654,24,289,1,288,1,1,0,1,1,148,147,141,141,84
"7514",13,"[24]ivoIoHcowHnJHGqKCvvhCAcc",275,0.996377,24,276,1,275,1,1,0,1,1,131,130,145,145,84
"7515",14,"[24]ivoIoHcowHnJHGqKCvvhCAcc",283,0.996479,24,284,1,283,1,1,0,1,1,158,157,126,126,84
"7516",15,"[24]ivoIoHcowHnJHGqKCvvhCAcc",284,0.996491,24,285,1,284,1,1,0,1,1,141,140,144,144,84
"7517",16,"[24]ivoIoHcowHnJHGqKCvvhCAcc",276,0.99639,24,277,1,276,1,1,0,1,1,141,140,136,136,84
"7518",17,"[24]ivoIoHcowHnJHGqKCvvhCAcc",281,0.996454,24,282,1,281,1,1,0,1,1,132,131,150,150,84
"7519",18,"[24]ivoIoHcowHnJHGqKCvvhCAcc",282,0.996466,24,283,1,282,1,1,0,1,1,141,140,142,142,84
"7520",19,"[24]ivoIoHcowHnJHGqKCvvhCAcc",281,0.996454,24,282,1,281,1,1,0,1,1,150,149,132,132,84
"7521",20,"[24]ivoIoHcowHnJHGqKCvvhCAcc",266,0.996255,24,267,1,266,1,1,0,1,1,125,124,142,142,84
"7522",21,"[24]ivoIoHcowHnJHGqKCvvhCAcc",264,0.996226,24,265,1,264,1,1,0,1,1,128,127,137,137,84
"7523",22,"[24]ivoIoHcowHnJHGqKCvvhCAcc",285,0.996503,24,286,1,285,1,1,0,1,1,159,158,127,127,84
"7524",23,"[24]ivoIoHcowHnJHGqKCvvhCAcc",278,0.996416,24,279,1,278,1,1,0,1,1,136,135,143,143,84
"7525",24,"[24]ivoIoHcowHnJHGqKCvvhCAcc",279,0.996429,24,280,1,279,1,1,0,1,1,128,127,152,152,84
"7526",25,"[24]ivoIoHcowHnJHGqKCvvhCAcc",278,0.996416,24,279,1,278,1,1,0,1,1,132,131,147,147,84
"7527",26,"[24]ivoIoHcowHnJHGqKCvvhCAcc",280,0.996441,24,281,1,280,1,1,0,1,1,150,149,131,131,84
"7528",27,"[24]ivoIoHcowHnJHGqKCvvhCAcc",279,0.996429,24,280,1,279,1,1,0,1,1,141,140,139,139,84
"7529",28,"[24]ivoIoHcowHnJHGqKCvvhCAcc",281,0.996454,24,282,1,281,1,1,0,1,1,135,134,147,147,84
"7530",29,"[24]ivoIoHcowHnJHGqKCvvhCAcc",288,0.99654,24,289,1,288,1,1,0,1,1,157,156,132,132,84
"7531",30,"[24]ivoIoHcowHnJHGqKCvvhCAcc",276,0.99639,24,277,1,276,1,1,0,1,1,126,125,151,151,84
"7532",31,"[24]ivoIoHcowHnJHGqKCvvhCAcc",289,0.996552,24,290,1,289,1,1,0,1,1,155,154,135,135,84
"7533",32,"[24]ivoIoHcowHnJHGqKCvvhCAcc",279,0.996429,24,280,1,279,1,1,0,1,1,140,139,140,140,84
"7534",33,"[24]ivoIoHcowHnJHGqKCvvhCAcc",287,0.996528,24,288,1,287,1,1,0,1,1,146,145,142,142,84
"7535",34,"[24]ivoIoHcowHnJHGqKCvvhCAcc",280,0.996441,24,281,1,280,1,1,0,1,1,133,132,148,148,84
"7536",35,"[24]ivoIoHcowHnJHGqKCvvhCAcc",278,0.996416,24,279,1,278,1,1,0,1,1,143,142,136,136,84
"7537",36,"[24]ivoIoHcowHnJHGqKCvvhCAcc",278,0.996416,24,279,1,278,1,1,0,1,1,135,134,144,144,84
"7538",37,"[24]ivoIoHcowHnJHGqKCvvhCAcc",286,0.996516,24,287,1,286,1,1,0,1,1,134,133,153,153,84
"7539",38,"[24]ivoIoHcowHnJHGqKCvvhCAcc",284,0.996491,24,285,1,284,1,1,0,1,1,144,143,141,141,84
"7540",39,"[24]ivoIoHcowHnJHGqKCvvhCAcc",282,0.996466,24,283,1,282,1,1,0,1,1,136,135,147,147,84
"7541",40,"[24]ivoIoHcowHnJHGqKCvvhCAcc",292,0.996587,24,293,1,292,1,1,0,1,1,144,143,149,149,84
"7542",41,"[24]ivoIoHcowHnJHGqKCvvhCAcc",281,0.996454,24,282,1,281,1,1,0,1,1,139,138,143,143,84
"7543",42,"[24]ivoIoHcowHnJHGqKCvvhCAcc",280,0.996441,24,281,1,280,1,1,0,1,1,147,146,134,134,84
"7544",43,"[24]ivoIoHcowHnJHGqKCvvhCAcc",279,0.996429,24,280,1,279,1,1,0,1,1,130,129,150,150,84
"7545",44,"[24]ivoIoHcowHnJHGqKCvvhCAcc",272,0.996337,24,273,1,272,1,1,0,1,1,132,131,141,141,84
"7546",45,"[24]ivoIoHcowHnJHGqKCvvhCAcc",277,0.996403,24,278,1,277,1,1,0,1,1,142,141,136,136,84
"7547",46,"[24]ivoIoHcowHnJHGqKCvvhCAcc",291,0.996575,24,292,1,291,1,1,0,1,1,146,145,146,146,84
"7548",47,"[24]ivoIoHcowHnJHGqKCvvhCAcc",285,0.996503,24,286,1,285,1,1,0,1,1,152,151,134,134,84
"7549",48,"[24]ivoIoHcowHnJHGqKCvvhCAcc",285,0.996503,24,286,1,285,1,1,0,1,1,154,153,132,132,84
"7550",49,"[24]ivoIoHcowHnJHGqKCvvhCAcc",279,0.996429,24,280,1,279,1,1,0,1,1,136,135,144,144,84
"7551",50,"[24]ivoIoHcowHnJHGqKCvvhCAcc",289,0.996552,24,290,1,289,1,1,0,1,1,133,132,157,157,84
"7552",51,"[24]ivoIoHcowHnJHGqKCvvhCAcc",281,0.996454,24,282,1,281,1,1,0,1,1,154,153,128,128,84
"7553",52,"[24]ivoIoHcowHnJHGqKCvvhCAcc",285,0.996503,24,286,1,285,1,1,0,1,1,138,137,148,148,84
"7554",53,"[24]ivoIoHcowHnJHGqKCvvhCAcc",277,0.996403,24,278,1,277,1,1,0,1,1,125,124,153,153,84
"7555",54,"[24]ivoIoHcowHnJHGqKCvvhCAcc",282,0.996466,24,283,1,282,1,1,0,1,1,125,124,158,158,84
"7556",55,"[24]ivoIoHcowHnJHGqKCvvhCAcc",279,0.996429,24,280,1,279,1,1,0,1,1,151,150,129,129,84
"7557",56,"[24]ivoIoHcowHnJHGqKCvvhCAcc",286,0.996516,24,287,1,286,1,1,0,1,1,134,133,153,153,84
"7558",57,"[24]ivoIoHcowHnJHGqKCvvhCAcc",284,0.996491,24,285,1,284,1,1,0,1,1,143,142,142,142,84
"7559",58,"[24]ivoIoHcowHnJHGqKCvvhCAcc",288,0.99654,24,289,1,288,1,1,0,1,1,147,146,142,142,84
"7560",59,"[24]ivoIoHcowHnJHGqKCvvhCAcc",282,0.996466,24,283,1,282,1,1,0,1,1,145,144,138,138,84
"7561",60,"[24]ivoIoHcowHnJHGqKCvvhCAcc",279,0.996429,24,280,1,279,1,1,0,1,1,147,146,133,133,84
"7562",61,"[24]ivoIoHcowHnJHGqKCvvhCAcc",280,0.996441,24,281,1,280,1,1,0,1,1,144,143,137,137,84
"7563",62,"[24]ivoIoHcowHnJHGqKCvvhCAcc",281,0.996454,24,282,1,281,1,1,0,1,1,132,131,150,150,84
"7564",63,"[24]ivoIoHcowHnJHGqKCvvhCAcc",278,0.996416,24,279,1,278,1,1,0,1,1,119,118,160,160,84
"7565",64,"[24]ivoIoHcowHnJHGqKCvvhCAcc",287,0.996528,24,288,1,287,1,1,0,1,1,140,139,148,148,84
"7566",65,"[24]ivoIoHcowHnJHGqKCvvhCAcc",282,0.996466,24,283,1,282,1,1,0,1,1,156,155,127,127,84
"7567",66,"[24]ivoIoHcowHnJHGqKCvvhCAcc",278,0.996416,24,279,1,278,1,1,0,1,1,141,140,138,138,84
"7568",67,"[24]ivoIoHcowHnJHGqKCvvhCAcc",281,0.996454,24,282,1,281,1,1,0,1,1,138,137,144,144,84
"7569",68,"[24]ivoIoHcowHnJHGqKCvvhCAcc",281,0.996454,24,282,1,281,1,1,0,1,1,133,132,149,149,84
"7570",69,"[24]ivoIoHcowHnJHGqKCvvhCAcc",282,0.996466,24,283,1,282,1,1,0,1,1,157,156,126,126,84
"7571",70,"[24]ivoIoHcowHnJHGqKCvvhCAcc",284,0.996491,24,285,1,284,1,1,0,1,1,140,139,145,145,84
"7572",71,"[24]ivoIoHcowHnJHGqKCvvhCAcc",274,0.996364,24,275,1,274,1,1,0,1,1,116,115,159,159,84
"7573",72,"[24]ivoIoHcowHnJHGqKCvvhCAcc",285,0.996503,24,286,1,285,1,1,0,1,1,142,141,144,144,84
"7574",73,"[24]ivoIoHcowHnJHGqKCvvhCAcc",278,0.996416,24,279,1,278,1,1,0,1,1,151,150,128,128,84
"7575",74,"[24]ivoIoHcowHnJHGqKCvvhCAcc",279,0.996429,24,280,1,279,1,1,0,1,1,155,154,125,125,84
"7576",75,"[24]ivoIoHcowHnJHGqKCvvhCAcc",276,0.99639,24,277,1,276,1,1,0,1,1,139,138,138,138,84
"7577",76,"[24]ivoIoHcowHnJHGqKCvvhCAcc",283,0.996479,24,284,1,283,1,1,0,1,1,140,139,144,144,84
"7578",77,"[24]ivoIoHcowHnJHGqKCvvhCAcc",278,0.996416,24,279,1,278,1,1,0,1,1,134,133,145,145,84
"7579",78,"[24]ivoIoHcowHnJHGqKCvvhCAcc",282,0.996466,24,283,1,282,1,1,0,1,1,142,141,141,141,84
"7580",79,"[24]ivoIoHcowHnJHGqKCvvhCAcc",280,0.996441,24,281,1,280,1,1,0,1,1,137,136,144,144,84
"7581",80,"[24]ivoIoHcowHnJHGqKCvvhCAcc",282,0.996466,24,283,1,282,1,1,0,1,1,130,129,153,153,84
"7582",81,"[24]ivoIoHcowHnJHGqKCvvhCAcc",284,0.996491,24,285,1,284,1,1,0,1,1,146,145,139,139,84
"7583",82,"[24]ivoIoHcowHnJHGqKCvvhCAcc",277,0.996403,24,278,1,277,1,1,0,1,1,150,149,128,128,84
"7584",83,"[24]ivoIoHcowHnJHGqKCvvhCAcc",281,0.996454,24,282,1,281,1,1,0,1,1,139,138,143,143,84
"7585",84,"[24]ivoIoHcowHnJHGqKCvvhCAcc",281,0.996454,24,282,1,281,1,1,0,1,1,140,139,142,142,84
"7586",85,"[24]ivoIoHcowHnJHGqKCvvhCAcc",277,0.996403,24,278,1,277,1,1,0,1,1,149,148,129,129,84
"7587",86,"[24]ivoIoHcowHnJHGqKCvvhCAcc",275,0.996377,24,276,1,275,1,1,0,1,1,132,131,144,144,84
"7588",87,"[24]ivoIoHcowHnJHGqKCvvhCAcc",284,0.996491,24,285,1,284,1,1,0,1,1,154,153,131,131,84
"7589",88,"[24]ivoIoHcowHnJHGqKCvvhCAcc",274,0.996364,24,275,1,274,1,1,0,1,1,139,138,136,136,84
"7590",89,"[24]ivoIoHcowHnJHGqKCvvhCAcc",285,0.996503,24,286,1,285,1,1,0,1,1,145,144,141,141,84
"7591",90,"[24]ivoIoHcowHnJHGqKCvvhCAcc",277,0.996403,24,278,1,277,1,1,0,1,1,151,150,127,127,84
"7592",91,"[24]ivoIoHcowHnJHGqKCvvhCAcc",274,0.996364,24,275,1,274,1,1,0,1,1,122,121,153,153,84
"7593",92,"[24]ivoIoHcowHnJHGqKCvvhCAcc",281,0.996454,24,282,1,281,1,1,0,1,1,153,152,129,129,84
"7594",93,"[24]ivoIoHcowHnJHGqKCvvhCAcc",279,0.996429,24,280,1,279,1,1,0,1,1,140,139,140,140,84
"7595",94,"[24]ivoIoHcowHnJHGqKCvvhCAcc",283,0.996479,24,284,1,283,1,1,0,1,1,143,142,141,141,84
"7596",95,"[24]ivoIoHcowHnJHGqKCvvhCAcc",277,0.996403,24,278,1,277,1,1,0,1,1,150,149,128,128,84
"7597",96,"[24]ivoIoHcowHnJHGqKCvvhCAcc",282,0.996466,24,283,1,282,1,1,0,1,1,155,154,128,128,84
"7598",97,"[24]ivoIoHcowHnJHGqKCvvhCAcc",283,0.996479,24,284,1,283,1,1,0,1,1,140,139,144,144,84
"7599",98,"[24]ivoIoHcowHnJHGqKCvvhCAcc",282,0.996466,24,283,1,282,1,1,0,1,1,142,141,141,141,84
"7600",99,"[24]ivoIoHcowHnJHGqKCvvhCAcc",278,0.996416,24,279,1,278,1,1,0,1,1,147,146,132,132,84
"7601",0,"[27]xHoIoHcouHnJHGqKCnxKJiqeipp",278,0.996416,27,279,1,278,1,1,0,1,1,140,139,139,139,85
"7602",1,"[27]xHoIoHcouHnJHGqKCnxKJiqeipp",279,0.996429,27,280,1,279,1,1,0,1,1,146,145,134,134,85
"7603",2,"[27]xHoIoHcouHnJHGqKCnxKJiqeipp",283,0.996479,27,284,1,283,1,1,0,1,1,139,138,145,145,85
"7604",3,"[27]xHoIoHcouHnJHGqKCnxKJiqeipp",274,0.996364,27,275,1,274,1,1,0,1,1,122,121,153,153,85
"7605",4,"[27]xHoIoHcouHnJHGqKCnxKJiqeipp",281,0.996454,27,282,1,281,1,1,0,1,1,131,130,151,151,85
"7606",5,"[27]xHoIoHcouHnJHGqKCnxKJiqeipp",287,0.996528,27,288,1,287,1,1,0,1,1,157,156,131,131,85
"7607",6,"[27]xHoIoHcouHnJHGqKCnxKJiqeipp",273,0.99635,27,274,1,273,1,1,0,1,1,120,119,154,154,85
"7608",7,"[27]xHoIoHcouHnJHGqKCnxKJiqeipp",277,0.996403,27,278,1,277,1,1,0,1,1,146,145,132,132,85
"7609",8,"[27]xHoIoHcouHnJHGqKCnxKJiqeipp",275,0.996377,27,276,1,275,1,1,0,1,1,135,134,141,141,85
"7610",9,"[27]xHoIoHcouHnJHGqKCnxKJiqeipp",287,0.996528,27,288,1,287,1,1,0,1,1,142,141,146,146,85
"7611",10,"[27]xHoIoHcouHnJHGqKCnxKJiqeipp",275,0.996377,27,276,1,275,1,1,0,1,1,137,136,139,139,85
"7612",11,"[27]xHoIoHcouHnJHGqKCnxKJiqeipp",277,0.996403,27,278,1,277,1,1,0,1,1,131,130,147,147,85
"7613",12,"[27]xHoIoHcouHnJHGqKCnxKJiqeipp",283,0.996479,27,284,1,283,1,1,0,1,1,134,133,150,150,85
"7614",13,"[27]xHoIoHcouHnJHGqKCnxKJiqeipp",287,0.996528,27,288,1,287,1,1,0,1,1,151,150,137,137,85
"7615",14,"[27]xHoIoHcouHnJHGqKCnxKJiqeipp",277,0.996403,27,278,1,277,1,1,0,1,1,132,131,146,146,85
"7616",15,"[27]xHoIoHcouHnJHGqKCnxKJiqeipp",283,0.996479,27,284,1,283,1,1,0,1,1,140,139,144,144,85
"7617",16,"[27]xHoIoHcouHnJHGqKCnxKJiqeipp",287,0.996528,27,288,1,287,1,1,0,1,1,148,147,140,140,85
"7618",17,"[27]xHoIoHcouHnJHGqKCnxKJiqeipp",290,0.996564,27,291,1,290,1,1,0,1,1,153,152,138,138,85
"7619",18,"[27]xHoIoHcouHnJHGqKCnxKJiqeipp",280,0.996441,27,281,1,280,1,1,0,1,1,140,139,141,141,85
"7620",19,"[27]xHoIoHcouHnJHGqKCnxKJiqeipp",282,0.996466,27,283,1,282,1,1,0,1,1,140,139,143,143,85
"7621",20,"[27]xHoIoHcouHnJHGqKCnxKJiqeipp",286,0.996516,27,287,1,286,1,1,0,1,1,151,150,136,136,85
"7622",21,"[27]xHoIoHcouHnJHGqKCnxKJiqeipp",288,0.99654,27,289,1,288,1,1,0,1,1,135,134,154,154,85
"7623",22,"[27]xHoIoHcouHnJHGqKCnxKJiqeipp",287,0.996528,27,288,1,287,1,1,0,1,1,159,158,129,129,85
"7624",23,"[27]xHoIoHcouHnJHGqKCnxKJiqeipp",279,0.996429,27,280,1,279,1,1,0,1,1,155,154,125,125,85
"7625",24,"[27]xHoIoHcouHnJHGqKCnxKJiqeipp",287,0.996528,27,288,1,287,1,1,0,1,1,156,155,132,132,85
"7626",25,"[27]xHoIoHcouHnJHGqKCnxKJiqeipp",280,0.996441,27,281,1,280,1,1,0,1,1,149,148,132,132,85
"7627",26,"[27]xHoIoHcouHnJHGqKCnxKJiqeipp",290,0.996564,27,291,1,290,1,1,0,1,1,141,140,150,150,85
"7628",27,"[27]xHoIoHcouHnJHGqKCnxKJiqeipp",280,0.996441,27,281,1,280,1,1,0,1,1,149,148,132,132,85
"7629",28,"[27]xHoIoHcouHnJHGqKCnxKJiqeipp",282,0.996466,27,283,1,282,1,1,0,1,1,131,130,152,152,85
"7630",29,"[27]xHoIoHcouHnJHGqKCnxKJiqeipp",285,0.996503,27,286,1,285,1,1,0,1,1,149,148,137,137,85
"7631",30,"[27]xHoIoHcouHnJHGqKCnxKJiqeipp",278,0.996416,27,279,1,278,1,1,0,1,1,141,140,138,138,85
"7632",31,"[27]xHoIoHcouHnJHGqKCnxKJiqeipp",286,0.996516,27,287,1,286,1,1,0,1,1,152,151,135,135,85
"7633",32,"[27]xHoIoHcouHnJHGqKCnxKJiqeipp",275,0.996377,27,276,1,275,1,1,0,1,1,133,132,143,143,85
"7634",33,"[27]xHoIoHcouHnJHGqKCnxKJiqeipp",282,0.996466,27,283,1,282,1,1,0,1,1,133,132,150,150,85
"7635",34,"[27]xHoIoHcouHnJHGqKCnxKJiqeipp",286,0.996516,27,287,1,286,1,1,0,1,1,141,140,146,146,85
"7636",35,"[27]xHoIoHcouHnJHGqKCnxKJiqeipp",276,0.99639,27,277,1,276,1,1,0,1,1,130,129,147,147,85
"7637",36,"[27]xHoIoHcouHnJHGqKCnxKJiqeipp",283,0.996479,27,284,1,283,1,1,0,1,1,154,153,130,130,85
"7638",37,"[27]xHoIoHcouHnJHGqKCnxKJiqeipp",278,0.996416,27,279,1,278,1,1,0,1,1,134,133,145,145,85
"7639",38,"[27]xHoIoHcouHnJHGqKCnxKJiqeipp",277,0.996403,27,278,1,277,1,1,0,1,1,133,132,145,145,85
"7640",39,"[27]xHoIoHcouHnJHGqKCnxKJiqeipp",284,0.996491,27,285,1,284,1,1,0,1,1,136,135,149,149,85
"7641",40,"[27]xHoIoHcouHnJHGqKCnxKJiqeipp",286,0.996516,27,287,1,286,1,1,0,1,1,149,148,138,138,85
"7642",41,"[27]xHoIoHcouHnJHGqKCnxKJiqeipp",285,0.996503,27,286,1,285,1,1,0,1,1,152,151,134,134,85
"7643",42,"[27]xHoIoHcouHnJHGqKCnxKJiqeipp",280,0.996441,27,281,1,280,1,1,0,1,1,157,156,124,124,85
"7644",43,"[27]xHoIoHcouHnJHGqKCnxKJiqeipp",283,0.996479,27,284,1,283,1,1,0,1,1,144,143,140,140,85
"7645",44,"[27]xHoIoHcouHnJHGqKCnxKJiqeipp",280,0.996441,27,281,1,280,1,1,0,1,1,144,143,137,137,85
"7646",45,"[27]xHoIoHcouHnJHGqKCnxKJiqeipp",288,0.99654,27,289,1,288,1,1,0,1,1,151,150,138,138,85
"7647",46,"[27]xHoIoHcouHnJHGqKCnxKJiqeipp",280,0.996441,27,281,1,280,1,1,0,1,1,141,140,140,140,85
"7648",47,"[27]xHoIoHcouHnJHGqKCnxKJiqeipp",270,0.99631,27,271,1,270,1,1,0,1,1,139,138,132,132,85
"7649",48,"[27]xHoIoHcouHnJHGqKCnxKJiqeipp",278,0.996416,27,279,1,278,1,1,0,1,1,134,133,145,145,85
"7650",49,"[27]xHoIoHcouHnJHGqKCnxKJiqeipp",281,0.996454,27,282,1,281,1,1,0,1,1,151,150,131,131,85
"7651",50,"[27]xHoIoHcouHnJHGqKCnxKJiqeipp",277,0.996403,27,278,1,277,1,1,0,1,1,135,134,143,143,85
"7652",51,"[27]xHoIoHcouHnJHGqKCnxKJiqeipp",283,0.996479,27,284,1,283,1,1,0,1,1,154,153,130,130,85
"7653",52,"[27]xHoIoHcouHnJHGqKCnxKJiqeipp",275,0.996377,27,276,1,275,1,1,0,1,1,132,131,144,144,85
"7654",53,"[27]xHoIoHcouHnJHGqKCnxKJiqeipp",281,0.996454,27,282,1,281,1,1,0,1,1,133,132,149,149,85
"7655",54,"[27]xHoIoHcouHnJHGqKCnxKJiqeipp",284,0.996491,27,285,1,284,1,1,0,1,1,146,145,139,139,85
"7656",55,"[27]xHoIoHcouHnJHGqKCnxKJiqeipp",271,0.996324,27,272,1,271,1,1,0,1,1,136,135,136,136,85
"7657",56,"[27]xHoIoHcouHnJHGqKCnxKJiqeipp",285,0.996503,27,286,1,285,1,1,0,1,1,145,144,141,141,85
"7658",57,"[27]xHoIoHcouHnJHGqKCnxKJiqeipp",278,0.996416,27,279,1,278,1,1,0,1,1,140,139,139,139,85
"7659",58,"[27]xHoIoHcouHnJHGqKCnxKJiqeipp",285,0.996503,27,286,1,285,1,1,0,1,1,146,145,140,140,85
"7660",59,"[27]xHoIoHcouHnJHGqKCnxKJiqeipp",281,0.996454,27,282,1,281,1,1,0,1,1,154,153,128,128,85
"7661",60,"[27]xHoIoHcouHnJHGqKCnxKJiqeipp",291,0.996575,27,292,1,291,1,1,0,1,1,148,147,144,144,85
"7662",61,"[27]xHoIoHcouHnJHGqKCnxKJiqeipp",288,0.99654,27,289,1,288,1,1,0,1,1,133,132,156,156,85
"7663",62,"[27]xHoIoHcouHnJHGqKCnxKJiqeipp",282,0.996466,27,283,1,282,1,1,0,1,1,152,151,131,131,85
"7664",63,"[27]xHoIoHcouHnJHGqKCnxKJiqeipp",285,0.996503,27,286,1,285,1,1,0,1,1,145,144,141,141,85
"7665",64,"[27]xHoIoHcouHnJHGqKCnxKJiqeipp",286,0.996516,27,287,1,286,1,1,0,1,1,160,159,127,127,85
"7666",65,"[27]xHoIoHcouHnJHGqKCnxKJiqeipp",277,0.996403,27,278,1,277,1,1,0,1,1,137,136,141,141,85
"7667",66,"[27]xHoIoHcouHnJHGqKCnxKJiqeipp",282,0.996466,27,283,1,282,1,1,0,1,1,143,142,140,140,85
"7668",67,"[27]xHoIoHcouHnJHGqKCnxKJiqeipp",283,0.996479,27,284,1,283,1,1,0,1,1,146,145,138,138,85
"7669",68,"[27]xHoIoHcouHnJHGqKCnxKJiqeipp",279,0.996429,27,280,1,279,1,1,0,1,1,128,127,152,152,85
"7670",69,"[27]xHoIoHcouHnJHGqKCnxKJiqeipp",280,0.996441,27,281,1,280,1,1,0,1,1,134,133,147,147,85
"7671",70,"[27]xHoIoHcouHnJHGqKCnxKJiqeipp",286,0.996516,27,287,1,286,1,1,0,1,1,146,145,141,141,85
"7672",71,"[27]xHoIoHcouHnJHGqKCnxKJiqeipp",280,0.996441,27,281,1,280,1,1,0,1,1,154,153,127,127,85
"7673",72,"[27]xHoIoHcouHnJHGqKCnxKJiqeipp",277,0.996403,27,278,1,277,1,1,0,1,1,133,132,145,145,85
"7674",73,"[27]xHoIoHcouHnJHGqKCnxKJiqeipp",281,0.996454,27,282,1,281,1,1,0,1,1,152,151,130,130,85
"7675",74,"[27]xHoIoHcouHnJHGqKCnxKJiqeipp",278,0.996416,27,279,1,278,1,1,0,1,1,140,139,139,139,85
"7676",75,"[27]xHoIoHcouHnJHGqKCnxKJiqeipp",288,0.99654,27,289,1,288,1,1,0,1,1,140,139,149,149,85
"7677",76,"[27]xHoIoHcouHnJHGqKCnxKJiqeipp",285,0.996503,27,286,1,285,1,1,0,1,1,148,147,138,138,85
"7678",77,"[27]xHoIoHcouHnJHGqKCnxKJiqeipp",281,0.996454,27,282,1,281,1,1,0,1,1,145,144,137,137,85
"7679",78,"[27]xHoIoHcouHnJHGqKCnxKJiqeipp",285,0.996503,27,286,1,285,1,1,0,1,1,152,151,134,134,85
"7680",79,"[27]xHoIoHcouHnJHGqKCnxKJiqeipp",287,0.996528,27,288,1,287,1,1,0,1,1,144,143,144,144,85
"7681",80,"[27]xHoIoHcouHnJHGqKCnxKJiqeipp",277,0.996403,27,278,1,277,1,1,0,1,1,127,126,151,151,85
"7682",81,"[27]xHoIoHcouHnJHGqKCnxKJiqeipp",284,0.996491,27,285,1,284,1,1,0,1,1,152,151,133,133,85
"7683",82,"[27]xHoIoHcouHnJHGqKCnxKJiqeipp",283,0.996479,27,284,1,283,1,1,0,1,1,139,138,145,145,85
"7684",83,"[27]xHoIoHcouHnJHGqKCnxKJiqeipp",280,0.996441,27,281,1,280,1,1,0,1,1,152,151,129,129,85
"7685",84,"[27]xHoIoHcouHnJHGqKCnxKJiqeipp",281,0.996454,27,282,1,281,1,1,0,1,1,141,140,141,141,85
"7686",85,"[27]xHoIoHcouHnJHGqKCnxKJiqeipp",275,0.996377,27,276,1,275,1,1,0,1,1,150,149,126,126,85
"7687",86,"[27]xHoIoHcouHnJHGqKCnxKJiqeipp",275,0.996377,27,276,1,275,1,1,0,1,1,134,133,142,142,85
"7688",87,"[27]xHoIoHcouHnJHGqKCnxKJiqeipp",276,0.99639,27,277,1,276,1,1,0,1,1,141,140,136,136,85
"7689",88,"[27]xHoIoHcouHnJHGqKCnxKJiqeipp",282,0.996466,27,283,1,282,1,1,0,1,1,141,140,142,142,85
"7690",89,"[27]xHoIoHcouHnJHGqKCnxKJiqeipp",283,0.996479,27,284,1,283,1,1,0,1,1,151,150,133,133,85
"7691",90,"[27]xHoIoHcouHnJHGqKCnxKJiqeipp",279,0.996429,27,280,1,279,1,1,0,1,1,142,141,138,138,85
"7692",91,"[27]xHoIoHcouHnJHGqKCnxKJiqeipp",284,0.996491,27,285,1,284,1,1,0,1,1,150,149,135,135,85
"7693",92,"[27]xHoIoHcouHnJHGqKCnxKJiqeipp",278,0.996416,27,279,1,278,1,1,0,1,1,153,152,126,126,85
"7694",93,"[27]xHoIoHcouHnJHGqKCnxKJiqeipp",278,0.996416,27,279,1,278,1,1,0,1,1,137,136,142,142,85
"7695",94,"[27]xHoIoHcouHnJHGqKCnxKJiqeipp",281,0.996454,27,282,1,281,1,1,0,1,1,131,130,151,151,85
"7696",95,"[27]xHoIoHcouHnJHGqKCnxKJiqeipp",283,0.996479,27,284,1,283,1,1,0,1,1,148,147,136,136,85
"7697",96,"[27]xHoIoHcouHnJHGqKCnxKJiqeipp",279,0.996429,27,280,1,279,1,1,0,1,1,133,132,147,147,85
"7698",97,"[27]xHoIoHcouHnJHGqKCnxKJiqeipp",278,0.996416,27,279,1,278,1,1,0,1,1,135,134,144,144,85
"7699",98,"[27]xHoIoHcouHnJHGqKCnxKJiqeipp",278,0.996416,27,279,1,278,1,1,0,1,1,136,135,143,143,85
"7700",99,"[27]xHoIoHcouHnJHGqKCnxKJiqeipp",275,0.996377,27,276,1,275,1,1,0,1,1,135,134,141,141,85
"7701",0,"[24]CEtHoIoHcrowHnJqGKCjaImb",298,0.996656,24,299,1,298,1,1,0,1,1,164,163,135,135,88
"7702",1,"[24]CEtHoIoHcrowHnJqGKCjaImb",298,0.996656,24,299,1,298,1,1,0,1,1,154,153,145,145,88
"7703",2,"[24]CEtHoIoHcrowHnJqGKCjaImb",293,0.996599,24,294,1,293,1,1,0,1,1,141,140,153,153,88
"7704",3,"[24]CEtHoIoHcrowHnJqGKCjaImb",301,0.996689,24,302,1,301,1,1,0,1,1,164,163,138,138,88
"7705",4,"[24]CEtHoIoHcrowHnJqGKCjaImb",289,0.996552,24,290,1,289,1,1,0,1,1,139,138,151,151,88
"7706",5,"[24]CEtHoIoHcrowHnJqGKCjaImb",300,0.996678,24,301,1,300,1,1,0,1,1,158,157,143,143,88
"7707",6,"[24]CEtHoIoHcrowHnJqGKCjaImb",296,0.996633,24,297,1,296,1,1,0,1,1,146,145,151,151,88
"7708",7,"[24]CEtHoIoHcrowHnJqGKCjaImb",296,0.996633,24,297,1,296,1,1,0,1,1,159,158,138,138,88
"7709",8,"[24]CEtHoIoHcrowHnJqGKCjaImb",295,0.996622,24,296,1,295,1,1,0,1,1,151,150,145,145,88
"7710",9,"[24]CEtHoIoHcrowHnJqGKCjaImb",304,0.996721,24,305,1,304,1,1,0,1,1,158,157,147,147,88
"7711",10,"[24]CEtHoIoHcrowHnJqGKCjaImb",291,0.996575,24,292,1,291,1,1,0,1,1,141,140,151,151,88
"7712",11,"[24]CEtHoIoHcrowHnJqGKCjaImb",294,0.99661,24,295,1,294,1,1,0,1,1,145,144,150,150,88
"7713",12,"[24]CEtHoIoHcrowHnJqGKCjaImb",293,0.996599,24,294,1,293,1,1,0,1,1,150,149,144,144,88
"7714",13,"[24]CEtHoIoHcrowHnJqGKCjaImb",294,0.99661,24,295,1,294,1,1,0,1,1,143,142,152,152,88
"7715",14,"[24]CEtHoIoHcrowHnJqGKCjaImb",289,0.996552,24,290,1,289,1,1,0,1,1,130,129,160,160,88
"7716",15,"[24]CEtHoIoHcrowHnJqGKCjaImb",294,0.99661,24,295,1,294,1,1,0,1,1,139,138,156,156,88
"7717",16,"[24]CEtHoIoHcrowHnJqGKCjaImb",297,0.996644,24,298,1,297,1,1,0,1,1,159,158,139,139,88
"7718",17,"[24]CEtHoIoHcrowHnJqGKCjaImb",298,0.996656,24,299,1,298,1,1,0,1,1,156,155,143,143,88
"7719",18,"[24]CEtHoIoHcrowHnJqGKCjaImb",295,0.996622,24,296,1,295,1,1,0,1,1,146,145,150,150,88
"7720",19,"[24]CEtHoIoHcrowHnJqGKCjaImb",297,0.996644,24,298,1,297,1,1,0,1,1,152,151,146,146,88
"7721",20,"[24]CEtHoIoHcrowHnJqGKCjaImb",297,0.996644,24,298,1,297,1,1,0,1,1,156,155,142,142,88
"7722",21,"[24]CEtHoIoHcrowHnJqGKCjaImb",297,0.996644,24,298,1,297,1,1,0,1,1,159,158,139,139,88
"7723",22,"[24]CEtHoIoHcrowHnJqGKCjaImb",300,0.996678,24,301,1,300,1,1,0,1,1,163,162,138,138,88
"7724",23,"[24]CEtHoIoHcrowHnJqGKCjaImb",295,0.996622,24,296,1,295,1,1,0,1,1,148,147,148,148,88
"7725",24,"[24]CEtHoIoHcrowHnJqGKCjaImb",300,0.996678,24,301,1,300,1,1,0,1,1,163,162,138,138,88
"7726",25,"[24]CEtHoIoHcrowHnJqGKCjaImb",292,0.996587,24,293,1,292,1,1,0,1,1,140,139,153,153,88
"7727",26,"[24]CEtHoIoHcrowHnJqGKCjaImb",297,0.996644,24,298,1,297,1,1,0,1,1,160,159,138,138,88
"7728",27,"[24]CEtHoIoHcrowHnJqGKCjaImb",300,0.996678,24,301,1,300,1,1,0,1,1,165,164,136,136,88
"7729",28,"[24]CEtHoIoHcrowHnJqGKCjaImb",294,0.99661,24,295,1,294,1,1,0,1,1,144,143,151,151,88
"7730",29,"[24]CEtHoIoHcrowHnJqGKCjaImb",291,0.996575,24,292,1,291,1,1,0,1,1,135,134,157,157,88
"7731",30,"[24]CEtHoIoHcrowHnJqGKCjaImb",297,0.996644,24,298,1,297,1,1,0,1,1,153,152,145,145,88
"7732",31,"[24]CEtHoIoHcrowHnJqGKCjaImb",291,0.996575,24,292,1,291,1,1,0,1,1,139,138,153,153,88
"7733",32,"[24]CEtHoIoHcrowHnJqGKCjaImb",297,0.996644,24,298,1,297,1,1,0,1,1,152,151,146,146,88
"7734",33,"[24]CEtHoIoHcrowHnJqGKCjaImb",301,0.996689,24,302,1,301,1,1,0,1,1,165,164,137,137,88
"7735",34,"[24]CEtHoIoHcrowHnJqGKCjaImb",295,0.996622,24,296,1,295,1,1,0,1,1,146,145,150,150,88
"7736",35,"[24]CEtHoIoHcrowHnJqGKCjaImb",297,0.996644,24,298,1,297,1,1,0,1,1,158,157,140,140,88
"7737",36,"[24]CEtHoIoHcrowHnJqGKCjaImb",298,0.996656,24,299,1,298,1,1,0,1,1,149,148,150,150,88
"7738",37,"[24]CEtHoIoHcrowHnJqGKCjaImb",290,0.996564,24,291,1,290,1,1,0,1,1,139,138,152,152,88
"7739",38,"[24]CEtHoIoHcrowHnJqGKCjaImb",296,0.996633,24,297,1,296,1,1,0,1,1,150,149,147,147,88
"7740",39,"[24]CEtHoIoHcrowHnJqGKCjaImb",286,0.996516,24,287,1,286,1,1,0,1,1,124,123,163,163,88
"7741",40,"[24]CEtHoIoHcrowHnJqGKCjaImb",291,0.996575,24,292,1,291,1,1,0,1,1,139,138,153,153,88
"7742",41,"[24]CEtHoIoHcrowHnJqGKCjaImb",293,0.996599,24,294,1,293,1,1,0,1,1,145,144,149,149,88
"7743",42,"[24]CEtHoIoHcrowHnJqGKCjaImb",294,0.99661,24,295,1,294,1,1,0,1,1,137,136,158,158,88
"7744",43,"[24]CEtHoIoHcrowHnJqGKCjaImb",297,0.996644,24,298,1,297,1,1,0,1,1,156,155,142,142,88
"7745",44,"[24]CEtHoIoHcrowHnJqGKCjaImb",299,0.996667,24,300,1,299,1,1,0,1,1,160,159,140,140,88
"7746",45,"[24]CEtHoIoHcrowHnJqGKCjaImb",296,0.996633,24,297,1,296,1,1,0,1,1,154,153,143,143,88
"7747",46,"[24]CEtHoIoHcrowHnJqGKCjaImb",291,0.996575,24,292,1,291,1,1,0,1,1,135,134,157,157,88
"7748",47,"[24]CEtHoIoHcrowHnJqGKCjaImb",295,0.996622,24,296,1,295,1,1,0,1,1,155,154,141,141,88
"7749",48,"[24]CEtHoIoHcrowHnJqGKCjaImb",297,0.996644,24,298,1,297,1,1,0,1,1,156,155,142,142,88
"7750",49,"[24]CEtHoIoHcrowHnJqGKCjaImb",292,0.996587,24,293,1,292,1,1,0,1,1,139,138,154,154,88
"7751",50,"[24]CEtHoIoHcrowHnJqGKCjaImb",292,0.996587,24,293,1,292,1,1,0,1,1,143,142,150,150,88
"7752",51,"[24]CEtHoIoHcrowHnJqGKCjaImb",296,0.996633,24,297,1,296,1,1,0,1,1,151,150,146,146,88
"7753",52,"[24]CEtHoIoHcrowHnJqGKCjaImb",294,0.99661,24,295,1,294,1,1,0,1,1,148,147,147,147,88
"7754",53,"[24]CEtHoIoHcrowHnJqGKCjaImb",296,0.996633,24,297,1,296,1,1,0,1,1,151,150,146,146,88
"7755",54,"[24]CEtHoIoHcrowHnJqGKCjaImb",295,0.996622,24,296,1,295,1,1,0,1,1,157,156,139,139,88
"7756",55,"[24]CEtHoIoHcrowHnJqGKCjaImb",295,0.996622,24,296,1,295,1,1,0,1,1,148,147,148,148,88
"7757",56,"[24]CEtHoIoHcrowHnJqGKCjaImb",293,0.996599,24,294,1,293,1,1,0,1,1,147,146,147,147,88
"7758",57,"[24]CEtHoIoHcrowHnJqGKCjaImb",299,0.996667,24,300,1,299,1,1,0,1,1,155,154,145,145,88
"7759",58,"[24]CEtHoIoHcrowHnJqGKCjaImb",297,0.996644,24,298,1,297,1,1,0,1,1,147,146,151,151,88
"7760",59,"[24]CEtHoIoHcrowHnJqGKCjaImb",299,0.996667,24,300,1,299,1,1,0,1,1,160,159,140,140,88
"7761",60,"[24]CEtHoIoHcrowHnJqGKCjaImb",293,0.996599,24,294,1,293,1,1,0,1,1,145,144,149,149,88
"7762",61,"[24]CEtHoIoHcrowHnJqGKCjaImb",299,0.996667,24,300,1,299,1,1,0,1,1,158,157,142,142,88
"7763",62,"[24]CEtHoIoHcrowHnJqGKCjaImb",298,0.996656,24,299,1,298,1,1,0,1,1,156,155,143,143,88
"7764",63,"[24]CEtHoIoHcrowHnJqGKCjaImb",303,0.996711,24,304,1,303,1,1,0,1,1,170,169,134,134,88
"7765",64,"[24]CEtHoIoHcrowHnJqGKCjaImb",293,0.996599,24,294,1,293,1,1,0,1,1,149,148,145,145,88
"7766",65,"[24]CEtHoIoHcrowHnJqGKCjaImb",296,0.996633,24,297,1,296,1,1,0,1,1,158,157,139,139,88
"7767",66,"[24]CEtHoIoHcrowHnJqGKCjaImb",298,0.996656,24,299,1,298,1,1,0,1,1,154,153,145,145,88
"7768",67,"[24]CEtHoIoHcrowHnJqGKCjaImb",296,0.996633,24,297,1,296,1,1,0,1,1,154,153,143,143,88
"7769",68,"[24]CEtHoIoHcrowHnJqGKCjaImb",295,0.996622,24,296,1,295,1,1,0,1,1,150,149,146,146,88
"7770",69,"[24]CEtHoIoHcrowHnJqGKCjaImb",288,0.99654,24,289,1,288,1,1,0,1,1,135,134,154,154,88
"7771",70,"[24]CEtHoIoHcrowHnJqGKCjaImb",303,0.996711,24,304,1,303,1,1,0,1,1,172,171,132,132,88
"7772",71,"[24]CEtHoIoHcrowHnJqGKCjaImb",288,0.99654,24,289,1,288,1,1,0,1,1,139,138,150,150,88
"7773",72,"[24]CEtHoIoHcrowHnJqGKCjaImb",298,0.996656,24,299,1,298,1,1,0,1,1,156,155,143,143,88
"7774",73,"[24]CEtHoIoHcrowHnJqGKCjaImb",294,0.99661,24,295,1,294,1,1,0,1,1,145,144,150,150,88
"7775",74,"[24]CEtHoIoHcrowHnJqGKCjaImb",295,0.996622,24,296,1,295,1,1,0,1,1,150,149,146,146,88
"7776",75,"[24]CEtHoIoHcrowHnJqGKCjaImb",301,0.996689,24,302,1,301,1,1,0,1,1,162,161,140,140,88
"7777",76,"[24]CEtHoIoHcrowHnJqGKCjaImb",300,0.996678,24,301,1,300,1,1,0,1,1,160,159,141,141,88
"7778",77,"[24]CEtHoIoHcrowHnJqGKCjaImb",294,0.99661,24,295,1,294,1,1,0,1,1,140,139,155,155,88
"7779",78,"[24]CEtHoIoHcrowHnJqGKCjaImb",295,0.996622,24,296,1,295,1,1,0,1,1,151,150,145,145,88
"7780",79,"[24]CEtHoIoHcrowHnJqGKCjaImb",293,0.996599,24,294,1,293,1,1,0,1,1,139,138,155,155,88
"7781",80,"[24]CEtHoIoHcrowHnJqGKCjaImb",296,0.996633,24,297,1,296,1,1,0,1,1,146,145,151,151,88
"7782",81,"[24]CEtHoIoHcrowHnJqGKCjaImb",290,0.996564,24,291,1,290,1,1,0,1,1,139,138,152,152,88
"7783",82,"[24]CEtHoIoHcrowHnJqGKCjaImb",289,0.996552,24,290,1,289,1,1,0,1,1,128,127,162,162,88
"7784",83,"[24]CEtHoIoHcrowHnJqGKCjaImb",303,0.996711,24,304,1,303,1,1,0,1,1,171,170,133,133,88
"7785",84,"[24]CEtHoIoHcrowHnJqGKCjaImb",289,0.996552,24,290,1,289,1,1,0,1,1,132,131,158,158,88
"7786",85,"[24]CEtHoIoHcrowHnJqGKCjaImb",298,0.996656,24,299,1,298,1,1,0,1,1,144,143,155,155,88
"7787",86,"[24]CEtHoIoHcrowHnJqGKCjaImb",300,0.996678,24,301,1,300,1,1,0,1,1,162,161,139,139,88
"7788",87,"[24]CEtHoIoHcrowHnJqGKCjaImb",297,0.996644,24,298,1,297,1,1,0,1,1,154,153,144,144,88
"7789",88,"[24]CEtHoIoHcrowHnJqGKCjaImb",302,0.9967,24,303,1,302,1,1,0,1,1,171,170,132,132,88
"7790",89,"[24]CEtHoIoHcrowHnJqGKCjaImb",292,0.996587,24,293,1,292,1,1,0,1,1,145,144,148,148,88
"7791",90,"[24]CEtHoIoHcrowHnJqGKCjaImb",293,0.996599,24,294,1,293,1,1,0,1,1,145,144,149,149,88
"7792",91,"[24]CEtHoIoHcrowHnJqGKCjaImb",286,0.996516,24,287,1,286,1,1,0,1,1,118,117,169,169,88
"7793",92,"[24]CEtHoIoHcrowHnJqGKCjaImb",296,0.996633,24,297,1,296,1,1,0,1,1,151,150,146,146,88
"7794",93,"[24]CEtHoIoHcrowHnJqGKCjaImb",295,0.996622,24,296,1,295,1,1,0,1,1,147,146,149,149,88
"7795",94,"[24]CEtHoIoHcrowHnJqGKCjaImb",289,0.996552,24,290,1,289,1,1,0,1,1,135,134,155,155,88
"7796",95,"[24]CEtHoIoHcrowHnJqGKCjaImb",289,0.996552,24,290,1,289,1,1,0,1,1,137,136,153,153,88
"7797",96,"[24]CEtHoIoHcrowHnJqGKCjaImb",301,0.996689,24,302,1,301,1,1,0,1,1,165,164,137,137,88
"7798",97,"[24]CEtHoIoHcrowHnJqGKCjaImb",300,0.996678,24,301,1,300,1,1,0,1,1,163,162,138,138,88
"7799",98,"[24]CEtHoIoHcrowHnJqGKCjaImb",296,0.996633,24,297,1,296,1,1,0,1,1,149,148,148,148,88
"7800",99,"[24]CEtHoIoHcrowHnJqGKCjaImb",295,0.996622,24,296,1,295,1,1,0,1,1,147,146,149,149,88
"7801",0,"[27]ioIoHcouHnJHGqKChqqtfsbJzpG",271,0.996324,27,272,1,271,1,1,0,1,1,134,133,138,138,89
"7802",1,"[27]ioIoHcouHnJHGqKChqqtfsbJzpG",273,0.99635,27,274,1,273,1,1,0,1,1,128,127,146,146,89
"7803",2,"[27]ioIoHcouHnJHGqKChqqtfsbJzpG",284,0.996491,27,285,1,284,1,1,0,1,1,141,140,144,144,89
"7804",3,"[27]ioIoHcouHnJHGqKChqqtfsbJzpG",284,0.996491,27,285,1,284,1,1,0,1,1,138,137,147,147,89
"7805",4,"[27]ioIoHcouHnJHGqKChqqtfsbJzpG",286,0.996516,27,287,1,286,1,1,0,1,1,153,152,134,134,89
"7806",5,"[27]ioIoHcouHnJHGqKChqqtfsbJzpG",284,0.996491,27,285,1,284,1,1,0,1,1,148,147,137,137,89
"7807",6,"[27]ioIoHcouHnJHGqKChqqtfsbJzpG",282,0.996466,27,283,1,282,1,1,0,1,1,145,144,138,138,89
"7808",7,"[27]ioIoHcouHnJHGqKChqqtfsbJzpG",287,0.996528,27,288,1,287,1,1,0,1,1,140,139,148,148,89
"7809",8,"[27]ioIoHcouHnJHGqKChqqtfsbJzpG",290,0.996564,27,291,1,290,1,1,0,1,1,156,155,135,135,89
"7810",9,"[27]ioIoHcouHnJHGqKChqqtfsbJzpG",262,0.996198,27,263,1,262,1,1,0,1,1,122,121,141,141,89
"7811",10,"[27]ioIoHcouHnJHGqKChqqtfsbJzpG",280,0.996441,27,281,1,280,1,1,0,1,1,148,147,133,133,89
"7812",11,"[27]ioIoHcouHnJHGqKChqqtfsbJzpG",278,0.996416,27,279,1,278,1,1,0,1,1,142,141,137,137,89
"7813",12,"[27]ioIoHcouHnJHGqKChqqtfsbJzpG",281,0.996454,27,282,1,281,1,1,0,1,1,134,133,148,148,89
"7814",13,"[27]ioIoHcouHnJHGqKChqqtfsbJzpG",281,0.996454,27,282,1,281,1,1,0,1,1,140,139,142,142,89
"7815",14,"[27]ioIoHcouHnJHGqKChqqtfsbJzpG",286,0.996516,27,287,1,286,1,1,0,1,1,142,141,145,145,89
"7816",15,"[27]ioIoHcouHnJHGqKChqqtfsbJzpG",285,0.996503,27,286,1,285,1,1,0,1,1,153,152,133,133,89
"7817",16,"[27]ioIoHcouHnJHGqKChqqtfsbJzpG",282,0.996466,27,283,1,282,1,1,0,1,1,135,134,148,148,89
"7818",17,"[27]ioIoHcouHnJHGqKChqqtfsbJzpG",278,0.996416,27,279,1,278,1,1,0,1,1,138,137,141,141,89
"7819",18,"[27]ioIoHcouHnJHGqKChqqtfsbJzpG",278,0.996416,27,279,1,278,1,1,0,1,1,126,125,153,153,89
"7820",19,"[27]ioIoHcouHnJHGqKChqqtfsbJzpG",284,0.996491,27,285,1,284,1,1,0,1,1,137,136,148,148,89
"7821",20,"[27]ioIoHcouHnJHGqKChqqtfsbJzpG",292,0.996587,27,293,1,292,1,1,0,1,1,159,158,134,134,89
"7822",21,"[27]ioIoHcouHnJHGqKChqqtfsbJzpG",285,0.996503,27,286,1,285,1,1,0,1,1,145,144,141,141,89
"7823",22,"[27]ioIoHcouHnJHGqKChqqtfsbJzpG",280,0.996441,27,281,1,280,1,1,0,1,1,137,136,144,144,89
"7824",23,"[27]ioIoHcouHnJHGqKChqqtfsbJzpG",276,0.99639,27,277,1,276,1,1,0,1,1,131,130,146,146,89
"7825",24,"[27]ioIoHcouHnJHGqKChqqtfsbJzpG",287,0.996528,27,288,1,287,1,1,0,1,1,154,153,134,134,89
"7826",25,"[27]ioIoHcouHnJHGqKChqqtfsbJzpG",277,0.996403,27,278,1,277,1,1,0,1,1,123,122,155,155,89
"7827",26,"[27]ioIoHcouHnJHGqKChqqtfsbJzpG",273,0.99635,27,274,1,273,1,1,0,1,1,126,125,148,148,89
"7828",27,"[27]ioIoHcouHnJHGqKChqqtfsbJzpG",276,0.99639,27,277,1,276,1,1,0,1,1,144,143,133,133,89
"7829",28,"[27]ioIoHcouHnJHGqKChqqtfsbJzpG",278,0.996416,27,279,1,278,1,1,0,1,1,141,140,138,138,89
"7830",29,"[27]ioIoHcouHnJHGqKChqqtfsbJzpG",281,0.996454,27,282,1,281,1,1,0,1,1,153,152,129,129,89
"7831",30,"[27]ioIoHcouHnJHGqKChqqtfsbJzpG",279,0.996429,27,280,1,279,1,1,0,1,1,135,134,145,145,89
"7832",31,"[27]ioIoHcouHnJHGqKChqqtfsbJzpG",287,0.996528,27,288,1,287,1,1,0,1,1,141,140,147,147,89
"7833",32,"[27]ioIoHcouHnJHGqKChqqtfsbJzpG",278,0.996416,27,279,1,278,1,1,0,1,1,134,133,145,145,89
"7834",33,"[27]ioIoHcouHnJHGqKChqqtfsbJzpG",280,0.996441,27,281,1,280,1,1,0,1,1,148,147,133,133,89
"7835",34,"[27]ioIoHcouHnJHGqKChqqtfsbJzpG",270,0.99631,27,271,1,270,1,1,0,1,1,137,136,134,134,89
"7836",35,"[27]ioIoHcouHnJHGqKChqqtfsbJzpG",277,0.996403,27,278,1,277,1,1,0,1,1,143,142,135,135,89
"7837",36,"[27]ioIoHcouHnJHGqKChqqtfsbJzpG",277,0.996403,27,278,1,277,1,1,0,1,1,130,129,148,148,89
"7838",37,"[27]ioIoHcouHnJHGqKChqqtfsbJzpG",291,0.996575,27,292,1,291,1,1,0,1,1,153,152,139,139,89
"7839",38,"[27]ioIoHcouHnJHGqKChqqtfsbJzpG",275,0.996377,27,276,1,275,1,1,0,1,1,127,126,149,149,89
"7840",39,"[27]ioIoHcouHnJHGqKChqqtfsbJzpG",284,0.996491,27,285,1,284,1,1,0,1,1,154,153,131,131,89
"7841",40,"[27]ioIoHcouHnJHGqKChqqtfsbJzpG",277,0.996403,27,278,1,277,1,1,0,1,1,132,131,146,146,89
"7842",41,"[27]ioIoHcouHnJHGqKChqqtfsbJzpG",284,0.996491,27,285,1,284,1,1,0,1,1,158,157,127,127,89
"7843",42,"[27]ioIoHcouHnJHGqKChqqtfsbJzpG",278,0.996416,27,279,1,278,1,1,0,1,1,148,147,131,131,89
"7844",43,"[27]ioIoHcouHnJHGqKChqqtfsbJzpG",282,0.996466,27,283,1,282,1,1,0,1,1,154,153,129,129,89
"7845",44,"[27]ioIoHcouHnJHGqKChqqtfsbJzpG",281,0.996454,27,282,1,281,1,1,0,1,1,132,131,150,150,89
"7846",45,"[27]ioIoHcouHnJHGqKChqqtfsbJzpG",280,0.996441,27,281,1,280,1,1,0,1,1,137,136,144,144,89
"7847",46,"[27]ioIoHcouHnJHGqKChqqtfsbJzpG",271,0.996324,27,272,1,271,1,1,0,1,1,140,139,132,132,89
"7848",47,"[27]ioIoHcouHnJHGqKChqqtfsbJzpG",281,0.996454,27,282,1,281,1,1,0,1,1,144,143,138,138,89
"7849",48,"[27]ioIoHcouHnJHGqKChqqtfsbJzpG",280,0.996441,27,281,1,280,1,1,0,1,1,146,145,135,135,89
"7850",49,"[27]ioIoHcouHnJHGqKChqqtfsbJzpG",283,0.996479,27,284,1,283,1,1,0,1,1,164,163,120,120,89
"7851",50,"[27]ioIoHcouHnJHGqKChqqtfsbJzpG",290,0.996564,27,291,1,290,1,1,0,1,1,142,141,149,149,89
"7852",51,"[27]ioIoHcouHnJHGqKChqqtfsbJzpG",279,0.996429,27,280,1,279,1,1,0,1,1,137,136,143,143,89
"7853",52,"[27]ioIoHcouHnJHGqKChqqtfsbJzpG",280,0.996441,27,281,1,280,1,1,0,1,1,124,123,157,157,89
"7854",53,"[27]ioIoHcouHnJHGqKChqqtfsbJzpG",287,0.996528,27,288,1,287,1,1,0,1,1,176,175,112,112,89
"7855",54,"[27]ioIoHcouHnJHGqKChqqtfsbJzpG",283,0.996479,27,284,1,283,1,1,0,1,1,153,152,131,131,89
"7856",55,"[27]ioIoHcouHnJHGqKChqqtfsbJzpG",280,0.996441,27,281,1,280,1,1,0,1,1,131,130,150,150,89
"7857",56,"[27]ioIoHcouHnJHGqKChqqtfsbJzpG",284,0.996491,27,285,1,284,1,1,0,1,1,138,137,147,147,89
"7858",57,"[27]ioIoHcouHnJHGqKChqqtfsbJzpG",291,0.996575,27,292,1,291,1,1,0,1,1,147,146,145,145,89
"7859",58,"[27]ioIoHcouHnJHGqKChqqtfsbJzpG",287,0.996528,27,288,1,287,1,1,0,1,1,144,143,144,144,89
"7860",59,"[27]ioIoHcouHnJHGqKChqqtfsbJzpG",277,0.996403,27,278,1,277,1,1,0,1,1,131,130,147,147,89
"7861",60,"[27]ioIoHcouHnJHGqKChqqtfsbJzpG",279,0.996429,27,280,1,279,1,1,0,1,1,141,140,139,139,89
"7862",61,"[27]ioIoHcouHnJHGqKChqqtfsbJzpG",276,0.99639,27,277,1,276,1,1,0,1,1,144,143,133,133,89
"7863",62,"[27]ioIoHcouHnJHGqKChqqtfsbJzpG",290,0.996564,27,291,1,290,1,1,0,1,1,151,150,140,140,89
"7864",63,"[27]ioIoHcouHnJHGqKChqqtfsbJzpG",287,0.996528,27,288,1,287,1,1,0,1,1,145,144,143,143,89
"7865",64,"[27]ioIoHcouHnJHGqKChqqtfsbJzpG",278,0.996416,27,279,1,278,1,1,0,1,1,137,136,142,142,89
"7866",65,"[27]ioIoHcouHnJHGqKChqqtfsbJzpG",280,0.996441,27,281,1,280,1,1,0,1,1,142,141,139,139,89
"7867",66,"[27]ioIoHcouHnJHGqKChqqtfsbJzpG",270,0.99631,27,271,1,270,1,1,0,1,1,134,133,137,137,89
"7868",67,"[27]ioIoHcouHnJHGqKChqqtfsbJzpG",281,0.996454,27,282,1,281,1,1,0,1,1,139,138,143,143,89
"7869",68,"[27]ioIoHcouHnJHGqKChqqtfsbJzpG",291,0.996575,27,292,1,291,1,1,0,1,1,149,148,143,143,89
"7870",69,"[27]ioIoHcouHnJHGqKChqqtfsbJzpG",279,0.996429,27,280,1,279,1,1,0,1,1,159,158,121,121,89
"7871",70,"[27]ioIoHcouHnJHGqKChqqtfsbJzpG",292,0.996587,27,293,1,292,1,1,0,1,1,156,155,137,137,89
"7872",71,"[27]ioIoHcouHnJHGqKChqqtfsbJzpG",292,0.996587,27,293,1,292,1,1,0,1,1,141,140,152,152,89
"7873",72,"[27]ioIoHcouHnJHGqKChqqtfsbJzpG",277,0.996403,27,278,1,277,1,1,0,1,1,130,129,148,148,89
"7874",73,"[27]ioIoHcouHnJHGqKChqqtfsbJzpG",284,0.996491,27,285,1,284,1,1,0,1,1,142,141,143,143,89
"7875",74,"[27]ioIoHcouHnJHGqKChqqtfsbJzpG",280,0.996441,27,281,1,280,1,1,0,1,1,157,156,124,124,89
"7876",75,"[27]ioIoHcouHnJHGqKChqqtfsbJzpG",286,0.996516,27,287,1,286,1,1,0,1,1,154,153,133,133,89
"7877",76,"[27]ioIoHcouHnJHGqKChqqtfsbJzpG",286,0.996516,27,287,1,286,1,1,0,1,1,144,143,143,143,89
"7878",77,"[27]ioIoHcouHnJHGqKChqqtfsbJzpG",281,0.996454,27,282,1,281,1,1,0,1,1,137,136,145,145,89
"7879",78,"[27]ioIoHcouHnJHGqKChqqtfsbJzpG",298,0.996656,27,299,1,298,1,1,0,1,1,167,166,132,132,89
"7880",79,"[27]ioIoHcouHnJHGqKChqqtfsbJzpG",276,0.99639,27,277,1,276,1,1,0,1,1,136,135,141,141,89
"7881",80,"[27]ioIoHcouHnJHGqKChqqtfsbJzpG",279,0.996429,27,280,1,279,1,1,0,1,1,153,152,127,127,89
"7882",81,"[27]ioIoHcouHnJHGqKChqqtfsbJzpG",282,0.996466,27,283,1,282,1,1,0,1,1,150,149,133,133,89
"7883",82,"[27]ioIoHcouHnJHGqKChqqtfsbJzpG",282,0.996466,27,283,1,282,1,1,0,1,1,154,153,129,129,89
"7884",83,"[27]ioIoHcouHnJHGqKChqqtfsbJzpG",280,0.996441,27,281,1,280,1,1,0,1,1,145,144,136,136,89
"7885",84,"[27]ioIoHcouHnJHGqKChqqtfsbJzpG",275,0.996377,27,276,1,275,1,1,0,1,1,130,129,146,146,89
"7886",85,"[27]ioIoHcouHnJHGqKChqqtfsbJzpG",278,0.996416,27,279,1,278,1,1,0,1,1,145,144,134,134,89
"7887",86,"[27]ioIoHcouHnJHGqKChqqtfsbJzpG",288,0.99654,27,289,1,288,1,1,0,1,1,152,151,137,137,89
"7888",87,"[27]ioIoHcouHnJHGqKChqqtfsbJzpG",281,0.996454,27,282,1,281,1,1,0,1,1,136,135,146,146,89
"7889",88,"[27]ioIoHcouHnJHGqKChqqtfsbJzpG",281,0.996454,27,282,1,281,1,1,0,1,1,155,154,127,127,89
"7890",89,"[27]ioIoHcouHnJHGqKChqqtfsbJzpG",283,0.996479,27,284,1,283,1,1,0,1,1,158,157,126,126,89
"7891",90,"[27]ioIoHcouHnJHGqKChqqtfsbJzpG",279,0.996429,27,280,1,279,1,1,0,1,1,139,138,141,141,89
"7892",91,"[27]ioIoHcouHnJHGqKChqqtfsbJzpG",283,0.996479,27,284,1,283,1,1,0,1,1,143,142,141,141,89
"7893",92,"[27]ioIoHcouHnJHGqKChqqtfsbJzpG",276,0.99639,27,277,1,276,1,1,0,1,1,126,125,151,151,89
"7894",93,"[27]ioIoHcouHnJHGqKChqqtfsbJzpG",280,0.996441,27,281,1,280,1,1,0,1,1,137,136,144,144,89
"7895",94,"[27]ioIoHcouHnJHGqKChqqtfsbJzpG",282,0.996466,27,283,1,282,1,1,0,1,1,147,146,136,136,89
"7896",95,"[27]ioIoHcouHnJHGqKChqqtfsbJzpG",281,0.996454,27,282,1,281,1,1,0,1,1,138,137,144,144,89
"7897",96,"[27]ioIoHcouHnJHGqKChqqtfsbJzpG",278,0.996416,27,279,1,278,1,1,0,1,1,138,137,141,141,89
"7898",97,"[27]ioIoHcouHnJHGqKChqqtfsbJzpG",284,0.996491,27,285,1,284,1,1,0,1,1,147,146,138,138,89
"7899",98,"[27]ioIoHcouHnJHGqKChqqtfsbJzpG",274,0.996364,27,275,1,274,1,1,0,1,1,135,134,140,140,89
"7900",99,"[27]ioIoHcouHnJHGqKChqqtfsbJzpG",269,0.996296,27,270,1,269,1,1,0,1,1,119,118,151,151,89
"7901",0,"[26]joIAoHcosHnJHqKHqKGCvdbxgn",342,0.997085,26,343,1,342,1,1,0,1,1,187,186,156,156,91
"7902",1,"[26]joIAoHcosHnJHqKHqKGCvdbxgn",345,0.99711,26,346,1,345,1,1,0,1,1,169,168,177,177,91
"7903",2,"[26]joIAoHcosHnJHqKHqKGCvdbxgn",341,0.997076,26,342,1,341,1,1,0,1,1,185,184,157,157,91
"7904",3,"[26]joIAoHcosHnJHqKHqKGCvdbxgn",345,0.99711,26,346,1,345,1,1,0,1,1,161,160,185,185,91
"7905",4,"[26]joIAoHcosHnJHqKHqKGCvdbxgn",339,0.997059,26,340,1,339,1,1,0,1,1,163,162,177,177,91
"7906",5,"[26]joIAoHcosHnJHqKHqKGCvdbxgn",346,0.997118,26,347,1,346,1,1,0,1,1,172,171,175,175,91
"7907",6,"[26]joIAoHcosHnJHqKHqKGCvdbxgn",359,0.997222,26,360,1,359,1,1,0,1,1,171,170,189,189,91
"7908",7,"[26]joIAoHcosHnJHqKHqKGCvdbxgn",343,0.997093,26,344,1,343,1,1,0,1,1,162,161,182,182,91
"7909",8,"[26]joIAoHcosHnJHqKHqKGCvdbxgn",346,0.997118,26,347,1,346,1,1,0,1,1,182,181,165,165,91
"7910",9,"[26]joIAoHcosHnJHqKHqKGCvdbxgn",351,0.997159,26,352,1,351,1,1,0,1,1,190,189,162,162,91
"7911",10,"[26]joIAoHcosHnJHqKHqKGCvdbxgn",344,0.997101,26,345,1,344,1,1,0,1,1,167,166,178,178,91
"7912",11,"[26]joIAoHcosHnJHqKHqKGCvdbxgn",348,0.997135,26,349,1,348,1,1,0,1,1,193,192,156,156,91
"7913",12,"[26]joIAoHcosHnJHqKHqKGCvdbxgn",346,0.997118,26,347,1,346,1,1,0,1,1,184,183,163,163,91
"7914",13,"[26]joIAoHcosHnJHqKHqKGCvdbxgn",355,0.997191,26,356,1,355,1,1,0,1,1,169,168,187,187,91
"7915",14,"[26]joIAoHcosHnJHqKHqKGCvdbxgn",356,0.997199,26,357,1,356,1,1,0,1,1,181,180,176,176,91
"7916",15,"[26]joIAoHcosHnJHqKHqKGCvdbxgn",355,0.997191,26,356,1,355,1,1,0,1,1,184,183,172,172,91
"7917",16,"[26]joIAoHcosHnJHqKHqKGCvdbxgn",347,0.997126,26,348,1,347,1,1,0,1,1,183,182,165,165,91
"7918",17,"[26]joIAoHcosHnJHqKHqKGCvdbxgn",353,0.997175,26,354,1,353,1,1,0,1,1,163,162,191,191,91
"7919",18,"[26]joIAoHcosHnJHqKHqKGCvdbxgn",345,0.99711,26,346,1,345,1,1,0,1,1,171,170,175,175,91
"7920",19,"[26]joIAoHcosHnJHqKHqKGCvdbxgn",349,0.997143,26,350,1,349,1,1,0,1,1,168,167,182,182,91
"7921",20,"[26]joIAoHcosHnJHqKHqKGCvdbxgn",339,0.997059,26,340,1,339,1,1,0,1,1,172,171,168,168,91
"7922",21,"[26]joIAoHcosHnJHqKHqKGCvdbxgn",347,0.997126,26,348,1,347,1,1,0,1,1,169,168,179,179,91
"7923",22,"[26]joIAoHcosHnJHqKHqKGCvdbxgn",350,0.997151,26,351,1,350,1,1,0,1,1,167,166,184,184,91
"7924",23,"[26]joIAoHcosHnJHqKHqKGCvdbxgn",338,0.99705,26,339,1,338,1,1,0,1,1,183,182,156,156,91
"7925",24,"[26]joIAoHcosHnJHqKHqKGCvdbxgn",341,0.997076,26,342,1,341,1,1,0,1,1,165,164,177,177,91
"7926",25,"[26]joIAoHcosHnJHqKHqKGCvdbxgn",339,0.997059,26,340,1,339,1,1,0,1,1,160,159,180,180,91
"7927",26,"[26]joIAoHcosHnJHqKHqKGCvdbxgn",349,0.997143,26,350,1,349,1,1,0,1,1,173,172,177,177,91
"7928",27,"[26]joIAoHcosHnJHqKHqKGCvdbxgn",336,0.997033,26,337,1,336,1,1,0,1,1,178,177,159,159,91
"7929",28,"[26]joIAoHcosHnJHqKHqKGCvdbxgn",343,0.997093,26,344,1,343,1,1,0,1,1,166,165,178,178,91
"7930",29,"[26]joIAoHcosHnJHqKHqKGCvdbxgn",353,0.997175,26,354,1,353,1,1,0,1,1,169,168,185,185,91
"7931",30,"[26]joIAoHcosHnJHqKHqKGCvdbxgn",340,0.997067,26,341,1,340,1,1,0,1,1,180,179,161,161,91
"7932",31,"[26]joIAoHcosHnJHqKHqKGCvdbxgn",344,0.997101,26,345,1,344,1,1,0,1,1,179,178,166,166,91
"7933",32,"[26]joIAoHcosHnJHqKHqKGCvdbxgn",355,0.997191,26,356,1,355,1,1,0,1,1,157,156,199,199,91
"7934",33,"[26]joIAoHcosHnJHqKHqKGCvdbxgn",344,0.997101,26,345,1,344,1,1,0,1,1,168,167,177,177,91
"7935",34,"[26]joIAoHcosHnJHqKHqKGCvdbxgn",348,0.997135,26,349,1,348,1,1,0,1,1,180,179,169,169,91
"7936",35,"[26]joIAoHcosHnJHqKHqKGCvdbxgn",343,0.997093,26,344,1,343,1,1,0,1,1,172,171,172,172,91
"7937",36,"[26]joIAoHcosHnJHqKHqKGCvdbxgn",340,0.997067,26,341,1,340,1,1,0,1,1,178,177,163,163,91
"7938",37,"[26]joIAoHcosHnJHqKHqKGCvdbxgn",342,0.997085,26,343,1,342,1,1,0,1,1,187,186,156,156,91
"7939",38,"[26]joIAoHcosHnJHqKHqKGCvdbxgn",344,0.997101,26,345,1,344,1,1,0,1,1,184,183,161,161,91
"7940",39,"[26]joIAoHcosHnJHqKHqKGCvdbxgn",340,0.997067,26,341,1,340,1,1,0,1,1,170,169,171,171,91
"7941",40,"[26]joIAoHcosHnJHqKHqKGCvdbxgn",334,0.997015,26,335,1,334,1,1,0,1,1,173,172,162,162,91
"7942",41,"[26]joIAoHcosHnJHqKHqKGCvdbxgn",338,0.99705,26,339,1,338,1,1,0,1,1,170,169,169,169,91
"7943",42,"[26]joIAoHcosHnJHqKHqKGCvdbxgn",343,0.997093,26,344,1,343,1,1,0,1,1,170,169,174,174,91
"7944",43,"[26]joIAoHcosHnJHqKHqKGCvdbxgn",348,0.997135,26,349,1,348,1,1,0,1,1,176,175,173,173,91
"7945",44,"[26]joIAoHcosHnJHqKHqKGCvdbxgn",342,0.997085,26,343,1,342,1,1,0,1,1,178,177,165,165,91
"7946",45,"[26]joIAoHcosHnJHqKHqKGCvdbxgn",348,0.997135,26,349,1,348,1,1,0,1,1,181,180,168,168,91
"7947",46,"[26]joIAoHcosHnJHqKHqKGCvdbxgn",362,0.997245,26,363,1,362,1,1,0,1,1,169,168,194,194,91
"7948",47,"[26]joIAoHcosHnJHqKHqKGCvdbxgn",349,0.997143,26,350,1,349,1,1,0,1,1,184,183,166,166,91
"7949",48,"[26]joIAoHcosHnJHqKHqKGCvdbxgn",348,0.997135,26,349,1,348,1,1,0,1,1,171,170,178,178,91
"7950",49,"[26]joIAoHcosHnJHqKHqKGCvdbxgn",346,0.997118,26,347,1,346,1,1,0,1,1,190,189,157,157,91
"7951",50,"[26]joIAoHcosHnJHqKHqKGCvdbxgn",341,0.997076,26,342,1,341,1,1,0,1,1,164,163,178,178,91
"7952",51,"[26]joIAoHcosHnJHqKHqKGCvdbxgn",348,0.997135,26,349,1,348,1,1,0,1,1,156,155,193,193,91
"7953",52,"[26]joIAoHcosHnJHqKHqKGCvdbxgn",350,0.997151,26,351,1,350,1,1,0,1,1,187,186,164,164,91
"7954",53,"[26]joIAoHcosHnJHqKHqKGCvdbxgn",340,0.997067,26,341,1,340,1,1,0,1,1,181,180,160,160,91
"7955",54,"[26]joIAoHcosHnJHqKHqKGCvdbxgn",353,0.997175,26,354,1,353,1,1,0,1,1,193,192,161,161,91
"7956",55,"[26]joIAoHcosHnJHqKHqKGCvdbxgn",340,0.997067,26,341,1,340,1,1,0,1,1,177,176,164,164,91
"7957",56,"[26]joIAoHcosHnJHqKHqKGCvdbxgn",365,0.997268,26,366,1,365,1,1,0,1,1,184,183,182,182,91
"7958",57,"[26]joIAoHcosHnJHqKHqKGCvdbxgn",353,0.997175,26,354,1,353,1,1,0,1,1,165,164,189,189,91
"7959",58,"[26]joIAoHcosHnJHqKHqKGCvdbxgn",350,0.997151,26,351,1,350,1,1,0,1,1,166,165,185,185,91
"7960",59,"[26]joIAoHcosHnJHqKHqKGCvdbxgn",340,0.997067,26,341,1,340,1,1,0,1,1,178,177,163,163,91
"7961",60,"[26]joIAoHcosHnJHqKHqKGCvdbxgn",340,0.997067,26,341,1,340,1,1,0,1,1,164,163,177,177,91
"7962",61,"[26]joIAoHcosHnJHqKHqKGCvdbxgn",347,0.997126,26,348,1,347,1,1,0,1,1,168,167,180,180,91
"7963",62,"[26]joIAoHcosHnJHqKHqKGCvdbxgn",347,0.997126,26,348,1,347,1,1,0,1,1,182,181,166,166,91
"7964",63,"[26]joIAoHcosHnJHqKHqKGCvdbxgn",347,0.997126,26,348,1,347,1,1,0,1,1,160,159,188,188,91
"7965",64,"[26]joIAoHcosHnJHqKHqKGCvdbxgn",351,0.997159,26,352,1,351,1,1,0,1,1,160,159,192,192,91
"7966",65,"[26]joIAoHcosHnJHqKHqKGCvdbxgn",349,0.997143,26,350,1,349,1,1,0,1,1,178,177,172,172,91
"7967",66,"[26]joIAoHcosHnJHqKHqKGCvdbxgn",353,0.997175,26,354,1,353,1,1,0,1,1,188,187,166,166,91
"7968",67,"[26]joIAoHcosHnJHqKHqKGCvdbxgn",346,0.997118,26,347,1,346,1,1,0,1,1,181,180,166,166,91
"7969",68,"[26]joIAoHcosHnJHqKHqKGCvdbxgn",355,0.997191,26,356,1,355,1,1,0,1,1,179,178,177,177,91
"7970",69,"[26]joIAoHcosHnJHqKHqKGCvdbxgn",341,0.997076,26,342,1,341,1,1,0,1,1,183,182,159,159,91
"7971",70,"[26]joIAoHcosHnJHqKHqKGCvdbxgn",343,0.997093,26,344,1,343,1,1,0,1,1,177,176,167,167,91
"7972",71,"[26]joIAoHcosHnJHqKHqKGCvdbxgn",349,0.997143,26,350,1,349,1,1,0,1,1,175,174,175,175,91
"7973",72,"[26]joIAoHcosHnJHqKHqKGCvdbxgn",340,0.997067,26,341,1,340,1,1,0,1,1,186,185,155,155,91
"7974",73,"[26]joIAoHcosHnJHqKHqKGCvdbxgn",348,0.997135,26,349,1,348,1,1,0,1,1,172,171,177,177,91
"7975",74,"[26]joIAoHcosHnJHqKHqKGCvdbxgn",336,0.997033,26,337,1,336,1,1,0,1,1,168,167,169,169,91
"7976",75,"[26]joIAoHcosHnJHqKHqKGCvdbxgn",345,0.99711,26,346,1,345,1,1,0,1,1,174,173,172,172,91
"7977",76,"[26]joIAoHcosHnJHqKHqKGCvdbxgn",347,0.997126,26,348,1,347,1,1,0,1,1,181,180,167,167,91
"7978",77,"[26]joIAoHcosHnJHqKHqKGCvdbxgn",337,0.997041,26,338,1,337,1,1,0,1,1,181,180,157,157,91
"7979",78,"[26]joIAoHcosHnJHqKHqKGCvdbxgn",342,0.997085,26,343,1,342,1,1,0,1,1,182,181,161,161,91
"7980",79,"[26]joIAoHcosHnJHqKHqKGCvdbxgn",348,0.997135,26,349,1,348,1,1,0,1,1,161,160,188,188,91
"7981",80,"[26]joIAoHcosHnJHqKHqKGCvdbxgn",348,0.997135,26,349,1,348,1,1,0,1,1,186,185,163,163,91
"7982",81,"[26]joIAoHcosHnJHqKHqKGCvdbxgn",349,0.997143,26,350,1,349,1,1,0,1,1,166,165,184,184,91
"7983",82,"[26]joIAoHcosHnJHqKHqKGCvdbxgn",340,0.997067,26,341,1,340,1,1,0,1,1,159,158,182,182,91
"7984",83,"[26]joIAoHcosHnJHqKHqKGCvdbxgn",341,0.997076,26,342,1,341,1,1,0,1,1,159,158,183,183,91
"7985",84,"[26]joIAoHcosHnJHqKHqKGCvdbxgn",342,0.997085,26,343,1,342,1,1,0,1,1,188,187,155,155,91
"7986",85,"[26]joIAoHcosHnJHqKHqKGCvdbxgn",337,0.997041,26,338,1,337,1,1,0,1,1,175,174,163,163,91
"7987",86,"[26]joIAoHcosHnJHqKHqKGCvdbxgn",346,0.997118,26,347,1,346,1,1,0,1,1,180,179,167,167,91
"7988",87,"[26]joIAoHcosHnJHqKHqKGCvdbxgn",343,0.997093,26,344,1,343,1,1,0,1,1,160,159,184,184,91
"7989",88,"[26]joIAoHcosHnJHqKHqKGCvdbxgn",358,0.997214,26,359,1,358,1,1,0,1,1,192,191,167,167,91
"7990",89,"[26]joIAoHcosHnJHqKHqKGCvdbxgn",346,0.997118,26,347,1,346,1,1,0,1,1,160,159,187,187,91
"7991",90,"[26]joIAoHcosHnJHqKHqKGCvdbxgn",346,0.997118,26,347,1,346,1,1,0,1,1,180,179,167,167,91
"7992",91,"[26]joIAoHcosHnJHqKHqKGCvdbxgn",339,0.997059,26,340,1,339,1,1,0,1,1,169,168,171,171,91
"7993",92,"[26]joIAoHcosHnJHqKHqKGCvdbxgn",348,0.997135,26,349,1,348,1,1,0,1,1,166,165,183,183,91
"7994",93,"[26]joIAoHcosHnJHqKHqKGCvdbxgn",343,0.997093,26,344,1,343,1,1,0,1,1,182,181,162,162,91
"7995",94,"[26]joIAoHcosHnJHqKHqKGCvdbxgn",341,0.997076,26,342,1,341,1,1,0,1,1,179,178,163,163,91
"7996",95,"[26]joIAoHcosHnJHqKHqKGCvdbxgn",348,0.997135,26,349,1,348,1,1,0,1,1,174,173,175,175,91
"7997",96,"[26]joIAoHcosHnJHqKHqKGCvdbxgn",347,0.997126,26,348,1,347,1,1,0,1,1,171,170,177,177,91
"7998",97,"[26]joIAoHcosHnJHqKHqKGCvdbxgn",347,0.997126,26,348,1,347,1,1,0,1,1,174,173,174,174,91
"7999",98,"[26]joIAoHcosHnJHqKHqKGCvdbxgn",342,0.997085,26,343,1,342,1,1,0,1,1,165,164,178,178,91
"8000",99,"[26]joIAoHcosHnJHqKHqKGCvdbxgn",345,0.99711,26,346,1,345,1,1,0,1,1,166,165,180,180,91
"8001",0,"[26]kyHHoIoHcosHnJHGqKCxuxhect",274,0.996364,26,275,1,274,1,1,0,1,1,127,126,148,148,92
"8002",1,"[26]kyHHoIoHcosHnJHGqKCxuxhect",280,0.996441,26,281,1,280,1,1,0,1,1,140,139,141,141,92
"8003",2,"[26]kyHHoIoHcosHnJHGqKCxuxhect",283,0.996479,26,284,1,283,1,1,0,1,1,137,136,147,147,92
"8004",3,"[26]kyHHoIoHcosHnJHGqKCxuxhect",285,0.996503,26,286,1,285,1,1,0,1,1,154,153,132,132,92
"8005",4,"[26]kyHHoIoHcosHnJHGqKCxuxhect",284,0.996491,26,285,1,284,1,1,0,1,1,153,152,132,132,92
"8006",5,"[26]kyHHoIoHcosHnJHGqKCxuxhect",280,0.996441,26,281,1,280,1,1,0,1,1,133,132,148,148,92
"8007",6,"[26]kyHHoIoHcosHnJHGqKCxuxhect",281,0.996454,26,282,1,281,1,1,0,1,1,134,133,148,148,92
"8008",7,"[26]kyHHoIoHcosHnJHGqKCxuxhect",286,0.996516,26,287,1,286,1,1,0,1,1,147,146,140,140,92
"8009",8,"[26]kyHHoIoHcosHnJHGqKCxuxhect",280,0.996441,26,281,1,280,1,1,0,1,1,136,135,145,145,92
"8010",9,"[26]kyHHoIoHcosHnJHGqKCxuxhect",284,0.996491,26,285,1,284,1,1,0,1,1,144,143,141,141,92
"8011",10,"[26]kyHHoIoHcosHnJHGqKCxuxhect",279,0.996429,26,280,1,279,1,1,0,1,1,156,155,124,124,92
"8012",11,"[26]kyHHoIoHcosHnJHGqKCxuxhect",289,0.996552,26,290,1,289,1,1,0,1,1,147,146,143,143,92
"8013",12,"[26]kyHHoIoHcosHnJHGqKCxuxhect",273,0.99635,26,274,1,273,1,1,0,1,1,130,129,144,144,92
"8014",13,"[26]kyHHoIoHcosHnJHGqKCxuxhect",275,0.996377,26,276,1,275,1,1,0,1,1,139,138,137,137,92
"8015",14,"[26]kyHHoIoHcosHnJHGqKCxuxhect",286,0.996516,26,287,1,286,1,1,0,1,1,150,149,137,137,92
"8016",15,"[26]kyHHoIoHcosHnJHGqKCxuxhect",279,0.996429,26,280,1,279,1,1,0,1,1,140,139,140,140,92
"8017",16,"[26]kyHHoIoHcosHnJHGqKCxuxhect",276,0.99639,26,277,1,276,1,1,0,1,1,125,124,152,152,92
"8018",17,"[26]kyHHoIoHcosHnJHGqKCxuxhect",279,0.996429,26,280,1,279,1,1,0,1,1,140,139,140,140,92
"8019",18,"[26]kyHHoIoHcosHnJHGqKCxuxhect",283,0.996479,26,284,1,283,1,1,0,1,1,144,143,140,140,92
"8020",19,"[26]kyHHoIoHcosHnJHGqKCxuxhect",274,0.996364,26,275,1,274,1,1,0,1,1,134,133,141,141,92
"8021",20,"[26]kyHHoIoHcosHnJHGqKCxuxhect",277,0.996403,26,278,1,277,1,1,0,1,1,141,140,137,137,92
"8022",21,"[26]kyHHoIoHcosHnJHGqKCxuxhect",285,0.996503,26,286,1,285,1,1,0,1,1,142,141,144,144,92
"8023",22,"[26]kyHHoIoHcosHnJHGqKCxuxhect",282,0.996466,26,283,1,282,1,1,0,1,1,142,141,141,141,92
"8024",23,"[26]kyHHoIoHcosHnJHGqKCxuxhect",280,0.996441,26,281,1,280,1,1,0,1,1,143,142,138,138,92
"8025",24,"[26]kyHHoIoHcosHnJHGqKCxuxhect",279,0.996429,26,280,1,279,1,1,0,1,1,142,141,138,138,92
"8026",25,"[26]kyHHoIoHcosHnJHGqKCxuxhect",288,0.99654,26,289,1,288,1,1,0,1,1,159,158,130,130,92
"8027",26,"[26]kyHHoIoHcosHnJHGqKCxuxhect",284,0.996491,26,285,1,284,1,1,0,1,1,139,138,146,146,92
"8028",27,"[26]kyHHoIoHcosHnJHGqKCxuxhect",287,0.996528,26,288,1,287,1,1,0,1,1,146,145,142,142,92
"8029",28,"[26]kyHHoIoHcosHnJHGqKCxuxhect",285,0.996503,26,286,1,285,1,1,0,1,1,149,148,137,137,92
"8030",29,"[26]kyHHoIoHcosHnJHGqKCxuxhect",274,0.996364,26,275,1,274,1,1,0,1,1,135,134,140,140,92
"8031",30,"[26]kyHHoIoHcosHnJHGqKCxuxhect",284,0.996491,26,285,1,284,1,1,0,1,1,141,140,144,144,92
"8032",31,"[26]kyHHoIoHcosHnJHGqKCxuxhect",281,0.996454,26,282,1,281,1,1,0,1,1,144,143,138,138,92
"8033",32,"[26]kyHHoIoHcosHnJHGqKCxuxhect",278,0.996416,26,279,1,278,1,1,0,1,1,137,136,142,142,92
"8034",33,"[26]kyHHoIoHcosHnJHGqKCxuxhect",286,0.996516,26,287,1,286,1,1,0,1,1,155,154,132,132,92
"8035",34,"[26]kyHHoIoHcosHnJHGqKCxuxhect",280,0.996441,26,281,1,280,1,1,0,1,1,132,131,149,149,92
"8036",35,"[26]kyHHoIoHcosHnJHGqKCxuxhect",283,0.996479,26,284,1,283,1,1,0,1,1,153,152,131,131,92
"8037",36,"[26]kyHHoIoHcosHnJHGqKCxuxhect",279,0.996429,26,280,1,279,1,1,0,1,1,149,148,131,131,92
"8038",37,"[26]kyHHoIoHcosHnJHGqKCxuxhect",279,0.996429,26,280,1,279,1,1,0,1,1,143,142,137,137,92
"8039",38,"[26]kyHHoIoHcosHnJHGqKCxuxhect",288,0.99654,26,289,1,288,1,1,0,1,1,154,153,135,135,92
"8040",39,"[26]kyHHoIoHcosHnJHGqKCxuxhect",278,0.996416,26,279,1,278,1,1,0,1,1,143,142,136,136,92
"8041",40,"[26]kyHHoIoHcosHnJHGqKCxuxhect",288,0.99654,26,289,1,288,1,1,0,1,1,143,142,146,146,92
"8042",41,"[26]kyHHoIoHcosHnJHGqKCxuxhect",287,0.996528,26,288,1,287,1,1,0,1,1,148,147,140,140,92
"8043",42,"[26]kyHHoIoHcosHnJHGqKCxuxhect",271,0.996324,26,272,1,271,1,1,0,1,1,140,139,132,132,92
"8044",43,"[26]kyHHoIoHcosHnJHGqKCxuxhect",273,0.99635,26,274,1,273,1,1,0,1,1,126,125,148,148,92
"8045",44,"[26]kyHHoIoHcosHnJHGqKCxuxhect",279,0.996429,26,280,1,279,1,1,0,1,1,119,118,161,161,92
"8046",45,"[26]kyHHoIoHcosHnJHGqKCxuxhect",279,0.996429,26,280,1,279,1,1,0,1,1,133,132,147,147,92
"8047",46,"[26]kyHHoIoHcosHnJHGqKCxuxhect",283,0.996479,26,284,1,283,1,1,0,1,1,133,132,151,151,92
"8048",47,"[26]kyHHoIoHcosHnJHGqKCxuxhect",277,0.996403,26,278,1,277,1,1,0,1,1,143,142,135,135,92
"8049",48,"[26]kyHHoIoHcosHnJHGqKCxuxhect",275,0.996377,26,276,1,275,1,1,0,1,1,122,121,154,154,92
"8050",49,"[26]kyHHoIoHcosHnJHGqKCxuxhect",282,0.996466,26,283,1,282,1,1,0,1,1,150,149,133,133,92
"8051",50,"[26]kyHHoIoHcosHnJHGqKCxuxhect",291,0.996575,26,292,1,291,1,1,0,1,1,149,148,143,143,92
"8052",51,"[26]kyHHoIoHcosHnJHGqKCxuxhect",279,0.996429,26,280,1,279,1,1,0,1,1,147,146,133,133,92
"8053",52,"[26]kyHHoIoHcosHnJHGqKCxuxhect",273,0.99635,26,274,1,273,1,1,0,1,1,127,126,147,147,92
"8054",53,"[26]kyHHoIoHcosHnJHGqKCxuxhect",281,0.996454,26,282,1,281,1,1,0,1,1,134,133,148,148,92
"8055",54,"[26]kyHHoIoHcosHnJHGqKCxuxhect",272,0.996337,26,273,1,272,1,1,0,1,1,144,143,129,129,92
"8056",55,"[26]kyHHoIoHcosHnJHGqKCxuxhect",282,0.996466,26,283,1,282,1,1,0,1,1,146,145,137,137,92
"8057",56,"[26]kyHHoIoHcosHnJHGqKCxuxhect",274,0.996364,26,275,1,274,1,1,0,1,1,143,142,132,132,92
"8058",57,"[26]kyHHoIoHcosHnJHGqKCxuxhect",282,0.996466,26,283,1,282,1,1,0,1,1,148,147,135,135,92
"8059",58,"[26]kyHHoIoHcosHnJHGqKCxuxhect",283,0.996479,26,284,1,283,1,1,0,1,1,141,140,143,143,92
"8060",59,"[26]kyHHoIoHcosHnJHGqKCxuxhect",283,0.996479,26,284,1,283,1,1,0,1,1,149,148,135,135,92
"8061",60,"[26]kyHHoIoHcosHnJHGqKCxuxhect",284,0.996491,26,285,1,284,1,1,0,1,1,141,140,144,144,92
"8062",61,"[26]kyHHoIoHcosHnJHGqKCxuxhect",278,0.996416,26,279,1,278,1,1,0,1,1,127,126,152,152,92
"8063",62,"[26]kyHHoIoHcosHnJHGqKCxuxhect",275,0.996377,26,276,1,275,1,1,0,1,1,122,121,154,154,92
"8064",63,"[26]kyHHoIoHcosHnJHGqKCxuxhect",281,0.996454,26,282,1,281,1,1,0,1,1,154,153,128,128,92
"8065",64,"[26]kyHHoIoHcosHnJHGqKCxuxhect",281,0.996454,26,282,1,281,1,1,0,1,1,144,143,138,138,92
"8066",65,"[26]kyHHoIoHcosHnJHGqKCxuxhect",275,0.996377,26,276,1,275,1,1,0,1,1,136,135,140,140,92
"8067",66,"[26]kyHHoIoHcosHnJHGqKCxuxhect",286,0.996516,26,287,1,286,1,1,0,1,1,145,144,142,142,92
"8068",67,"[26]kyHHoIoHcosHnJHGqKCxuxhect",261,0.996183,26,262,1,261,1,1,0,1,1,153,152,109,109,92
"8069",68,"[26]kyHHoIoHcosHnJHGqKCxuxhect",284,0.996491,26,285,1,284,1,1,0,1,1,116,115,169,169,92
"8070",69,"[26]kyHHoIoHcosHnJHGqKCxuxhect",277,0.996403,26,278,1,277,1,1,0,1,1,141,140,137,137,92
"8071",70,"[26]kyHHoIoHcosHnJHGqKCxuxhect",283,0.996479,26,284,1,283,1,1,0,1,1,129,128,155,155,92
"8072",71,"[26]kyHHoIoHcosHnJHGqKCxuxhect",269,0.996296,26,270,1,269,1,1,0,1,1,148,147,122,122,92
"8073",72,"[26]kyHHoIoHcosHnJHGqKCxuxhect",274,0.996364,26,275,1,274,1,1,0,1,1,130,129,145,145,92
"8074",73,"[26]kyHHoIoHcosHnJHGqKCxuxhect",277,0.996403,26,278,1,277,1,1,0,1,1,131,130,147,147,92
"8075",74,"[26]kyHHoIoHcosHnJHGqKCxuxhect",279,0.996429,26,280,1,279,1,1,0,1,1,136,135,144,144,92
"8076",75,"[26]kyHHoIoHcosHnJHGqKCxuxhect",274,0.996364,26,275,1,274,1,1,0,1,1,143,142,132,132,92
"8077",76,"[26]kyHHoIoHcosHnJHGqKCxuxhect",284,0.996491,26,285,1,284,1,1,0,1,1,153,152,132,132,92
"8078",77,"[26]kyHHoIoHcosHnJHGqKCxuxhect",275,0.996377,26,276,1,275,1,1,0,1,1,130,129,146,146,92
"8079",78,"[26]kyHHoIoHcosHnJHGqKCxuxhect",279,0.996429,26,280,1,279,1,1,0,1,1,139,138,141,141,92
"8080",79,"[26]kyHHoIoHcosHnJHGqKCxuxhect",271,0.996324,26,272,1,271,1,1,0,1,1,125,124,147,147,92
"8081",80,"[26]kyHHoIoHcosHnJHGqKCxuxhect",288,0.99654,26,289,1,288,1,1,0,1,1,149,148,140,140,92
"8082",81,"[26]kyHHoIoHcosHnJHGqKCxuxhect",272,0.996337,26,273,1,272,1,1,0,1,1,134,133,139,139,92
"8083",82,"[26]kyHHoIoHcosHnJHGqKCxuxhect",277,0.996403,26,278,1,277,1,1,0,1,1,137,136,141,141,92
"8084",83,"[26]kyHHoIoHcosHnJHGqKCxuxhect",274,0.996364,26,275,1,274,1,1,0,1,1,142,141,133,133,92
"8085",84,"[26]kyHHoIoHcosHnJHGqKCxuxhect",283,0.996479,26,284,1,283,1,1,0,1,1,140,139,144,144,92
"8086",85,"[26]kyHHoIoHcosHnJHGqKCxuxhect",279,0.996429,26,280,1,279,1,1,0,1,1,139,138,141,141,92
"8087",86,"[26]kyHHoIoHcosHnJHGqKCxuxhect",281,0.996454,26,282,1,281,1,1,0,1,1,130,129,152,152,92
"8088",87,"[26]kyHHoIoHcosHnJHGqKCxuxhect",283,0.996479,26,284,1,283,1,1,0,1,1,132,131,152,152,92
"8089",88,"[26]kyHHoIoHcosHnJHGqKCxuxhect",287,0.996528,26,288,1,287,1,1,0,1,1,146,145,142,142,92
"8090",89,"[26]kyHHoIoHcosHnJHGqKCxuxhect",275,0.996377,26,276,1,275,1,1,0,1,1,123,122,153,153,92
"8091",90,"[26]kyHHoIoHcosHnJHGqKCxuxhect",273,0.99635,26,274,1,273,1,1,0,1,1,130,129,144,144,92
"8092",91,"[26]kyHHoIoHcosHnJHGqKCxuxhect",282,0.996466,26,283,1,282,1,1,0,1,1,137,136,146,146,92
"8093",92,"[26]kyHHoIoHcosHnJHGqKCxuxhect",281,0.996454,26,282,1,281,1,1,0,1,1,145,144,137,137,92
"8094",93,"[26]kyHHoIoHcosHnJHGqKCxuxhect",272,0.996337,26,273,1,272,1,1,0,1,1,136,135,137,137,92
"8095",94,"[26]kyHHoIoHcosHnJHGqKCxuxhect",284,0.996491,26,285,1,284,1,1,0,1,1,144,143,141,141,92
"8096",95,"[26]kyHHoIoHcosHnJHGqKCxuxhect",282,0.996466,26,283,1,282,1,1,0,1,1,136,135,147,147,92
"8097",96,"[26]kyHHoIoHcosHnJHGqKCxuxhect",276,0.99639,26,277,1,276,1,1,0,1,1,145,144,132,132,92
"8098",97,"[26]kyHHoIoHcosHnJHGqKCxuxhect",270,0.99631,26,271,1,270,1,1,0,1,1,123,122,148,148,92
"8099",98,"[26]kyHHoIoHcosHnJHGqKCxuxhect",287,0.996528,26,288,1,287,1,1,0,1,1,156,155,132,132,92
"8100",99,"[26]kyHHoIoHcosHnJHGqKCxuxhect",264,0.996226,26,265,1,264,1,1,0,1,1,141,140,124,124,92
"8101",0,"[26]iHoIoHcouHnJqGKCKAzxfxxedK",297,0.996644,26,298,1,297,1,1,0,1,1,151,150,147,147,93
"8102",1,"[26]iHoIoHcouHnJqGKCKAzxfxxedK",302,0.9967,26,303,1,302,1,1,0,1,1,166,165,137,137,93
"8103",2,"[26]iHoIoHcouHnJqGKCKAzxfxxedK",291,0.996575,26,292,1,291,1,1,0,1,1,134,133,158,158,93
"8104",3,"[26]iHoIoHcouHnJqGKCKAzxfxxedK",296,0.996633,26,297,1,296,1,1,0,1,1,148,147,149,149,93
"8105",4,"[26]iHoIoHcouHnJqGKCKAzxfxxedK",302,0.9967,26,303,1,302,1,1,0,1,1,164,163,139,139,93
"8106",5,"[26]iHoIoHcouHnJqGKCKAzxfxxedK",296,0.996633,26,297,1,296,1,1,0,1,1,146,145,151,151,93
"8107",6,"[26]iHoIoHcouHnJqGKCKAzxfxxedK",303,0.996711,26,304,1,303,1,1,0,1,1,159,158,145,145,93
"8108",7,"[26]iHoIoHcouHnJqGKCKAzxfxxedK",298,0.996656,26,299,1,298,1,1,0,1,1,153,152,146,146,93
"8109",8,"[26]iHoIoHcouHnJqGKCKAzxfxxedK",296,0.996633,26,297,1,296,1,1,0,1,1,146,145,151,151,93
"8110",9,"[26]iHoIoHcouHnJqGKCKAzxfxxedK",295,0.996622,26,296,1,295,1,1,0,1,1,144,143,152,152,93
"8111",10,"[26]iHoIoHcouHnJqGKCKAzxfxxedK",296,0.996633,26,297,1,296,1,1,0,1,1,148,147,149,149,93
"8112",11,"[26]iHoIoHcouHnJqGKCKAzxfxxedK",295,0.996622,26,296,1,295,1,1,0,1,1,151,150,145,145,93
"8113",12,"[26]iHoIoHcouHnJqGKCKAzxfxxedK",295,0.996622,26,296,1,295,1,1,0,1,1,146,145,150,150,93
"8114",13,"[26]iHoIoHcouHnJqGKCKAzxfxxedK",294,0.99661,26,295,1,294,1,1,0,1,1,146,145,149,149,93
"8115",14,"[26]iHoIoHcouHnJqGKCKAzxfxxedK",296,0.996633,26,297,1,296,1,1,0,1,1,143,142,154,154,93
"8116",15,"[26]iHoIoHcouHnJqGKCKAzxfxxedK",303,0.996711,26,304,1,303,1,1,0,1,1,168,167,136,136,93
"8117",16,"[26]iHoIoHcouHnJqGKCKAzxfxxedK",288,0.99654,26,289,1,288,1,1,0,1,1,134,133,155,155,93
"8118",17,"[26]iHoIoHcouHnJqGKCKAzxfxxedK",299,0.996667,26,300,1,299,1,1,0,1,1,160,159,140,140,93
"8119",18,"[26]iHoIoHcouHnJqGKCKAzxfxxedK",300,0.996678,26,301,1,300,1,1,0,1,1,162,161,139,139,93
"8120",19,"[26]iHoIoHcouHnJqGKCKAzxfxxedK",298,0.996656,26,299,1,298,1,1,0,1,1,151,150,148,148,93
"8121",20,"[26]iHoIoHcouHnJqGKCKAzxfxxedK",300,0.996678,26,301,1,300,1,1,0,1,1,163,162,138,138,93
"8122",21,"[26]iHoIoHcouHnJqGKCKAzxfxxedK",289,0.996552,26,290,1,289,1,1,0,1,1,135,134,155,155,93
"8123",22,"[26]iHoIoHcouHnJqGKCKAzxfxxedK",297,0.996644,26,298,1,297,1,1,0,1,1,152,151,146,146,93
"8124",23,"[26]iHoIoHcouHnJqGKCKAzxfxxedK",297,0.996644,26,298,1,297,1,1,0,1,1,149,148,149,149,93
"8125",24,"[26]iHoIoHcouHnJqGKCKAzxfxxedK",284,0.996491,26,285,1,284,1,1,0,1,1,121,120,164,164,93
"8126",25,"[26]iHoIoHcouHnJqGKCKAzxfxxedK",296,0.996633,26,297,1,296,1,1,0,1,1,150,149,147,147,93
"8127",26,"[26]iHoIoHcouHnJqGKCKAzxfxxedK",299,0.996667,26,300,1,299,1,1,0,1,1,158,157,142,142,93
"8128",27,"[26]iHoIoHcouHnJqGKCKAzxfxxedK",295,0.996622,26,296,1,295,1,1,0,1,1,142,141,154,154,93
"8129",28,"[26]iHoIoHcouHnJqGKCKAzxfxxedK",291,0.996575,26,292,1,291,1,1,0,1,1,137,136,155,155,93
"8130",29,"[26]iHoIoHcouHnJqGKCKAzxfxxedK",297,0.996644,26,298,1,297,1,1,0,1,1,153,152,145,145,93
"8131",30,"[26]iHoIoHcouHnJqGKCKAzxfxxedK",301,0.996689,26,302,1,301,1,1,0,1,1,162,161,140,140,93
"8132",31,"[26]iHoIoHcouHnJqGKCKAzxfxxedK",294,0.99661,26,295,1,294,1,1,0,1,1,142,141,153,153,93
"8133",32,"[26]iHoIoHcouHnJqGKCKAzxfxxedK",292,0.996587,26,293,1,292,1,1,0,1,1,140,139,153,153,93
"8134",33,"[26]iHoIoHcouHnJqGKCKAzxfxxedK",298,0.996656,26,299,1,298,1,1,0,1,1,156,155,143,143,93
"8135",34,"[26]iHoIoHcouHnJqGKCKAzxfxxedK",286,0.996516,26,287,1,286,1,1,0,1,1,138,137,149,149,93
"8136",35,"[26]iHoIoHcouHnJqGKCKAzxfxxedK",294,0.99661,26,295,1,294,1,1,0,1,1,146,145,149,149,93
"8137",36,"[26]iHoIoHcouHnJqGKCKAzxfxxedK",294,0.99661,26,295,1,294,1,1,0,1,1,140,139,155,155,93
"8138",37,"[26]iHoIoHcouHnJqGKCKAzxfxxedK",301,0.996689,26,302,1,301,1,1,0,1,1,164,163,138,138,93
"8139",38,"[26]iHoIoHcouHnJqGKCKAzxfxxedK",300,0.996678,26,301,1,300,1,1,0,1,1,159,158,142,142,93
"8140",39,"[26]iHoIoHcouHnJqGKCKAzxfxxedK",296,0.996633,26,297,1,296,1,1,0,1,1,145,144,152,152,93
"8141",40,"[26]iHoIoHcouHnJqGKCKAzxfxxedK",296,0.996633,26,297,1,296,1,1,0,1,1,149,148,148,148,93
"8142",41,"[26]iHoIoHcouHnJqGKCKAzxfxxedK",289,0.996552,26,290,1,289,1,1,0,1,1,146,145,144,144,93
"8143",42,"[26]iHoIoHcouHnJqGKCKAzxfxxedK",292,0.996587,26,293,1,292,1,1,0,1,1,147,146,146,146,93
"8144",43,"[26]iHoIoHcouHnJqGKCKAzxfxxedK",295,0.996622,26,296,1,295,1,1,0,1,1,149,148,147,147,93
"8145",44,"[26]iHoIoHcouHnJqGKCKAzxfxxedK",292,0.996587,26,293,1,292,1,1,0,1,1,139,138,154,154,93
"8146",45,"[26]iHoIoHcouHnJqGKCKAzxfxxedK",298,0.996656,26,299,1,298,1,1,0,1,1,151,150,148,148,93
"8147",46,"[26]iHoIoHcouHnJqGKCKAzxfxxedK",299,0.996667,26,300,1,299,1,1,0,1,1,154,153,146,146,93
"8148",47,"[26]iHoIoHcouHnJqGKCKAzxfxxedK",294,0.99661,26,295,1,294,1,1,0,1,1,148,147,147,147,93
"8149",48,"[26]iHoIoHcouHnJqGKCKAzxfxxedK",294,0.99661,26,295,1,294,1,1,0,1,1,149,148,146,146,93
"8150",49,"[26]iHoIoHcouHnJqGKCKAzxfxxedK",299,0.996667,26,300,1,299,1,1,0,1,1,155,154,145,145,93
"8151",50,"[26]iHoIoHcouHnJqGKCKAzxfxxedK",296,0.996633,26,297,1,296,1,1,0,1,1,153,152,144,144,93
"8152",51,"[26]iHoIoHcouHnJqGKCKAzxfxxedK",300,0.996678,26,301,1,300,1,1,0,1,1,160,159,141,141,93
"8153",52,"[26]iHoIoHcouHnJqGKCKAzxfxxedK",293,0.996599,26,294,1,293,1,1,0,1,1,134,133,160,160,93
"8154",53,"[26]iHoIoHcouHnJqGKCKAzxfxxedK",294,0.99661,26,295,1,294,1,1,0,1,1,145,144,150,150,93
"8155",54,"[26]iHoIoHcouHnJqGKCKAzxfxxedK",286,0.996516,26,287,1,286,1,1,0,1,1,142,141,145,145,93
"8156",55,"[26]iHoIoHcouHnJqGKCKAzxfxxedK",294,0.99661,26,295,1,294,1,1,0,1,1,141,140,154,154,93
"8157",56,"[26]iHoIoHcouHnJqGKCKAzxfxxedK",294,0.99661,26,295,1,294,1,1,0,1,1,137,136,158,158,93
"8158",57,"[26]iHoIoHcouHnJqGKCKAzxfxxedK",301,0.996689,26,302,1,301,1,1,0,1,1,158,157,144,144,93
"8159",58,"[26]iHoIoHcouHnJqGKCKAzxfxxedK",303,0.996711,26,304,1,303,1,1,0,1,1,169,168,135,135,93
"8160",59,"[26]iHoIoHcouHnJqGKCKAzxfxxedK",299,0.996667,26,300,1,299,1,1,0,1,1,155,154,145,145,93
"8161",60,"[26]iHoIoHcouHnJqGKCKAzxfxxedK",299,0.996667,26,300,1,299,1,1,0,1,1,161,160,139,139,93
"8162",61,"[26]iHoIoHcouHnJqGKCKAzxfxxedK",290,0.996564,26,291,1,290,1,1,0,1,1,131,130,160,160,93
"8163",62,"[26]iHoIoHcouHnJqGKCKAzxfxxedK",302,0.9967,26,303,1,302,1,1,0,1,1,167,166,136,136,93
"8164",63,"[26]iHoIoHcouHnJqGKCKAzxfxxedK",296,0.996633,26,297,1,296,1,1,0,1,1,157,156,140,140,93
"8165",64,"[26]iHoIoHcouHnJqGKCKAzxfxxedK",291,0.996575,26,292,1,291,1,1,0,1,1,137,136,155,155,93
"8166",65,"[26]iHoIoHcouHnJqGKCKAzxfxxedK",292,0.996587,26,293,1,292,1,1,0,1,1,143,142,150,150,93
"8167",66,"[26]iHoIoHcouHnJqGKCKAzxfxxedK",289,0.996552,26,290,1,289,1,1,0,1,1,135,134,155,155,93
"8168",67,"[26]iHoIoHcouHnJqGKCKAzxfxxedK",299,0.996667,26,300,1,299,1,1,0,1,1,158,157,142,142,93
"8169",68,"[26]iHoIoHcouHnJqGKCKAzxfxxedK",294,0.99661,26,295,1,294,1,1,0,1,1,147,146,148,148,93
"8170",69,"[26]iHoIoHcouHnJqGKCKAzxfxxedK",295,0.996622,26,296,1,295,1,1,0,1,1,147,146,149,149,93
"8171",70,"[26]iHoIoHcouHnJqGKCKAzxfxxedK",290,0.996564,26,291,1,290,1,1,0,1,1,140,139,151,151,93
"8172",71,"[26]iHoIoHcouHnJqGKCKAzxfxxedK",293,0.996599,26,294,1,293,1,1,0,1,1,139,138,155,155,93
"8173",72,"[26]iHoIoHcouHnJqGKCKAzxfxxedK",295,0.996622,26,296,1,295,1,1,0,1,1,149,148,147,147,93
"8174",73,"[26]iHoIoHcouHnJqGKCKAzxfxxedK",307,0.996753,26,308,1,307,1,1,0,1,1,173,172,135,135,93
"8175",74,"[26]iHoIoHcouHnJqGKCKAzxfxxedK",295,0.996622,26,296,1,295,1,1,0,1,1,139,138,157,157,93
"8176",75,"[26]iHoIoHcouHnJqGKCKAzxfxxedK",295,0.996622,26,296,1,295,1,1,0,1,1,145,144,151,151,93
"8177",76,"[26]iHoIoHcouHnJqGKCKAzxfxxedK",294,0.99661,26,295,1,294,1,1,0,1,1,144,143,151,151,93
"8178",77,"[26]iHoIoHcouHnJqGKCKAzxfxxedK",293,0.996599,26,294,1,293,1,1,0,1,1,140,139,154,154,93
"8179",78,"[26]iHoIoHcouHnJqGKCKAzxfxxedK",296,0.996633,26,297,1,296,1,1,0,1,1,145,144,152,152,93
"8180",79,"[26]iHoIoHcouHnJqGKCKAzxfxxedK",292,0.996587,26,293,1,292,1,1,0,1,1,135,134,158,158,93
"8181",80,"[26]iHoIoHcouHnJqGKCKAzxfxxedK",300,0.996678,26,301,1,300,1,1,0,1,1,159,158,142,142,93
"8182",81,"[26]iHoIoHcouHnJqGKCKAzxfxxedK",291,0.996575,26,292,1,291,1,1,0,1,1,135,134,157,157,93
"8183",82,"[26]iHoIoHcouHnJqGKCKAzxfxxedK",298,0.996656,26,299,1,298,1,1,0,1,1,164,163,135,135,93
"8184",83,"[26]iHoIoHcouHnJqGKCKAzxfxxedK",302,0.9967,26,303,1,302,1,1,0,1,1,166,165,137,137,93
"8185",84,"[26]iHoIoHcouHnJqGKCKAzxfxxedK",291,0.996575,26,292,1,291,1,1,0,1,1,132,131,160,160,93
"8186",85,"[26]iHoIoHcouHnJqGKCKAzxfxxedK",295,0.996622,26,296,1,295,1,1,0,1,1,149,148,147,147,93
"8187",86,"[26]iHoIoHcouHnJqGKCKAzxfxxedK",297,0.996644,26,298,1,297,1,1,0,1,1,150,149,148,148,93
"8188",87,"[26]iHoIoHcouHnJqGKCKAzxfxxedK",296,0.996633,26,297,1,296,1,1,0,1,1,154,153,143,143,93
"8189",88,"[26]iHoIoHcouHnJqGKCKAzxfxxedK",295,0.996622,26,296,1,295,1,1,0,1,1,144,143,152,152,93
"8190",89,"[26]iHoIoHcouHnJqGKCKAzxfxxedK",293,0.996599,26,294,1,293,1,1,0,1,1,145,144,149,149,93
"8191",90,"[26]iHoIoHcouHnJqGKCKAzxfxxedK",302,0.9967,26,303,1,302,1,1,0,1,1,166,165,137,137,93
"8192",91,"[26]iHoIoHcouHnJqGKCKAzxfxxedK",294,0.99661,26,295,1,294,1,1,0,1,1,142,141,153,153,93
"8193",92,"[26]iHoIoHcouHnJqGKCKAzxfxxedK",302,0.9967,26,303,1,302,1,1,0,1,1,165,164,138,138,93
"8194",93,"[26]iHoIoHcouHnJqGKCKAzxfxxedK",299,0.996667,26,300,1,299,1,1,0,1,1,157,156,143,143,93
"8195",94,"[26]iHoIoHcouHnJqGKCKAzxfxxedK",297,0.996644,26,298,1,297,1,1,0,1,1,151,150,147,147,93
"8196",95,"[26]iHoIoHcouHnJqGKCKAzxfxxedK",292,0.996587,26,293,1,292,1,1,0,1,1,139,138,154,154,93
"8197",96,"[26]iHoIoHcouHnJqGKCKAzxfxxedK",296,0.996633,26,297,1,296,1,1,0,1,1,147,146,150,150,93
"8198",97,"[26]iHoIoHcouHnJqGKCKAzxfxxedK",291,0.996575,26,292,1,291,1,1,0,1,1,134,133,158,158,93
"8199",98,"[26]iHoIoHcouHnJqGKCKAzxfxxedK",294,0.99661,26,295,1,294,1,1,0,1,1,148,147,147,147,93
"8200",99,"[26]iHoIoHcouHnJqGKCKAzxfxxedK",295,0.996622,26,296,1,295,1,1,0,1,1,143,142,153,153,93
"8201",0,"[24]HoIEoHcowHnJHGqKCBmEAmmB",287,0.996528,24,288,1,287,1,1,0,1,1,145,144,143,143,94
"8202",1,"[24]HoIEoHcowHnJHGqKCBmEAmmB",280,0.996441,24,281,1,280,1,1,0,1,1,142,141,139,139,94
"8203",2,"[24]HoIEoHcowHnJHGqKCBmEAmmB",282,0.996466,24,283,1,282,1,1,0,1,1,142,141,141,141,94
"8204",3,"[24]HoIEoHcowHnJHGqKCBmEAmmB",278,0.996416,24,279,1,278,1,1,0,1,1,136,135,143,143,94
"8205",4,"[24]HoIEoHcowHnJHGqKCBmEAmmB",286,0.996516,24,287,1,286,1,1,0,1,1,138,137,149,149,94
"8206",5,"[24]HoIEoHcowHnJHGqKCBmEAmmB",282,0.996466,24,283,1,282,1,1,0,1,1,140,139,143,143,94
"8207",6,"[24]HoIEoHcowHnJHGqKCBmEAmmB",288,0.99654,24,289,1,288,1,1,0,1,1,155,154,134,134,94
"8208",7,"[24]HoIEoHcowHnJHGqKCBmEAmmB",278,0.996416,24,279,1,278,1,1,0,1,1,134,133,145,145,94
"8209",8,"[24]HoIEoHcowHnJHGqKCBmEAmmB",287,0.996528,24,288,1,287,1,1,0,1,1,154,153,134,134,94
"8210",9,"[24]HoIEoHcowHnJHGqKCBmEAmmB",272,0.996337,24,273,1,272,1,1,0,1,1,123,122,150,150,94
"8211",10,"[24]HoIEoHcowHnJHGqKCBmEAmmB",277,0.996403,24,278,1,277,1,1,0,1,1,133,132,145,145,94
"8212",11,"[24]HoIEoHcowHnJHGqKCBmEAmmB",281,0.996454,24,282,1,281,1,1,0,1,1,147,146,135,135,94
"8213",12,"[24]HoIEoHcowHnJHGqKCBmEAmmB",280,0.996441,24,281,1,280,1,1,0,1,1,139,138,142,142,94
"8214",13,"[24]HoIEoHcowHnJHGqKCBmEAmmB",281,0.996454,24,282,1,281,1,1,0,1,1,125,124,157,157,94
"8215",14,"[24]HoIEoHcowHnJHGqKCBmEAmmB",279,0.996429,24,280,1,279,1,1,0,1,1,146,145,134,134,94
"8216",15,"[24]HoIEoHcowHnJHGqKCBmEAmmB",280,0.996441,24,281,1,280,1,1,0,1,1,144,143,137,137,94
"8217",16,"[24]HoIEoHcowHnJHGqKCBmEAmmB",278,0.996416,24,279,1,278,1,1,0,1,1,132,131,147,147,94
"8218",17,"[24]HoIEoHcowHnJHGqKCBmEAmmB",280,0.996441,24,281,1,280,1,1,0,1,1,145,144,136,136,94
"8219",18,"[24]HoIEoHcowHnJHGqKCBmEAmmB",291,0.996575,24,292,1,291,1,1,0,1,1,144,143,148,148,94
"8220",19,"[24]HoIEoHcowHnJHGqKCBmEAmmB",283,0.996479,24,284,1,283,1,1,0,1,1,146,145,138,138,94
"8221",20,"[24]HoIEoHcowHnJHGqKCBmEAmmB",279,0.996429,24,280,1,279,1,1,0,1,1,137,136,143,143,94
"8222",21,"[24]HoIEoHcowHnJHGqKCBmEAmmB",290,0.996564,24,291,1,290,1,1,0,1,1,152,151,139,139,94
"8223",22,"[24]HoIEoHcowHnJHGqKCBmEAmmB",277,0.996403,24,278,1,277,1,1,0,1,1,129,128,149,149,94
"8224",23,"[24]HoIEoHcowHnJHGqKCBmEAmmB",279,0.996429,24,280,1,279,1,1,0,1,1,143,142,137,137,94
"8225",24,"[24]HoIEoHcowHnJHGqKCBmEAmmB",282,0.996466,24,283,1,282,1,1,0,1,1,130,129,153,153,94
"8226",25,"[24]HoIEoHcowHnJHGqKCBmEAmmB",279,0.996429,24,280,1,279,1,1,0,1,1,127,126,153,153,94
"8227",26,"[24]HoIEoHcowHnJHGqKCBmEAmmB",285,0.996503,24,286,1,285,1,1,0,1,1,150,149,136,136,94
"8228",27,"[24]HoIEoHcowHnJHGqKCBmEAmmB",282,0.996466,24,283,1,282,1,1,0,1,1,158,157,125,125,94
"8229",28,"[24]HoIEoHcowHnJHGqKCBmEAmmB",278,0.996416,24,279,1,278,1,1,0,1,1,147,146,132,132,94
"8230",29,"[24]HoIEoHcowHnJHGqKCBmEAmmB",283,0.996479,24,284,1,283,1,1,0,1,1,155,154,129,129,94
"8231",30,"[24]HoIEoHcowHnJHGqKCBmEAmmB",284,0.996491,24,285,1,284,1,1,0,1,1,141,140,144,144,94
"8232",31,"[24]HoIEoHcowHnJHGqKCBmEAmmB",281,0.996454,24,282,1,281,1,1,0,1,1,133,132,149,149,94
"8233",32,"[24]HoIEoHcowHnJHGqKCBmEAmmB",281,0.996454,24,282,1,281,1,1,0,1,1,141,140,141,141,94
"8234",33,"[24]HoIEoHcowHnJHGqKCBmEAmmB",287,0.996528,24,288,1,287,1,1,0,1,1,153,152,135,135,94
"8235",34,"[24]HoIEoHcowHnJHGqKCBmEAmmB",284,0.996491,24,285,1,284,1,1,0,1,1,137,136,148,148,94
"8236",35,"[24]HoIEoHcowHnJHGqKCBmEAmmB",282,0.996466,24,283,1,282,1,1,0,1,1,151,150,132,132,94
"8237",36,"[24]HoIEoHcowHnJHGqKCBmEAmmB",281,0.996454,24,282,1,281,1,1,0,1,1,127,126,155,155,94
"8238",37,"[24]HoIEoHcowHnJHGqKCBmEAmmB",279,0.996429,24,280,1,279,1,1,0,1,1,132,131,148,148,94
"8239",38,"[24]HoIEoHcowHnJHGqKCBmEAmmB",271,0.996324,24,272,1,271,1,1,0,1,1,135,134,137,137,94
"8240",39,"[24]HoIEoHcowHnJHGqKCBmEAmmB",286,0.996516,24,287,1,286,1,1,0,1,1,141,140,146,146,94
"8241",40,"[24]HoIEoHcowHnJHGqKCBmEAmmB",280,0.996441,24,281,1,280,1,1,0,1,1,144,143,137,137,94
"8242",41,"[24]HoIEoHcowHnJHGqKCBmEAmmB",284,0.996491,24,285,1,284,1,1,0,1,1,138,137,147,147,94
"8243",42,"[24]HoIEoHcowHnJHGqKCBmEAmmB",274,0.996364,24,275,1,274,1,1,0,1,1,117,116,158,158,94
"8244",43,"[24]HoIEoHcowHnJHGqKCBmEAmmB",284,0.996491,24,285,1,284,1,1,0,1,1,133,132,152,152,94
"8245",44,"[24]HoIEoHcowHnJHGqKCBmEAmmB",282,0.996466,24,283,1,282,1,1,0,1,1,139,138,144,144,94
"8246",45,"[24]HoIEoHcowHnJHGqKCBmEAmmB",278,0.996416,24,279,1,278,1,1,0,1,1,124,123,155,155,94
"8247",46,"[24]HoIEoHcowHnJHGqKCBmEAmmB",288,0.99654,24,289,1,288,1,1,0,1,1,159,158,130,130,94
"8248",47,"[24]HoIEoHcowHnJHGqKCBmEAmmB",280,0.996441,24,281,1,280,1,1,0,1,1,137,136,144,144,94
"8249",48,"[24]HoIEoHcowHnJHGqKCBmEAmmB",287,0.996528,24,288,1,287,1,1,0,1,1,143,142,145,145,94
"8250",49,"[24]HoIEoHcowHnJHGqKCBmEAmmB",282,0.996466,24,283,1,282,1,1,0,1,1,145,144,138,138,94
"8251",50,"[24]HoIEoHcowHnJHGqKCBmEAmmB",282,0.996466,24,283,1,282,1,1,0,1,1,133,132,150,150,94
"8252",51,"[24]HoIEoHcowHnJHGqKCBmEAmmB",287,0.996528,24,288,1,287,1,1,0,1,1,153,152,135,135,94
"8253",52,"[24]HoIEoHcowHnJHGqKCBmEAmmB",278,0.996416,24,279,1,278,1,1,0,1,1,137,136,142,142,94
"8254",53,"[24]HoIEoHcowHnJHGqKCBmEAmmB",284,0.996491,24,285,1,284,1,1,0,1,1,142,141,143,143,94
"8255",54,"[24]HoIEoHcowHnJHGqKCBmEAmmB",282,0.996466,24,283,1,282,1,1,0,1,1,158,157,125,125,94
"8256",55,"[24]HoIEoHcowHnJHGqKCBmEAmmB",289,0.996552,24,290,1,289,1,1,0,1,1,153,152,137,137,94
"8257",56,"[24]HoIEoHcowHnJHGqKCBmEAmmB",270,0.99631,24,271,1,270,1,1,0,1,1,119,118,152,152,94
"8258",57,"[24]HoIEoHcowHnJHGqKCBmEAmmB",279,0.996429,24,280,1,279,1,1,0,1,1,137,136,143,143,94
"8259",58,"[24]HoIEoHcowHnJHGqKCBmEAmmB",280,0.996441,24,281,1,280,1,1,0,1,1,149,148,132,132,94
"8260",59,"[24]HoIEoHcowHnJHGqKCBmEAmmB",281,0.996454,24,282,1,281,1,1,0,1,1,134,133,148,148,94
"8261",60,"[24]HoIEoHcowHnJHGqKCBmEAmmB",288,0.99654,24,289,1,288,1,1,0,1,1,146,145,143,143,94
"8262",61,"[24]HoIEoHcowHnJHGqKCBmEAmmB",277,0.996403,24,278,1,277,1,1,0,1,1,142,141,136,136,94
"8263",62,"[24]HoIEoHcowHnJHGqKCBmEAmmB",280,0.996441,24,281,1,280,1,1,0,1,1,142,141,139,139,94
"8264",63,"[24]HoIEoHcowHnJHGqKCBmEAmmB",287,0.996528,24,288,1,287,1,1,0,1,1,151,150,137,137,94
"8265",64,"[24]HoIEoHcowHnJHGqKCBmEAmmB",282,0.996466,24,283,1,282,1,1,0,1,1,135,134,148,148,94
"8266",65,"[24]HoIEoHcowHnJHGqKCBmEAmmB",286,0.996516,24,287,1,286,1,1,0,1,1,157,156,130,130,94
"8267",66,"[24]HoIEoHcowHnJHGqKCBmEAmmB",275,0.996377,24,276,1,275,1,1,0,1,1,129,128,147,147,94
"8268",67,"[24]HoIEoHcowHnJHGqKCBmEAmmB",286,0.996516,24,287,1,286,1,1,0,1,1,159,158,128,128,94
"8269",68,"[24]HoIEoHcowHnJHGqKCBmEAmmB",284,0.996491,24,285,1,284,1,1,0,1,1,147,146,138,138,94
"8270",69,"[24]HoIEoHcowHnJHGqKCBmEAmmB",284,0.996491,24,285,1,284,1,1,0,1,1,147,146,138,138,94
"8271",70,"[24]HoIEoHcowHnJHGqKCBmEAmmB",273,0.99635,24,274,1,273,1,1,0,1,1,122,121,152,152,94
"8272",71,"[24]HoIEoHcowHnJHGqKCBmEAmmB",280,0.996441,24,281,1,280,1,1,0,1,1,133,132,148,148,94
"8273",72,"[24]HoIEoHcowHnJHGqKCBmEAmmB",289,0.996552,24,290,1,289,1,1,0,1,1,150,149,140,140,94
"8274",73,"[24]HoIEoHcowHnJHGqKCBmEAmmB",280,0.996441,24,281,1,280,1,1,0,1,1,127,126,154,154,94
"8275",74,"[24]HoIEoHcowHnJHGqKCBmEAmmB",290,0.996564,24,291,1,290,1,1,0,1,1,164,163,127,127,94
"8276",75,"[24]HoIEoHcowHnJHGqKCBmEAmmB",281,0.996454,24,282,1,281,1,1,0,1,1,144,143,138,138,94
"8277",76,"[24]HoIEoHcowHnJHGqKCBmEAmmB",287,0.996528,24,288,1,287,1,1,0,1,1,145,144,143,143,94
"8278",77,"[24]HoIEoHcowHnJHGqKCBmEAmmB",275,0.996377,24,276,1,275,1,1,0,1,1,123,122,153,153,94
"8279",78,"[24]HoIEoHcowHnJHGqKCBmEAmmB",286,0.996516,24,287,1,286,1,1,0,1,1,138,137,149,149,94
"8280",79,"[24]HoIEoHcowHnJHGqKCBmEAmmB",280,0.996441,24,281,1,280,1,1,0,1,1,127,126,154,154,94
"8281",80,"[24]HoIEoHcowHnJHGqKCBmEAmmB",282,0.996466,24,283,1,282,1,1,0,1,1,144,143,139,139,94
"8282",81,"[24]HoIEoHcowHnJHGqKCBmEAmmB",279,0.996429,24,280,1,279,1,1,0,1,1,143,142,137,137,94
"8283",82,"[24]HoIEoHcowHnJHGqKCBmEAmmB",281,0.996454,24,282,1,281,1,1,0,1,1,146,145,136,136,94
"8284",83,"[24]HoIEoHcowHnJHGqKCBmEAmmB",278,0.996416,24,279,1,278,1,1,0,1,1,141,140,138,138,94
"8285",84,"[24]HoIEoHcowHnJHGqKCBmEAmmB",277,0.996403,24,278,1,277,1,1,0,1,1,146,145,132,132,94
"8286",85,"[24]HoIEoHcowHnJHGqKCBmEAmmB",281,0.996454,24,282,1,281,1,1,0,1,1,149,148,133,133,94
"8287",86,"[24]HoIEoHcowHnJHGqKCBmEAmmB",285,0.996503,24,286,1,285,1,1,0,1,1,144,143,142,142,94
"8288",87,"[24]HoIEoHcowHnJHGqKCBmEAmmB",276,0.99639,24,277,1,276,1,1,0,1,1,130,129,147,147,94
"8289",88,"[24]HoIEoHcowHnJHGqKCBmEAmmB",282,0.996466,24,283,1,282,1,1,0,1,1,148,147,135,135,94
"8290",89,"[24]HoIEoHcowHnJHGqKCBmEAmmB",289,0.996552,24,290,1,289,1,1,0,1,1,153,152,137,137,94
"8291",90,"[24]HoIEoHcowHnJHGqKCBmEAmmB",278,0.996416,24,279,1,278,1,1,0,1,1,154,153,125,125,94
"8292",91,"[24]HoIEoHcowHnJHGqKCBmEAmmB",281,0.996454,24,282,1,281,1,1,0,1,1,145,144,137,137,94
"8293",92,"[24]HoIEoHcowHnJHGqKCBmEAmmB",286,0.996516,24,287,1,286,1,1,0,1,1,147,146,140,140,94
"8294",93,"[24]HoIEoHcowHnJHGqKCBmEAmmB",281,0.996454,24,282,1,281,1,1,0,1,1,156,155,126,126,94
"8295",94,"[24]HoIEoHcowHnJHGqKCBmEAmmB",292,0.996587,24,293,1,292,1,1,0,1,1,139,138,154,154,94
"8296",95,"[24]HoIEoHcowHnJHGqKCBmEAmmB",283,0.996479,24,284,1,283,1,1,0,1,1,144,143,140,140,94
"8297",96,"[24]HoIEoHcowHnJHGqKCBmEAmmB",274,0.996364,24,275,1,274,1,1,0,1,1,130,129,145,145,94
"8298",97,"[24]HoIEoHcowHnJHGqKCBmEAmmB",274,0.996364,24,275,1,274,1,1,0,1,1,120,119,155,155,94
"8299",98,"[24]HoIEoHcowHnJHGqKCBmEAmmB",287,0.996528,24,288,1,287,1,1,0,1,1,151,150,137,137,94
"8300",99,"[24]HoIEoHcowHnJHGqKCBmEAmmB",284,0.996491,24,285,1,284,1,1,0,1,1,133,132,152,152,94
"8301",0,"[25]ioIoHcosHnJHGqKCvFkgqeiah",277,0.996403,25,278,1,277,1,1,0,1,1,133,132,145,145,95
"8302",1,"[25]ioIoHcosHnJHGqKCvFkgqeiah",276,0.99639,25,277,1,276,1,1,0,1,1,138,137,139,139,95
"8303",2,"[25]ioIoHcosHnJHGqKCvFkgqeiah",288,0.99654,25,289,1,288,1,1,0,1,1,150,149,139,139,95
"8304",3,"[25]ioIoHcosHnJHGqKCvFkgqeiah",293,0.996599,25,294,1,293,1,1,0,1,1,146,145,148,148,95
"8305",4,"[25]ioIoHcosHnJHGqKCvFkgqeiah",287,0.996528,25,288,1,287,1,1,0,1,1,139,138,149,149,95
"8306",5,"[25]ioIoHcosHnJHGqKCvFkgqeiah",283,0.996479,25,284,1,283,1,1,0,1,1,141,140,143,143,95
"8307",6,"[25]ioIoHcosHnJHGqKCvFkgqeiah",277,0.996403,25,278,1,277,1,1,0,1,1,150,149,128,128,95
"8308",7,"[25]ioIoHcosHnJHGqKCvFkgqeiah",283,0.996479,25,284,1,283,1,1,0,1,1,147,146,137,137,95
"8309",8,"[25]ioIoHcosHnJHGqKCvFkgqeiah",281,0.996454,25,282,1,281,1,1,0,1,1,148,147,134,134,95
"8310",9,"[25]ioIoHcosHnJHGqKCvFkgqeiah",294,0.99661,25,295,1,294,1,1,0,1,1,159,158,136,136,95
"8311",10,"[25]ioIoHcosHnJHGqKCvFkgqeiah",284,0.996491,25,285,1,284,1,1,0,1,1,149,148,136,136,95
"8312",11,"[25]ioIoHcosHnJHGqKCvFkgqeiah",281,0.996454,25,282,1,281,1,1,0,1,1,143,142,139,139,95
"8313",12,"[25]ioIoHcosHnJHGqKCvFkgqeiah",285,0.996503,25,286,1,285,1,1,0,1,1,154,153,132,132,95
"8314",13,"[25]ioIoHcosHnJHGqKCvFkgqeiah",273,0.99635,25,274,1,273,1,1,0,1,1,149,148,125,125,95
"8315",14,"[25]ioIoHcosHnJHGqKCvFkgqeiah",286,0.996516,25,287,1,286,1,1,0,1,1,149,148,138,138,95
"8316",15,"[25]ioIoHcosHnJHGqKCvFkgqeiah",276,0.99639,25,277,1,276,1,1,0,1,1,111,110,166,166,95
"8317",16,"[25]ioIoHcosHnJHGqKCvFkgqeiah",275,0.996377,25,276,1,275,1,1,0,1,1,140,139,136,136,95
"8318",17,"[25]ioIoHcosHnJHGqKCvFkgqeiah",276,0.99639,25,277,1,276,1,1,0,1,1,141,140,136,136,95
"8319",18,"[25]ioIoHcosHnJHGqKCvFkgqeiah",283,0.996479,25,284,1,283,1,1,0,1,1,145,144,139,139,95
"8320",19,"[25]ioIoHcosHnJHGqKCvFkgqeiah",280,0.996441,25,281,1,280,1,1,0,1,1,133,132,148,148,95
"8321",20,"[25]ioIoHcosHnJHGqKCvFkgqeiah",284,0.996491,25,285,1,284,1,1,0,1,1,140,139,145,145,95
"8322",21,"[25]ioIoHcosHnJHGqKCvFkgqeiah",283,0.996479,25,284,1,283,1,1,0,1,1,130,129,154,154,95
"8323",22,"[25]ioIoHcosHnJHGqKCvFkgqeiah",283,0.996479,25,284,1,283,1,1,0,1,1,141,140,143,143,95
"8324",23,"[25]ioIoHcosHnJHGqKCvFkgqeiah",285,0.996503,25,286,1,285,1,1,0,1,1,161,160,125,125,95
"8325",24,"[25]ioIoHcosHnJHGqKCvFkgqeiah",280,0.996441,25,281,1,280,1,1,0,1,1,146,145,135,135,95
"8326",25,"[25]ioIoHcosHnJHGqKCvFkgqeiah",281,0.996454,25,282,1,281,1,1,0,1,1,145,144,137,137,95
"8327",26,"[25]ioIoHcosHnJHGqKCvFkgqeiah",282,0.996466,25,283,1,282,1,1,0,1,1,138,137,145,145,95
"8328",27,"[25]ioIoHcosHnJHGqKCvFkgqeiah",281,0.996454,25,282,1,281,1,1,0,1,1,133,132,149,149,95
"8329",28,"[25]ioIoHcosHnJHGqKCvFkgqeiah",289,0.996552,25,290,1,289,1,1,0,1,1,163,162,127,127,95
"8330",29,"[25]ioIoHcosHnJHGqKCvFkgqeiah",277,0.996403,25,278,1,277,1,1,0,1,1,145,144,133,133,95
"8331",30,"[25]ioIoHcosHnJHGqKCvFkgqeiah",286,0.996516,25,287,1,286,1,1,0,1,1,141,140,146,146,95
"8332",31,"[25]ioIoHcosHnJHGqKCvFkgqeiah",286,0.996516,25,287,1,286,1,1,0,1,1,138,137,149,149,95
"8333",32,"[25]ioIoHcosHnJHGqKCvFkgqeiah",282,0.996466,25,283,1,282,1,1,0,1,1,149,148,134,134,95
"8334",33,"[25]ioIoHcosHnJHGqKCvFkgqeiah",280,0.996441,25,281,1,280,1,1,0,1,1,134,133,147,147,95
"8335",34,"[25]ioIoHcosHnJHGqKCvFkgqeiah",276,0.99639,25,277,1,276,1,1,0,1,1,151,150,126,126,95
"8336",35,"[25]ioIoHcosHnJHGqKCvFkgqeiah",290,0.996564,25,291,1,290,1,1,0,1,1,146,145,145,145,95
"8337",36,"[25]ioIoHcosHnJHGqKCvFkgqeiah",286,0.996516,25,287,1,286,1,1,0,1,1,141,140,146,146,95
"8338",37,"[25]ioIoHcosHnJHGqKCvFkgqeiah",284,0.996491,25,285,1,284,1,1,0,1,1,148,147,137,137,95
"8339",38,"[25]ioIoHcosHnJHGqKCvFkgqeiah",286,0.996516,25,287,1,286,1,1,0,1,1,150,149,137,137,95
"8340",39,"[25]ioIoHcosHnJHGqKCvFkgqeiah",284,0.996491,25,285,1,284,1,1,0,1,1,146,145,139,139,95
"8341",40,"[25]ioIoHcosHnJHGqKCvFkgqeiah",271,0.996324,25,272,1,271,1,1,0,1,1,134,133,138,138,95
"8342",41,"[25]ioIoHcosHnJHGqKCvFkgqeiah",281,0.996454,25,282,1,281,1,1,0,1,1,138,137,144,144,95
"8343",42,"[25]ioIoHcosHnJHGqKCvFkgqeiah",284,0.996491,25,285,1,284,1,1,0,1,1,150,149,135,135,95
"8344",43,"[25]ioIoHcosHnJHGqKCvFkgqeiah",270,0.99631,25,271,1,270,1,1,0,1,1,134,133,137,137,95
"8345",44,"[25]ioIoHcosHnJHGqKCvFkgqeiah",281,0.996454,25,282,1,281,1,1,0,1,1,141,140,141,141,95
"8346",45,"[25]ioIoHcosHnJHGqKCvFkgqeiah",285,0.996503,25,286,1,285,1,1,0,1,1,143,142,143,143,95
"8347",46,"[25]ioIoHcosHnJHGqKCvFkgqeiah",276,0.99639,25,277,1,276,1,1,0,1,1,140,139,137,137,95
"8348",47,"[25]ioIoHcosHnJHGqKCvFkgqeiah",283,0.996479,25,284,1,283,1,1,0,1,1,159,158,125,125,95
"8349",48,"[25]ioIoHcosHnJHGqKCvFkgqeiah",281,0.996454,25,282,1,281,1,1,0,1,1,130,129,152,152,95
"8350",49,"[25]ioIoHcosHnJHGqKCvFkgqeiah",280,0.996441,25,281,1,280,1,1,0,1,1,141,140,140,140,95
"8351",50,"[25]ioIoHcosHnJHGqKCvFkgqeiah",281,0.996454,25,282,1,281,1,1,0,1,1,127,126,155,155,95
"8352",51,"[25]ioIoHcosHnJHGqKCvFkgqeiah",277,0.996403,25,278,1,277,1,1,0,1,1,149,148,129,129,95
"8353",52,"[25]ioIoHcosHnJHGqKCvFkgqeiah",279,0.996429,25,280,1,279,1,1,0,1,1,139,138,141,141,95
"8354",53,"[25]ioIoHcosHnJHGqKCvFkgqeiah",280,0.996441,25,281,1,280,1,1,0,1,1,140,139,141,141,95
"8355",54,"[25]ioIoHcosHnJHGqKCvFkgqeiah",280,0.996441,25,281,1,280,1,1,0,1,1,137,136,144,144,95
"8356",55,"[25]ioIoHcosHnJHGqKCvFkgqeiah",279,0.996429,25,280,1,279,1,1,0,1,1,142,141,138,138,95
"8357",56,"[25]ioIoHcosHnJHGqKCvFkgqeiah",282,0.996466,25,283,1,282,1,1,0,1,1,145,144,138,138,95
"8358",57,"[25]ioIoHcosHnJHGqKCvFkgqeiah",283,0.996479,25,284,1,283,1,1,0,1,1,144,143,140,140,95
"8359",58,"[25]ioIoHcosHnJHGqKCvFkgqeiah",277,0.996403,25,278,1,277,1,1,0,1,1,140,139,138,138,95
"8360",59,"[25]ioIoHcosHnJHGqKCvFkgqeiah",279,0.996429,25,280,1,279,1,1,0,1,1,143,142,137,137,95
"8361",60,"[25]ioIoHcosHnJHGqKCvFkgqeiah",278,0.996416,25,279,1,278,1,1,0,1,1,136,135,143,143,95
"8362",61,"[25]ioIoHcosHnJHGqKCvFkgqeiah",289,0.996552,25,290,1,289,1,1,0,1,1,147,146,143,143,95
"8363",62,"[25]ioIoHcosHnJHGqKCvFkgqeiah",280,0.996441,25,281,1,280,1,1,0,1,1,142,141,139,139,95
"8364",63,"[25]ioIoHcosHnJHGqKCvFkgqeiah",291,0.996575,25,292,1,291,1,1,0,1,1,147,146,145,145,95
"8365",64,"[25]ioIoHcosHnJHGqKCvFkgqeiah",284,0.996491,25,285,1,284,1,1,0,1,1,144,143,141,141,95
"8366",65,"[25]ioIoHcosHnJHGqKCvFkgqeiah",289,0.996552,25,290,1,289,1,1,0,1,1,134,133,156,156,95
"8367",66,"[25]ioIoHcosHnJHGqKCvFkgqeiah",280,0.996441,25,281,1,280,1,1,0,1,1,133,132,148,148,95
"8368",67,"[25]ioIoHcosHnJHGqKCvFkgqeiah",281,0.996454,25,282,1,281,1,1,0,1,1,153,152,129,129,95
"8369",68,"[25]ioIoHcosHnJHGqKCvFkgqeiah",286,0.996516,25,287,1,286,1,1,0,1,1,144,143,143,143,95
"8370",69,"[25]ioIoHcosHnJHGqKCvFkgqeiah",286,0.996516,25,287,1,286,1,1,0,1,1,135,134,152,152,95
"8371",70,"[25]ioIoHcosHnJHGqKCvFkgqeiah",286,0.996516,25,287,1,286,1,1,0,1,1,153,152,134,134,95
"8372",71,"[25]ioIoHcosHnJHGqKCvFkgqeiah",279,0.996429,25,280,1,279,1,1,0,1,1,145,144,135,135,95
"8373",72,"[25]ioIoHcosHnJHGqKCvFkgqeiah",284,0.996491,25,285,1,284,1,1,0,1,1,134,133,151,151,95
"8374",73,"[25]ioIoHcosHnJHGqKCvFkgqeiah",278,0.996416,25,279,1,278,1,1,0,1,1,138,137,141,141,95
"8375",74,"[25]ioIoHcosHnJHGqKCvFkgqeiah",275,0.996377,25,276,1,275,1,1,0,1,1,133,132,143,143,95
"8376",75,"[25]ioIoHcosHnJHGqKCvFkgqeiah",282,0.996466,25,283,1,282,1,1,0,1,1,137,136,146,146,95
"8377",76,"[25]ioIoHcosHnJHGqKCvFkgqeiah",284,0.996491,25,285,1,284,1,1,0,1,1,153,152,132,132,95
"8378",77,"[25]ioIoHcosHnJHGqKCvFkgqeiah",285,0.996503,25,286,1,285,1,1,0,1,1,155,154,131,131,95
"8379",78,"[25]ioIoHcosHnJHGqKCvFkgqeiah",283,0.996479,25,284,1,283,1,1,0,1,1,155,154,129,129,95
"8380",79,"[25]ioIoHcosHnJHGqKCvFkgqeiah",285,0.996503,25,286,1,285,1,1,0,1,1,155,154,131,131,95
"8381",80,"[25]ioIoHcosHnJHGqKCvFkgqeiah",280,0.996441,25,281,1,280,1,1,0,1,1,135,134,146,146,95
"8382",81,"[25]ioIoHcosHnJHGqKCvFkgqeiah",277,0.996403,25,278,1,277,1,1,0,1,1,132,131,146,146,95
"8383",82,"[25]ioIoHcosHnJHGqKCvFkgqeiah",277,0.996403,25,278,1,277,1,1,0,1,1,144,143,134,134,95
"8384",83,"[25]ioIoHcosHnJHGqKCvFkgqeiah",285,0.996503,25,286,1,285,1,1,0,1,1,136,135,150,150,95
"8385",84,"[25]ioIoHcosHnJHGqKCvFkgqeiah",289,0.996552,25,290,1,289,1,1,0,1,1,139,138,151,151,95
"8386",85,"[25]ioIoHcosHnJHGqKCvFkgqeiah",283,0.996479,25,284,1,283,1,1,0,1,1,139,138,145,145,95
"8387",86,"[25]ioIoHcosHnJHGqKCvFkgqeiah",278,0.996416,25,279,1,278,1,1,0,1,1,139,138,140,140,95
"8388",87,"[25]ioIoHcosHnJHGqKCvFkgqeiah",284,0.996491,25,285,1,284,1,1,0,1,1,144,143,141,141,95
"8389",88,"[25]ioIoHcosHnJHGqKCvFkgqeiah",279,0.996429,25,280,1,279,1,1,0,1,1,139,138,141,141,95
"8390",89,"[25]ioIoHcosHnJHGqKCvFkgqeiah",280,0.996441,25,281,1,280,1,1,0,1,1,145,144,136,136,95
"8391",90,"[25]ioIoHcosHnJHGqKCvFkgqeiah",284,0.996491,25,285,1,284,1,1,0,1,1,138,137,147,147,95
"8392",91,"[25]ioIoHcosHnJHGqKCvFkgqeiah",282,0.996466,25,283,1,282,1,1,0,1,1,138,137,145,145,95
"8393",92,"[25]ioIoHcosHnJHGqKCvFkgqeiah",281,0.996454,25,282,1,281,1,1,0,1,1,139,138,143,143,95
"8394",93,"[25]ioIoHcosHnJHGqKCvFkgqeiah",282,0.996466,25,283,1,282,1,1,0,1,1,153,152,130,130,95
"8395",94,"[25]ioIoHcosHnJHGqKCvFkgqeiah",282,0.996466,25,283,1,282,1,1,0,1,1,135,134,148,148,95
"8396",95,"[25]ioIoHcosHnJHGqKCvFkgqeiah",278,0.996416,25,279,1,278,1,1,0,1,1,133,132,146,146,95
"8397",96,"[25]ioIoHcosHnJHGqKCvFkgqeiah",275,0.996377,25,276,1,275,1,1,0,1,1,134,133,142,142,95
"8398",97,"[25]ioIoHcosHnJHGqKCvFkgqeiah",276,0.99639,25,277,1,276,1,1,0,1,1,134,133,143,143,95
"8399",98,"[25]ioIoHcosHnJHGqKCvFkgqeiah",284,0.996491,25,285,1,284,1,1,0,1,1,139,138,146,146,95
"8400",99,"[25]ioIoHcosHnJHGqKCvFkgqeiah",281,0.996454,25,282,1,281,1,1,0,1,1,146,145,136,136,95
"8401",0,"[24]HHoIEoHcouHnJHGqKChBctds",281,0.996454,24,282,1,281,1,1,0,1,1,153,152,129,129,96
"8402",1,"[24]HHoIEoHcouHnJHGqKChBctds",278,0.996416,24,279,1,278,1,1,0,1,1,136,135,143,143,96
"8403",2,"[24]HHoIEoHcouHnJHGqKChBctds",284,0.996491,24,285,1,284,1,1,0,1,1,156,155,129,129,96
"8404",3,"[24]HHoIEoHcouHnJHGqKChBctds",283,0.996479,24,284,1,283,1,1,0,1,1,155,154,129,129,96
"8405",4,"[24]HHoIEoHcouHnJHGqKChBctds",283,0.996479,24,284,1,283,1,1,0,1,1,150,149,134,134,96
"8406",5,"[24]HHoIEoHcouHnJHGqKChBctds",282,0.996466,24,283,1,282,1,1,0,1,1,141,140,142,142,96
"8407",6,"[24]HHoIEoHcouHnJHGqKChBctds",274,0.996364,24,275,1,274,1,1,0,1,1,141,140,134,134,96
"8408",7,"[24]HHoIEoHcouHnJHGqKChBctds",277,0.996403,24,278,1,277,1,1,0,1,1,130,129,148,148,96
"8409",8,"[24]HHoIEoHcouHnJHGqKChBctds",280,0.996441,24,281,1,280,1,1,0,1,1,136,135,145,145,96
"8410",9,"[24]HHoIEoHcouHnJHGqKChBctds",277,0.996403,24,278,1,277,1,1,0,1,1,150,149,128,128,96
"8411",10,"[24]HHoIEoHcouHnJHGqKChBctds",282,0.996466,24,283,1,282,1,1,0,1,1,155,154,128,128,96
"8412",11,"[24]HHoIEoHcouHnJHGqKChBctds",289,0.996552,24,290,1,289,1,1,0,1,1,150,149,140,140,96
"8413",12,"[24]HHoIEoHcouHnJHGqKChBctds",273,0.99635,24,274,1,273,1,1,0,1,1,129,128,145,145,96
"8414",13,"[24]HHoIEoHcouHnJHGqKChBctds",280,0.996441,24,281,1,280,1,1,0,1,1,142,141,139,139,96
"8415",14,"[24]HHoIEoHcouHnJHGqKChBctds",282,0.996466,24,283,1,282,1,1,0,1,1,137,136,146,146,96
"8416",15,"[24]HHoIEoHcouHnJHGqKChBctds",285,0.996503,24,286,1,285,1,1,0,1,1,150,149,136,136,96
"8417",16,"[24]HHoIEoHcouHnJHGqKChBctds",283,0.996479,24,284,1,283,1,1,0,1,1,142,141,142,142,96
"8418",17,"[24]HHoIEoHcouHnJHGqKChBctds",276,0.99639,24,277,1,276,1,1,0,1,1,138,137,139,139,96
"8419",18,"[24]HHoIEoHcouHnJHGqKChBctds",278,0.996416,24,279,1,278,1,1,0,1,1,143,142,136,136,96
"8420",19,"[24]HHoIEoHcouHnJHGqKChBctds",272,0.996337,24,273,1,272,1,1,0,1,1,139,138,134,134,96
"8421",20,"[24]HHoIEoHcouHnJHGqKChBctds",275,0.996377,24,276,1,275,1,1,0,1,1,121,120,155,155,96
"8422",21,"[24]HHoIEoHcouHnJHGqKChBctds",283,0.996479,24,284,1,283,1,1,0,1,1,145,144,139,139,96
"8423",22,"[24]HHoIEoHcouHnJHGqKChBctds",280,0.996441,24,281,1,280,1,1,0,1,1,140,139,141,141,96
"8424",23,"[24]HHoIEoHcouHnJHGqKChBctds",277,0.996403,24,278,1,277,1,1,0,1,1,143,142,135,135,96
"8425",24,"[24]HHoIEoHcouHnJHGqKChBctds",285,0.996503,24,286,1,285,1,1,0,1,1,150,149,136,136,96
"8426",25,"[24]HHoIEoHcouHnJHGqKChBctds",281,0.996454,24,282,1,281,1,1,0,1,1,155,154,127,127,96
"8427",26,"[24]HHoIEoHcouHnJHGqKChBctds",280,0.996441,24,281,1,280,1,1,0,1,1,145,144,136,136,96
"8428",27,"[24]HHoIEoHcouHnJHGqKChBctds",285,0.996503,24,286,1,285,1,1,0,1,1,151,150,135,135,96
"8429",28,"[24]HHoIEoHcouHnJHGqKChBctds",286,0.996516,24,287,1,286,1,1,0,1,1,153,152,134,134,96
"8430",29,"[24]HHoIEoHcouHnJHGqKChBctds",280,0.996441,24,281,1,280,1,1,0,1,1,150,149,131,131,96
"8431",30,"[24]HHoIEoHcouHnJHGqKChBctds",288,0.99654,24,289,1,288,1,1,0,1,1,143,142,146,146,96
"8432",31,"[24]HHoIEoHcouHnJHGqKChBctds",285,0.996503,24,286,1,285,1,1,0,1,1,141,140,145,145,96
"8433",32,"[24]HHoIEoHcouHnJHGqKChBctds",278,0.996416,24,279,1,278,1,1,0,1,1,133,132,146,146,96
"8434",33,"[24]HHoIEoHcouHnJHGqKChBctds",274,0.996364,24,275,1,274,1,1,0,1,1,128,127,147,147,96
"8435",34,"[24]HHoIEoHcouHnJHGqKChBctds",283,0.996479,24,284,1,283,1,1,0,1,1,147,146,137,137,96
"8436",35,"[24]HHoIEoHcouHnJHGqKChBctds",283,0.996479,24,284,1,283,1,1,0,1,1,145,144,139,139,96
"8437",36,"[24]HHoIEoHcouHnJHGqKChBctds",283,0.996479,24,284,1,283,1,1,0,1,1,142,141,142,142,96
"8438",37,"[24]HHoIEoHcouHnJHGqKChBctds",279,0.996429,24,280,1,279,1,1,0,1,1,154,153,126,126,96
"8439",38,"[24]HHoIEoHcouHnJHGqKChBctds",280,0.996441,24,281,1,280,1,1,0,1,1,138,137,143,143,96
"8440",39,"[24]HHoIEoHcouHnJHGqKChBctds",288,0.99654,24,289,1,288,1,1,0,1,1,151,150,138,138,96
"8441",40,"[24]HHoIEoHcouHnJHGqKChBctds",284,0.996491,24,285,1,284,1,1,0,1,1,143,142,142,142,96
"8442",41,"[24]HHoIEoHcouHnJHGqKChBctds",277,0.996403,24,278,1,277,1,1,0,1,1,153,152,125,125,96
"8443",42,"[24]HHoIEoHcouHnJHGqKChBctds",278,0.996416,24,279,1,278,1,1,0,1,1,142,141,137,137,96
"8444",43,"[24]HHoIEoHcouHnJHGqKChBctds",289,0.996552,24,290,1,289,1,1,0,1,1,157,156,133,133,96
"8445",44,"[24]HHoIEoHcouHnJHGqKChBctds",282,0.996466,24,283,1,282,1,1,0,1,1,152,151,131,131,96
"8446",45,"[24]HHoIEoHcouHnJHGqKChBctds",277,0.996403,24,278,1,277,1,1,0,1,1,126,125,152,152,96
"8447",46,"[24]HHoIEoHcouHnJHGqKChBctds",283,0.996479,24,284,1,283,1,1,0,1,1,132,131,152,152,96
"8448",47,"[24]HHoIEoHcouHnJHGqKChBctds",273,0.99635,24,274,1,273,1,1,0,1,1,133,132,141,141,96
"8449",48,"[24]HHoIEoHcouHnJHGqKChBctds",281,0.996454,24,282,1,281,1,1,0,1,1,141,140,141,141,96
"8450",49,"[24]HHoIEoHcouHnJHGqKChBctds",282,0.996466,24,283,1,282,1,1,0,1,1,140,139,143,143,96
"8451",50,"[24]HHoIEoHcouHnJHGqKChBctds",286,0.996516,24,287,1,286,1,1,0,1,1,144,143,143,143,96
"8452",51,"[24]HHoIEoHcouHnJHGqKChBctds",281,0.996454,24,282,1,281,1,1,0,1,1,149,148,133,133,96
"8453",52,"[24]HHoIEoHcouHnJHGqKChBctds",279,0.996429,24,280,1,279,1,1,0,1,1,139,138,141,141,96
"8454",53,"[24]HHoIEoHcouHnJHGqKChBctds",283,0.996479,24,284,1,283,1,1,0,1,1,150,149,134,134,96
"8455",54,"[24]HHoIEoHcouHnJHGqKChBctds",280,0.996441,24,281,1,280,1,1,0,1,1,146,145,135,135,96
"8456",55,"[24]HHoIEoHcouHnJHGqKChBctds",284,0.996491,24,285,1,284,1,1,0,1,1,148,147,137,137,96
"8457",56,"[24]HHoIEoHcouHnJHGqKChBctds",280,0.996441,24,281,1,280,1,1,0,1,1,152,151,129,129,96
"8458",57,"[24]HHoIEoHcouHnJHGqKChBctds",285,0.996503,24,286,1,285,1,1,0,1,1,144,143,142,142,96
"8459",58,"[24]HHoIEoHcouHnJHGqKChBctds",279,0.996429,24,280,1,279,1,1,0,1,1,153,152,127,127,96
"8460",59,"[24]HHoIEoHcouHnJHGqKChBctds",285,0.996503,24,286,1,285,1,1,0,1,1,151,150,135,135,96
"8461",60,"[24]HHoIEoHcouHnJHGqKChBctds",285,0.996503,24,286,1,285,1,1,0,1,1,143,142,143,143,96
"8462",61,"[24]HHoIEoHcouHnJHGqKChBctds",284,0.996491,24,285,1,284,1,1,0,1,1,163,162,122,122,96
"8463",62,"[24]HHoIEoHcouHnJHGqKChBctds",288,0.99654,24,289,1,288,1,1,0,1,1,142,141,147,147,96
"8464",63,"[24]HHoIEoHcouHnJHGqKChBctds",283,0.996479,24,284,1,283,1,1,0,1,1,144,143,140,140,96
"8465",64,"[24]HHoIEoHcouHnJHGqKChBctds",280,0.996441,24,281,1,280,1,1,0,1,1,171,170,110,110,96
"8466",65,"[24]HHoIEoHcouHnJHGqKChBctds",282,0.996466,24,283,1,282,1,1,0,1,1,149,148,134,134,96
"8467",66,"[24]HHoIEoHcouHnJHGqKChBctds",286,0.996516,24,287,1,286,1,1,0,1,1,151,150,136,136,96
"8468",67,"[24]HHoIEoHcouHnJHGqKChBctds",279,0.996429,24,280,1,279,1,1,0,1,1,140,139,140,140,96
"8469",68,"[24]HHoIEoHcouHnJHGqKChBctds",275,0.996377,24,276,1,275,1,1,0,1,1,140,139,136,136,96
"8470",69,"[24]HHoIEoHcouHnJHGqKChBctds",269,0.996296,24,270,1,269,1,1,0,1,1,139,138,131,131,96
"8471",70,"[24]HHoIEoHcouHnJHGqKChBctds",277,0.996403,24,278,1,277,1,1,0,1,1,142,141,136,136,96
"8472",71,"[24]HHoIEoHcouHnJHGqKChBctds",282,0.996466,24,283,1,282,1,1,0,1,1,148,147,135,135,96
"8473",72,"[24]HHoIEoHcouHnJHGqKChBctds",283,0.996479,24,284,1,283,1,1,0,1,1,137,136,147,147,96
"8474",73,"[24]HHoIEoHcouHnJHGqKChBctds",279,0.996429,24,280,1,279,1,1,0,1,1,134,133,146,146,96
"8475",74,"[24]HHoIEoHcouHnJHGqKChBctds",272,0.996337,24,273,1,272,1,1,0,1,1,119,118,154,154,96
"8476",75,"[24]HHoIEoHcouHnJHGqKChBctds",274,0.996364,24,275,1,274,1,1,0,1,1,149,148,126,126,96
"8477",76,"[24]HHoIEoHcouHnJHGqKChBctds",276,0.99639,24,277,1,276,1,1,0,1,1,150,149,127,127,96
"8478",77,"[24]HHoIEoHcouHnJHGqKChBctds",273,0.99635,24,274,1,273,1,1,0,1,1,144,143,130,130,96
"8479",78,"[24]HHoIEoHcouHnJHGqKChBctds",273,0.99635,24,274,1,273,1,1,0,1,1,148,147,126,126,96
"8480",79,"[24]HHoIEoHcouHnJHGqKChBctds",278,0.996416,24,279,1,278,1,1,0,1,1,142,141,137,137,96
"8481",80,"[24]HHoIEoHcouHnJHGqKChBctds",276,0.99639,24,277,1,276,1,1,0,1,1,142,141,135,135,96
"8482",81,"[24]HHoIEoHcouHnJHGqKChBctds",281,0.996454,24,282,1,281,1,1,0,1,1,143,142,139,139,96
"8483",82,"[24]HHoIEoHcouHnJHGqKChBctds",281,0.996454,24,282,1,281,1,1,0,1,1,141,140,141,141,96
"8484",83,"[24]HHoIEoHcouHnJHGqKChBctds",286,0.996516,24,287,1,286,1,1,0,1,1,141,140,146,146,96
"8485",84,"[24]HHoIEoHcouHnJHGqKChBctds",286,0.996516,24,287,1,286,1,1,0,1,1,156,155,131,131,96
"8486",85,"[24]HHoIEoHcouHnJHGqKChBctds",279,0.996429,24,280,1,279,1,1,0,1,1,130,129,150,150,96
"8487",86,"[24]HHoIEoHcouHnJHGqKChBctds",278,0.996416,24,279,1,278,1,1,0,1,1,143,142,136,136,96
"8488",87,"[24]HHoIEoHcouHnJHGqKChBctds",280,0.996441,24,281,1,280,1,1,0,1,1,142,141,139,139,96
"8489",88,"[24]HHoIEoHcouHnJHGqKChBctds",278,0.996416,24,279,1,278,1,1,0,1,1,137,136,142,142,96
"8490",89,"[24]HHoIEoHcouHnJHGqKChBctds",277,0.996403,24,278,1,277,1,1,0,1,1,132,131,146,146,96
"8491",90,"[24]HHoIEoHcouHnJHGqKChBctds",280,0.996441,24,281,1,280,1,1,0,1,1,133,132,148,148,96
"8492",91,"[24]HHoIEoHcouHnJHGqKChBctds",279,0.996429,24,280,1,279,1,1,0,1,1,128,127,152,152,96
"8493",92,"[24]HHoIEoHcouHnJHGqKChBctds",281,0.996454,24,282,1,281,1,1,0,1,1,138,137,144,144,96
"8494",93,"[24]HHoIEoHcouHnJHGqKChBctds",280,0.996441,24,281,1,280,1,1,0,1,1,141,140,140,140,96
"8495",94,"[24]HHoIEoHcouHnJHGqKChBctds",288,0.99654,24,289,1,288,1,1,0,1,1,150,149,139,139,96
"8496",95,"[24]HHoIEoHcouHnJHGqKChBctds",282,0.996466,24,283,1,282,1,1,0,1,1,139,138,144,144,96
"8497",96,"[24]HHoIEoHcouHnJHGqKChBctds",286,0.996516,24,287,1,286,1,1,0,1,1,156,155,131,131,96
"8498",97,"[24]HHoIEoHcouHnJHGqKChBctds",284,0.996491,24,285,1,284,1,1,0,1,1,139,138,146,146,96
"8499",98,"[24]HHoIEoHcouHnJHGqKChBctds",273,0.99635,24,274,1,273,1,1,0,1,1,132,131,142,142,96
"8500",99,"[24]HHoIEoHcouHnJHGqKChBctds",274,0.996364,24,275,1,274,1,1,0,1,1,144,143,131,131,96
"8501",0,"[28]JAHoImoHcoxHnJHGqKCmdpHIKvkq",279,0.996429,28,280,1,279,1,1,0,1,1,126,125,154,154,97
"8502",1,"[28]JAHoImoHcoxHnJHGqKCmdpHIKvkq",280,0.996441,28,281,1,280,1,1,0,1,1,126,125,155,155,97
"8503",2,"[28]JAHoImoHcoxHnJHGqKCmdpHIKvkq",291,0.996575,28,292,1,291,1,1,0,1,1,153,152,139,139,97
"8504",3,"[28]JAHoImoHcoxHnJHGqKCmdpHIKvkq",283,0.996479,28,284,1,283,1,1,0,1,1,146,145,138,138,97
"8505",4,"[28]JAHoImoHcoxHnJHGqKCmdpHIKvkq",281,0.996454,28,282,1,281,1,1,0,1,1,154,153,128,128,97
"8506",5,"[28]JAHoImoHcoxHnJHGqKCmdpHIKvkq",281,0.996454,28,282,1,281,1,1,0,1,1,144,143,138,138,97
"8507",6,"[28]JAHoImoHcoxHnJHGqKCmdpHIKvkq",274,0.996364,28,275,1,274,1,1,0,1,1,130,129,145,145,97
"8508",7,"[28]JAHoImoHcoxHnJHGqKCmdpHIKvkq",284,0.996491,28,285,1,284,1,1,0,1,1,140,139,145,145,97
"8509",8,"[28]JAHoImoHcoxHnJHGqKCmdpHIKvkq",283,0.996479,28,284,1,283,1,1,0,1,1,138,137,146,146,97
"8510",9,"[28]JAHoImoHcoxHnJHGqKCmdpHIKvkq",278,0.996416,28,279,1,278,1,1,0,1,1,132,131,147,147,97
"8511",10,"[28]JAHoImoHcoxHnJHGqKCmdpHIKvkq",279,0.996429,28,280,1,279,1,1,0,1,1,141,140,139,139,97
"8512",11,"[28]JAHoImoHcoxHnJHGqKCmdpHIKvkq",283,0.996479,28,284,1,283,1,1,0,1,1,138,137,146,146,97
"8513",12,"[28]JAHoImoHcoxHnJHGqKCmdpHIKvkq",281,0.996454,28,282,1,281,1,1,0,1,1,157,156,125,125,97
"8514",13,"[28]JAHoImoHcoxHnJHGqKCmdpHIKvkq",285,0.996503,28,286,1,285,1,1,0,1,1,141,140,145,145,97
"8515",14,"[28]JAHoImoHcoxHnJHGqKCmdpHIKvkq",294,0.99661,28,295,1,294,1,1,0,1,1,149,148,146,146,97
"8516",15,"[28]JAHoImoHcoxHnJHGqKCmdpHIKvkq",278,0.996416,28,279,1,278,1,1,0,1,1,163,162,116,116,97
"8517",16,"[28]JAHoImoHcoxHnJHGqKCmdpHIKvkq",284,0.996491,28,285,1,284,1,1,0,1,1,137,136,148,148,97
"8518",17,"[28]JAHoImoHcoxHnJHGqKCmdpHIKvkq",277,0.996403,28,278,1,277,1,1,0,1,1,123,122,155,155,97
"8519",18,"[28]JAHoImoHcoxHnJHGqKCmdpHIKvkq",283,0.996479,28,284,1,283,1,1,0,1,1,146,145,138,138,97
"8520",19,"[28]JAHoImoHcoxHnJHGqKCmdpHIKvkq",283,0.996479,28,284,1,283,1,1,0,1,1,157,156,127,127,97
"8521",20,"[28]JAHoImoHcoxHnJHGqKCmdpHIKvkq",279,0.996429,28,280,1,279,1,1,0,1,1,147,146,133,133,97
"8522",21,"[28]JAHoImoHcoxHnJHGqKCmdpHIKvkq",282,0.996466,28,283,1,282,1,1,0,1,1,138,137,145,145,97
"8523",22,"[28]JAHoImoHcoxHnJHGqKCmdpHIKvkq",272,0.996337,28,273,1,272,1,1,0,1,1,123,122,150,150,97
"8524",23,"[28]JAHoImoHcoxHnJHGqKCmdpHIKvkq",278,0.996416,28,279,1,278,1,1,0,1,1,123,122,156,156,97
"8525",24,"[28]JAHoImoHcoxHnJHGqKCmdpHIKvkq",283,0.996479,28,284,1,283,1,1,0,1,1,136,135,148,148,97
"8526",25,"[28]JAHoImoHcoxHnJHGqKCmdpHIKvkq",286,0.996516,28,287,1,286,1,1,0,1,1,155,154,132,132,97
"8527",26,"[28]JAHoImoHcoxHnJHGqKCmdpHIKvkq",280,0.996441,28,281,1,280,1,1,0,1,1,138,137,143,143,97
"8528",27,"[28]JAHoImoHcoxHnJHGqKCmdpHIKvkq",288,0.99654,28,289,1,288,1,1,0,1,1,163,162,126,126,97
"8529",28,"[28]JAHoImoHcoxHnJHGqKCmdpHIKvkq",279,0.996429,28,280,1,279,1,1,0,1,1,138,137,142,142,97
"8530",29,"[28]JAHoImoHcoxHnJHGqKCmdpHIKvkq",283,0.996479,28,284,1,283,1,1,0,1,1,141,140,143,143,97
"8531",30,"[28]JAHoImoHcoxHnJHGqKCmdpHIKvkq",278,0.996416,28,279,1,278,1,1,0,1,1,130,129,149,149,97
"8532",31,"[28]JAHoImoHcoxHnJHGqKCmdpHIKvkq",286,0.996516,28,287,1,286,1,1,0,1,1,136,135,151,151,97
"8533",32,"[28]JAHoImoHcoxHnJHGqKCmdpHIKvkq",284,0.996491,28,285,1,284,1,1,0,1,1,142,141,143,143,97
"8534",33,"[28]JAHoImoHcoxHnJHGqKCmdpHIKvkq",287,0.996528,28,288,1,287,1,1,0,1,1,148,147,140,140,97
"8535",34,"[28]JAHoImoHcoxHnJHGqKCmdpHIKvkq",288,0.99654,28,289,1,288,1,1,0,1,1,143,142,146,146,97
"8536",35,"[28]JAHoImoHcoxHnJHGqKCmdpHIKvkq",290,0.996564,28,291,1,290,1,1,0,1,1,164,163,127,127,97
"8537",36,"[28]JAHoImoHcoxHnJHGqKCmdpHIKvkq",284,0.996491,28,285,1,284,1,1,0,1,1,143,142,142,142,97
"8538",37,"[28]JAHoImoHcoxHnJHGqKCmdpHIKvkq",286,0.996516,28,287,1,286,1,1,0,1,1,146,145,141,141,97
"8539",38,"[28]JAHoImoHcoxHnJHGqKCmdpHIKvkq",286,0.996516,28,287,1,286,1,1,0,1,1,144,143,143,143,97
"8540",39,"[28]JAHoImoHcoxHnJHGqKCmdpHIKvkq",280,0.996441,28,281,1,280,1,1,0,1,1,144,143,137,137,97
"8541",40,"[28]JAHoImoHcoxHnJHGqKCmdpHIKvkq",281,0.996454,28,282,1,281,1,1,0,1,1,141,140,141,141,97
"8542",41,"[28]JAHoImoHcoxHnJHGqKCmdpHIKvkq",282,0.996466,28,283,1,282,1,1,0,1,1,141,140,142,142,97
"8543",42,"[28]JAHoImoHcoxHnJHGqKCmdpHIKvkq",286,0.996516,28,287,1,286,1,1,0,1,1,138,137,149,149,97
"8544",43,"[28]JAHoImoHcoxHnJHGqKCmdpHIKvkq",279,0.996429,28,280,1,279,1,1,0,1,1,132,131,148,148,97
"8545",44,"[28]JAHoImoHcoxHnJHGqKCmdpHIKvkq",281,0.996454,28,282,1,281,1,1,0,1,1,138,137,144,144,97
"8546",45,"[28]JAHoImoHcoxHnJHGqKCmdpHIKvkq",283,0.996479,28,284,1,283,1,1,0,1,1,142,141,142,142,97
"8547",46,"[28]JAHoImoHcoxHnJHGqKCmdpHIKvkq",281,0.996454,28,282,1,281,1,1,0,1,1,135,134,147,147,97
"8548",47,"[28]JAHoImoHcoxHnJHGqKCmdpHIKvkq",280,0.996441,28,281,1,280,1,1,0,1,1,135,134,146,146,97
"8549",48,"[28]JAHoImoHcoxHnJHGqKCmdpHIKvkq",281,0.996454,28,282,1,281,1,1,0,1,1,138,137,144,144,97
"8550",49,"[28]JAHoImoHcoxHnJHGqKCmdpHIKvkq",289,0.996552,28,290,1,289,1,1,0,1,1,148,147,142,142,97
"8551",50,"[28]JAHoImoHcoxHnJHGqKCmdpHIKvkq",275,0.996377,28,276,1,275,1,1,0,1,1,144,143,132,132,97
"8552",51,"[28]JAHoImoHcoxHnJHGqKCmdpHIKvkq",281,0.996454,28,282,1,281,1,1,0,1,1,143,142,139,139,97
"8553",52,"[28]JAHoImoHcoxHnJHGqKCmdpHIKvkq",290,0.996564,28,291,1,290,1,1,0,1,1,153,152,138,138,97
"8554",53,"[28]JAHoImoHcoxHnJHGqKCmdpHIKvkq",285,0.996503,28,286,1,285,1,1,0,1,1,138,137,148,148,97
"8555",54,"[28]JAHoImoHcoxHnJHGqKCmdpHIKvkq",277,0.996403,28,278,1,277,1,1,0,1,1,153,152,125,125,97
"8556",55,"[28]JAHoImoHcoxHnJHGqKCmdpHIKvkq",279,0.996429,28,280,1,279,1,1,0,1,1,147,146,133,133,97
"8557",56,"[28]JAHoImoHcoxHnJHGqKCmdpHIKvkq",282,0.996466,28,283,1,282,1,1,0,1,1,132,131,151,151,97
"8558",57,"[28]JAHoImoHcoxHnJHGqKCmdpHIKvkq",281,0.996454,28,282,1,281,1,1,0,1,1,136,135,146,146,97
"8559",58,"[28]JAHoImoHcoxHnJHGqKCmdpHIKvkq",286,0.996516,28,287,1,286,1,1,0,1,1,146,145,141,141,97
"8560",59,"[28]JAHoImoHcoxHnJHGqKCmdpHIKvkq",274,0.996364,28,275,1,274,1,1,0,1,1,127,126,148,148,97
"8561",60,"[28]JAHoImoHcoxHnJHGqKCmdpHIKvkq",281,0.996454,28,282,1,281,1,1,0,1,1,130,129,152,152,97
"8562",61,"[28]JAHoImoHcoxHnJHGqKCmdpHIKvkq",280,0.996441,28,281,1,280,1,1,0,1,1,129,128,152,152,97
"8563",62,"[28]JAHoImoHcoxHnJHGqKCmdpHIKvkq",284,0.996491,28,285,1,284,1,1,0,1,1,153,152,132,132,97
"8564",63,"[28]JAHoImoHcoxHnJHGqKCmdpHIKvkq",275,0.996377,28,276,1,275,1,1,0,1,1,134,133,142,142,97
"8565",64,"[28]JAHoImoHcoxHnJHGqKCmdpHIKvkq",278,0.996416,28,279,1,278,1,1,0,1,1,137,136,142,142,97
"8566",65,"[28]JAHoImoHcoxHnJHGqKCmdpHIKvkq",282,0.996466,28,283,1,282,1,1,0,1,1,129,128,154,154,97
"8567",66,"[28]JAHoImoHcoxHnJHGqKCmdpHIKvkq",281,0.996454,28,282,1,281,1,1,0,1,1,155,154,127,127,97
"8568",67,"[28]JAHoImoHcoxHnJHGqKCmdpHIKvkq",280,0.996441,28,281,1,280,1,1,0,1,1,145,144,136,136,97
"8569",68,"[28]JAHoImoHcoxHnJHGqKCmdpHIKvkq",292,0.996587,28,293,1,292,1,1,0,1,1,159,158,134,134,97
"8570",69,"[28]JAHoImoHcoxHnJHGqKCmdpHIKvkq",281,0.996454,28,282,1,281,1,1,0,1,1,119,118,163,163,97
"8571",70,"[28]JAHoImoHcoxHnJHGqKCmdpHIKvkq",278,0.996416,28,279,1,278,1,1,0,1,1,140,139,139,139,97
"8572",71,"[28]JAHoImoHcoxHnJHGqKCmdpHIKvkq",271,0.996324,28,272,1,271,1,1,0,1,1,133,132,139,139,97
"8573",72,"[28]JAHoImoHcoxHnJHGqKCmdpHIKvkq",289,0.996552,28,290,1,289,1,1,0,1,1,146,145,144,144,97
"8574",73,"[28]JAHoImoHcoxHnJHGqKCmdpHIKvkq",276,0.99639,28,277,1,276,1,1,0,1,1,115,114,162,162,97
"8575",74,"[28]JAHoImoHcoxHnJHGqKCmdpHIKvkq",286,0.996516,28,287,1,286,1,1,0,1,1,146,145,141,141,97
"8576",75,"[28]JAHoImoHcoxHnJHGqKCmdpHIKvkq",277,0.996403,28,278,1,277,1,1,0,1,1,129,128,149,149,97
"8577",76,"[28]JAHoImoHcoxHnJHGqKCmdpHIKvkq",278,0.996416,28,279,1,278,1,1,0,1,1,140,139,139,139,97
"8578",77,"[28]JAHoImoHcoxHnJHGqKCmdpHIKvkq",291,0.996575,28,292,1,291,1,1,0,1,1,145,144,147,147,97
"8579",78,"[28]JAHoImoHcoxHnJHGqKCmdpHIKvkq",285,0.996503,28,286,1,285,1,1,0,1,1,154,153,132,132,97
"8580",79,"[28]JAHoImoHcoxHnJHGqKCmdpHIKvkq",274,0.996364,28,275,1,274,1,1,0,1,1,128,127,147,147,97
"8581",80,"[28]JAHoImoHcoxHnJHGqKCmdpHIKvkq",282,0.996466,28,283,1,282,1,1,0,1,1,142,141,141,141,97
"8582",81,"[28]JAHoImoHcoxHnJHGqKCmdpHIKvkq",274,0.996364,28,275,1,274,1,1,0,1,1,137,136,138,138,97
"8583",82,"[28]JAHoImoHcoxHnJHGqKCmdpHIKvkq",283,0.996479,28,284,1,283,1,1,0,1,1,150,149,134,134,97
"8584",83,"[28]JAHoImoHcoxHnJHGqKCmdpHIKvkq",284,0.996491,28,285,1,284,1,1,0,1,1,143,142,142,142,97
"8585",84,"[28]JAHoImoHcoxHnJHGqKCmdpHIKvkq",280,0.996441,28,281,1,280,1,1,0,1,1,145,144,136,136,97
"8586",85,"[28]JAHoImoHcoxHnJHGqKCmdpHIKvkq",283,0.996479,28,284,1,283,1,1,0,1,1,148,147,136,136,97
"8587",86,"[28]JAHoImoHcoxHnJHGqKCmdpHIKvkq",291,0.996575,28,292,1,291,1,1,0,1,1,152,151,140,140,97
"8588",87,"[28]JAHoImoHcoxHnJHGqKCmdpHIKvkq",283,0.996479,28,284,1,283,1,1,0,1,1,156,155,128,128,97
"8589",88,"[28]JAHoImoHcoxHnJHGqKCmdpHIKvkq",280,0.996441,28,281,1,280,1,1,0,1,1,130,129,151,151,97
"8590",89,"[28]JAHoImoHcoxHnJHGqKCmdpHIKvkq",281,0.996454,28,282,1,281,1,1,0,1,1,146,145,136,136,97
"8591",90,"[28]JAHoImoHcoxHnJHGqKCmdpHIKvkq",281,0.996454,28,282,1,281,1,1,0,1,1,150,149,132,132,97
"8592",91,"[28]JAHoImoHcoxHnJHGqKCmdpHIKvkq",284,0.996491,28,285,1,284,1,1,0,1,1,154,153,131,131,97
"8593",92,"[28]JAHoImoHcoxHnJHGqKCmdpHIKvkq",283,0.996479,28,284,1,283,1,1,0,1,1,133,132,151,151,97
"8594",93,"[28]JAHoImoHcoxHnJHGqKCmdpHIKvkq",287,0.996528,28,288,1,287,1,1,0,1,1,155,154,133,133,97
"8595",94,"[28]JAHoImoHcoxHnJHGqKCmdpHIKvkq",279,0.996429,28,280,1,279,1,1,0,1,1,137,136,143,143,97
"8596",95,"[28]JAHoImoHcoxHnJHGqKCmdpHIKvkq",278,0.996416,28,279,1,278,1,1,0,1,1,137,136,142,142,97
"8597",96,"[28]JAHoImoHcoxHnJHGqKCmdpHIKvkq",278,0.996416,28,279,1,278,1,1,0,1,1,136,135,143,143,97
"8598",97,"[28]JAHoImoHcoxHnJHGqKCmdpHIKvkq",277,0.996403,28,278,1,277,1,1,0,1,1,126,125,152,152,97
"8599",98,"[28]JAHoImoHcoxHnJHGqKCmdpHIKvkq",278,0.996416,28,279,1,278,1,1,0,1,1,133,132,146,146,97
"8600",99,"[28]JAHoImoHcoxHnJHGqKCmdpHIKvkq",279,0.996429,28,280,1,279,1,1,0,1,1,140,139,140,140,97
"8601",0,"[20]BoIpmoHcowHnJHGqKCnx",285,0.996503,20,286,1,285,1,1,0,1,1,134,133,152,152,98
"8602",1,"[20]BoIpmoHcowHnJHGqKCnx",275,0.996377,20,276,1,275,1,1,0,1,1,128,127,148,148,98
"8603",2,"[20]BoIpmoHcowHnJHGqKCnx",278,0.996416,20,279,1,278,1,1,0,1,1,154,153,125,125,98
"8604",3,"[20]BoIpmoHcowHnJHGqKCnx",277,0.996403,20,278,1,277,1,1,0,1,1,138,137,140,140,98
"8605",4,"[20]BoIpmoHcowHnJHGqKCnx",275,0.996377,20,276,1,275,1,1,0,1,1,134,133,142,142,98
"8606",5,"[20]BoIpmoHcowHnJHGqKCnx",273,0.99635,20,274,1,273,1,1,0,1,1,135,134,139,139,98
"8607",6,"[20]BoIpmoHcowHnJHGqKCnx",281,0.996454,20,282,1,281,1,1,0,1,1,125,124,157,157,98
"8608",7,"[20]BoIpmoHcowHnJHGqKCnx",284,0.996491,20,285,1,284,1,1,0,1,1,156,155,129,129,98
"8609",8,"[20]BoIpmoHcowHnJHGqKCnx",283,0.996479,20,284,1,283,1,1,0,1,1,139,138,145,145,98
"8610",9,"[20]BoIpmoHcowHnJHGqKCnx",285,0.996503,20,286,1,285,1,1,0,1,1,139,138,147,147,98
"8611",10,"[20]BoIpmoHcowHnJHGqKCnx",293,0.996599,20,294,1,293,1,1,0,1,1,155,154,139,139,98
"8612",11,"[20]BoIpmoHcowHnJHGqKCnx",279,0.996429,20,280,1,279,1,1,0,1,1,132,131,148,148,98
"8613",12,"[20]BoIpmoHcowHnJHGqKCnx",286,0.996516,20,287,1,286,1,1,0,1,1,154,153,133,133,98
"8614",13,"[20]BoIpmoHcowHnJHGqKCnx",283,0.996479,20,284,1,283,1,1,0,1,1,151,150,133,133,98
"8615",14,"[20]BoIpmoHcowHnJHGqKCnx",267,0.996269,20,268,1,267,1,1,0,1,1,143,142,125,125,98
"8616",15,"[20]BoIpmoHcowHnJHGqKCnx",279,0.996429,20,280,1,279,1,1,0,1,1,162,161,118,118,98
"8617",16,"[20]BoIpmoHcowHnJHGqKCnx",278,0.996416,20,279,1,278,1,1,0,1,1,149,148,130,130,98
"8618",17,"[20]BoIpmoHcowHnJHGqKCnx",283,0.996479,20,284,1,283,1,1,0,1,1,148,147,136,136,98
"8619",18,"[20]BoIpmoHcowHnJHGqKCnx",285,0.996503,20,286,1,285,1,1,0,1,1,151,150,135,135,98
"8620",19,"[20]BoIpmoHcowHnJHGqKCnx",281,0.996454,20,282,1,281,1,1,0,1,1,132,131,150,150,98
"8621",20,"[20]BoIpmoHcowHnJHGqKCnx",280,0.996441,20,281,1,280,1,1,0,1,1,150,149,131,131,98
"8622",21,"[20]BoIpmoHcowHnJHGqKCnx",283,0.996479,20,284,1,283,1,1,0,1,1,130,129,154,154,98
"8623",22,"[20]BoIpmoHcowHnJHGqKCnx",277,0.996403,20,278,1,277,1,1,0,1,1,151,150,127,127,98
"8624",23,"[20]BoIpmoHcowHnJHGqKCnx",273,0.99635,20,274,1,273,1,1,0,1,1,125,124,149,149,98
"8625",24,"[20]BoIpmoHcowHnJHGqKCnx",276,0.99639,20,277,1,276,1,1,0,1,1,127,126,150,150,98
"8626",25,"[20]BoIpmoHcowHnJHGqKCnx",293,0.996599,20,294,1,293,1,1,0,1,1,147,146,147,147,98
"8627",26,"[20]BoIpmoHcowHnJHGqKCnx",278,0.996416,20,279,1,278,1,1,0,1,1,142,141,137,137,98
"8628",27,"[20]BoIpmoHcowHnJHGqKCnx",285,0.996503,20,286,1,285,1,1,0,1,1,149,148,137,137,98
"8629",28,"[20]BoIpmoHcowHnJHGqKCnx",279,0.996429,20,280,1,279,1,1,0,1,1,137,136,143,143,98
"8630",29,"[20]BoIpmoHcowHnJHGqKCnx",281,0.996454,20,282,1,281,1,1,0,1,1,132,131,150,150,98
"8631",30,"[20]BoIpmoHcowHnJHGqKCnx",278,0.996416,20,279,1,278,1,1,0,1,1,147,146,132,132,98
"8632",31,"[20]BoIpmoHcowHnJHGqKCnx",278,0.996416,20,279,1,278,1,1,0,1,1,140,139,139,139,98
"8633",32,"[20]BoIpmoHcowHnJHGqKCnx",289,0.996552,20,290,1,289,1,1,0,1,1,160,159,130,130,98
"8634",33,"[20]BoIpmoHcowHnJHGqKCnx",282,0.996466,20,283,1,282,1,1,0,1,1,147,146,136,136,98
"8635",34,"[20]BoIpmoHcowHnJHGqKCnx",281,0.996454,20,282,1,281,1,1,0,1,1,140,139,142,142,98
"8636",35,"[20]BoIpmoHcowHnJHGqKCnx",287,0.996528,20,288,1,287,1,1,0,1,1,152,151,136,136,98
"8637",36,"[20]BoIpmoHcowHnJHGqKCnx",285,0.996503,20,286,1,285,1,1,0,1,1,148,147,138,138,98
"8638",37,"[20]BoIpmoHcowHnJHGqKCnx",292,0.996587,20,293,1,292,1,1,0,1,1,158,157,135,135,98
"8639",38,"[20]BoIpmoHcowHnJHGqKCnx",281,0.996454,20,282,1,281,1,1,0,1,1,135,134,147,147,98
"8640",39,"[20]BoIpmoHcowHnJHGqKCnx",279,0.996429,20,280,1,279,1,1,0,1,1,141,140,139,139,98
"8641",40,"[20]BoIpmoHcowHnJHGqKCnx",289,0.996552,20,290,1,289,1,1,0,1,1,150,149,140,140,98
"8642",41,"[20]BoIpmoHcowHnJHGqKCnx",281,0.996454,20,282,1,281,1,1,0,1,1,148,147,134,134,98
"8643",42,"[20]BoIpmoHcowHnJHGqKCnx",275,0.996377,20,276,1,275,1,1,0,1,1,140,139,136,136,98
"8644",43,"[20]BoIpmoHcowHnJHGqKCnx",281,0.996454,20,282,1,281,1,1,0,1,1,160,159,122,122,98
"8645",44,"[20]BoIpmoHcowHnJHGqKCnx",275,0.996377,20,276,1,275,1,1,0,1,1,144,143,132,132,98
"8646",45,"[20]BoIpmoHcowHnJHGqKCnx",273,0.99635,20,274,1,273,1,1,0,1,1,118,117,156,156,98
"8647",46,"[20]BoIpmoHcowHnJHGqKCnx",278,0.996416,20,279,1,278,1,1,0,1,1,139,138,140,140,98
"8648",47,"[20]BoIpmoHcowHnJHGqKCnx",285,0.996503,20,286,1,285,1,1,0,1,1,147,146,139,139,98
"8649",48,"[20]BoIpmoHcowHnJHGqKCnx",273,0.99635,20,274,1,273,1,1,0,1,1,133,132,141,141,98
"8650",49,"[20]BoIpmoHcowHnJHGqKCnx",273,0.99635,20,274,1,273,1,1,0,1,1,139,138,135,135,98
"8651",50,"[20]BoIpmoHcowHnJHGqKCnx",288,0.99654,20,289,1,288,1,1,0,1,1,155,154,134,134,98
"8652",51,"[20]BoIpmoHcowHnJHGqKCnx",281,0.996454,20,282,1,281,1,1,0,1,1,135,134,147,147,98
"8653",52,"[20]BoIpmoHcowHnJHGqKCnx",280,0.996441,20,281,1,280,1,1,0,1,1,139,138,142,142,98
"8654",53,"[20]BoIpmoHcowHnJHGqKCnx",282,0.996466,20,283,1,282,1,1,0,1,1,156,155,127,127,98
"8655",54,"[20]BoIpmoHcowHnJHGqKCnx",279,0.996429,20,280,1,279,1,1,0,1,1,126,125,154,154,98
"8656",55,"[20]BoIpmoHcowHnJHGqKCnx",277,0.996403,20,278,1,277,1,1,0,1,1,133,132,145,145,98
"8657",56,"[20]BoIpmoHcowHnJHGqKCnx",283,0.996479,20,284,1,283,1,1,0,1,1,144,143,140,140,98
"8658",57,"[20]BoIpmoHcowHnJHGqKCnx",282,0.996466,20,283,1,282,1,1,0,1,1,144,143,139,139,98
"8659",58,"[20]BoIpmoHcowHnJHGqKCnx",279,0.996429,20,280,1,279,1,1,0,1,1,155,154,125,125,98
"8660",59,"[20]BoIpmoHcowHnJHGqKCnx",279,0.996429,20,280,1,279,1,1,0,1,1,142,141,138,138,98
"8661",60,"[20]BoIpmoHcowHnJHGqKCnx",272,0.996337,20,273,1,272,1,1,0,1,1,132,131,141,141,98
"8662",61,"[20]BoIpmoHcowHnJHGqKCnx",282,0.996466,20,283,1,282,1,1,0,1,1,146,145,137,137,98
"8663",62,"[20]BoIpmoHcowHnJHGqKCnx",285,0.996503,20,286,1,285,1,1,0,1,1,148,147,138,138,98
"8664",63,"[20]BoIpmoHcowHnJHGqKCnx",284,0.996491,20,285,1,284,1,1,0,1,1,134,133,151,151,98
"8665",64,"[20]BoIpmoHcowHnJHGqKCnx",280,0.996441,20,281,1,280,1,1,0,1,1,138,137,143,143,98
"8666",65,"[20]BoIpmoHcowHnJHGqKCnx",281,0.996454,20,282,1,281,1,1,0,1,1,145,144,137,137,98
"8667",66,"[20]BoIpmoHcowHnJHGqKCnx",278,0.996416,20,279,1,278,1,1,0,1,1,131,130,148,148,98
"8668",67,"[20]BoIpmoHcowHnJHGqKCnx",289,0.996552,20,290,1,289,1,1,0,1,1,156,155,134,134,98
"8669",68,"[20]BoIpmoHcowHnJHGqKCnx",281,0.996454,20,282,1,281,1,1,0,1,1,151,150,131,131,98
"8670",69,"[20]BoIpmoHcowHnJHGqKCnx",287,0.996528,20,288,1,287,1,1,0,1,1,136,135,152,152,98
"8671",70,"[20]BoIpmoHcowHnJHGqKCnx",278,0.996416,20,279,1,278,1,1,0,1,1,130,129,149,149,98
"8672",71,"[20]BoIpmoHcowHnJHGqKCnx",278,0.996416,20,279,1,278,1,1,0,1,1,148,147,131,131,98
"8673",72,"[20]BoIpmoHcowHnJHGqKCnx",287,0.996528,20,288,1,287,1,1,0,1,1,147,146,141,141,98
"8674",73,"[20]BoIpmoHcowHnJHGqKCnx",279,0.996429,20,280,1,279,1,1,0,1,1,145,144,135,135,98
"8675",74,"[20]BoIpmoHcowHnJHGqKCnx",281,0.996454,20,282,1,281,1,1,0,1,1,153,152,129,129,98
"8676",75,"[20]BoIpmoHcowHnJHGqKCnx",280,0.996441,20,281,1,280,1,1,0,1,1,128,127,153,153,98
"8677",76,"[20]BoIpmoHcowHnJHGqKCnx",284,0.996491,20,285,1,284,1,1,0,1,1,139,138,146,146,98
"8678",77,"[20]BoIpmoHcowHnJHGqKCnx",281,0.996454,20,282,1,281,1,1,0,1,1,144,143,138,138,98
"8679",78,"[20]BoIpmoHcowHnJHGqKCnx",281,0.996454,20,282,1,281,1,1,0,1,1,138,137,144,144,98
"8680",79,"[20]BoIpmoHcowHnJHGqKCnx",285,0.996503,20,286,1,285,1,1,0,1,1,152,151,134,134,98
"8681",80,"[20]BoIpmoHcowHnJHGqKCnx",279,0.996429,20,280,1,279,1,1,0,1,1,137,136,143,143,98
"8682",81,"[20]BoIpmoHcowHnJHGqKCnx",278,0.996416,20,279,1,278,1,1,0,1,1,130,129,149,149,98
"8683",82,"[20]BoIpmoHcowHnJHGqKCnx",284,0.996491,20,285,1,284,1,1,0,1,1,157,156,128,128,98
"8684",83,"[20]BoIpmoHcowHnJHGqKCnx",279,0.996429,20,280,1,279,1,1,0,1,1,131,130,149,149,98
"8685",84,"[20]BoIpmoHcowHnJHGqKCnx",277,0.996403,20,278,1,277,1,1,0,1,1,148,147,130,130,98
"8686",85,"[20]BoIpmoHcowHnJHGqKCnx",275,0.996377,20,276,1,275,1,1,0,1,1,135,134,141,141,98
"8687",86,"[20]BoIpmoHcowHnJHGqKCnx",282,0.996466,20,283,1,282,1,1,0,1,1,136,135,147,147,98
"8688",87,"[20]BoIpmoHcowHnJHGqKCnx",272,0.996337,20,273,1,272,1,1,0,1,1,133,132,140,140,98
"8689",88,"[20]BoIpmoHcowHnJHGqKCnx",278,0.996416,20,279,1,278,1,1,0,1,1,138,137,141,141,98
"8690",89,"[20]BoIpmoHcowHnJHGqKCnx",281,0.996454,20,282,1,281,1,1,0,1,1,140,139,142,142,98
"8691",90,"[20]BoIpmoHcowHnJHGqKCnx",280,0.996441,20,281,1,280,1,1,0,1,1,144,143,137,137,98
"8692",91,"[20]BoIpmoHcowHnJHGqKCnx",284,0.996491,20,285,1,284,1,1,0,1,1,137,136,148,148,98
"8693",92,"[20]BoIpmoHcowHnJHGqKCnx",278,0.996416,20,279,1,278,1,1,0,1,1,129,128,150,150,98
"8694",93,"[20]BoIpmoHcowHnJHGqKCnx",278,0.996416,20,279,1,278,1,1,0,1,1,144,143,135,135,98
"8695",94,"[20]BoIpmoHcowHnJHGqKCnx",281,0.996454,20,282,1,281,1,1,0,1,1,140,139,142,142,98
"8696",95,"[20]BoIpmoHcowHnJHGqKCnx",282,0.996466,20,283,1,282,1,1,0,1,1,136,135,147,147,98
"8697",96,"[20]BoIpmoHcowHnJHGqKCnx",287,0.996528,20,288,1,287,1,1,0,1,1,148,147,140,140,98
"8698",97,"[20]BoIpmoHcowHnJHGqKCnx",274,0.996364,20,275,1,274,1,1,0,1,1,145,144,130,130,98
"8699",98,"[20]BoIpmoHcowHnJHGqKCnx",274,0.996364,20,275,1,274,1,1,0,1,1,141,140,134,134,98
"8700",99,"[20]BoIpmoHcowHnJHGqKCnx",281,0.996454,20,282,1,281,1,1,0,1,1,146,145,136,136,98
"8701",0,"[27]dHoIoHcotHnJHGqKChcohyqwHrA",281,0.996454,27,282,1,281,1,1,0,1,1,133,132,149,149,99
"8702",1,"[27]dHoIoHcotHnJHGqKChcohyqwHrA",277,0.996403,27,278,1,277,1,1,0,1,1,133,132,145,145,99
"8703",2,"[27]dHoIoHcotHnJHGqKChcohyqwHrA",279,0.996429,27,280,1,279,1,1,0,1,1,144,143,136,136,99
"8704",3,"[27]dHoIoHcotHnJHGqKChcohyqwHrA",285,0.996503,27,286,1,285,1,1,0,1,1,161,160,125,125,99
"8705",4,"[27]dHoIoHcotHnJHGqKChcohyqwHrA",283,0.996479,27,284,1,283,1,1,0,1,1,139,138,145,145,99
"8706",5,"[27]dHoIoHcotHnJHGqKChcohyqwHrA",279,0.996429,27,280,1,279,1,1,0,1,1,147,146,133,133,99
"8707",6,"[27]dHoIoHcotHnJHGqKChcohyqwHrA",277,0.996403,27,278,1,277,1,1,0,1,1,141,140,137,137,99
"8708",7,"[27]dHoIoHcotHnJHGqKChcohyqwHrA",279,0.996429,27,280,1,279,1,1,0,1,1,131,130,149,149,99
"8709",8,"[27]dHoIoHcotHnJHGqKChcohyqwHrA",278,0.996416,27,279,1,278,1,1,0,1,1,142,141,137,137,99
"8710",9,"[27]dHoIoHcotHnJHGqKChcohyqwHrA",284,0.996491,27,285,1,284,1,1,0,1,1,149,148,136,136,99
"8711",10,"[27]dHoIoHcotHnJHGqKChcohyqwHrA",280,0.996441,27,281,1,280,1,1,0,1,1,143,142,138,138,99
"8712",11,"[27]dHoIoHcotHnJHGqKChcohyqwHrA",282,0.996466,27,283,1,282,1,1,0,1,1,150,149,133,133,99
"8713",12,"[27]dHoIoHcotHnJHGqKChcohyqwHrA",278,0.996416,27,279,1,278,1,1,0,1,1,124,123,155,155,99
"8714",13,"[27]dHoIoHcotHnJHGqKChcohyqwHrA",284,0.996491,27,285,1,284,1,1,0,1,1,141,140,144,144,99
"8715",14,"[27]dHoIoHcotHnJHGqKChcohyqwHrA",286,0.996516,27,287,1,286,1,1,0,1,1,140,139,147,147,99
"8716",15,"[27]dHoIoHcotHnJHGqKChcohyqwHrA",284,0.996491,27,285,1,284,1,1,0,1,1,134,133,151,151,99
"8717",16,"[27]dHoIoHcotHnJHGqKChcohyqwHrA",287,0.996528,27,288,1,287,1,1,0,1,1,162,161,126,126,99
"8718",17,"[27]dHoIoHcotHnJHGqKChcohyqwHrA",278,0.996416,27,279,1,278,1,1,0,1,1,126,125,153,153,99
"8719",18,"[27]dHoIoHcotHnJHGqKChcohyqwHrA",279,0.996429,27,280,1,279,1,1,0,1,1,146,145,134,134,99
"8720",19,"[27]dHoIoHcotHnJHGqKChcohyqwHrA",278,0.996416,27,279,1,278,1,1,0,1,1,134,133,145,145,99
"8721",20,"[27]dHoIoHcotHnJHGqKChcohyqwHrA",277,0.996403,27,278,1,277,1,1,0,1,1,144,143,134,134,99
"8722",21,"[27]dHoIoHcotHnJHGqKChcohyqwHrA",283,0.996479,27,284,1,283,1,1,0,1,1,151,150,133,133,99
"8723",22,"[27]dHoIoHcotHnJHGqKChcohyqwHrA",279,0.996429,27,280,1,279,1,1,0,1,1,144,143,136,136,99
"8724",23,"[27]dHoIoHcotHnJHGqKChcohyqwHrA",285,0.996503,27,286,1,285,1,1,0,1,1,149,148,137,137,99
"8725",24,"[27]dHoIoHcotHnJHGqKChcohyqwHrA",274,0.996364,27,275,1,274,1,1,0,1,1,139,138,136,136,99
"8726",25,"[27]dHoIoHcotHnJHGqKChcohyqwHrA",270,0.99631,27,271,1,270,1,1,0,1,1,133,132,138,138,99
"8727",26,"[27]dHoIoHcotHnJHGqKChcohyqwHrA",280,0.996441,27,281,1,280,1,1,0,1,1,148,147,133,133,99
"8728",27,"[27]dHoIoHcotHnJHGqKChcohyqwHrA",280,0.996441,27,281,1,280,1,1,0,1,1,124,123,157,157,99
"8729",28,"[27]dHoIoHcotHnJHGqKChcohyqwHrA",282,0.996466,27,283,1,282,1,1,0,1,1,139,138,144,144,99
"8730",29,"[27]dHoIoHcotHnJHGqKChcohyqwHrA",282,0.996466,27,283,1,282,1,1,0,1,1,144,143,139,139,99
"8731",30,"[27]dHoIoHcotHnJHGqKChcohyqwHrA",278,0.996416,27,279,1,278,1,1,0,1,1,141,140,138,138,99
"8732",31,"[27]dHoIoHcotHnJHGqKChcohyqwHrA",279,0.996429,27,280,1,279,1,1,0,1,1,151,150,129,129,99
"8733",32,"[27]dHoIoHcotHnJHGqKChcohyqwHrA",277,0.996403,27,278,1,277,1,1,0,1,1,142,141,136,136,99
"8734",33,"[27]dHoIoHcotHnJHGqKChcohyqwHrA",276,0.99639,27,277,1,276,1,1,0,1,1,141,140,136,136,99
"8735",34,"[27]dHoIoHcotHnJHGqKChcohyqwHrA",288,0.99654,27,289,1,288,1,1,0,1,1,144,143,145,145,99
"8736",35,"[27]dHoIoHcotHnJHGqKChcohyqwHrA",286,0.996516,27,287,1,286,1,1,0,1,1,150,149,137,137,99
"8737",36,"[27]dHoIoHcotHnJHGqKChcohyqwHrA",278,0.996416,27,279,1,278,1,1,0,1,1,158,157,121,121,99
"8738",37,"[27]dHoIoHcotHnJHGqKChcohyqwHrA",281,0.996454,27,282,1,281,1,1,0,1,1,150,149,132,132,99
"8739",38,"[27]dHoIoHcotHnJHGqKChcohyqwHrA",282,0.996466,27,283,1,282,1,1,0,1,1,149,148,134,134,99
"8740",39,"[27]dHoIoHcotHnJHGqKChcohyqwHrA",283,0.996479,27,284,1,283,1,1,0,1,1,128,127,156,156,99
"8741",40,"[27]dHoIoHcotHnJHGqKChcohyqwHrA",279,0.996429,27,280,1,279,1,1,0,1,1,146,145,134,134,99
"8742",41,"[27]dHoIoHcotHnJHGqKChcohyqwHrA",280,0.996441,27,281,1,280,1,1,0,1,1,143,142,138,138,99
"8743",42,"[27]dHoIoHcotHnJHGqKChcohyqwHrA",283,0.996479,27,284,1,283,1,1,0,1,1,136,135,148,148,99
"8744",43,"[27]dHoIoHcotHnJHGqKChcohyqwHrA",278,0.996416,27,279,1,278,1,1,0,1,1,136,135,143,143,99
"8745",44,"[27]dHoIoHcotHnJHGqKChcohyqwHrA",280,0.996441,27,281,1,280,1,1,0,1,1,144,143,137,137,99
"8746",45,"[27]dHoIoHcotHnJHGqKChcohyqwHrA",278,0.996416,27,279,1,278,1,1,0,1,1,150,149,129,129,99
"8747",46,"[27]dHoIoHcotHnJHGqKChcohyqwHrA",285,0.996503,27,286,1,285,1,1,0,1,1,147,146,139,139,99
"8748",47,"[27]dHoIoHcotHnJHGqKChcohyqwHrA",278,0.996416,27,279,1,278,1,1,0,1,1,129,128,150,150,99
"8749",48,"[27]dHoIoHcotHnJHGqKChcohyqwHrA",278,0.996416,27,279,1,278,1,1,0,1,1,133,132,146,146,99
"8750",49,"[27]dHoIoHcotHnJHGqKChcohyqwHrA",284,0.996491,27,285,1,284,1,1,0,1,1,152,151,133,133,99
"8751",50,"[27]dHoIoHcotHnJHGqKChcohyqwHrA",282,0.996466,27,283,1,282,1,1,0,1,1,141,140,142,142,99
"8752",51,"[27]dHoIoHcotHnJHGqKChcohyqwHrA",284,0.996491,27,285,1,284,1,1,0,1,1,146,145,139,139,99
"8753",52,"[27]dHoIoHcotHnJHGqKChcohyqwHrA",280,0.996441,27,281,1,280,1,1,0,1,1,143,142,138,138,99
"8754",53,"[27]dHoIoHcotHnJHGqKChcohyqwHrA",290,0.996564,27,291,1,290,1,1,0,1,1,149,148,142,142,99
"8755",54,"[27]dHoIoHcotHnJHGqKChcohyqwHrA",278,0.996416,27,279,1,278,1,1,0,1,1,134,133,145,145,99
"8756",55,"[27]dHoIoHcotHnJHGqKChcohyqwHrA",285,0.996503,27,286,1,285,1,1,0,1,1,144,143,142,142,99
"8757",56,"[27]dHoIoHcotHnJHGqKChcohyqwHrA",278,0.996416,27,279,1,278,1,1,0,1,1,140,139,139,139,99
"8758",57,"[27]dHoIoHcotHnJHGqKChcohyqwHrA",282,0.996466,27,283,1,282,1,1,0,1,1,147,146,136,136,99
"8759",58,"[27]dHoIoHcotHnJHGqKChcohyqwHrA",281,0.996454,27,282,1,281,1,1,0,1,1,151,150,131,131,99
"8760",59,"[27]dHoIoHcotHnJHGqKChcohyqwHrA",276,0.99639,27,277,1,276,1,1,0,1,1,133,132,144,144,99
"8761",60,"[27]dHoIoHcotHnJHGqKChcohyqwHrA",281,0.996454,27,282,1,281,1,1,0,1,1,137,136,145,145,99
"8762",61,"[27]dHoIoHcotHnJHGqKChcohyqwHrA",281,0.996454,27,282,1,281,1,1,0,1,1,141,140,141,141,99
"8763",62,"[27]dHoIoHcotHnJHGqKChcohyqwHrA",282,0.996466,27,283,1,282,1,1,0,1,1,137,136,146,146,99
"8764",63,"[27]dHoIoHcotHnJHGqKChcohyqwHrA",281,0.996454,27,282,1,281,1,1,0,1,1,138,137,144,144,99
"8765",64,"[27]dHoIoHcotHnJHGqKChcohyqwHrA",275,0.996377,27,276,1,275,1,1,0,1,1,128,127,148,148,99
"8766",65,"[27]dHoIoHcotHnJHGqKChcohyqwHrA",281,0.996454,27,282,1,281,1,1,0,1,1,145,144,137,137,99
"8767",66,"[27]dHoIoHcotHnJHGqKChcohyqwHrA",281,0.996454,27,282,1,281,1,1,0,1,1,141,140,141,141,99
"8768",67,"[27]dHoIoHcotHnJHGqKChcohyqwHrA",285,0.996503,27,286,1,285,1,1,0,1,1,159,158,127,127,99
"8769",68,"[27]dHoIoHcotHnJHGqKChcohyqwHrA",283,0.996479,27,284,1,283,1,1,0,1,1,154,153,130,130,99
"8770",69,"[27]dHoIoHcotHnJHGqKChcohyqwHrA",288,0.99654,27,289,1,288,1,1,0,1,1,142,141,147,147,99
"8771",70,"[27]dHoIoHcotHnJHGqKChcohyqwHrA",283,0.996479,27,284,1,283,1,1,0,1,1,154,153,130,130,99
"8772",71,"[27]dHoIoHcotHnJHGqKChcohyqwHrA",288,0.99654,27,289,1,288,1,1,0,1,1,153,152,136,136,99
"8773",72,"[27]dHoIoHcotHnJHGqKChcohyqwHrA",283,0.996479,27,284,1,283,1,1,0,1,1,143,142,141,141,99
"8774",73,"[27]dHoIoHcotHnJHGqKChcohyqwHrA",279,0.996429,27,280,1,279,1,1,0,1,1,132,131,148,148,99
"8775",74,"[27]dHoIoHcotHnJHGqKChcohyqwHrA",275,0.996377,27,276,1,275,1,1,0,1,1,130,129,146,146,99
"8776",75,"[27]dHoIoHcotHnJHGqKChcohyqwHrA",285,0.996503,27,286,1,285,1,1,0,1,1,145,144,141,141,99
"8777",76,"[27]dHoIoHcotHnJHGqKChcohyqwHrA",288,0.99654,27,289,1,288,1,1,0,1,1,149,148,140,140,99
"8778",77,"[27]dHoIoHcotHnJHGqKChcohyqwHrA",285,0.996503,27,286,1,285,1,1,0,1,1,153,152,133,133,99
"8779",78,"[27]dHoIoHcotHnJHGqKChcohyqwHrA",285,0.996503,27,286,1,285,1,1,0,1,1,146,145,140,140,99
"8780",79,"[27]dHoIoHcotHnJHGqKChcohyqwHrA",281,0.996454,27,282,1,281,1,1,0,1,1,149,148,133,133,99
"8781",80,"[27]dHoIoHcotHnJHGqKChcohyqwHrA",280,0.996441,27,281,1,280,1,1,0,1,1,135,134,146,146,99
"8782",81,"[27]dHoIoHcotHnJHGqKChcohyqwHrA",289,0.996552,27,290,1,289,1,1,0,1,1,148,147,142,142,99
"8783",82,"[27]dHoIoHcotHnJHGqKChcohyqwHrA",289,0.996552,27,290,1,289,1,1,0,1,1,141,140,149,149,99
"8784",83,"[27]dHoIoHcotHnJHGqKChcohyqwHrA",284,0.996491,27,285,1,284,1,1,0,1,1,145,144,140,140,99
"8785",84,"[27]dHoIoHcotHnJHGqKChcohyqwHrA",282,0.996466,27,283,1,282,1,1,0,1,1,153,152,130,130,99
"8786",85,"[27]dHoIoHcotHnJHGqKChcohyqwHrA",267,0.996269,27,268,1,267,1,1,0,1,1,125,124,143,143,99
"8787",86,"[27]dHoIoHcotHnJHGqKChcohyqwHrA",283,0.996479,27,284,1,283,1,1,0,1,1,156,155,128,128,99
"8788",87,"[27]dHoIoHcotHnJHGqKChcohyqwHrA",285,0.996503,27,286,1,285,1,1,0,1,1,144,143,142,142,99
"8789",88,"[27]dHoIoHcotHnJHGqKChcohyqwHrA",277,0.996403,27,278,1,277,1,1,0,1,1,137,136,141,141,99
"8790",89,"[27]dHoIoHcotHnJHGqKChcohyqwHrA",282,0.996466,27,283,1,282,1,1,0,1,1,125,124,158,158,99
"8791",90,"[27]dHoIoHcotHnJHGqKChcohyqwHrA",282,0.996466,27,283,1,282,1,1,0,1,1,155,154,128,128,99
"8792",91,"[27]dHoIoHcotHnJHGqKChcohyqwHrA",278,0.996416,27,279,1,278,1,1,0,1,1,155,154,124,124,99
"8793",92,"[27]dHoIoHcotHnJHGqKChcohyqwHrA",283,0.996479,27,284,1,283,1,1,0,1,1,138,137,146,146,99
"8794",93,"[27]dHoIoHcotHnJHGqKChcohyqwHrA",283,0.996479,27,284,1,283,1,1,0,1,1,141,140,143,143,99
"8795",94,"[27]dHoIoHcotHnJHGqKChcohyqwHrA",276,0.99639,27,277,1,276,1,1,0,1,1,120,119,157,157,99
"8796",95,"[27]dHoIoHcotHnJHGqKChcohyqwHrA",280,0.996441,27,281,1,280,1,1,0,1,1,141,140,140,140,99
"8797",96,"[27]dHoIoHcotHnJHGqKChcohyqwHrA",279,0.996429,27,280,1,279,1,1,0,1,1,131,130,149,149,99
"8798",97,"[27]dHoIoHcotHnJHGqKChcohyqwHrA",284,0.996491,27,285,1,284,1,1,0,1,1,152,151,133,133,99
"8799",98,"[27]dHoIoHcotHnJHGqKChcohyqwHrA",275,0.996377,27,276,1,275,1,1,0,1,1,134,133,142,142,99
"8800",99,"[27]dHoIoHcotHnJHGqKChcohyqwHrA",283,0.996479,27,284,1,283,1,1,0,1,1,147,146,137,137,99
"8801",0,"[25]itoIoHcoxHnJHGqKCqulJtdCn",280,0.996441,25,281,1,280,1,1,0,1,1,139,138,142,142,100
"8802",1,"[25]itoIoHcoxHnJHGqKCqulJtdCn",285,0.996503,25,286,1,285,1,1,0,1,1,141,140,145,145,100
"8803",2,"[25]itoIoHcoxHnJHGqKCqulJtdCn",277,0.996403,25,278,1,277,1,1,0,1,1,130,129,148,148,100
"8804",3,"[25]itoIoHcoxHnJHGqKCqulJtdCn",284,0.996491,25,285,1,284,1,1,0,1,1,165,164,120,120,100
"8805",4,"[25]itoIoHcoxHnJHGqKCqulJtdCn",289,0.996552,25,290,1,289,1,1,0,1,1,133,132,157,157,100
"8806",5,"[25]itoIoHcoxHnJHGqKCqulJtdCn",278,0.996416,25,279,1,278,1,1,0,1,1,124,123,155,155,100
"8807",6,"[25]itoIoHcoxHnJHGqKCqulJtdCn",281,0.996454,25,282,1,281,1,1,0,1,1,150,149,132,132,100
"8808",7,"[25]itoIoHcoxHnJHGqKCqulJtdCn",280,0.996441,25,281,1,280,1,1,0,1,1,140,139,141,141,100
"8809",8,"[25]itoIoHcoxHnJHGqKCqulJtdCn",287,0.996528,25,288,1,287,1,1,0,1,1,148,147,140,140,100
"8810",9,"[25]itoIoHcoxHnJHGqKCqulJtdCn",278,0.996416,25,279,1,278,1,1,0,1,1,128,127,151,151,100
"8811",10,"[25]itoIoHcoxHnJHGqKCqulJtdCn",284,0.996491,25,285,1,284,1,1,0,1,1,144,143,141,141,100
"8812",11,"[25]itoIoHcoxHnJHGqKCqulJtdCn",272,0.996337,25,273,1,272,1,1,0,1,1,129,128,144,144,100
"8813",12,"[25]itoIoHcoxHnJHGqKCqulJtdCn",286,0.996516,25,287,1,286,1,1,0,1,1,143,142,144,144,100
"8814",13,"[25]itoIoHcoxHnJHGqKCqulJtdCn",283,0.996479,25,284,1,283,1,1,0,1,1,140,139,144,144,100
"8815",14,"[25]itoIoHcoxHnJHGqKCqulJtdCn",272,0.996337,25,273,1,272,1,1,0,1,1,129,128,144,144,100
"8816",15,"[25]itoIoHcoxHnJHGqKCqulJtdCn",286,0.996516,25,287,1,286,1,1,0,1,1,149,148,138,138,100
"8817",16,"[25]itoIoHcoxHnJHGqKCqulJtdCn",286,0.996516,25,287,1,286,1,1,0,1,1,157,156,130,130,100
"8818",17,"[25]itoIoHcoxHnJHGqKCqulJtdCn",272,0.996337,25,273,1,272,1,1,0,1,1,143,142,130,130,100
"8819",18,"[25]itoIoHcoxHnJHGqKCqulJtdCn",287,0.996528,25,288,1,287,1,1,0,1,1,140,139,148,148,100
"8820",19,"[25]itoIoHcoxHnJHGqKCqulJtdCn",281,0.996454,25,282,1,281,1,1,0,1,1,127,126,155,155,100
"8821",20,"[25]itoIoHcoxHnJHGqKCqulJtdCn",282,0.996466,25,283,1,282,1,1,0,1,1,148,147,135,135,100
"8822",21,"[25]itoIoHcoxHnJHGqKCqulJtdCn",284,0.996491,25,285,1,284,1,1,0,1,1,139,138,146,146,100
"8823",22,"[25]itoIoHcoxHnJHGqKCqulJtdCn",280,0.996441,25,281,1,280,1,1,0,1,1,142,141,139,139,100
"8824",23,"[25]itoIoHcoxHnJHGqKCqulJtdCn",284,0.996491,25,285,1,284,1,1,0,1,1,143,142,142,142,100
"8825",24,"[25]itoIoHcoxHnJHGqKCqulJtdCn",286,0.996516,25,287,1,286,1,1,0,1,1,159,158,128,128,100
"8826",25,"[25]itoIoHcoxHnJHGqKCqulJtdCn",280,0.996441,25,281,1,280,1,1,0,1,1,137,136,144,144,100
"8827",26,"[25]itoIoHcoxHnJHGqKCqulJtdCn",286,0.996516,25,287,1,286,1,1,0,1,1,148,147,139,139,100
"8828",27,"[25]itoIoHcoxHnJHGqKCqulJtdCn",274,0.996364,25,275,1,274,1,1,0,1,1,125,124,150,150,100
"8829",28,"[25]itoIoHcoxHnJHGqKCqulJtdCn",286,0.996516,25,287,1,286,1,1,0,1,1,135,134,152,152,100
"8830",29,"[25]itoIoHcoxHnJHGqKCqulJtdCn",285,0.996503,25,286,1,285,1,1,0,1,1,132,131,154,154,100
"8831",30,"[25]itoIoHcoxHnJHGqKCqulJtdCn",279,0.996429,25,280,1,279,1,1,0,1,1,145,144,135,135,100
"8832",31,"[25]itoIoHcoxHnJHGqKCqulJtdCn",281,0.996454,25,282,1,281,1,1,0,1,1,132,131,150,150,100
"8833",32,"[25]itoIoHcoxHnJHGqKCqulJtdCn",281,0.996454,25,282,1,281,1,1,0,1,1,135,134,147,147,100
"8834",33,"[25]itoIoHcoxHnJHGqKCqulJtdCn",288,0.99654,25,289,1,288,1,1,0,1,1,136,135,153,153,100
"8835",34,"[25]itoIoHcoxHnJHGqKCqulJtdCn",273,0.99635,25,274,1,273,1,1,0,1,1,138,137,136,136,100
"8836",35,"[25]itoIoHcoxHnJHGqKCqulJtdCn",284,0.996491,25,285,1,284,1,1,0,1,1,158,157,127,127,100
"8837",36,"[25]itoIoHcoxHnJHGqKCqulJtdCn",281,0.996454,25,282,1,281,1,1,0,1,1,145,144,137,137,100
"8838",37,"[25]itoIoHcoxHnJHGqKCqulJtdCn",279,0.996429,25,280,1,279,1,1,0,1,1,147,146,133,133,100
"8839",38,"[25]itoIoHcoxHnJHGqKCqulJtdCn",279,0.996429,25,280,1,279,1,1,0,1,1,143,142,137,137,100
"8840",39,"[25]itoIoHcoxHnJHGqKCqulJtdCn",276,0.99639,25,277,1,276,1,1,0,1,1,139,138,138,138,100
"8841",40,"[25]itoIoHcoxHnJHGqKCqulJtdCn",292,0.996587,25,293,1,292,1,1,0,1,1,154,153,139,139,100
"8842",41,"[25]itoIoHcoxHnJHGqKCqulJtdCn",281,0.996454,25,282,1,281,1,1,0,1,1,141,140,141,141,100
"8843",42,"[25]itoIoHcoxHnJHGqKCqulJtdCn",278,0.996416,25,279,1,278,1,1,0,1,1,122,121,157,157,100
"8844",43,"[25]itoIoHcoxHnJHGqKCqulJtdCn",279,0.996429,25,280,1,279,1,1,0,1,1,137,136,143,143,100
"8845",44,"[25]itoIoHcoxHnJHGqKCqulJtdCn",284,0.996491,25,285,1,284,1,1,0,1,1,153,152,132,132,100
"8846",45,"[25]itoIoHcoxHnJHGqKCqulJtdCn",283,0.996479,25,284,1,283,1,1,0,1,1,149,148,135,135,100
"8847",46,"[25]itoIoHcoxHnJHGqKCqulJtdCn",287,0.996528,25,288,1,287,1,1,0,1,1,148,147,140,140,100
"8848",47,"[25]itoIoHcoxHnJHGqKCqulJtdCn",285,0.996503,25,286,1,285,1,1,0,1,1,143,142,143,143,100
"8849",48,"[25]itoIoHcoxHnJHGqKCqulJtdCn",289,0.996552,25,290,1,289,1,1,0,1,1,144,143,146,146,100
"8850",49,"[25]itoIoHcoxHnJHGqKCqulJtdCn",283,0.996479,25,284,1,283,1,1,0,1,1,128,127,156,156,100
"8851",50,"[25]itoIoHcoxHnJHGqKCqulJtdCn",277,0.996403,25,278,1,277,1,1,0,1,1,136,135,142,142,100
"8852",51,"[25]itoIoHcoxHnJHGqKCqulJtdCn",283,0.996479,25,284,1,283,1,1,0,1,1,136,135,148,148,100
"8853",52,"[25]itoIoHcoxHnJHGqKCqulJtdCn",279,0.996429,25,280,1,279,1,1,0,1,1,160,159,120,120,100
"8854",53,"[25]itoIoHcoxHnJHGqKCqulJtdCn",280,0.996441,25,281,1,280,1,1,0,1,1,157,156,124,124,100
"8855",54,"[25]itoIoHcoxHnJHGqKCqulJtdCn",289,0.996552,25,290,1,289,1,1,0,1,1,162,161,128,128,100
"8856",55,"[25]itoIoHcoxHnJHGqKCqulJtdCn",284,0.996491,25,285,1,284,1,1,0,1,1,136,135,149,149,100
"8857",56,"[25]itoIoHcoxHnJHGqKCqulJtdCn",283,0.996479,25,284,1,283,1,1,0,1,1,137,136,147,147,100
"8858",57,"[25]itoIoHcoxHnJHGqKCqulJtdCn",285,0.996503,25,286,1,285,1,1,0,1,1,148,147,138,138,100
"8859",58,"[25]itoIoHcoxHnJHGqKCqulJtdCn",275,0.996377,25,276,1,275,1,1,0,1,1,137,136,139,139,100
"8860",59,"[25]itoIoHcoxHnJHGqKCqulJtdCn",277,0.996403,25,278,1,277,1,1,0,1,1,126,125,152,152,100
"8861",60,"[25]itoIoHcoxHnJHGqKCqulJtdCn",283,0.996479,25,284,1,283,1,1,0,1,1,147,146,137,137,100
"8862",61,"[25]itoIoHcoxHnJHGqKCqulJtdCn",284,0.996491,25,285,1,284,1,1,0,1,1,140,139,145,145,100
"8863",62,"[25]itoIoHcoxHnJHGqKCqulJtdCn",286,0.996516,25,287,1,286,1,1,0,1,1,133,132,154,154,100
"8864",63,"[25]itoIoHcoxHnJHGqKCqulJtdCn",279,0.996429,25,280,1,279,1,1,0,1,1,147,146,133,133,100
"8865",64,"[25]itoIoHcoxHnJHGqKCqulJtdCn",273,0.99635,25,274,1,273,1,1,0,1,1,141,140,133,133,100
"8866",65,"[25]itoIoHcoxHnJHGqKCqulJtdCn",288,0.99654,25,289,1,288,1,1,0,1,1,148,147,141,141,100
"8867",66,"[25]itoIoHcoxHnJHGqKCqulJtdCn",280,0.996441,25,281,1,280,1,1,0,1,1,124,123,157,157,100
"8868",67,"[25]itoIoHcoxHnJHGqKCqulJtdCn",280,0.996441,25,281,1,280,1,1,0,1,1,129,128,152,152,100
"8869",68,"[25]itoIoHcoxHnJHGqKCqulJtdCn",293,0.996599,25,294,1,293,1,1,0,1,1,156,155,138,138,100
"8870",69,"[25]itoIoHcoxHnJHGqKCqulJtdCn",279,0.996429,25,280,1,279,1,1,0,1,1,132,131,148,148,100
"8871",70,"[25]itoIoHcoxHnJHGqKCqulJtdCn",276,0.99639,25,277,1,276,1,1,0,1,1,147,146,130,130,100
"8872",71,"[25]itoIoHcoxHnJHGqKCqulJtdCn",279,0.996429,25,280,1,279,1,1,0,1,1,147,146,133,133,100
"8873",72,"[25]itoIoHcoxHnJHGqKCqulJtdCn",290,0.996564,25,291,1,290,1,1,0,1,1,147,146,144,144,100
"8874",73,"[25]itoIoHcoxHnJHGqKCqulJtdCn",279,0.996429,25,280,1,279,1,1,0,1,1,137,136,143,143,100
"8875",74,"[25]itoIoHcoxHnJHGqKCqulJtdCn",282,0.996466,25,283,1,282,1,1,0,1,1,140,139,143,143,100
"8876",75,"[25]itoIoHcoxHnJHGqKCqulJtdCn",283,0.996479,25,284,1,283,1,1,0,1,1,142,141,142,142,100
"8877",76,"[25]itoIoHcoxHnJHGqKCqulJtdCn",271,0.996324,25,272,1,271,1,1,0,1,1,117,116,155,155,100
"8878",77,"[25]itoIoHcoxHnJHGqKCqulJtdCn",285,0.996503,25,286,1,285,1,1,0,1,1,153,152,133,133,100
"8879",78,"[25]itoIoHcoxHnJHGqKCqulJtdCn",285,0.996503,25,286,1,285,1,1,0,1,1,147,146,139,139,100
"8880",79,"[25]itoIoHcoxHnJHGqKCqulJtdCn",283,0.996479,25,284,1,283,1,1,0,1,1,147,146,137,137,100
"8881",80,"[25]itoIoHcoxHnJHGqKCqulJtdCn",282,0.996466,25,283,1,282,1,1,0,1,1,141,140,142,142,100
"8882",81,"[25]itoIoHcoxHnJHGqKCqulJtdCn",282,0.996466,25,283,1,282,1,1,0,1,1,147,146,136,136,100
"8883",82,"[25]itoIoHcoxHnJHGqKCqulJtdCn",277,0.996403,25,278,1,277,1,1,0,1,1,139,138,139,139,100
"8884",83,"[25]itoIoHcoxHnJHGqKCqulJtdCn",284,0.996491,25,285,1,284,1,1,0,1,1,138,137,147,147,100
"8885",84,"[25]itoIoHcoxHnJHGqKCqulJtdCn",281,0.996454,25,282,1,281,1,1,0,1,1,149,148,133,133,100
"8886",85,"[25]itoIoHcoxHnJHGqKCqulJtdCn",287,0.996528,25,288,1,287,1,1,0,1,1,149,148,139,139,100
"8887",86,"[25]itoIoHcoxHnJHGqKCqulJtdCn",275,0.996377,25,276,1,275,1,1,0,1,1,136,135,140,140,100
"8888",87,"[25]itoIoHcoxHnJHGqKCqulJtdCn",284,0.996491,25,285,1,284,1,1,0,1,1,138,137,147,147,100
"8889",88,"[25]itoIoHcoxHnJHGqKCqulJtdCn",291,0.996575,25,292,1,291,1,1,0,1,1,153,152,139,139,100
"8890",89,"[25]itoIoHcoxHnJHGqKCqulJtdCn",279,0.996429,25,280,1,279,1,1,0,1,1,136,135,144,144,100
"8891",90,"[25]itoIoHcoxHnJHGqKCqulJtdCn",277,0.996403,25,278,1,277,1,1,0,1,1,142,141,136,136,100
"8892",91,"[25]itoIoHcoxHnJHGqKCqulJtdCn",281,0.996454,25,282,1,281,1,1,0,1,1,132,131,150,150,100
"8893",92,"[25]itoIoHcoxHnJHGqKCqulJtdCn",291,0.996575,25,292,1,291,1,1,0,1,1,163,162,129,129,100
"8894",93,"[25]itoIoHcoxHnJHGqKCqulJtdCn",284,0.996491,25,285,1,284,1,1,0,1,1,125,124,160,160,100
"8895",94,"[25]itoIoHcoxHnJHGqKCqulJtdCn",281,0.996454,25,282,1,281,1,1,0,1,1,138,137,144,144,100
"8896",95,"[25]itoIoHcoxHnJHGqKCqulJtdCn",280,0.996441,25,281,1,280,1,1,0,1,1,141,140,140,140,100
"8897",96,"[25]itoIoHcoxHnJHGqKCqulJtdCn",272,0.996337,25,273,1,272,1,1,0,1,1,139,138,134,134,100
"8898",97,"[25]itoIoHcoxHnJHGqKCqulJtdCn",284,0.996491,25,285,1,284,1,1,0,1,1,143,142,142,142,100
"8899",98,"[25]itoIoHcoxHnJHGqKCqulJtdCn",287,0.996528,25,288,1,287,1,1,0,1,1,144,143,144,144,100
"8900",99,"[25]itoIoHcoxHnJHGqKCqulJtdCn",276,0.99639,25,277,1,276,1,1,0,1,1,133,132,144,144,100
